enhancer_name,enhancer_chrom,enhancer_start,enhancer_end,promoter_name,promoter_chrom,promoter_start,promoter_end,label,enhancer_distance_to_promoter
H1|chr1:940643-940694,chr1,940643,940694,H1|chr1:939876-939981,chr1,939876,939981,1,767
H1|chr1:940643-940688,chr1,940643,940688,H1|chr1:939876-939981,chr1,939876,939981,1,767
H1|chr1:940649-940701,chr1,940649,940701,H1|chr1:939691-939766,chr1,939691,939766,1,958
H1|chr1:940649-940698,chr1,940649,940698,H1|chr1:939691-939766,chr1,939691,939766,1,958
H1|chr1:940652-940751,chr1,940652,940751,H1|chr1:939705-939821,chr1,939705,939821,1,947
H1|chr1:940715-940819,chr1,940715,940819,H1|chr1:939881-939924,chr1,939881,939924,1,834
H1|chr1:940718-940819,chr1,940718,940819,H1|chr1:939881-939924,chr1,939881,939924,1,837
H1|chr1:940718-940752,chr1,940718,940752,H1|chr1:939705-939821,chr1,939705,939821,1,1013
H1|chr1:940822-940897,chr1,940822,940897,H1|chr1:936562-936637,chr1,936562,936637,1,4260
H1|chr1:973138-973184,chr1,973138,973184,H1|chr1:110950825-110950874,chr1,110950825,110950874,1,109977687
H1|chr1:973138-973182,chr1,973138,973182,H1|chr1:110950825-110950874,chr1,110950825,110950874,1,109977687
H1|chr1:973142-973182,chr1,973142,973182,H1|chr1:110950825-110950874,chr1,110950825,110950874,1,109977683
H1|chr1:1088969-1088992,chr1,1088969,1088992,H1|chr1:1362779-1362847,chr1,1362779,1362847,1,273810
H1|chr1:1193437-1193573,chr1,1193437,1193573,H1|chr1:1188543-1188666,chr1,1188543,1188666,1,4894
H1|chr1:1193619-1193694,chr1,1193619,1193694,H1|chr1:1187426-1187484,chr1,1187426,1187484,1,6193
H1|chr1:2169183-2169247,chr1,2169183,2169247,H1|chr1:900250-900300,chr1,900250,900300,1,1268933
H1|chr1:2172340-2172485,chr1,2172340,2172485,H1|chr1:224302535-224302555,chr1,224302535,224302555,1,222130195
H1|chr1:2172355-2172485,chr1,2172355,2172485,H1|chr1:224302535-224302555,chr1,224302535,224302555,1,222130180
H1|chr1:2172706-2172756,chr1,2172706,2172756,H1|chr1:2046144-2046243,chr1,2046144,2046243,1,126562
H1|chr1:2172706-2172727,chr1,2172706,2172727,H1|chr1:2046144-2046243,chr1,2046144,2046243,1,126562
H1|chr1:2172775-2172925,chr1,2172775,2172925,H1|chr1:2046144-2046239,chr1,2046144,2046239,1,126631
H1|chr1:2172807-2172925,chr1,2172807,2172925,H1|chr1:2046144-2046239,chr1,2046144,2046239,1,126663
H1|chr1:2175617-2175700,chr1,2175617,2175700,H1|chr1:2133434-2133467,chr1,2133434,2133467,1,42183
H1|chr1:2176421-2176450,chr1,2176421,2176450,H1|chr1:1289123-1289244,chr1,1289123,1289244,1,887298
H1|chr1:2176423-2176482,chr1,2176423,2176482,H1|chr1:1289123-1289244,chr1,1289123,1289244,1,887300
H1|chr1:2177199-2177253,chr1,2177199,2177253,H1|chr1:2134364-2134384,chr1,2134364,2134384,1,42835
H1|chr1:2184309-2184383,chr1,2184309,2184383,H1|chr1:1410045-1410179,chr1,1410045,1410179,1,774264
H1|chr1:2188846-2188974,chr1,2188846,2188974,H1|chr1:1287496-1287591,chr1,1287496,1287591,1,901350
H1|chr1:2188921-2188976,chr1,2188921,2188976,H1|chr1:1287496-1287591,chr1,1287496,1287591,1,901425
H1|chr1:2190721-2190758,chr1,2190721,2190758,H1|chr1:224302933-224302995,chr1,224302933,224302995,1,222112212
H1|chr1:2200505-2200550,chr1,2200505,2200550,H1|chr1:27335516-27335579,chr1,27335516,27335579,1,25135011
H1|chr1:2221234-2221335,chr1,2221234,2221335,H1|chr1:229407755-229407792,chr1,229407755,229407792,1,227186521
H1|chr1:2221238-2221335,chr1,2221238,2221335,H1|chr1:229407755-229407792,chr1,229407755,229407792,1,227186517
H1|chr1:2479713-2479820,chr1,2479713,2479820,H1|chr1:2510066-2510216,chr1,2510066,2510216,1,30353
H1|chr1:2479811-2479843,chr1,2479811,2479843,H1|chr1:2510000-2510114,chr1,2510000,2510114,1,30189
H1|chr1:8431321-8431348,chr1,8431321,8431348,H1|chr1:44882217-44882287,chr1,44882217,44882287,1,36450896
H1|chr1:8431322-8431347,chr1,8431322,8431347,H1|chr1:44882217-44882287,chr1,44882217,44882287,1,36450895
H1|chr1:8508045-8508160,chr1,8508045,8508160,H1|chr1:28970813-28970833,chr1,28970813,28970833,1,20462768
H1|chr1:8513733-8513793,chr1,8513733,8513793,H1|chr1:25560308-25560351,chr1,25560308,25560351,1,17046575
H1|chr1:8520214-8520296,chr1,8520214,8520296,H1|chr1:85358425-85358493,chr1,85358425,85358493,1,76838211
H1|chr1:8520225-8520375,chr1,8520225,8520375,H1|chr1:85358425-85358493,chr1,85358425,85358493,1,76838200
H1|chr1:10953216-10953274,chr1,10953216,10953274,H1|chr1:11111038-11111118,chr1,11111038,11111118,1,157822
H1|chr1:10953217-10953274,chr1,10953217,10953274,H1|chr1:11111038-11111118,chr1,11111038,11111118,1,157821
H1|chr1:11766986-11767053,chr1,11766986,11767053,H1|chr1:11726636-11726745,chr1,11726636,11726745,1,40350
H1|chr1:11767934-11767994,chr1,11767934,11767994,H1|chr1:11712632-11712664,chr1,11712632,11712664,1,55302
H1|chr1:12304126-12304161,chr1,12304126,12304161,H1|chr1:11725213-11725268,chr1,11725213,11725268,1,578913
H1|chr1:12304127-12304161,chr1,12304127,12304161,H1|chr1:11725213-11725268,chr1,11725213,11725268,1,578914
H1|chr1:12304127-12304160,chr1,12304127,12304160,H1|chr1:11725212-11725268,chr1,11725212,11725268,1,578915
H1|chr1:12687895-12687940,chr1,12687895,12687940,H1|chr1:12681167-12681215,chr1,12681167,12681215,1,6728
H1|chr1:12688074-12688135,chr1,12688074,12688135,H1|chr1:12683157-12683242,chr1,12683157,12683242,1,4917
H1|chr1:12688078-12688228,chr1,12688078,12688228,H1|chr1:12683157-12683242,chr1,12683157,12683242,1,4921
H1|chr1:14951815-14951859,chr1,14951815,14951859,H1|chr1:6846834-6846916,chr1,6846834,6846916,1,8104981
H1|chr1:15061230-15061315,chr1,15061230,15061315,H1|chr1:14923804-14923834,chr1,14923804,14923834,1,137426
H1|chr1:15065939-15065999,chr1,15065939,15065999,H1|chr1:9349991-9350074,chr1,9349991,9350074,1,5715948
H1|chr1:15065939-15065998,chr1,15065939,15065998,H1|chr1:9349991-9350074,chr1,9349991,9350074,1,5715948
H1|chr1:15067930-15068017,chr1,15067930,15068017,H1|chr1:82265657-82265709,chr1,82265657,82265709,1,67197727
H1|chr1:15067930-15068015,chr1,15067930,15068015,H1|chr1:82265657-82265709,chr1,82265657,82265709,1,67197727
H1|chr1:15530998-15531071,chr1,15530998,15531071,H1|chr1:17867605-17867648,chr1,17867605,17867648,1,2336607
H1|chr1:15530998-15531069,chr1,15530998,15531069,H1|chr1:17867605-17867648,chr1,17867605,17867648,1,2336607
H1|chr1:15530998-15531061,chr1,15530998,15531061,H1|chr1:17867605-17867648,chr1,17867605,17867648,1,2336607
H1|chr1:16212409-16212426,chr1,16212409,16212426,H1|chr1:16090285-16090391,chr1,16090285,16090391,1,122124
H1|chr1:16356696-16356759,chr1,16356696,16356759,H1|chr1:16378499-16378601,chr1,16378499,16378601,1,21803
H1|chr1:16356711-16356759,chr1,16356711,16356759,H1|chr1:16378499-16378601,chr1,16378499,16378601,1,21788
H1|chr1:16356712-16356759,chr1,16356712,16356759,H1|chr1:16378499-16378601,chr1,16378499,16378601,1,21787
H1|chr1:16356730-16356759,chr1,16356730,16356759,H1|chr1:16378499-16378601,chr1,16378499,16378601,1,21769
H1|chr1:16818799-16818911,chr1,16818799,16818911,H1|chr1:17247227-17247299,chr1,17247227,17247299,1,428428
H1|chr1:16818864-16818934,chr1,16818864,16818934,H1|chr1:17247303-17247453,chr1,17247303,17247453,1,428439
H1|chr1:16818882-16818951,chr1,16818882,16818951,H1|chr1:17247237-17247302,chr1,17247237,17247302,1,428355
H1|chr1:16818882-16818941,chr1,16818882,16818941,H1|chr1:17247206-17247240,chr1,17247206,17247240,1,428324
H1|chr1:16818886-16818945,chr1,16818886,16818945,H1|chr1:17247205-17247237,chr1,17247205,17247237,1,428319
H1|chr1:16818893-16818951,chr1,16818893,16818951,H1|chr1:17247295-17247445,chr1,17247295,17247445,1,428402
H1|chr1:16818893-16818938,chr1,16818893,16818938,H1|chr1:17247219-17247240,chr1,17247219,17247240,1,428326
H1|chr1:16819596-16819674,chr1,16819596,16819674,H1|chr1:17246195-17246236,chr1,17246195,17246236,1,426599
H1|chr1:16820444-16820551,chr1,16820444,16820551,H1|chr1:17244636-17244678,chr1,17244636,17244678,1,424192
H1|chr1:16821351-16821498,chr1,16821351,16821498,H1|chr1:17244740-17244848,chr1,17244740,17244848,1,423389
H1|chr1:16821522-16821537,chr1,16821522,16821537,H1|chr1:17244796-17244834,chr1,17244796,17244834,1,423274
H1|chr1:16822450-16822600,chr1,16822450,16822600,H1|chr1:17243634-17243784,chr1,17243634,17243784,1,421184
H1|chr1:16822457-16822607,chr1,16822457,16822607,H1|chr1:17243718-17243865,chr1,17243718,17243865,1,421261
H1|chr1:16822591-16822738,chr1,16822591,16822738,H1|chr1:17243646-17243793,chr1,17243646,17243793,1,421055
H1|chr1:16822980-16823104,chr1,16822980,16823104,H1|chr1:17243472-17243492,chr1,17243472,17243492,1,420492
H1|chr1:17027790-17027937,chr1,17027790,17027937,H1|chr1:6507186-6507238,chr1,6507186,6507238,1,10520604
H1|chr1:17027822-17027918,chr1,17027822,17027918,H1|chr1:6507203-6507238,chr1,6507203,6507238,1,10520619
H1|chr1:17027824-17027918,chr1,17027824,17027918,H1|chr1:6507204-6507257,chr1,6507204,6507257,1,10520620
H1|chr1:17027832-17027937,chr1,17027832,17027937,H1|chr1:6507203-6507238,chr1,6507203,6507238,1,10520629
H1|chr1:17027839-17027937,chr1,17027839,17027937,H1|chr1:6507186-6507238,chr1,6507186,6507238,1,10520653
H1|chr1:17878985-17879058,chr1,17878985,17879058,H1|chr1:16537491-16537553,chr1,16537491,16537553,1,1341494
H1|chr1:17878985-17879057,chr1,17878985,17879057,H1|chr1:16537491-16537553,chr1,16537491,16537553,1,1341494
H1|chr1:17889794-17889839,chr1,17889794,17889839,H1|chr1:16538130-16538221,chr1,16538130,16538221,1,1351664
H1|chr1:17898644-17898694,chr1,17898644,17898694,H1|chr1:114701057-114701157,chr1,114701057,114701157,1,96802413
H1|chr1:17898645-17898694,chr1,17898645,17898694,H1|chr1:114701058-114701104,chr1,114701058,114701104,1,96802413
H1|chr1:19947029-19947075,chr1,19947029,19947075,H1|chr1:19579058-19579166,chr1,19579058,19579166,1,367971
H1|chr1:19947029-19947071,chr1,19947029,19947071,H1|chr1:19579058-19579166,chr1,19579058,19579166,1,367971
H1|chr1:20095303-20095320,chr1,20095303,20095320,H1|chr1:1334294-1334390,chr1,1334294,1334390,1,18761009
H1|chr1:22289836-22289909,chr1,22289836,22289909,H1|chr1:150603919-150603974,chr1,150603919,150603974,1,128314083
H1|chr1:22289841-22289909,chr1,22289841,22289909,H1|chr1:150603874-150603945,chr1,150603874,150603945,1,128314033
H1|chr1:22289854-22289933,chr1,22289854,22289933,H1|chr1:150603910-150603950,chr1,150603910,150603950,1,128314056
H1|chr1:26098271-26098372,chr1,26098271,26098372,H1|chr1:9649394-9649488,chr1,9649394,9649488,1,16448877
H1|chr1:26098271-26098327,chr1,26098271,26098327,H1|chr1:9649394-9649488,chr1,9649394,9649488,1,16448877
H1|chr1:26098271-26098326,chr1,26098271,26098326,H1|chr1:9649394-9649488,chr1,9649394,9649488,1,16448877
H1|chr1:26743147-26743270,chr1,26743147,26743270,H1|chr1:26757495-26757581,chr1,26757495,26757581,1,14348
H1|chr1:26743147-26743208,chr1,26743147,26743208,H1|chr1:26757495-26757581,chr1,26757495,26757581,1,14348
H1|chr1:26743147-26743204,chr1,26743147,26743204,H1|chr1:26757495-26757581,chr1,26757495,26757581,1,14348
H1|chr1:26743156-26743266,chr1,26743156,26743266,H1|chr1:26757495-26757581,chr1,26757495,26757581,1,14339
H1|chr1:26743680-26743760,chr1,26743680,26743760,H1|chr1:26756269-26756338,chr1,26756269,26756338,1,12589
H1|chr1:26745113-26745146,chr1,26745113,26745146,H1|chr1:26758439-26758470,chr1,26758439,26758470,1,13326
H1|chr1:26745113-26745144,chr1,26745113,26745144,H1|chr1:26758437-26758470,chr1,26758437,26758470,1,13324
H1|chr1:26745606-26745716,chr1,26745606,26745716,H1|chr1:26757405-26757470,chr1,26757405,26757470,1,11799
H1|chr1:26745608-26745693,chr1,26745608,26745693,H1|chr1:26757405-26757470,chr1,26757405,26757470,1,11797
H1|chr1:26745757-26745789,chr1,26745757,26745789,H1|chr1:26756462-26756558,chr1,26756462,26756558,1,10705
H1|chr1:26747288-26747324,chr1,26747288,26747324,H1|chr1:26758512-26758626,chr1,26758512,26758626,1,11224
H1|chr1:26749811-26749864,chr1,26749811,26749864,H1|chr1:26757460-26757557,chr1,26757460,26757557,1,7649
H1|chr1:26750054-26750130,chr1,26750054,26750130,H1|chr1:26758317-26758364,chr1,26758317,26758364,1,8263
H1|chr1:26750054-26750129,chr1,26750054,26750129,H1|chr1:26758317-26758364,chr1,26758317,26758364,1,8263
H1|chr1:26750318-26750407,chr1,26750318,26750407,H1|chr1:26799083-26799197,chr1,26799083,26799197,1,48765
H1|chr1:26750754-26750845,chr1,26750754,26750845,H1|chr1:26757551-26757619,chr1,26757551,26757619,1,6797
H1|chr1:26750754-26750836,chr1,26750754,26750836,H1|chr1:26757551-26757619,chr1,26757551,26757619,1,6797
H1|chr1:26752597-26752652,chr1,26752597,26752652,H1|chr1:26756213-26756246,chr1,26756213,26756246,1,3616
H1|chr1:26752600-26752652,chr1,26752600,26752652,H1|chr1:26756213-26756246,chr1,26756213,26756246,1,3613
H1|chr1:27327703-27327831,chr1,27327703,27327831,H1|chr1:27321952-27321971,chr1,27321952,27321971,1,5751
H1|chr1:27327707-27327846,chr1,27327707,27327846,H1|chr1:27321952-27321971,chr1,27321952,27321971,1,5755
H1|chr1:27327890-27328040,chr1,27327890,27328040,H1|chr1:27050545-27050570,chr1,27050545,27050570,1,277345
H1|chr1:27327937-27328058,chr1,27327937,27328058,H1|chr1:27050545-27050570,chr1,27050545,27050570,1,277392
H1|chr1:27327952-27328042,chr1,27327952,27328042,H1|chr1:27321354-27321403,chr1,27321354,27321403,1,6598
H1|chr1:27328082-27328182,chr1,27328082,27328182,H1|chr1:27334720-27334823,chr1,27334720,27334823,1,6638
H1|chr1:27328086-27328200,chr1,27328086,27328200,H1|chr1:27321864-27321946,chr1,27321864,27321946,1,6222
H1|chr1:27328093-27328153,chr1,27328093,27328153,H1|chr1:27321994-27322046,chr1,27321994,27322046,1,6099
H1|chr1:27328093-27328151,chr1,27328093,27328151,H1|chr1:27321994-27322046,chr1,27321994,27322046,1,6099
H1|chr1:27328143-27328182,chr1,27328143,27328182,H1|chr1:27321972-27322025,chr1,27321972,27322025,1,6171
H1|chr1:27328203-27328316,chr1,27328203,27328316,H1|chr1:27321530-27321567,chr1,27321530,27321567,1,6673
H1|chr1:27328371-27328464,chr1,27328371,27328464,H1|chr1:27321562-27321616,chr1,27321562,27321616,1,6809
H1|chr1:27328371-27328461,chr1,27328371,27328461,H1|chr1:27321562-27321616,chr1,27321562,27321616,1,6809
H1|chr1:27328375-27328453,chr1,27328375,27328453,H1|chr1:27321601-27321624,chr1,27321601,27321624,1,6774
H1|chr1:27328375-27328451,chr1,27328375,27328451,H1|chr1:27321601-27321624,chr1,27321601,27321624,1,6774
H1|chr1:27328470-27328521,chr1,27328470,27328521,H1|chr1:27321497-27321546,chr1,27321497,27321546,1,6973
H1|chr1:27328897-27328960,chr1,27328897,27328960,H1|chr1:27335574-27335651,chr1,27335574,27335651,1,6677
H1|chr1:27328897-27328949,chr1,27328897,27328949,H1|chr1:27335610-27335642,chr1,27335610,27335642,1,6713
H1|chr1:27328907-27329014,chr1,27328907,27329014,H1|chr1:27321276-27321306,chr1,27321276,27321306,1,7631
H1|chr1:27329396-27329463,chr1,27329396,27329463,H1|chr1:27051382-27051440,chr1,27051382,27051440,1,278014
H1|chr1:27329686-27329734,chr1,27329686,27329734,H1|chr1:27338539-27338657,chr1,27338539,27338657,1,8853
H1|chr1:27329689-27329739,chr1,27329689,27329739,H1|chr1:27321873-27321947,chr1,27321873,27321947,1,7816
H1|chr1:27329702-27329734,chr1,27329702,27329734,H1|chr1:27338539-27338657,chr1,27338539,27338657,1,8837
H1|chr1:27329842-27329957,chr1,27329842,27329957,H1|chr1:27321347-27321388,chr1,27321347,27321388,1,8495
H1|chr1:27329848-27329957,chr1,27329848,27329957,H1|chr1:27321347-27321388,chr1,27321347,27321388,1,8501
H1|chr1:27330372-27330393,chr1,27330372,27330393,H1|chr1:27321384-27321502,chr1,27321384,27321502,1,8988
H1|chr1:27330437-27330508,chr1,27330437,27330508,H1|chr1:27336301-27336368,chr1,27336301,27336368,1,5864
H1|chr1:27330830-27330852,chr1,27330830,27330852,H1|chr1:27337678-27337759,chr1,27337678,27337759,1,6848
H1|chr1:27331216-27331243,chr1,27331216,27331243,H1|chr1:27322036-27322105,chr1,27322036,27322105,1,9180
H1|chr1:27331216-27331242,chr1,27331216,27331242,H1|chr1:27322036-27322105,chr1,27322036,27322105,1,9180
H1|chr1:27376218-27376314,chr1,27376218,27376314,H1|chr1:213034523-213034557,chr1,213034523,213034557,1,185658305
H1|chr1:27676795-27676886,chr1,27676795,27676886,H1|chr1:27665925-27665950,chr1,27665925,27665950,1,10870
H1|chr1:27676795-27676885,chr1,27676795,27676885,H1|chr1:27665925-27665950,chr1,27665925,27665950,1,10870
H1|chr1:27676814-27676908,chr1,27676814,27676908,H1|chr1:27665560-27665597,chr1,27665560,27665597,1,11254
H1|chr1:27857694-27857755,chr1,27857694,27857755,H1|chr1:27667332-27667371,chr1,27667332,27667371,1,190362
H1|chr1:27910403-27910447,chr1,27910403,27910447,H1|chr1:27665977-27666063,chr1,27665977,27666063,1,244426
H1|chr1:27910403-27910440,chr1,27910403,27910440,H1|chr1:27665977-27666063,chr1,27665977,27666063,1,244426
H1|chr1:27911062-27911133,chr1,27911062,27911133,H1|chr1:27667660-27667780,chr1,27667660,27667780,1,243402
H1|chr1:27911062-27911131,chr1,27911062,27911131,H1|chr1:27667660-27667780,chr1,27667660,27667780,1,243402
H1|chr1:27911062-27911092,chr1,27911062,27911092,H1|chr1:27667660-27667780,chr1,27667660,27667780,1,243402
H1|chr1:27911191-27911236,chr1,27911191,27911236,H1|chr1:25593055-25593202,chr1,25593055,25593202,1,2318136
H1|chr1:28592180-28592243,chr1,28592180,28592243,H1|chr1:27674714-27674801,chr1,27674714,27674801,1,917466
H1|chr1:28592181-28592263,chr1,28592181,28592263,H1|chr1:27674714-27674801,chr1,27674714,27674801,1,917467
H1|chr1:28592181-28592262,chr1,28592181,28592262,H1|chr1:27674714-27674801,chr1,27674714,27674801,1,917467
H1|chr1:28592635-28592658,chr1,28592635,28592658,H1|chr1:28263428-28263542,chr1,28263428,28263542,1,329207
H1|chr1:28906270-28906389,chr1,28906270,28906389,H1|chr1:173836043-173836074,chr1,173836043,173836074,1,144929773
H1|chr1:28906270-28906385,chr1,28906270,28906385,H1|chr1:173836043-173836074,chr1,173836043,173836074,1,144929773
H1|chr1:28906274-28906392,chr1,28906274,28906392,H1|chr1:173836043-173836074,chr1,173836043,173836074,1,144929769
H1|chr1:28907454-28907565,chr1,28907454,28907565,H1|chr1:111991116-111991134,chr1,111991116,111991134,1,83083662
H1|chr1:28907454-28907564,chr1,28907454,28907564,H1|chr1:111991116-111991134,chr1,111991116,111991134,1,83083662
H1|chr1:28975149-28975177,chr1,28975149,28975177,H1|chr1:200861397-200861480,chr1,200861397,200861480,1,171886248
H1|chr1:29308819-29308844,chr1,29308819,29308844,H1|chr1:150546667-150546725,chr1,150546667,150546725,1,121237848
H1|chr1:29308819-29308843,chr1,29308819,29308843,H1|chr1:150546667-150546725,chr1,150546667,150546725,1,121237848
H1|chr1:31294046-31294087,chr1,31294046,31294087,H1|chr1:182809558-182809664,chr1,182809558,182809664,1,151515512
H1|chr1:33184619-33184696,chr1,33184619,33184696,H1|chr1:33171322-33171350,chr1,33171322,33171350,1,13297
H1|chr1:33184620-33184752,chr1,33184620,33184752,H1|chr1:33171348-33171364,chr1,33171348,33171364,1,13272
H1|chr1:33593858-33594008,chr1,33593858,33594008,H1|chr1:33650432-33650497,chr1,33650432,33650497,1,56574
H1|chr1:33593858-33593942,chr1,33593858,33593942,H1|chr1:33650432-33650497,chr1,33650432,33650497,1,56574
H1|chr1:33599122-33599178,chr1,33599122,33599178,H1|chr1:33646320-33646421,chr1,33646320,33646421,1,47198
H1|chr1:33599132-33599178,chr1,33599132,33599178,H1|chr1:33646320-33646421,chr1,33646320,33646421,1,47188
H1|chr1:34103194-34103248,chr1,34103194,34103248,H1|chr1:32402358-32402437,chr1,32402358,32402437,1,1700836
H1|chr1:34103195-34103248,chr1,34103195,34103248,H1|chr1:32402358-32402437,chr1,32402358,32402437,1,1700837
H1|chr1:38532892-38532993,chr1,38532892,38532993,H1|chr1:27664891-27664940,chr1,27664891,27664940,1,10868001
H1|chr1:38538477-38538541,chr1,38538477,38538541,H1|chr1:6299990-6300076,chr1,6299990,6300076,1,32238487
H1|chr1:38539634-38539669,chr1,38539634,38539669,H1|chr1:40205399-40205531,chr1,40205399,40205531,1,1665765
H1|chr1:38553195-38553259,chr1,38553195,38553259,H1|chr1:109235987-109236058,chr1,109235987,109236058,1,70682792
H1|chr1:38553195-38553226,chr1,38553195,38553226,H1|chr1:109235987-109236058,chr1,109235987,109236058,1,70682792
H1|chr1:38560173-38560250,chr1,38560173,38560250,H1|chr1:40205074-40205133,chr1,40205074,40205133,1,1644901
H1|chr1:38560182-38560250,chr1,38560182,38560250,H1|chr1:40205074-40205133,chr1,40205074,40205133,1,1644892
H1|chr1:39462997-39463022,chr1,39462997,39463022,H1|chr1:39569810-39569908,chr1,39569810,39569908,1,106813
H1|chr1:39463263-39463319,chr1,39463263,39463319,H1|chr1:39572206-39572301,chr1,39572206,39572301,1,108943
H1|chr1:39463322-39463345,chr1,39463322,39463345,H1|chr1:39572206-39572301,chr1,39572206,39572301,1,108884
H1|chr1:39465409-39465488,chr1,39465409,39465488,H1|chr1:36855361-36855422,chr1,36855361,36855422,1,2610048
H1|chr1:39465414-39465488,chr1,39465414,39465488,H1|chr1:36855361-36855422,chr1,36855361,36855422,1,2610053
H1|chr1:39467596-39467631,chr1,39467596,39467631,H1|chr1:39490404-39490554,chr1,39490404,39490554,1,22808
H1|chr1:39468455-39468497,chr1,39468455,39468497,H1|chr1:38479287-38479340,chr1,38479287,38479340,1,989168
H1|chr1:39471776-39471898,chr1,39471776,39471898,H1|chr1:39487313-39487347,chr1,39487313,39487347,1,15537
H1|chr1:39471782-39471898,chr1,39471782,39471898,H1|chr1:39487313-39487347,chr1,39487313,39487347,1,15531
H1|chr1:39472151-39472175,chr1,39472151,39472175,H1|chr1:38478788-38478876,chr1,38478788,38478876,1,993363
H1|chr1:39472151-39472174,chr1,39472151,39472174,H1|chr1:38478788-38478876,chr1,38478788,38478876,1,993363
H1|chr1:39475819-39475969,chr1,39475819,39475969,H1|chr1:36854280-36854430,chr1,36854280,36854430,1,2621539
H1|chr1:39481585-39481692,chr1,39481585,39481692,H1|chr1:39488015-39488058,chr1,39488015,39488058,1,6430
H1|chr1:39481589-39481693,chr1,39481589,39481693,H1|chr1:39488015-39488058,chr1,39488015,39488058,1,6426
H1|chr1:39482675-39482717,chr1,39482675,39482717,H1|chr1:39488838-39488959,chr1,39488838,39488959,1,6163
H1|chr1:39482688-39482717,chr1,39482688,39482717,H1|chr1:39488838-39488959,chr1,39488838,39488959,1,6150
H1|chr1:39597930-39598025,chr1,39597930,39598025,H1|chr1:36920007-36920076,chr1,36920007,36920076,1,2677923
H1|chr1:39597945-39598026,chr1,39597945,39598026,H1|chr1:36920007-36920076,chr1,36920007,36920076,1,2677938
H1|chr1:39619093-39619138,chr1,39619093,39619138,H1|chr1:86046742-86046792,chr1,86046742,86046792,1,46427649
H1|chr1:39627854-39627980,chr1,39627854,39627980,H1|chr1:38231511-38231530,chr1,38231511,38231530,1,1396343
H1|chr1:41839337-41839459,chr1,41839337,41839459,H1|chr1:40994911-40994935,chr1,40994911,40994935,1,844426
H1|chr1:41839421-41839459,chr1,41839421,41839459,H1|chr1:40994875-40994935,chr1,40994875,40994935,1,844546
H1|chr1:43403256-43403308,chr1,43403256,43403308,H1|chr1:213034651-213034719,chr1,213034651,213034719,1,169631395
H1|chr1:43405860-43405898,chr1,43405860,43405898,H1|chr1:120255826-120255892,chr1,120255826,120255892,1,76849966
H1|chr1:43411323-43411400,chr1,43411323,43411400,H1|chr1:47800592-47800649,chr1,47800592,47800649,1,4389269
H1|chr1:43437669-43437742,chr1,43437669,43437742,H1|chr1:45312261-45312280,chr1,45312261,45312280,1,1874592
H1|chr1:43437670-43437742,chr1,43437670,43437742,H1|chr1:45312261-45312280,chr1,45312261,45312280,1,1874591
H1|chr1:43472704-43472774,chr1,43472704,43472774,H1|chr1:43427836-43427911,chr1,43427836,43427911,1,44868
H1|chr1:43472752-43472901,chr1,43472752,43472901,H1|chr1:43427836-43427911,chr1,43427836,43427911,1,44916
H1|chr1:43472763-43472827,chr1,43472763,43472827,H1|chr1:43421862-43421996,chr1,43421862,43421996,1,50901
H1|chr1:43472763-43472826,chr1,43472763,43472826,H1|chr1:43421862-43421996,chr1,43421862,43421996,1,50901
H1|chr1:44022627-44022667,chr1,44022627,44022667,H1|chr1:43150232-43150342,chr1,43150232,43150342,1,872395
H1|chr1:44705658-44705753,chr1,44705658,44705753,H1|chr1:36024278-36024313,chr1,36024278,36024313,1,8681380
H1|chr1:44705659-44705753,chr1,44705659,44705753,H1|chr1:36024278-36024313,chr1,36024278,36024313,1,8681381
H1|chr1:44705659-44705748,chr1,44705659,44705748,H1|chr1:36024278-36024312,chr1,36024278,36024312,1,8681381
H1|chr1:44804532-44804600,chr1,44804532,44804600,H1|chr1:150266946-150267002,chr1,150266946,150267002,1,105462414
H1|chr1:44804533-44804600,chr1,44804533,44804600,H1|chr1:150266945-150267002,chr1,150266945,150267002,1,105462412
H1|chr1:44945394-44945491,chr1,44945394,44945491,H1|chr1:100597556-100597658,chr1,100597556,100597658,1,55652162
H1|chr1:44945394-44945458,chr1,44945394,44945458,H1|chr1:100597556-100597658,chr1,100597556,100597658,1,55652162
H1|chr1:44945443-44945491,chr1,44945443,44945491,H1|chr1:100597556-100597658,chr1,100597556,100597658,1,55652113
H1|chr1:44950815-44950840,chr1,44950815,44950840,H1|chr1:6547221-6547266,chr1,6547221,6547266,1,38403594
H1|chr1:44994866-44994969,chr1,44994866,44994969,H1|chr1:113496707-113496769,chr1,113496707,113496769,1,68501841
H1|chr1:44994866-44994948,chr1,44994866,44994948,H1|chr1:113496707-113496775,chr1,113496707,113496775,1,68501841
H1|chr1:44994866-44994898,chr1,44994866,44994898,H1|chr1:113496707-113496769,chr1,113496707,113496769,1,68501841
H1|chr1:45017479-45017561,chr1,45017479,45017561,H1|chr1:44818973-44819006,chr1,44818973,44819006,1,198506
H1|chr1:45017479-45017559,chr1,45017479,45017559,H1|chr1:44818973-44819006,chr1,44818973,44819006,1,198506
H1|chr1:45018056-45018138,chr1,45018056,45018138,H1|chr1:27666674-27666731,chr1,27666674,27666731,1,17351382
H1|chr1:45038281-45038344,chr1,45038281,45038344,H1|chr1:44819210-44819275,chr1,44819210,44819275,1,219071
H1|chr1:45052738-45052785,chr1,45052738,45052785,H1|chr1:27672171-27672199,chr1,27672171,27672199,1,17380567
H1|chr1:46870150-46870178,chr1,46870150,46870178,H1|chr1:212967439-212967534,chr1,212967439,212967534,1,166097289
H1|chr1:46936810-46936830,chr1,46936810,46936830,H1|chr1:173987813-173987943,chr1,173987813,173987943,1,127051003
H1|chr1:54741393-54741451,chr1,54741393,54741451,H1|chr1:32862687-32862833,chr1,32862687,32862833,1,21878706
H1|chr1:54742477-54742554,chr1,54742477,54742554,H1|chr1:43425691-43425748,chr1,43425691,43425748,1,11316786
H1|chr1:54749088-54749144,chr1,54749088,54749144,H1|chr1:57043510-57043603,chr1,57043510,57043603,1,2294422
H1|chr1:54755077-54755159,chr1,54755077,54755159,H1|chr1:57043510-57043603,chr1,57043510,57043603,1,2288433
H1|chr1:54767783-54767860,chr1,54767783,54767860,H1|chr1:16677890-16677932,chr1,16677890,16677932,1,38089893
H1|chr1:54782999-54783088,chr1,54782999,54783088,H1|chr1:62662362-62662423,chr1,62662362,62662423,1,7879363
H1|chr1:54793284-54793303,chr1,54793284,54793303,H1|chr1:113497846-113497932,chr1,113497846,113497932,1,58704562
H1|chr1:54809628-54809706,chr1,54809628,54809706,H1|chr1:62664118-62664190,chr1,62664118,62664190,1,7854490
H1|chr1:54817188-54817214,chr1,54817188,54817214,H1|chr1:93912336-93912415,chr1,93912336,93912415,1,39095148
H1|chr1:54817189-54817214,chr1,54817189,54817214,H1|chr1:93912336-93912415,chr1,93912336,93912415,1,39095147
H1|chr1:54826225-54826315,chr1,54826225,54826315,H1|chr1:62664516-62664573,chr1,62664516,62664573,1,7838291
H1|chr1:54834282-54834309,chr1,54834282,54834309,H1|chr1:1287733-1287833,chr1,1287733,1287833,1,53546549
H1|chr1:54834282-54834308,chr1,54834282,54834308,H1|chr1:1287733-1287833,chr1,1287733,1287833,1,53546549
H1|chr1:54836503-54836583,chr1,54836503,54836583,H1|chr1:8761281-8761330,chr1,8761281,8761330,1,46075222
H1|chr1:54836506-54836583,chr1,54836506,54836583,H1|chr1:8761281-8761330,chr1,8761281,8761330,1,46075225
H1|chr1:54847009-54847090,chr1,54847009,54847090,H1|chr1:51703507-51703545,chr1,51703507,51703545,1,3143502
H1|chr1:54847009-54847055,chr1,54847009,54847055,H1|chr1:51703507-51703545,chr1,51703507,51703545,1,3143502
H1|chr1:54848931-54849022,chr1,54848931,54849022,H1|chr1:43425525-43425582,chr1,43425525,43425582,1,11423406
H1|chr1:54848931-54849020,chr1,54848931,54849020,H1|chr1:43425525-43425582,chr1,43425525,43425582,1,11423406
H1|chr1:54850608-54850635,chr1,54850608,54850635,H1|chr1:43425628-43425721,chr1,43425628,43425721,1,11424980
H1|chr1:54850611-54850635,chr1,54850611,54850635,H1|chr1:43425628-43425721,chr1,43425628,43425721,1,11424983
H1|chr1:54851369-54851488,chr1,54851369,54851488,H1|chr1:57111896-57111925,chr1,57111896,57111925,1,2260527
H1|chr1:54851370-54851479,chr1,54851370,54851479,H1|chr1:57111896-57111925,chr1,57111896,57111925,1,2260526
H1|chr1:54854384-54854430,chr1,54854384,54854430,H1|chr1:62664287-62664370,chr1,62664287,62664370,1,7809903
H1|chr1:56976423-56976489,chr1,56976423,56976489,H1|chr1:64240704-64240747,chr1,64240704,64240747,1,7264281
H1|chr1:56998025-56998078,chr1,56998025,56998078,H1|chr1:156700156-156700249,chr1,156700156,156700249,1,99702131
H1|chr1:56998026-56998080,chr1,56998026,56998080,H1|chr1:156700156-156700249,chr1,156700156,156700249,1,99702130
H1|chr1:57006439-57006523,chr1,57006439,57006523,H1|chr1:200381605-200381652,chr1,200381605,200381652,1,143375166
H1|chr1:57025667-57025718,chr1,57025667,57025718,H1|chr1:200381594-200381631,chr1,200381594,200381631,1,143355927
H1|chr1:57025670-57025718,chr1,57025670,57025718,H1|chr1:200381594-200381631,chr1,200381594,200381631,1,143355924
H1|chr1:57036990-57037008,chr1,57036990,57037008,H1|chr1:63153325-63153411,chr1,63153325,63153411,1,6116335
H1|chr1:57036990-57037007,chr1,57036990,57037007,H1|chr1:63153325-63153411,chr1,63153325,63153411,1,6116335
H1|chr1:62314296-62314351,chr1,62314296,62314351,H1|chr1:62663305-62663377,chr1,62663305,62663377,1,349009
H1|chr1:62317576-62317672,chr1,62317576,62317672,H1|chr1:62663363-62663513,chr1,62663363,62663513,1,345787
H1|chr1:62694417-62694526,chr1,62694417,62694526,H1|chr1:62664118-62664180,chr1,62664118,62664180,1,30299
H1|chr1:62694438-62694526,chr1,62694438,62694526,H1|chr1:62664118-62664180,chr1,62664118,62664180,1,30320
H1|chr1:62694642-62694782,chr1,62694642,62694782,H1|chr1:62664471-62664591,chr1,62664471,62664591,1,30171
H1|chr1:62695180-62695207,chr1,62695180,62695207,H1|chr1:62663157-62663254,chr1,62663157,62663254,1,32023
H1|chr1:62695895-62695961,chr1,62695895,62695961,H1|chr1:62664591-62664710,chr1,62664591,62664710,1,31304
H1|chr1:62695930-62695961,chr1,62695930,62695961,H1|chr1:62664591-62664710,chr1,62664591,62664710,1,31339
H1|chr1:62697006-62697106,chr1,62697006,62697106,H1|chr1:62661560-62661590,chr1,62661560,62661590,1,35446
H1|chr1:62697757-62697797,chr1,62697757,62697797,H1|chr1:62661337-62661447,chr1,62661337,62661447,1,36420
H1|chr1:62698420-62698561,chr1,62698420,62698561,H1|chr1:62665219-62665287,chr1,62665219,62665287,1,33201
H1|chr1:62698474-62698556,chr1,62698474,62698556,H1|chr1:62665219-62665287,chr1,62665219,62665287,1,33255
H1|chr1:62698579-62698599,chr1,62698579,62698599,H1|chr1:62663454-62663572,chr1,62663454,62663572,1,35125
H1|chr1:62698866-62698935,chr1,62698866,62698935,H1|chr1:62664559-62664647,chr1,62664559,62664647,1,34307
H1|chr1:62698866-62698928,chr1,62698866,62698928,H1|chr1:62664559-62664647,chr1,62664559,62664647,1,34307
H1|chr1:62698870-62699017,chr1,62698870,62699017,H1|chr1:62663255-62663293,chr1,62663255,62663293,1,35615
H1|chr1:62698932-62699044,chr1,62698932,62699044,H1|chr1:62663255-62663293,chr1,62663255,62663293,1,35677
H1|chr1:62698994-62699074,chr1,62698994,62699074,H1|chr1:62664035-62664099,chr1,62664035,62664099,1,34959
H1|chr1:62699608-62699731,chr1,62699608,62699731,H1|chr1:62663973-62663993,chr1,62663973,62663993,1,35635
H1|chr1:62701113-62701182,chr1,62701113,62701182,H1|chr1:62661636-62661714,chr1,62661636,62661714,1,39477
H1|chr1:62701137-62701262,chr1,62701137,62701262,H1|chr1:62664146-62664170,chr1,62664146,62664170,1,36991
H1|chr1:62701186-62701336,chr1,62701186,62701336,H1|chr1:62661636-62661714,chr1,62661636,62661714,1,39550
H1|chr1:62872690-62872822,chr1,62872690,62872822,H1|chr1:76254250-76254289,chr1,76254250,76254289,1,13381560
H1|chr1:62872690-62872801,chr1,62872690,62872801,H1|chr1:76254250-76254289,chr1,76254250,76254289,1,13381560
H1|chr1:64263017-64263043,chr1,64263017,64263043,H1|chr1:78442373-78442520,chr1,78442373,78442520,1,14179356
H1|chr1:64311263-64311319,chr1,64311263,64311319,H1|chr1:156306555-156306622,chr1,156306555,156306622,1,91995292
H1|chr1:64314070-64314117,chr1,64314070,64314117,H1|chr1:62664107-62664178,chr1,62664107,62664178,1,1649963
H1|chr1:64316750-64316840,chr1,64316750,64316840,H1|chr1:62662226-62662269,chr1,62662226,62662269,1,1654524
H1|chr1:64322981-64323066,chr1,64322981,64323066,H1|chr1:16537031-16537093,chr1,16537031,16537093,1,47785950
H1|chr1:64322981-64323065,chr1,64322981,64323065,H1|chr1:16537031-16537093,chr1,16537031,16537093,1,47785950
H1|chr1:64942462-64942501,chr1,64942462,64942501,H1|chr1:62664357-62664401,chr1,62664357,62664401,1,2278105
H1|chr1:64949481-64949547,chr1,64949481,64949547,H1|chr1:15254131-15254203,chr1,15254131,15254203,1,49695350
H1|chr1:64985553-64985626,chr1,64985553,64985626,H1|chr1:41442828-41442978,chr1,41442828,41442978,1,23542725
H1|chr1:64992490-64992557,chr1,64992490,64992557,H1|chr1:62662729-62662808,chr1,62662729,62662808,1,2329761
H1|chr1:64992492-64992556,chr1,64992492,64992556,H1|chr1:62662729-62662808,chr1,62662729,62662808,1,2329763
H1|chr1:90403795-90403857,chr1,90403795,90403857,H1|chr1:90309796-90309866,chr1,90309796,90309866,1,93999
H1|chr1:90405003-90405066,chr1,90405003,90405066,H1|chr1:90310869-90310893,chr1,90310869,90310893,1,94134
H1|chr1:93569331-93569419,chr1,93569331,93569419,H1|chr1:156700779-156700844,chr1,156700779,156700844,1,63131448
H1|chr1:93569334-93569419,chr1,93569334,93569419,H1|chr1:156700779-156700844,chr1,156700779,156700844,1,63131445
H1|chr1:93569475-93569625,chr1,93569475,93569625,H1|chr1:53190169-53190215,chr1,53190169,53190215,1,40379306
H1|chr1:93569534-93569659,chr1,93569534,93569659,H1|chr1:53190165-53190215,chr1,53190165,53190215,1,40379369
H1|chr1:93570700-93570806,chr1,93570700,93570806,H1|chr1:11728473-11728508,chr1,11728473,11728508,1,81842227
H1|chr1:93570726-93570806,chr1,93570726,93570806,H1|chr1:11728473-11728508,chr1,11728473,11728508,1,81842253
H1|chr1:109642826-109642943,chr1,109642826,109642943,H1|chr1:27669232-27669345,chr1,27669232,27669345,1,81973594
H1|chr1:109642827-109642943,chr1,109642827,109642943,H1|chr1:27669232-27669345,chr1,27669232,27669345,1,81973595
H1|chr1:109642908-109642945,chr1,109642908,109642945,H1|chr1:27669232-27669345,chr1,27669232,27669345,1,81973676
H1|chr1:109782097-109782193,chr1,109782097,109782193,H1|chr1:109757297-109757326,chr1,109757297,109757326,1,24800
H1|chr1:109782836-109782970,chr1,109782836,109782970,H1|chr1:109757476-109757516,chr1,109757476,109757516,1,25360
H1|chr1:109782836-109782946,chr1,109782836,109782946,H1|chr1:109757476-109757516,chr1,109757476,109757516,1,25360
H1|chr1:109783713-109783847,chr1,109783713,109783847,H1|chr1:62660926-62660950,chr1,62660926,62660950,1,47122787
H1|chr1:109783724-109783847,chr1,109783724,109783847,H1|chr1:62660926-62660950,chr1,62660926,62660950,1,47122798
H1|chr1:109923520-109923611,chr1,109923520,109923611,H1|chr1:200380942-200381001,chr1,200380942,200381001,1,90457422
H1|chr1:109923520-109923559,chr1,109923520,109923559,H1|chr1:200380942-200381014,chr1,200380942,200381014,1,90457422
H1|chr1:113392662-113392693,chr1,113392662,113392693,H1|chr1:113498953-113499075,chr1,113498953,113499075,1,106291
H1|chr1:113392665-113392693,chr1,113392665,113392693,H1|chr1:113498953-113499075,chr1,113498953,113499075,1,106288
H1|chr1:113392714-113392743,chr1,113392714,113392743,H1|chr1:113498957-113499072,chr1,113498957,113499072,1,106243
H1|chr1:114660391-114660497,chr1,114660391,114660497,H1|chr1:76254163-76254212,chr1,76254163,76254212,1,38406228
H1|chr1:114660432-114660497,chr1,114660432,114660497,H1|chr1:76254163-76254212,chr1,76254163,76254212,1,38406269
H1|chr1:144594097-144594214,chr1,144594097,144594214,H1|chr1:148556612-148556762,chr1,148556612,148556762,1,3962515
H1|chr1:144594127-144594250,chr1,144594127,144594250,H1|chr1:148556466-148556616,chr1,148556466,148556616,1,3962339
H1|chr1:144595191-144595300,chr1,144595191,144595300,H1|chr1:148557601-148557656,chr1,148557601,148557656,1,3962410
H1|chr1:144595676-144595712,chr1,144595676,144595712,H1|chr1:148558086-148558235,chr1,148558086,148558235,1,3962410
H1|chr1:144595803-144595856,chr1,144595803,144595856,H1|chr1:148558160-148558307,chr1,148558160,148558307,1,3962357
H1|chr1:144595829-144595952,chr1,144595829,144595952,H1|chr1:148556783-148556810,chr1,148556783,148556810,1,3960954
H1|chr1:144596184-144596217,chr1,144596184,144596217,H1|chr1:148558551-148558700,chr1,148558551,148558700,1,3962367
H1|chr1:144596399-144596549,chr1,144596399,144596549,H1|chr1:148558227-148558286,chr1,148558227,148558286,1,3961828
H1|chr1:144597995-144598145,chr1,144597995,144598145,H1|chr1:148560467-148560617,chr1,148560467,148560617,1,3962472
H1|chr1:144598225-144598375,chr1,144598225,144598375,H1|chr1:148560509-148560659,chr1,148560509,148560659,1,3962284
H1|chr1:144598629-144598762,chr1,144598629,144598762,H1|chr1:148556781-148556834,chr1,148556781,148556834,1,3958152
H1|chr1:147926550-147926578,chr1,147926550,147926578,H1|chr1:171455045-171455153,chr1,171455045,171455153,1,23528495
H1|chr1:147926551-147926578,chr1,147926551,147926578,H1|chr1:171455045-171455153,chr1,171455045,171455153,1,23528494
H1|chr1:147997579-147997729,chr1,147997579,147997729,H1|chr1:148763364-148763514,chr1,148763364,148763514,1,765785
H1|chr1:147997625-147997775,chr1,147997625,147997775,H1|chr1:148763414-148763563,chr1,148763414,148763563,1,765789
H1|chr1:149286265-149286415,chr1,149286265,149286415,H1|chr1:149671939-149672016,chr1,149671939,149672016,1,385674
H1|chr1:149286297-149286447,chr1,149286297,149286447,H1|chr1:149671927-149671988,chr1,149671927,149671988,1,385630
H1|chr1:149286307-149286445,chr1,149286307,149286445,H1|chr1:149671938-149671972,chr1,149671938,149671972,1,385631
H1|chr1:149286325-149286454,chr1,149286325,149286454,H1|chr1:149671918-149672003,chr1,149671918,149672003,1,385593
H1|chr1:149286328-149286443,chr1,149286328,149286443,H1|chr1:149671938-149671972,chr1,149671938,149671972,1,385610
H1|chr1:149286339-149286450,chr1,149286339,149286450,H1|chr1:149671927-149671966,chr1,149671927,149671966,1,385588
H1|chr1:149286343-149286455,chr1,149286343,149286455,H1|chr1:149671939-149671991,chr1,149671939,149671991,1,385596
H1|chr1:149286345-149286463,chr1,149286345,149286463,H1|chr1:149671942-149671989,chr1,149671942,149671989,1,385597
H1|chr1:149286351-149286450,chr1,149286351,149286450,H1|chr1:149671927-149671991,chr1,149671927,149671991,1,385576
H1|chr1:149286357-149286455,chr1,149286357,149286455,H1|chr1:149671939-149671991,chr1,149671939,149671991,1,385582
H1|chr1:149286360-149286463,chr1,149286360,149286463,H1|chr1:149671942-149671989,chr1,149671942,149671989,1,385582
H1|chr1:149286361-149286450,chr1,149286361,149286450,H1|chr1:149671927-149671988,chr1,149671927,149671988,1,385566
H1|chr1:149286364-149286450,chr1,149286364,149286450,H1|chr1:149671927-149671991,chr1,149671927,149671991,1,385563
H1|chr1:149286389-149286450,chr1,149286389,149286450,H1|chr1:149671927-149671991,chr1,149671927,149671991,1,385538
H1|chr1:149286389-149286449,chr1,149286389,149286449,H1|chr1:149671927-149671991,chr1,149671927,149671991,1,385538
H1|chr1:149286391-149286450,chr1,149286391,149286450,H1|chr1:149671927-149671989,chr1,149671927,149671989,1,385536
H1|chr1:149286398-149286548,chr1,149286398,149286548,H1|chr1:149671924-149672028,chr1,149671924,149672028,1,385526
H1|chr1:149286407-149286516,chr1,149286407,149286516,H1|chr1:149671928-149671995,chr1,149671928,149671995,1,385521
H1|chr1:149286422-149286502,chr1,149286422,149286502,H1|chr1:149671946-149671972,chr1,149671946,149671972,1,385524
H1|chr1:149286422-149286492,chr1,149286422,149286492,H1|chr1:149671946-149671972,chr1,149671946,149671972,1,385524
H1|chr1:149286425-149286572,chr1,149286425,149286572,H1|chr1:149671971-149672054,chr1,149671971,149672054,1,385546
H1|chr1:149286427-149286512,chr1,149286427,149286512,H1|chr1:149671950-149672006,chr1,149671950,149672006,1,385523
H1|chr1:149286427-149286497,chr1,149286427,149286497,H1|chr1:149671939-149672016,chr1,149671939,149672016,1,385512
H1|chr1:149286433-149286516,chr1,149286433,149286516,H1|chr1:149671928-149671995,chr1,149671928,149671995,1,385495
H1|chr1:149286457-149286607,chr1,149286457,149286607,H1|chr1:149672177-149672327,chr1,149672177,149672327,1,385720
H1|chr1:149286470-149286620,chr1,149286470,149286620,H1|chr1:149671921-149671980,chr1,149671921,149671980,1,385451
H1|chr1:149286470-149286564,chr1,149286470,149286564,H1|chr1:149671950-149672006,chr1,149671950,149672006,1,385480
H1|chr1:149286474-149286500,chr1,149286474,149286500,H1|chr1:149671927-149672002,chr1,149671927,149672002,1,385453
H1|chr1:149286477-149286539,chr1,149286477,149286539,H1|chr1:149672017-149672081,chr1,149672017,149672081,1,385540
H1|chr1:149286484-149286565,chr1,149286484,149286565,H1|chr1:149671932-149672001,chr1,149671932,149672001,1,385448
H1|chr1:149286485-149286565,chr1,149286485,149286565,H1|chr1:149671932-149672002,chr1,149671932,149672002,1,385447
H1|chr1:149286956-149287049,chr1,149286956,149287049,H1|chr1:149672502-149672586,chr1,149672502,149672586,1,385546
H1|chr1:149286968-149287049,chr1,149286968,149287049,H1|chr1:149672464-149672595,chr1,149672464,149672595,1,385496
H1|chr1:149287048-149287117,chr1,149287048,149287117,H1|chr1:149672535-149672595,chr1,149672535,149672595,1,385487
H1|chr1:149287048-149287084,chr1,149287048,149287084,H1|chr1:149672536-149672595,chr1,149672536,149672595,1,385488
H1|chr1:149289523-149289559,chr1,149289523,149289559,H1|chr1:149674699-149674788,chr1,149674699,149674788,1,385176
H1|chr1:149291481-149291619,chr1,149291481,149291619,H1|chr1:149675740-149675835,chr1,149675740,149675835,1,384259
H1|chr1:150539792-150539852,chr1,150539792,150539852,H1|chr1:150531630-150531718,chr1,150531630,150531718,1,8162
H1|chr1:150540692-150540742,chr1,150540692,150540742,H1|chr1:150534225-150534312,chr1,150534225,150534312,1,6467
H1|chr1:150540692-150540740,chr1,150540692,150540740,H1|chr1:150534225-150534312,chr1,150534225,150534312,1,6467
H1|chr1:150541227-150541286,chr1,150541227,150541286,H1|chr1:150530600-150530664,chr1,150530600,150530664,1,10627
H1|chr1:150541227-150541282,chr1,150541227,150541282,H1|chr1:150530600-150530664,chr1,150530600,150530664,1,10627
H1|chr1:150544285-150544361,chr1,150544285,150544361,H1|chr1:150292114-150292143,chr1,150292114,150292143,1,252171
H1|chr1:150544285-150544342,chr1,150544285,150544342,H1|chr1:150292114-150292143,chr1,150292114,150292143,1,252171
H1|chr1:150544293-150544443,chr1,150544293,150544443,H1|chr1:150292114-150292143,chr1,150292114,150292143,1,252179
H1|chr1:150544331-150544443,chr1,150544331,150544443,H1|chr1:150292114-150292143,chr1,150292114,150292143,1,252217
H1|chr1:150545216-150545304,chr1,150545216,150545304,H1|chr1:150536007-150536157,chr1,150536007,150536157,1,9209
H1|chr1:150545530-150545561,chr1,150545530,150545561,H1|chr1:150536182-150536200,chr1,150536182,150536200,1,9348
H1|chr1:150614006-150614136,chr1,150614006,150614136,H1|chr1:150604751-150604771,chr1,150604751,150604771,1,9255
H1|chr1:150614006-150614131,chr1,150614006,150614131,H1|chr1:150604751-150604771,chr1,150604751,150604771,1,9255
H1|chr1:150614010-150614160,chr1,150614010,150614160,H1|chr1:150604751-150604771,chr1,150604751,150604771,1,9259
H1|chr1:153836618-153836756,chr1,153836618,153836756,H1|chr1:153939559-153939709,chr1,153939559,153939709,1,102941
H1|chr1:153837377-153837416,chr1,153837377,153837416,H1|chr1:153959862-153959949,chr1,153959862,153959949,1,122485
H1|chr1:153854692-153854778,chr1,153854692,153854778,H1|chr1:154244254-154244299,chr1,154244254,154244299,1,389562
H1|chr1:153854692-153854777,chr1,153854692,153854777,H1|chr1:154244253-154244300,chr1,154244253,154244300,1,389561
H1|chr1:156147638-156147729,chr1,156147638,156147729,H1|chr1:155170808-155170867,chr1,155170808,155170867,1,976830
H1|chr1:156147638-156147724,chr1,156147638,156147724,H1|chr1:155170803-155170867,chr1,155170803,155170867,1,976835
H1|chr1:156637285-156637407,chr1,156637285,156637407,H1|chr1:156644244-156644308,chr1,156644244,156644308,1,6959
H1|chr1:156637325-156637407,chr1,156637325,156637407,H1|chr1:156644244-156644308,chr1,156644244,156644308,1,6919
H1|chr1:156638102-156638213,chr1,156638102,156638213,H1|chr1:156645604-156645633,chr1,156645604,156645633,1,7502
H1|chr1:156638104-156638213,chr1,156638104,156638213,H1|chr1:156645604-156645633,chr1,156645604,156645633,1,7500
H1|chr1:156638218-156638249,chr1,156638218,156638249,H1|chr1:156644525-156644626,chr1,156644525,156644626,1,6307
H1|chr1:156659589-156659616,chr1,156659589,156659616,H1|chr1:156673740-156673815,chr1,156673740,156673815,1,14151
H1|chr1:156660868-156660996,chr1,156660868,156660996,H1|chr1:156673540-156673664,chr1,156673540,156673664,1,12672
H1|chr1:156660868-156660894,chr1,156660868,156660894,H1|chr1:156673540-156673664,chr1,156673540,156673664,1,12672
H1|chr1:156663127-156663173,chr1,156663127,156663173,H1|chr1:156675592-156675702,chr1,156675592,156675702,1,12465
H1|chr1:156663133-156663173,chr1,156663133,156663173,H1|chr1:156675592-156675702,chr1,156675592,156675702,1,12459
H1|chr1:156663326-156663377,chr1,156663326,156663377,H1|chr1:156676445-156676571,chr1,156676445,156676571,1,13119
H1|chr1:156663353-156663377,chr1,156663353,156663377,H1|chr1:156676445-156676571,chr1,156676445,156676571,1,13092
H1|chr1:158000333-158000400,chr1,158000333,158000400,H1|chr1:44116450-44116497,chr1,44116450,44116497,1,113883883
H1|chr1:158035427-158035529,chr1,158035427,158035529,H1|chr1:44116656-44116677,chr1,44116656,44116677,1,113918771
H1|chr1:158035428-158035529,chr1,158035428,158035529,H1|chr1:44116656-44116677,chr1,44116656,44116677,1,113918772
H1|chr1:162145248-162145339,chr1,162145248,162145339,H1|chr1:25559252-25559290,chr1,25559252,25559290,1,136585996
H1|chr1:164546914-164546933,chr1,164546914,164546933,H1|chr1:161736497-161736591,chr1,161736497,161736591,1,2810417
H1|chr1:164546914-164546932,chr1,164546914,164546932,H1|chr1:161736497-161736591,chr1,161736497,161736591,1,2810417
H1|chr1:164551858-164551933,chr1,164551858,164551933,H1|chr1:62661276-62661351,chr1,62661276,62661351,1,101890582
H1|chr1:164556946-164557036,chr1,164556946,164557036,H1|chr1:62665021-62665118,chr1,62665021,62665118,1,101891925
H1|chr1:164557693-164557737,chr1,164557693,164557737,H1|chr1:120254826-120254900,chr1,120254826,120254900,1,44302867
H1|chr1:164557694-164557737,chr1,164557694,164557737,H1|chr1:120254854-120254901,chr1,120254854,120254901,1,44302840
H1|chr1:164557736-164557788,chr1,164557736,164557788,H1|chr1:120254826-120254900,chr1,120254826,120254900,1,44302910
H1|chr1:164557737-164557789,chr1,164557737,164557789,H1|chr1:120254826-120254901,chr1,120254826,120254901,1,44302911
H1|chr1:164557742-164557789,chr1,164557742,164557789,H1|chr1:120254826-120254901,chr1,120254826,120254901,1,44302916
H1|chr1:164559334-164559461,chr1,164559334,164559461,H1|chr1:156859718-156859736,chr1,156859718,156859736,1,7699616
H1|chr1:164559358-164559461,chr1,164559358,164559461,H1|chr1:156859718-156859736,chr1,156859718,156859736,1,7699640
H1|chr1:164559365-164559461,chr1,164559365,164559461,H1|chr1:156859718-156859736,chr1,156859718,156859736,1,7699647
H1|chr1:164559377-164559461,chr1,164559377,164559461,H1|chr1:156859718-156859743,chr1,156859718,156859743,1,7699659
H1|chr1:164561095-164561154,chr1,164561095,164561154,H1|chr1:200381911-200382015,chr1,200381911,200382015,1,35820816
H1|chr1:164561108-164561154,chr1,164561108,164561154,H1|chr1:200381911-200382015,chr1,200381911,200382015,1,35820803
H1|chr1:164561410-164561428,chr1,164561410,164561428,H1|chr1:62664107-62664194,chr1,62664107,62664194,1,101897303
H1|chr1:164563711-164563780,chr1,164563711,164563780,H1|chr1:52455857-52455889,chr1,52455857,52455889,1,112107854
H1|chr1:164565554-164565621,chr1,164565554,164565621,H1|chr1:62664049-62664134,chr1,62664049,62664134,1,101901505
H1|chr1:164565560-164565621,chr1,164565560,164565621,H1|chr1:62664049-62664134,chr1,62664049,62664134,1,101901511
H1|chr1:164607751-164607809,chr1,164607751,164607809,H1|chr1:155540703-155540792,chr1,155540703,155540792,1,9067048
H1|chr1:164607751-164607808,chr1,164607751,164607808,H1|chr1:155540703-155540792,chr1,155540703,155540792,1,9067048
H1|chr1:164609381-164609443,chr1,164609381,164609443,H1|chr1:155102271-155102421,chr1,155102271,155102421,1,9507110
H1|chr1:164611294-164611371,chr1,164611294,164611371,H1|chr1:39326250-39326323,chr1,39326250,39326323,1,125285044
H1|chr1:164611294-164611370,chr1,164611294,164611370,H1|chr1:39326250-39326323,chr1,39326250,39326323,1,125285044
H1|chr1:164611295-164611419,chr1,164611295,164611419,H1|chr1:39326250-39326323,chr1,39326250,39326323,1,125285045
H1|chr1:164611586-164611604,chr1,164611586,164611604,H1|chr1:155538443-155538575,chr1,155538443,155538575,1,9073143
H1|chr1:164612824-164612912,chr1,164612824,164612912,H1|chr1:93915010-93915160,chr1,93915010,93915160,1,70697814
H1|chr1:165807198-165807276,chr1,165807198,165807276,H1|chr1:151513611-151513656,chr1,151513611,151513656,1,14293587
H1|chr1:165807258-165807276,chr1,165807258,165807276,H1|chr1:151513611-151513656,chr1,151513611,151513656,1,14293647
H1|chr1:165808984-165809059,chr1,165808984,165809059,H1|chr1:182762122-182762197,chr1,182762122,182762197,1,16953138
H1|chr1:165808993-165809059,chr1,165808993,165809059,H1|chr1:182762122-182762206,chr1,182762122,182762206,1,16953129
H1|chr1:165817539-165817573,chr1,165817539,165817573,H1|chr1:113616884-113616945,chr1,113616884,113616945,1,52200655
H1|chr1:167201795-167201921,chr1,167201795,167201921,H1|chr1:174844596-174844623,chr1,174844596,174844623,1,7642801
H1|chr1:167201795-167201918,chr1,167201795,167201918,H1|chr1:174844596-174844623,chr1,174844596,174844623,1,7642801
H1|chr1:167201796-167201921,chr1,167201796,167201921,H1|chr1:174844596-174844623,chr1,174844596,174844623,1,7642800
H1|chr1:167768697-167768749,chr1,167768697,167768749,H1|chr1:201944878-201944990,chr1,201944878,201944990,1,34176181
H1|chr1:167768702-167768744,chr1,167768702,167768744,H1|chr1:201944885-201944972,chr1,201944885,201944972,1,34176183
H1|chr1:168361698-168361750,chr1,168361698,168361750,H1|chr1:178064476-178064626,chr1,178064476,178064626,1,9702778
H1|chr1:168361698-168361748,chr1,168361698,168361748,H1|chr1:178064476-178064626,chr1,178064476,178064626,1,9702778
H1|chr1:173390772-173390825,chr1,173390772,173390825,H1|chr1:173448532-173448574,chr1,173448532,173448574,1,57760
H1|chr1:173390801-173390825,chr1,173390801,173390825,H1|chr1:173448532-173448574,chr1,173448532,173448574,1,57731
H1|chr1:173391465-173391498,chr1,173391465,173391498,H1|chr1:173442871-173442959,chr1,173442871,173442959,1,51406
H1|chr1:173393026-173393113,chr1,173393026,173393113,H1|chr1:173445770-173445838,chr1,173445770,173445838,1,52744
H1|chr1:173393031-173393113,chr1,173393031,173393113,H1|chr1:173445765-173445833,chr1,173445765,173445833,1,52734
H1|chr1:173393077-173393113,chr1,173393077,173393113,H1|chr1:173445770-173445787,chr1,173445770,173445787,1,52693
H1|chr1:173393792-173393832,chr1,173393792,173393832,H1|chr1:173442472-173442499,chr1,173442472,173442499,1,48680
H1|chr1:173394190-173394278,chr1,173394190,173394278,H1|chr1:173444379-173444431,chr1,173444379,173444431,1,50189
H1|chr1:173394677-173394695,chr1,173394677,173394695,H1|chr1:173443005-173443114,chr1,173443005,173443114,1,48328
H1|chr1:173399700-173399766,chr1,173399700,173399766,H1|chr1:173445930-173446008,chr1,173445930,173446008,1,46230
H1|chr1:173399701-173399766,chr1,173399701,173399766,H1|chr1:173445930-173446008,chr1,173445930,173446008,1,46229
H1|chr1:173408408-173408464,chr1,173408408,173408464,H1|chr1:173445839-173445879,chr1,173445839,173445879,1,37431
H1|chr1:173408683-173408740,chr1,173408683,173408740,H1|chr1:173444475-173444536,chr1,173444475,173444536,1,35792
H1|chr1:173409851-173409889,chr1,173409851,173409889,H1|chr1:173445833-173445910,chr1,173445833,173445910,1,35982
H1|chr1:173410988-173411066,chr1,173410988,173411066,H1|chr1:173445900-173445923,chr1,173445900,173445923,1,34912
H1|chr1:173410992-173411066,chr1,173410992,173411066,H1|chr1:173445900-173445923,chr1,173445900,173445923,1,34908
H1|chr1:173411114-173411153,chr1,173411114,173411153,H1|chr1:173445854-173445896,chr1,173445854,173445896,1,34740
H1|chr1:173411187-173411236,chr1,173411187,173411236,H1|chr1:173445836-173445933,chr1,173445836,173445933,1,34649
H1|chr1:173411706-173411750,chr1,173411706,173411750,H1|chr1:173441829-173441973,chr1,173441829,173441973,1,30123
H1|chr1:173411906-173411999,chr1,173411906,173411999,H1|chr1:173445244-173445306,chr1,173445244,173445306,1,33338
H1|chr1:173411911-173411999,chr1,173411911,173411999,H1|chr1:173445244-173445306,chr1,173445244,173445306,1,33333
H1|chr1:173413889-173414005,chr1,173413889,173414005,H1|chr1:173442583-173442651,chr1,173442583,173442651,1,28694
H1|chr1:173414905-173415015,chr1,173414905,173415015,H1|chr1:173445002-173445038,chr1,173445002,173445038,1,30097
H1|chr1:173415854-173415928,chr1,173415854,173415928,H1|chr1:173444950-173445006,chr1,173444950,173445006,1,29096
H1|chr1:173416597-173416681,chr1,173416597,173416681,H1|chr1:173444991-173445040,chr1,173444991,173445040,1,28394
H1|chr1:173416598-173416681,chr1,173416598,173416681,H1|chr1:173444991-173445040,chr1,173444991,173445040,1,28393
H1|chr1:173417317-173417424,chr1,173417317,173417424,H1|chr1:173445789-173445825,chr1,173445789,173445825,1,28472
H1|chr1:173606899-173606949,chr1,173606899,173606949,H1|chr1:173641053-173641106,chr1,173641053,173641106,1,34154
H1|chr1:173607111-173607173,chr1,173607111,173607173,H1|chr1:173640372-173640488,chr1,173640372,173640488,1,33261
H1|chr1:173607133-173607233,chr1,173607133,173607233,H1|chr1:173639303-173639337,chr1,173639303,173639337,1,32170
H1|chr1:173607139-173607173,chr1,173607139,173607173,H1|chr1:173640372-173640488,chr1,173640372,173640488,1,33233
H1|chr1:173607155-173607173,chr1,173607155,173607173,H1|chr1:173640372-173640447,chr1,173640372,173640447,1,33217
H1|chr1:173607574-173607667,chr1,173607574,173607667,H1|chr1:173639292-173639333,chr1,173639292,173639333,1,31718
H1|chr1:178255694-178255803,chr1,178255694,178255803,H1|chr1:45790789-45790827,chr1,45790789,45790827,1,132464905
H1|chr1:183006237-183006308,chr1,183006237,183006308,H1|chr1:235269818-235269868,chr1,235269818,235269868,1,52263581
H1|chr1:183006237-183006264,chr1,183006237,183006264,H1|chr1:235269818-235269867,chr1,235269818,235269867,1,52263581
H1|chr1:204057415-204057561,chr1,204057415,204057561,H1|chr1:213034078-213034165,chr1,213034078,213034165,1,8976663
H1|chr1:204057512-204057575,chr1,204057512,204057575,H1|chr1:213034078-213034165,chr1,213034078,213034165,1,8976566
H1|chr1:204063431-204063459,chr1,204063431,204063459,H1|chr1:203826574-203826712,chr1,203826574,203826712,1,236857
H1|chr1:204072188-204072263,chr1,204072188,204072263,H1|chr1:213034132-213034207,chr1,213034132,213034207,1,8961944
H1|chr1:204073448-204073471,chr1,204073448,204073471,H1|chr1:203765096-203765148,chr1,203765096,203765148,1,308352
H1|chr1:204081828-204081863,chr1,204081828,204081863,H1|chr1:224624835-224624890,chr1,224624835,224624890,1,20543007
H1|chr1:204259955-204260065,chr1,204259955,204260065,H1|chr1:204045403-204045425,chr1,204045403,204045425,1,214552
H1|chr1:204278049-204278115,chr1,204278049,204278115,H1|chr1:204047094-204047178,chr1,204047094,204047178,1,230955
H1|chr1:204544839-204544884,chr1,204544839,204544884,H1|chr1:205534520-205534567,chr1,205534520,205534567,1,989681
H1|chr1:204544840-204544884,chr1,204544840,204544884,H1|chr1:205534520-205534567,chr1,205534520,205534567,1,989680
H1|chr1:205280395-205280483,chr1,205280395,205280483,H1|chr1:16134831-16134861,chr1,16134831,16134861,1,189145564
H1|chr1:205280395-205280482,chr1,205280395,205280482,H1|chr1:16134831-16134861,chr1,16134831,16134861,1,189145564
H1|chr1:212924688-212924716,chr1,212924688,212924716,H1|chr1:154948691-154948809,chr1,154948691,154948809,1,57975997
H1|chr1:212926998-212927071,chr1,212926998,212927071,H1|chr1:224545167-224545195,chr1,224545167,224545195,1,11618169
H1|chr1:213081093-213081186,chr1,213081093,213081186,H1|chr1:213032695-213032739,chr1,213032695,213032739,1,48398
H1|chr1:213081700-213081780,chr1,213081700,213081780,H1|chr1:225998464-225998535,chr1,225998464,225998535,1,12916764
H1|chr1:213081745-213081853,chr1,213081745,213081853,H1|chr1:225998464-225998492,chr1,225998464,225998492,1,12916719
H1|chr1:213083263-213083331,chr1,213083263,213083331,H1|chr1:213030715-213030816,chr1,213030715,213030816,1,52548
H1|chr1:213083283-213083332,chr1,213083283,213083332,H1|chr1:213030715-213030816,chr1,213030715,213030816,1,52568
H1|chr1:213086850-213086936,chr1,213086850,213086936,H1|chr1:213035135-213035276,chr1,213035135,213035276,1,51715
H1|chr1:213087190-213087214,chr1,213087190,213087214,H1|chr1:213034485-213034527,chr1,213034485,213034527,1,52705
H1|chr1:213087526-213087639,chr1,213087526,213087639,H1|chr1:213033763-213033800,chr1,213033763,213033800,1,53763
H1|chr1:213091005-213091046,chr1,213091005,213091046,H1|chr1:213123468-213123532,chr1,213123468,213123532,1,32463
H1|chr1:213091113-213091202,chr1,213091113,213091202,H1|chr1:213126455-213126483,chr1,213126455,213126483,1,35342
H1|chr1:213091666-213091728,chr1,213091666,213091728,H1|chr1:213120365-213120411,chr1,213120365,213120411,1,28699
H1|chr1:213131400-213131422,chr1,213131400,213131422,H1|chr1:213034341-213034487,chr1,213034341,213034487,1,97059
H1|chr1:213132082-213132118,chr1,213132082,213132118,H1|chr1:213035285-213035424,chr1,213035285,213035424,1,96797
H1|chr1:213134701-213134811,chr1,213134701,213134811,H1|chr1:41830744-41830777,chr1,41830744,41830777,1,171303957
H1|chr1:213135994-213136021,chr1,213135994,213136021,H1|chr1:213033780-213033870,chr1,213033780,213033870,1,102214
H1|chr1:213136632-213136715,chr1,213136632,213136715,H1|chr1:213036101-213036133,chr1,213036101,213036133,1,100531
H1|chr1:213137746-213137855,chr1,213137746,213137855,H1|chr1:213034767-213034798,chr1,213034767,213034798,1,102979
H1|chr1:213140421-213140441,chr1,213140421,213140441,H1|chr1:213034116-213034224,chr1,213034116,213034224,1,106305
H1|chr1:213140421-213140439,chr1,213140421,213140439,H1|chr1:213034116-213034224,chr1,213034116,213034224,1,106305
H1|chr1:213141221-213141302,chr1,213141221,213141302,H1|chr1:213034451-213034520,chr1,213034451,213034520,1,106770
H1|chr1:213141225-213141303,chr1,213141225,213141303,H1|chr1:213034451-213034520,chr1,213034451,213034520,1,106774
H1|chr1:214614031-214614114,chr1,214614031,214614114,H1|chr1:214453069-214453180,chr1,214453069,214453180,1,160962
H1|chr1:214614031-214614070,chr1,214614031,214614070,H1|chr1:214453069-214453180,chr1,214453069,214453180,1,160962
H1|chr1:214625986-214626047,chr1,214625986,214626047,H1|chr1:214452008-214452080,chr1,214452008,214452080,1,173978
H1|chr1:223188614-223188651,chr1,223188614,223188651,H1|chr1:10005151-10005300,chr1,10005151,10005300,1,213183463
H1|chr1:223190644-223190664,chr1,223190644,223190664,H1|chr1:213034264-213034394,chr1,213034264,213034394,1,10156380
H1|chr1:223193534-223193565,chr1,223193534,223193565,H1|chr1:10004154-10004283,chr1,10004154,10004283,1,213189380
H1|chr1:223193534-223193555,chr1,223193534,223193555,H1|chr1:10004154-10004283,chr1,10004154,10004283,1,213189380
H1|chr1:223195102-223195198,chr1,223195102,223195198,H1|chr1:213033330-213033480,chr1,213033330,213033480,1,10161772
H1|chr1:223196979-223197067,chr1,223196979,223197067,H1|chr1:222883343-222883466,chr1,222883343,222883466,1,313636
H1|chr1:223196979-223196999,chr1,223196979,223196999,H1|chr1:222883343-222883466,chr1,222883343,222883466,1,313636
H1|chr1:223197984-223198061,chr1,223197984,223198061,H1|chr1:84544433-84544506,chr1,84544433,84544506,1,138653551
H1|chr1:223197986-223198061,chr1,223197986,223198061,H1|chr1:84544433-84544506,chr1,84544433,84544506,1,138653553
H1|chr1:223198739-223198789,chr1,223198739,223198789,H1|chr1:222887078-222887113,chr1,222887078,222887113,1,311661
H1|chr1:223202086-223202187,chr1,223202086,223202187,H1|chr1:213036018-213036067,chr1,213036018,213036067,1,10166068
H1|chr1:223205713-223205798,chr1,223205713,223205798,H1|chr1:224545401-224545421,chr1,224545401,224545421,1,1339688
H1|chr1:223205713-223205797,chr1,223205713,223205797,H1|chr1:224545401-224545421,chr1,224545401,224545421,1,1339688
H1|chr1:223205713-223205774,chr1,223205713,223205774,H1|chr1:224545401-224545421,chr1,224545401,224545421,1,1339688
H1|chr1:223205714-223205798,chr1,223205714,223205798,H1|chr1:224545401-224545421,chr1,224545401,224545421,1,1339687
H1|chr1:224011006-224011061,chr1,224011006,224011061,H1|chr1:213035035-213035127,chr1,213035035,213035127,1,10975971
H1|chr1:224395087-224395148,chr1,224395087,224395148,H1|chr1:224542771-224542847,chr1,224542771,224542847,1,147684
H1|chr1:225951134-225951224,chr1,225951134,225951224,H1|chr1:225962659-225962717,chr1,225962659,225962717,1,11525
H1|chr1:225953354-225953427,chr1,225953354,225953427,H1|chr1:225964104-225964236,chr1,225964104,225964236,1,10750
H1|chr1:227176244-227176269,chr1,227176244,227176269,H1|chr1:11717545-11717695,chr1,11717545,11717695,1,215458699
H1|chr1:227322398-227322485,chr1,227322398,227322485,H1|chr1:213125257-213125305,chr1,213125257,213125305,1,14197141
H1|chr1:228562226-228562313,chr1,228562226,228562313,H1|chr1:9241762-9241882,chr1,9241762,9241882,1,219320464
H1|chr1:229310620-229310694,chr1,229310620,229310694,H1|chr1:229548663-229548696,chr1,229548663,229548696,1,238043
H1|chr1:229310693-229310750,chr1,229310693,229310750,H1|chr1:229548719-229548777,chr1,229548719,229548777,1,238026
H1|chr1:229310939-229310989,chr1,229310939,229310989,H1|chr1:229548886-229548937,chr1,229548886,229548937,1,237947
H1|chr1:229311613-229311693,chr1,229311613,229311693,H1|chr1:229549460-229549517,chr1,229549460,229549517,1,237847
H1|chr1:229311620-229311736,chr1,229311620,229311736,H1|chr1:229549458-229549492,chr1,229549458,229549492,1,237838
H1|chr1:229311633-229311694,chr1,229311633,229311694,H1|chr1:229549472-229549529,chr1,229549472,229549529,1,237839
H1|chr1:229311729-229311774,chr1,229311729,229311774,H1|chr1:229549678-229549744,chr1,229549678,229549744,1,237949
H1|chr1:229312031-229312069,chr1,229312031,229312069,H1|chr1:229550025-229550124,chr1,229550025,229550124,1,237994
H1|chr1:229312201-229312258,chr1,229312201,229312258,H1|chr1:229550154-229550247,chr1,229550154,229550247,1,237953
H1|chr1:229312679-229312719,chr1,229312679,229312719,H1|chr1:229550283-229550339,chr1,229550283,229550339,1,237604
H1|chr1:229312682-229312740,chr1,229312682,229312740,H1|chr1:229550276-229550326,chr1,229550276,229550326,1,237594
H1|chr1:229312683-229312735,chr1,229312683,229312735,H1|chr1:229550283-229550327,chr1,229550283,229550327,1,237600
H1|chr1:229312691-229312728,chr1,229312691,229312728,H1|chr1:229550284-229550397,chr1,229550284,229550397,1,237593
H1|chr1:229312706-229312831,chr1,229312706,229312831,H1|chr1:229550204-229550258,chr1,229550204,229550258,1,237498
H1|chr1:229312732-229312831,chr1,229312732,229312831,H1|chr1:229550204-229550252,chr1,229550204,229550252,1,237472
H1|chr1:229312733-229312831,chr1,229312733,229312831,H1|chr1:229550204-229550252,chr1,229550204,229550252,1,237471
H1|chr1:229312770-229312829,chr1,229312770,229312829,H1|chr1:229550203-229550294,chr1,229550203,229550294,1,237433
H1|chr1:229312771-229312831,chr1,229312771,229312831,H1|chr1:229550204-229550294,chr1,229550204,229550294,1,237433
H1|chr1:229312785-229312825,chr1,229312785,229312825,H1|chr1:229550210-229550314,chr1,229550210,229550314,1,237425
H1|chr1:229313011-229313077,chr1,229313011,229313077,H1|chr1:229550965-229551011,chr1,229550965,229551011,1,237954
H1|chr1:229313092-229313174,chr1,229313092,229313174,H1|chr1:229551057-229551115,chr1,229551057,229551115,1,237965
H1|chr1:229313093-229313174,chr1,229313093,229313174,H1|chr1:229551057-229551115,chr1,229551057,229551115,1,237964
H1|chr1:229313103-229313174,chr1,229313103,229313174,H1|chr1:229551057-229551111,chr1,229551057,229551111,1,237954
H1|chr1:229313384-229313455,chr1,229313384,229313455,H1|chr1:229551334-229551371,chr1,229551334,229551371,1,237950
H1|chr1:229314094-229314156,chr1,229314094,229314156,H1|chr1:229551361-229551405,chr1,229551361,229551405,1,237267
H1|chr1:229315290-229315408,chr1,229315290,229315408,H1|chr1:229549899-229549944,chr1,229549899,229549944,1,234609
H1|chr1:229315303-229315408,chr1,229315303,229315408,H1|chr1:229549899-229549944,chr1,229549899,229549944,1,234596
H1|chr1:232246573-232246592,chr1,232246573,232246592,H1|chr1:225839810-225839958,chr1,225839810,225839958,1,6406763
H1|chr1:232254841-232254914,chr1,232254841,232254914,H1|chr1:154974144-154974194,chr1,154974144,154974194,1,77280697
H1|chr1:232254968-232255058,chr1,232254968,232255058,H1|chr1:39457411-39457456,chr1,39457411,39457456,1,192797557
H1|chr1:232254968-232255051,chr1,232254968,232255051,H1|chr1:39457411-39457456,chr1,39457411,39457456,1,192797557
H1|chr1:232255215-232255272,chr1,232255215,232255272,H1|chr1:229549464-229549494,chr1,229549464,229549494,1,2705751
H1|chr1:232255324-232255473,chr1,232255324,232255473,H1|chr1:229549458-229549492,chr1,229549458,229549492,1,2705866
H1|chr1:232255441-232255584,chr1,232255441,232255584,H1|chr1:229551337-229551388,chr1,229551337,229551388,1,2704104
H1|chr1:232255537-232255673,chr1,232255537,232255673,H1|chr1:154971268-154971345,chr1,154971268,154971345,1,77284269
H1|chr1:232255600-232255673,chr1,232255600,232255673,H1|chr1:154971268-154971345,chr1,154971268,154971345,1,77284332
H1|chr1:232258938-232259048,chr1,232258938,232259048,H1|chr1:229551323-229551392,chr1,229551323,229551392,1,2707615
H1|chr1:232259749-232259843,chr1,232259749,232259843,H1|chr1:211750354-211750382,chr1,211750354,211750382,1,20509395
H1|chr1:232259749-232259837,chr1,232259749,232259837,H1|chr1:211750354-211750382,chr1,211750354,211750382,1,20509395
H1|chr1:232259946-232260015,chr1,232259946,232260015,H1|chr1:245025639-245025692,chr1,245025639,245025692,1,12765693
H1|chr1:232259947-232260015,chr1,232259947,232260015,H1|chr1:245025639-245025692,chr1,245025639,245025692,1,12765692
H1|chr1:232259948-232260014,chr1,232259948,232260014,H1|chr1:245025639-245025692,chr1,245025639,245025692,1,12765691
H1|chr1:232260474-232260539,chr1,232260474,232260539,H1|chr1:229551326-229551370,chr1,229551326,229551370,1,2709148
H1|chr1:232260631-232260696,chr1,232260631,232260696,H1|chr1:32642426-32642469,chr1,32642426,32642469,1,199618205
H1|chr1:232264199-232264272,chr1,232264199,232264272,H1|chr1:39458209-39458286,chr1,39458209,39458286,1,192805990
H1|chr1:232264235-232264341,chr1,232264235,232264341,H1|chr1:224628383-224628412,chr1,224628383,224628412,1,7635852
H1|chr1:232264246-232264337,chr1,232264246,232264337,H1|chr1:233433698-233433809,chr1,233433698,233433809,1,1169452
H1|chr1:232264246-232264282,chr1,232264246,232264282,H1|chr1:233433698-233433809,chr1,233433698,233433809,1,1169452
H1|chr1:232264304-232264381,chr1,232264304,232264381,H1|chr1:6675654-6675721,chr1,6675654,6675721,1,225588650
H1|chr1:232264308-232264381,chr1,232264308,232264381,H1|chr1:6675654-6675721,chr1,6675654,6675721,1,225588654
H1|chr1:232266280-232266312,chr1,232266280,232266312,H1|chr1:233430135-233430219,chr1,233430135,233430219,1,1163855
H1|chr1:232266930-232266973,chr1,232266930,232266973,H1|chr1:229551315-229551411,chr1,229551315,229551411,1,2715615
H1|chr1:232267434-232267452,chr1,232267434,232267452,H1|chr1:32864247-32864305,chr1,32864247,32864305,1,199403187
H1|chr1:232269060-232269151,chr1,232269060,232269151,H1|chr1:245025666-245025725,chr1,245025666,245025725,1,12756606
H1|chr1:232271608-232271722,chr1,232271608,232271722,H1|chr1:245025565-245025606,chr1,245025565,245025606,1,12753957
H1|chr1:232271613-232271722,chr1,232271613,232271722,H1|chr1:245025565-245025606,chr1,245025565,245025606,1,12753952
H1|chr1:232272092-232272150,chr1,232272092,232272150,H1|chr1:178064305-178064351,chr1,178064305,178064351,1,54207787
H1|chr1:232272109-232272226,chr1,232272109,232272226,H1|chr1:229551316-229551349,chr1,229551316,229551349,1,2720793
H1|chr1:232272113-232272148,chr1,232272113,232272148,H1|chr1:229551298-229551369,chr1,229551298,229551369,1,2720815
H1|chr1:232275362-232275425,chr1,232275362,232275425,H1|chr1:229551323-229551408,chr1,229551323,229551408,1,2724039
H1|chr1:232275363-232275405,chr1,232275363,232275405,H1|chr1:229551323-229551408,chr1,229551323,229551408,1,2724040
H1|chr1:232276790-232276853,chr1,232276790,232276853,H1|chr1:229551314-229551370,chr1,229551314,229551370,1,2725476
H1|chr1:232276818-232276848,chr1,232276818,232276848,H1|chr1:229551317-229551404,chr1,229551317,229551404,1,2725501
H1|chr1:232277289-232277393,chr1,232277289,232277393,H1|chr1:25559252-25559290,chr1,25559252,25559290,1,206718037
H1|chr1:232278978-232279034,chr1,232278978,232279034,H1|chr1:224626350-224626406,chr1,224626350,224626406,1,7652628
H1|chr1:233249713-233249747,chr1,233249713,233249747,H1|chr1:33115836-33115916,chr1,33115836,33115916,1,200133877
H1|chr1:233249713-233249746,chr1,233249713,233249746,H1|chr1:33115836-33115916,chr1,33115836,33115916,1,200133877
H1|chr1:235835480-235835557,chr1,235835480,235835557,H1|chr1:213034879-213034924,chr1,213034879,213034924,1,22800601
H1|chr1:235840219-235840238,chr1,235840219,235840238,H1|chr1:151434320-151434433,chr1,151434320,151434433,1,84405899
H1|chr1:235840221-235840238,chr1,235840221,235840238,H1|chr1:151434320-151434433,chr1,151434320,151434433,1,84405901
H1|chr1:235844002-235844056,chr1,235844002,235844056,H1|chr1:213033749-213033834,chr1,213033749,213033834,1,22810253
H1|chr1:235845689-235845720,chr1,235845689,235845720,H1|chr1:247267051-247267156,chr1,247267051,247267156,1,11421362
H1|chr1:244979467-244979510,chr1,244979467,244979510,H1|chr1:244998093-244998216,chr1,244998093,244998216,1,18626
H1|chr1:244979480-244979620,chr1,244979480,244979620,H1|chr1:244998093-244998124,chr1,244998093,244998124,1,18613
H1|chr1:244979522-244979620,chr1,244979522,244979620,H1|chr1:244998093-244998124,chr1,244998093,244998124,1,18571
H1|chr1:244979557-244979620,chr1,244979557,244979620,H1|chr1:244998093-244998129,chr1,244998093,244998129,1,18536
H1|chr1:244979566-244979620,chr1,244979566,244979620,H1|chr1:244998093-244998193,chr1,244998093,244998193,1,18527
H1|chr1:244979576-244979620,chr1,244979576,244979620,H1|chr1:244998093-244998164,chr1,244998093,244998164,1,18517
H1|chr1:244979588-244979620,chr1,244979588,244979620,H1|chr1:244998093-244998140,chr1,244998093,244998140,1,18505
H1|chr1:244979589-244979620,chr1,244979589,244979620,H1|chr1:244998093-244998129,chr1,244998093,244998129,1,18504
H1|chr1:244979597-244979620,chr1,244979597,244979620,H1|chr1:244998093-244998170,chr1,244998093,244998170,1,18496
H1|chr1:244979600-244979620,chr1,244979600,244979620,H1|chr1:244998093-244998160,chr1,244998093,244998160,1,18493
H1|chr1:247500634-247500695,chr1,247500634,247500695,H1|chr1:247498241-247498391,chr1,247498241,247498391,1,2393
H1|chr1:247500737-247500824,chr1,247500737,247500824,H1|chr1:247499480-247499581,chr1,247499480,247499581,1,1257
H1|chr1:247500737-247500786,chr1,247500737,247500786,H1|chr1:247499480-247499581,chr1,247499480,247499581,1,1257
H1|chr1:247500778-247500844,chr1,247500778,247500844,H1|chr1:247499687-247499771,chr1,247499687,247499771,1,1091
H1|chr1:247500791-247500875,chr1,247500791,247500875,H1|chr1:247499489-247499564,chr1,247499489,247499564,1,1302
H1|chr1:247500810-247500875,chr1,247500810,247500875,H1|chr1:247499489-247499564,chr1,247499489,247499564,1,1321
H1|chr1:247500862-247500923,chr1,247500862,247500923,H1|chr1:247498694-247498764,chr1,247498694,247498764,1,2168
H1|chr1:247500918-247500969,chr1,247500918,247500969,H1|chr1:247498083-247498154,chr1,247498083,247498154,1,2835
H1|chr1:247538665-247538703,chr1,247538665,247538703,H1|chr1:247496652-247496744,chr1,247496652,247496744,1,42013
H1|chr2:3306765-3306821,chr2,3306765,3306821,H1|chr2:3626569-3626719,chr2,3626569,3626719,1,319804
H1|chr2:8013904-8013946,chr2,8013904,8013946,H1|chr2:176032563-176032624,chr2,176032563,176032624,1,168018659
H1|chr2:8013906-8013946,chr2,8013906,8013946,H1|chr2:176032563-176032624,chr2,176032563,176032624,1,168018657
H1|chr2:8017155-8017245,chr2,8017155,8017245,H1|chr2:44397944-44397966,chr2,44397944,44397966,1,36380789
H1|chr2:16087865-16087937,chr2,16087865,16087937,H1|chr2:16084497-16084563,chr2,16084497,16084563,1,3368
H1|chr2:16092022-16092101,chr2,16092022,16092101,H1|chr2:16085310-16085419,chr2,16085310,16085419,1,6712
H1|chr2:19428063-19428101,chr2,19428063,19428101,H1|chr2:219435070-219435136,chr2,219435070,219435136,1,200007007
H1|chr2:19428076-19428122,chr2,19428076,19428122,H1|chr2:219435091-219435195,chr2,219435091,219435195,1,200007015
H1|chr2:26762341-26762385,chr2,26762341,26762385,H1|chr2:26986715-26986795,chr2,26986715,26986795,1,224374
H1|chr2:26762475-26762548,chr2,26762475,26762548,H1|chr2:26986802-26986867,chr2,26986802,26986867,1,224327
H1|chr2:31556391-31556454,chr2,31556391,31556454,H1|chr2:68477743-68477794,chr2,68477743,68477794,1,36921352
H1|chr2:36597173-36597217,chr2,36597173,36597217,H1|chr2:37192803-37192827,chr2,37192803,37192827,1,595630
H1|chr2:36598908-36598950,chr2,36598908,36598950,H1|chr2:3626877-3626913,chr2,3626877,3626913,1,32972031
H1|chr2:36626660-36626695,chr2,36626660,36626695,H1|chr2:3621528-3621583,chr2,3621528,3621583,1,33005132
H1|chr2:36628755-36628812,chr2,36628755,36628812,H1|chr2:37192803-37192828,chr2,37192803,37192828,1,564048
H1|chr2:36628771-36628812,chr2,36628771,36628812,H1|chr2:37192803-37192828,chr2,37192803,37192828,1,564032
H1|chr2:42754861-42754961,chr2,42754861,42754961,H1|chr2:36584988-36585056,chr2,36584988,36585056,1,6169873
H1|chr2:42754862-42754985,chr2,42754862,42754985,H1|chr2:36584988-36585056,chr2,36584988,36585056,1,6169874
H1|chr2:42754903-42754985,chr2,42754903,42754985,H1|chr2:36584988-36585056,chr2,36584988,36585056,1,6169915
H1|chr2:44468276-44468309,chr2,44468276,44468309,H1|chr2:44390032-44390104,chr2,44390032,44390104,1,78244
H1|chr2:44468276-44468308,chr2,44468276,44468308,H1|chr2:44390032-44390104,chr2,44390032,44390104,1,78244
H1|chr2:44469260-44469293,chr2,44469260,44469293,H1|chr2:44390016-44390099,chr2,44390016,44390099,1,79244
H1|chr2:44469265-44469295,chr2,44469265,44469295,H1|chr2:44390032-44390104,chr2,44390032,44390104,1,79233
H1|chr2:44469265-44469293,chr2,44469265,44469293,H1|chr2:44390003-44390104,chr2,44390003,44390104,1,79262
H1|chr2:46935904-46936019,chr2,46935904,46936019,H1|chr2:25047649-25047727,chr2,25047649,25047727,1,21888255
H1|chr2:51229012-51229052,chr2,51229012,51229052,H1|chr2:220429367-220429425,chr2,220429367,220429425,1,169200355
H1|chr2:51229013-51229052,chr2,51229013,51229052,H1|chr2:220429367-220429425,chr2,220429367,220429425,1,169200354
H1|chr2:51229013-51229051,chr2,51229013,51229051,H1|chr2:220429367-220429425,chr2,220429367,220429425,1,169200354
H1|chr2:54798321-54798368,chr2,54798321,54798368,H1|chr2:48758191-48758263,chr2,48758191,48758263,1,6040130
H1|chr2:54798321-54798366,chr2,54798321,54798366,H1|chr2:48758191-48758263,chr2,48758191,48758263,1,6040130
H1|chr2:55353310-55353392,chr2,55353310,55353392,H1|chr2:55495140-55495208,chr2,55495140,55495208,1,141830
H1|chr2:55355970-55356071,chr2,55355970,55356071,H1|chr2:55500209-55500245,chr2,55500209,55500245,1,144239
H1|chr2:60728124-60728172,chr2,60728124,60728172,H1|chr2:56154642-56154705,chr2,56154642,56154705,1,4573482
H1|chr2:60728127-60728172,chr2,60728127,60728172,H1|chr2:56154642-56154705,chr2,56154642,56154705,1,4573485
H1|chr2:60730754-60730808,chr2,60730754,60730808,H1|chr2:96873342-96873400,chr2,96873342,96873400,1,36142588
H1|chr2:60730755-60730814,chr2,60730755,60730814,H1|chr2:96873342-96873401,chr2,96873342,96873401,1,36142587
H1|chr2:60740383-60740421,chr2,60740383,60740421,H1|chr2:96873342-96873400,chr2,96873342,96873400,1,36132959
H1|chr2:60740389-60740421,chr2,60740389,60740421,H1|chr2:96873342-96873400,chr2,96873342,96873400,1,36132953
H1|chr2:60742648-60742673,chr2,60742648,60742673,H1|chr2:9145767-9145825,chr2,9145767,9145825,1,51596881
H1|chr2:60742648-60742672,chr2,60742648,60742672,H1|chr2:9145767-9145825,chr2,9145767,9145825,1,51596881
H1|chr2:60751458-60751497,chr2,60751458,60751497,H1|chr2:61296130-61296185,chr2,61296130,61296185,1,544672
H1|chr2:60751458-60751496,chr2,60751458,60751496,H1|chr2:61296130-61296185,chr2,61296130,61296185,1,544672
H1|chr2:60757303-60757333,chr2,60757303,60757333,H1|chr2:64081478-64081617,chr2,64081478,64081617,1,3324175
H1|chr2:60766072-60766119,chr2,60766072,60766119,H1|chr2:64069624-64069712,chr2,64069624,64069712,1,3303552
H1|chr2:60769640-60769670,chr2,60769640,60769670,H1|chr2:64079254-64079343,chr2,64079254,64079343,1,3309614
H1|chr2:60770514-60770553,chr2,60770514,60770553,H1|chr2:64078995-64079070,chr2,64078995,64079070,1,3308481
H1|chr2:64010702-64010726,chr2,64010702,64010726,H1|chr2:64071696-64071819,chr2,64071696,64071819,1,60994
H1|chr2:64011572-64011611,chr2,64011572,64011611,H1|chr2:64066619-64066683,chr2,64066619,64066683,1,55047
H1|chr2:64093807-64093883,chr2,64093807,64093883,H1|chr2:160472120-160472198,chr2,160472120,160472198,1,96378313
H1|chr2:64093813-64093883,chr2,64093813,64093883,H1|chr2:160472120-160472198,chr2,160472120,160472198,1,96378307
H1|chr2:64093818-64093884,chr2,64093818,64093884,H1|chr2:160472120-160472198,chr2,160472120,160472198,1,96378302
H1|chr2:64094255-64094280,chr2,64094255,64094280,H1|chr2:88354550-88354648,chr2,88354550,88354648,1,24260295
H1|chr2:64095034-64095089,chr2,64095034,64095089,H1|chr2:63851164-63851220,chr2,63851164,63851220,1,243870
H1|chr2:64095034-64095087,chr2,64095034,64095087,H1|chr2:63851164-63851220,chr2,63851164,63851220,1,243870
H1|chr2:64101569-64101658,chr2,64101569,64101658,H1|chr2:85196063-85196108,chr2,85196063,85196108,1,21094494
H1|chr2:64102384-64102435,chr2,64102384,64102435,H1|chr2:85199583-85199633,chr2,85199583,85199633,1,21097199
H1|chr2:64103118-64103175,chr2,64103118,64103175,H1|chr2:63853479-63853556,chr2,63853479,63853556,1,249639
H1|chr2:64474683-64474710,chr2,64474683,64474710,H1|chr2:64074765-64074836,chr2,64074765,64074836,1,399918
H1|chr2:64474687-64474710,chr2,64474687,64474710,H1|chr2:64074765-64074836,chr2,64074765,64074836,1,399922
H1|chr2:64480528-64480594,chr2,64480528,64480594,H1|chr2:64077889-64077925,chr2,64077889,64077925,1,402639
H1|chr2:64481431-64481473,chr2,64481431,64481473,H1|chr2:27602472-27602529,chr2,27602472,27602529,1,36878959
H1|chr2:64481432-64481473,chr2,64481432,64481473,H1|chr2:27602472-27602529,chr2,27602472,27602529,1,36878960
H1|chr2:64482136-64482261,chr2,64482136,64482261,H1|chr2:64076404-64076433,chr2,64076404,64076433,1,405732
H1|chr2:64482140-64482261,chr2,64482140,64482261,H1|chr2:64076404-64076433,chr2,64076404,64076433,1,405736
H1|chr2:64482175-64482261,chr2,64482175,64482261,H1|chr2:64076404-64076433,chr2,64076404,64076433,1,405771
H1|chr2:64483069-64483148,chr2,64483069,64483148,H1|chr2:64072583-64072633,chr2,64072583,64072633,1,410486
H1|chr2:64486221-64486288,chr2,64486221,64486288,H1|chr2:64081445-64081506,chr2,64081445,64081506,1,404776
H1|chr2:64488985-64489087,chr2,64488985,64489087,H1|chr2:64370258-64370312,chr2,64370258,64370312,1,118727
H1|chr2:64488991-64489087,chr2,64488991,64489087,H1|chr2:64370258-64370312,chr2,64370258,64370312,1,118733
H1|chr2:64489451-64489557,chr2,64489451,64489557,H1|chr2:64369754-64369770,chr2,64369754,64369770,1,119697
H1|chr2:64489453-64489557,chr2,64489453,64489557,H1|chr2:64369754-64369770,chr2,64369754,64369770,1,119699
H1|chr2:64490877-64490931,chr2,64490877,64490931,H1|chr2:64370827-64370864,chr2,64370827,64370864,1,120050
H1|chr2:64491491-64491625,chr2,64491491,64491625,H1|chr2:64079813-64079834,chr2,64079813,64079834,1,411678
H1|chr2:64491496-64491625,chr2,64491496,64491625,H1|chr2:64079813-64079834,chr2,64079813,64079834,1,411683
H1|chr2:64494836-64494868,chr2,64494836,64494868,H1|chr2:64075685-64075783,chr2,64075685,64075783,1,419151
H1|chr2:64508322-64508375,chr2,64508322,64508375,H1|chr2:64079595-64079720,chr2,64079595,64079720,1,428727
H1|chr2:64508353-64508378,chr2,64508353,64508378,H1|chr2:64079595-64079720,chr2,64079595,64079720,1,428758
H1|chr2:64508702-64508787,chr2,64508702,64508787,H1|chr2:64078378-64078516,chr2,64078378,64078516,1,430324
H1|chr2:64511687-64511716,chr2,64511687,64511716,H1|chr2:64070923-64070997,chr2,64070923,64070997,1,440764
H1|chr2:64511687-64511715,chr2,64511687,64511715,H1|chr2:64070923-64070997,chr2,64070923,64070997,1,440764
H1|chr2:70974160-70974261,chr2,70974160,70974261,H1|chr2:100105776-100105803,chr2,100105776,100105803,1,29131616
H1|chr2:74213656-74213806,chr2,74213656,74213806,H1|chr2:74230236-74230363,chr2,74230236,74230363,1,16580
H1|chr2:74213725-74213833,chr2,74213725,74213833,H1|chr2:74230258-74230408,chr2,74230258,74230408,1,16533
H1|chr2:74220671-74220726,chr2,74220671,74220726,H1|chr2:74228258-74228371,chr2,74228258,74228371,1,7587
H1|chr2:74220684-74220703,chr2,74220684,74220703,H1|chr2:74227193-74227231,chr2,74227193,74227231,1,6509
H1|chr2:74220896-74220997,chr2,74220896,74220997,H1|chr2:74226838-74226869,chr2,74226838,74226869,1,5942
H1|chr2:74221464-74221528,chr2,74221464,74221528,H1|chr2:74228466-74228549,chr2,74228466,74228549,1,7002
H1|chr2:85168929-85169024,chr2,85168929,85169024,H1|chr2:85195472-85195498,chr2,85195472,85195498,1,26543
H1|chr2:85168929-85169023,chr2,85168929,85169023,H1|chr2:85195472-85195498,chr2,85195472,85195498,1,26543
H1|chr2:85172362-85172406,chr2,85172362,85172406,H1|chr2:85193658-85193724,chr2,85193658,85193724,1,21296
H1|chr2:85172666-85172717,chr2,85172666,85172717,H1|chr2:85195048-85195118,chr2,85195048,85195118,1,22382
H1|chr2:85175010-85175119,chr2,85175010,85175119,H1|chr2:85195480-85195504,chr2,85195480,85195504,1,20470
H1|chr2:85175028-85175176,chr2,85175028,85175176,H1|chr2:85195480-85195504,chr2,85195480,85195504,1,20452
H1|chr2:85177496-85177563,chr2,85177496,85177563,H1|chr2:85194536-85194626,chr2,85194536,85194626,1,17040
H1|chr2:85180325-85180372,chr2,85180325,85180372,H1|chr2:85197935-85198038,chr2,85197935,85198038,1,17610
H1|chr2:85180490-85180563,chr2,85180490,85180563,H1|chr2:85197461-85197559,chr2,85197461,85197559,1,16971
H1|chr2:85180511-85180563,chr2,85180511,85180563,H1|chr2:85197461-85197559,chr2,85197461,85197559,1,16950
H1|chr2:85180801-85180846,chr2,85180801,85180846,H1|chr2:85195503-85195634,chr2,85195503,85195634,1,14702
H1|chr2:85180827-85180846,chr2,85180827,85180846,H1|chr2:85195503-85195634,chr2,85195503,85195634,1,14676
H1|chr2:85181081-85181099,chr2,85181081,85181099,H1|chr2:85194170-85194315,chr2,85194170,85194315,1,13089
H1|chr2:85183644-85183743,chr2,85183644,85183743,H1|chr2:85193996-85194033,chr2,85193996,85194033,1,10352
H1|chr2:85183676-85183736,chr2,85183676,85183736,H1|chr2:85195377-85195474,chr2,85195377,85195474,1,11701
H1|chr2:85183681-85183743,chr2,85183681,85183743,H1|chr2:85196099-85196199,chr2,85196099,85196199,1,12418
H1|chr2:85183688-85183743,chr2,85183688,85183743,H1|chr2:85193996-85194033,chr2,85193996,85194033,1,10308
H1|chr2:85183688-85183736,chr2,85183688,85183736,H1|chr2:85195377-85195474,chr2,85195377,85195474,1,11689
H1|chr2:85183713-85183743,chr2,85183713,85183743,H1|chr2:85196099-85196199,chr2,85196099,85196199,1,12386
H1|chr2:85184236-85184280,chr2,85184236,85184280,H1|chr2:85195789-85195929,chr2,85195789,85195929,1,11553
H1|chr2:85184376-85184427,chr2,85184376,85184427,H1|chr2:85197430-85197535,chr2,85197430,85197535,1,13054
H1|chr2:85184377-85184463,chr2,85184377,85184463,H1|chr2:85195468-85195499,chr2,85195468,85195499,1,11091
H1|chr2:85184378-85184463,chr2,85184378,85184463,H1|chr2:85195468-85195499,chr2,85195468,85195499,1,11090
H1|chr2:85184382-85184427,chr2,85184382,85184427,H1|chr2:85197430-85197535,chr2,85197430,85197535,1,13048
H1|chr2:85184505-85184635,chr2,85184505,85184635,H1|chr2:85195405-85195424,chr2,85195405,85195424,1,10900
H1|chr2:85184748-85184843,chr2,85184748,85184843,H1|chr2:85193598-85193710,chr2,85193598,85193710,1,8850
H1|chr2:85184805-85184843,chr2,85184805,85184843,H1|chr2:85193598-85193710,chr2,85193598,85193710,1,8793
H1|chr2:85184848-85184930,chr2,85184848,85184930,H1|chr2:85194127-85194213,chr2,85194127,85194213,1,9279
H1|chr2:85184848-85184909,chr2,85184848,85184909,H1|chr2:85194127-85194213,chr2,85194127,85194213,1,9279
H1|chr2:85185278-85185374,chr2,85185278,85185374,H1|chr2:85196063-85196142,chr2,85196063,85196142,1,10785
H1|chr2:85185278-85185331,chr2,85185278,85185331,H1|chr2:85196063-85196142,chr2,85196063,85196142,1,10785
H1|chr2:85185584-85185620,chr2,85185584,85185620,H1|chr2:85195030-85195071,chr2,85195030,85195071,1,9446
H1|chr2:85185813-85185847,chr2,85185813,85185847,H1|chr2:85196941-85196996,chr2,85196941,85196996,1,11128
H1|chr2:85186117-85186221,chr2,85186117,85186221,H1|chr2:85196544-85196596,chr2,85196544,85196596,1,10427
H1|chr2:85186133-85186221,chr2,85186133,85186221,H1|chr2:85196544-85196596,chr2,85196544,85196596,1,10411
H1|chr2:85186175-85186325,chr2,85186175,85186325,H1|chr2:85197069-85197098,chr2,85197069,85197098,1,10894
H1|chr2:85186224-85186292,chr2,85186224,85186292,H1|chr2:85197005-85197076,chr2,85197005,85197076,1,10781
H1|chr2:85186270-85186386,chr2,85186270,85186386,H1|chr2:85197069-85197098,chr2,85197069,85197098,1,10799
H1|chr2:85186440-85186538,chr2,85186440,85186538,H1|chr2:85193425-85193520,chr2,85193425,85193520,1,6985
H1|chr2:85186483-85186538,chr2,85186483,85186538,H1|chr2:85193425-85193520,chr2,85193425,85193520,1,6942
H1|chr2:85186809-85186837,chr2,85186809,85186837,H1|chr2:85193643-85193765,chr2,85193643,85193765,1,6834
H1|chr2:85187194-85187241,chr2,85187194,85187241,H1|chr2:85194011-85194114,chr2,85194011,85194114,1,6817
H1|chr2:85187312-85187383,chr2,85187312,85187383,H1|chr2:85193850-85193886,chr2,85193850,85193886,1,6538
H1|chr2:85187563-85187597,chr2,85187563,85187597,H1|chr2:85193344-85193397,chr2,85193344,85193397,1,5781
H1|chr2:85187564-85187597,chr2,85187564,85187597,H1|chr2:85193344-85193397,chr2,85193344,85193397,1,5780
H1|chr2:85381698-85381727,chr2,85381698,85381727,H1|chr2:85194817-85194967,chr2,85194817,85194967,1,186881
H1|chr2:85386079-85386114,chr2,85386079,85386114,H1|chr2:85199386-85199484,chr2,85199386,85199484,1,186693
H1|chr2:85386440-85386508,chr2,85386440,85386508,H1|chr2:85194082-85194152,chr2,85194082,85194152,1,192358
H1|chr2:85386442-85386508,chr2,85386442,85386508,H1|chr2:85194082-85194152,chr2,85194082,85194152,1,192360
H1|chr2:85386738-85386824,chr2,85386738,85386824,H1|chr2:85193927-85193953,chr2,85193927,85193953,1,192811
H1|chr2:85386739-85386824,chr2,85386739,85386824,H1|chr2:85193927-85193953,chr2,85193927,85193953,1,192812
H1|chr2:85397213-85397306,chr2,85397213,85397306,H1|chr2:85195165-85195274,chr2,85195165,85195274,1,202048
H1|chr2:85397266-85397307,chr2,85397266,85397307,H1|chr2:85195165-85195274,chr2,85195165,85195274,1,202101
H1|chr2:85400675-85400715,chr2,85400675,85400715,H1|chr2:85199608-85199713,chr2,85199608,85199713,1,201067
H1|chr2:85415088-85415126,chr2,85415088,85415126,H1|chr2:85767259-85767322,chr2,85767259,85767322,1,352171
H1|chr2:85415478-85415507,chr2,85415478,85415507,H1|chr2:85197100-85197191,chr2,85197100,85197191,1,218378
H1|chr2:85415480-85415507,chr2,85415480,85415507,H1|chr2:85197100-85197191,chr2,85197100,85197191,1,218380
H1|chr2:85415893-85415959,chr2,85415893,85415959,H1|chr2:85767287-85767337,chr2,85767287,85767337,1,351394
H1|chr2:85418138-85418170,chr2,85418138,85418170,H1|chr2:75937290-75937384,chr2,75937290,75937384,1,9480848
H1|chr2:85418138-85418163,chr2,85418138,85418163,H1|chr2:75937290-75937384,chr2,75937290,75937384,1,9480848
H1|chr2:85462656-85462724,chr2,85462656,85462724,H1|chr2:77748360-77748395,chr2,77748360,77748395,1,7714296
H1|chr2:85462656-85462688,chr2,85462656,85462688,H1|chr2:77748360-77748402,chr2,77748360,77748402,1,7714296
H1|chr2:85473489-85473522,chr2,85473489,85473522,H1|chr2:77747758-77747875,chr2,77747758,77747875,1,7725731
H1|chr2:85479251-85479341,chr2,85479251,85479341,H1|chr2:73052535-73052569,chr2,73052535,73052569,1,12426716
H1|chr2:85479251-85479340,chr2,85479251,85479340,H1|chr2:73052535-73052569,chr2,73052535,73052569,1,12426716
H1|chr2:85480349-85480488,chr2,85480349,85480488,H1|chr2:64073001-64073039,chr2,64073001,64073039,1,21407348
H1|chr2:85480349-85480461,chr2,85480349,85480461,H1|chr2:64073001-64073039,chr2,64073001,64073039,1,21407348
H1|chr2:85507520-85507548,chr2,85507520,85507548,H1|chr2:85195737-85195843,chr2,85195737,85195843,1,311783
H1|chr2:85507522-85507548,chr2,85507522,85507548,H1|chr2:85195733-85195843,chr2,85195733,85195843,1,311789
H1|chr2:85507524-85507548,chr2,85507524,85507548,H1|chr2:85195737-85195843,chr2,85195737,85195843,1,311787
H1|chr2:85512783-85512876,chr2,85512783,85512876,H1|chr2:85193754-85193796,chr2,85193754,85193796,1,319029
H1|chr2:85512787-85512876,chr2,85512787,85512876,H1|chr2:85193754-85193796,chr2,85193754,85193796,1,319033
H1|chr2:85513192-85513292,chr2,85513192,85513292,H1|chr2:64066452-64066569,chr2,64066452,64066569,1,21446740
H1|chr2:85513357-85513471,chr2,85513357,85513471,H1|chr2:85196780-85196809,chr2,85196780,85196809,1,316577
H1|chr2:85516992-85517063,chr2,85516992,85517063,H1|chr2:85195840-85195958,chr2,85195840,85195958,1,321152
H1|chr2:87301186-87301335,chr2,87301186,87301335,H1|chr2:86949632-86949780,chr2,86949632,86949780,1,351554
H1|chr2:87302948-87303067,chr2,87302948,87303067,H1|chr2:86947934-86948079,chr2,86947934,86948079,1,355014
H1|chr2:102347113-102347175,chr2,102347113,102347175,H1|chr2:101619972-101620051,chr2,101619972,101620051,1,727141
H1|chr2:102347113-102347173,chr2,102347113,102347173,H1|chr2:101619972-101620051,chr2,101619972,101620051,1,727141
H1|chr2:120553937-120553987,chr2,120553937,120553987,H1|chr2:151342517-151342616,chr2,151342517,151342616,1,30788580
H1|chr2:120553940-120553990,chr2,120553940,120553990,H1|chr2:151342517-151342616,chr2,151342517,151342616,1,30788577
H1|chr2:121502677-121502700,chr2,121502677,121502700,H1|chr2:121011482-121011513,chr2,121011482,121011513,1,491195
H1|chr2:121502680-121502700,chr2,121502680,121502700,H1|chr2:121011482-121011513,chr2,121011482,121011513,1,491198
H1|chr2:121544014-121544060,chr2,121544014,121544060,H1|chr2:61764360-61764391,chr2,61764360,61764391,1,59779654
H1|chr2:121544401-121544457,chr2,121544401,121544457,H1|chr2:121492831-121492880,chr2,121492831,121492880,1,51570
H1|chr2:121544405-121544457,chr2,121544405,121544457,H1|chr2:121492831-121492880,chr2,121492831,121492880,1,51574
H1|chr2:121577300-121577424,chr2,121577300,121577424,H1|chr2:56151467-56151534,chr2,56151467,56151534,1,65425833
H1|chr2:121577300-121577376,chr2,121577300,121577376,H1|chr2:56151467-56151534,chr2,56151467,56151534,1,65425833
H1|chr2:121577348-121577428,chr2,121577348,121577428,H1|chr2:56151467-56151534,chr2,56151467,56151534,1,65425881
H1|chr2:121653355-121653405,chr2,121653355,121653405,H1|chr2:121489886-121489939,chr2,121489886,121489939,1,163469
H1|chr2:121656950-121657029,chr2,121656950,121657029,H1|chr2:242637941-242637971,chr2,242637941,242637971,1,120980991
H1|chr2:121656950-121657027,chr2,121656950,121657027,H1|chr2:242637941-242637971,chr2,242637941,242637971,1,120980991
H1|chr2:121656953-121657029,chr2,121656953,121657029,H1|chr2:242637941-242637971,chr2,242637941,242637971,1,120980988
H1|chr2:121657824-121657880,chr2,121657824,121657880,H1|chr2:121491941-121492085,chr2,121491941,121492085,1,165883
H1|chr2:134893965-134894046,chr2,134893965,134894046,H1|chr2:219523093-219523133,chr2,219523093,219523133,1,84629128
H1|chr2:153260982-153261004,chr2,153260982,153261004,H1|chr2:74404195-74404344,chr2,74404195,74404344,1,78856787
H1|chr2:153260984-153261004,chr2,153260984,153261004,H1|chr2:74404195-74404344,chr2,74404195,74404344,1,78856789
H1|chr2:171774500-171774547,chr2,171774500,171774547,H1|chr2:171783562-171783683,chr2,171783562,171783683,1,9062
H1|chr2:171774521-171774547,chr2,171774521,171774547,H1|chr2:171783562-171783683,chr2,171783562,171783683,1,9041
H1|chr2:171774529-171774601,chr2,171774529,171774601,H1|chr2:171782654-171782702,chr2,171782654,171782702,1,8125
H1|chr2:171774869-171774937,chr2,171774869,171774937,H1|chr2:171782400-171782443,chr2,171782400,171782443,1,7531
H1|chr2:173321754-173321796,chr2,173321754,173321796,H1|chr2:232324310-232324395,chr2,232324310,232324395,1,59002556
H1|chr2:173326589-173326644,chr2,173326589,173326644,H1|chr2:232324215-232324306,chr2,232324215,232324306,1,58997626
H1|chr2:189167963-189168016,chr2,189167963,189168016,H1|chr2:210868185-210868236,chr2,210868185,210868236,1,21700222
H1|chr2:189171299-189171341,chr2,189171299,189171341,H1|chr2:187455674-187455761,chr2,187455674,187455761,1,1715625
H1|chr2:189171299-189171339,chr2,189171299,189171339,H1|chr2:187455674-187455761,chr2,187455674,187455761,1,1715625
H1|chr2:189175993-189176037,chr2,189175993,189176037,H1|chr2:187455962-187456011,chr2,187455962,187456011,1,1720031
H1|chr2:189176300-189176345,chr2,189176300,189176345,H1|chr2:201174808-201174883,chr2,201174808,201174883,1,11998508
H1|chr2:189184112-189184195,chr2,189184112,189184195,H1|chr2:170551530-170551594,chr2,170551530,170551594,1,18632582
H1|chr2:189184112-189184194,chr2,189184112,189184194,H1|chr2:170551530-170551594,chr2,170551530,170551594,1,18632582
H1|chr2:189188623-189188642,chr2,189188623,189188642,H1|chr2:12860158-12860259,chr2,12860158,12860259,1,176328465
H1|chr2:189193521-189193586,chr2,189193521,189193586,H1|chr2:201173096-201173156,chr2,201173096,201173156,1,11979575
H1|chr2:189193521-189193584,chr2,189193521,189193584,H1|chr2:201173096-201173156,chr2,201173096,201173156,1,11979575
H1|chr2:189193862-189193925,chr2,189193862,189193925,H1|chr2:216877634-216877718,chr2,216877634,216877718,1,27683772
H1|chr2:189197972-189198076,chr2,189197972,189198076,H1|chr2:189155953-189156058,chr2,189155953,189156058,1,42019
H1|chr2:189198034-189198079,chr2,189198034,189198079,H1|chr2:189155953-189156058,chr2,189155953,189156058,1,42081
H1|chr2:201206436-201206498,chr2,201206436,201206498,H1|chr2:201980227-201980372,chr2,201980227,201980372,1,773791
H1|chr2:201224675-201224796,chr2,201224675,201224796,H1|chr2:201977034-201977094,chr2,201977034,201977094,1,752359
H1|chr2:201224675-201224765,chr2,201224675,201224765,H1|chr2:201977034-201977094,chr2,201977034,201977094,1,752359
H1|chr2:201225103-201225156,chr2,201225103,201225156,H1|chr2:219645846-219645940,chr2,219645846,219645940,1,18420743
H1|chr2:201225136-201225156,chr2,201225136,201225156,H1|chr2:219645846-219645936,chr2,219645846,219645936,1,18420710
H1|chr2:202748555-202748582,chr2,202748555,202748582,H1|chr2:161348906-161348982,chr2,161348906,161348982,1,41399649
H1|chr2:202820685-202820800,chr2,202820685,202820800,H1|chr2:203102996-203103056,chr2,203102996,203103056,1,282311
H1|chr2:217177745-217177826,chr2,217177745,217177826,H1|chr2:216975430-216975483,chr2,216975430,216975483,1,202315
H1|chr2:217177745-217177802,chr2,217177745,217177802,H1|chr2:216975430-216975483,chr2,216975430,216975483,1,202315
H1|chr2:219272143-219272168,chr2,219272143,219272168,H1|chr2:20549340-20549446,chr2,20549340,20549446,1,198722803
H1|chr2:219272144-219272168,chr2,219272144,219272168,H1|chr2:20549380-20549445,chr2,20549380,20549445,1,198722764
H1|chr2:233233248-233233330,chr2,233233248,233233330,H1|chr2:233256439-233256485,chr2,233256439,233256485,1,23191
H1|chr2:233283108-233283131,chr2,233283108,233283131,H1|chr2:233255849-233255907,chr2,233255849,233255907,1,27259
H1|chr2:233284071-233284112,chr2,233284071,233284112,H1|chr2:233254604-233254653,chr2,233254604,233254653,1,29467
H1|chr2:233285331-233285347,chr2,233285331,233285347,H1|chr2:232575357-232575507,chr2,232575357,232575507,1,709974
H1|chr2:233286426-233286458,chr2,233286426,233286458,H1|chr2:233255829-233255947,chr2,233255829,233255947,1,30597
H1|chr2:233286825-233286861,chr2,233286825,233286861,H1|chr2:232576700-232576795,chr2,232576700,232576795,1,710125
H1|chr2:233359652-233359705,chr2,233359652,233359705,H1|chr2:233256501-233256638,chr2,233256501,233256638,1,103151
H1|chr2:236438632-236438740,chr2,236438632,236438740,H1|chr2:233562214-233562328,chr2,233562214,233562328,1,2876418
H1|chr2:236438704-236438740,chr2,236438704,236438740,H1|chr2:233562214-233562328,chr2,233562214,233562328,1,2876490
H1|chr2:236992349-236992423,chr2,236992349,236992423,H1|chr2:26257868-26257944,chr2,26257868,26257944,1,210734481
H1|chr2:236992353-236992426,chr2,236992353,236992426,H1|chr2:26257871-26257948,chr2,26257871,26257948,1,210734482
H1|chr2:238107791-238107880,chr2,238107791,238107880,H1|chr2:198367061-198367119,chr2,198367061,198367119,1,39740730
H1|chr2:238107803-238107881,chr2,238107803,238107881,H1|chr2:198367061-198367119,chr2,198367061,198367119,1,39740742
H1|chr2:238520689-238520789,chr2,238520689,238520789,H1|chr2:85821149-85821199,chr2,85821149,85821199,1,152699540
H1|chr2:239316590-239316611,chr2,239316590,239316611,H1|chr2:239331447-239331569,chr2,239331447,239331569,1,14857
H1|chr2:239325377-239325419,chr2,239325377,239325419,H1|chr2:239331035-239331171,chr2,239331035,239331171,1,5658
H1|chr3:11742531-11742582,chr3,11742531,11742582,H1|chr3:12528203-12528282,chr3,12528203,12528282,1,785672
H1|chr3:11742531-11742581,chr3,11742531,11742581,H1|chr3:12528203-12528282,chr3,12528203,12528282,1,785672
H1|chr3:13058042-13058081,chr3,13058042,13058081,H1|chr3:13115617-13115682,chr3,13115617,13115682,1,57575
H1|chr3:13059078-13059118,chr3,13059078,13059118,H1|chr3:13115628-13115738,chr3,13115628,13115738,1,56550
H1|chr3:14453000-14453029,chr3,14453000,14453029,H1|chr3:52567152-52567232,chr3,52567152,52567232,1,38114152
H1|chr3:14461360-14461393,chr3,14461360,14461393,H1|chr3:18485586-18485702,chr3,18485586,18485702,1,4024226
H1|chr3:14461360-14461392,chr3,14461360,14461392,H1|chr3:18485586-18485702,chr3,18485586,18485702,1,4024226
H1|chr3:14461360-14461391,chr3,14461360,14461391,H1|chr3:18485587-18485702,chr3,18485587,18485702,1,4024227
H1|chr3:14463618-14463679,chr3,14463618,14463679,H1|chr3:14219318-14219403,chr3,14219318,14219403,1,244300
H1|chr3:14463618-14463645,chr3,14463618,14463645,H1|chr3:14219318-14219402,chr3,14219318,14219402,1,244300
H1|chr3:14464627-14464729,chr3,14464627,14464729,H1|chr3:14219318-14219403,chr3,14219318,14219403,1,245309
H1|chr3:14464632-14464729,chr3,14464632,14464729,H1|chr3:14219318-14219402,chr3,14219318,14219402,1,245314
H1|chr3:14605049-14605092,chr3,14605049,14605092,H1|chr3:9883826-9883907,chr3,9883826,9883907,1,4721223
H1|chr3:14605050-14605094,chr3,14605050,14605094,H1|chr3:9883826-9883908,chr3,9883826,9883908,1,4721224
H1|chr3:23530912-23531014,chr3,23530912,23531014,H1|chr3:32860638-32860722,chr3,32860638,32860722,1,9329726
H1|chr3:23530949-23531015,chr3,23530949,23531015,H1|chr3:32860638-32860722,chr3,32860638,32860722,1,9329689
H1|chr3:28618274-28618317,chr3,28618274,28618317,H1|chr3:32862716-32862793,chr3,32862716,32862793,1,4244442
H1|chr3:28619072-28619195,chr3,28619072,28619195,H1|chr3:32863898-32863925,chr3,32863898,32863925,1,4244826
H1|chr3:28622186-28622267,chr3,28622186,28622267,H1|chr3:32860692-32860729,chr3,32860692,32860729,1,4238506
H1|chr3:28622186-28622264,chr3,28622186,28622264,H1|chr3:32860692-32860729,chr3,32860692,32860729,1,4238506
H1|chr3:31926073-31926104,chr3,31926073,31926104,H1|chr3:32862304-32862454,chr3,32862304,32862454,1,936231
H1|chr3:31937382-31937463,chr3,31937382,31937463,H1|chr3:32862317-32862353,chr3,32862317,32862353,1,924935
H1|chr3:31988930-31989064,chr3,31988930,31989064,H1|chr3:32861237-32861287,chr3,32861237,32861287,1,872307
H1|chr3:31988964-31989064,chr3,31988964,31989064,H1|chr3:32861237-32861287,chr3,32861237,32861287,1,872273
H1|chr3:31992380-31992448,chr3,31992380,31992448,H1|chr3:32857103-32857147,chr3,32857103,32857147,1,864723
H1|chr3:32006082-32006155,chr3,32006082,32006155,H1|chr3:32861811-32861888,chr3,32861811,32861888,1,855729
H1|chr3:32006083-32006195,chr3,32006083,32006195,H1|chr3:32861811-32861888,chr3,32861811,32861888,1,855728
H1|chr3:32865152-32865252,chr3,32865152,32865252,H1|chr3:32859105-32859177,chr3,32859105,32859177,1,6047
H1|chr3:32865152-32865230,chr3,32865152,32865230,H1|chr3:32859105-32859177,chr3,32859105,32859177,1,6047
H1|chr3:32865391-32865472,chr3,32865391,32865472,H1|chr3:121608534-121608595,chr3,121608534,121608595,1,88743143
H1|chr3:32866550-32866623,chr3,32866550,32866623,H1|chr3:32858642-32858701,chr3,32858642,32858701,1,7908
H1|chr3:32866893-32866943,chr3,32866893,32866943,H1|chr3:32858344-32858469,chr3,32858344,32858469,1,8549
H1|chr3:32866893-32866918,chr3,32866893,32866918,H1|chr3:32858344-32858469,chr3,32858344,32858469,1,8549
H1|chr3:32867698-32867836,chr3,32867698,32867836,H1|chr3:39445029-39445087,chr3,39445029,39445087,1,6577331
H1|chr3:32867744-32867836,chr3,32867744,32867836,H1|chr3:39445029-39445087,chr3,39445029,39445087,1,6577285
H1|chr3:32869388-32869428,chr3,32869388,32869428,H1|chr3:38067505-38067570,chr3,38067505,38067570,1,5198117
H1|chr3:32869408-32869432,chr3,32869408,32869432,H1|chr3:32856925-32857043,chr3,32856925,32857043,1,12483
H1|chr3:32869409-32869456,chr3,32869409,32869456,H1|chr3:32856925-32857043,chr3,32856925,32857043,1,12484
H1|chr3:32869472-32869511,chr3,32869472,32869511,H1|chr3:14552273-14552310,chr3,14552273,14552310,1,18317199
H1|chr3:32870210-32870289,chr3,32870210,32870289,H1|chr3:32826162-32826241,chr3,32826162,32826241,1,44048
H1|chr3:32870614-32870657,chr3,32870614,32870657,H1|chr3:32857451-32857555,chr3,32857451,32857555,1,13163
H1|chr3:32870698-32870784,chr3,32870698,32870784,H1|chr3:32857451-32857555,chr3,32857451,32857555,1,13247
H1|chr3:32870706-32870758,chr3,32870706,32870758,H1|chr3:33142470-33142540,chr3,33142470,33142540,1,271764
H1|chr3:32870837-32870981,chr3,32870837,32870981,H1|chr3:49174838-49174943,chr3,49174838,49174943,1,16304001
H1|chr3:32870968-32871033,chr3,32870968,32871033,H1|chr3:32854776-32854910,chr3,32854776,32854910,1,16192
H1|chr3:32871569-32871675,chr3,32871569,32871675,H1|chr3:39450367-39450474,chr3,39450367,39450474,1,6578798
H1|chr3:32871708-32871781,chr3,32871708,32871781,H1|chr3:32824970-32824991,chr3,32824970,32824991,1,46738
H1|chr3:32871708-32871776,chr3,32871708,32871776,H1|chr3:32824970-32824991,chr3,32824970,32824991,1,46738
H1|chr3:32872488-32872621,chr3,32872488,32872621,H1|chr3:32856558-32856575,chr3,32856558,32856575,1,15930
H1|chr3:32872500-32872650,chr3,32872500,32872650,H1|chr3:32856558-32856575,chr3,32856558,32856575,1,15942
H1|chr3:32872899-32872987,chr3,32872899,32872987,H1|chr3:32857065-32857151,chr3,32857065,32857151,1,15834
H1|chr3:32872899-32872960,chr3,32872899,32872960,H1|chr3:32857065-32857151,chr3,32857065,32857151,1,15834
H1|chr3:32873205-32873326,chr3,32873205,32873326,H1|chr3:47206778-47206818,chr3,47206778,47206818,1,14333573
H1|chr3:32873205-32873315,chr3,32873205,32873315,H1|chr3:47206778-47206818,chr3,47206778,47206818,1,14333573
H1|chr3:32873868-32873971,chr3,32873868,32873971,H1|chr3:3843518-3843578,chr3,3843518,3843578,1,29030350
H1|chr3:32873882-32873972,chr3,32873882,32873972,H1|chr3:3843518-3843578,chr3,3843518,3843578,1,29030364
H1|chr3:32874410-32874470,chr3,32874410,32874470,H1|chr3:132380403-132380498,chr3,132380403,132380498,1,99505993
H1|chr3:32874410-32874446,chr3,32874410,32874446,H1|chr3:132380403-132380498,chr3,132380403,132380498,1,99505993
H1|chr3:32875318-32875382,chr3,32875318,32875382,H1|chr3:32727381-32727467,chr3,32727381,32727467,1,147937
H1|chr3:32875682-32875710,chr3,32875682,32875710,H1|chr3:32826194-32826299,chr3,32826194,32826299,1,49488
H1|chr3:32877175-32877232,chr3,32877175,32877232,H1|chr3:32856857-32856919,chr3,32856857,32856919,1,20318
H1|chr3:32877175-32877228,chr3,32877175,32877228,H1|chr3:32856857-32856919,chr3,32856857,32856919,1,20318
H1|chr3:32877528-32877568,chr3,32877528,32877568,H1|chr3:32826162-32826240,chr3,32826162,32826240,1,51366
H1|chr3:32877800-32877830,chr3,32877800,32877830,H1|chr3:14553425-14553538,chr3,14553425,14553538,1,18324375
H1|chr3:32878927-32879028,chr3,32878927,32879028,H1|chr3:32859318-32859354,chr3,32859318,32859354,1,19609
H1|chr3:32879230-32879325,chr3,32879230,32879325,H1|chr3:32854492-32854582,chr3,32854492,32854582,1,24738
H1|chr3:32879266-32879326,chr3,32879266,32879326,H1|chr3:32854492-32854582,chr3,32854492,32854582,1,24774
H1|chr3:32879313-32879364,chr3,32879313,32879364,H1|chr3:32857591-32857662,chr3,32857591,32857662,1,21722
H1|chr3:32879313-32879363,chr3,32879313,32879363,H1|chr3:32857591-32857662,chr3,32857591,32857662,1,21722
H1|chr3:32879515-32879571,chr3,32879515,32879571,H1|chr3:3844035-3844094,chr3,3844035,3844094,1,29035480
H1|chr3:32880529-32880569,chr3,32880529,32880569,H1|chr3:32825203-32825353,chr3,32825203,32825353,1,55326
H1|chr3:32881323-32881432,chr3,32881323,32881432,H1|chr3:32859086-32859153,chr3,32859086,32859153,1,22237
H1|chr3:32881349-32881432,chr3,32881349,32881432,H1|chr3:32859086-32859153,chr3,32859086,32859153,1,22263
H1|chr3:32881731-32881778,chr3,32881731,32881778,H1|chr3:132374862-132374951,chr3,132374862,132374951,1,99493131
H1|chr3:32883331-32883478,chr3,32883331,32883478,H1|chr3:32856989-32857013,chr3,32856989,32857013,1,26342
H1|chr3:32883390-32883516,chr3,32883390,32883516,H1|chr3:32856989-32857013,chr3,32856989,32857013,1,26401
H1|chr3:32883480-32883536,chr3,32883480,32883536,H1|chr3:32859468-32859491,chr3,32859468,32859491,1,24012
H1|chr3:32884071-32884162,chr3,32884071,32884162,H1|chr3:33839144-33839217,chr3,33839144,33839217,1,955073
H1|chr3:32884085-32884162,chr3,32884085,32884162,H1|chr3:33839144-33839217,chr3,33839144,33839217,1,955059
H1|chr3:32885118-32885176,chr3,32885118,32885176,H1|chr3:32858850-32858878,chr3,32858850,32858878,1,26268
H1|chr3:32885855-32885893,chr3,32885855,32885893,H1|chr3:32857983-32858100,chr3,32857983,32858100,1,27872
H1|chr3:32885936-32885990,chr3,32885936,32885990,H1|chr3:32825629-32825768,chr3,32825629,32825768,1,60307
H1|chr3:32886214-32886300,chr3,32886214,32886300,H1|chr3:32857791-32857823,chr3,32857791,32857823,1,28423
H1|chr3:32886217-32886300,chr3,32886217,32886300,H1|chr3:32857791-32857823,chr3,32857791,32857823,1,28426
H1|chr3:32887693-32887808,chr3,32887693,32887808,H1|chr3:39455638-39455661,chr3,39455638,39455661,1,6567945
H1|chr3:32887695-32887808,chr3,32887695,32887808,H1|chr3:39455638-39455663,chr3,39455638,39455663,1,6567943
H1|chr3:32887950-32888004,chr3,32887950,32888004,H1|chr3:32826821-32826879,chr3,32826821,32826879,1,61129
H1|chr3:32887950-32888002,chr3,32887950,32888002,H1|chr3:32826813-32826879,chr3,32826813,32826879,1,61137
H1|chr3:32890240-32890335,chr3,32890240,32890335,H1|chr3:33143313-33143355,chr3,33143313,33143355,1,253073
H1|chr3:32890986-32891095,chr3,32890986,32891095,H1|chr3:52007380-52007414,chr3,52007380,52007414,1,19116394
H1|chr3:32891768-32891861,chr3,32891768,32891861,H1|chr3:3843954-3844001,chr3,3843954,3844001,1,29047814
H1|chr3:32893896-32893966,chr3,32893896,32893966,H1|chr3:39456260-39456332,chr3,39456260,39456332,1,6562364
H1|chr3:32893896-32893964,chr3,32893896,32893964,H1|chr3:39456258-39456332,chr3,39456258,39456332,1,6562362
H1|chr3:32894797-32894910,chr3,32894797,32894910,H1|chr3:47206740-47206784,chr3,47206740,47206784,1,14311943
H1|chr3:32894804-32894910,chr3,32894804,32894910,H1|chr3:47206740-47206784,chr3,47206740,47206784,1,14311936
H1|chr3:32895371-32895518,chr3,32895371,32895518,H1|chr3:32824480-32824498,chr3,32824480,32824498,1,70891
H1|chr3:32895386-32895518,chr3,32895386,32895518,H1|chr3:32824480-32824498,chr3,32824480,32824498,1,70906
H1|chr3:32896848-32896998,chr3,32896848,32896998,H1|chr3:32855747-32855790,chr3,32855747,32855790,1,41101
H1|chr3:32896923-32897023,chr3,32896923,32897023,H1|chr3:32855747-32855790,chr3,32855747,32855790,1,41176
H1|chr3:32897571-32897627,chr3,32897571,32897627,H1|chr3:32859240-32859314,chr3,32859240,32859314,1,38331
H1|chr3:32897571-32897626,chr3,32897571,32897626,H1|chr3:32859240-32859314,chr3,32859240,32859314,1,38331
H1|chr3:32897826-32897884,chr3,32897826,32897884,H1|chr3:52002435-52002502,chr3,52002435,52002502,1,19104609
H1|chr3:32898541-32898628,chr3,32898541,32898628,H1|chr3:32858444-32858495,chr3,32858444,32858495,1,40097
H1|chr3:32899727-32899856,chr3,32899727,32899856,H1|chr3:32727332-32727431,chr3,32727332,32727431,1,172395
H1|chr3:32899809-32899857,chr3,32899809,32899857,H1|chr3:32727332-32727431,chr3,32727332,32727431,1,172477
H1|chr3:32900786-32900854,chr3,32900786,32900854,H1|chr3:32826712-32826803,chr3,32826712,32826803,1,74074
H1|chr3:32900786-32900845,chr3,32900786,32900845,H1|chr3:32826712-32826803,chr3,32826712,32826803,1,74074
H1|chr3:32901676-32901748,chr3,32901676,32901748,H1|chr3:33142479-33142540,chr3,33142479,33142540,1,240803
H1|chr3:32901780-32901878,chr3,32901780,32901878,H1|chr3:33142475-33142529,chr3,33142475,33142529,1,240695
H1|chr3:32901780-32901870,chr3,32901780,32901870,H1|chr3:33142475-33142529,chr3,33142475,33142529,1,240695
H1|chr3:32902010-32902050,chr3,32902010,32902050,H1|chr3:39455473-39455533,chr3,39455473,39455533,1,6553463
H1|chr3:32902678-32902770,chr3,32902678,32902770,H1|chr3:32824723-32824782,chr3,32824723,32824782,1,77955
H1|chr3:32902678-32902769,chr3,32902678,32902769,H1|chr3:32824723-32824782,chr3,32824723,32824782,1,77955
H1|chr3:32902947-32903056,chr3,32902947,32903056,H1|chr3:33836089-33836127,chr3,33836089,33836127,1,933142
H1|chr3:32902947-32903055,chr3,32902947,32903055,H1|chr3:33836089-33836127,chr3,33836089,33836127,1,933142
H1|chr3:32903644-32903664,chr3,32903644,32903664,H1|chr3:32855827-32855974,chr3,32855827,32855974,1,47817
H1|chr3:32903811-32903881,chr3,32903811,32903881,H1|chr3:32859297-32859331,chr3,32859297,32859331,1,44514
H1|chr3:32904227-32904359,chr3,32904227,32904359,H1|chr3:32858076-32858107,chr3,32858076,32858107,1,46151
H1|chr3:32904227-32904346,chr3,32904227,32904346,H1|chr3:32858076-32858107,chr3,32858076,32858107,1,46151
H1|chr3:32906055-32906112,chr3,32906055,32906112,H1|chr3:32823662-32823746,chr3,32823662,32823746,1,82393
H1|chr3:32907768-32907865,chr3,32907768,32907865,H1|chr3:32856565-32856595,chr3,32856565,32856595,1,51203
H1|chr3:32908305-32908400,chr3,32908305,32908400,H1|chr3:39456126-39456178,chr3,39456126,39456178,1,6547821
H1|chr3:32908305-32908397,chr3,32908305,32908397,H1|chr3:39456126-39456178,chr3,39456126,39456178,1,6547821
H1|chr3:32909321-32909414,chr3,32909321,32909414,H1|chr3:32615499-32615579,chr3,32615499,32615579,1,293822
H1|chr3:32909344-32909414,chr3,32909344,32909414,H1|chr3:32615499-32615579,chr3,32615499,32615579,1,293845
H1|chr3:32910810-32910889,chr3,32910810,32910889,H1|chr3:32858611-32858640,chr3,32858611,32858640,1,52199
H1|chr3:32911254-32911316,chr3,32911254,32911316,H1|chr3:32858336-32858486,chr3,32858336,32858486,1,52918
H1|chr3:32911443-32911545,chr3,32911443,32911545,H1|chr3:32858010-32858044,chr3,32858010,32858044,1,53433
H1|chr3:32911444-32911545,chr3,32911444,32911545,H1|chr3:32858010-32858044,chr3,32858010,32858044,1,53434
H1|chr3:32913837-32913858,chr3,32913837,32913858,H1|chr3:32823908-32824028,chr3,32823908,32824028,1,89929
H1|chr3:32913837-32913857,chr3,32913837,32913857,H1|chr3:32823908-32824028,chr3,32823908,32824028,1,89929
H1|chr3:32914004-32914131,chr3,32914004,32914131,H1|chr3:32858398-32858496,chr3,32858398,32858496,1,55606
H1|chr3:32914004-32914056,chr3,32914004,32914056,H1|chr3:32858398-32858496,chr3,32858398,32858496,1,55606
H1|chr3:32914004-32914054,chr3,32914004,32914054,H1|chr3:32858398-32858496,chr3,32858398,32858496,1,55606
H1|chr3:32914542-32914624,chr3,32914542,32914624,H1|chr3:32858410-32858468,chr3,32858410,32858468,1,56132
H1|chr3:32915615-32915737,chr3,32915615,32915737,H1|chr3:32612841-32612901,chr3,32612841,32612901,1,302774
H1|chr3:32915615-32915705,chr3,32915615,32915705,H1|chr3:32612841-32612901,chr3,32612841,32612901,1,302774
H1|chr3:32915639-32915674,chr3,32915639,32915674,H1|chr3:32857195-32857311,chr3,32857195,32857311,1,58444
H1|chr3:32915640-32915674,chr3,32915640,32915674,H1|chr3:32857195-32857311,chr3,32857195,32857311,1,58445
H1|chr3:32915841-32915913,chr3,32915841,32915913,H1|chr3:14552275-14552310,chr3,14552275,14552310,1,18363566
H1|chr3:32916166-32916218,chr3,32916166,32916218,H1|chr3:32858502-32858600,chr3,32858502,32858600,1,57664
H1|chr3:32917626-32917691,chr3,32917626,32917691,H1|chr3:32859321-32859386,chr3,32859321,32859386,1,58305
H1|chr3:32917792-32917920,chr3,32917792,32917920,H1|chr3:32859470-32859492,chr3,32859470,32859492,1,58322
H1|chr3:32918452-32918547,chr3,32918452,32918547,H1|chr3:33840763-33840827,chr3,33840763,33840827,1,922311
H1|chr3:32918452-32918538,chr3,32918452,32918538,H1|chr3:33840763-33840827,chr3,33840763,33840827,1,922311
H1|chr3:32918594-32918716,chr3,32918594,32918716,H1|chr3:32858296-32858324,chr3,32858296,32858324,1,60298
H1|chr3:32918597-32918747,chr3,32918597,32918747,H1|chr3:32858296-32858324,chr3,32858296,32858324,1,60301
H1|chr3:32921174-32921192,chr3,32921174,32921192,H1|chr3:32826979-32827042,chr3,32826979,32827042,1,94195
H1|chr3:32924353-32924453,chr3,32924353,32924453,H1|chr3:39445061-39445152,chr3,39445061,39445152,1,6520708
H1|chr3:32924353-32924412,chr3,32924353,32924412,H1|chr3:39445061-39445152,chr3,39445061,39445152,1,6520708
H1|chr3:32926914-32927060,chr3,32926914,32927060,H1|chr3:32858541-32858637,chr3,32858541,32858637,1,68373
H1|chr3:32926914-32926968,chr3,32926914,32926968,H1|chr3:32858541-32858637,chr3,32858541,32858637,1,68373
H1|chr3:32926978-32927081,chr3,32926978,32927081,H1|chr3:32858514-32858571,chr3,32858514,32858571,1,68464
H1|chr3:32926978-32927071,chr3,32926978,32927071,H1|chr3:32858514-32858571,chr3,32858514,32858571,1,68464
H1|chr3:41250223-41250285,chr3,41250223,41250285,H1|chr3:47839629-47839673,chr3,47839629,47839673,1,6589406
H1|chr3:41371647-41371710,chr3,41371647,41371710,H1|chr3:61547340-61547402,chr3,61547340,61547402,1,20175693
H1|chr3:41371647-41371708,chr3,41371647,41371708,H1|chr3:61547340-61547404,chr3,61547340,61547404,1,20175693
H1|chr3:41371648-41371708,chr3,41371648,41371708,H1|chr3:61547340-61547402,chr3,61547340,61547402,1,20175692
H1|chr3:41371669-41371710,chr3,41371669,41371710,H1|chr3:61547340-61547402,chr3,61547340,61547402,1,20175671
H1|chr3:44106855-44106874,chr3,44106855,44106874,H1|chr3:44040848-44040998,chr3,44040848,44040998,1,66007
H1|chr3:44110319-44110378,chr3,44110319,44110378,H1|chr3:109055958-109056057,chr3,109055958,109056057,1,64945639
H1|chr3:44110327-44110378,chr3,44110327,44110378,H1|chr3:109055958-109056057,chr3,109055958,109056057,1,64945631
H1|chr3:47002372-47002423,chr3,47002372,47002423,H1|chr3:195721335-195721434,chr3,195721335,195721434,1,148718963
H1|chr3:47002375-47002425,chr3,47002375,47002425,H1|chr3:195721337-195721437,chr3,195721337,195721437,1,148718962
H1|chr3:50554092-50554161,chr3,50554092,50554161,H1|chr3:50546335-50546381,chr3,50546335,50546381,1,7757
H1|chr3:50562056-50562149,chr3,50562056,50562149,H1|chr3:50542247-50542304,chr3,50542247,50542304,1,19809
H1|chr3:50562079-50562149,chr3,50562079,50562149,H1|chr3:50542247-50542311,chr3,50542247,50542311,1,19832
H1|chr3:53271626-53271682,chr3,53271626,53271682,H1|chr3:49054264-49054315,chr3,49054264,49054315,1,4217362
H1|chr3:53271681-53271787,chr3,53271681,53271787,H1|chr3:109055753-109055794,chr3,109055753,109055794,1,55784072
H1|chr3:53275620-53275662,chr3,53275620,53275662,H1|chr3:53324242-53324293,chr3,53324242,53324293,1,48622
H1|chr3:53275965-53276037,chr3,53275965,53276037,H1|chr3:109057927-109058077,chr3,109057927,109058077,1,55781962
H1|chr3:53275988-53276124,chr3,53275988,53276124,H1|chr3:53324233-53324265,chr3,53324233,53324265,1,48245
H1|chr3:53275988-53276106,chr3,53275988,53276106,H1|chr3:53324233-53324265,chr3,53324233,53324265,1,48245
H1|chr3:53277969-53278086,chr3,53277969,53278086,H1|chr3:53324303-53324356,chr3,53324303,53324356,1,46334
H1|chr3:53277969-53278066,chr3,53277969,53278066,H1|chr3:53324303-53324356,chr3,53324303,53324356,1,46334
H1|chr3:54667629-54667678,chr3,54667629,54667678,H1|chr3:135915173-135915230,chr3,135915173,135915230,1,81247544
H1|chr3:54670969-54671016,chr3,54670969,54671016,H1|chr3:52930446-52930526,chr3,52930446,52930526,1,1740523
H1|chr3:54671216-54671246,chr3,54671216,54671246,H1|chr3:51573508-51573658,chr3,51573508,51573658,1,3097708
H1|chr3:54671299-54671413,chr3,54671299,54671413,H1|chr3:15902092-15902203,chr3,15902092,15902203,1,38769207
H1|chr3:54671597-54671667,chr3,54671597,54671667,H1|chr3:135912712-135912778,chr3,135912712,135912778,1,81241115
H1|chr3:54671604-54671667,chr3,54671604,54671667,H1|chr3:135912712-135912778,chr3,135912712,135912778,1,81241108
H1|chr3:54673556-54673611,chr3,54673556,54673611,H1|chr3:51573679-51573815,chr3,51573679,51573815,1,3099877
H1|chr3:55595304-55595376,chr3,55595304,55595376,H1|chr3:44669705-44669818,chr3,44669705,44669818,1,10925599
H1|chr3:55595342-55595379,chr3,55595342,55595379,H1|chr3:44669705-44669818,chr3,44669705,44669818,1,10925637
H1|chr3:55626221-55626306,chr3,55626221,55626306,H1|chr3:85007162-85007194,chr3,85007162,85007194,1,29380941
H1|chr3:57171074-57171123,chr3,57171074,57171123,H1|chr3:129035926-129036012,chr3,129035926,129036012,1,71864852
H1|chr3:57183725-57183832,chr3,57183725,57183832,H1|chr3:40547902-40547939,chr3,40547902,40547939,1,16635823
H1|chr3:57779638-57779719,chr3,57779638,57779719,H1|chr3:186897232-186897296,chr3,186897232,186897296,1,129117594
H1|chr3:57779643-57779718,chr3,57779643,57779718,H1|chr3:186897232-186897296,chr3,186897232,186897296,1,129117589
H1|chr3:57790700-57790796,chr3,57790700,57790796,H1|chr3:186897918-186897969,chr3,186897918,186897969,1,129107218
H1|chr3:57790701-57790796,chr3,57790701,57790796,H1|chr3:186897918-186897969,chr3,186897918,186897969,1,129107217
H1|chr3:61567327-61567371,chr3,61567327,61567371,H1|chr3:48482685-48482835,chr3,48482685,48482835,1,13084642
H1|chr3:61576737-61576835,chr3,61576737,61576835,H1|chr3:63849254-63849390,chr3,63849254,63849390,1,2272517
H1|chr3:61609442-61609556,chr3,61609442,61609556,H1|chr3:186898097-186898195,chr3,186898097,186898195,1,125288655
H1|chr3:61609444-61609555,chr3,61609444,61609555,H1|chr3:186898096-186898195,chr3,186898096,186898195,1,125288652
H1|chr3:61609504-61609555,chr3,61609504,61609555,H1|chr3:186898096-186898195,chr3,186898096,186898195,1,125288592
H1|chr3:61610230-61610251,chr3,61610230,61610251,H1|chr3:32861147-32861260,chr3,32861147,32861260,1,28749083
H1|chr3:61610470-61610538,chr3,61610470,61610538,H1|chr3:32862603-32862634,chr3,32862603,32862634,1,28747867
H1|chr3:61610474-61610538,chr3,61610474,61610538,H1|chr3:32862603-32862634,chr3,32862603,32862634,1,28747871
H1|chr3:61659940-61659979,chr3,61659940,61659979,H1|chr3:32861011-32861126,chr3,32861011,32861126,1,28798929
H1|chr3:61659944-61659979,chr3,61659944,61659979,H1|chr3:32861011-32861126,chr3,32861011,32861126,1,28798933
H1|chr3:61672567-61672618,chr3,61672567,61672618,H1|chr3:48754359-48754448,chr3,48754359,48754448,1,12918208
H1|chr3:61672568-61672617,chr3,61672568,61672617,H1|chr3:48754359-48754448,chr3,48754359,48754448,1,12918209
H1|chr3:61673523-61673573,chr3,61673523,61673573,H1|chr3:32854883-32854970,chr3,32854883,32854970,1,28818640
H1|chr3:61673524-61673573,chr3,61673524,61673573,H1|chr3:32854883-32854970,chr3,32854883,32854970,1,28818641
H1|chr3:61682941-61683038,chr3,61682941,61683038,H1|chr3:57198970-57199032,chr3,57198970,57199032,1,4483971
H1|chr3:61682941-61683025,chr3,61682941,61683025,H1|chr3:57198970-57199032,chr3,57198970,57199032,1,4483971
H1|chr3:61682941-61682975,chr3,61682941,61682975,H1|chr3:57198970-57199032,chr3,57198970,57199032,1,4483971
H1|chr3:61688322-61688377,chr3,61688322,61688377,H1|chr3:3844133-3844183,chr3,3844133,3844183,1,57844189
H1|chr3:61688958-61689008,chr3,61688958,61689008,H1|chr3:32859459-32859519,chr3,32859459,32859519,1,28829499
H1|chr3:61782707-61782840,chr3,61782707,61782840,H1|chr3:69128454-69128474,chr3,69128454,69128474,1,7345747
H1|chr3:61782713-61782840,chr3,61782713,61782840,H1|chr3:69128454-69128474,chr3,69128454,69128474,1,7345741
H1|chr3:61833453-61833550,chr3,61833453,61833550,H1|chr3:132137780-132137833,chr3,132137780,132137833,1,70304327
H1|chr3:61833511-61833550,chr3,61833511,61833550,H1|chr3:132137780-132137849,chr3,132137780,132137849,1,70304269
H1|chr3:61903722-61903763,chr3,61903722,61903763,H1|chr3:132376767-132376806,chr3,132376767,132376806,1,70473045
H1|chr3:61921860-61921928,chr3,61921860,61921928,H1|chr3:9434619-9434681,chr3,9434619,9434681,1,52487241
H1|chr3:61921860-61921887,chr3,61921860,61921887,H1|chr3:9434619-9434679,chr3,9434619,9434679,1,52487241
H1|chr3:62432441-62432468,chr3,62432441,62432468,H1|chr3:43731287-43731361,chr3,43731287,43731361,1,18701154
H1|chr3:66483546-66483619,chr3,66483546,66483619,H1|chr3:71630987-71631070,chr3,71630987,71631070,1,5147441
H1|chr3:66483552-66483619,chr3,66483552,66483619,H1|chr3:71630987-71631070,chr3,71630987,71631070,1,5147435
H1|chr3:73145000-73145102,chr3,73145000,73145102,H1|chr3:109054399-109054549,chr3,109054399,109054549,1,35909399
H1|chr3:73145008-73145105,chr3,73145008,73145105,H1|chr3:109054472-109054570,chr3,109054472,109054570,1,35909464
H1|chr3:73145008-73145079,chr3,73145008,73145079,H1|chr3:109054374-109054524,chr3,109054374,109054524,1,35909366
H1|chr3:73145008-73145063,chr3,73145008,73145063,H1|chr3:109054648-109054798,chr3,109054648,109054798,1,35909640
H1|chr3:73159116-73159140,chr3,73159116,73159140,H1|chr3:150802116-150802195,chr3,150802116,150802195,1,77643000
H1|chr3:99630295-99630331,chr3,99630295,99630331,H1|chr3:25705074-25705145,chr3,25705074,25705145,1,73925221
H1|chr3:99630306-99630331,chr3,99630306,99630331,H1|chr3:25705074-25705145,chr3,25705074,25705145,1,73925232
H1|chr3:109075275-109075296,chr3,109075275,109075296,H1|chr3:109057710-109057839,chr3,109057710,109057839,1,17565
H1|chr3:109075735-109075843,chr3,109075735,109075843,H1|chr3:109061286-109061344,chr3,109061286,109061344,1,14449
H1|chr3:109075751-109075843,chr3,109075751,109075843,H1|chr3:109061286-109061344,chr3,109061286,109061344,1,14465
H1|chr3:110684047-110684152,chr3,110684047,110684152,H1|chr3:109053733-109053795,chr3,109053733,109053795,1,1630314
H1|chr3:110684047-110684126,chr3,110684047,110684126,H1|chr3:109053733-109053798,chr3,109053733,109053798,1,1630314
H1|chr3:110684067-110684152,chr3,110684067,110684152,H1|chr3:109053733-109053795,chr3,109053733,109053795,1,1630334
H1|chr3:110684134-110684152,chr3,110684134,110684152,H1|chr3:109053733-109053798,chr3,109053733,109053798,1,1630401
H1|chr3:112073159-112073231,chr3,112073159,112073231,H1|chr3:196364099-196364163,chr3,196364099,196364163,1,84290940
H1|chr3:112073161-112073231,chr3,112073161,112073231,H1|chr3:196364099-196364163,chr3,196364099,196364163,1,84290938
H1|chr3:128498648-128498705,chr3,128498648,128498705,H1|chr3:109053396-109053440,chr3,109053396,109053440,1,19445252
H1|chr3:128507455-128507540,chr3,128507455,128507540,H1|chr3:109058515-109058546,chr3,109058515,109058546,1,19448940
H1|chr3:128507457-128507540,chr3,128507457,128507540,H1|chr3:109058515-109058546,chr3,109058515,109058546,1,19448942
H1|chr3:129065563-129065596,chr3,129065563,129065596,H1|chr3:39445778-39445833,chr3,39445778,39445833,1,89619785
H1|chr3:129065563-129065594,chr3,129065563,129065594,H1|chr3:39445778-39445833,chr3,39445778,39445833,1,89619785
H1|chr3:129287588-129287685,chr3,129287588,129287685,H1|chr3:129351749-129351881,chr3,129351749,129351881,1,64161
H1|chr3:132100581-132100677,chr3,132100581,132100677,H1|chr3:132131844-132131886,chr3,132131844,132131886,1,31263
H1|chr3:132100866-132100957,chr3,132100866,132100957,H1|chr3:132132582-132132732,chr3,132132582,132132732,1,31716
H1|chr3:149341753-149341853,chr3,149341753,149341853,H1|chr3:193851731-193851781,chr3,193851731,193851781,1,44509978
H1|chr3:149341776-149341853,chr3,149341776,149341853,H1|chr3:193851731-193851804,chr3,193851731,193851804,1,44509955
H1|chr3:150524672-150524756,chr3,150524672,150524756,H1|chr3:150481528-150481587,chr3,150481528,150481587,1,43144
H1|chr3:150524672-150524755,chr3,150524672,150524755,H1|chr3:150481528-150481587,chr3,150481528,150481587,1,43144
H1|chr3:171875323-171875399,chr3,171875323,171875399,H1|chr3:186897817-186897891,chr3,186897817,186897891,1,15022494
H1|chr3:171897316-171897388,chr3,171897316,171897388,H1|chr3:186897468-186897553,chr3,186897468,186897553,1,15000152
H1|chr3:171897324-171897389,chr3,171897324,171897389,H1|chr3:186897468-186897553,chr3,186897468,186897553,1,15000144
H1|chr3:179419809-179419859,chr3,179419809,179419859,H1|chr3:179044902-179044985,chr3,179044902,179044985,1,374907
H1|chr3:179421741-179421772,chr3,179421741,179421772,H1|chr3:179043159-179043309,chr3,179043159,179043309,1,378582
H1|chr3:185436869-185436945,chr3,185436869,185436945,H1|chr3:185546064-185546083,chr3,185546064,185546083,1,109195
H1|chr3:185437516-185437597,chr3,185437516,185437597,H1|chr3:9442761-9442830,chr3,9442761,9442830,1,175994755
H1|chr3:185437518-185437619,chr3,185437518,185437619,H1|chr3:9442761-9442830,chr3,9442761,9442830,1,175994757
H1|chr3:185445498-185445644,chr3,185445498,185445644,H1|chr3:185547586-185547669,chr3,185547586,185547669,1,102088
H1|chr3:185453031-185453088,chr3,185453031,185453088,H1|chr3:69100317-69100463,chr3,69100317,69100463,1,116352714
H1|chr3:185454994-185455021,chr3,185454994,185455021,H1|chr3:185544967-185545117,chr3,185544967,185545117,1,89973
H1|chr3:185479821-185479866,chr3,185479821,185479866,H1|chr3:185651901-185652013,chr3,185651901,185652013,1,172080
H1|chr3:185479828-185479866,chr3,185479828,185479866,H1|chr3:185651901-185652013,chr3,185651901,185652013,1,172073
H1|chr3:185486940-185487081,chr3,185486940,185487081,H1|chr3:185655301-185655331,chr3,185655301,185655331,1,168361
H1|chr3:185486961-185487081,chr3,185486961,185487081,H1|chr3:185655301-185655331,chr3,185655301,185655331,1,168340
H1|chr3:185493478-185493562,chr3,185493478,185493562,H1|chr3:185652691-185652744,chr3,185652691,185652744,1,159213
H1|chr3:185495798-185495849,chr3,185495798,185495849,H1|chr3:185654950-185655006,chr3,185654950,185655006,1,159152
H1|chr3:185496923-185496989,chr3,185496923,185496989,H1|chr3:185652733-185652791,chr3,185652733,185652791,1,155810
H1|chr3:185497526-185497588,chr3,185497526,185497588,H1|chr3:136581528-136581616,chr3,136581528,136581616,1,48915998
H1|chr3:185497526-185497587,chr3,185497526,185497587,H1|chr3:136581528-136581616,chr3,136581528,136581616,1,48915998
H1|chr3:185497760-185497814,chr3,185497760,185497814,H1|chr3:185654620-185654704,chr3,185654620,185654704,1,156860
H1|chr3:185501571-185501624,chr3,185501571,185501624,H1|chr3:113458979-113459061,chr3,113458979,113459061,1,72042592
H1|chr3:185501574-185501624,chr3,185501574,185501624,H1|chr3:113458999-113459064,chr3,113458999,113459064,1,72042575
H1|chr3:185503737-185503783,chr3,185503737,185503783,H1|chr3:185652568-185652602,chr3,185652568,185652602,1,148831
H1|chr3:185509225-185509308,chr3,185509225,185509308,H1|chr3:185653990-185654044,chr3,185653990,185654044,1,144765
H1|chr3:185509226-185509308,chr3,185509226,185509308,H1|chr3:185653990-185654044,chr3,185653990,185654044,1,144764
H1|chr3:185533588-185533633,chr3,185533588,185533633,H1|chr3:185654620-185654725,chr3,185654620,185654725,1,121032
H1|chr3:186655574-186655673,chr3,186655574,186655673,H1|chr3:109052036-109052079,chr3,109052036,109052079,1,77603538
H1|chr3:186655575-186655673,chr3,186655575,186655673,H1|chr3:109052036-109052079,chr3,109052036,109052079,1,77603539
H1|chr3:186880483-186880611,chr3,186880483,186880611,H1|chr3:149947594-149947611,chr3,149947594,149947611,1,36932889
H1|chr3:186880499-186880649,chr3,186880499,186880649,H1|chr3:149947594-149947611,chr3,149947594,149947611,1,36932905
H1|chr3:186880868-186880892,chr3,186880868,186880892,H1|chr3:61548212-61548318,chr3,61548212,61548318,1,125332656
H1|chr3:186882034-186882086,chr3,186882034,186882086,H1|chr3:197678276-197678374,chr3,197678276,197678374,1,10796242
H1|chr3:186882035-186882105,chr3,186882035,186882105,H1|chr3:197678276-197678374,chr3,197678276,197678374,1,10796241
H1|chr3:186882768-186882799,chr3,186882768,186882799,H1|chr3:170075721-170075848,chr3,170075721,170075848,1,16807047
H1|chr3:186883764-186883821,chr3,186883764,186883821,H1|chr3:186650187-186650232,chr3,186650187,186650232,1,233577
H1|chr3:186884415-186884519,chr3,186884415,186884519,H1|chr3:185539893-185539924,chr3,185539893,185539924,1,1344522
H1|chr3:186884417-186884519,chr3,186884417,186884519,H1|chr3:185539893-185539924,chr3,185539893,185539924,1,1344524
H1|chr3:186886713-186886804,chr3,186886713,186886804,H1|chr3:186523025-186523064,chr3,186523025,186523064,1,363688
H1|chr3:186887399-186887430,chr3,186887399,186887430,H1|chr3:185826554-185826612,chr3,185826554,185826612,1,1060845
H1|chr3:186889363-186889404,chr3,186889363,186889404,H1|chr3:182970771-182970820,chr3,182970771,182970820,1,3918592
H1|chr3:186890496-186890553,chr3,186890496,186890553,H1|chr3:185541807-185541848,chr3,185541807,185541848,1,1348689
H1|chr3:186890498-186890553,chr3,186890498,186890553,H1|chr3:185541807-185541848,chr3,185541807,185541848,1,1348691
H1|chr3:186890656-186890736,chr3,186890656,186890736,H1|chr3:179371602-179371633,chr3,179371602,179371633,1,7519054
H1|chr3:186890656-186890732,chr3,186890656,186890732,H1|chr3:179371602-179371633,chr3,179371602,179371633,1,7519054
H1|chr3:186890683-186890735,chr3,186890683,186890735,H1|chr3:179371657-179371724,chr3,179371657,179371724,1,7519026
H1|chr3:186890712-186890748,chr3,186890712,186890748,H1|chr3:186523853-186523937,chr3,186523853,186523937,1,366859
H1|chr3:186890931-186890954,chr3,186890931,186890954,H1|chr3:185825706-185825754,chr3,185825706,185825754,1,1065225
H1|chr3:186890950-186891016,chr3,186890950,186891016,H1|chr3:186650084-186650109,chr3,186650084,186650109,1,240866
H1|chr3:186890950-186891015,chr3,186890950,186891015,H1|chr3:186650084-186650109,chr3,186650084,186650109,1,240866
H1|chr3:186891957-186892028,chr3,186891957,186892028,H1|chr3:197678749-197678826,chr3,197678749,197678826,1,10786792
H1|chr3:186892238-186892284,chr3,186892238,186892284,H1|chr3:185540266-185540335,chr3,185540266,185540335,1,1351972
H1|chr3:187903051-187903113,chr3,187903051,187903113,H1|chr3:187458527-187458581,chr3,187458527,187458581,1,444524
H1|chr3:187906986-187907074,chr3,187906986,187907074,H1|chr3:187461995-187462013,chr3,187461995,187462013,1,444991
H1|chr3:194876132-194876194,chr3,194876132,194876194,H1|chr3:172167501-172167558,chr3,172167501,172167558,1,22708631
H1|chr3:194876144-194876194,chr3,194876144,194876194,H1|chr3:172167501-172167558,chr3,172167501,172167558,1,22708643
H1|chr3:194922152-194922219,chr3,194922152,194922219,H1|chr3:150129913-150129968,chr3,150129913,150129968,1,44792239
H1|chr3:194922155-194922219,chr3,194922155,194922219,H1|chr3:150129913-150129968,chr3,150129913,150129968,1,44792242
H1|chr3:194922155-194922218,chr3,194922155,194922218,H1|chr3:150129911-150129968,chr3,150129911,150129968,1,44792244
H1|chr3:194963282-194963363,chr3,194963282,194963363,H1|chr3:172471099-172471143,chr3,172471099,172471143,1,22492183
H1|chr3:194963282-194963362,chr3,194963282,194963362,H1|chr3:172471099-172471143,chr3,172471099,172471143,1,22492183
H1|chr3:194963287-194963363,chr3,194963287,194963363,H1|chr3:172471099-172471143,chr3,172471099,172471143,1,22492188
H1|chr3:197379834-197379984,chr3,197379834,197379984,H1|chr3:195363784-195363934,chr3,195363784,195363934,1,2016050
H1|chr3:197379899-197379982,chr3,197379899,197379982,H1|chr3:195363784-195363934,chr3,195363784,195363934,1,2016115
H1|chr3:197379902-197380052,chr3,197379902,197380052,H1|chr3:195363879-195363953,chr3,195363879,195363953,1,2016023
H1|chr4:124439-124555,chr4,124439,124555,H1|chr4:205447-205499,chr4,205447,205499,1,81008
H1|chr4:124457-124555,chr4,124457,124555,H1|chr4:205447-205499,chr4,205447,205499,1,80990
H1|chr4:124493-124555,chr4,124493,124555,H1|chr4:205447-205535,chr4,205447,205535,1,80954
H1|chr4:124513-124555,chr4,124513,124555,H1|chr4:205446-205583,chr4,205446,205583,1,80933
H1|chr4:125088-125196,chr4,125088,125196,H1|chr4:209152-209197,chr4,209152,209197,1,84064
H1|chr4:125091-125196,chr4,125091,125196,H1|chr4:209152-209197,chr4,209152,209197,1,84061
H1|chr4:206472-206519,chr4,206472,206519,H1|chr4:331089-331155,chr4,331089,331155,1,124617
H1|chr4:206636-206727,chr4,206636,206727,H1|chr4:54232-54263,chr4,54232,54263,1,152404
H1|chr4:206636-206687,chr4,206636,206687,H1|chr4:54232-54263,chr4,54232,54263,1,152404
H1|chr4:206913-206993,chr4,206913,206993,H1|chr4:53784-53851,chr4,53784,53851,1,153129
H1|chr4:207738-207835,chr4,207738,207835,H1|chr4:129649-129715,chr4,129649,129715,1,78089
H1|chr4:207738-207821,chr4,207738,207821,H1|chr4:129649-129715,chr4,129649,129715,1,78089
H1|chr4:207913-207972,chr4,207913,207972,H1|chr4:126141-126191,chr4,126141,126191,1,81772
H1|chr4:207916-207961,chr4,207916,207961,H1|chr4:332976-333016,chr4,332976,333016,1,125060
H1|chr4:207922-208006,chr4,207922,208006,H1|chr4:125878-125902,chr4,125878,125902,1,82044
H1|chr4:774819-774935,chr4,774819,774935,H1|chr4:675129-675274,chr4,675129,675274,1,99690
H1|chr4:775292-775367,chr4,775292,775367,H1|chr4:671445-671518,chr4,671445,671518,1,103847
H1|chr4:2053457-2053550,chr4,2053457,2053550,H1|chr4:2058172-2058204,chr4,2058172,2058204,1,4715
H1|chr4:2053475-2053579,chr4,2053475,2053579,H1|chr4:2059362-2059387,chr4,2059362,2059387,1,5887
H1|chr4:2599564-2599604,chr4,2599564,2599604,H1|chr4:26361604-26361641,chr4,26361604,26361641,1,23762040
H1|chr4:2601107-2601182,chr4,2601107,2601182,H1|chr4:26362891-26362952,chr4,26362891,26362952,1,23761784
H1|chr4:4854183-4854250,chr4,4854183,4854250,H1|chr4:4859048-4859092,chr4,4859048,4859092,1,4865
H1|chr4:4855270-4855329,chr4,4855270,4855329,H1|chr4:4856468-4856500,chr4,4856468,4856500,1,1198
H1|chr4:4855283-4855395,chr4,4855283,4855395,H1|chr4:4857674-4857712,chr4,4857674,4857712,1,2391
H1|chr4:4855307-4855457,chr4,4855307,4855457,H1|chr4:4857674-4857712,chr4,4857674,4857712,1,2367
H1|chr4:6255873-6255904,chr4,6255873,6255904,H1|chr4:6268362-6268424,chr4,6268362,6268424,1,12489
H1|chr4:6255908-6256007,chr4,6255908,6256007,H1|chr4:6269934-6269966,chr4,6269934,6269966,1,14026
H1|chr4:6333436-6333459,chr4,6333436,6333459,H1|chr4:52711090-52711221,chr4,52711090,52711221,1,46377654
H1|chr4:6333440-6333459,chr4,6333440,6333459,H1|chr4:52711090-52711221,chr4,52711090,52711221,1,46377650
H1|chr4:16694704-16694779,chr4,16694704,16694779,H1|chr4:18022769-18022918,chr4,18022769,18022918,1,1328065
H1|chr4:16694718-16694779,chr4,16694718,16694779,H1|chr4:18022769-18022919,chr4,18022769,18022919,1,1328051
H1|chr4:22464681-22464762,chr4,22464681,22464762,H1|chr4:16899107-16899159,chr4,16899107,16899159,1,5565574
H1|chr4:22464689-22464762,chr4,22464689,22464762,H1|chr4:16899115-16899159,chr4,16899115,16899159,1,5565574
H1|chr4:39941731-39941822,chr4,39941731,39941822,H1|chr4:113736198-113736279,chr4,113736198,113736279,1,73794467
H1|chr4:39941731-39941800,chr4,39941731,39941800,H1|chr4:113736198-113736279,chr4,113736198,113736279,1,73794467
H1|chr4:53579187-53579214,chr4,53579187,53579214,H1|chr4:53588775-53588798,chr4,53588775,53588798,1,9588
H1|chr4:53580789-53580819,chr4,53580789,53580819,H1|chr4:53589308-53589396,chr4,53589308,53589396,1,8519
H1|chr4:53580897-53580951,chr4,53580897,53580951,H1|chr4:53729073-53729113,chr4,53729073,53729113,1,148176
H1|chr4:53582050-53582159,chr4,53582050,53582159,H1|chr4:53726772-53726903,chr4,53726772,53726903,1,144722
H1|chr4:53582859-53582935,chr4,53582859,53582935,H1|chr4:52709884-52709937,chr4,52709884,52709937,1,872975
H1|chr4:53582859-53582934,chr4,53582859,53582934,H1|chr4:52709884-52709937,chr4,52709884,52709937,1,872975
H1|chr4:53582860-53582935,chr4,53582860,53582935,H1|chr4:52709884-52709937,chr4,52709884,52709937,1,872976
H1|chr4:53583881-53583998,chr4,53583881,53583998,H1|chr4:40060309-40060361,chr4,40060309,40060361,1,13523572
H1|chr4:53583933-53583998,chr4,53583933,53583998,H1|chr4:40060278-40060310,chr4,40060278,40060310,1,13523655
H1|chr4:77613870-77613982,chr4,77613870,77613982,H1|chr4:113737715-113737737,chr4,113737715,113737737,1,36123845
H1|chr4:79078108-79078175,chr4,79078108,79078175,H1|chr4:78978127-78978277,chr4,78978127,78978277,1,99981
H1|chr4:79078108-79078169,chr4,79078108,79078169,H1|chr4:78978127-78978277,chr4,78978127,78978277,1,99981
H1|chr4:79088300-79088330,chr4,79088300,79088330,H1|chr4:26363096-26363197,chr4,26363096,26363197,1,52725204
H1|chr4:79088300-79088329,chr4,79088300,79088329,H1|chr4:26363096-26363197,chr4,26363096,26363197,1,52725204
H1|chr4:79092727-79092763,chr4,79092727,79092763,H1|chr4:103681045-103681192,chr4,103681045,103681192,1,24588318
H1|chr4:79092728-79092763,chr4,79092728,79092763,H1|chr4:103681045-103681192,chr4,103681045,103681192,1,24588317
H1|chr4:85491024-85491126,chr4,85491024,85491126,H1|chr4:85502701-85502766,chr4,85502701,85502766,1,11677
H1|chr4:85491041-85491126,chr4,85491041,85491126,H1|chr4:85502701-85502766,chr4,85502701,85502766,1,11660
H1|chr4:85491058-85491126,chr4,85491058,85491126,H1|chr4:85502701-85502759,chr4,85502701,85502759,1,11643
H1|chr4:85492961-85492988,chr4,85492961,85492988,H1|chr4:85502701-85502757,chr4,85502701,85502757,1,9740
H1|chr4:85494014-85494043,chr4,85494014,85494043,H1|chr4:85502701-85502822,chr4,85502701,85502822,1,8687
H1|chr4:85496943-85497051,chr4,85496943,85497051,H1|chr4:85502701-85502722,chr4,85502701,85502722,1,5758
H1|chr4:87880341-87880461,chr4,87880341,87880461,H1|chr4:56409066-56409093,chr4,56409066,56409093,1,31471275
H1|chr4:87888476-87888500,chr4,87888476,87888500,H1|chr4:56410062-56410148,chr4,56410062,56410148,1,31478414
H1|chr4:87888477-87888500,chr4,87888477,87888500,H1|chr4:56410062-56410148,chr4,56410062,56410148,1,31478415
H1|chr4:88021240-88021322,chr4,88021240,88021322,H1|chr4:90603915-90604065,chr4,90603915,90604065,1,2582675
H1|chr4:88021241-88021322,chr4,88021241,88021322,H1|chr4:90603915-90604065,chr4,90603915,90604065,1,2582674
H1|chr4:93191060-93191145,chr4,93191060,93191145,H1|chr4:93224830-93224898,chr4,93224830,93224898,1,33770
H1|chr4:93191060-93191142,chr4,93191060,93191142,H1|chr4:93224830-93224898,chr4,93224830,93224898,1,33770
H1|chr4:93191069-93191154,chr4,93191069,93191154,H1|chr4:93224566-93224594,chr4,93224566,93224594,1,33497
H1|chr4:93191069-93191153,chr4,93191069,93191153,H1|chr4:93224566-93224594,chr4,93224566,93224594,1,33497
H1|chr4:93191554-93191677,chr4,93191554,93191677,H1|chr4:129733806-129733827,chr4,129733806,129733827,1,36542252
H1|chr4:93191590-93191677,chr4,93191590,93191677,H1|chr4:129733685-129733827,chr4,129733685,129733827,1,36542095
H1|chr4:93192282-93192356,chr4,93192282,93192356,H1|chr4:93198973-93199002,chr4,93198973,93199002,1,6691
H1|chr4:93192282-93192344,chr4,93192282,93192344,H1|chr4:93198973-93199002,chr4,93198973,93199002,1,6691
H1|chr4:93193691-93193785,chr4,93193691,93193785,H1|chr4:56263589-56263614,chr4,56263589,56263614,1,36930102
H1|chr4:93193919-93194025,chr4,93193919,93194025,H1|chr4:159644146-159644165,chr4,159644146,159644165,1,66450227
H1|chr4:93193947-93194025,chr4,93193947,93194025,H1|chr4:159644146-159644165,chr4,159644146,159644165,1,66450199
H1|chr4:93197344-93197401,chr4,93197344,93197401,H1|chr4:56264232-56264311,chr4,56264232,56264311,1,36933112
H1|chr4:93198647-93198760,chr4,93198647,93198760,H1|chr4:93226926-93226960,chr4,93226926,93226960,1,28279
H1|chr4:93198697-93198847,chr4,93198697,93198847,H1|chr4:93226929-93226960,chr4,93226929,93226960,1,28232
H1|chr4:93348159-93348230,chr4,93348159,93348230,H1|chr4:93202709-93202785,chr4,93202709,93202785,1,145450
H1|chr4:93349340-93349487,chr4,93349340,93349487,H1|chr4:93201049-93201121,chr4,93201049,93201121,1,148291
H1|chr4:93349412-93349490,chr4,93349412,93349490,H1|chr4:93201049-93201121,chr4,93201049,93201121,1,148363
H1|chr4:93364207-93364268,chr4,93364207,93364268,H1|chr4:93224993-93225093,chr4,93224993,93225093,1,139214
H1|chr4:93364223-93364268,chr4,93364223,93364268,H1|chr4:93224993-93225093,chr4,93224993,93225093,1,139230
H1|chr4:93365686-93365827,chr4,93365686,93365827,H1|chr4:93225439-93225509,chr4,93225439,93225509,1,140247
H1|chr4:93365686-93365766,chr4,93365686,93365766,H1|chr4:93225439-93225509,chr4,93225439,93225509,1,140247
H1|chr4:93367103-93367193,chr4,93367103,93367193,H1|chr4:87516410-87516470,chr4,87516410,87516470,1,5850693
H1|chr4:93367105-93367224,chr4,93367105,93367224,H1|chr4:87516410-87516470,chr4,87516410,87516470,1,5850695
H1|chr4:93369363-93369441,chr4,93369363,93369441,H1|chr4:93201142-93201169,chr4,93201142,93201169,1,168221
H1|chr4:93369389-93369475,chr4,93369389,93369475,H1|chr4:140097007-140097097,chr4,140097007,140097097,1,46727618
H1|chr4:93370095-93370132,chr4,93370095,93370132,H1|chr4:93202800-93202888,chr4,93202800,93202888,1,167295
H1|chr4:93373462-93373554,chr4,93373462,93373554,H1|chr4:93202031-93202088,chr4,93202031,93202088,1,171431
H1|chr4:93373467-93373613,chr4,93373467,93373613,H1|chr4:93202031-93202088,chr4,93202031,93202088,1,171436
H1|chr4:93381172-93381297,chr4,93381172,93381297,H1|chr4:89374940-89375004,chr4,89374940,89375004,1,4006232
H1|chr4:93381654-93381713,chr4,93381654,93381713,H1|chr4:183371256-183371406,chr4,183371256,183371406,1,89989602
H1|chr4:93384066-93384129,chr4,93384066,93384129,H1|chr4:89373726-89373789,chr4,89373726,89373789,1,4010340
H1|chr4:93384067-93384129,chr4,93384067,93384129,H1|chr4:89373725-89373789,chr4,89373725,89373789,1,4010342
H1|chr4:93384998-93385047,chr4,93384998,93385047,H1|chr4:93202686-93202779,chr4,93202686,93202779,1,182312
H1|chr4:93385449-93385505,chr4,93385449,93385505,H1|chr4:87514443-87514514,chr4,87514443,87514514,1,5871006
H1|chr4:93412412-93412549,chr4,93412412,93412549,H1|chr4:130013916-130013955,chr4,130013916,130013955,1,36601504
H1|chr4:93412412-93412520,chr4,93412412,93412520,H1|chr4:130013916-130013955,chr4,130013916,130013955,1,36601504
H1|chr4:93414810-93414899,chr4,93414810,93414899,H1|chr4:93199867-93199923,chr4,93199867,93199923,1,214943
H1|chr4:93414829-93414899,chr4,93414829,93414899,H1|chr4:93199867-93199947,chr4,93199867,93199947,1,214962
H1|chr4:93415256-93415304,chr4,93415256,93415304,H1|chr4:93201335-93201373,chr4,93201335,93201373,1,213921
H1|chr4:93420133-93420224,chr4,93420133,93420224,H1|chr4:93225327-93225375,chr4,93225327,93225375,1,194806
H1|chr4:93421719-93421775,chr4,93421719,93421775,H1|chr4:93225399-93225546,chr4,93225399,93225546,1,196320
H1|chr4:99536700-99536797,chr4,99536700,99536797,H1|chr4:100007792-100007826,chr4,100007792,100007826,1,471092
H1|chr4:99536701-99536797,chr4,99536701,99536797,H1|chr4:100007792-100007826,chr4,100007792,100007826,1,471091
H1|chr4:99537000-99537050,chr4,99537000,99537050,H1|chr4:100008007-100008088,chr4,100008007,100008088,1,471007
H1|chr4:102227329-102227436,chr4,102227329,102227436,H1|chr4:177117543-177117603,chr4,177117543,177117603,1,74890214
H1|chr4:102227346-102227436,chr4,102227346,102227436,H1|chr4:177117543-177117603,chr4,177117543,177117603,1,74890197
H1|chr4:102227379-102227436,chr4,102227379,102227436,H1|chr4:177117543-177117603,chr4,177117543,177117603,1,74890164
H1|chr4:113628346-113628459,chr4,113628346,113628459,H1|chr4:113738536-113738569,chr4,113738536,113738569,1,110190
H1|chr4:113628347-113628459,chr4,113628347,113628459,H1|chr4:113738536-113738569,chr4,113738536,113738569,1,110189
H1|chr4:113629048-113629103,chr4,113629048,113629103,H1|chr4:113737871-113737966,chr4,113737871,113737966,1,108823
H1|chr4:113668411-113668450,chr4,113668411,113668450,H1|chr4:113632753-113632903,chr4,113632753,113632903,1,35658
H1|chr4:113670534-113670678,chr4,113670534,113670678,H1|chr4:113736947-113737020,chr4,113736947,113737020,1,66413
H1|chr4:113670630-113670707,chr4,113670630,113670707,H1|chr4:113736947-113737020,chr4,113736947,113737020,1,66317
H1|chr4:113671447-113671497,chr4,113671447,113671497,H1|chr4:113632138-113632195,chr4,113632138,113632195,1,39309
H1|chr4:113671447-113671496,chr4,113671447,113671496,H1|chr4:113632138-113632195,chr4,113632138,113632195,1,39309
H1|chr4:113672026-113672073,chr4,113672026,113672073,H1|chr4:113632500-113632585,chr4,113632500,113632585,1,39526
H1|chr4:113672135-113672186,chr4,113672135,113672186,H1|chr4:113630611-113630710,chr4,113630611,113630710,1,41524
H1|chr4:113672135-113672185,chr4,113672135,113672185,H1|chr4:113630611-113630710,chr4,113630611,113630710,1,41524
H1|chr4:113672752-113672867,chr4,113672752,113672867,H1|chr4:113739075-113739105,chr4,113739075,113739105,1,66323
H1|chr4:113672781-113672915,chr4,113672781,113672915,H1|chr4:113739075-113739105,chr4,113739075,113739105,1,66294
H1|chr4:113673712-113673769,chr4,113673712,113673769,H1|chr4:113632680-113632773,chr4,113632680,113632773,1,41032
H1|chr4:113673713-113673831,chr4,113673713,113673831,H1|chr4:113632862-113632957,chr4,113632862,113632957,1,40851
H1|chr4:113673713-113673768,chr4,113673713,113673768,H1|chr4:113632862-113632957,chr4,113632862,113632957,1,40851
H1|chr4:113675670-113675715,chr4,113675670,113675715,H1|chr4:113738089-113738170,chr4,113738089,113738170,1,62419
H1|chr4:113675837-113675860,chr4,113675837,113675860,H1|chr4:113632165-113632266,chr4,113632165,113632266,1,43672
H1|chr4:113676427-113676483,chr4,113676427,113676483,H1|chr4:113735345-113735394,chr4,113735345,113735394,1,58918
H1|chr4:113676493-113676619,chr4,113676493,113676619,H1|chr4:113736966-113737082,chr4,113736966,113737082,1,60473
H1|chr4:113677486-113677608,chr4,113677486,113677608,H1|chr4:113736274-113736342,chr4,113736274,113736342,1,58788
H1|chr4:113677486-113677568,chr4,113677486,113677568,H1|chr4:113736274-113736342,chr4,113736274,113736342,1,58788
H1|chr4:113677768-113677798,chr4,113677768,113677798,H1|chr4:113631698-113631757,chr4,113631698,113631757,1,46070
H1|chr4:113677864-113677954,chr4,113677864,113677954,H1|chr4:113632164-113632258,chr4,113632164,113632258,1,45700
H1|chr4:113677864-113677920,chr4,113677864,113677920,H1|chr4:113632164-113632258,chr4,113632164,113632258,1,45700
H1|chr4:113678327-113678433,chr4,113678327,113678433,H1|chr4:113737875-113737966,chr4,113737875,113737966,1,59548
H1|chr4:113678375-113678434,chr4,113678375,113678434,H1|chr4:113737875-113737966,chr4,113737875,113737966,1,59500
H1|chr4:113678463-113678581,chr4,113678463,113678581,H1|chr4:113738232-113738257,chr4,113738232,113738257,1,59769
H1|chr4:113679041-113679111,chr4,113679041,113679111,H1|chr4:113736316-113736373,chr4,113736316,113736373,1,57275
H1|chr4:113680307-113680386,chr4,113680307,113680386,H1|chr4:113630851-113630904,chr4,113630851,113630904,1,49456
H1|chr4:113680414-113680459,chr4,113680414,113680459,H1|chr4:113630615-113630689,chr4,113630615,113630689,1,49799
H1|chr4:113680414-113680456,chr4,113680414,113680456,H1|chr4:113630615-113630689,chr4,113630615,113630689,1,49799
H1|chr4:113680481-113680545,chr4,113680481,113680545,H1|chr4:113734459-113734546,chr4,113734459,113734546,1,53978
H1|chr4:113680481-113680544,chr4,113680481,113680544,H1|chr4:113734459-113734546,chr4,113734459,113734546,1,53978
H1|chr4:113680575-113680601,chr4,113680575,113680601,H1|chr4:113738015-113738152,chr4,113738015,113738152,1,57440
H1|chr4:113682174-113682233,chr4,113682174,113682233,H1|chr4:113631723-113631786,chr4,113631723,113631786,1,50451
H1|chr4:113682645-113682785,chr4,113682645,113682785,H1|chr4:113629955-113630047,chr4,113629955,113630047,1,52690
H1|chr4:113683837-113683915,chr4,113683837,113683915,H1|chr4:113632697-113632778,chr4,113632697,113632778,1,51140
H1|chr4:113683845-113683914,chr4,113683845,113683914,H1|chr4:113632697-113632778,chr4,113632697,113632778,1,51148
H1|chr4:113684526-113684564,chr4,113684526,113684564,H1|chr4:113738051-113738201,chr4,113738051,113738201,1,53525
H1|chr4:113684547-113684637,chr4,113684547,113684637,H1|chr4:113631661-113631710,chr4,113631661,113631710,1,52886
H1|chr4:113684577-113684689,chr4,113684577,113684689,H1|chr4:113630610-113630705,chr4,113630610,113630705,1,53967
H1|chr4:113684634-113684689,chr4,113684634,113684689,H1|chr4:113630610-113630705,chr4,113630610,113630705,1,54024
H1|chr4:113684988-113685090,chr4,113684988,113685090,H1|chr4:113736999-113737043,chr4,113736999,113737043,1,52011
H1|chr4:113685472-113685492,chr4,113685472,113685492,H1|chr4:113736201-113736338,chr4,113736201,113736338,1,50729
H1|chr4:113685495-113685602,chr4,113685495,113685602,H1|chr4:113630890-113630948,chr4,113630890,113630948,1,54605
H1|chr4:113685495-113685584,chr4,113685495,113685584,H1|chr4:113630890-113630948,chr4,113630890,113630948,1,54605
H1|chr4:113903701-113903736,chr4,113903701,113903736,H1|chr4:120381148-120381277,chr4,120381148,120381277,1,6477447
H1|chr4:113903701-113903719,chr4,113903701,113903719,H1|chr4:120381148-120381277,chr4,120381148,120381277,1,6477447
H1|chr4:128775735-128775882,chr4,128775735,128775882,H1|chr4:128799661-128799751,chr4,128799661,128799751,1,23926
H1|chr4:128775845-128775905,chr4,128775845,128775905,H1|chr4:128799661-128799751,chr4,128799661,128799751,1,23816
H1|chr4:128777055-128777104,chr4,128777055,128777104,H1|chr4:128797987-128798064,chr4,128797987,128798064,1,20932
H1|chr4:146749756-146749793,chr4,146749756,146749793,H1|chr4:146859980-146860064,chr4,146859980,146860064,1,110224
H1|chr4:146753325-146753365,chr4,146753325,146753365,H1|chr4:146859829-146859877,chr4,146859829,146859877,1,106504
H1|chr4:146757720-146757770,chr4,146757720,146757770,H1|chr4:188917431-188917537,chr4,188917431,188917537,1,42159711
H1|chr4:146757720-146757764,chr4,146757720,146757764,H1|chr4:188917431-188917537,chr4,188917431,188917537,1,42159711
H1|chr4:152363792-152363859,chr4,152363792,152363859,H1|chr4:123750669-123750698,chr4,123750669,123750698,1,28613123
H1|chr4:152363792-152363857,chr4,152363792,152363857,H1|chr4:123750669-123750698,chr4,123750669,123750698,1,28613123
H1|chr4:152363794-152363859,chr4,152363794,152363859,H1|chr4:123750669-123750698,chr4,123750669,123750698,1,28613125
H1|chr4:152373555-152373665,chr4,152373555,152373665,H1|chr4:152021400-152021435,chr4,152021400,152021435,1,352155
H1|chr4:152667125-152667201,chr4,152667125,152667201,H1|chr4:153701700-153701774,chr4,153701700,153701774,1,1034575
H1|chr4:152667236-152667272,chr4,152667236,152667272,H1|chr4:153701700-153701774,chr4,153701700,153701774,1,1034464
H1|chr4:184038140-184038253,chr4,184038140,184038253,H1|chr4:154126276-154126302,chr4,154126276,154126302,1,29911864
H1|chr4:184038141-184038253,chr4,184038141,184038253,H1|chr4:154126276-154126302,chr4,154126276,154126302,1,29911865
H1|chr4:184077307-184077337,chr4,184077307,184077337,H1|chr4:6198558-6198631,chr4,6198558,6198631,1,177878749
H1|chr4:184077319-184077337,chr4,184077319,184077337,H1|chr4:6198499-6198631,chr4,6198499,6198631,1,177878820
H1|chr4:184081936-184081999,chr4,184081936,184081999,H1|chr4:123751570-123751657,chr4,123751570,123751657,1,60330366
H1|chr4:184081936-184081990,chr4,184081936,184081990,H1|chr4:123751561-123751657,chr4,123751561,123751657,1,60330375
H1|chr5:78362-78445,chr5,78362,78445,H1|chr5:55290-55314,chr5,55290,55314,1,23072
H1|chr5:87139-87187,chr5,87139,87187,H1|chr5:57556-57655,chr5,57556,57655,1,29583
H1|chr5:784126-784225,chr5,784126,784225,H1|chr5:692841-692921,chr5,692841,692921,1,91285
H1|chr5:784127-784272,chr5,784127,784272,H1|chr5:692751-692898,chr5,692751,692898,1,91376
H1|chr5:784583-784728,chr5,784583,784728,H1|chr5:693278-693428,chr5,693278,693428,1,91305
H1|chr5:784641-784696,chr5,784641,784696,H1|chr5:693048-693166,chr5,693048,693166,1,91593
H1|chr5:785103-785252,chr5,785103,785252,H1|chr5:693682-693832,chr5,693682,693832,1,91421
H1|chr5:785181-785328,chr5,785181,785328,H1|chr5:693919-694066,chr5,693919,694066,1,91262
H1|chr5:785191-785335,chr5,785191,785335,H1|chr5:693735-693880,chr5,693735,693880,1,91456
H1|chr5:785527-785553,chr5,785527,785553,H1|chr5:693716-693837,chr5,693716,693837,1,91811
H1|chr5:785635-785675,chr5,785635,785675,H1|chr5:694518-694570,chr5,694518,694570,1,91117
H1|chr5:785697-785810,chr5,785697,785810,H1|chr5:696321-696419,chr5,696321,696419,1,89376
H1|chr5:785697-785731,chr5,785697,785731,H1|chr5:696321-696419,chr5,696321,696419,1,89376
H1|chr5:785701-785851,chr5,785701,785851,H1|chr5:694346-694382,chr5,694346,694382,1,91355
H1|chr5:787857-787969,chr5,787857,787969,H1|chr5:696525-696645,chr5,696525,696645,1,91332
H1|chr5:788662-788810,chr5,788662,788810,H1|chr5:697474-697624,chr5,697474,697624,1,91188
H1|chr5:788697-788782,chr5,788697,788782,H1|chr5:697312-697372,chr5,697312,697372,1,91385
H1|chr5:788697-788757,chr5,788697,788757,H1|chr5:697302-697372,chr5,697302,697372,1,91395
H1|chr5:788697-788754,chr5,788697,788754,H1|chr5:697302-697372,chr5,697302,697372,1,91395
H1|chr5:788716-788866,chr5,788716,788866,H1|chr5:697444-697594,chr5,697444,697594,1,91272
H1|chr5:788720-788815,chr5,788720,788815,H1|chr5:697444-697594,chr5,697444,697594,1,91276
H1|chr5:788728-788878,chr5,788728,788878,H1|chr5:697476-697621,chr5,697476,697621,1,91252
H1|chr5:788735-788880,chr5,788735,788880,H1|chr5:697441-697591,chr5,697441,697591,1,91294
H1|chr5:788748-788898,chr5,788748,788898,H1|chr5:697471-697621,chr5,697471,697621,1,91277
H1|chr5:788871-788964,chr5,788871,788964,H1|chr5:697715-697774,chr5,697715,697774,1,91156
H1|chr5:788871-788963,chr5,788871,788963,H1|chr5:697716-697774,chr5,697716,697774,1,91155
H1|chr5:788871-788962,chr5,788871,788962,H1|chr5:697715-697774,chr5,697715,697774,1,91156
H1|chr5:788871-788945,chr5,788871,788945,H1|chr5:697716-697774,chr5,697716,697774,1,91155
H1|chr5:1633157-1633195,chr5,1633157,1633195,H1|chr5:272203-272312,chr5,272203,272312,1,1360954
H1|chr5:1633340-1633490,chr5,1633340,1633490,H1|chr5:272436-272586,chr5,272436,272586,1,1360904
H1|chr5:1633445-1633533,chr5,1633445,1633533,H1|chr5:272383-272529,chr5,272383,272529,1,1361062
H1|chr5:1633449-1633599,chr5,1633449,1633599,H1|chr5:272212-272362,chr5,272212,272362,1,1361237
H1|chr5:1633477-1633602,chr5,1633477,1633602,H1|chr5:272104-272230,chr5,272104,272230,1,1361373
H1|chr5:7407743-7407817,chr5,7407743,7407817,H1|chr5:7395857-7395880,chr5,7395857,7395880,1,11886
H1|chr5:7407743-7407816,chr5,7407743,7407816,H1|chr5:7395857-7395880,chr5,7395857,7395880,1,11886
H1|chr5:7407765-7407817,chr5,7407765,7407817,H1|chr5:7395857-7395880,chr5,7395857,7395880,1,11908
H1|chr5:7409871-7409903,chr5,7409871,7409903,H1|chr5:7393104-7393203,chr5,7393104,7393203,1,16767
H1|chr5:7409871-7409902,chr5,7409871,7409902,H1|chr5:7393104-7393203,chr5,7393104,7393203,1,16767
H1|chr5:7414047-7414140,chr5,7414047,7414140,H1|chr5:7395320-7395386,chr5,7395320,7395386,1,18727
H1|chr5:7414047-7414131,chr5,7414047,7414131,H1|chr5:7395320-7395386,chr5,7395320,7395386,1,18727
H1|chr5:7418174-7418265,chr5,7418174,7418265,H1|chr5:25441120-25441245,chr5,25441120,25441245,1,18022946
H1|chr5:7418244-7418265,chr5,7418244,7418265,H1|chr5:25441120-25441245,chr5,25441120,25441245,1,18022876
H1|chr5:7421659-7421719,chr5,7421659,7421719,H1|chr5:76504016-76504073,chr5,76504016,76504073,1,69082357
H1|chr5:7423566-7423668,chr5,7423566,7423668,H1|chr5:25444748-25444794,chr5,25444748,25444794,1,18021182
H1|chr5:7423568-7423606,chr5,7423568,7423606,H1|chr5:25444748-25444794,chr5,25444748,25444794,1,18021180
H1|chr5:7663715-7663839,chr5,7663715,7663839,H1|chr5:6377681-6377710,chr5,6377681,6377710,1,1286034
H1|chr5:7663715-7663831,chr5,7663715,7663831,H1|chr5:6377681-6377710,chr5,6377681,6377710,1,1286034
H1|chr5:7663718-7663839,chr5,7663718,7663839,H1|chr5:6377681-6377710,chr5,6377681,6377710,1,1286037
H1|chr5:12669377-12669452,chr5,12669377,12669452,H1|chr5:25443873-25443948,chr5,25443873,25443948,1,12774496
H1|chr5:12670720-12670771,chr5,12670720,12670771,H1|chr5:25443512-25443567,chr5,25443512,25443567,1,12772792
H1|chr5:14196552-14196642,chr5,14196552,14196642,H1|chr5:27475222-27475306,chr5,27475222,27475306,1,13278670
H1|chr5:14196579-14196642,chr5,14196579,14196642,H1|chr5:27475222-27475306,chr5,27475222,27475306,1,13278643
H1|chr5:14216668-14216696,chr5,14216668,14216696,H1|chr5:25442250-25442280,chr5,25442250,25442280,1,11225582
H1|chr5:14226976-14227020,chr5,14226976,14227020,H1|chr5:54829466-54829520,chr5,54829466,54829520,1,40602490
H1|chr5:14251918-14251947,chr5,14251918,14251947,H1|chr5:25443369-25443405,chr5,25443369,25443405,1,11191451
H1|chr5:14251919-14251987,chr5,14251919,14251987,H1|chr5:25443404-25443488,chr5,25443404,25443488,1,11191485
H1|chr5:14440290-14440380,chr5,14440290,14440380,H1|chr5:25443634-25443691,chr5,25443634,25443691,1,11003344
H1|chr5:14440306-14440381,chr5,14440306,14440381,H1|chr5:25443615-25443690,chr5,25443615,25443690,1,11003309
H1|chr5:14445314-14445371,chr5,14445314,14445371,H1|chr5:25442144-25442237,chr5,25442144,25442237,1,10996830
H1|chr5:14445314-14445370,chr5,14445314,14445370,H1|chr5:25442186-25442238,chr5,25442186,25442238,1,10996872
H1|chr5:14452421-14452441,chr5,14452421,14452441,H1|chr5:141256781-141256802,chr5,141256781,141256802,1,126804360
H1|chr5:15691965-15692058,chr5,15691965,15692058,H1|chr5:140703917-140703934,chr5,140703917,140703934,1,125011952
H1|chr5:15691966-15692058,chr5,15691966,15692058,H1|chr5:140703917-140703934,chr5,140703917,140703934,1,125011951
H1|chr5:16709373-16709462,chr5,16709373,16709462,H1|chr5:25441556-25441581,chr5,25441556,25441581,1,8732183
H1|chr5:16728513-16728547,chr5,16728513,16728547,H1|chr5:25444600-25444654,chr5,25444600,25444654,1,8716087
H1|chr5:16728556-16728607,chr5,16728556,16728607,H1|chr5:25444256-25444339,chr5,25444256,25444339,1,8715700
H1|chr5:25445068-25445162,chr5,25445068,25445162,H1|chr5:27474625-27474660,chr5,27474625,27474660,1,2029557
H1|chr5:25445068-25445109,chr5,25445068,25445109,H1|chr5:16736242-16736335,chr5,16736242,16736335,1,8708826
H1|chr5:25445077-25445141,chr5,25445077,25445141,H1|chr5:16741139-16741189,chr5,16741139,16741189,1,8703938
H1|chr5:25445194-25445220,chr5,25445194,25445220,H1|chr5:16737932-16737966,chr5,16737932,16737966,1,8707262
H1|chr5:27473573-27473604,chr5,27473573,27473604,H1|chr5:147161087-147161122,chr5,147161087,147161122,1,119687514
H1|chr5:32282719-32282790,chr5,32282719,32282790,H1|chr5:25444515-25444550,chr5,25444515,25444550,1,6838204
H1|chr5:32283140-32283178,chr5,32283140,32283178,H1|chr5:25443192-25443221,chr5,25443192,25443221,1,6839948
H1|chr5:32298448-32298490,chr5,32298448,32298490,H1|chr5:140174351-140174459,chr5,140174351,140174459,1,107875903
H1|chr5:54785671-54785724,chr5,54785671,54785724,H1|chr5:56472636-56472763,chr5,56472636,56472763,1,1686965
H1|chr5:54787459-54787576,chr5,54787459,54787576,H1|chr5:56472359-56472408,chr5,56472359,56472408,1,1684900
H1|chr5:54787476-54787577,chr5,54787476,54787577,H1|chr5:56472359-56472408,chr5,56472359,56472408,1,1684883
H1|chr5:54787570-54787670,chr5,54787570,54787670,H1|chr5:69344437-69344556,chr5,69344437,69344556,1,14556867
H1|chr5:54787570-54787597,chr5,54787570,54787597,H1|chr5:69344437-69344556,chr5,69344437,69344556,1,14556867
H1|chr5:54787570-54787596,chr5,54787570,54787596,H1|chr5:69344437-69344556,chr5,69344437,69344556,1,14556867
H1|chr5:54787574-54787669,chr5,54787574,54787669,H1|chr5:69344437-69344556,chr5,69344437,69344556,1,14556863
H1|chr5:54788375-54788448,chr5,54788375,54788448,H1|chr5:56472516-56472567,chr5,56472516,56472567,1,1684141
H1|chr5:54792881-54793026,chr5,54792881,54793026,H1|chr5:178287264-178287361,chr5,178287264,178287361,1,123494383
H1|chr5:71601404-71601495,chr5,71601404,71601495,H1|chr5:74160926-74160965,chr5,74160926,74160965,1,2559522
H1|chr5:71601404-71601493,chr5,71601404,71601493,H1|chr5:74160926-74160965,chr5,74160926,74160965,1,2559522
H1|chr5:74764288-74764320,chr5,74764288,74764320,H1|chr5:31529873-31529944,chr5,31529873,31529944,1,43234415
H1|chr5:78556483-78556513,chr5,78556483,78556513,H1|chr5:76504311-76504352,chr5,76504311,76504352,1,2052172
H1|chr5:79471096-79471165,chr5,79471096,79471165,H1|chr5:79552302-79552366,chr5,79552302,79552366,1,81206
H1|chr5:79471447-79471488,chr5,79471447,79471488,H1|chr5:79554260-79554334,chr5,79554260,79554334,1,82813
H1|chr5:79480004-79480069,chr5,79480004,79480069,H1|chr5:94890201-94890233,chr5,94890201,94890233,1,15410197
H1|chr5:79481327-79481362,chr5,79481327,79481362,H1|chr5:76787180-76787277,chr5,76787180,76787277,1,2694147
H1|chr5:79481391-79481541,chr5,79481391,79481541,H1|chr5:76787138-76787272,chr5,76787138,76787272,1,2694253
H1|chr5:79481423-79481567,chr5,79481423,79481567,H1|chr5:76787122-76787272,chr5,76787122,76787272,1,2694301
H1|chr5:81715659-81715690,chr5,81715659,81715690,H1|chr5:175631346-175631465,chr5,175631346,175631465,1,93915687
H1|chr5:81715660-81715686,chr5,81715660,81715686,H1|chr5:175631346-175631465,chr5,175631346,175631465,1,93915686
H1|chr5:82097504-82097585,chr5,82097504,82097585,H1|chr5:147248684-147248705,chr5,147248684,147248705,1,65151180
H1|chr5:82120981-82121097,chr5,82120981,82121097,H1|chr5:147250704-147250854,chr5,147250704,147250854,1,65129723
H1|chr5:87693418-87693467,chr5,87693418,87693467,H1|chr5:613266-613305,chr5,613266,613305,1,87080152
H1|chr5:87693466-87693495,chr5,87693466,87693495,H1|chr5:613267-613305,chr5,613267,613305,1,87080199
H1|chr5:90228727-90228824,chr5,90228727,90228824,H1|chr5:79550716-79550769,chr5,79550716,79550769,1,10678011
H1|chr5:90228728-90228818,chr5,90228728,90228818,H1|chr5:79550716-79550769,chr5,79550716,79550769,1,10678012
H1|chr5:93691989-93692137,chr5,93691989,93692137,H1|chr5:25441511-25441569,chr5,25441511,25441569,1,68250478
H1|chr5:93691989-93692081,chr5,93691989,93692081,H1|chr5:25441511-25441569,chr5,25441511,25441569,1,68250478
H1|chr5:93691996-93692140,chr5,93691996,93692140,H1|chr5:34658434-34658509,chr5,34658434,34658509,1,59033562
H1|chr5:93691996-93692071,chr5,93691996,93692071,H1|chr5:34658434-34658509,chr5,34658434,34658509,1,59033562
H1|chr5:93691996-93692066,chr5,93691996,93692066,H1|chr5:34658434-34658509,chr5,34658434,34658509,1,59033562
H1|chr5:93692037-93692132,chr5,93692037,93692132,H1|chr5:25441511-25441569,chr5,25441511,25441569,1,68250526
H1|chr5:93692496-93692610,chr5,93692496,93692610,H1|chr5:25443602-25443638,chr5,25443602,25443638,1,68248894
H1|chr5:93692496-93692571,chr5,93692496,93692571,H1|chr5:25443565-25443638,chr5,25443565,25443638,1,68248931
H1|chr5:93694566-93694619,chr5,93694566,93694619,H1|chr5:61604726-61604791,chr5,61604726,61604791,1,32089840
H1|chr5:93694760-93694804,chr5,93694760,93694804,H1|chr5:115907171-115907195,chr5,115907171,115907195,1,22212411
H1|chr5:93696135-93696215,chr5,93696135,93696215,H1|chr5:115905868-115905909,chr5,115905868,115905909,1,22209733
H1|chr5:106315042-106315185,chr5,106315042,106315185,H1|chr5:147252686-147252771,chr5,147252686,147252771,1,40937644
H1|chr5:106315120-106315185,chr5,106315120,106315185,H1|chr5:147252686-147252771,chr5,147252686,147252771,1,40937566
H1|chr5:106315643-106315721,chr5,106315643,106315721,H1|chr5:147246122-147246168,chr5,147246122,147246168,1,40930479
H1|chr5:106315644-106315726,chr5,106315644,106315726,H1|chr5:147252464-147252610,chr5,147252464,147252610,1,40936820
H1|chr5:106316352-106316428,chr5,106316352,106316428,H1|chr5:147251778-147251925,chr5,147251778,147251925,1,40935426
H1|chr5:106316859-106316922,chr5,106316859,106316922,H1|chr5:147251574-147251657,chr5,147251574,147251657,1,40934715
H1|chr5:106316859-106316919,chr5,106316859,106316919,H1|chr5:147251574-147251664,chr5,147251574,147251664,1,40934715
H1|chr5:106316948-106316973,chr5,106316948,106316973,H1|chr5:147251445-147251595,chr5,147251445,147251595,1,40934497
H1|chr5:106317205-106317355,chr5,106317205,106317355,H1|chr5:147250990-147251090,chr5,147250990,147251090,1,40933785
H1|chr5:106317432-106317465,chr5,106317432,106317465,H1|chr5:147250776-147250900,chr5,147250776,147250900,1,40933344
H1|chr5:106317870-106317953,chr5,106317870,106317953,H1|chr5:147250348-147250483,chr5,147250348,147250483,1,40932478
H1|chr5:106321862-106321987,chr5,106321862,106321987,H1|chr5:147246111-147246136,chr5,147246111,147246136,1,40924249
H1|chr5:106838906-106838923,chr5,106838906,106838923,H1|chr5:107007767-107007910,chr5,107007767,107007910,1,168861
H1|chr5:106863800-106863924,chr5,106863800,106863924,H1|chr5:107007596-107007670,chr5,107007596,107007670,1,143796
H1|chr5:106863800-106863846,chr5,106863800,106863846,H1|chr5:107007596-107007670,chr5,107007596,107007670,1,143796
H1|chr5:106863899-106863929,chr5,106863899,106863929,H1|chr5:107007596-107007670,chr5,107007596,107007670,1,143697
H1|chr5:106924345-106924385,chr5,106924345,106924385,H1|chr5:150828241-150828351,chr5,150828241,150828351,1,43903896
H1|chr5:106924345-106924374,chr5,106924345,106924374,H1|chr5:150828241-150828350,chr5,150828241,150828350,1,43903896
H1|chr5:106924350-106924418,chr5,106924350,106924418,H1|chr5:150828241-150828350,chr5,150828241,150828350,1,43903891
H1|chr5:109173367-109173397,chr5,109173367,109173397,H1|chr5:107007802-107007851,chr5,107007802,107007851,1,2165565
H1|chr5:115852684-115852736,chr5,115852684,115852736,H1|chr5:6449548-6449565,chr5,6449548,6449565,1,109403136
H1|chr5:115852684-115852726,chr5,115852684,115852726,H1|chr5:6449548-6449565,chr5,6449548,6449565,1,109403136
H1|chr5:115903044-115903096,chr5,115903044,115903096,H1|chr5:141699968-141700023,chr5,141699968,141700023,1,25796924
H1|chr5:115903057-115903098,chr5,115903057,115903098,H1|chr5:141699970-141700023,chr5,141699970,141700023,1,25796913
H1|chr5:116382508-116382658,chr5,116382508,116382658,H1|chr5:147249713-147249863,chr5,147249713,147249863,1,30867205
H1|chr5:116382513-116382654,chr5,116382513,116382654,H1|chr5:147249922-147249953,chr5,147249922,147249953,1,30867409
H1|chr5:116382553-116382616,chr5,116382553,116382616,H1|chr5:147249761-147249871,chr5,147249761,147249871,1,30867208
H1|chr5:116382582-116382619,chr5,116382582,116382619,H1|chr5:147249787-147249896,chr5,147249787,147249896,1,30867205
H1|chr5:116382583-116382633,chr5,116382583,116382633,H1|chr5:147249892-147249926,chr5,147249892,147249926,1,30867309
H1|chr5:116382591-116382636,chr5,116382591,116382636,H1|chr5:147249877-147249923,chr5,147249877,147249923,1,30867286
H1|chr5:116385243-116385259,chr5,116385243,116385259,H1|chr5:147251597-147251728,chr5,147251597,147251728,1,30866354
H1|chr5:116385564-116385714,chr5,116385564,116385714,H1|chr5:147251844-147251994,chr5,147251844,147251994,1,30866280
H1|chr5:116385598-116385746,chr5,116385598,116385746,H1|chr5:147252211-147252361,chr5,147252211,147252361,1,30866613
H1|chr5:122431297-122431342,chr5,122431297,122431342,H1|chr5:154137447-154137551,chr5,154137447,154137551,1,31706150
H1|chr5:122431299-122431342,chr5,122431299,122431342,H1|chr5:154137461-154137551,chr5,154137461,154137551,1,31706162
H1|chr5:122431299-122431338,chr5,122431299,122431338,H1|chr5:154137447-154137551,chr5,154137447,154137551,1,31706148
H1|chr5:124045916-124045977,chr5,124045916,124045977,H1|chr5:179249277-179249412,chr5,179249277,179249412,1,55203361
H1|chr5:133870747-133870894,chr5,133870747,133870894,H1|chr5:141734992-141735038,chr5,141734992,141735038,1,7864245
H1|chr5:133870748-133870894,chr5,133870748,133870894,H1|chr5:141734992-141735038,chr5,141734992,141735038,1,7864244
H1|chr5:133870810-133870899,chr5,133870810,133870899,H1|chr5:141734992-141735038,chr5,141734992,141735038,1,7864182
H1|chr5:139015247-139015311,chr5,139015247,139015311,H1|chr5:139024795-139024855,chr5,139024795,139024855,1,9548
H1|chr5:139018567-139018637,chr5,139018567,139018637,H1|chr5:139026451-139026531,chr5,139026451,139026531,1,7884
H1|chr5:139018569-139018684,chr5,139018569,139018684,H1|chr5:139026451-139026531,chr5,139026451,139026531,1,7882
H1|chr5:141188808-141188908,chr5,141188808,141188908,H1|chr5:141061008-141061040,chr5,141061008,141061040,1,127800
H1|chr5:141188808-141188893,chr5,141188808,141188893,H1|chr5:141061008-141061040,chr5,141061008,141061040,1,127800
H1|chr5:141195460-141195569,chr5,141195460,141195569,H1|chr5:141706916-141706957,chr5,141706916,141706957,1,511456
H1|chr5:141195595-141195745,chr5,141195595,141195745,H1|chr5:141706916-141706957,chr5,141706916,141706957,1,511321
H1|chr5:141214402-141214527,chr5,141214402,141214527,H1|chr5:141703223-141703319,chr5,141703223,141703319,1,488821
H1|chr5:141214473-141214527,chr5,141214473,141214527,H1|chr5:141703223-141703319,chr5,141703223,141703319,1,488750
H1|chr5:141230548-141230650,chr5,141230548,141230650,H1|chr5:141255464-141255546,chr5,141255464,141255546,1,24916
H1|chr5:141230548-141230574,chr5,141230548,141230574,H1|chr5:141255464-141255546,chr5,141255464,141255546,1,24916
H1|chr5:141231486-141231512,chr5,141231486,141231512,H1|chr5:141258170-141258260,chr5,141258170,141258260,1,26684
H1|chr5:141231488-141231512,chr5,141231488,141231512,H1|chr5:141258170-141258260,chr5,141258170,141258260,1,26682
H1|chr5:141231622-141231666,chr5,141231622,141231666,H1|chr5:141256918-141256952,chr5,141256918,141256952,1,25296
H1|chr5:141232285-141232342,chr5,141232285,141232342,H1|chr5:171883926-171883951,chr5,171883926,171883951,1,30651641
H1|chr5:141232285-141232340,chr5,141232285,141232340,H1|chr5:171883926-171883951,chr5,171883926,171883951,1,30651641
H1|chr5:141232384-141232451,chr5,141232384,141232451,H1|chr5:171883926-171883949,chr5,171883926,171883949,1,30651542
H1|chr5:141643876-141643979,chr5,141643876,141643979,H1|chr5:141704189-141704207,chr5,141704189,141704207,1,60313
H1|chr5:141647057-141647166,chr5,141647057,141647166,H1|chr5:141703115-141703155,chr5,141703115,141703155,1,56058
H1|chr5:141663044-141663067,chr5,141663044,141663067,H1|chr5:141704272-141704396,chr5,141704272,141704396,1,41228
H1|chr5:141668077-141668097,chr5,141668077,141668097,H1|chr5:141701844-141701994,chr5,141701844,141701994,1,33767
H1|chr5:141669696-141669791,chr5,141669696,141669791,H1|chr5:141705177-141705245,chr5,141705177,141705245,1,35481
H1|chr5:141669709-141669791,chr5,141669709,141669791,H1|chr5:141705177-141705245,chr5,141705177,141705245,1,35468
H1|chr5:141669932-141670024,chr5,141669932,141670024,H1|chr5:141703900-141703987,chr5,141703900,141703987,1,33968
H1|chr5:141669961-141670024,chr5,141669961,141670024,H1|chr5:141703900-141703987,chr5,141703900,141703987,1,33939
H1|chr5:141672518-141672591,chr5,141672518,141672591,H1|chr5:141700213-141700263,chr5,141700213,141700263,1,27695
H1|chr5:141673723-141673788,chr5,141673723,141673788,H1|chr5:141702495-141702567,chr5,141702495,141702567,1,28772
H1|chr5:141674500-141674518,chr5,141674500,141674518,H1|chr5:141700556-141700668,chr5,141700556,141700668,1,26056
H1|chr5:141674501-141674518,chr5,141674501,141674518,H1|chr5:141700556-141700668,chr5,141700556,141700668,1,26055
H1|chr5:141695386-141695433,chr5,141695386,141695433,H1|chr5:141735174-141735229,chr5,141735174,141735229,1,39788
H1|chr5:141695387-141695433,chr5,141695387,141695433,H1|chr5:141735174-141735229,chr5,141735174,141735229,1,39787
H1|chr5:141698470-141698539,chr5,141698470,141698539,H1|chr5:141734320-141734380,chr5,141734320,141734380,1,35850
H1|chr5:141698471-141698539,chr5,141698471,141698539,H1|chr5:141734320-141734380,chr5,141734320,141734380,1,35849
H1|chr5:141782109-141782167,chr5,141782109,141782167,H1|chr5:115908525-115908593,chr5,115908525,115908593,1,25873584
H1|chr5:141782113-141782167,chr5,141782113,141782167,H1|chr5:115908525-115908593,chr5,115908525,115908593,1,25873588
H1|chr5:142207623-142207662,chr5,142207623,142207662,H1|chr5:140571336-140571390,chr5,140571336,140571390,1,1636287
H1|chr5:146168439-146168464,chr5,146168439,146168464,H1|chr5:72411424-72411574,chr5,72411424,72411574,1,73757015
H1|chr5:146812190-146812238,chr5,146812190,146812238,H1|chr5:147251304-147251406,chr5,147251304,147251406,1,439114
H1|chr5:146812793-146812892,chr5,146812793,146812892,H1|chr5:147251763-147251910,chr5,147251763,147251910,1,438970
H1|chr5:146816470-146816536,chr5,146816470,146816536,H1|chr5:147250372-147250497,chr5,147250372,147250497,1,433902
H1|chr5:146817439-146817493,chr5,146817439,146817493,H1|chr5:147252988-147253058,chr5,147252988,147253058,1,435549
H1|chr5:146817445-146817493,chr5,146817445,146817493,H1|chr5:147252988-147253058,chr5,147252988,147253058,1,435543
H1|chr5:146819299-146819400,chr5,146819299,146819400,H1|chr5:147249323-147249375,chr5,147249323,147249375,1,430024
H1|chr5:146819339-146819400,chr5,146819339,146819400,H1|chr5:147249323-147249375,chr5,147249323,147249375,1,429984
H1|chr5:146823566-146823647,chr5,146823566,146823647,H1|chr5:147251856-147251989,chr5,147251856,147251989,1,428290
H1|chr5:146823630-146823647,chr5,146823630,146823647,H1|chr5:147251856-147251989,chr5,147251856,147251989,1,428226
H1|chr5:146865206-146865305,chr5,146865206,146865305,H1|chr5:140787299-140787359,chr5,140787299,140787359,1,6077907
H1|chr5:146865215-146865305,chr5,146865215,146865305,H1|chr5:140787299-140787359,chr5,140787299,140787359,1,6077916
H1|chr5:146868782-146868902,chr5,146868782,146868902,H1|chr5:140765328-140765358,chr5,140765328,140765358,1,6103454
H1|chr5:146939584-146939653,chr5,146939584,146939653,H1|chr5:147246831-147246861,chr5,147246831,147246861,1,307247
H1|chr5:146942748-146942807,chr5,146942748,146942807,H1|chr5:147764165-147764188,chr5,147764165,147764188,1,821417
H1|chr5:146945357-146945413,chr5,146945357,146945413,H1|chr5:147256275-147256415,chr5,147256275,147256415,1,310918
H1|chr5:146946537-146946602,chr5,146946537,146946602,H1|chr5:147246758-147246886,chr5,147246758,147246886,1,300221
H1|chr5:146946753-146946831,chr5,146946753,146946831,H1|chr5:146829883-146829938,chr5,146829883,146829938,1,116870
H1|chr5:146947105-146947182,chr5,146947105,146947182,H1|chr5:147248020-147248099,chr5,147248020,147248099,1,300915
H1|chr5:146947111-146947182,chr5,146947111,146947182,H1|chr5:147248020-147248099,chr5,147248020,147248099,1,300909
H1|chr5:146952877-146952924,chr5,146952877,146952924,H1|chr5:146829777-146829897,chr5,146829777,146829897,1,123100
H1|chr5:146952906-146952924,chr5,146952906,146952924,H1|chr5:146829777-146829897,chr5,146829777,146829897,1,123129
H1|chr5:147239777-147239818,chr5,147239777,147239818,H1|chr5:147248686-147248773,chr5,147248686,147248773,1,8909
H1|chr5:147239842-147239918,chr5,147239842,147239918,H1|chr5:147251612-147251754,chr5,147251612,147251754,1,11770
H1|chr5:147240084-147240108,chr5,147240084,147240108,H1|chr5:147247789-147247935,chr5,147247789,147247935,1,7705
H1|chr5:147240375-147240419,chr5,147240375,147240419,H1|chr5:147249866-147249916,chr5,147249866,147249916,1,9491
H1|chr5:147240504-147240638,chr5,147240504,147240638,H1|chr5:147251545-147251648,chr5,147251545,147251648,1,11041
H1|chr5:147240504-147240543,chr5,147240504,147240543,H1|chr5:147251545-147251648,chr5,147251545,147251648,1,11041
H1|chr5:147240792-147240836,chr5,147240792,147240836,H1|chr5:147253396-147253466,chr5,147253396,147253466,1,12604
H1|chr5:147240851-147240879,chr5,147240851,147240879,H1|chr5:147249292-147249378,chr5,147249292,147249378,1,8441
H1|chr5:147240898-147240934,chr5,147240898,147240934,H1|chr5:147246048-147246159,chr5,147246048,147246159,1,5150
H1|chr5:147240898-147240924,chr5,147240898,147240924,H1|chr5:147249959-147250019,chr5,147249959,147250019,1,9061
H1|chr5:147240899-147240924,chr5,147240899,147240924,H1|chr5:147249959-147250019,chr5,147249959,147250019,1,9060
H1|chr5:147240951-147240980,chr5,147240951,147240980,H1|chr5:147251357-147251463,chr5,147251357,147251463,1,10406
H1|chr5:147240952-147240980,chr5,147240952,147240980,H1|chr5:147251357-147251463,chr5,147251357,147251463,1,10405
H1|chr5:147241047-147241116,chr5,147241047,147241116,H1|chr5:147246173-147246254,chr5,147246173,147246254,1,5126
H1|chr5:147241062-147241088,chr5,147241062,147241088,H1|chr5:147245790-147245864,chr5,147245790,147245864,1,4728
H1|chr5:147241063-147241088,chr5,147241063,147241088,H1|chr5:147245790-147245864,chr5,147245790,147245864,1,4727
H1|chr5:147241065-147241116,chr5,147241065,147241116,H1|chr5:147247351-147247458,chr5,147247351,147247458,1,6286
H1|chr5:147241081-147241116,chr5,147241081,147241116,H1|chr5:147247351-147247458,chr5,147247351,147247458,1,6270
H1|chr5:147241209-147241288,chr5,147241209,147241288,H1|chr5:147250945-147250972,chr5,147250945,147250972,1,9736
H1|chr5:147241252-147241343,chr5,147241252,147241343,H1|chr5:147246117-147246238,chr5,147246117,147246238,1,4865
H1|chr5:147241253-147241282,chr5,147241253,147241282,H1|chr5:147246117-147246238,chr5,147246117,147246238,1,4864
H1|chr5:147241259-147241373,chr5,147241259,147241373,H1|chr5:147252632-147252670,chr5,147252632,147252670,1,11373
H1|chr5:147241261-147241373,chr5,147241261,147241373,H1|chr5:147252632-147252670,chr5,147252632,147252670,1,11371
H1|chr5:147241283-147241373,chr5,147241283,147241373,H1|chr5:147247929-147247994,chr5,147247929,147247994,1,6646
H1|chr5:147241288-147241373,chr5,147241288,147241373,H1|chr5:147247929-147247994,chr5,147247929,147247994,1,6641
H1|chr5:147241512-147241535,chr5,147241512,147241535,H1|chr5:147245908-147246035,chr5,147245908,147246035,1,4396
H1|chr5:147241569-147241593,chr5,147241569,147241593,H1|chr5:147252390-147252465,chr5,147252390,147252465,1,10821
H1|chr5:147241744-147241808,chr5,147241744,147241808,H1|chr5:147247832-147247899,chr5,147247832,147247899,1,6088
H1|chr5:147241745-147241808,chr5,147241745,147241808,H1|chr5:147247832-147247900,chr5,147247832,147247900,1,6087
H1|chr5:147241837-147241889,chr5,147241837,147241889,H1|chr5:147252464-147252559,chr5,147252464,147252559,1,10627
H1|chr5:147241840-147241930,chr5,147241840,147241930,H1|chr5:147252464-147252559,chr5,147252464,147252559,1,10624
H1|chr5:147241845-147241960,chr5,147241845,147241960,H1|chr5:147252990-147253025,chr5,147252990,147253025,1,11145
H1|chr5:147241860-147242010,chr5,147241860,147242010,H1|chr5:147252990-147253025,chr5,147252990,147253025,1,11130
H1|chr5:147241912-147241945,chr5,147241912,147241945,H1|chr5:147252454-147252524,chr5,147252454,147252524,1,10542
H1|chr5:147242049-147242082,chr5,147242049,147242082,H1|chr5:147248450-147248600,chr5,147248450,147248600,1,6401
H1|chr5:147242059-147242161,chr5,147242059,147242161,H1|chr5:147247758-147247829,chr5,147247758,147247829,1,5699
H1|chr5:147242071-147242157,chr5,147242071,147242157,H1|chr5:147250040-147250063,chr5,147250040,147250063,1,7969
H1|chr5:147242077-147242178,chr5,147242077,147242178,H1|chr5:147247623-147247680,chr5,147247623,147247680,1,5546
H1|chr5:147242077-147242170,chr5,147242077,147242170,H1|chr5:147247623-147247680,chr5,147247623,147247680,1,5546
H1|chr5:147242081-147242102,chr5,147242081,147242102,H1|chr5:147252448-147252594,chr5,147252448,147252594,1,10367
H1|chr5:147242082-147242161,chr5,147242082,147242161,H1|chr5:147247758-147247829,chr5,147247758,147247829,1,5676
H1|chr5:147242157-147242187,chr5,147242157,147242187,H1|chr5:147249922-147250021,chr5,147249922,147250021,1,7765
H1|chr5:147242159-147242187,chr5,147242159,147242187,H1|chr5:147249922-147250021,chr5,147249922,147250021,1,7763
H1|chr5:147242167-147242242,chr5,147242167,147242242,H1|chr5:147251446-147251487,chr5,147251446,147251487,1,9279
H1|chr5:147242172-147242242,chr5,147242172,147242242,H1|chr5:147251446-147251487,chr5,147251446,147251487,1,9274
H1|chr5:147242186-147242302,chr5,147242186,147242302,H1|chr5:147247254-147247317,chr5,147247254,147247317,1,5068
H1|chr5:147242215-147242302,chr5,147242215,147242302,H1|chr5:147247254-147247317,chr5,147247254,147247317,1,5039
H1|chr5:147242240-147242294,chr5,147242240,147242294,H1|chr5:147252691-147252785,chr5,147252691,147252785,1,10451
H1|chr5:147242270-147242291,chr5,147242270,147242291,H1|chr5:147251543-147251645,chr5,147251543,147251645,1,9273
H1|chr5:147242322-147242373,chr5,147242322,147242373,H1|chr5:147252845-147252927,chr5,147252845,147252927,1,10523
H1|chr5:147242376-147242421,chr5,147242376,147242421,H1|chr5:147246417-147246504,chr5,147246417,147246504,1,4041
H1|chr5:147242488-147242558,chr5,147242488,147242558,H1|chr5:147248294-147248335,chr5,147248294,147248335,1,5806
H1|chr5:147242489-147242565,chr5,147242489,147242565,H1|chr5:147252287-147252358,chr5,147252287,147252358,1,9798
H1|chr5:147242649-147242691,chr5,147242649,147242691,H1|chr5:147251508-147251616,chr5,147251508,147251616,1,8859
H1|chr5:147242650-147242695,chr5,147242650,147242695,H1|chr5:147249204-147249258,chr5,147249204,147249258,1,6554
H1|chr5:147242668-147242726,chr5,147242668,147242726,H1|chr5:147250720-147250857,chr5,147250720,147250857,1,8052
H1|chr5:147242686-147242747,chr5,147242686,147242747,H1|chr5:147252296-147252378,chr5,147252296,147252378,1,9610
H1|chr5:147242698-147242801,chr5,147242698,147242801,H1|chr5:147253526-147253573,chr5,147253526,147253573,1,10828
H1|chr5:147242700-147242762,chr5,147242700,147242762,H1|chr5:147252611-147252693,chr5,147252611,147252693,1,9911
H1|chr5:147242704-147242854,chr5,147242704,147242854,H1|chr5:147248118-147248163,chr5,147248118,147248163,1,5414
H1|chr5:147242718-147242814,chr5,147242718,147242814,H1|chr5:147253526-147253573,chr5,147253526,147253573,1,10808
H1|chr5:147242726-147242832,chr5,147242726,147242832,H1|chr5:147252837-147252904,chr5,147252837,147252904,1,10111
H1|chr5:147242726-147242809,chr5,147242726,147242809,H1|chr5:147252837-147252904,chr5,147252837,147252904,1,10111
H1|chr5:147242732-147242762,chr5,147242732,147242762,H1|chr5:147247947-147248044,chr5,147247947,147248044,1,5215
H1|chr5:147242734-147242762,chr5,147242734,147242762,H1|chr5:147247947-147248044,chr5,147247947,147248044,1,5213
H1|chr5:147242749-147242854,chr5,147242749,147242854,H1|chr5:147248118-147248163,chr5,147248118,147248163,1,5369
H1|chr5:147242770-147242818,chr5,147242770,147242818,H1|chr5:147247238-147247294,chr5,147247238,147247294,1,4468
H1|chr5:147242773-147242799,chr5,147242773,147242799,H1|chr5:147250130-147250280,chr5,147250130,147250280,1,7357
H1|chr5:147242781-147242804,chr5,147242781,147242804,H1|chr5:147252648-147252774,chr5,147252648,147252774,1,9867
H1|chr5:147242781-147242803,chr5,147242781,147242803,H1|chr5:147252648-147252774,chr5,147252648,147252774,1,9867
H1|chr5:154062482-154062597,chr5,154062482,154062597,H1|chr5:154134201-154134307,chr5,154134201,154134307,1,71719
H1|chr5:154062492-154062597,chr5,154062492,154062597,H1|chr5:154134201-154134241,chr5,154134201,154134241,1,71709
H1|chr5:154062553-154062597,chr5,154062553,154062597,H1|chr5:154134201-154134307,chr5,154134201,154134307,1,71648
H1|chr5:154064832-154064882,chr5,154064832,154064882,H1|chr5:154136215-154136315,chr5,154136215,154136315,1,71383
H1|chr5:154064833-154064914,chr5,154064833,154064914,H1|chr5:154136215-154136315,chr5,154136215,154136315,1,71382
H1|chr5:154065195-154065300,chr5,154065195,154065300,H1|chr5:154090441-154090459,chr5,154090441,154090459,1,25246
H1|chr5:154065277-154065364,chr5,154065277,154065364,H1|chr5:154098955-154098992,chr5,154098955,154098992,1,33678
H1|chr5:154065780-154065810,chr5,154065780,154065810,H1|chr5:154088604-154088699,chr5,154088604,154088699,1,22824
H1|chr5:154069263-154069354,chr5,154069263,154069354,H1|chr5:154089208-154089285,chr5,154089208,154089285,1,19945
H1|chr5:154069263-154069336,chr5,154069263,154069336,H1|chr5:154089208-154089285,chr5,154089208,154089285,1,19945
H1|chr5:154072470-154072519,chr5,154072470,154072519,H1|chr5:154100137-154100268,chr5,154100137,154100268,1,27667
H1|chr5:154072472-154072518,chr5,154072472,154072518,H1|chr5:154100137-154100268,chr5,154100137,154100268,1,27665
H1|chr5:154072979-154073023,chr5,154072979,154073023,H1|chr5:154091268-154091349,chr5,154091268,154091349,1,18289
H1|chr5:154073793-154073898,chr5,154073793,154073898,H1|chr5:154091347-154091370,chr5,154091347,154091370,1,17554
H1|chr5:154073824-154073967,chr5,154073824,154073967,H1|chr5:154099526-154099585,chr5,154099526,154099585,1,25702
H1|chr5:154073824-154073888,chr5,154073824,154073888,H1|chr5:154099526-154099585,chr5,154099526,154099585,1,25702
H1|chr5:154073829-154073979,chr5,154073829,154073979,H1|chr5:154099675-154099755,chr5,154099675,154099755,1,25846
H1|chr5:154074021-154074102,chr5,154074021,154074102,H1|chr5:154100045-154100114,chr5,154100045,154100114,1,26024
H1|chr5:154074024-154074110,chr5,154074024,154074110,H1|chr5:154100045-154100114,chr5,154100045,154100114,1,26021
H1|chr5:154075081-154075156,chr5,154075081,154075156,H1|chr5:154091860-154091903,chr5,154091860,154091903,1,16779
H1|chr5:154075106-154075200,chr5,154075106,154075200,H1|chr5:154091860-154091903,chr5,154091860,154091903,1,16754
H1|chr5:154075388-154075445,chr5,154075388,154075445,H1|chr5:154088183-154088278,chr5,154088183,154088278,1,12795
H1|chr5:154075626-154075654,chr5,154075626,154075654,H1|chr5:154090040-154090138,chr5,154090040,154090138,1,14414
H1|chr5:154075969-154076060,chr5,154075969,154076060,H1|chr5:154088896-154088952,chr5,154088896,154088952,1,12927
H1|chr5:154077503-154077598,chr5,154077503,154077598,H1|chr5:154087532-154087578,chr5,154087532,154087578,1,10029
H1|chr5:154077509-154077600,chr5,154077509,154077600,H1|chr5:154088633-154088700,chr5,154088633,154088700,1,11124
H1|chr5:154077520-154077600,chr5,154077520,154077600,H1|chr5:154088633-154088700,chr5,154088633,154088700,1,11113
H1|chr5:154147705-154147811,chr5,154147705,154147811,H1|chr5:25443459-25443503,chr5,25443459,25443503,1,128704246
H1|chr5:154150623-154150683,chr5,154150623,154150683,H1|chr5:138631519-138631624,chr5,138631519,138631624,1,15519104
H1|chr5:154151260-154151310,chr5,154151260,154151310,H1|chr5:154089457-154089523,chr5,154089457,154089523,1,61803
H1|chr5:154152603-154152648,chr5,154152603,154152648,H1|chr5:154091974-154092056,chr5,154091974,154092056,1,60629
H1|chr5:154154649-154154690,chr5,154154649,154154690,H1|chr5:124081199-124081273,chr5,124081199,124081273,1,30073450
H1|chr5:154154766-154154857,chr5,154154766,154154857,H1|chr5:171438155-171438301,chr5,171438155,171438301,1,17283389
H1|chr5:154154766-154154853,chr5,154154766,154154853,H1|chr5:171438026-171438089,chr5,171438026,171438089,1,17283260
H1|chr5:154154766-154154829,chr5,154154766,154154829,H1|chr5:171438171-171438301,chr5,171438171,171438301,1,17283405
H1|chr5:154160260-154160352,chr5,154160260,154160352,H1|chr5:118788512-118788569,chr5,118788512,118788569,1,35371748
H1|chr5:154160329-154160475,chr5,154160329,154160475,H1|chr5:118788512-118788569,chr5,118788512,118788569,1,35371817
H1|chr5:154160881-154161031,chr5,154160881,154161031,H1|chr5:138631715-138631775,chr5,138631715,138631775,1,15529166
H1|chr5:154161048-154161135,chr5,154161048,154161135,H1|chr5:138631715-138631775,chr5,138631715,138631775,1,15529333
H1|chr5:154164227-154164321,chr5,154164227,154164321,H1|chr5:154091398-154091510,chr5,154091398,154091510,1,72829
H1|chr5:154166489-154166539,chr5,154166489,154166539,H1|chr5:25443632-25443710,chr5,25443632,25443710,1,128722857
H1|chr5:167745481-167745530,chr5,167745481,167745530,H1|chr5:154136446-154136521,chr5,154136446,154136521,1,13609035
H1|chr5:167761424-167761486,chr5,167761424,167761486,H1|chr5:72145050-72145116,chr5,72145050,72145116,1,95616374
H1|chr5:167761424-167761484,chr5,167761424,167761484,H1|chr5:72145050-72145116,chr5,72145050,72145116,1,95616374
H1|chr5:168437686-168437758,chr5,168437686,168437758,H1|chr5:175961392-175961446,chr5,175961392,175961446,1,7523706
H1|chr5:168437718-168437758,chr5,168437718,168437758,H1|chr5:175961392-175961446,chr5,175961392,175961446,1,7523674
H1|chr5:171398805-171398862,chr5,171398805,171398862,H1|chr5:171438337-171438460,chr5,171438337,171438460,1,39532
H1|chr5:171410259-171410305,chr5,171410259,171410305,H1|chr5:171435172-171435248,chr5,171435172,171435248,1,24913
H1|chr5:171410259-171410304,chr5,171410259,171410304,H1|chr5:171435172-171435248,chr5,171435172,171435248,1,24913
H1|chr5:171414107-171414164,chr5,171414107,171414164,H1|chr5:170815976-170816094,chr5,170815976,170816094,1,598131
H1|chr5:171414107-171414139,chr5,171414107,171414139,H1|chr5:170815976-170816094,chr5,170815976,170816094,1,598131
H1|chr5:171414108-171414164,chr5,171414108,171414164,H1|chr5:170815976-170816094,chr5,170815976,170816094,1,598132
H1|chr5:171414235-171414298,chr5,171414235,171414298,H1|chr5:171436153-171436214,chr5,171436153,171436214,1,21918
H1|chr5:175259053-175259139,chr5,175259053,175259139,H1|chr5:102089032-102089100,chr5,102089032,102089100,1,73170021
H1|chr5:175259054-175259139,chr5,175259054,175259139,H1|chr5:102088843-102088905,chr5,102088843,102088905,1,73170211
H1|chr5:175260589-175260683,chr5,175260589,175260683,H1|chr5:175219554-175219679,chr5,175219554,175219679,1,41035
H1|chr5:175262164-175262215,chr5,175262164,175262215,H1|chr5:175221729-175221879,chr5,175221729,175221879,1,40435
H1|chr5:175262165-175262215,chr5,175262165,175262215,H1|chr5:175221729-175221879,chr5,175221729,175221879,1,40436
H1|chr5:175263113-175263263,chr5,175263113,175263263,H1|chr5:175221740-175221831,chr5,175221740,175221831,1,41373
H1|chr5:175265017-175265097,chr5,175265017,175265097,H1|chr5:175222367-175222409,chr5,175222367,175222409,1,42650
H1|chr5:175617943-175618003,chr5,175617943,175618003,H1|chr5:175628990-175629140,chr5,175628990,175629140,1,11047
H1|chr5:175620875-175620955,chr5,175620875,175620955,H1|chr5:175627037-175627107,chr5,175627037,175627107,1,6162
H1|chr5:176755899-176755993,chr5,176755899,176755993,H1|chr5:176743211-176743267,chr5,176743211,176743267,1,12688
H1|chr5:176755967-176756008,chr5,176755967,176756008,H1|chr5:176740489-176740587,chr5,176740489,176740587,1,15478
H1|chr5:176757946-176757985,chr5,176757946,176757985,H1|chr5:176740707-176740768,chr5,176740707,176740768,1,17239
H1|chr5:176757947-176757985,chr5,176757947,176757985,H1|chr5:176740707-176740736,chr5,176740707,176740736,1,17240
H1|chr5:176759275-176759365,chr5,176759275,176759365,H1|chr5:176738057-176738109,chr5,176738057,176738109,1,21218
H1|chr5:176759324-176759474,chr5,176759324,176759474,H1|chr5:176738057-176738109,chr5,176738057,176738109,1,21267
H1|chr5:176759328-176759364,chr5,176759328,176759364,H1|chr5:176739542-176739627,chr5,176739542,176739627,1,19786
H1|chr5:176760804-176760828,chr5,176760804,176760828,H1|chr5:176872823-176872917,chr5,176872823,176872917,1,112019
H1|chr5:176918276-176918390,chr5,176918276,176918390,H1|chr5:176902254-176902301,chr5,176902254,176902301,1,16022
H1|chr5:176918276-176918379,chr5,176918276,176918379,H1|chr5:176902254-176902301,chr5,176902254,176902301,1,16022
H1|chr5:176918357-176918406,chr5,176918357,176918406,H1|chr5:176905994-176906053,chr5,176905994,176906053,1,12363
H1|chr5:177363811-177363958,chr5,177363811,177363958,H1|chr5:175628380-175628529,chr5,175628380,175628529,1,1735431
H1|chr5:177364242-177364313,chr5,177364242,177364313,H1|chr5:175628473-175628549,chr5,175628473,175628549,1,1735769
H1|chr5:177364242-177364310,chr5,177364242,177364310,H1|chr5:175628458-175628550,chr5,175628458,175628550,1,1735784
H1|chr5:177364252-177364310,chr5,177364252,177364310,H1|chr5:175628458-175628550,chr5,175628458,175628550,1,1735794
H1|chr5:177364930-177365080,chr5,177364930,177365080,H1|chr5:175627946-175627983,chr5,175627946,175627983,1,1736984
H1|chr5:177364987-177365130,chr5,177364987,177365130,H1|chr5:175627755-175627905,chr5,175627755,175627905,1,1737232
H1|chr5:177364987-177365074,chr5,177364987,177365074,H1|chr5:175627755-175627905,chr5,175627755,175627905,1,1737232
H1|chr5:177364993-177365080,chr5,177364993,177365080,H1|chr5:175627757-175627902,chr5,175627757,175627902,1,1737236
H1|chr5:177364994-177365130,chr5,177364994,177365130,H1|chr5:175627753-175627899,chr5,175627753,175627899,1,1737241
H1|chr5:177365016-177365076,chr5,177365016,177365076,H1|chr5:175627734-175627789,chr5,175627734,175627789,1,1737282
H1|chr5:177365045-177365129,chr5,177365045,177365129,H1|chr5:175627665-175627813,chr5,175627665,175627813,1,1737380
H1|chr5:177365257-177365406,chr5,177365257,177365406,H1|chr5:175627663-175627797,chr5,175627663,175627797,1,1737594
H1|chr5:177365267-177365417,chr5,177365267,177365417,H1|chr5:175627761-175627813,chr5,175627761,175627813,1,1737506
H1|chr5:177365277-177365427,chr5,177365277,177365427,H1|chr5:175627668-175627769,chr5,175627668,175627769,1,1737609
H1|chr5:177365279-177365428,chr5,177365279,177365428,H1|chr5:175627719-175627823,chr5,175627719,175627823,1,1737560
H1|chr5:177365316-177365466,chr5,177365316,177365466,H1|chr5:175627658-175627804,chr5,175627658,175627804,1,1737658
H1|chr5:177366321-177366387,chr5,177366321,177366387,H1|chr5:175626627-175626678,chr5,175626627,175626678,1,1739694
H1|chr5:177605289-177605377,chr5,177605289,177605377,H1|chr5:177591103-177591191,chr5,177591103,177591191,1,14186
H1|chr5:177605289-177605372,chr5,177605289,177605372,H1|chr5:177591158-177591191,chr5,177591158,177591191,1,14131
H1|chr5:177605289-177605347,chr5,177605289,177605347,H1|chr5:177591103-177591191,chr5,177591103,177591191,1,14186
H1|chr5:177605289-177605335,chr5,177605289,177605335,H1|chr5:177591071-177591191,chr5,177591071,177591191,1,14218
H1|chr5:177605289-177605319,chr5,177605289,177605319,H1|chr5:177591071-177591191,chr5,177591071,177591191,1,14218
H1|chr5:177607469-177607574,chr5,177607469,177607574,H1|chr5:177591141-177591191,chr5,177591141,177591191,1,16328
H1|chr5:177607469-177607572,chr5,177607469,177607572,H1|chr5:177591159-177591191,chr5,177591159,177591191,1,16310
H1|chr5:177607469-177607569,chr5,177607469,177607569,H1|chr5:177591141-177591191,chr5,177591141,177591191,1,16328
H1|chr5:177607469-177607566,chr5,177607469,177607566,H1|chr5:177591141-177591191,chr5,177591141,177591191,1,16328
H1|chr5:177607469-177607557,chr5,177607469,177607557,H1|chr5:177591096-177591191,chr5,177591096,177591191,1,16373
H1|chr5:177607469-177607531,chr5,177607469,177607531,H1|chr5:177591069-177591197,chr5,177591069,177591197,1,16400
H1|chr5:177607469-177607524,chr5,177607469,177607524,H1|chr5:177591096-177591191,chr5,177591096,177591191,1,16373
H1|chr5:177607469-177607507,chr5,177607469,177607507,H1|chr5:177591061-177591191,chr5,177591061,177591191,1,16408
H1|chr5:177607469-177607489,chr5,177607469,177607489,H1|chr5:177591061-177591191,chr5,177591061,177591191,1,16408
H1|chr5:177607577-177607615,chr5,177607577,177607615,H1|chr5:177591097-177591191,chr5,177591097,177591191,1,16480
H1|chr5:177621965-177622109,chr5,177621965,177622109,H1|chr5:177627397-177627417,chr5,177627397,177627417,1,5432
H1|chr5:177621968-177622074,chr5,177621968,177622074,H1|chr5:177627397-177627417,chr5,177627397,177627417,1,5429
H1|chr5:177622899-177622922,chr5,177622899,177622922,H1|chr5:177627843-177627979,chr5,177627843,177627979,1,4944
H1|chr5:177666100-177666123,chr5,177666100,177666123,H1|chr5:177663779-177663892,chr5,177663779,177663892,1,2321
H1|chr5:177671137-177671180,chr5,177671137,177671180,H1|chr5:177663095-177663154,chr5,177663095,177663154,1,8042
H1|chr6:703652-703754,chr6,703652,703754,H1|chr6:693584-693640,chr6,693584,693640,1,10068
H1|chr6:703662-703756,chr6,703662,703756,H1|chr6:693584-693640,chr6,693584,693640,1,10078
H1|chr6:710692-710727,chr6,710692,710727,H1|chr6:694863-694941,chr6,694863,694941,1,15829
H1|chr6:710713-710781,chr6,710713,710781,H1|chr6:696501-696606,chr6,696501,696606,1,14212
H1|chr6:710713-710758,chr6,710713,710758,H1|chr6:696501-696606,chr6,696501,696606,1,14212
H1|chr6:711527-711591,chr6,711527,711591,H1|chr6:694196-694290,chr6,694196,694290,1,17331
H1|chr6:711527-711590,chr6,711527,711590,H1|chr6:693236-693313,chr6,693236,693313,1,18291
H1|chr6:711527-711583,chr6,711527,711583,H1|chr6:694196-694290,chr6,694196,694290,1,17331
H1|chr6:711527-711579,chr6,711527,711579,H1|chr6:693236-693313,chr6,693236,693313,1,18291
H1|chr6:711527-711566,chr6,711527,711566,H1|chr6:694179-694290,chr6,694179,694290,1,17348
H1|chr6:711527-711562,chr6,711527,711562,H1|chr6:694175-694290,chr6,694175,694290,1,17352
H1|chr6:2854838-2854921,chr6,2854838,2854921,H1|chr6:2842219-2842293,chr6,2842219,2842293,1,12619
H1|chr6:2854845-2854921,chr6,2854845,2854921,H1|chr6:2842219-2842293,chr6,2842219,2842293,1,12626
H1|chr6:2856683-2856815,chr6,2856683,2856815,H1|chr6:2841556-2841574,chr6,2841556,2841574,1,15127
H1|chr6:2856683-2856796,chr6,2856683,2856796,H1|chr6:2841499-2841574,chr6,2841499,2841574,1,15184
H1|chr6:2856683-2856762,chr6,2856683,2856762,H1|chr6:2841435-2841574,chr6,2841435,2841574,1,15248
H1|chr6:2856683-2856756,chr6,2856683,2856756,H1|chr6:2841490-2841574,chr6,2841490,2841574,1,15193
H1|chr6:2856683-2856752,chr6,2856683,2856752,H1|chr6:2841499-2841574,chr6,2841499,2841574,1,15184
H1|chr6:2856683-2856749,chr6,2856683,2856749,H1|chr6:2841490-2841574,chr6,2841490,2841574,1,15193
H1|chr6:2856700-2856850,chr6,2856700,2856850,H1|chr6:2841556-2841574,chr6,2841556,2841574,1,15144
H1|chr6:2858184-2858251,chr6,2858184,2858251,H1|chr6:2842770-2842834,chr6,2842770,2842834,1,15414
H1|chr6:4794398-4794436,chr6,4794398,4794436,H1|chr6:10587291-10587385,chr6,10587291,10587385,1,5792893
H1|chr6:4794416-4794436,chr6,4794416,4794436,H1|chr6:10587291-10587385,chr6,10587291,10587385,1,5792875
H1|chr6:4806067-4806108,chr6,4806067,4806108,H1|chr6:10583364-10583434,chr6,10583364,10583434,1,5777297
H1|chr6:4806068-4806108,chr6,4806068,4806108,H1|chr6:10583364-10583434,chr6,10583364,10583434,1,5777296
H1|chr6:12887838-12887864,chr6,12887838,12887864,H1|chr6:10695717-10695858,chr6,10695717,10695858,1,2192121
H1|chr6:14283129-14283179,chr6,14283129,14283179,H1|chr6:139350500-139350645,chr6,139350500,139350645,1,125067371
H1|chr6:14284621-14284675,chr6,14284621,14284675,H1|chr6:15246467-15246512,chr6,15246467,15246512,1,961846
H1|chr6:14284621-14284672,chr6,14284621,14284672,H1|chr6:15246467-15246512,chr6,15246467,15246512,1,961846
H1|chr6:14287888-14287967,chr6,14287888,14287967,H1|chr6:108278139-108278161,chr6,108278139,108278161,1,93990251
H1|chr6:14288200-14288280,chr6,14288200,14288280,H1|chr6:15247980-15248029,chr6,15247980,15248029,1,959780
H1|chr6:14288201-14288280,chr6,14288201,14288280,H1|chr6:15247980-15248029,chr6,15247980,15248029,1,959779
H1|chr6:14288277-14288316,chr6,14288277,14288316,H1|chr6:44230827-44230882,chr6,44230827,44230882,1,29942550
H1|chr6:14288280-14288316,chr6,14288280,14288316,H1|chr6:44230827-44230882,chr6,44230827,44230882,1,29942547
H1|chr6:14291808-14291881,chr6,14291808,14291881,H1|chr6:15247387-15247464,chr6,15247387,15247464,1,955579
H1|chr6:14291808-14291880,chr6,14291808,14291880,H1|chr6:15247387-15247464,chr6,15247387,15247464,1,955579
H1|chr6:14293875-14293916,chr6,14293875,14293916,H1|chr6:44216524-44216607,chr6,44216524,44216607,1,29922649
H1|chr6:14296734-14296804,chr6,14296734,14296804,H1|chr6:111141472-111141552,chr6,111141472,111141552,1,96844738
H1|chr6:14296739-14296817,chr6,14296739,14296817,H1|chr6:111141467-111141539,chr6,111141467,111141539,1,96844728
H1|chr6:14297126-14297163,chr6,14297126,14297163,H1|chr6:15248003-15248055,chr6,15248003,15248055,1,950877
H1|chr6:14297126-14297162,chr6,14297126,14297162,H1|chr6:15248003-15248055,chr6,15248003,15248055,1,950877
H1|chr6:14858994-14859058,chr6,14858994,14859058,H1|chr6:15249580-15249625,chr6,15249580,15249625,1,390586
H1|chr6:14859526-14859577,chr6,14859526,14859577,H1|chr6:15249175-15249249,chr6,15249175,15249249,1,389649
H1|chr6:14859526-14859576,chr6,14859526,14859576,H1|chr6:15249175-15249249,chr6,15249175,15249249,1,389649
H1|chr6:14867656-14867705,chr6,14867656,14867705,H1|chr6:7108554-7108661,chr6,7108554,7108661,1,7759102
H1|chr6:14867656-14867699,chr6,14867656,14867699,H1|chr6:7108554-7108661,chr6,7108554,7108661,1,7759102
H1|chr6:14871872-14871926,chr6,14871872,14871926,H1|chr6:15246370-15246421,chr6,15246370,15246421,1,374498
H1|chr6:14872371-14872447,chr6,14872371,14872447,H1|chr6:7312487-7312540,chr6,7312487,7312540,1,7559884
H1|chr6:14872371-14872414,chr6,14872371,14872414,H1|chr6:7312487-7312540,chr6,7312487,7312540,1,7559884
H1|chr6:14873431-14873543,chr6,14873431,14873543,H1|chr6:33421442-33421550,chr6,33421442,33421550,1,18548011
H1|chr6:14873490-14873543,chr6,14873490,14873543,H1|chr6:33421400-33421550,chr6,33421400,33421550,1,18547910
H1|chr6:15254502-15254597,chr6,15254502,15254597,H1|chr6:10558148-10558191,chr6,10558148,10558191,1,4696354
H1|chr6:15259058-15259110,chr6,15259058,15259110,H1|chr6:13815511-13815567,chr6,13815511,13815567,1,1443547
H1|chr6:15259258-15259307,chr6,15259258,15259307,H1|chr6:10583441-10583526,chr6,10583441,10583526,1,4675817
H1|chr6:15259259-15259306,chr6,15259259,15259306,H1|chr6:10583441-10583526,chr6,10583441,10583526,1,4675818
H1|chr6:15261045-15261135,chr6,15261045,15261135,H1|chr6:16760452-16760535,chr6,16760452,16760535,1,1499407
H1|chr6:15261045-15261112,chr6,15261045,15261112,H1|chr6:16760452-16760535,chr6,16760452,16760535,1,1499407
H1|chr6:15262187-15262283,chr6,15262187,15262283,H1|chr6:33241609-33241665,chr6,33241609,33241665,1,17979422
H1|chr6:15262187-15262278,chr6,15262187,15262278,H1|chr6:33241609-33241665,chr6,33241609,33241665,1,17979422
H1|chr6:15262212-15262349,chr6,15262212,15262349,H1|chr6:33240206-33240244,chr6,33240206,33240244,1,17977994
H1|chr6:15262237-15262349,chr6,15262237,15262349,H1|chr6:33240206-33240244,chr6,33240206,33240244,1,17977969
H1|chr6:15262464-15262523,chr6,15262464,15262523,H1|chr6:44189015-44189072,chr6,44189015,44189072,1,28926551
H1|chr6:15262465-15262523,chr6,15262465,15262523,H1|chr6:44189015-44189073,chr6,44189015,44189073,1,28926550
H1|chr6:15264438-15264518,chr6,15264438,15264518,H1|chr6:24911887-24911908,chr6,24911887,24911908,1,9647449
H1|chr6:15264990-15265086,chr6,15264990,15265086,H1|chr6:15246465-15246510,chr6,15246465,15246510,1,18525
H1|chr6:15265989-15266065,chr6,15265989,15266065,H1|chr6:42745960-42746029,chr6,42745960,42746029,1,27479971
H1|chr6:15265991-15266065,chr6,15265991,15266065,H1|chr6:42745960-42746029,chr6,42745960,42746029,1,27479969
H1|chr6:15266204-15266255,chr6,15266204,15266255,H1|chr6:8099446-8099493,chr6,8099446,8099493,1,7166758
H1|chr6:15266205-15266246,chr6,15266205,15266246,H1|chr6:12751178-12751264,chr6,12751178,12751264,1,2515027
H1|chr6:15266475-15266561,chr6,15266475,15266561,H1|chr6:86350740-86350772,chr6,86350740,86350772,1,71084265
H1|chr6:15266604-15266700,chr6,15266604,15266700,H1|chr6:16131544-16131565,chr6,16131544,16131565,1,864940
H1|chr6:15266604-15266699,chr6,15266604,15266699,H1|chr6:16131544-16131565,chr6,16131544,16131565,1,864940
H1|chr6:15267556-15267623,chr6,15267556,15267623,H1|chr6:15246301-15246441,chr6,15246301,15246441,1,21255
H1|chr6:15267758-15267823,chr6,15267758,15267823,H1|chr6:15246408-15246497,chr6,15246408,15246497,1,21350
H1|chr6:15269099-15269183,chr6,15269099,15269183,H1|chr6:16760142-16760208,chr6,16760142,16760208,1,1491043
H1|chr6:15269105-15269254,chr6,15269105,15269254,H1|chr6:16760142-16760208,chr6,16760142,16760208,1,1491037
H1|chr6:15271501-15271611,chr6,15271501,15271611,H1|chr6:111199482-111199518,chr6,111199482,111199518,1,95927981
H1|chr6:15271502-15271608,chr6,15271502,15271608,H1|chr6:111199482-111199518,chr6,111199482,111199518,1,95927980
H1|chr6:15272735-15272775,chr6,15272735,15272775,H1|chr6:7141264-7141306,chr6,7141264,7141306,1,8131471
H1|chr6:15274386-15274471,chr6,15274386,15274471,H1|chr6:13616901-13616927,chr6,13616901,13616927,1,1657485
H1|chr6:15274386-15274470,chr6,15274386,15274470,H1|chr6:13616901-13616927,chr6,13616901,13616927,1,1657485
H1|chr6:15276097-15276183,chr6,15276097,15276183,H1|chr6:33242069-33242122,chr6,33242069,33242122,1,17965972
H1|chr6:15277400-15277478,chr6,15277400,15277478,H1|chr6:33401581-33401634,chr6,33401581,33401634,1,18124181
H1|chr6:15277763-15277850,chr6,15277763,15277850,H1|chr6:31505255-31505302,chr6,31505255,31505302,1,16227492
H1|chr6:15277763-15277849,chr6,15277763,15277849,H1|chr6:31505255-31505302,chr6,31505255,31505302,1,16227492
H1|chr6:15279809-15279841,chr6,15279809,15279841,H1|chr6:15246395-15246489,chr6,15246395,15246489,1,33414
H1|chr6:15280739-15280784,chr6,15280739,15280784,H1|chr6:40553566-40553680,chr6,40553566,40553680,1,25272827
H1|chr6:15281530-15281634,chr6,15281530,15281634,H1|chr6:33240819-33240840,chr6,33240819,33240840,1,17959289
H1|chr6:15282276-15282384,chr6,15282276,15282384,H1|chr6:4774555-4774596,chr6,4774555,4774596,1,10507721
H1|chr6:15282276-15282379,chr6,15282276,15282379,H1|chr6:4774555-4774596,chr6,4774555,4774596,1,10507721
H1|chr6:15282724-15282805,chr6,15282724,15282805,H1|chr6:47447469-47447523,chr6,47447469,47447523,1,32164745
H1|chr6:15282729-15282805,chr6,15282729,15282805,H1|chr6:47447469-47447523,chr6,47447469,47447523,1,32164740
H1|chr6:15282916-15283002,chr6,15282916,15283002,H1|chr6:8098562-8098655,chr6,8098562,8098655,1,7184354
H1|chr6:15282917-15283032,chr6,15282917,15283032,H1|chr6:10583705-10583751,chr6,10583705,10583751,1,4699212
H1|chr6:15282943-15283032,chr6,15282943,15283032,H1|chr6:10583705-10583751,chr6,10583705,10583751,1,4699238
H1|chr6:15284081-15284130,chr6,15284081,15284130,H1|chr6:80250608-80250708,chr6,80250608,80250708,1,64966527
H1|chr6:15284081-15284128,chr6,15284081,15284128,H1|chr6:80250592-80250708,chr6,80250592,80250708,1,64966511
H1|chr6:15284081-15284115,chr6,15284081,15284115,H1|chr6:80250592-80250708,chr6,80250592,80250708,1,64966511
H1|chr6:15284884-15284954,chr6,15284884,15284954,H1|chr6:47447131-47447204,chr6,47447131,47447204,1,32162247
H1|chr6:15286436-15286527,chr6,15286436,15286527,H1|chr6:10583504-10583557,chr6,10583504,10583557,1,4702932
H1|chr6:15286439-15286529,chr6,15286439,15286529,H1|chr6:10583504-10583557,chr6,10583504,10583557,1,4702935
H1|chr6:15287402-15287476,chr6,15287402,15287476,H1|chr6:99872650-99872707,chr6,99872650,99872707,1,84585248
H1|chr6:15287402-15287475,chr6,15287402,15287475,H1|chr6:99872650-99872707,chr6,99872650,99872707,1,84585248
H1|chr6:15288503-15288566,chr6,15288503,15288566,H1|chr6:15246356-15246403,chr6,15246356,15246403,1,42147
H1|chr6:15288568-15288626,chr6,15288568,15288626,H1|chr6:86351432-86351515,chr6,86351432,86351515,1,71062864
H1|chr6:15291340-15291474,chr6,15291340,15291474,H1|chr6:15246378-15246400,chr6,15246378,15246400,1,44962
H1|chr6:15291346-15291474,chr6,15291346,15291474,H1|chr6:15246378-15246400,chr6,15246378,15246400,1,44968
H1|chr6:15291814-15291865,chr6,15291814,15291865,H1|chr6:13617467-13617530,chr6,13617467,13617530,1,1674347
H1|chr6:15291979-15292078,chr6,15291979,15292078,H1|chr6:15246463-15246510,chr6,15246463,15246510,1,45516
H1|chr6:15295626-15295766,chr6,15295626,15295766,H1|chr6:29596988-29597054,chr6,29596988,29597054,1,14301362
H1|chr6:15295682-15295766,chr6,15295682,15295766,H1|chr6:29596988-29597054,chr6,29596988,29597054,1,14301306
H1|chr6:15295782-15295874,chr6,15295782,15295874,H1|chr6:15246317-15246352,chr6,15246317,15246352,1,49465
H1|chr6:15295786-15295839,chr6,15295786,15295839,H1|chr6:15246295-15246350,chr6,15246295,15246350,1,49491
H1|chr6:15296266-15296341,chr6,15296266,15296341,H1|chr6:111197743-111197788,chr6,111197743,111197788,1,95901477
H1|chr6:15296589-15296690,chr6,15296589,15296690,H1|chr6:4773953-4774018,chr6,4773953,4774018,1,10522636
H1|chr6:15296607-15296692,chr6,15296607,15296692,H1|chr6:4773953-4774018,chr6,4773953,4774018,1,10522654
H1|chr6:15298168-15298282,chr6,15298168,15298282,H1|chr6:74366273-74366299,chr6,74366273,74366299,1,59068105
H1|chr6:15298998-15299080,chr6,15298998,15299080,H1|chr6:111198358-111198426,chr6,111198358,111198426,1,95899360
H1|chr6:15299276-15299358,chr6,15299276,15299358,H1|chr6:10555877-10555917,chr6,10555877,10555917,1,4743399
H1|chr6:15301827-15301871,chr6,15301827,15301871,H1|chr6:42747020-42747090,chr6,42747020,42747090,1,27445193
H1|chr6:15301830-15301871,chr6,15301830,15301871,H1|chr6:42747020-42747090,chr6,42747020,42747090,1,27445190
H1|chr6:15302149-15302186,chr6,15302149,15302186,H1|chr6:15246420-15246503,chr6,15246420,15246503,1,55729
H1|chr6:15302358-15302454,chr6,15302358,15302454,H1|chr6:31505699-31505752,chr6,31505699,31505752,1,16203341
H1|chr6:15304167-15304199,chr6,15304167,15304199,H1|chr6:12752334-12752422,chr6,12752334,12752422,1,2551833
H1|chr6:15304819-15304873,chr6,15304819,15304873,H1|chr6:15246428-15246503,chr6,15246428,15246503,1,58391
H1|chr6:15305748-15305841,chr6,15305748,15305841,H1|chr6:29594953-29594995,chr6,29594953,29594995,1,14289205
H1|chr6:15306241-15306291,chr6,15306241,15306291,H1|chr6:10559202-10559263,chr6,10559202,10559263,1,4747039
H1|chr6:15306484-15306541,chr6,15306484,15306541,H1|chr6:30582131-30582201,chr6,30582131,30582201,1,15275647
H1|chr6:15306494-15306519,chr6,15306494,15306519,H1|chr6:33397267-33397340,chr6,33397267,33397340,1,18090773
H1|chr6:15306497-15306519,chr6,15306497,15306519,H1|chr6:33397267-33397340,chr6,33397267,33397340,1,18090770
H1|chr6:15309209-15309301,chr6,15309209,15309301,H1|chr6:15246424-15246479,chr6,15246424,15246479,1,62785
H1|chr6:15309209-15309300,chr6,15309209,15309300,H1|chr6:15246424-15246479,chr6,15246424,15246479,1,62785
H1|chr6:15310477-15310552,chr6,15310477,15310552,H1|chr6:30583252-30583308,chr6,30583252,30583308,1,15272775
H1|chr6:15310630-15310694,chr6,15310630,15310694,H1|chr6:13815311-13815358,chr6,13815311,13815358,1,1495319
H1|chr6:15310631-15310694,chr6,15310631,15310694,H1|chr6:13815311-13815358,chr6,13815311,13815358,1,1495320
H1|chr6:15311419-15311455,chr6,15311419,15311455,H1|chr6:30583605-30583719,chr6,30583605,30583719,1,15272186
H1|chr6:15312066-15312123,chr6,15312066,15312123,H1|chr6:157803571-157803638,chr6,157803571,157803638,1,142491505
H1|chr6:15312427-15312549,chr6,15312427,15312549,H1|chr6:42750429-42750465,chr6,42750429,42750465,1,27438002
H1|chr6:15313052-15313088,chr6,15313052,15313088,H1|chr6:15246462-15246491,chr6,15246462,15246491,1,66590
H1|chr6:15313086-15313105,chr6,15313086,15313105,H1|chr6:7140415-7140503,chr6,7140415,7140503,1,8172671
H1|chr6:15313086-15313104,chr6,15313086,15313104,H1|chr6:7140415-7140503,chr6,7140415,7140503,1,8172671
H1|chr6:15313090-15313169,chr6,15313090,15313169,H1|chr6:15246462-15246491,chr6,15246462,15246491,1,66628
H1|chr6:15313849-15313969,chr6,15313849,15313969,H1|chr6:10584035-10584065,chr6,10584035,10584065,1,4729814
H1|chr6:15313904-15314003,chr6,15313904,15314003,H1|chr6:15246345-15246394,chr6,15246345,15246394,1,67559
H1|chr6:15317068-15317103,chr6,15317068,15317103,H1|chr6:15246129-15246190,chr6,15246129,15246190,1,70939
H1|chr6:15317480-15317508,chr6,15317480,15317508,H1|chr6:10587315-10587405,chr6,10587315,10587405,1,4730165
H1|chr6:15317482-15317508,chr6,15317482,15317508,H1|chr6:10587315-10587405,chr6,10587315,10587405,1,4730167
H1|chr6:15319827-15319885,chr6,15319827,15319885,H1|chr6:10583502-10583625,chr6,10583502,10583625,1,4736325
H1|chr6:15322060-15322123,chr6,15322060,15322123,H1|chr6:74366187-74366228,chr6,74366187,74366228,1,59044127
H1|chr6:15322520-15322576,chr6,15322520,15322576,H1|chr6:43022453-43022525,chr6,43022453,43022525,1,27699933
H1|chr6:15323796-15323823,chr6,15323796,15323823,H1|chr6:31504608-31504675,chr6,31504608,31504675,1,16180812
H1|chr6:15323796-15323822,chr6,15323796,15323822,H1|chr6:31504608-31504675,chr6,31504608,31504675,1,16180812
H1|chr6:15324012-15324107,chr6,15324012,15324107,H1|chr6:15246303-15246405,chr6,15246303,15246405,1,77709
H1|chr6:15324013-15324107,chr6,15324013,15324107,H1|chr6:15246303-15246405,chr6,15246303,15246405,1,77710
H1|chr6:15324515-15324574,chr6,15324515,15324574,H1|chr6:16132140-16132193,chr6,16132140,16132193,1,807625
H1|chr6:15324516-15324574,chr6,15324516,15324574,H1|chr6:16132140-16132193,chr6,16132140,16132193,1,807624
H1|chr6:15324661-15324718,chr6,15324661,15324718,H1|chr6:15246360-15246414,chr6,15246360,15246414,1,78301
H1|chr6:15329803-15329857,chr6,15329803,15329857,H1|chr6:33242395-33242451,chr6,33242395,33242451,1,17912592
H1|chr6:15330576-15330597,chr6,15330576,15330597,H1|chr6:16130405-16130503,chr6,16130405,16130503,1,799829
H1|chr6:15333657-15333788,chr6,15333657,15333788,H1|chr6:15246408-15246493,chr6,15246408,15246493,1,87249
H1|chr6:15333728-15333793,chr6,15333728,15333793,H1|chr6:15246408-15246493,chr6,15246408,15246493,1,87320
H1|chr6:15336023-15336069,chr6,15336023,15336069,H1|chr6:15246366-15246470,chr6,15246366,15246470,1,89657
H1|chr6:15338048-15338087,chr6,15338048,15338087,H1|chr6:30584863-30584969,chr6,30584863,30584969,1,15246815
H1|chr6:15339951-15340095,chr6,15339951,15340095,H1|chr6:47446013-47446121,chr6,47446013,47446121,1,32106062
H1|chr6:15339951-15340081,chr6,15339951,15340081,H1|chr6:47446013-47446121,chr6,47446013,47446121,1,32106062
H1|chr6:15340054-15340096,chr6,15340054,15340096,H1|chr6:47446013-47446121,chr6,47446013,47446121,1,32105959
H1|chr6:15340129-15340157,chr6,15340129,15340157,H1|chr6:99872373-99872399,chr6,99872373,99872399,1,84532244
H1|chr6:15340587-15340632,chr6,15340587,15340632,H1|chr6:151713058-151713129,chr6,151713058,151713129,1,136372471
H1|chr6:15341088-15341197,chr6,15341088,15341197,H1|chr6:10588050-10588197,chr6,10588050,10588197,1,4753038
H1|chr6:15343164-15343310,chr6,15343164,15343310,H1|chr6:42751875-42751901,chr6,42751875,42751901,1,27408711
H1|chr6:15343186-15343310,chr6,15343186,15343310,H1|chr6:42751875-42751901,chr6,42751875,42751901,1,27408689
H1|chr6:15343913-15343935,chr6,15343913,15343935,H1|chr6:15246104-15246172,chr6,15246104,15246172,1,97809
H1|chr6:15346027-15346069,chr6,15346027,15346069,H1|chr6:29601496-29601604,chr6,29601496,29601604,1,14255469
H1|chr6:15346028-15346092,chr6,15346028,15346092,H1|chr6:29601496-29601604,chr6,29601496,29601604,1,14255468
H1|chr6:15346677-15346827,chr6,15346677,15346827,H1|chr6:24910259-24910303,chr6,24910259,24910303,1,9563582
H1|chr6:15346740-15346842,chr6,15346740,15346842,H1|chr6:24910259-24910303,chr6,24910259,24910303,1,9563519
H1|chr6:15347646-15347770,chr6,15347646,15347770,H1|chr6:4774030-4774053,chr6,4774030,4774053,1,10573616
H1|chr6:15347647-15347770,chr6,15347647,15347770,H1|chr6:4774030-4774053,chr6,4774030,4774053,1,10573617
H1|chr6:15348405-15348476,chr6,15348405,15348476,H1|chr6:30584942-30585001,chr6,30584942,30585001,1,15236537
H1|chr6:15350028-15350054,chr6,15350028,15350054,H1|chr6:151717193-151717305,chr6,151717193,151717305,1,136367165
H1|chr6:15351438-15351573,chr6,15351438,15351573,H1|chr6:16129807-16129847,chr6,16129807,16129847,1,778369
H1|chr6:15351466-15351573,chr6,15351466,15351573,H1|chr6:16129807-16129847,chr6,16129807,16129847,1,778341
H1|chr6:15352357-15352398,chr6,15352357,15352398,H1|chr6:151713571-151713690,chr6,151713571,151713690,1,136361214
H1|chr6:15352357-15352388,chr6,15352357,15352388,H1|chr6:151713571-151713690,chr6,151713571,151713690,1,136361214
H1|chr6:15353717-15353805,chr6,15353717,15353805,H1|chr6:33401753-33401800,chr6,33401753,33401800,1,18048036
H1|chr6:15353953-15353977,chr6,15353953,15353977,H1|chr6:29596303-29596415,chr6,29596303,29596415,1,14242350
H1|chr6:15355833-15355906,chr6,15355833,15355906,H1|chr6:15246313-15246345,chr6,15246313,15246345,1,109520
H1|chr6:15357943-15357995,chr6,15357943,15357995,H1|chr6:111805719-111805816,chr6,111805719,111805816,1,96447776
H1|chr6:15357945-15358076,chr6,15357945,15358076,H1|chr6:111805719-111805816,chr6,111805719,111805816,1,96447774
H1|chr6:15361627-15361720,chr6,15361627,15361720,H1|chr6:15246415-15246462,chr6,15246415,15246462,1,115212
H1|chr6:15362295-15362378,chr6,15362295,15362378,H1|chr6:15246430-15246473,chr6,15246430,15246473,1,115865
H1|chr6:15362304-15362378,chr6,15362304,15362378,H1|chr6:15246430-15246482,chr6,15246430,15246482,1,115874
H1|chr6:15363595-15363724,chr6,15363595,15363724,H1|chr6:29598177-29598198,chr6,29598177,29598198,1,14234582
H1|chr6:15364232-15364285,chr6,15364232,15364285,H1|chr6:10560364-10560485,chr6,10560364,10560485,1,4803868
H1|chr6:15364232-15364255,chr6,15364232,15364255,H1|chr6:10560364-10560485,chr6,10560364,10560485,1,4803868
H1|chr6:15374520-15374579,chr6,15374520,15374579,H1|chr6:15246258-15246334,chr6,15246258,15246334,1,128262
H1|chr6:15374784-15374884,chr6,15374784,15374884,H1|chr6:15246393-15246433,chr6,15246393,15246433,1,128391
H1|chr6:15375663-15375699,chr6,15375663,15375699,H1|chr6:29597112-29597187,chr6,29597112,29597187,1,14221449
H1|chr6:15375663-15375698,chr6,15375663,15375698,H1|chr6:29597112-29597187,chr6,29597112,29597187,1,14221449
H1|chr6:15382706-15382788,chr6,15382706,15382788,H1|chr6:24666287-24666323,chr6,24666287,24666323,1,9283581
H1|chr6:15382706-15382766,chr6,15382706,15382766,H1|chr6:24666287-24666323,chr6,24666287,24666323,1,9283581
H1|chr6:15382707-15382788,chr6,15382707,15382788,H1|chr6:24666287-24666323,chr6,24666287,24666323,1,9283580
H1|chr6:15385331-15385401,chr6,15385331,15385401,H1|chr6:10559234-10559313,chr6,10559234,10559313,1,4826097
H1|chr6:15385973-15386008,chr6,15385973,15386008,H1|chr6:42751364-42751464,chr6,42751364,42751464,1,27365391
H1|chr6:15385974-15386008,chr6,15385974,15386008,H1|chr6:42751364-42751464,chr6,42751364,42751464,1,27365390
H1|chr6:15386171-15386277,chr6,15386171,15386277,H1|chr6:151714670-151714706,chr6,151714670,151714706,1,136328499
H1|chr6:15386279-15386352,chr6,15386279,15386352,H1|chr6:111409608-111409659,chr6,111409608,111409659,1,96023329
H1|chr6:15386279-15386350,chr6,15386279,15386350,H1|chr6:111409608-111409659,chr6,111409608,111409659,1,96023329
H1|chr6:15390273-15390313,chr6,15390273,15390313,H1|chr6:13618731-13618832,chr6,13618731,13618832,1,1771542
H1|chr6:15390281-15390314,chr6,15390281,15390314,H1|chr6:111200305-111200455,chr6,111200305,111200455,1,95810024
H1|chr6:15390281-15390313,chr6,15390281,15390313,H1|chr6:111200305-111200455,chr6,111200305,111200455,1,95810024
H1|chr6:15390530-15390634,chr6,15390530,15390634,H1|chr6:111805756-111805792,chr6,111805756,111805792,1,96415226
H1|chr6:15390540-15390634,chr6,15390540,15390634,H1|chr6:111805756-111805792,chr6,111805756,111805792,1,96415216
H1|chr6:15390924-15390944,chr6,15390924,15390944,H1|chr6:13486790-13486813,chr6,13486790,13486813,1,1904134
H1|chr6:15393879-15394000,chr6,15393879,15394000,H1|chr6:111199237-111199331,chr6,111199237,111199331,1,95805358
H1|chr6:15394753-15394830,chr6,15394753,15394830,H1|chr6:33240276-33240346,chr6,33240276,33240346,1,17845523
H1|chr6:15394753-15394829,chr6,15394753,15394829,H1|chr6:33240276-33240346,chr6,33240276,33240346,1,17845523
H1|chr6:15407770-15407847,chr6,15407770,15407847,H1|chr6:13486790-13486813,chr6,13486790,13486813,1,1920980
H1|chr6:15426703-15426725,chr6,15426703,15426725,H1|chr6:15246378-15246451,chr6,15246378,15246451,1,180325
H1|chr6:15427937-15428000,chr6,15427937,15428000,H1|chr6:44192405-44192503,chr6,44192405,44192503,1,28764468
H1|chr6:15427937-15427989,chr6,15427937,15427989,H1|chr6:44192405-44192503,chr6,44192405,44192503,1,28764468
H1|chr6:15428991-15429068,chr6,15428991,15429068,H1|chr6:15246458-15246498,chr6,15246458,15246498,1,182533
H1|chr6:15431417-15431526,chr6,15431417,15431526,H1|chr6:5006561-5006602,chr6,5006561,5006602,1,10424856
H1|chr6:15431509-15431529,chr6,15431509,15431529,H1|chr6:15246387-15246405,chr6,15246387,15246405,1,185122
H1|chr6:15435004-15435060,chr6,15435004,15435060,H1|chr6:44192610-44192700,chr6,44192610,44192700,1,28757606
H1|chr6:15436839-15436874,chr6,15436839,15436874,H1|chr6:15246429-15246507,chr6,15246429,15246507,1,190410
H1|chr6:15437307-15437386,chr6,15437307,15437386,H1|chr6:15246367-15246407,chr6,15246367,15246407,1,190940
H1|chr6:15437308-15437387,chr6,15437308,15437387,H1|chr6:15246367-15246407,chr6,15246367,15246407,1,190941
H1|chr6:15441622-15441682,chr6,15441622,15441682,H1|chr6:27861826-27861889,chr6,27861826,27861889,1,12420204
H1|chr6:15445383-15445515,chr6,15445383,15445515,H1|chr6:15246327-15246347,chr6,15246327,15246347,1,199056
H1|chr6:15445383-15445513,chr6,15445383,15445513,H1|chr6:15246327-15246347,chr6,15246327,15246347,1,199056
H1|chr6:15446048-15446097,chr6,15446048,15446097,H1|chr6:27860349-27860490,chr6,27860349,27860490,1,12414301
H1|chr6:15490050-15490126,chr6,15490050,15490126,H1|chr6:121758146-121758207,chr6,121758146,121758207,1,106268096
H1|chr6:15911134-15911232,chr6,15911134,15911232,H1|chr6:16128801-16128853,chr6,16128801,16128853,1,217667
H1|chr6:15911160-15911232,chr6,15911160,15911232,H1|chr6:16128801-16128855,chr6,16128801,16128855,1,217641
H1|chr6:15911179-15911232,chr6,15911179,15911232,H1|chr6:16128801-16128852,chr6,16128801,16128852,1,217622
H1|chr6:21737032-21737104,chr6,21737032,21737104,H1|chr6:26127193-26127237,chr6,26127193,26127237,1,4390161
H1|chr6:21737056-21737162,chr6,21737056,21737162,H1|chr6:26127193-26127237,chr6,26127193,26127237,1,4390137
H1|chr6:22028650-22028720,chr6,22028650,22028720,H1|chr6:15246482-15246512,chr6,15246482,15246512,1,6782168
H1|chr6:22033654-22033757,chr6,22033654,22033757,H1|chr6:15249243-15249342,chr6,15249243,15249342,1,6784411
H1|chr6:25367790-25367828,chr6,25367790,25367828,H1|chr6:28134083-28134144,chr6,28134083,28134144,1,2766293
H1|chr6:25367790-25367827,chr6,25367790,25367827,H1|chr6:28134083-28134144,chr6,28134083,28134144,1,2766293
H1|chr6:25500254-25500339,chr6,25500254,25500339,H1|chr6:42745940-42745979,chr6,42745940,42745979,1,17245686
H1|chr6:25500254-25500336,chr6,25500254,25500336,H1|chr6:42745940-42745979,chr6,42745940,42745979,1,17245686
H1|chr6:31790003-31790078,chr6,31790003,31790078,H1|chr6:31794979-31795093,chr6,31794979,31795093,1,4976
H1|chr6:31790036-31790078,chr6,31790036,31790078,H1|chr6:31794979-31795098,chr6,31794979,31795098,1,4943
H1|chr6:31790042-31790078,chr6,31790042,31790078,H1|chr6:31794979-31795093,chr6,31794979,31795093,1,4937
H1|chr6:31790047-31790078,chr6,31790047,31790078,H1|chr6:31794979-31795098,chr6,31794979,31795098,1,4932
H1|chr6:31790115-31790182,chr6,31790115,31790182,H1|chr6:31805468-31805535,chr6,31805468,31805535,1,15353
H1|chr6:33764177-33764241,chr6,33764177,33764241,H1|chr6:33760495-33760581,chr6,33760495,33760581,1,3682
H1|chr6:33764183-33764331,chr6,33764183,33764331,H1|chr6:33760495-33760581,chr6,33760495,33760581,1,3688
H1|chr6:33764663-33764699,chr6,33764663,33764699,H1|chr6:33761107-33761157,chr6,33761107,33761157,1,3556
H1|chr6:33765985-33766011,chr6,33765985,33766011,H1|chr6:33761397-33761506,chr6,33761397,33761506,1,4588
H1|chr6:34194239-34194292,chr6,34194239,34194292,H1|chr6:34201829-34201926,chr6,34201829,34201926,1,7590
H1|chr6:34194241-34194300,chr6,34194241,34194300,H1|chr6:34201829-34201926,chr6,34201829,34201926,1,7588
H1|chr6:34195135-34195166,chr6,34195135,34195166,H1|chr6:34200093-34200148,chr6,34200093,34200148,1,4958
H1|chr6:34195347-34195425,chr6,34195347,34195425,H1|chr6:34206863-34206903,chr6,34206863,34206903,1,11516
H1|chr6:34195348-34195425,chr6,34195348,34195425,H1|chr6:34206863-34206903,chr6,34206863,34206903,1,11515
H1|chr6:35205565-35205641,chr6,35205565,35205641,H1|chr6:35226770-35226825,chr6,35226770,35226825,1,21205
H1|chr6:35207927-35207973,chr6,35207927,35207973,H1|chr6:35227078-35227118,chr6,35227078,35227118,1,19151
H1|chr6:37036916-37036953,chr6,37036916,37036953,H1|chr6:37011461-37011574,chr6,37011461,37011574,1,25455
H1|chr6:37044954-37045023,chr6,37044954,37045023,H1|chr6:37011969-37012105,chr6,37011969,37012105,1,32985
H1|chr6:37091690-37091750,chr6,37091690,37091750,H1|chr6:36956354-36956444,chr6,36956354,36956444,1,135336
H1|chr6:37092607-37092644,chr6,37092607,37092644,H1|chr6:36563990-36564016,chr6,36563990,36564016,1,528617
H1|chr6:37092666-37092727,chr6,37092666,37092727,H1|chr6:36563960-36564016,chr6,36563960,36564016,1,528706
H1|chr6:37093354-37093440,chr6,37093354,37093440,H1|chr6:36952408-36952472,chr6,36952408,36952472,1,140946
H1|chr6:37093908-37093970,chr6,37093908,37093970,H1|chr6:36563278-36563341,chr6,36563278,36563341,1,530630
H1|chr6:37094141-37094176,chr6,37094141,37094176,H1|chr6:36953042-36953101,chr6,36953042,36953101,1,141099
H1|chr6:37095136-37095156,chr6,37095136,37095156,H1|chr6:3260107-3260135,chr6,3260107,3260135,1,33835029
H1|chr6:37096044-37096068,chr6,37096044,37096068,H1|chr6:29593442-29593592,chr6,29593442,29593592,1,7502602
H1|chr6:37097111-37097155,chr6,37097111,37097155,H1|chr6:37135488-37135594,chr6,37135488,37135594,1,38377
H1|chr6:37097127-37097277,chr6,37097127,37097277,H1|chr6:44216940-44217060,chr6,44216940,44217060,1,7119813
H1|chr6:37097290-37097320,chr6,37097290,37097320,H1|chr6:44216940-44217060,chr6,44216940,44217060,1,7119650
H1|chr6:37098520-37098568,chr6,37098520,37098568,H1|chr6:99958757-99958792,chr6,99958757,99958792,1,62860237
H1|chr6:37098533-37098568,chr6,37098533,37098568,H1|chr6:99958757-99958792,chr6,99958757,99958792,1,62860224
H1|chr6:37100251-37100387,chr6,37100251,37100387,H1|chr6:37139430-37139492,chr6,37139430,37139492,1,39179
H1|chr6:37100433-37100518,chr6,37100433,37100518,H1|chr6:37139430-37139492,chr6,37139430,37139492,1,38997
H1|chr6:37101270-37101358,chr6,37101270,37101358,H1|chr6:37134889-37134940,chr6,37134889,37134940,1,33619
H1|chr6:37104845-37104880,chr6,37104845,37104880,H1|chr6:29596282-29596353,chr6,29596282,29596353,1,7508563
H1|chr6:37104846-37104880,chr6,37104846,37104880,H1|chr6:29596282-29596353,chr6,29596282,29596353,1,7508564
H1|chr6:41558597-41558682,chr6,41558597,41558682,H1|chr6:30539418-30539477,chr6,30539418,30539477,1,11019179
H1|chr6:41558597-41558681,chr6,41558597,41558681,H1|chr6:30539418-30539477,chr6,30539418,30539477,1,11019179
H1|chr6:42227639-42227673,chr6,42227639,42227673,H1|chr6:76459839-76459947,chr6,76459839,76459947,1,34232200
H1|chr6:42227640-42227673,chr6,42227640,42227673,H1|chr6:76459840-76459947,chr6,76459840,76459947,1,34232200
H1|chr6:42273513-42273596,chr6,42273513,42273596,H1|chr6:41042080-41042178,chr6,41042080,41042178,1,1231433
H1|chr6:42273513-42273565,chr6,42273513,42273565,H1|chr6:41042080-41042178,chr6,41042080,41042178,1,1231433
H1|chr6:42273514-42273596,chr6,42273514,42273596,H1|chr6:41042080-41042178,chr6,41042080,41042178,1,1231434
H1|chr6:42383857-42383919,chr6,42383857,42383919,H1|chr6:30293501-30293576,chr6,30293501,30293576,1,12090356
H1|chr6:42383857-42383918,chr6,42383857,42383918,H1|chr6:30293501-30293576,chr6,30293501,30293576,1,12090356
H1|chr6:42386022-42386093,chr6,42386022,42386093,H1|chr6:30293700-30293762,chr6,30293700,30293762,1,12092322
H1|chr6:42398378-42398468,chr6,42398378,42398468,H1|chr6:30881322-30881382,chr6,30881322,30881382,1,11517056
H1|chr6:43079185-43079233,chr6,43079185,43079233,H1|chr6:42847947-42847984,chr6,42847947,42847984,1,231238
H1|chr6:43079190-43079235,chr6,43079190,43079235,H1|chr6:42847949-42847981,chr6,42847949,42847981,1,231241
H1|chr6:48041520-48041636,chr6,48041520,48041636,H1|chr6:48039636-48039710,chr6,48039636,48039710,1,1884
H1|chr6:48041520-48041596,chr6,48041520,48041596,H1|chr6:48039636-48039710,chr6,48039636,48039710,1,1884
H1|chr6:48041538-48041610,chr6,48041538,48041610,H1|chr6:48041309-48041458,chr6,48041309,48041458,1,229
H1|chr6:48041780-48041929,chr6,48041780,48041929,H1|chr6:48041226-48041347,chr6,48041226,48041347,1,554
H1|chr6:48078756-48078851,chr6,48078756,48078851,H1|chr6:48041225-48041316,chr6,48041225,48041316,1,37531
H1|chr6:48078756-48078815,chr6,48078756,48078815,H1|chr6:48041225-48041316,chr6,48041225,48041316,1,37531
H1|chr6:48078784-48078867,chr6,48078784,48078867,H1|chr6:48037597-48037662,chr6,48037597,48037662,1,41187
H1|chr6:48078784-48078807,chr6,48078784,48078807,H1|chr6:48036813-48036887,chr6,48036813,48036887,1,41971
H1|chr6:56620008-56620047,chr6,56620008,56620047,H1|chr6:26195684-26195777,chr6,26195684,26195777,1,30424324
H1|chr6:56620845-56620926,chr6,56620845,56620926,H1|chr6:26182237-26182326,chr6,26182237,26182326,1,30438608
H1|chr6:56620866-56620927,chr6,56620866,56620927,H1|chr6:26182237-26182326,chr6,26182237,26182326,1,30438629
H1|chr6:87877820-87877859,chr6,87877820,87877859,H1|chr6:86300167-86300233,chr6,86300167,86300233,1,1577653
H1|chr6:87882022-87882060,chr6,87882022,87882060,H1|chr6:86299924-86299995,chr6,86299924,86299995,1,1582098
H1|chr6:87882023-87882060,chr6,87882023,87882060,H1|chr6:86299924-86299995,chr6,86299924,86299995,1,1582099
H1|chr6:90378043-90378085,chr6,90378043,90378085,H1|chr6:90351733-90351811,chr6,90351733,90351811,1,26310
H1|chr6:90393687-90393779,chr6,90393687,90393779,H1|chr6:90348328-90348355,chr6,90348328,90348355,1,45359
H1|chr6:105390587-105390698,chr6,105390587,105390698,H1|chr6:105403954-105403983,chr6,105403954,105403983,1,13367
H1|chr6:105392853-105392908,chr6,105392853,105392908,H1|chr6:105402013-105402060,chr6,105402013,105402060,1,9160
H1|chr6:107935454-107935550,chr6,107935454,107935550,H1|chr6:109110609-109110719,chr6,109110609,109110719,1,1175155
H1|chr6:107935511-107935550,chr6,107935511,107935550,H1|chr6:109110609-109110719,chr6,109110609,109110719,1,1175098
H1|chr6:112159173-112159293,chr6,112159173,112159293,H1|chr6:155053136-155053166,chr6,155053136,155053166,1,42893963
H1|chr6:112159173-112159215,chr6,112159173,112159215,H1|chr6:155053127-155053166,chr6,155053127,155053166,1,42893954
H1|chr6:125987468-125987536,chr6,125987468,125987536,H1|chr6:149070000-149070061,chr6,149070000,149070061,1,23082532
H1|chr6:132223792-132223942,chr6,132223792,132223942,H1|chr6:132271718-132271740,chr6,132271718,132271740,1,47926
H1|chr6:132227588-132227674,chr6,132227588,132227674,H1|chr6:132273607-132273667,chr6,132273607,132273667,1,46019
H1|chr6:132227588-132227666,chr6,132227588,132227666,H1|chr6:132273597-132273667,chr6,132273597,132273667,1,46009
H1|chr6:132227957-132227983,chr6,132227957,132227983,H1|chr6:132274398-132274465,chr6,132274398,132274465,1,46441
H1|chr6:132228817-132228878,chr6,132228817,132228878,H1|chr6:132271675-132271787,chr6,132271675,132271787,1,42858
H1|chr6:132228844-132228878,chr6,132228844,132228878,H1|chr6:132271675-132271787,chr6,132271675,132271787,1,42831
H1|chr6:132228918-132229046,chr6,132228918,132229046,H1|chr6:132274578-132274600,chr6,132274578,132274600,1,45660
H1|chr6:132228994-132229028,chr6,132228994,132229028,H1|chr6:151716718-151716834,chr6,151716718,151716834,1,19487724
H1|chr6:132228995-132229036,chr6,132228995,132229036,H1|chr6:151716718-151716834,chr6,151716718,151716834,1,19487723
H1|chr6:136760237-136760321,chr6,136760237,136760321,H1|chr6:151716420-151716486,chr6,151716420,151716486,1,14956183
H1|chr6:136760237-136760320,chr6,136760237,136760320,H1|chr6:151716420-151716486,chr6,151716420,151716486,1,14956183
H1|chr6:136760237-136760312,chr6,136760237,136760312,H1|chr6:151716420-151716495,chr6,151716420,151716495,1,14956183
H1|chr6:143177567-143177608,chr6,143177567,143177608,H1|chr6:136871317-136871467,chr6,136871317,136871467,1,6306250
H1|chr6:144588182-144588210,chr6,144588182,144588210,H1|chr6:144603691-144603765,chr6,144603691,144603765,1,15509
H1|chr6:144588942-144589092,chr6,144588942,144589092,H1|chr6:144605869-144605922,chr6,144605869,144605922,1,16927
H1|chr6:144589054-144589190,chr6,144589054,144589190,H1|chr6:144605869-144605901,chr6,144605869,144605901,1,16815
H1|chr6:144589072-144589190,chr6,144589072,144589190,H1|chr6:144605869-144605901,chr6,144605869,144605901,1,16797
H1|chr6:144589083-144589190,chr6,144589083,144589190,H1|chr6:144605869-144605911,chr6,144605869,144605911,1,16786
H1|chr6:144589093-144589190,chr6,144589093,144589190,H1|chr6:144605869-144605922,chr6,144605869,144605922,1,16776
H1|chr6:144589103-144589190,chr6,144589103,144589190,H1|chr6:144605869-144605924,chr6,144605869,144605924,1,16766
H1|chr6:144593283-144593321,chr6,144593283,144593321,H1|chr6:144602297-144602378,chr6,144602297,144602378,1,9014
H1|chr6:144593731-144593854,chr6,144593731,144593854,H1|chr6:144605869-144605891,chr6,144605869,144605891,1,12138
H1|chr6:144593802-144593854,chr6,144593802,144593854,H1|chr6:144605869-144605964,chr6,144605869,144605964,1,12067
H1|chr6:144593830-144593858,chr6,144593830,144593858,H1|chr6:144605869-144605978,chr6,144605869,144605978,1,12039
H1|chr6:144593985-144594098,chr6,144593985,144594098,H1|chr6:144603599-144603628,chr6,144603599,144603628,1,9614
H1|chr6:144595516-144595540,chr6,144595516,144595540,H1|chr6:144601833-144601955,chr6,144601833,144601955,1,6317
H1|chr6:144596464-144596538,chr6,144596464,144596538,H1|chr6:144605869-144605986,chr6,144605869,144605986,1,9405
H1|chr6:144596505-144596538,chr6,144596505,144596538,H1|chr6:144605869-144605986,chr6,144605869,144605986,1,9364
H1|chr6:144597536-144597638,chr6,144597536,144597638,H1|chr6:144605900-144605938,chr6,144605900,144605938,1,8364
H1|chr6:144597538-144597638,chr6,144597538,144597638,H1|chr6:144605900-144605938,chr6,144605900,144605938,1,8362
H1|chr6:144598688-144598797,chr6,144598688,144598797,H1|chr6:144605605-144605646,chr6,144605605,144605646,1,6917
H1|chr6:144598725-144598854,chr6,144598725,144598854,H1|chr6:144605546-144605567,chr6,144605546,144605567,1,6821
H1|chr6:144599279-144599341,chr6,144599279,144599341,H1|chr6:144601887-144601975,chr6,144601887,144601975,1,2608
H1|chr6:144650109-144650192,chr6,144650109,144650192,H1|chr6:143771155-143771200,chr6,143771155,143771200,1,878954
H1|chr6:144650109-144650191,chr6,144650109,144650191,H1|chr6:143771155-143771200,chr6,143771155,143771200,1,878954
H1|chr6:144650110-144650162,chr6,144650110,144650162,H1|chr6:143771155-143771195,chr6,143771155,143771195,1,878955
H1|chr6:149082872-149082926,chr6,149082872,149082926,H1|chr6:136870344-136870450,chr6,136870344,136870450,1,12212528
H1|chr6:149082883-149082927,chr6,149082883,149082927,H1|chr6:136870344-136870450,chr6,136870344,136870450,1,12212539
H1|chr6:157150888-157150990,chr6,157150888,157150990,H1|chr6:114662569-114662596,chr6,114662569,114662596,1,42488319
H1|chr6:157182383-157182455,chr6,157182383,157182455,H1|chr6:160212203-160212341,chr6,160212203,160212341,1,3029820
H1|chr6:157182383-157182422,chr6,157182383,157182422,H1|chr6:160212203-160212341,chr6,160212203,160212341,1,3029820
H1|chr6:157254195-157254286,chr6,157254195,157254286,H1|chr6:158702764-158702820,chr6,158702764,158702820,1,1448569
H1|chr6:157254198-157254286,chr6,157254198,157254286,H1|chr6:158702764-158702820,chr6,158702764,158702820,1,1448566
H1|chr6:157270850-157270955,chr6,157270850,157270955,H1|chr6:158703425-158703443,chr6,158703425,158703443,1,1432575
H1|chr6:157289149-157289202,chr6,157289149,157289202,H1|chr6:159238369-159238397,chr6,159238369,159238397,1,1949220
H1|chr6:157289150-157289266,chr6,157289150,157289266,H1|chr6:159238369-159238397,chr6,159238369,159238397,1,1949219
H1|chr6:157377994-157378059,chr6,157377994,157378059,H1|chr6:37225803-37225888,chr6,37225803,37225888,1,120152191
H1|chr6:157382829-157382877,chr6,157382829,157382877,H1|chr6:34393242-34393331,chr6,34393242,34393331,1,122989587
H1|chr6:157382831-157382877,chr6,157382831,157382877,H1|chr6:34393242-34393331,chr6,34393242,34393331,1,122989589
H1|chr6:158257630-158257712,chr6,158257630,158257712,H1|chr6:157101380-157101514,chr6,157101380,157101514,1,1156250
H1|chr6:158654420-158654511,chr6,158654420,158654511,H1|chr6:158700852-158700911,chr6,158700852,158700911,1,46432
H1|chr6:158654421-158654511,chr6,158654421,158654511,H1|chr6:158700852-158700911,chr6,158700852,158700911,1,46431
H1|chr6:158654686-158654736,chr6,158654686,158654736,H1|chr6:158703703-158703807,chr6,158703703,158703807,1,49017
H1|chr6:158654694-158654736,chr6,158654694,158654736,H1|chr6:158703703-158703807,chr6,158703703,158703807,1,49009
H1|chr6:158977566-158977606,chr6,158977566,158977606,H1|chr6:111199655-111199757,chr6,111199655,111199757,1,47777911
H1|chr6:167402234-167402296,chr6,167402234,167402296,H1|chr6:31135597-31135674,chr6,31135597,31135674,1,136266637
H1|chr6:167402239-167402296,chr6,167402239,167402296,H1|chr6:31135597-31135674,chr6,31135597,31135674,1,136266642
H1|chr6:167642945-167643026,chr6,167642945,167643026,H1|chr6:35437486-35437517,chr6,35437486,35437517,1,132205459
H1|chr6:167647271-167647407,chr6,167647271,167647407,H1|chr6:27805191-27805301,chr6,27805191,27805301,1,139842080
H1|chr6:167647271-167647388,chr6,167647271,167647388,H1|chr6:27805191-27805301,chr6,27805191,27805301,1,139842080
H1|chr6:167647367-167647407,chr6,167647367,167647407,H1|chr6:27805191-27805301,chr6,27805191,27805301,1,139842176
H1|chr6:167650156-167650196,chr6,167650156,167650196,H1|chr6:35437105-35437175,chr6,35437105,35437175,1,132213051
H1|chr6:167661464-167661557,chr6,167661464,167661557,H1|chr6:71996937-71997004,chr6,71996937,71997004,1,95664527
H1|chr6:167661465-167661557,chr6,167661465,167661557,H1|chr6:71996967-71997004,chr6,71996967,71997004,1,95664498
H1|chr6:167661482-167661557,chr6,167661482,167661557,H1|chr6:71996937-71997004,chr6,71996937,71997004,1,95664545
H1|chr7:2462247-2462346,chr7,2462247,2462346,H1|chr7:99041539-99041657,chr7,99041539,99041657,1,96579292
H1|chr7:2910257-2910386,chr7,2910257,2910386,H1|chr7:2885730-2885766,chr7,2885730,2885766,1,24527
H1|chr7:2910257-2910367,chr7,2910257,2910367,H1|chr7:2885730-2885766,chr7,2885730,2885766,1,24527
H1|chr7:2910257-2910335,chr7,2910257,2910335,H1|chr7:2885680-2885766,chr7,2885680,2885766,1,24577
H1|chr7:2910257-2910321,chr7,2910257,2910321,H1|chr7:2885680-2885766,chr7,2885680,2885766,1,24577
H1|chr7:2910268-2910331,chr7,2910268,2910331,H1|chr7:2885680-2885766,chr7,2885680,2885766,1,24588
H1|chr7:5531752-5531862,chr7,5531752,5531862,H1|chr7:5598093-5598133,chr7,5598093,5598133,1,66341
H1|chr7:5531804-5531953,chr7,5531804,5531953,H1|chr7:5598093-5598133,chr7,5598093,5598133,1,66289
H1|chr7:5533119-5533231,chr7,5533119,5533231,H1|chr7:5598170-5598217,chr7,5598170,5598217,1,65051
H1|chr7:5533128-5533231,chr7,5533128,5533231,H1|chr7:5598170-5598217,chr7,5598170,5598217,1,65042
H1|chr7:8262124-8262144,chr7,8262124,8262144,H1|chr7:148848377-148848462,chr7,148848377,148848462,1,140586253
H1|chr7:8262124-8262142,chr7,8262124,8262142,H1|chr7:148848377-148848462,chr7,148848377,148848462,1,140586253
H1|chr7:20094460-20094610,chr7,20094460,20094610,H1|chr7:100134678-100134720,chr7,100134678,100134720,1,80040218
H1|chr7:20094673-20094721,chr7,20094673,20094721,H1|chr7:100134649-100134721,chr7,100134649,100134721,1,80039976
H1|chr7:20097841-20097898,chr7,20097841,20097898,H1|chr7:7224273-7224327,chr7,7224273,7224327,1,12873568
H1|chr7:20110833-20110918,chr7,20110833,20110918,H1|chr7:26239106-26239157,chr7,26239106,26239157,1,6128273
H1|chr7:23494910-23495002,chr7,23494910,23495002,H1|chr7:23527364-23527413,chr7,23527364,23527413,1,32454
H1|chr7:23494914-23495002,chr7,23494914,23495002,H1|chr7:23527364-23527413,chr7,23527364,23527413,1,32450
H1|chr7:23499223-23499285,chr7,23499223,23499285,H1|chr7:23526923-23526967,chr7,23526923,23526967,1,27700
H1|chr7:23499690-23499787,chr7,23499690,23499787,H1|chr7:23529129-23529257,chr7,23529129,23529257,1,29439
H1|chr7:23500055-23500154,chr7,23500055,23500154,H1|chr7:23569486-23569529,chr7,23569486,23569529,1,69431
H1|chr7:23518864-23518945,chr7,23518864,23518945,H1|chr7:23570662-23570752,chr7,23570662,23570752,1,51798
H1|chr7:23518885-23518945,chr7,23518885,23518945,H1|chr7:23570662-23570752,chr7,23570662,23570752,1,51777
H1|chr7:23518951-23519042,chr7,23518951,23519042,H1|chr7:23532517-23532576,chr7,23532517,23532576,1,13566
H1|chr7:23518952-23519055,chr7,23518952,23519055,H1|chr7:23532517-23532576,chr7,23532517,23532576,1,13565
H1|chr7:23519498-23519517,chr7,23519498,23519517,H1|chr7:23533063-23533213,chr7,23533063,23533213,1,13565
H1|chr7:23523419-23523453,chr7,23523419,23523453,H1|chr7:23531998-23532078,chr7,23531998,23532078,1,8579
H1|chr7:23523612-23523657,chr7,23523612,23523657,H1|chr7:23531581-23531710,chr7,23531581,23531710,1,7969
H1|chr7:23524267-23524323,chr7,23524267,23524323,H1|chr7:23529304-23529448,chr7,23529304,23529448,1,5037
H1|chr7:23524289-23524370,chr7,23524289,23524370,H1|chr7:23528340-23528393,chr7,23528340,23528393,1,4051
H1|chr7:23524580-23524676,chr7,23524580,23524676,H1|chr7:23526772-23526814,chr7,23526772,23526814,1,2192
H1|chr7:23524594-23524650,chr7,23524594,23524650,H1|chr7:23528338-23528397,chr7,23528338,23528397,1,3744
H1|chr7:23524931-23525010,chr7,23524931,23525010,H1|chr7:23526269-23526321,chr7,23526269,23526321,1,1338
H1|chr7:23524941-23524989,chr7,23524941,23524989,H1|chr7:23526269-23526321,chr7,23526269,23526321,1,1328
H1|chr7:24413794-24413848,chr7,24413794,24413848,H1|chr7:24318914-24318982,chr7,24318914,24318982,1,94880
H1|chr7:24418797-24418907,chr7,24418797,24418907,H1|chr7:24319059-24319101,chr7,24319059,24319101,1,99738
H1|chr7:24432734-24432837,chr7,24432734,24432837,H1|chr7:24321429-24321467,chr7,24321429,24321467,1,111305
H1|chr7:24434247-24434334,chr7,24434247,24434334,H1|chr7:24324351-24324372,chr7,24324351,24324372,1,109896
H1|chr7:24434679-24434789,chr7,24434679,24434789,H1|chr7:24322683-24322723,chr7,24322683,24322723,1,111996
H1|chr7:24434782-24434929,chr7,24434782,24434929,H1|chr7:24322683-24322723,chr7,24322683,24322723,1,112099
H1|chr7:24436215-24436275,chr7,24436215,24436275,H1|chr7:26239401-26239491,chr7,26239401,26239491,1,1803186
H1|chr7:24436215-24436274,chr7,24436215,24436274,H1|chr7:26239401-26239491,chr7,26239401,26239491,1,1803186
H1|chr7:24436473-24436514,chr7,24436473,24436514,H1|chr7:24796473-24796521,chr7,24796473,24796521,1,360000
H1|chr7:24437982-24438087,chr7,24437982,24438087,H1|chr7:135243479-135243518,chr7,135243479,135243518,1,110805497
H1|chr7:24437984-24438087,chr7,24437984,24438087,H1|chr7:135243479-135243518,chr7,135243479,135243518,1,110805495
H1|chr7:24441377-24441469,chr7,24441377,24441469,H1|chr7:23506773-23506910,chr7,23506773,23506910,1,934604
H1|chr7:24441377-24441455,chr7,24441377,24441455,H1|chr7:23506773-23506910,chr7,23506773,23506910,1,934604
H1|chr7:24444782-24444845,chr7,24444782,24444845,H1|chr7:23507186-23507248,chr7,23507186,23507248,1,937596
H1|chr7:24444784-24444844,chr7,24444784,24444844,H1|chr7:23507184-23507249,chr7,23507184,23507249,1,937600
H1|chr7:24446092-24446131,chr7,24446092,24446131,H1|chr7:25165373-25165505,chr7,25165373,25165505,1,719281
H1|chr7:24446092-24446110,chr7,24446092,24446110,H1|chr7:25165373-25165505,chr7,25165373,25165505,1,719281
H1|chr7:24446590-24446713,chr7,24446590,24446713,H1|chr7:26239702-26239754,chr7,26239702,26239754,1,1793112
H1|chr7:24446615-24446713,chr7,24446615,24446713,H1|chr7:26239702-26239754,chr7,26239702,26239754,1,1793087
H1|chr7:26198558-26198708,chr7,26198558,26198708,H1|chr7:43768164-43768219,chr7,43768164,43768219,1,17569606
H1|chr7:26198558-26198695,chr7,26198558,26198695,H1|chr7:43768164-43768219,chr7,43768164,43768219,1,17569606
H1|chr7:26198635-26198730,chr7,26198635,26198730,H1|chr7:43768164-43768219,chr7,43768164,43768219,1,17569529
H1|chr7:27595140-27595215,chr7,27595140,27595215,H1|chr7:26237759-26237823,chr7,26237759,26237823,1,1357381
H1|chr7:27595140-27595213,chr7,27595140,27595213,H1|chr7:26237759-26237823,chr7,26237759,26237823,1,1357381
H1|chr7:30202689-30202733,chr7,30202689,30202733,H1|chr7:30176619-30176742,chr7,30176619,30176742,1,26070
H1|chr7:30202706-30202733,chr7,30202706,30202733,H1|chr7:30176619-30176742,chr7,30176619,30176742,1,26087
H1|chr7:30206605-30206626,chr7,30206605,30206626,H1|chr7:30173166-30173225,chr7,30173166,30173225,1,33439
H1|chr7:33532720-33532798,chr7,33532720,33532798,H1|chr7:44838018-44838110,chr7,44838018,44838110,1,11305298
H1|chr7:33532720-33532773,chr7,33532720,33532773,H1|chr7:44838018-44838110,chr7,44838018,44838110,1,11305298
H1|chr7:33749594-33749700,chr7,33749594,33749700,H1|chr7:35075861-35075899,chr7,35075861,35075899,1,1326267
H1|chr7:33749594-33749692,chr7,33749594,33749692,H1|chr7:35075861-35075905,chr7,35075861,35075905,1,1326267
H1|chr7:33749594-33749688,chr7,33749594,33749688,H1|chr7:35075861-35075905,chr7,35075861,35075905,1,1326267
H1|chr7:33749594-33749683,chr7,33749594,33749683,H1|chr7:35075861-35075905,chr7,35075861,35075905,1,1326267
H1|chr7:44077961-44078099,chr7,44077961,44078099,H1|chr7:102232272-102232420,chr7,102232272,102232420,1,58154311
H1|chr7:44078722-44078872,chr7,44078722,44078872,H1|chr7:102233168-102233318,chr7,102233168,102233318,1,58154446
H1|chr7:69199495-69199574,chr7,69199495,69199574,H1|chr7:65212607-65212648,chr7,65212607,65212648,1,3986888
H1|chr7:69199496-69199528,chr7,69199496,69199528,H1|chr7:65212606-65212648,chr7,65212606,65212648,1,3986890
H1|chr7:70163861-70163901,chr7,70163861,70163901,H1|chr7:131238333-131238389,chr7,131238333,131238389,1,61074472
H1|chr7:70164339-70164437,chr7,70164339,70164437,H1|chr7:121035703-121035734,chr7,121035703,121035734,1,50871364
H1|chr7:70164342-70164437,chr7,70164342,70164437,H1|chr7:121035703-121035734,chr7,121035703,121035734,1,50871361
H1|chr7:70166665-70166715,chr7,70166665,70166715,H1|chr7:70598873-70598971,chr7,70598873,70598971,1,432208
H1|chr7:70167134-70167210,chr7,70167134,70167210,H1|chr7:121035958-121035998,chr7,121035958,121035998,1,50868824
H1|chr7:70167135-70167210,chr7,70167135,70167210,H1|chr7:121035958-121035998,chr7,121035958,121035998,1,50868823
H1|chr7:70168134-70168228,chr7,70168134,70168228,H1|chr7:131237344-131237381,chr7,131237344,131237381,1,61069210
H1|chr7:70168137-70168228,chr7,70168137,70168228,H1|chr7:131237344-131237381,chr7,131237344,131237381,1,61069207
H1|chr7:70172350-70172412,chr7,70172350,70172412,H1|chr7:70599033-70599103,chr7,70599033,70599103,1,426683
H1|chr7:70174715-70174753,chr7,70174715,70174753,H1|chr7:70598551-70598649,chr7,70598551,70598649,1,423836
H1|chr7:70313178-70313280,chr7,70313178,70313280,H1|chr7:70598810-70598835,chr7,70598810,70598835,1,285632
H1|chr7:70926492-70926533,chr7,70926492,70926533,H1|chr7:121781744-121781836,chr7,121781744,121781836,1,50855252
H1|chr7:70929584-70929620,chr7,70929584,70929620,H1|chr7:121783473-121783621,chr7,121783473,121783621,1,50853889
H1|chr7:70965459-70965521,chr7,70965459,70965521,H1|chr7:1176752-1176807,chr7,1176752,1176807,1,69788707
H1|chr7:70965459-70965519,chr7,70965459,70965519,H1|chr7:1176752-1176807,chr7,1176752,1176807,1,69788707
H1|chr7:70965460-70965519,chr7,70965460,70965519,H1|chr7:1176752-1176807,chr7,1176752,1176807,1,69788708
H1|chr7:71098983-71099024,chr7,71098983,71099024,H1|chr7:72396406-72396475,chr7,72396406,72396475,1,1297423
H1|chr7:73558903-73558981,chr7,73558903,73558981,H1|chr7:73587505-73587586,chr7,73587505,73587586,1,28602
H1|chr7:73562446-73562593,chr7,73562446,73562593,H1|chr7:73584825-73584888,chr7,73584825,73584888,1,22379
H1|chr7:75266516-75266627,chr7,75266516,75266627,H1|chr7:72396715-72396865,chr7,72396715,72396865,1,2869801
H1|chr7:75266533-75266627,chr7,75266533,75266627,H1|chr7:72396715-72396865,chr7,72396715,72396865,1,2869818
H1|chr7:75275942-75276044,chr7,75275942,75276044,H1|chr7:73673114-73673207,chr7,73673114,73673207,1,1602828
H1|chr7:75275942-75275999,chr7,75275942,75275999,H1|chr7:73673114-73673207,chr7,73673114,73673207,1,1602828
H1|chr7:75807839-75807877,chr7,75807839,75807877,H1|chr7:75828289-75828334,chr7,75828289,75828334,1,20450
H1|chr7:75819579-75819640,chr7,75819579,75819640,H1|chr7:75828085-75828129,chr7,75828085,75828129,1,8506
H1|chr7:75921668-75921702,chr7,75921668,75921702,H1|chr7:75927112-75927262,chr7,75927112,75927262,1,5444
H1|chr7:75923189-75923229,chr7,75923189,75923229,H1|chr7:75927872-75927954,chr7,75927872,75927954,1,4683
H1|chr7:97925213-97925239,chr7,97925213,97925239,H1|chr7:91570756-91570858,chr7,91570756,91570858,1,6354457
H1|chr7:98735640-98735759,chr7,98735640,98735759,H1|chr7:100449366-100449428,chr7,100449366,100449428,1,1713726
H1|chr7:98735640-98735728,chr7,98735640,98735728,H1|chr7:100449366-100449406,chr7,100449366,100449406,1,1713726
H1|chr7:99230574-99230645,chr7,99230574,99230645,H1|chr7:97737684-97737701,chr7,97737684,97737701,1,1492890
H1|chr7:99230574-99230631,chr7,99230574,99230631,H1|chr7:97737684-97737701,chr7,97737684,97737701,1,1492890
H1|chr7:99230576-99230648,chr7,99230576,99230648,H1|chr7:97737684-97737701,chr7,97737684,97737701,1,1492892
H1|chr7:100045373-100045399,chr7,100045373,100045399,H1|chr7:100270089-100270153,chr7,100270089,100270153,1,224716
H1|chr7:100048791-100048869,chr7,100048791,100048869,H1|chr7:100270089-100270161,chr7,100270089,100270161,1,221298
H1|chr7:100937212-100937260,chr7,100937212,100937260,H1|chr7:100857888-100857961,chr7,100857888,100857961,1,79324
H1|chr7:100937212-100937259,chr7,100937212,100937259,H1|chr7:100857888-100857961,chr7,100857888,100857961,1,79324
H1|chr7:100949180-100949246,chr7,100949180,100949246,H1|chr7:101931264-101931291,chr7,101931264,101931291,1,982084
H1|chr7:100949180-100949245,chr7,100949180,100949245,H1|chr7:101931264-101931291,chr7,101931264,101931291,1,982084
H1|chr7:101031781-101031883,chr7,101031781,101031883,H1|chr7:104653776-104653808,chr7,104653776,104653808,1,3621995
H1|chr7:101031859-101031963,chr7,101031859,101031963,H1|chr7:100876901-100876941,chr7,100876901,100876941,1,154958
H1|chr7:101032756-101032825,chr7,101032756,101032825,H1|chr7:104652796-104652910,chr7,104652796,104652910,1,3620040
H1|chr7:101043752-101043794,chr7,101043752,101043794,H1|chr7:100899451-100899559,chr7,100899451,100899559,1,144301
H1|chr7:101056726-101056776,chr7,101056726,101056776,H1|chr7:101005884-101005947,chr7,101005884,101005947,1,50842
H1|chr7:101131861-101131947,chr7,101131861,101131947,H1|chr7:74378462-74378499,chr7,74378462,74378499,1,26753399
H1|chr7:101131861-101131946,chr7,101131861,101131946,H1|chr7:74378462-74378499,chr7,74378462,74378499,1,26753399
H1|chr7:101131861-101131915,chr7,101131861,101131915,H1|chr7:74378462-74378499,chr7,74378462,74378499,1,26753399
H1|chr7:101139047-101139143,chr7,101139047,101139143,H1|chr7:100290930-100291004,chr7,100290930,100291004,1,848117
H1|chr7:101139047-101139123,chr7,101139047,101139123,H1|chr7:100290930-100291004,chr7,100290930,100291004,1,848117
H1|chr7:101532924-101533074,chr7,101532924,101533074,H1|chr7:112091785-112091848,chr7,112091785,112091848,1,10558861
H1|chr7:101576916-101576949,chr7,101576916,101576949,H1|chr7:5636233-5636332,chr7,5636233,5636332,1,95940683
H1|chr7:101580899-101580955,chr7,101580899,101580955,H1|chr7:99822192-99822294,chr7,99822192,99822294,1,1758707
H1|chr7:101586767-101586847,chr7,101586767,101586847,H1|chr7:100289518-100289551,chr7,100289518,100289551,1,1297249
H1|chr7:101591610-101591740,chr7,101591610,101591740,H1|chr7:93629813-93629833,chr7,93629813,93629833,1,7961797
H1|chr7:101595578-101595645,chr7,101595578,101595645,H1|chr7:100290832-100290882,chr7,100290832,100290882,1,1304746
H1|chr7:101595579-101595645,chr7,101595579,101595645,H1|chr7:100290832-100290882,chr7,100290832,100290882,1,1304747
H1|chr7:101595992-101596073,chr7,101595992,101596073,H1|chr7:74073694-74073759,chr7,74073694,74073759,1,27522298
H1|chr7:101596316-101596373,chr7,101596316,101596373,H1|chr7:99765386-99765434,chr7,99765386,99765434,1,1830930
H1|chr7:101597395-101597428,chr7,101597395,101597428,H1|chr7:99755627-99755694,chr7,99755627,99755694,1,1841768
H1|chr7:101597395-101597427,chr7,101597395,101597427,H1|chr7:99755627-99755694,chr7,99755627,99755694,1,1841768
H1|chr7:101598923-101598994,chr7,101598923,101598994,H1|chr7:93631846-93631925,chr7,93631846,93631925,1,7967077
H1|chr7:101598923-101598989,chr7,101598923,101598989,H1|chr7:93631846-93631925,chr7,93631846,93631925,1,7967077
H1|chr7:102133091-102133156,chr7,102133091,102133156,H1|chr7:102232346-102232496,chr7,102232346,102232496,1,99255
H1|chr7:102133102-102133156,chr7,102133102,102133156,H1|chr7:102232325-102232419,chr7,102232325,102232419,1,99223
H1|chr7:102133103-102133163,chr7,102133103,102133163,H1|chr7:102232318-102232428,chr7,102232318,102232428,1,99215
H1|chr7:102133164-102133314,chr7,102133164,102133314,H1|chr7:102232273-102232422,chr7,102232273,102232422,1,99109
H1|chr7:102133232-102133382,chr7,102133232,102133382,H1|chr7:102232256-102232404,chr7,102232256,102232404,1,99024
H1|chr7:102133260-102133407,chr7,102133260,102133407,H1|chr7:102232321-102232471,chr7,102232321,102232471,1,99061
H1|chr7:102133277-102133427,chr7,102133277,102133427,H1|chr7:102232273-102232423,chr7,102232273,102232423,1,98996
H1|chr7:102329046-102329144,chr7,102329046,102329144,H1|chr7:102233190-102233241,chr7,102233190,102233241,1,95856
H1|chr7:102329090-102329184,chr7,102329090,102329184,H1|chr7:102233199-102233236,chr7,102233199,102233236,1,95891
H1|chr7:105302277-105302345,chr7,105302277,105302345,H1|chr7:130133939-130134006,chr7,130133939,130134006,1,24831662
H1|chr7:105308068-105308141,chr7,105308068,105308141,H1|chr7:105171355-105171422,chr7,105171355,105171422,1,136713
H1|chr7:105360054-105360106,chr7,105360054,105360106,H1|chr7:156684786-156684841,chr7,156684786,156684841,1,51324732
H1|chr7:105360054-105360105,chr7,105360054,105360105,H1|chr7:156684786-156684841,chr7,156684786,156684841,1,51324732
H1|chr7:105493479-105493535,chr7,105493479,105493535,H1|chr7:121036143-121036237,chr7,121036143,121036237,1,15542664
H1|chr7:107604425-107604465,chr7,107604425,107604465,H1|chr7:97599717-97599829,chr7,97599717,97599829,1,10004708
H1|chr7:107604425-107604462,chr7,107604425,107604462,H1|chr7:97599717-97599829,chr7,97599717,97599829,1,10004708
H1|chr7:111495095-111495135,chr7,111495095,111495135,H1|chr7:150065220-150065252,chr7,150065220,150065252,1,38570125
H1|chr7:111495096-111495135,chr7,111495096,111495135,H1|chr7:150065219-150065287,chr7,150065219,150065287,1,38570123
H1|chr7:111810006-111810062,chr7,111810006,111810062,H1|chr7:131240633-131240668,chr7,131240633,131240668,1,19430627
H1|chr7:111811880-111811995,chr7,111811880,111811995,H1|chr7:131237235-131237270,chr7,131237235,131237270,1,19425355
H1|chr7:111811903-111812053,chr7,111811903,111812053,H1|chr7:131237235-131237270,chr7,131237235,131237270,1,19425332
H1|chr7:111815111-111815204,chr7,111815111,111815204,H1|chr7:151215677-151215699,chr7,151215677,151215699,1,39400566
H1|chr7:111815111-111815203,chr7,111815111,111815203,H1|chr7:151215676-151215699,chr7,151215676,151215699,1,39400565
H1|chr7:121519325-121519462,chr7,121519325,121519462,H1|chr7:121783876-121783932,chr7,121783876,121783932,1,264551
H1|chr7:121519368-121519462,chr7,121519368,121519462,H1|chr7:121783876-121783932,chr7,121783876,121783932,1,264508
H1|chr7:121524971-121525021,chr7,121524971,121525021,H1|chr7:121781290-121781327,chr7,121781290,121781327,1,256319
H1|chr7:121525123-121525203,chr7,121525123,121525203,H1|chr7:121781452-121781498,chr7,121781452,121781498,1,256329
H1|chr7:121525125-121525203,chr7,121525125,121525203,H1|chr7:121781450-121781498,chr7,121781450,121781498,1,256325
H1|chr7:121527042-121527126,chr7,121527042,121527126,H1|chr7:121782205-121782248,chr7,121782205,121782248,1,255163
H1|chr7:121568584-121568666,chr7,121568584,121568666,H1|chr7:121782533-121782568,chr7,121782533,121782568,1,213949
H1|chr7:121568586-121568666,chr7,121568586,121568666,H1|chr7:121782533-121782568,chr7,121782533,121782568,1,213947
H1|chr7:121571958-121571991,chr7,121571958,121571991,H1|chr7:121775654-121775752,chr7,121775654,121775752,1,203696
H1|chr7:121572009-121572061,chr7,121572009,121572061,H1|chr7:121775654-121775752,chr7,121775654,121775752,1,203645
H1|chr7:121572011-121572056,chr7,121572011,121572056,H1|chr7:121775654-121775757,chr7,121775654,121775757,1,203643
H1|chr7:121572955-121572997,chr7,121572955,121572997,H1|chr7:121777830-121777911,chr7,121777830,121777911,1,204875
H1|chr7:121572956-121572997,chr7,121572956,121572997,H1|chr7:121777830-121777911,chr7,121777830,121777911,1,204874
H1|chr7:121577241-121577301,chr7,121577241,121577301,H1|chr7:121773850-121773919,chr7,121773850,121773919,1,196609
H1|chr7:121577508-121577557,chr7,121577508,121577557,H1|chr7:121777774-121777827,chr7,121777774,121777827,1,200266
H1|chr7:121581407-121581500,chr7,121581407,121581500,H1|chr7:121781365-121781422,chr7,121781365,121781422,1,199958
H1|chr7:121581425-121581500,chr7,121581425,121581500,H1|chr7:121781347-121781422,chr7,121781347,121781422,1,199922
H1|chr7:121725712-121725735,chr7,121725712,121725735,H1|chr7:149471545-149471644,chr7,149471545,149471644,1,27745833
H1|chr7:121725714-121725735,chr7,121725714,121725735,H1|chr7:149471545-149471644,chr7,149471545,149471644,1,27745831
H1|chr7:121725714-121725734,chr7,121725714,121725734,H1|chr7:149471545-149471644,chr7,149471545,149471644,1,27745831
H1|chr7:121731168-121731282,chr7,121731168,121731282,H1|chr7:50859380-50859412,chr7,50859380,50859412,1,70871788
H1|chr7:121731168-121731264,chr7,121731168,121731264,H1|chr7:50859380-50859412,chr7,50859380,50859412,1,70871788
H1|chr7:121731203-121731353,chr7,121731203,121731353,H1|chr7:50859380-50859412,chr7,50859380,50859412,1,70871823
H1|chr7:121984179-121984208,chr7,121984179,121984208,H1|chr7:121775618-121775685,chr7,121775618,121775685,1,208561
H1|chr7:121986678-121986789,chr7,121986678,121986789,H1|chr7:121776882-121776962,chr7,121776882,121776962,1,209796
H1|chr7:121986678-121986788,chr7,121986678,121986788,H1|chr7:121776882-121776962,chr7,121776882,121776962,1,209796
H1|chr7:121986720-121986790,chr7,121986720,121986790,H1|chr7:121776882-121776962,chr7,121776882,121776962,1,209838
H1|chr7:127309542-127309612,chr7,127309542,127309612,H1|chr7:121780111-121780180,chr7,121780111,121780180,1,5529431
H1|chr7:127575044-127575105,chr7,127575044,127575105,H1|chr7:121775421-121775475,chr7,121775421,121775475,1,5799623
H1|chr7:127578351-127578400,chr7,127578351,127578400,H1|chr7:121777379-121777498,chr7,121777379,121777498,1,5800972
H1|chr7:127578369-127578400,chr7,127578369,127578400,H1|chr7:121777379-121777498,chr7,121777379,121777498,1,5800990
H1|chr7:128523391-128523430,chr7,128523391,128523430,H1|chr7:128335726-128335759,chr7,128335726,128335759,1,187665
H1|chr7:128892523-128892593,chr7,128892523,128892593,H1|chr7:121780398-121780523,chr7,121780398,121780523,1,7112125
H1|chr7:128899369-128899420,chr7,128899369,128899420,H1|chr7:121783065-121783102,chr7,121783065,121783102,1,7116304
H1|chr7:129482514-129482621,chr7,129482514,129482621,H1|chr7:131237836-131237883,chr7,131237836,131237883,1,1755322
H1|chr7:129482519-129482622,chr7,129482519,129482622,H1|chr7:131237836-131237883,chr7,131237836,131237883,1,1755317
H1|chr7:129485513-129485619,chr7,129485513,129485619,H1|chr7:131240188-131240237,chr7,131240188,131240237,1,1754675
H1|chr7:131199119-131199229,chr7,131199119,131199229,H1|chr7:121782045-121782085,chr7,121782045,121782085,1,9417074
H1|chr7:131199132-131199229,chr7,131199132,131199229,H1|chr7:121782045-121782084,chr7,121782045,121782084,1,9417087
H1|chr7:131203438-131203474,chr7,131203438,131203474,H1|chr7:142987278-142987320,chr7,142987278,142987320,1,11783840
H1|chr7:131205474-131205520,chr7,131205474,131205520,H1|chr7:129590843-129590922,chr7,129590843,129590922,1,1614631
H1|chr7:131207089-131207157,chr7,131207089,131207157,H1|chr7:121782220-121782241,chr7,121782220,121782241,1,9424869
H1|chr7:131212855-131212967,chr7,131212855,131212967,H1|chr7:138147983-138148054,chr7,138147983,138148054,1,6935128
H1|chr7:131212888-131212967,chr7,131212888,131212967,H1|chr7:138147983-138148054,chr7,138147983,138148054,1,6935095
H1|chr7:131220049-131220161,chr7,131220049,131220161,H1|chr7:82071938-82071971,chr7,82071938,82071971,1,49148111
H1|chr7:131220049-131220160,chr7,131220049,131220160,H1|chr7:82071938-82071971,chr7,82071938,82071971,1,49148111
H1|chr7:131220071-131220161,chr7,131220071,131220161,H1|chr7:82071938-82071971,chr7,82071938,82071971,1,49148133
H1|chr7:131224440-131224539,chr7,131224440,131224539,H1|chr7:148848397-148848462,chr7,148848397,148848462,1,17623957
H1|chr7:131224440-131224522,chr7,131224440,131224522,H1|chr7:148848397-148848462,chr7,148848397,148848462,1,17623957
H1|chr7:131225099-131225124,chr7,131225099,131225124,H1|chr7:121781739-121781808,chr7,121781739,121781808,1,9443360
H1|chr7:131226123-131226157,chr7,131226123,131226157,H1|chr7:121782755-121782776,chr7,121782755,121782776,1,9443368
H1|chr7:131227341-131227436,chr7,131227341,131227436,H1|chr7:148846059-148846096,chr7,148846059,148846096,1,17618718
H1|chr7:131227341-131227433,chr7,131227341,131227433,H1|chr7:148846059-148846096,chr7,148846059,148846096,1,17618718
H1|chr7:131227940-131227989,chr7,131227940,131227989,H1|chr7:148848043-148848120,chr7,148848043,148848120,1,17620103
H1|chr7:131228918-131228963,chr7,131228918,131228963,H1|chr7:129590930-129591016,chr7,129590930,129591016,1,1637988
H1|chr7:131230734-131230780,chr7,131230734,131230780,H1|chr7:138147970-138148063,chr7,138147970,138148063,1,6917236
H1|chr7:131232000-131232123,chr7,131232000,131232123,H1|chr7:41744259-41744282,chr7,41744259,41744282,1,89487741
H1|chr7:131232000-131232121,chr7,131232000,131232121,H1|chr7:41744259-41744282,chr7,41744259,41744282,1,89487741
H1|chr7:131234779-131234818,chr7,131234779,131234818,H1|chr7:121783895-121784038,chr7,121783895,121784038,1,9450884
H1|chr7:131235922-131236002,chr7,131235922,131236002,H1|chr7:129590164-129590209,chr7,129590164,129590209,1,1645758
H1|chr7:131286702-131286762,chr7,131286702,131286762,H1|chr7:131238950-131239021,chr7,131238950,131239021,1,47752
H1|chr7:131288243-131288333,chr7,131288243,131288333,H1|chr7:131240224-131240246,chr7,131240224,131240246,1,48019
H1|chr7:132564743-132564825,chr7,132564743,132564825,H1|chr7:121786935-121786978,chr7,121786935,121786978,1,10777808
H1|chr7:148663524-148663646,chr7,148663524,148663646,H1|chr7:148791208-148791263,chr7,148791208,148791263,1,127684
H1|chr7:150032778-150032879,chr7,150032778,150032879,H1|chr7:100290043-100290092,chr7,100290043,100290092,1,49742735
H1|chr7:150093446-150093511,chr7,150093446,150093511,H1|chr7:150815060-150815144,chr7,150815060,150815144,1,721614
H1|chr7:150093453-150093538,chr7,150093453,150093538,H1|chr7:150815060-150815130,chr7,150815060,150815130,1,721607
H1|chr8:430541-430561,chr8,430541,430561,H1|chr8:493140-493267,chr8,493140,493267,1,62599
H1|chr8:430815-430909,chr8,430815,430909,H1|chr8:493948-494095,chr8,493948,494095,1,63133
H1|chr8:433125-433204,chr8,433125,433204,H1|chr8:493948-493999,chr8,493948,493999,1,60823
H1|chr8:433152-433211,chr8,433152,433211,H1|chr8:493948-493999,chr8,493948,493999,1,60796
H1|chr8:434546-434574,chr8,434546,434574,H1|chr8:494639-494658,chr8,494639,494658,1,60093
H1|chr8:435871-435895,chr8,435871,435895,H1|chr8:1773098-1773203,chr8,1773098,1773203,1,1337227
H1|chr8:436392-436460,chr8,436392,436460,H1|chr8:494544-494583,chr8,494544,494583,1,58152
H1|chr8:436763-436883,chr8,436763,436883,H1|chr8:495479-495495,chr8,495479,495495,1,58716
H1|chr8:436763-436881,chr8,436763,436881,H1|chr8:495479-495495,chr8,495479,495495,1,58716
H1|chr8:437694-437758,chr8,437694,437758,H1|chr8:1773132-1773218,chr8,1773132,1773218,1,1335438
H1|chr8:437695-437784,chr8,437695,437784,H1|chr8:1773132-1773218,chr8,1773132,1773218,1,1335437
H1|chr8:438822-438857,chr8,438822,438857,H1|chr8:493164-493279,chr8,493164,493279,1,54342
H1|chr8:438844-438987,chr8,438844,438987,H1|chr8:493164-493279,chr8,493164,493279,1,54320
H1|chr8:438875-438987,chr8,438875,438987,H1|chr8:493164-493279,chr8,493164,493279,1,54289
H1|chr8:479442-479565,chr8,479442,479565,H1|chr8:500698-500725,chr8,500698,500725,1,21256
H1|chr8:483284-483351,chr8,483284,483351,H1|chr8:1773180-1773212,chr8,1773180,1773212,1,1289896
H1|chr8:486314-486362,chr8,486314,486362,H1|chr8:1772648-1772739,chr8,1772648,1772739,1,1286334
H1|chr8:1745756-1745784,chr8,1745756,1745784,H1|chr8:42357029-42357123,chr8,42357029,42357123,1,40611273
H1|chr8:1745756-1745783,chr8,1745756,1745783,H1|chr8:42357028-42357123,chr8,42357028,42357123,1,40611272
H1|chr8:1750250-1750320,chr8,1750250,1750320,H1|chr8:1768905-1768982,chr8,1768905,1768982,1,18655
H1|chr8:1750251-1750342,chr8,1750251,1750342,H1|chr8:1768905-1768982,chr8,1768905,1768982,1,18654
H1|chr8:1757554-1757605,chr8,1757554,1757605,H1|chr8:1769452-1769515,chr8,1769452,1769515,1,11898
H1|chr8:1762144-1762222,chr8,1762144,1762222,H1|chr8:1772719-1772739,chr8,1772719,1772739,1,10575
H1|chr8:1764883-1764926,chr8,1764883,1764926,H1|chr8:1767693-1767777,chr8,1767693,1767777,1,2810
H1|chr8:8723805-8723895,chr8,8723805,8723895,H1|chr8:11661825-11661861,chr8,11661825,11661861,1,2938020
H1|chr8:8723805-8723841,chr8,8723805,8723841,H1|chr8:11661825-11661861,chr8,11661825,11661861,1,2938020
H1|chr8:8723806-8723841,chr8,8723806,8723841,H1|chr8:11661824-11661861,chr8,11661824,11661861,1,2938018
H1|chr8:8723840-8723894,chr8,8723840,8723894,H1|chr8:11661825-11661861,chr8,11661825,11661861,1,2937985
H1|chr8:30254343-30254385,chr8,30254343,30254385,H1|chr8:73923692-73923790,chr8,73923692,73923790,1,43669349
H1|chr8:30254344-30254385,chr8,30254344,30254385,H1|chr8:73923692-73923790,chr8,73923692,73923790,1,43669348
H1|chr8:30256297-30256360,chr8,30256297,30256360,H1|chr8:35095785-35095830,chr8,35095785,35095830,1,4839488
H1|chr8:30256298-30256360,chr8,30256298,30256360,H1|chr8:35095785-35095830,chr8,35095785,35095830,1,4839487
H1|chr8:30257087-30257154,chr8,30257087,30257154,H1|chr8:119121739-119121758,chr8,119121739,119121758,1,88864652
H1|chr8:30257720-30257757,chr8,30257720,30257757,H1|chr8:91657183-91657232,chr8,91657183,91657232,1,61399463
H1|chr8:30257777-30257875,chr8,30257777,30257875,H1|chr8:91657183-91657232,chr8,91657183,91657232,1,61399406
H1|chr8:30258651-30258697,chr8,30258651,30258697,H1|chr8:56986523-56986551,chr8,56986523,56986551,1,26727872
H1|chr8:30259591-30259698,chr8,30259591,30259698,H1|chr8:42013230-42013269,chr8,42013230,42013269,1,11753639
H1|chr8:30259591-30259697,chr8,30259591,30259697,H1|chr8:42013230-42013269,chr8,42013230,42013269,1,11753639
H1|chr8:30260277-30260321,chr8,30260277,30260321,H1|chr8:28560222-28560325,chr8,28560222,28560325,1,1700055
H1|chr8:30260277-30260316,chr8,30260277,30260316,H1|chr8:28560222-28560325,chr8,28560222,28560325,1,1700055
H1|chr8:30260283-30260316,chr8,30260283,30260316,H1|chr8:28560219-28560325,chr8,28560219,28560325,1,1700064
H1|chr8:30260800-30260860,chr8,30260800,30260860,H1|chr8:73924750-73924886,chr8,73924750,73924886,1,43663950
H1|chr8:30264523-30264608,chr8,30264523,30264608,H1|chr8:27636793-27636829,chr8,27636793,27636829,1,2627730
H1|chr8:30264526-30264608,chr8,30264526,30264608,H1|chr8:27636793-27636829,chr8,27636793,27636829,1,2627733
H1|chr8:30265062-30265117,chr8,30265062,30265117,H1|chr8:35095787-35095847,chr8,35095787,35095847,1,4830725
H1|chr8:30266743-30266821,chr8,30266743,30266821,H1|chr8:28749086-28749158,chr8,28749086,28749158,1,1517657
H1|chr8:30266745-30266861,chr8,30266745,30266861,H1|chr8:28749086-28749158,chr8,28749086,28749158,1,1517659
H1|chr8:30268673-30268697,chr8,30268673,30268697,H1|chr8:91655098-91655139,chr8,91655098,91655139,1,61386425
H1|chr8:30269058-30269121,chr8,30269058,30269121,H1|chr8:11057575-11057597,chr8,11057575,11057597,1,19211483
H1|chr8:30270323-30270409,chr8,30270323,30270409,H1|chr8:28749030-28749136,chr8,28749030,28749136,1,1521293
H1|chr8:30270323-30270367,chr8,30270323,30270367,H1|chr8:28749030-28749136,chr8,28749030,28749136,1,1521293
H1|chr8:30270645-30270691,chr8,30270645,30270691,H1|chr8:145575550-145575660,chr8,145575550,145575660,1,115304905
H1|chr8:30270645-30270689,chr8,30270645,30270689,H1|chr8:145575550-145575660,chr8,145575550,145575660,1,115304905
H1|chr8:30270653-30270693,chr8,30270653,30270693,H1|chr8:145575550-145575660,chr8,145575550,145575660,1,115304897
H1|chr8:30274295-30274374,chr8,30274295,30274374,H1|chr8:27629696-27629767,chr8,27629696,27629767,1,2644599
H1|chr8:30274295-30274373,chr8,30274295,30274373,H1|chr8:27629696-27629767,chr8,27629696,27629767,1,2644599
H1|chr8:30274792-30274823,chr8,30274792,30274823,H1|chr8:11664458-11664508,chr8,11664458,11664508,1,18610334
H1|chr8:30274792-30274819,chr8,30274792,30274819,H1|chr8:11664458-11664508,chr8,11664458,11664508,1,18610334
H1|chr8:30275468-30275535,chr8,30275468,30275535,H1|chr8:11056944-11057036,chr8,11056944,11057036,1,19218524
H1|chr8:30275477-30275535,chr8,30275477,30275535,H1|chr8:11056944-11057036,chr8,11056944,11057036,1,19218533
H1|chr8:30279195-30279345,chr8,30279195,30279345,H1|chr8:124290430-124290575,chr8,124290430,124290575,1,94011235
H1|chr8:30279195-30279332,chr8,30279195,30279332,H1|chr8:124290430-124290575,chr8,124290430,124290575,1,94011235
H1|chr8:30279200-30279350,chr8,30279200,30279350,H1|chr8:124290430-124290575,chr8,124290430,124290575,1,94011230
H1|chr8:30279201-30279351,chr8,30279201,30279351,H1|chr8:124290430-124290566,chr8,124290430,124290566,1,94011229
H1|chr8:30279937-30280018,chr8,30279937,30280018,H1|chr8:124290445-124290575,chr8,124290445,124290575,1,94010508
H1|chr8:30281858-30281900,chr8,30281858,30281900,H1|chr8:42012917-42013047,chr8,42012917,42013047,1,11731059
H1|chr8:30282932-30283016,chr8,30282932,30283016,H1|chr8:73924839-73924908,chr8,73924839,73924908,1,43641907
H1|chr8:30282932-30283003,chr8,30282932,30283003,H1|chr8:73924839-73924908,chr8,73924839,73924908,1,43641907
H1|chr8:30289300-30289445,chr8,30289300,30289445,H1|chr8:35093860-35093886,chr8,35093860,35093886,1,4804560
H1|chr8:30289300-30289337,chr8,30289300,30289337,H1|chr8:35093860-35093886,chr8,35093860,35093886,1,4804560
H1|chr8:30399923-30400015,chr8,30399923,30400015,H1|chr8:82541847-82541871,chr8,82541847,82541871,1,52141924
H1|chr8:30399923-30400012,chr8,30399923,30400012,H1|chr8:82541847-82541871,chr8,82541847,82541871,1,52141924
H1|chr8:30399925-30400015,chr8,30399925,30400015,H1|chr8:82541847-82541871,chr8,82541847,82541871,1,52141922
H1|chr8:37945904-37945929,chr8,37945904,37945929,H1|chr8:42396197-42396298,chr8,42396197,42396298,1,4450293
H1|chr8:37945908-37945930,chr8,37945908,37945930,H1|chr8:42396197-42396313,chr8,42396197,42396313,1,4450289
H1|chr8:38290361-38290409,chr8,38290361,38290409,H1|chr8:91657301-91657329,chr8,91657301,91657329,1,53366940
H1|chr8:38291083-38291203,chr8,38291083,38291203,H1|chr8:37887193-37887227,chr8,37887193,37887227,1,403890
H1|chr8:38291087-38291203,chr8,38291087,38291203,H1|chr8:37887193-37887227,chr8,37887193,37887227,1,403894
H1|chr8:38291935-38292010,chr8,38291935,38292010,H1|chr8:54936424-54936473,chr8,54936424,54936473,1,16644489
H1|chr8:38292769-38292857,chr8,38292769,38292857,H1|chr8:37883551-37883606,chr8,37883551,37883606,1,409218
H1|chr8:38295285-38295322,chr8,38295285,38295322,H1|chr8:144655916-144655947,chr8,144655916,144655947,1,106360631
H1|chr8:38295287-38295358,chr8,38295287,38295358,H1|chr8:144655916-144655947,chr8,144655916,144655947,1,106360629
H1|chr8:38295787-38295861,chr8,38295787,38295861,H1|chr8:38584074-38584109,chr8,38584074,38584109,1,288287
H1|chr8:38298807-38298850,chr8,38298807,38298850,H1|chr8:54937763-54937853,chr8,54937763,54937853,1,16638956
H1|chr8:38300591-38300620,chr8,38300591,38300620,H1|chr8:30242942-30243061,chr8,30242942,30243061,1,8057649
H1|chr8:38303884-38304034,chr8,38303884,38304034,H1|chr8:91655018-91655080,chr8,91655018,91655080,1,53351134
H1|chr8:38304015-38304100,chr8,38304015,38304100,H1|chr8:91655018-91655080,chr8,91655018,91655080,1,53351003
H1|chr8:38304038-38304163,chr8,38304038,38304163,H1|chr8:38585113-38585145,chr8,38585113,38585145,1,281075
H1|chr8:38306160-38306243,chr8,38306160,38306243,H1|chr8:30246397-30246456,chr8,30246397,30246456,1,8059763
H1|chr8:38306161-38306273,chr8,38306161,38306273,H1|chr8:30246917-30246935,chr8,30246917,30246935,1,8059244
H1|chr8:38306162-38306273,chr8,38306162,38306273,H1|chr8:30246917-30246935,chr8,30246917,30246935,1,8059245
H1|chr8:40723663-40723741,chr8,40723663,40723741,H1|chr8:39760962-39761017,chr8,39760962,39761017,1,962701
H1|chr8:40723663-40723726,chr8,40723663,40723726,H1|chr8:39760962-39761017,chr8,39760962,39761017,1,962701
H1|chr8:40723664-40723741,chr8,40723664,40723741,H1|chr8:39760962-39761017,chr8,39760962,39761017,1,962702
H1|chr8:42152977-42153124,chr8,42152977,42153124,H1|chr8:42394212-42394258,chr8,42394212,42394258,1,241235
H1|chr8:42153188-42153292,chr8,42153188,42153292,H1|chr8:42394212-42394258,chr8,42394212,42394258,1,241024
H1|chr8:56757346-56757389,chr8,56757346,56757389,H1|chr8:56792192-56792309,chr8,56792192,56792309,1,34846
H1|chr8:56757346-56757379,chr8,56757346,56757379,H1|chr8:56792192-56792309,chr8,56792192,56792309,1,34846
H1|chr8:56773615-56773711,chr8,56773615,56773711,H1|chr8:56789286-56789326,chr8,56789286,56789326,1,15671
H1|chr8:56875994-56876091,chr8,56875994,56876091,H1|chr8:57126845-57126878,chr8,57126845,57126878,1,250851
H1|chr8:56882390-56882469,chr8,56882390,56882469,H1|chr8:37755540-37755566,chr8,37755540,37755566,1,19126850
H1|chr8:56882390-56882467,chr8,56882390,56882467,H1|chr8:37755540-37755566,chr8,37755540,37755566,1,19126850
H1|chr8:56882394-56882469,chr8,56882394,56882469,H1|chr8:37755540-37755566,chr8,37755540,37755566,1,19126854
H1|chr8:56891828-56891904,chr8,56891828,56891904,H1|chr8:141519002-141519076,chr8,141519002,141519076,1,84627174
H1|chr8:56891828-56891899,chr8,56891828,56891899,H1|chr8:141518959-141519079,chr8,141518959,141519079,1,84627131
H1|chr8:56892237-56892301,chr8,56892237,56892301,H1|chr8:57122476-57122560,chr8,57122476,57122560,1,230239
H1|chr8:56892239-56892301,chr8,56892239,56892301,H1|chr8:57122476-57122560,chr8,57122476,57122560,1,230237
H1|chr8:67263788-67263835,chr8,67263788,67263835,H1|chr8:101961728-101961796,chr8,101961728,101961796,1,34697940
H1|chr8:70997581-70997697,chr8,70997581,70997697,H1|chr8:70984880-70984918,chr8,70984880,70984918,1,12701
H1|chr8:70997581-70997693,chr8,70997581,70997693,H1|chr8:70984880-70984918,chr8,70984880,70984918,1,12701
H1|chr8:70999195-70999237,chr8,70999195,70999237,H1|chr8:70988579-70988647,chr8,70988579,70988647,1,10616
H1|chr8:70999201-70999237,chr8,70999201,70999237,H1|chr8:70988579-70988647,chr8,70988579,70988647,1,10622
H1|chr8:70999488-70999533,chr8,70999488,70999533,H1|chr8:70986523-70986557,chr8,70986523,70986557,1,12965
H1|chr8:71003296-71003416,chr8,71003296,71003416,H1|chr8:70987660-70987690,chr8,70987660,70987690,1,15636
H1|chr8:71003383-71003530,chr8,71003383,71003530,H1|chr8:70987660-70987690,chr8,70987660,70987690,1,15723
H1|chr8:71004416-71004526,chr8,71004416,71004526,H1|chr8:70986457-70986550,chr8,70986457,70986550,1,17959
H1|chr8:72565446-72565479,chr8,72565446,72565479,H1|chr8:73924835-73924907,chr8,73924835,73924907,1,1359389
H1|chr8:72565446-72565477,chr8,72565446,72565477,H1|chr8:73924835-73924907,chr8,73924835,73924907,1,1359389
H1|chr8:72574520-72574622,chr8,72574520,72574622,H1|chr8:73921780-73921930,chr8,73921780,73921930,1,1347260
H1|chr8:72588201-72588247,chr8,72588201,72588247,H1|chr8:119120716-119120809,chr8,119120716,119120809,1,46532515
H1|chr8:72588201-72588245,chr8,72588201,72588245,H1|chr8:119120716-119120809,chr8,119120716,119120809,1,46532515
H1|chr8:72588315-72588390,chr8,72588315,72588390,H1|chr8:73924351-73924437,chr8,73924351,73924437,1,1336036
H1|chr8:72588330-72588390,chr8,72588330,72588390,H1|chr8:73924351-73924437,chr8,73924351,73924437,1,1336021
H1|chr8:72591878-72591933,chr8,72591878,72591933,H1|chr8:54933316-54933384,chr8,54933316,54933384,1,17658562
H1|chr8:72592937-72593003,chr8,72592937,72593003,H1|chr8:54933968-54934041,chr8,54933968,54934041,1,17658969
H1|chr8:72592937-72593002,chr8,72592937,72593002,H1|chr8:54933968-54934041,chr8,54933968,54934041,1,17658969
H1|chr8:72593652-72593703,chr8,72593652,72593703,H1|chr8:30243420-30243469,chr8,30243420,30243469,1,42350232
H1|chr8:72593652-72593702,chr8,72593652,72593702,H1|chr8:30243419-30243469,chr8,30243419,30243469,1,42350233
H1|chr8:72595957-72596104,chr8,72595957,72596104,H1|chr8:35093748-35093777,chr8,35093748,35093777,1,37502209
H1|chr8:72595985-72596057,chr8,72595985,72596057,H1|chr8:30247013-30247050,chr8,30247013,30247050,1,42348972
H1|chr8:72596011-72596132,chr8,72596011,72596132,H1|chr8:35093748-35093777,chr8,35093748,35093777,1,37502263
H1|chr8:72597423-72597533,chr8,72597423,72597533,H1|chr8:38324958-38325019,chr8,38324958,38325019,1,34272465
H1|chr8:72597447-72597533,chr8,72597447,72597533,H1|chr8:38324958-38325019,chr8,38324958,38325019,1,34272489
H1|chr8:72599073-72599169,chr8,72599073,72599169,H1|chr8:38321524-38321578,chr8,38321524,38321578,1,34277549
H1|chr8:72599096-72599170,chr8,72599096,72599170,H1|chr8:38321501-38321577,chr8,38321501,38321577,1,34277595
H1|chr8:72599109-72599177,chr8,72599109,72599177,H1|chr8:54933680-54933734,chr8,54933680,54933734,1,17665429
H1|chr8:72599816-72599964,chr8,72599816,72599964,H1|chr8:37919237-37919310,chr8,37919237,37919310,1,34680579
H1|chr8:72599940-72600087,chr8,72599940,72600087,H1|chr8:30243430-30243456,chr8,30243430,30243456,1,42356510
H1|chr8:72599967-72600091,chr8,72599967,72600091,H1|chr8:30243430-30243456,chr8,30243430,30243456,1,42356537
H1|chr8:72600046-72600139,chr8,72600046,72600139,H1|chr8:63162422-63162465,chr8,63162422,63162465,1,9437624
H1|chr8:72600046-72600128,chr8,72600046,72600128,H1|chr8:63162422-63162465,chr8,63162422,63162465,1,9437624
H1|chr8:72600398-72600478,chr8,72600398,72600478,H1|chr8:56684831-56684912,chr8,56684831,56684912,1,15915567
H1|chr8:72600409-72600478,chr8,72600409,72600478,H1|chr8:56684831-56684912,chr8,56684831,56684912,1,15915578
H1|chr8:72601857-72601877,chr8,72601857,72601877,H1|chr8:30243357-30243450,chr8,30243357,30243450,1,42358500
H1|chr8:72602445-72602511,chr8,72602445,72602511,H1|chr8:73923034-73923085,chr8,73923034,73923085,1,1320589
H1|chr8:72602447-72602512,chr8,72602447,72602512,H1|chr8:73923034-73923085,chr8,73923034,73923085,1,1320587
H1|chr8:72603551-72603671,chr8,72603551,72603671,H1|chr8:30247127-30247157,chr8,30247127,30247157,1,42356424
H1|chr8:72603600-72603750,chr8,72603600,72603750,H1|chr8:30247127-30247157,chr8,30247127,30247157,1,42356473
H1|chr8:72603645-72603740,chr8,72603645,72603740,H1|chr8:119121871-119121920,chr8,119121871,119121920,1,46518226
H1|chr8:72603646-72603740,chr8,72603646,72603740,H1|chr8:119121871-119121920,chr8,119121871,119121920,1,46518225
H1|chr8:72603798-72603824,chr8,72603798,72603824,H1|chr8:30245484-30245573,chr8,30245484,30245573,1,42358314
H1|chr8:72604040-72604104,chr8,72604040,72604104,H1|chr8:73923853-73923892,chr8,73923853,73923892,1,1319813
H1|chr8:72605379-72605411,chr8,72605379,72605411,H1|chr8:37919982-37920064,chr8,37919982,37920064,1,34685397
H1|chr8:72606155-72606305,chr8,72606155,72606305,H1|chr8:35094603-35094672,chr8,35094603,35094672,1,37511552
H1|chr8:72606155-72606236,chr8,72606155,72606236,H1|chr8:35094603-35094672,chr8,35094603,35094672,1,37511552
H1|chr8:72627595-72627689,chr8,72627595,72627689,H1|chr8:73923153-73923248,chr8,73923153,73923248,1,1295558
H1|chr8:72627636-72627691,chr8,72627636,72627691,H1|chr8:73923153-73923248,chr8,73923153,73923248,1,1295517
H1|chr8:72627638-72627691,chr8,72627638,72627691,H1|chr8:73923153-73923248,chr8,73923153,73923248,1,1295515
H1|chr8:103379436-103379492,chr8,103379436,103379492,H1|chr8:101730696-101730790,chr8,101730696,101730790,1,1648740
H1|chr8:103379917-103380062,chr8,103379917,103380062,H1|chr8:103873878-103873904,chr8,103873878,103873904,1,493961
H1|chr8:103380027-103380131,chr8,103380027,103380131,H1|chr8:103873878-103873904,chr8,103873878,103873904,1,493851
H1|chr8:103383703-103383751,chr8,103383703,103383751,H1|chr8:91657243-91657393,chr8,91657243,91657393,1,11726460
H1|chr8:103384140-103384230,chr8,103384140,103384230,H1|chr8:91656977-91657023,chr8,91656977,91657023,1,11727163
H1|chr8:103384140-103384203,chr8,103384140,103384203,H1|chr8:91656977-91657023,chr8,91656977,91657023,1,11727163
H1|chr8:103387278-103387308,chr8,103387278,103387308,H1|chr8:91656888-91656963,chr8,91656888,91656963,1,11730390
H1|chr8:103387282-103387308,chr8,103387282,103387308,H1|chr8:91656888-91656963,chr8,91656888,91656963,1,11730394
H1|chr8:103392240-103392309,chr8,103392240,103392309,H1|chr8:91656502-91656546,chr8,91656502,91656546,1,11735738
H1|chr8:103392241-103392308,chr8,103392241,103392308,H1|chr8:91656502-91656546,chr8,91656502,91656546,1,11735739
H1|chr8:103393537-103393589,chr8,103393537,103393589,H1|chr8:101732631-101732654,chr8,101732631,101732654,1,1660906
H1|chr8:103398512-103398573,chr8,103398512,103398573,H1|chr8:103872551-103872657,chr8,103872551,103872657,1,474039
H1|chr8:103398512-103398556,chr8,103398512,103398556,H1|chr8:103872551-103872657,chr8,103872551,103872657,1,474039
H1|chr8:103406490-103406520,chr8,103406490,103406520,H1|chr8:103426991-103427060,chr8,103426991,103427060,1,20501
H1|chr8:103410769-103410834,chr8,103410769,103410834,H1|chr8:103427114-103427161,chr8,103427114,103427161,1,16345
H1|chr8:103418971-103419121,chr8,103418971,103419121,H1|chr8:103873965-103874002,chr8,103873965,103874002,1,454994
H1|chr8:103419017-103419130,chr8,103419017,103419130,H1|chr8:103873965-103874002,chr8,103873965,103874002,1,454948
H1|chr8:103419018-103419130,chr8,103419018,103419130,H1|chr8:103873965-103874002,chr8,103873965,103874002,1,454947
H1|chr8:116479252-116479310,chr8,116479252,116479310,H1|chr8:115295989-115296080,chr8,115295989,115296080,1,1183263
H1|chr8:116479253-116479312,chr8,116479253,116479312,H1|chr8:115295989-115296080,chr8,115295989,115296080,1,1183264
H1|chr8:118930756-118930872,chr8,118930756,118930872,H1|chr8:107283519-107283549,chr8,107283519,107283549,1,11647237
H1|chr8:118930843-118930892,chr8,118930843,118930892,H1|chr8:107283534-107283632,chr8,107283534,107283632,1,11647309
H1|chr8:126267033-126267085,chr8,126267033,126267085,H1|chr8:133788188-133788260,chr8,133788188,133788260,1,7521155
H1|chr8:126267033-126267084,chr8,126267033,126267084,H1|chr8:133788188-133788259,chr8,133788188,133788259,1,7521155
H1|chr8:128807512-128807532,chr8,128807512,128807532,H1|chr8:37960377-37960507,chr8,37960377,37960507,1,90847135
H1|chr8:128807513-128807565,chr8,128807513,128807565,H1|chr8:37960377-37960507,chr8,37960377,37960507,1,90847136
H1|chr8:128809165-128809283,chr8,128809165,128809283,H1|chr8:128749847-128749885,chr8,128749847,128749885,1,59318
H1|chr8:128809165-128809274,chr8,128809165,128809274,H1|chr8:128749847-128749885,chr8,128749847,128749885,1,59318
H1|chr8:128809540-128809616,chr8,128809540,128809616,H1|chr8:131028137-131028169,chr8,131028137,131028169,1,2218597
H1|chr8:128809540-128809614,chr8,128809540,128809614,H1|chr8:131028137-131028169,chr8,131028137,131028169,1,2218597
H1|chr8:128810554-128810611,chr8,128810554,128810611,H1|chr8:57126080-57126212,chr8,57126080,57126212,1,71684474
H1|chr8:128812811-128812829,chr8,128812811,128812829,H1|chr8:11056961-11056991,chr8,11056961,11056991,1,117755850
H1|chr8:128814701-128814751,chr8,128814701,128814751,H1|chr8:124086417-124086494,chr8,124086417,124086494,1,4728284
H1|chr8:128820790-128820836,chr8,128820790,128820836,H1|chr8:130951406-130951472,chr8,130951406,130951472,1,2130616
H1|chr8:128820900-128820950,chr8,128820900,128820950,H1|chr8:103874271-103874336,chr8,103874271,103874336,1,24946629
H1|chr8:128828304-128828379,chr8,128828304,128828379,H1|chr8:144677075-144677214,chr8,144677075,144677214,1,15848771
H1|chr8:128828304-128828378,chr8,128828304,128828378,H1|chr8:144677138-144677214,chr8,144677138,144677214,1,15848834
H1|chr8:128829845-128829887,chr8,128829845,128829887,H1|chr8:103422930-103423068,chr8,103422930,103423068,1,25406915
H1|chr8:128832838-128832927,chr8,128832838,128832927,H1|chr8:103874897-103874929,chr8,103874897,103874929,1,24957941
H1|chr8:128834673-128834699,chr8,128834673,128834699,H1|chr8:124086410-124086504,chr8,124086410,124086504,1,4748263
H1|chr8:128834673-128834698,chr8,128834673,128834698,H1|chr8:124086410-124086504,chr8,124086410,124086504,1,4748263
H1|chr8:128835815-128835908,chr8,128835815,128835908,H1|chr8:93109457-93109548,chr8,93109457,93109548,1,35726358
H1|chr8:128835850-128835909,chr8,128835850,128835909,H1|chr8:93109457-93109548,chr8,93109457,93109548,1,35726393
H1|chr8:128848079-128848162,chr8,128848079,128848162,H1|chr8:101168752-101168788,chr8,101168752,101168788,1,27679327
H1|chr8:128848080-128848162,chr8,128848080,128848162,H1|chr8:101168752-101168788,chr8,101168752,101168788,1,27679328
H1|chr8:128854108-128854233,chr8,128854108,128854233,H1|chr8:11057566-11057588,chr8,11057566,11057588,1,117796542
H1|chr8:128854110-128854233,chr8,128854110,128854233,H1|chr8:11057566-11057588,chr8,11057566,11057588,1,117796544
H1|chr8:128855088-128855138,chr8,128855088,128855138,H1|chr8:130951401-130951469,chr8,130951401,130951469,1,2096313
H1|chr8:128866909-128866957,chr8,128866909,128866957,H1|chr8:11057715-11057761,chr8,11057715,11057761,1,117809194
H1|chr8:128871946-128871992,chr8,128871946,128871992,H1|chr8:130951528-130951601,chr8,130951528,130951601,1,2079582
H1|chr8:128878422-128878522,chr8,128878422,128878522,H1|chr8:128749499-128749593,chr8,128749499,128749593,1,128923
H1|chr8:128879267-128879327,chr8,128879267,128879327,H1|chr8:103422580-103422625,chr8,103422580,103422625,1,25456687
H1|chr8:128879268-128879310,chr8,128879268,128879310,H1|chr8:103422580-103422625,chr8,103422580,103422625,1,25456688
H1|chr8:128892277-128892340,chr8,128892277,128892340,H1|chr8:98657853-98657921,chr8,98657853,98657921,1,30234424
H1|chr8:128892277-128892339,chr8,128892277,128892339,H1|chr8:98657853-98657921,chr8,98657853,98657921,1,30234424
H1|chr8:128892815-128892838,chr8,128892815,128892838,H1|chr8:110343767-110343821,chr8,110343767,110343821,1,18549048
H1|chr8:128903940-128904039,chr8,128903940,128904039,H1|chr8:93113125-93113188,chr8,93113125,93113188,1,35790815
H1|chr8:128903955-128904039,chr8,128903955,128904039,H1|chr8:93113125-93113188,chr8,93113125,93113188,1,35790830
H1|chr8:128905116-128905174,chr8,128905116,128905174,H1|chr8:128747501-128747587,chr8,128747501,128747587,1,157615
H1|chr8:128905116-128905172,chr8,128905116,128905172,H1|chr8:128747501-128747587,chr8,128747501,128747587,1,157615
H1|chr8:128905290-128905398,chr8,128905290,128905398,H1|chr8:124087012-124087042,chr8,124087012,124087042,1,4818278
H1|chr8:128905291-128905398,chr8,128905291,128905398,H1|chr8:124087012-124087042,chr8,124087012,124087042,1,4818279
H1|chr8:128905457-128905546,chr8,128905457,128905546,H1|chr8:146054256-146054279,chr8,146054256,146054279,1,17148799
H1|chr8:128905491-128905541,chr8,128905491,128905541,H1|chr8:103423132-103423199,chr8,103423132,103423199,1,25482359
H1|chr8:128905493-128905639,chr8,128905493,128905639,H1|chr8:103423132-103423199,chr8,103423132,103423199,1,25482361
H1|chr8:128906710-128906748,chr8,128906710,128906748,H1|chr8:101166583-101166661,chr8,101166583,101166661,1,27740127
H1|chr8:128906710-128906746,chr8,128906710,128906746,H1|chr8:101166583-101166661,chr8,101166583,101166661,1,27740127
H1|chr8:128914846-128914890,chr8,128914846,128914890,H1|chr8:131027766-131027855,chr8,131027766,131027855,1,2112920
H1|chr8:128915257-128915331,chr8,128915257,128915331,H1|chr8:144674345-144674390,chr8,144674345,144674390,1,15759088
H1|chr8:128924691-128924841,chr8,128924691,128924841,H1|chr8:103429182-103429262,chr8,103429182,103429262,1,25495509
H1|chr8:128924691-128924760,chr8,128924691,128924760,H1|chr8:103429182-103429262,chr8,103429182,103429262,1,25495509
H1|chr8:128929452-128929568,chr8,128929452,128929568,H1|chr8:37958929-37958957,chr8,37958929,37958957,1,90970523
H1|chr8:129051702-129051792,chr8,129051702,129051792,H1|chr8:144415475-144415535,chr8,144415475,144415535,1,15363773
H1|chr8:129051702-129051791,chr8,129051702,129051791,H1|chr8:144415475-144415535,chr8,144415475,144415535,1,15363773
H1|chr8:129077948-129078014,chr8,129077948,129078014,H1|chr8:128746649-128746773,chr8,128746649,128746773,1,331299
H1|chr8:129080488-129080509,chr8,129080488,129080509,H1|chr8:128751356-128751443,chr8,128751356,128751443,1,329132
H1|chr8:130993955-130994033,chr8,130993955,130994033,H1|chr8:145134306-145134329,chr8,145134306,145134329,1,14140351
H1|chr8:141609838-141609950,chr8,141609838,141609950,H1|chr8:141650158-141650245,chr8,141650158,141650245,1,40320
H1|chr8:141609886-141609949,chr8,141609886,141609949,H1|chr8:141650158-141650245,chr8,141650158,141650245,1,40272
H1|chr8:143442012-143442041,chr8,143442012,143442041,H1|chr8:74658137-74658218,chr8,74658137,74658218,1,68783875
H1|chr8:143442012-143442040,chr8,143442012,143442040,H1|chr8:74658137-74658218,chr8,74658137,74658218,1,68783875
H1|chr8:145986975-145987061,chr8,145986975,145987061,H1|chr8:145980268-145980334,chr8,145980268,145980334,1,6707
H1|chr8:145986975-145987059,chr8,145986975,145987059,H1|chr8:145980268-145980334,chr8,145980268,145980334,1,6707
H1|chr8:145987853-145987922,chr8,145987853,145987922,H1|chr8:145981975-145982056,chr8,145981975,145982056,1,5878
H1|chr9:536029-536080,chr9,536029,536080,H1|chr9:96113181-96113288,chr9,96113181,96113288,1,95577152
H1|chr9:536029-536071,chr9,536029,536071,H1|chr9:96113181-96113288,chr9,96113181,96113288,1,95577152
H1|chr9:536048-536091,chr9,536048,536091,H1|chr9:96113181-96113288,chr9,96113181,96113288,1,95577133
H1|chr9:3289554-3289639,chr9,3289554,3289639,H1|chr9:71737682-71737712,chr9,71737682,71737712,1,68448128
H1|chr9:3289606-3289639,chr9,3289606,3289639,H1|chr9:71737682-71737712,chr9,71737682,71737712,1,68448076
H1|chr9:6776805-6776922,chr9,6776805,6776922,H1|chr9:80646964-80646983,chr9,80646964,80646983,1,73870159
H1|chr9:6776805-6776920,chr9,6776805,6776920,H1|chr9:80646964-80646983,chr9,80646964,80646983,1,73870159
H1|chr9:6776809-6776959,chr9,6776809,6776959,H1|chr9:80646964-80646983,chr9,80646964,80646983,1,73870155
H1|chr9:16795853-16795921,chr9,16795853,16795921,H1|chr9:23821108-23821216,chr9,23821108,23821216,1,7025255
H1|chr9:16795853-16795895,chr9,16795853,16795895,H1|chr9:23821108-23821216,chr9,23821108,23821216,1,7025255
H1|chr9:16795855-16795919,chr9,16795855,16795919,H1|chr9:23821108-23821216,chr9,23821108,23821216,1,7025253
H1|chr9:35600204-35600260,chr9,35600204,35600260,H1|chr9:35601025-35601098,chr9,35601025,35601098,1,821
H1|chr9:66455488-66455604,chr9,66455488,66455604,H1|chr9:68411578-68411637,chr9,68411578,68411637,1,1956090
H1|chr9:66455782-66455798,chr9,66455782,66455798,H1|chr9:68411205-68411353,chr9,68411205,68411353,1,1955423
H1|chr9:66456229-66456378,chr9,66456229,66456378,H1|chr9:68410780-68410928,chr9,68410780,68410928,1,1954551
H1|chr9:76701737-76701769,chr9,76701737,76701769,H1|chr9:96111041-96111170,chr9,96111041,96111170,1,19409304
H1|chr9:76701768-76701910,chr9,76701768,76701910,H1|chr9:96111072-96111129,chr9,96111072,96111129,1,19409304
H1|chr9:76702235-76702385,chr9,76702235,76702385,H1|chr9:96111559-96111703,chr9,96111559,96111703,1,19409324
H1|chr9:76702326-76702387,chr9,76702326,76702387,H1|chr9:96110801-96110877,chr9,96110801,96110877,1,19408475
H1|chr9:76706120-76706270,chr9,76706120,76706270,H1|chr9:96110113-96110195,chr9,96110113,96110195,1,19403993
H1|chr9:84284131-84284167,chr9,84284131,84284167,H1|chr9:38490003-38490128,chr9,38490003,38490128,1,45794128
H1|chr9:84284132-84284168,chr9,84284132,84284168,H1|chr9:38490003-38490128,chr9,38490003,38490128,1,45794129
H1|chr9:88419919-88419941,chr9,88419919,88419941,H1|chr9:86431735-86431816,chr9,86431735,86431816,1,1988184
H1|chr9:88419919-88419939,chr9,88419919,88419939,H1|chr9:86431735-86431816,chr9,86431735,86431816,1,1988184
H1|chr9:90133088-90133174,chr9,90133088,90133174,H1|chr9:125695938-125696047,chr9,125695938,125696047,1,35562850
H1|chr9:94106542-94106656,chr9,94106542,94106656,H1|chr9:133321554-133321589,chr9,133321554,133321589,1,39215012
H1|chr9:94106543-94106663,chr9,94106543,94106663,H1|chr9:133321554-133321589,chr9,133321554,133321589,1,39215011
H1|chr9:94656403-94656439,chr9,94656403,94656439,H1|chr9:140499288-140499409,chr9,140499288,140499409,1,45842885
H1|chr9:96115716-96115739,chr9,96115716,96115739,H1|chr9:96111071-96111196,chr9,96111071,96111196,1,4645
H1|chr9:96115762-96115803,chr9,96115762,96115803,H1|chr9:96112246-96112396,chr9,96112246,96112396,1,3516
H1|chr9:96232707-96232748,chr9,96232707,96232748,H1|chr9:96111244-96111332,chr9,96111244,96111332,1,121463
H1|chr9:96232707-96232747,chr9,96232707,96232747,H1|chr9:96111244-96111332,chr9,96111244,96111332,1,121463
H1|chr9:96234645-96234665,chr9,96234645,96234665,H1|chr9:96112656-96112786,chr9,96112656,96112786,1,121989
H1|chr9:96235496-96235532,chr9,96235496,96235532,H1|chr9:96111468-96111582,chr9,96111468,96111582,1,124028
H1|chr9:99977708-99977827,chr9,99977708,99977827,H1|chr9:96113086-96113111,chr9,96113086,96113111,1,3864622
H1|chr9:99978040-99978151,chr9,99978040,99978151,H1|chr9:96110994-96111081,chr9,96110994,96111081,1,3867046
H1|chr9:99978061-99978149,chr9,99978061,99978149,H1|chr9:33523706-33523768,chr9,33523706,33523768,1,66454355
H1|chr9:99978121-99978165,chr9,99978121,99978165,H1|chr9:96110411-96110517,chr9,96110411,96110517,1,3867710
H1|chr9:99978457-99978578,chr9,99978457,99978578,H1|chr9:96111420-96111471,chr9,96111420,96111471,1,3867037
H1|chr9:99978489-99978578,chr9,99978489,99978578,H1|chr9:96111420-96111471,chr9,96111420,96111471,1,3867069
H1|chr9:99980027-99980175,chr9,99980027,99980175,H1|chr9:96112955-96113105,chr9,96112955,96113105,1,3867072
H1|chr9:99980032-99980182,chr9,99980032,99980182,H1|chr9:96112976-96113126,chr9,96112976,96113126,1,3867056
H1|chr9:99980051-99980198,chr9,99980051,99980198,H1|chr9:96112976-96113126,chr9,96112976,96113126,1,3867075
H1|chr9:99980054-99980199,chr9,99980054,99980199,H1|chr9:96112955-96113105,chr9,96112955,96113105,1,3867099
H1|chr9:99980078-99980228,chr9,99980078,99980228,H1|chr9:96112976-96113126,chr9,96112976,96113126,1,3867102
H1|chr9:99980081-99980231,chr9,99980081,99980231,H1|chr9:96112959-96113106,chr9,96112959,96113106,1,3867122
H1|chr9:99980083-99980230,chr9,99980083,99980230,H1|chr9:96112957-96113107,chr9,96112957,96113107,1,3867126
H1|chr9:99980090-99980191,chr9,99980090,99980191,H1|chr9:96112966-96113107,chr9,96112966,96113107,1,3867124
H1|chr9:99980091-99980241,chr9,99980091,99980241,H1|chr9:96112963-96113113,chr9,96112963,96113113,1,3867128
H1|chr9:99980106-99980256,chr9,99980106,99980256,H1|chr9:96112977-96113127,chr9,96112977,96113127,1,3867129
H1|chr9:99980108-99980258,chr9,99980108,99980258,H1|chr9:96112982-96113132,chr9,96112982,96113132,1,3867126
H1|chr9:99980109-99980259,chr9,99980109,99980259,H1|chr9:96112972-96113122,chr9,96112972,96113122,1,3867137
H1|chr9:99980109-99980256,chr9,99980109,99980256,H1|chr9:96112983-96113129,chr9,96112983,96113129,1,3867126
H1|chr9:99980111-99980261,chr9,99980111,99980261,H1|chr9:96112978-96113116,chr9,96112978,96113116,1,3867133
H1|chr9:99980112-99980262,chr9,99980112,99980262,H1|chr9:96112955-96113105,chr9,96112955,96113105,1,3867157
H1|chr9:99980113-99980263,chr9,99980113,99980263,H1|chr9:96112952-96113102,chr9,96112952,96113102,1,3867161
H1|chr9:99980119-99980269,chr9,99980119,99980269,H1|chr9:96113077-96113135,chr9,96113077,96113135,1,3867042
H1|chr9:99980130-99980276,chr9,99980130,99980276,H1|chr9:96112960-96113110,chr9,96112960,96113110,1,3867170
H1|chr9:99980130-99980272,chr9,99980130,99980272,H1|chr9:96112959-96113106,chr9,96112959,96113106,1,3867171
H1|chr9:99980137-99980287,chr9,99980137,99980287,H1|chr9:96112972-96113121,chr9,96112972,96113121,1,3867165
H1|chr9:99980137-99980286,chr9,99980137,99980286,H1|chr9:96113045-96113132,chr9,96113045,96113132,1,3867092
H1|chr9:99980138-99980288,chr9,99980138,99980288,H1|chr9:96112969-96113119,chr9,96112969,96113119,1,3867169
H1|chr9:99980141-99980287,chr9,99980141,99980287,H1|chr9:96113081-96113114,chr9,96113081,96113114,1,3867060
H1|chr9:99980145-99980293,chr9,99980145,99980293,H1|chr9:96112962-96113111,chr9,96112962,96113111,1,3867183
H1|chr9:99980147-99980297,chr9,99980147,99980297,H1|chr9:96112955-96113105,chr9,96112955,96113105,1,3867192
H1|chr9:99980148-99980298,chr9,99980148,99980298,H1|chr9:96112957-96113107,chr9,96112957,96113107,1,3867191
H1|chr9:99980148-99980292,chr9,99980148,99980292,H1|chr9:96112960-96113110,chr9,96112960,96113110,1,3867188
H1|chr9:99980150-99980300,chr9,99980150,99980300,H1|chr9:96112957-96113107,chr9,96112957,96113107,1,3867193
H1|chr9:99980150-99980298,chr9,99980150,99980298,H1|chr9:96112963-96113113,chr9,96112963,96113113,1,3867187
H1|chr9:99980151-99980301,chr9,99980151,99980301,H1|chr9:96112957-96113107,chr9,96112957,96113107,1,3867194
H1|chr9:99980152-99980300,chr9,99980152,99980300,H1|chr9:96113035-96113126,chr9,96113035,96113126,1,3867117
H1|chr9:99980152-99980299,chr9,99980152,99980299,H1|chr9:96112957-96113107,chr9,96112957,96113107,1,3867195
H1|chr9:99980153-99980303,chr9,99980153,99980303,H1|chr9:96112994-96113126,chr9,96112994,96113126,1,3867159
H1|chr9:99980154-99980304,chr9,99980154,99980304,H1|chr9:96112978-96113124,chr9,96112978,96113124,1,3867176
H1|chr9:99980156-99980306,chr9,99980156,99980306,H1|chr9:96112969-96113119,chr9,96112969,96113119,1,3867187
H1|chr9:99980160-99980308,chr9,99980160,99980308,H1|chr9:96112957-96113107,chr9,96112957,96113107,1,3867203
H1|chr9:99980164-99980314,chr9,99980164,99980314,H1|chr9:96112963-96113113,chr9,96112963,96113113,1,3867201
H1|chr9:99980165-99980315,chr9,99980165,99980315,H1|chr9:96112957-96113107,chr9,96112957,96113107,1,3867208
H1|chr9:99980168-99980318,chr9,99980168,99980318,H1|chr9:96112970-96113120,chr9,96112970,96113120,1,3867198
H1|chr9:99980415-99980505,chr9,99980415,99980505,H1|chr9:96113047-96113107,chr9,96113047,96113107,1,3867368
H1|chr9:99980420-99980570,chr9,99980420,99980570,H1|chr9:96112978-96113124,chr9,96112978,96113124,1,3867442
H1|chr9:99980425-99980507,chr9,99980425,99980507,H1|chr9:96112978-96113125,chr9,96112978,96113125,1,3867447
H1|chr9:99980426-99980576,chr9,99980426,99980576,H1|chr9:96112983-96113129,chr9,96112983,96113129,1,3867443
H1|chr9:99980444-99980594,chr9,99980444,99980594,H1|chr9:96112980-96113123,chr9,96112980,96113123,1,3867464
H1|chr9:99980446-99980579,chr9,99980446,99980579,H1|chr9:96112978-96113124,chr9,96112978,96113124,1,3867468
H1|chr9:99980460-99980610,chr9,99980460,99980610,H1|chr9:96112978-96113124,chr9,96112978,96113124,1,3867482
H1|chr9:99980466-99980616,chr9,99980466,99980616,H1|chr9:96112978-96113124,chr9,96112978,96113124,1,3867488
H1|chr9:99980508-99980576,chr9,99980508,99980576,H1|chr9:96111558-96111640,chr9,96111558,96111640,1,3868950
H1|chr9:99980510-99980584,chr9,99980510,99980584,H1|chr9:96112978-96113125,chr9,96112978,96113125,1,3867532
H1|chr9:99980919-99981069,chr9,99980919,99981069,H1|chr9:96112983-96113128,chr9,96112983,96113128,1,3867936
H1|chr9:99981786-99981916,chr9,99981786,99981916,H1|chr9:96113031-96113111,chr9,96113031,96113111,1,3868755
H1|chr9:99982496-99982646,chr9,99982496,99982646,H1|chr9:33525100-33525225,chr9,33525100,33525225,1,66457396
H1|chr9:99982564-99982644,chr9,99982564,99982644,H1|chr9:33525163-33525207,chr9,33525163,33525207,1,66457401
H1|chr9:99982662-99982757,chr9,99982662,99982757,H1|chr9:33525051-33525201,chr9,33525051,33525201,1,66457611
H1|chr9:99982676-99982826,chr9,99982676,99982826,H1|chr9:33525050-33525195,chr9,33525050,33525195,1,66457626
H1|chr9:99982684-99982830,chr9,99982684,99982830,H1|chr9:33525101-33525240,chr9,33525101,33525240,1,66457583
H1|chr9:99982695-99982834,chr9,99982695,99982834,H1|chr9:33525084-33525234,chr9,33525084,33525234,1,66457611
H1|chr9:99982695-99982810,chr9,99982695,99982810,H1|chr9:33525141-33525264,chr9,33525141,33525264,1,66457554
H1|chr9:99982739-99982830,chr9,99982739,99982830,H1|chr9:33525060-33525210,chr9,33525060,33525210,1,66457679
H1|chr9:99982750-99982830,chr9,99982750,99982830,H1|chr9:33525101-33525240,chr9,33525101,33525240,1,66457649
H1|chr9:99982754-99982830,chr9,99982754,99982830,H1|chr9:33525068-33525218,chr9,33525068,33525218,1,66457686
H1|chr9:99982860-99983010,chr9,99982860,99983010,H1|chr9:33525037-33525187,chr9,33525037,33525187,1,66457823
H1|chr9:99982880-99983026,chr9,99982880,99983026,H1|chr9:33525073-33525223,chr9,33525073,33525223,1,66457807
H1|chr9:99982882-99983032,chr9,99982882,99983032,H1|chr9:33524880-33525029,chr9,33524880,33525029,1,66458002
H1|chr9:99982897-99983042,chr9,99982897,99983042,H1|chr9:33524858-33525006,chr9,33524858,33525006,1,66458039
H1|chr9:99982898-99983048,chr9,99982898,99983048,H1|chr9:33525075-33525225,chr9,33525075,33525225,1,66457823
H1|chr9:99982904-99983054,chr9,99982904,99983054,H1|chr9:33524866-33525016,chr9,33524866,33525016,1,66458038
H1|chr9:99982914-99983064,chr9,99982914,99983064,H1|chr9:33524880-33525028,chr9,33524880,33525028,1,66458034
H1|chr9:99982916-99983066,chr9,99982916,99983066,H1|chr9:33524892-33525041,chr9,33524892,33525041,1,66458024
H1|chr9:99982918-99983068,chr9,99982918,99983068,H1|chr9:33524847-33524997,chr9,33524847,33524997,1,66458071
H1|chr9:99982920-99983067,chr9,99982920,99983067,H1|chr9:33524900-33525050,chr9,33524900,33525050,1,66458020
H1|chr9:99982920-99983066,chr9,99982920,99983066,H1|chr9:33524900-33525040,chr9,33524900,33525040,1,66458020
H1|chr9:99982923-99983073,chr9,99982923,99983073,H1|chr9:33525101-33525240,chr9,33525101,33525240,1,66457822
H1|chr9:99982934-99983084,chr9,99982934,99983084,H1|chr9:33524900-33525050,chr9,33524900,33525050,1,66458034
H1|chr9:99982936-99983086,chr9,99982936,99983086,H1|chr9:33524858-33525006,chr9,33524858,33525006,1,66458078
H1|chr9:99982939-99983049,chr9,99982939,99983049,H1|chr9:33524881-33524967,chr9,33524881,33524967,1,66458058
H1|chr9:99982943-99983092,chr9,99982943,99983092,H1|chr9:33524858-33525006,chr9,33524858,33525006,1,66458085
H1|chr9:99982946-99983096,chr9,99982946,99983096,H1|chr9:33524858-33525006,chr9,33524858,33525006,1,66458088
H1|chr9:99982947-99983097,chr9,99982947,99983097,H1|chr9:33524900-33525047,chr9,33524900,33525047,1,66458047
H1|chr9:99982948-99983097,chr9,99982948,99983097,H1|chr9:33524885-33525031,chr9,33524885,33525031,1,66458063
H1|chr9:99982949-99983099,chr9,99982949,99983099,H1|chr9:33524880-33525029,chr9,33524880,33525029,1,66458069
H1|chr9:99982949-99983071,chr9,99982949,99983071,H1|chr9:33524892-33524935,chr9,33524892,33524935,1,66458057
H1|chr9:99982949-99983037,chr9,99982949,99983037,H1|chr9:33525116-33525148,chr9,33525116,33525148,1,66457833
H1|chr9:99982950-99983099,chr9,99982950,99983099,H1|chr9:33524868-33525018,chr9,33524868,33525018,1,66458082
H1|chr9:99982951-99983086,chr9,99982951,99983086,H1|chr9:33524874-33525018,chr9,33524874,33525018,1,66458077
H1|chr9:99982952-99983102,chr9,99982952,99983102,H1|chr9:33524880-33525028,chr9,33524880,33525028,1,66458072
H1|chr9:99982954-99983101,chr9,99982954,99983101,H1|chr9:33524900-33525050,chr9,33524900,33525050,1,66458054
H1|chr9:99982955-99983101,chr9,99982955,99983101,H1|chr9:33524900-33525050,chr9,33524900,33525050,1,66458055
H1|chr9:99983101-99983239,chr9,99983101,99983239,H1|chr9:33524839-33524989,chr9,33524839,33524989,1,66458262
H1|chr9:99983101-99983236,chr9,99983101,99983236,H1|chr9:33524842-33524992,chr9,33524842,33524992,1,66458259
H1|chr9:99983175-99983203,chr9,99983175,99983203,H1|chr9:33524833-33524979,chr9,33524833,33524979,1,66458342
H1|chr9:99983361-99983404,chr9,99983361,99983404,H1|chr9:33524848-33524997,chr9,33524848,33524997,1,66458513
H1|chr9:99983699-99983746,chr9,99983699,99983746,H1|chr9:33524216-33524294,chr9,33524216,33524294,1,66459483
H1|chr9:99983710-99983771,chr9,99983710,99983771,H1|chr9:33524311-33524341,chr9,33524311,33524341,1,66459399
H1|chr9:99983931-99984079,chr9,99983931,99984079,H1|chr9:33523892-33523943,chr9,33523892,33523943,1,66460039
H1|chr9:99984008-99984083,chr9,99984008,99984083,H1|chr9:33523711-33523760,chr9,33523711,33523760,1,66460297
H1|chr9:99984142-99984224,chr9,99984142,99984224,H1|chr9:33523718-33523766,chr9,33523718,33523766,1,66460424
H1|chr9:99984143-99984194,chr9,99984143,99984194,H1|chr9:33523719-33523815,chr9,33523719,33523815,1,66460424
H1|chr9:99984239-99984301,chr9,99984239,99984301,H1|chr9:33523696-33523742,chr9,33523696,33523742,1,66460543
H1|chr9:99984712-99984809,chr9,99984712,99984809,H1|chr9:33523730-33523759,chr9,33523730,33523759,1,66460982
H1|chr9:109633669-109633797,chr9,109633669,109633797,H1|chr9:109625043-109625076,chr9,109625043,109625076,1,8626
H1|chr9:109633669-109633786,chr9,109633669,109633786,H1|chr9:109625043-109625076,chr9,109625043,109625076,1,8626
H1|chr9:109634404-109634461,chr9,109634404,109634461,H1|chr9:109622214-109622307,chr9,109622214,109622307,1,12190
H1|chr9:109634406-109634460,chr9,109634406,109634460,H1|chr9:109622214-109622307,chr9,109622214,109622307,1,12192
H1|chr9:109638775-109638798,chr9,109638775,109638798,H1|chr9:72374041-72374191,chr9,72374041,72374191,1,37264734
H1|chr9:109639854-109639917,chr9,109639854,109639917,H1|chr9:119450336-119450426,chr9,119450336,119450426,1,9810482
H1|chr9:109641090-109641119,chr9,109641090,109641119,H1|chr9:109624679-109624799,chr9,109624679,109624799,1,16411
H1|chr9:109642881-109642915,chr9,109642881,109642915,H1|chr9:109625172-109625273,chr9,109625172,109625273,1,17709
H1|chr9:109646450-109646491,chr9,109646450,109646491,H1|chr9:109623909-109623975,chr9,109623909,109623975,1,22541
H1|chr9:109646450-109646490,chr9,109646450,109646490,H1|chr9:109623909-109623975,chr9,109623909,109623975,1,22541
H1|chr9:109674369-109674412,chr9,109674369,109674412,H1|chr9:109623444-109623526,chr9,109623444,109623526,1,50925
H1|chr9:109675379-109675423,chr9,109675379,109675423,H1|chr9:109625033-109625074,chr9,109625033,109625074,1,50346
H1|chr9:116870799-116870883,chr9,116870799,116870883,H1|chr9:116860722-116860839,chr9,116860722,116860839,1,10077
H1|chr9:122042514-122042629,chr9,122042514,122042629,H1|chr9:101558007-101558042,chr9,101558007,101558042,1,20484507
H1|chr9:122042514-122042591,chr9,122042514,122042591,H1|chr9:101558007-101558041,chr9,101558007,101558041,1,20484507
H1|chr9:122042534-122042670,chr9,122042534,122042670,H1|chr9:101558007-101558038,chr9,101558007,101558038,1,20484527
H1|chr9:124476055-124476145,chr9,124476055,124476145,H1|chr9:33023952-33024060,chr9,33023952,33024060,1,91452103
H1|chr9:126156249-126156317,chr9,126156249,126156317,H1|chr9:123341542-123341622,chr9,123341542,123341622,1,2814707
H1|chr9:126156249-126156276,chr9,126156249,126156276,H1|chr9:123341523-123341622,chr9,123341523,123341622,1,2814726
H1|chr9:127455794-127455823,chr9,127455794,127455823,H1|chr9:108004339-108004440,chr9,108004339,108004440,1,19451455
H1|chr9:127455795-127455823,chr9,127455795,127455823,H1|chr9:108004339-108004440,chr9,108004339,108004440,1,19451456
H1|chr9:128648512-128648573,chr9,128648512,128648573,H1|chr9:135819333-135819371,chr9,135819333,135819371,1,7170821
H1|chr9:128648514-128648573,chr9,128648514,128648573,H1|chr9:135819333-135819371,chr9,135819333,135819371,1,7170819
H1|chr9:129416153-129416232,chr9,129416153,129416232,H1|chr9:84301095-84301142,chr9,84301095,84301142,1,45115058
H1|chr9:129832727-129832852,chr9,129832727,129832852,H1|chr9:131592575-131592604,chr9,131592575,131592604,1,1759848
H1|chr9:129832727-129832849,chr9,129832727,129832849,H1|chr9:131592575-131592604,chr9,131592575,131592604,1,1759848
H1|chr9:129832728-129832849,chr9,129832728,129832849,H1|chr9:131592575-131592604,chr9,131592575,131592604,1,1759847
H1|chr9:130719197-130719255,chr9,130719197,130719255,H1|chr9:130690831-130690865,chr9,130690831,130690865,1,28366
H1|chr9:130719385-130719445,chr9,130719385,130719445,H1|chr9:130690833-130690866,chr9,130690833,130690866,1,28552
H1|chr9:130725030-130725139,chr9,130725030,130725139,H1|chr9:130701982-130702005,chr9,130701982,130702005,1,23048
H1|chr9:130725030-130725138,chr9,130725030,130725138,H1|chr9:130701982-130702005,chr9,130701982,130702005,1,23048
H1|chr9:130728651-130728731,chr9,130728651,130728731,H1|chr9:130701775-130701840,chr9,130701775,130701840,1,26876
H1|chr9:130772539-130772591,chr9,130772539,130772591,H1|chr9:130743759-130743822,chr9,130743759,130743822,1,28780
H1|chr9:131009324-131009474,chr9,131009324,131009474,H1|chr9:131444676-131444739,chr9,131444676,131444739,1,435352
H1|chr9:131009435-131009522,chr9,131009435,131009522,H1|chr9:131444676-131444739,chr9,131444676,131444739,1,435241
H1|chr9:131013384-131013423,chr9,131013384,131013423,H1|chr9:131446534-131446622,chr9,131446534,131446622,1,433150
H1|chr9:132945709-132945749,chr9,132945709,132945749,H1|chr9:132804558-132804662,chr9,132804558,132804662,1,141151
H1|chr9:132945710-132945749,chr9,132945710,132945749,H1|chr9:132804558-132804662,chr9,132804558,132804662,1,141152
H1|chr9:133332958-133333048,chr9,133332958,133333048,H1|chr9:33679705-33679855,chr9,33679705,33679855,1,99653253
H1|chr9:133643245-133643303,chr9,133643245,133643303,H1|chr9:117377668-117377763,chr9,117377668,117377763,1,16265577
H1|chr9:133643252-133643303,chr9,133643252,133643303,H1|chr9:117377668-117377763,chr9,117377668,117377763,1,16265584
H1|chr9:133644099-133644187,chr9,133644099,133644187,H1|chr9:134268064-134268126,chr9,134268064,134268126,1,623965
H1|chr9:134249089-134249239,chr9,134249089,134249239,H1|chr9:134271985-134272122,chr9,134271985,134272122,1,22896
H1|chr9:134249089-134249237,chr9,134249089,134249237,H1|chr9:134271985-134272122,chr9,134271985,134272122,1,22896
H1|chr9:134251688-134251735,chr9,134251688,134251735,H1|chr9:134265896-134265964,chr9,134265896,134265964,1,14208
H1|chr9:134254782-134254875,chr9,134254782,134254875,H1|chr9:134272126-134272276,chr9,134272126,134272276,1,17344
H1|chr9:134281360-134281443,chr9,134281360,134281443,H1|chr9:134375590-134375611,chr9,134375590,134375611,1,94230
H1|chr9:134282610-134282634,chr9,134282610,134282634,H1|chr9:134269236-134269287,chr9,134269236,134269287,1,13374
H1|chr9:134284455-134284571,chr9,134284455,134284571,H1|chr9:133972844-133972878,chr9,133972844,133972878,1,311611
H1|chr9:134287880-134287910,chr9,134287880,134287910,H1|chr9:134376092-134376204,chr9,134376092,134376204,1,88212
H1|chr9:134287881-134287910,chr9,134287881,134287910,H1|chr9:134376092-134376204,chr9,134376092,134376204,1,88211
H1|chr9:134289605-134289654,chr9,134289605,134289654,H1|chr9:96929927-96930020,chr9,96929927,96930020,1,37359678
H1|chr9:134293350-134293393,chr9,134293350,134293393,H1|chr9:96930730-96930808,chr9,96930730,96930808,1,37362620
H1|chr9:134294818-134294862,chr9,134294818,134294862,H1|chr9:134268118-134268265,chr9,134268118,134268265,1,26700
H1|chr9:134295328-134295385,chr9,134295328,134295385,H1|chr9:134269153-134269212,chr9,134269153,134269212,1,26175
H1|chr9:134578566-134578690,chr9,134578566,134578690,H1|chr9:134267275-134267425,chr9,134267275,134267425,1,311291
H1|chr9:134579436-134579556,chr9,134579436,134579556,H1|chr9:134271008-134271038,chr9,134271008,134271038,1,308428
H1|chr9:134579438-134579562,chr9,134579438,134579562,H1|chr9:134271008-134271038,chr9,134271008,134271038,1,308430
H1|chr9:134885611-134885760,chr9,134885611,134885760,H1|chr9:133320688-133320769,chr9,133320688,133320769,1,1564923
H1|chr9:134885612-134885760,chr9,134885612,134885760,H1|chr9:133320688-133320814,chr9,133320688,133320814,1,1564924
H1|chr9:135463865-135463984,chr9,135463865,135463984,H1|chr9:135456147-135456214,chr9,135456147,135456214,1,7718
H1|chr9:135463906-135463989,chr9,135463906,135463989,H1|chr9:135456147-135456214,chr9,135456147,135456214,1,7759
H1|chr9:135465665-135465730,chr9,135465665,135465730,H1|chr9:135460201-135460265,chr9,135460201,135460265,1,5464
H1|chr9:136012380-136012473,chr9,136012380,136012473,H1|chr9:136282302-136282357,chr9,136282302,136282357,1,269922
H1|chr9:136829296-136829392,chr9,136829296,136829392,H1|chr9:137003794-137003812,chr9,137003794,137003812,1,174498
H1|chr9:138895523-138895593,chr9,138895523,138895593,H1|chr9:32572578-32572676,chr9,32572578,32572676,1,106322945
H1|chr9:139422698-139422766,chr9,139422698,139422766,H1|chr9:139440857-139440921,chr9,139440857,139440921,1,18159
H1|chr9:139422716-139422767,chr9,139422716,139422767,H1|chr9:139440857-139440921,chr9,139440857,139440921,1,18141
H1|chr9:139424408-139424509,chr9,139424408,139424509,H1|chr9:139440383-139440461,chr9,139440383,139440461,1,15975
H1|chr9:139424437-139424509,chr9,139424437,139424509,H1|chr9:139440383-139440461,chr9,139440383,139440461,1,15946
H1|chr9:139424875-139424996,chr9,139424875,139424996,H1|chr9:139441663-139441692,chr9,139441663,139441692,1,16788
H1|chr9:139424876-139425003,chr9,139424876,139425003,H1|chr9:139441663-139441692,chr9,139441663,139441692,1,16787
H1|chr9:140554934-140554995,chr9,140554934,140554995,H1|chr9:140179865-140179954,chr9,140179865,140179954,1,375069
H1|chr9:140560695-140560766,chr9,140560695,140560766,H1|chr9:140178886-140178965,chr9,140178886,140178965,1,381809
H1|chr9:140560702-140560767,chr9,140560702,140560767,H1|chr9:140178887-140178972,chr9,140178887,140178972,1,381815
H1|chr9:140562527-140562564,chr9,140562527,140562564,H1|chr9:140489768-140489841,chr9,140489768,140489841,1,72759
H1|chr9:140579602-140579669,chr9,140579602,140579669,H1|chr9:140489446-140489509,chr9,140489446,140489509,1,90156
H1|chr10:12675771-12675813,chr10,12675771,12675813,H1|chr10:13388774-13388794,chr10,13388774,13388794,1,713003
H1|chr10:21798797-21798892,chr10,21798797,21798892,H1|chr10:977582-977629,chr10,977582,977629,1,20821215
H1|chr10:21798799-21798892,chr10,21798799,21798892,H1|chr10:977582-977629,chr10,977582,977629,1,20821217
H1|chr10:21798833-21798892,chr10,21798833,21798892,H1|chr10:977582-977629,chr10,977582,977629,1,20821251
H1|chr10:22955559-22955589,chr10,22955559,22955589,H1|chr10:23384884-23384986,chr10,23384884,23384986,1,429325
H1|chr10:22955561-22955589,chr10,22955561,22955589,H1|chr10:23384884-23384986,chr10,23384884,23384986,1,429323
H1|chr10:32606588-32606651,chr10,32606588,32606651,H1|chr10:33240531-33240559,chr10,33240531,33240559,1,633943
H1|chr10:32610553-32610571,chr10,32610553,32610571,H1|chr10:33240530-33240559,chr10,33240530,33240559,1,629977
H1|chr10:32613973-32614064,chr10,32613973,32614064,H1|chr10:33240091-33240117,chr10,33240091,33240117,1,626118
H1|chr10:32613975-32614064,chr10,32613975,32614064,H1|chr10:33240091-33240117,chr10,33240091,33240117,1,626116
H1|chr10:34938996-34939083,chr10,34938996,34939083,H1|chr10:126843105-126843141,chr10,126843105,126843141,1,91904109
H1|chr10:34942012-34942124,chr10,34942012,34942124,H1|chr10:126843958-126843990,chr10,126843958,126843990,1,91901946
H1|chr10:52969085-52969193,chr10,52969085,52969193,H1|chr10:69834509-69834551,chr10,69834509,69834551,1,16865424
H1|chr10:52969085-52969184,chr10,52969085,52969184,H1|chr10:69834509-69834551,chr10,69834509,69834551,1,16865424
H1|chr10:52969088-52969181,chr10,52969088,52969181,H1|chr10:69834506-69834537,chr10,69834506,69834537,1,16865418
H1|chr10:52969182-52969208,chr10,52969182,52969208,H1|chr10:69834509-69834551,chr10,69834509,69834551,1,16865327
H1|chr10:52975505-52975545,chr10,52975505,52975545,H1|chr10:126844113-126844182,chr10,126844113,126844182,1,73868608
H1|chr10:52977451-52977492,chr10,52977451,52977492,H1|chr10:126844113-126844182,chr10,126844113,126844182,1,73866662
H1|chr10:52983722-52983778,chr10,52983722,52983778,H1|chr10:126843807-126843841,chr10,126843807,126843841,1,73860085
H1|chr10:52983722-52983777,chr10,52983722,52983777,H1|chr10:126843807-126843841,chr10,126843807,126843841,1,73860085
H1|chr10:53795186-53795298,chr10,53795186,53795298,H1|chr10:123355037-123355117,chr10,123355037,123355117,1,69559851
H1|chr10:53795186-53795297,chr10,53795186,53795297,H1|chr10:123355037-123355117,chr10,123355037,123355117,1,69559851
H1|chr10:53795186-53795256,chr10,53795186,53795256,H1|chr10:123355037-123355117,chr10,123355037,123355117,1,69559851
H1|chr10:65189267-65189317,chr10,65189267,65189317,H1|chr10:65280014-65280045,chr10,65280014,65280045,1,90747
H1|chr10:65189789-65189871,chr10,65189789,65189871,H1|chr10:133999301-133999321,chr10,133999301,133999321,1,68809512
H1|chr10:65191311-65191454,chr10,65191311,65191454,H1|chr10:65280834-65280897,chr10,65280834,65280897,1,89523
H1|chr10:65191311-65191394,chr10,65191311,65191394,H1|chr10:65280834-65280897,chr10,65280834,65280897,1,89523
H1|chr10:65264150-65264175,chr10,65264150,65264175,H1|chr10:65279077-65279171,chr10,65279077,65279171,1,14927
H1|chr10:65264228-65264312,chr10,65264228,65264312,H1|chr10:65279527-65279568,chr10,65279527,65279568,1,15299
H1|chr10:65264261-65264295,chr10,65264261,65264295,H1|chr10:65278328-65278357,chr10,65278328,65278357,1,14067
H1|chr10:65264300-65264329,chr10,65264300,65264329,H1|chr10:65278451-65278547,chr10,65278451,65278547,1,14151
H1|chr10:65264309-65264329,chr10,65264309,65264329,H1|chr10:65278451-65278547,chr10,65278451,65278547,1,14142
H1|chr10:65264340-65264387,chr10,65264340,65264387,H1|chr10:65280372-65280469,chr10,65280372,65280469,1,16032
H1|chr10:65264343-65264397,chr10,65264343,65264397,H1|chr10:65280372-65280469,chr10,65280372,65280469,1,16029
H1|chr10:65267232-65267281,chr10,65267232,65267281,H1|chr10:65277791-65277853,chr10,65277791,65277853,1,10559
H1|chr10:65267503-65267544,chr10,65267503,65267544,H1|chr10:65278708-65278761,chr10,65278708,65278761,1,11205
H1|chr10:65267657-65267724,chr10,65267657,65267724,H1|chr10:65278209-65278282,chr10,65278209,65278282,1,10552
H1|chr10:65268567-65268640,chr10,65268567,65268640,H1|chr10:65279074-65279169,chr10,65279074,65279169,1,10507
H1|chr10:65268585-65268640,chr10,65268585,65268640,H1|chr10:65279074-65279169,chr10,65279074,65279169,1,10489
H1|chr10:65269125-65269164,chr10,65269125,65269164,H1|chr10:65226445-65226504,chr10,65226445,65226504,1,42680
H1|chr10:65269358-65269412,chr10,65269358,65269412,H1|chr10:65279372-65279512,chr10,65279372,65279512,1,10014
H1|chr10:65269944-65270035,chr10,65269944,65270035,H1|chr10:65280475-65280534,chr10,65280475,65280534,1,10531
H1|chr10:65269952-65270102,chr10,65269952,65270102,H1|chr10:65280475-65280534,chr10,65280475,65280534,1,10523
H1|chr10:65270842-65270899,chr10,65270842,65270899,H1|chr10:65278995-65279058,chr10,65278995,65279058,1,8153
H1|chr10:65272014-65272049,chr10,65272014,65272049,H1|chr10:65277281-65277413,chr10,65277281,65277413,1,5267
H1|chr10:65272324-65272375,chr10,65272324,65272375,H1|chr10:65276469-65276568,chr10,65276469,65276568,1,4145
H1|chr10:65272825-65272914,chr10,65272825,65272914,H1|chr10:65278202-65278263,chr10,65278202,65278263,1,5377
H1|chr10:65273653-65273735,chr10,65273653,65273735,H1|chr10:65224691-65224770,chr10,65224691,65224770,1,48962
H1|chr10:65273665-65273736,chr10,65273665,65273736,H1|chr10:65224691-65224770,chr10,65224691,65224770,1,48974
H1|chr10:65273871-65273914,chr10,65273871,65273914,H1|chr10:69647434-69647548,chr10,69647434,69647548,1,4373563
H1|chr10:65273878-65273914,chr10,65273878,65273914,H1|chr10:69647434-69647548,chr10,69647434,69647548,1,4373556
H1|chr10:65274005-65274054,chr10,65274005,65274054,H1|chr10:69647516-69647606,chr10,69647516,69647606,1,4373511
H1|chr10:65274006-65274079,chr10,65274006,65274079,H1|chr10:69647516-69647606,chr10,69647516,69647606,1,4373510
H1|chr10:65275061-65275085,chr10,65275061,65275085,H1|chr10:65276392-65276503,chr10,65276392,65276503,1,1331
H1|chr10:72095180-72095265,chr10,72095180,72095265,H1|chr10:75633860-75633915,chr10,75633860,75633915,1,3538680
H1|chr10:74507882-74507946,chr10,74507882,74507946,H1|chr10:18689453-18689489,chr10,18689453,18689489,1,55818429
H1|chr10:79324729-79324765,chr10,79324729,79324765,H1|chr10:103893300-103893347,chr10,103893300,103893347,1,24568571
H1|chr10:79413112-79413163,chr10,79413112,79413163,H1|chr10:79398643-79398762,chr10,79398643,79398762,1,14469
H1|chr10:79413112-79413143,chr10,79413112,79413143,H1|chr10:79398643-79398762,chr10,79398643,79398762,1,14469
H1|chr10:79416427-79416455,chr10,79416427,79416455,H1|chr10:79401100-79401138,chr10,79401100,79401138,1,15327
H1|chr10:79420870-79420976,chr10,79420870,79420976,H1|chr10:79399951-79400101,chr10,79399951,79400101,1,20919
H1|chr10:79804906-79804983,chr10,79804906,79804983,H1|chr10:99207455-99207602,chr10,99207455,99207602,1,19402549
H1|chr10:80870808-80870890,chr10,80870808,80870890,H1|chr10:83636494-83636573,chr10,83636494,83636573,1,2765686
H1|chr10:80870822-80870891,chr10,80870822,80870891,H1|chr10:83636494-83636573,chr10,83636494,83636573,1,2765672
H1|chr10:80884082-80884126,chr10,80884082,80884126,H1|chr10:82217143-82217267,chr10,82217143,82217267,1,1333061
H1|chr10:80884082-80884108,chr10,80884082,80884108,H1|chr10:82217143-82217267,chr10,82217143,82217267,1,1333061
H1|chr10:80908684-80908813,chr10,80908684,80908813,H1|chr10:44881310-44881331,chr10,44881310,44881331,1,36027374
H1|chr10:80908684-80908812,chr10,80908684,80908812,H1|chr10:44881310-44881331,chr10,44881310,44881331,1,36027374
H1|chr10:80913630-80913738,chr10,80913630,80913738,H1|chr10:83636057-83636104,chr10,83636057,83636104,1,2722427
H1|chr10:80913630-80913733,chr10,80913630,80913733,H1|chr10:83636057-83636104,chr10,83636057,83636104,1,2722427
H1|chr10:80938038-80938099,chr10,80938038,80938099,H1|chr10:82212257-82212312,chr10,82212257,82212312,1,1274219
H1|chr10:88548711-88548733,chr10,88548711,88548733,H1|chr10:69649858-69649949,chr10,69649858,69649949,1,18898853
H1|chr10:88548713-88548733,chr10,88548713,88548733,H1|chr10:69649858-69649949,chr10,69649858,69649949,1,18898855
H1|chr10:88549341-88549382,chr10,88549341,88549382,H1|chr10:69647450-69647583,chr10,69647450,69647583,1,18901891
H1|chr10:88551888-88551967,chr10,88551888,88551967,H1|chr10:13384491-13384562,chr10,13384491,13384562,1,75167397
H1|chr10:88552263-88552362,chr10,88552263,88552362,H1|chr10:13384491-13384562,chr10,13384491,13384562,1,75167772
H1|chr10:99278171-99278248,chr10,99278171,99278248,H1|chr10:99472747-99472820,chr10,99472747,99472820,1,194576
H1|chr10:99305454-99305476,chr10,99305454,99305476,H1|chr10:99472996-99473050,chr10,99472996,99473050,1,167542
H1|chr10:99312218-99312268,chr10,99312218,99312268,H1|chr10:99470513-99470663,chr10,99470513,99470663,1,158295
H1|chr10:114436500-114436542,chr10,114436500,114436542,H1|chr10:114709033-114709104,chr10,114709033,114709104,1,272533
H1|chr10:114436500-114436541,chr10,114436500,114436541,H1|chr10:114709033-114709104,chr10,114709033,114709104,1,272533
H1|chr10:114446750-114446779,chr10,114446750,114446779,H1|chr10:114707065-114707198,chr10,114707065,114707198,1,260315
H1|chr10:114592745-114592805,chr10,114592745,114592805,H1|chr10:114645673-114645763,chr10,114645673,114645763,1,52928
H1|chr10:114596488-114596530,chr10,114596488,114596530,H1|chr10:114644992-114645064,chr10,114644992,114645064,1,48504
H1|chr10:114693296-114693382,chr10,114693296,114693382,H1|chr10:114706843-114706883,chr10,114706843,114706883,1,13547
H1|chr10:114698323-114698357,chr10,114698323,114698357,H1|chr10:114708956-114709058,chr10,114708956,114709058,1,10633
H1|chr10:114718089-114718112,chr10,114718089,114718112,H1|chr10:43930869-43930948,chr10,43930869,43930948,1,70787220
H1|chr10:114804628-114804663,chr10,114804628,114804663,H1|chr10:114707758-114707879,chr10,114707758,114707879,1,96870
H1|chr10:114804628-114804649,chr10,114804628,114804649,H1|chr10:114707758-114707879,chr10,114707758,114707879,1,96870
H1|chr10:114810343-114810396,chr10,114810343,114810396,H1|chr10:116526123-116526197,chr10,116526123,116526197,1,1715780
H1|chr10:114811048-114811171,chr10,114811048,114811171,H1|chr10:71208172-71208189,chr10,71208172,71208189,1,43602876
H1|chr10:114812280-114812351,chr10,114812280,114812351,H1|chr10:114709370-114709394,chr10,114709370,114709394,1,102910
H1|chr10:114812281-114812351,chr10,114812281,114812351,H1|chr10:114709370-114709394,chr10,114709370,114709394,1,102911
H1|chr10:114813503-114813525,chr10,114813503,114813525,H1|chr10:27445396-27445530,chr10,27445396,27445530,1,87368107
H1|chr10:114813598-114813706,chr10,114813598,114813706,H1|chr10:126842753-126842821,chr10,126842753,126842821,1,12029155
H1|chr10:114813598-114813676,chr10,114813598,114813676,H1|chr10:126842753-126842821,chr10,126842753,126842821,1,12029155
H1|chr10:114818256-114818282,chr10,114818256,114818282,H1|chr10:126844645-126844701,chr10,126844645,126844701,1,12026389
H1|chr10:114821052-114821153,chr10,114821052,114821153,H1|chr10:126846175-126846213,chr10,126846175,126846213,1,12025123
H1|chr10:114821057-114821205,chr10,114821057,114821205,H1|chr10:126846175-126846213,chr10,126846175,126846213,1,12025118
H1|chr10:114823820-114823865,chr10,114823820,114823865,H1|chr10:88517194-88517290,chr10,88517194,88517290,1,26306626
H1|chr10:114829713-114829752,chr10,114829713,114829752,H1|chr10:116525966-116526003,chr10,116525966,116526003,1,1696253
H1|chr10:114829745-114829855,chr10,114829745,114829855,H1|chr10:116525966-116526003,chr10,116525966,116526003,1,1696221
H1|chr10:114835963-114836030,chr10,114835963,114836030,H1|chr10:32216219-32216253,chr10,32216219,32216253,1,82619744
H1|chr10:114836836-114836906,chr10,114836836,114836906,H1|chr10:126843870-126843912,chr10,126843870,126843912,1,12007034
H1|chr10:114836837-114836906,chr10,114836837,114836906,H1|chr10:126843870-126843912,chr10,126843870,126843912,1,12007033
H1|chr10:114839825-114839915,chr10,114839825,114839915,H1|chr10:116521429-116521494,chr10,116521429,116521494,1,1681604
H1|chr10:114839831-114839916,chr10,114839831,114839916,H1|chr10:116521429-116521494,chr10,116521429,116521494,1,1681598
H1|chr10:114842839-114842934,chr10,114842839,114842934,H1|chr10:128590319-128590341,chr10,128590319,128590341,1,13747480
H1|chr10:114842839-114842932,chr10,114842839,114842932,H1|chr10:128590319-128590341,chr10,128590319,128590341,1,13747480
H1|chr10:114845405-114845492,chr10,114845405,114845492,H1|chr10:126845206-126845266,chr10,126845206,126845266,1,11999801
H1|chr10:114845407-114845529,chr10,114845407,114845529,H1|chr10:126845206-126845266,chr10,126845206,126845266,1,11999799
H1|chr10:114845685-114845725,chr10,114845685,114845725,H1|chr10:111768694-111768798,chr10,111768694,111768798,1,3076991
H1|chr10:114850587-114850665,chr10,114850587,114850665,H1|chr10:88519034-88519075,chr10,88519034,88519075,1,26331553
H1|chr10:114850929-114850966,chr10,114850929,114850966,H1|chr10:88518244-88518275,chr10,88518244,88518275,1,26332685
H1|chr10:114851367-114851465,chr10,114851367,114851465,H1|chr10:75763559-75763597,chr10,75763559,75763597,1,39087808
H1|chr10:114851368-114851465,chr10,114851368,114851465,H1|chr10:75763559-75763597,chr10,75763559,75763597,1,39087809
H1|chr10:114852997-114853051,chr10,114852997,114853051,H1|chr10:111768562-111768625,chr10,111768562,111768625,1,3084435
H1|chr10:114852997-114853049,chr10,114852997,114853049,H1|chr10:111768562-111768625,chr10,111768562,111768625,1,3084435
H1|chr10:114857154-114857270,chr10,114857154,114857270,H1|chr10:32221499-32221560,chr10,32221499,32221560,1,82635655
H1|chr10:114857154-114857243,chr10,114857154,114857243,H1|chr10:32221499-32221560,chr10,32221499,32221560,1,82635655
H1|chr10:114857369-114857422,chr10,114857369,114857422,H1|chr10:75760188-75760234,chr10,75760188,75760234,1,39097181
H1|chr10:114857369-114857421,chr10,114857369,114857421,H1|chr10:75760188-75760234,chr10,75760188,75760234,1,39097181
H1|chr10:114857763-114857850,chr10,114857763,114857850,H1|chr10:126843627-126843664,chr10,126843627,126843664,1,11985864
H1|chr10:114888866-114888947,chr10,114888866,114888947,H1|chr10:89625074-89625096,chr10,89625074,89625096,1,25263792
H1|chr10:114888867-114888947,chr10,114888867,114888947,H1|chr10:89625074-89625096,chr10,89625074,89625096,1,25263793
H1|chr10:118642374-118642427,chr10,118642374,118642427,H1|chr10:104158593-104158679,chr10,104158593,104158679,1,14483781
H1|chr10:118642375-118642427,chr10,118642375,118642427,H1|chr10:104158593-104158679,chr10,104158593,104158679,1,14483782
H1|chr10:123307500-123307548,chr10,123307500,123307548,H1|chr10:123732855-123732942,chr10,123732855,123732942,1,425355
H1|chr10:123307502-123307548,chr10,123307502,123307548,H1|chr10:123732855-123732942,chr10,123732855,123732942,1,425353
H1|chr10:123307502-123307546,chr10,123307502,123307546,H1|chr10:123732855-123732942,chr10,123732855,123732942,1,425353
H1|chr10:123337792-123337881,chr10,123337792,123337881,H1|chr10:126844447-126844544,chr10,126844447,126844544,1,3506655
H1|chr10:123337828-123337881,chr10,123337828,123337881,H1|chr10:126844447-126844544,chr10,126844447,126844544,1,3506619
H1|chr10:123338996-123339087,chr10,123338996,123339087,H1|chr10:75759444-75759503,chr10,75759444,75759503,1,47579552
H1|chr10:123339000-123339091,chr10,123339000,123339091,H1|chr10:75759444-75759503,chr10,75759444,75759503,1,47579556
H1|chr10:123339905-123339970,chr10,123339905,123339970,H1|chr10:126843118-126843187,chr10,126843118,126843187,1,3503213
H1|chr10:123339905-123339966,chr10,123339905,123339966,H1|chr10:126843118-126843187,chr10,126843118,126843187,1,3503213
H1|chr10:123340766-123340853,chr10,123340766,123340853,H1|chr10:75764683-75764707,chr10,75764683,75764707,1,47576083
H1|chr10:125757220-125757300,chr10,125757220,125757300,H1|chr10:125750702-125750761,chr10,125750702,125750761,1,6518
H1|chr10:125766109-125766147,chr10,125766109,125766147,H1|chr10:125746375-125746487,chr10,125746375,125746487,1,19734
H1|chr10:126784188-126784252,chr10,126784188,126784252,H1|chr10:114714842-114714910,chr10,114714842,114714910,1,12069346
H1|chr10:126794842-126794874,chr10,126794842,126794874,H1|chr10:114715608-114715685,chr10,114715608,114715685,1,12079234
H1|chr10:126804554-126804600,chr10,126804554,126804600,H1|chr10:65027599-65027668,chr10,65027599,65027668,1,61776955
H1|chr10:126804634-126804745,chr10,126804634,126804745,H1|chr10:93558759-93558798,chr10,93558759,93558798,1,33245875
H1|chr10:126805193-126805241,chr10,126805193,126805241,H1|chr10:69834791-69834853,chr10,69834791,69834853,1,56970402
H1|chr10:126809844-126809957,chr10,126809844,126809957,H1|chr10:128589101-128589127,chr10,128589101,128589127,1,1779257
H1|chr10:126810125-126810152,chr10,126810125,126810152,H1|chr10:123686754-123686812,chr10,123686754,123686812,1,3123371
H1|chr10:126810718-126810774,chr10,126810718,126810774,H1|chr10:123354985-123355010,chr10,123354985,123355010,1,3455733
H1|chr10:126814616-126814711,chr10,126814616,126814711,H1|chr10:58119988-58120010,chr10,58119988,58120010,1,68694628
H1|chr10:126814617-126814711,chr10,126814617,126814711,H1|chr10:58119988-58120010,chr10,58119988,58120010,1,68694629
H1|chr10:126814687-126814711,chr10,126814687,126814711,H1|chr10:58119988-58120010,chr10,58119988,58120010,1,68694699
H1|chr10:126816112-126816159,chr10,126816112,126816159,H1|chr10:93558943-93559029,chr10,93558943,93559029,1,33257169
H1|chr10:126816114-126816159,chr10,126816114,126816159,H1|chr10:93558943-93559029,chr10,93558943,93559029,1,33257171
H1|chr10:126816226-126816295,chr10,126816226,126816295,H1|chr10:65026231-65026274,chr10,65026231,65026274,1,61789995
H1|chr10:126816226-126816294,chr10,126816226,126816294,H1|chr10:65026231-65026274,chr10,65026231,65026274,1,61789995
H1|chr10:126823709-126823745,chr10,126823709,126823745,H1|chr10:128594932-128594980,chr10,128594932,128594980,1,1771223
H1|chr10:126834839-126834923,chr10,126834839,126834923,H1|chr10:123355949-123356001,chr10,123355949,123356001,1,3478890
H1|chr10:126838938-126838967,chr10,126838938,126838967,H1|chr10:123686853-123686929,chr10,123686853,123686929,1,3152085
H1|chr10:132918249-132918328,chr10,132918249,132918328,H1|chr10:126846171-126846235,chr10,126846171,126846235,1,6072078
H1|chr10:132918250-132918328,chr10,132918250,132918328,H1|chr10:126846171-126846235,chr10,126846171,126846235,1,6072079
H1|chr11:784128-784236,chr11,784128,784236,H1|chr11:841448-841542,chr11,841448,841542,1,57320
H1|chr11:784180-784258,chr11,784180,784258,H1|chr11:805814-805855,chr11,805814,805855,1,21634
H1|chr11:784180-784236,chr11,784180,784236,H1|chr11:841448-841542,chr11,841448,841542,1,57268
H1|chr11:2704798-2704840,chr11,2704798,2704840,H1|chr11:14362801-14362868,chr11,14362801,14362868,1,11658003
H1|chr11:2704800-2704840,chr11,2704800,2704840,H1|chr11:14362801-14362868,chr11,14362801,14362868,1,11658001
H1|chr11:2707937-2708043,chr11,2707937,2708043,H1|chr11:14360298-14360339,chr11,14360298,14360339,1,11652361
H1|chr11:2707964-2708043,chr11,2707964,2708043,H1|chr11:14360298-14360366,chr11,14360298,14360366,1,11652334
H1|chr11:12703901-12703969,chr11,12703901,12703969,H1|chr11:14362567-14362620,chr11,14362567,14362620,1,1658666
H1|chr11:12724068-12724194,chr11,12724068,12724194,H1|chr11:14362892-14362969,chr11,14362892,14362969,1,1638824
H1|chr11:12724134-12724206,chr11,12724134,12724206,H1|chr11:14362892-14362969,chr11,14362892,14362969,1,1638758
H1|chr11:12750612-12750647,chr11,12750612,12750647,H1|chr11:27655390-27655498,chr11,27655390,27655498,1,14904778
H1|chr11:12750612-12750644,chr11,12750612,12750644,H1|chr11:27655390-27655498,chr11,27655390,27655498,1,14904778
H1|chr11:12751035-12751124,chr11,12751035,12751124,H1|chr11:17032647-17032726,chr11,17032647,17032726,1,4281612
H1|chr11:12751035-12751106,chr11,12751035,12751106,H1|chr11:17032647-17032726,chr11,17032647,17032726,1,4281612
H1|chr11:12752445-12752547,chr11,12752445,12752547,H1|chr11:17031283-17031328,chr11,17031283,17031328,1,4278838
H1|chr11:12780037-12780092,chr11,12780037,12780092,H1|chr11:27655648-27655723,chr11,27655648,27655723,1,14875611
H1|chr11:12789773-12789886,chr11,12789773,12789886,H1|chr11:14362681-14362702,chr11,14362681,14362702,1,1572908
H1|chr11:12789774-12789886,chr11,12789774,12789886,H1|chr11:14362681-14362702,chr11,14362681,14362702,1,1572907
H1|chr11:12815775-12815823,chr11,12815775,12815823,H1|chr11:47195858-47195934,chr11,47195858,47195934,1,34380083
H1|chr11:12815784-12815823,chr11,12815784,12815823,H1|chr11:47195858-47195934,chr11,47195858,47195934,1,34380074
H1|chr11:12827750-12827787,chr11,12827750,12827787,H1|chr11:47293654-47293748,chr11,47293654,47293748,1,34465904
H1|chr11:16938757-16938855,chr11,16938757,16938855,H1|chr11:12697823-12697869,chr11,12697823,12697869,1,4240934
H1|chr11:16938757-16938853,chr11,16938757,16938853,H1|chr11:12697823-12697869,chr11,12697823,12697869,1,4240934
H1|chr11:16941412-16941498,chr11,16941412,16941498,H1|chr11:16761854-16761918,chr11,16761854,16761918,1,179558
H1|chr11:16941648-16941709,chr11,16941648,16941709,H1|chr11:16761854-16761918,chr11,16761854,16761918,1,179794
H1|chr11:16963528-16963594,chr11,16963528,16963594,H1|chr11:12699443-12699527,chr11,12699443,12699527,1,4264085
H1|chr11:16963530-16963600,chr11,16963530,16963600,H1|chr11:12699443-12699527,chr11,12699443,12699527,1,4264087
H1|chr11:16967286-16967347,chr11,16967286,16967347,H1|chr11:16760626-16760661,chr11,16760626,16760661,1,206660
H1|chr11:16967287-16967347,chr11,16967287,16967347,H1|chr11:16760626-16760661,chr11,16760626,16760661,1,206661
H1|chr11:16999888-16999978,chr11,16999888,16999978,H1|chr11:61132214-61132285,chr11,61132214,61132285,1,44132326
H1|chr11:16999888-16999967,chr11,16999888,16999967,H1|chr11:61132214-61132285,chr11,61132214,61132285,1,44132326
H1|chr11:20060911-20061016,chr11,20060911,20061016,H1|chr11:22647577-22647622,chr11,22647577,22647622,1,2586666
H1|chr11:20060911-20061015,chr11,20060911,20061015,H1|chr11:22647577-22647622,chr11,22647577,22647622,1,2586666
H1|chr11:26928938-26929019,chr11,26928938,26929019,H1|chr11:10744150-10744216,chr11,10744150,10744216,1,16184788
H1|chr11:26928938-26929012,chr11,26928938,26929012,H1|chr11:10744150-10744216,chr11,10744150,10744216,1,16184788
H1|chr11:27446289-27446389,chr11,27446289,27446389,H1|chr11:18611470-18611520,chr11,18611470,18611520,1,8834819
H1|chr11:27446290-27446405,chr11,27446290,27446405,H1|chr11:18611470-18611520,chr11,18611470,18611520,1,8834820
H1|chr11:27446358-27446405,chr11,27446358,27446405,H1|chr11:18611470-18611520,chr11,18611470,18611520,1,8834888
H1|chr11:27448884-27448956,chr11,27448884,27448956,H1|chr11:63615129-63615169,chr11,63615129,63615169,1,36166245
H1|chr11:27448894-27448956,chr11,27448894,27448956,H1|chr11:63615129-63615169,chr11,63615129,63615169,1,36166235
H1|chr11:27450283-27450325,chr11,27450283,27450325,H1|chr11:27654776-27654830,chr11,27654776,27654830,1,204493
H1|chr11:27450285-27450325,chr11,27450285,27450325,H1|chr11:27654776-27654830,chr11,27654776,27654830,1,204491
H1|chr11:27450803-27450909,chr11,27450803,27450909,H1|chr11:27654623-27654676,chr11,27654623,27654676,1,203820
H1|chr11:27450820-27450907,chr11,27450820,27450907,H1|chr11:27654623-27654676,chr11,27654623,27654676,1,203803
H1|chr11:27452495-27452606,chr11,27452495,27452606,H1|chr11:27655210-27655272,chr11,27655210,27655272,1,202715
H1|chr11:27452518-27452606,chr11,27452518,27452606,H1|chr11:27655210-27655272,chr11,27655210,27655272,1,202692
H1|chr11:27462625-27462676,chr11,27462625,27462676,H1|chr11:33181296-33181385,chr11,33181296,33181385,1,5718671
H1|chr11:27462626-27462676,chr11,27462626,27462676,H1|chr11:33181296-33181385,chr11,33181296,33181385,1,5718670
H1|chr11:27464679-27464775,chr11,27464679,27464775,H1|chr11:27655301-27655355,chr11,27655301,27655355,1,190622
H1|chr11:27464679-27464774,chr11,27464679,27464774,H1|chr11:27655301-27655355,chr11,27655301,27655355,1,190622
H1|chr11:27473757-27473798,chr11,27473757,27473798,H1|chr11:27653944-27654035,chr11,27653944,27654035,1,180187
H1|chr11:27476349-27476418,chr11,27476349,27476418,H1|chr11:27654551-27654615,chr11,27654551,27654615,1,178202
H1|chr11:27476589-27476651,chr11,27476589,27476651,H1|chr11:17032775-17032824,chr11,17032775,17032824,1,10443814
H1|chr11:27476589-27476649,chr11,27476589,27476649,H1|chr11:17032775-17032824,chr11,17032775,17032824,1,10443814
H1|chr11:27477938-27478020,chr11,27477938,27478020,H1|chr11:17034150-17034216,chr11,17034150,17034216,1,10443788
H1|chr11:27483803-27483897,chr11,27483803,27483897,H1|chr11:27654680-27654789,chr11,27654680,27654789,1,170877
H1|chr11:27483805-27483860,chr11,27483805,27483860,H1|chr11:77530350-77530414,chr11,77530350,77530414,1,50046545
H1|chr11:27483856-27483897,chr11,27483856,27483897,H1|chr11:27654680-27654789,chr11,27654680,27654789,1,170824
H1|chr11:27484218-27484294,chr11,27484218,27484294,H1|chr11:33181214-33181315,chr11,33181214,33181315,1,5696996
H1|chr11:27484218-27484267,chr11,27484218,27484267,H1|chr11:33181214-33181315,chr11,33181214,33181315,1,5696996
H1|chr11:27484220-27484294,chr11,27484220,27484294,H1|chr11:33181241-33181317,chr11,33181241,33181317,1,5697021
H1|chr11:27484350-27484396,chr11,27484350,27484396,H1|chr11:27654750-27654830,chr11,27654750,27654830,1,170400
H1|chr11:27484369-27484401,chr11,27484369,27484401,H1|chr11:27655201-27655268,chr11,27655201,27655268,1,170832
H1|chr11:34209913-34209936,chr11,34209913,34209936,H1|chr11:34125995-34126064,chr11,34125995,34126064,1,83918
H1|chr11:34218138-34218178,chr11,34218138,34218178,H1|chr11:34123187-34123218,chr11,34123187,34123218,1,94951
H1|chr11:34265529-34265565,chr11,34265529,34265565,H1|chr11:77182686-77182816,chr11,77182686,77182816,1,42917157
H1|chr11:34265529-34265547,chr11,34265529,34265547,H1|chr11:77182686-77182816,chr11,77182686,77182816,1,42917157
H1|chr11:36124190-36124295,chr11,36124190,36124295,H1|chr11:36313467-36313498,chr11,36313467,36313498,1,189277
H1|chr11:36126747-36126812,chr11,36126747,36126812,H1|chr11:36310553-36310656,chr11,36310553,36310656,1,183806
H1|chr11:44195409-44195452,chr11,44195409,44195452,H1|chr11:27655240-27655310,chr11,27655240,27655310,1,16540169
H1|chr11:44793407-44793462,chr11,44793407,44793462,H1|chr11:11641714-11641809,chr11,11641714,11641809,1,33151693
H1|chr11:44793408-44793484,chr11,44793408,44793484,H1|chr11:11641721-11641809,chr11,11641721,11641809,1,33151687
H1|chr11:44900488-44900569,chr11,44900488,44900569,H1|chr11:205779-205826,chr11,205779,205826,1,44694709
H1|chr11:44900488-44900535,chr11,44900488,44900535,H1|chr11:205779-205826,chr11,205779,205826,1,44694709
H1|chr11:44979367-44979444,chr11,44979367,44979444,H1|chr11:44971962-44972033,chr11,44971962,44972033,1,7405
H1|chr11:44979367-44979442,chr11,44979367,44979442,H1|chr11:44971962-44972033,chr11,44971962,44972033,1,7405
H1|chr11:44979383-44979436,chr11,44979383,44979436,H1|chr11:44972753-44972810,chr11,44972753,44972810,1,6630
H1|chr11:46455424-46455549,chr11,46455424,46455549,H1|chr11:46369463-46369485,chr11,46369463,46369485,1,85961
H1|chr11:46455508-46455653,chr11,46455508,46455653,H1|chr11:46369463-46369485,chr11,46369463,46369485,1,86045
H1|chr11:46455547-46455653,chr11,46455547,46455653,H1|chr11:46369463-46369485,chr11,46369463,46369485,1,86084
H1|chr11:47083272-47083312,chr11,47083272,47083312,H1|chr11:33280248-33280367,chr11,33280248,33280367,1,13803024
H1|chr11:47083283-47083313,chr11,47083283,47083313,H1|chr11:33280248-33280367,chr11,33280248,33280367,1,13803035
H1|chr11:48107791-48107851,chr11,48107791,48107851,H1|chr11:46140783-46140826,chr11,46140783,46140826,1,1967008
H1|chr11:57235881-57235933,chr11,57235881,57235933,H1|chr11:57090670-57090725,chr11,57090670,57090725,1,145211
H1|chr11:57238362-57238398,chr11,57238362,57238398,H1|chr11:57093018-57093099,chr11,57093018,57093099,1,145344
H1|chr11:57238363-57238398,chr11,57238363,57238398,H1|chr11:57093018-57093099,chr11,57093018,57093099,1,145345
H1|chr11:57243055-57243118,chr11,57243055,57243118,H1|chr11:3012971-3013031,chr11,3012971,3013031,1,54230084
H1|chr11:57251662-57251774,chr11,57251662,57251774,H1|chr11:47238946-47238972,chr11,47238946,47238972,1,10012716
H1|chr11:57251662-57251705,chr11,57251662,57251705,H1|chr11:47238946-47238972,chr11,47238946,47238972,1,10012716
H1|chr11:57260621-57260715,chr11,57260621,57260715,H1|chr11:7698010-7698066,chr11,7698010,7698066,1,49562611
H1|chr11:57260655-57260805,chr11,57260655,57260805,H1|chr11:7698010-7698066,chr11,7698010,7698066,1,49562645
H1|chr11:57260655-57260804,chr11,57260655,57260804,H1|chr11:7698010-7698066,chr11,7698010,7698066,1,49562645
H1|chr11:58864261-58864383,chr11,58864261,58864383,H1|chr11:58869637-58869785,chr11,58869637,58869785,1,5376
H1|chr11:58864287-58864383,chr11,58864287,58864383,H1|chr11:58869637-58869691,chr11,58869637,58869691,1,5350
H1|chr11:58866059-58866098,chr11,58866059,58866098,H1|chr11:58827162-58827219,chr11,58827162,58827219,1,38897
H1|chr11:58868214-58868309,chr11,58868214,58868309,H1|chr11:58870683-58870717,chr11,58870683,58870717,1,2469
H1|chr11:58868611-58868689,chr11,58868611,58868689,H1|chr11:58825336-58825409,chr11,58825336,58825409,1,43275
H1|chr11:58868611-58868688,chr11,58868611,58868688,H1|chr11:58825336-58825409,chr11,58825336,58825409,1,43275
H1|chr11:63528490-63528529,chr11,63528490,63528529,H1|chr11:63577908-63578044,chr11,63577908,63578044,1,49418
H1|chr11:63529363-63529461,chr11,63529363,63529461,H1|chr11:63607435-63607491,chr11,63607435,63607491,1,78072
H1|chr11:63529367-63529461,chr11,63529367,63529461,H1|chr11:63607435-63607491,chr11,63607435,63607491,1,78068
H1|chr11:63529604-63529711,chr11,63529604,63529711,H1|chr11:63607319-63607362,chr11,63607319,63607362,1,77715
H1|chr11:63530739-63530759,chr11,63530739,63530759,H1|chr11:63379327-63379476,chr11,63379327,63379476,1,151412
H1|chr11:63533516-63533568,chr11,63533516,63533568,H1|chr11:63377743-63377806,chr11,63377743,63377806,1,155773
H1|chr11:63533516-63533567,chr11,63533516,63533567,H1|chr11:63377743-63377806,chr11,63377743,63377806,1,155773
H1|chr11:63536339-63536420,chr11,63536339,63536420,H1|chr11:63580426-63580470,chr11,63580426,63580470,1,44087
H1|chr11:63537103-63537191,chr11,63537103,63537191,H1|chr11:63579109-63579172,chr11,63579109,63579172,1,42006
H1|chr11:63537103-63537189,chr11,63537103,63537189,H1|chr11:63579109-63579172,chr11,63579109,63579172,1,42006
H1|chr11:63641917-63641947,chr11,63641917,63641947,H1|chr11:67799922-67800040,chr11,67799922,67800040,1,4158005
H1|chr11:63641917-63641945,chr11,63641917,63641945,H1|chr11:67799921-67800040,chr11,67799921,67800040,1,4158004
H1|chr11:63641918-63641962,chr11,63641918,63641962,H1|chr11:67799921-67800040,chr11,67799921,67800040,1,4158003
H1|chr11:63770056-63770150,chr11,63770056,63770150,H1|chr11:63744528-63744618,chr11,63744528,63744618,1,25528
H1|chr11:63772677-63772817,chr11,63772677,63772817,H1|chr11:118888282-118888340,chr11,118888282,118888340,1,55115605
H1|chr11:63772677-63772769,chr11,63772677,63772769,H1|chr11:118888282-118888340,chr11,118888282,118888340,1,55115605
H1|chr11:63772724-63772817,chr11,63772724,63772817,H1|chr11:118888291-118888340,chr11,118888291,118888340,1,55115567
H1|chr11:63777566-63777593,chr11,63777566,63777593,H1|chr11:64011345-64011495,chr11,64011345,64011495,1,233779
H1|chr11:63779080-63779136,chr11,63779080,63779136,H1|chr11:63380691-63380841,chr11,63380691,63380841,1,398389
H1|chr11:63784478-63784570,chr11,63784478,63784570,H1|chr11:63735178-63735222,chr11,63735178,63735222,1,49300
H1|chr11:63861902-63861995,chr11,63861902,63861995,H1|chr11:63449764-63449793,chr11,63449764,63449793,1,412138
H1|chr11:63864901-63864965,chr11,63864901,63864965,H1|chr11:63449824-63449937,chr11,63449824,63449937,1,415077
H1|chr11:63893741-63893859,chr11,63893741,63893859,H1|chr11:74205380-74205401,chr11,74205380,74205401,1,10311639
H1|chr11:64974326-64974385,chr11,64974326,64974385,H1|chr11:64881837-64881896,chr11,64881837,64881896,1,92489
H1|chr11:64976006-64976031,chr11,64976006,64976031,H1|chr11:64887542-64887689,chr11,64887542,64887689,1,88464
H1|chr11:65069240-65069297,chr11,65069240,65069297,H1|chr11:64951815-64951901,chr11,64951815,64951901,1,117425
H1|chr11:65069240-65069296,chr11,65069240,65069296,H1|chr11:64951815-64951901,chr11,64951815,64951901,1,117425
H1|chr11:65192161-65192288,chr11,65192161,65192288,H1|chr11:47292776-47292798,chr11,47292776,47292798,1,17899385
H1|chr11:65192162-65192287,chr11,65192162,65192287,H1|chr11:47292776-47292798,chr11,47292776,47292798,1,17899386
H1|chr11:65192162-65192279,chr11,65192162,65192279,H1|chr11:47292776-47292798,chr11,47292776,47292798,1,17899386
H1|chr11:65258337-65258415,chr11,65258337,65258415,H1|chr11:61733600-61733744,chr11,61733600,61733744,1,3524737
H1|chr11:65265451-65265538,chr11,65265451,65265538,H1|chr11:67184462-67184536,chr11,67184462,67184536,1,1919011
H1|chr11:65265462-65265538,chr11,65265462,65265538,H1|chr11:67184462-67184536,chr11,67184462,67184536,1,1919000
H1|chr11:65266526-65266626,chr11,65266526,65266626,H1|chr11:65430270-65430289,chr11,65430270,65430289,1,163744
H1|chr11:65266532-65266610,chr11,65266532,65266610,H1|chr11:291259-291293,chr11,291259,291293,1,64975273
H1|chr11:65266533-65266561,chr11,65266533,65266561,H1|chr11:65317814-65317887,chr11,65317814,65317887,1,51281
H1|chr11:65266539-65266580,chr11,65266539,65266580,H1|chr11:286467-286552,chr11,286467,286552,1,64980072
H1|chr11:65266628-65266720,chr11,65266628,65266720,H1|chr11:65430270-65430289,chr11,65430270,65430289,1,163642
H1|chr11:65266712-65266783,chr11,65266712,65266783,H1|chr11:67351729-67351753,chr11,67351729,67351753,1,2085017
H1|chr11:65266742-65266857,chr11,65266742,65266857,H1|chr11:748702-748823,chr11,748702,748823,1,64518040
H1|chr11:65266832-65266861,chr11,65266832,65266861,H1|chr11:748702-748823,chr11,748702,748823,1,64518130
H1|chr11:65266849-65266897,chr11,65266849,65266897,H1|chr11:748042-748144,chr11,748042,748144,1,64518807
H1|chr11:65266850-65266897,chr11,65266850,65266897,H1|chr11:748042-748144,chr11,748042,748144,1,64518808
H1|chr11:65266947-65267018,chr11,65266947,65267018,H1|chr11:117103773-117103852,chr11,117103773,117103852,1,51836826
H1|chr11:65266947-65267014,chr11,65266947,65267014,H1|chr11:117103773-117103852,chr11,117103773,117103852,1,51836826
H1|chr11:65266949-65267047,chr11,65266949,65267047,H1|chr11:117103774-117103853,chr11,117103774,117103853,1,51836825
H1|chr11:65266974-65267047,chr11,65266974,65267047,H1|chr11:2399972-2400089,chr11,2399972,2400089,1,62867002
H1|chr11:65266974-65267006,chr11,65266974,65267006,H1|chr11:2399972-2400089,chr11,2399972,2400089,1,62867002
H1|chr11:65267107-65267159,chr11,65267107,65267159,H1|chr11:291414-291511,chr11,291414,291511,1,64975693
H1|chr11:65267112-65267159,chr11,65267112,65267159,H1|chr11:291414-291511,chr11,291414,291511,1,64975698
H1|chr11:65267226-65267254,chr11,65267226,65267254,H1|chr11:57529709-57529806,chr11,57529709,57529806,1,7737517
H1|chr11:65267233-65267254,chr11,65267233,65267254,H1|chr11:57529709-57529806,chr11,57529709,57529806,1,7737524
H1|chr11:65267399-65267464,chr11,65267399,65267464,H1|chr11:61734402-61734425,chr11,61734402,61734425,1,3532997
H1|chr11:65267442-65267467,chr11,65267442,65267467,H1|chr11:62431973-62432117,chr11,62431973,62432117,1,2835469
H1|chr11:65267486-65267556,chr11,65267486,65267556,H1|chr11:57530738-57530808,chr11,57530738,57530808,1,7736748
H1|chr11:65267486-65267555,chr11,65267486,65267555,H1|chr11:57530738-57530808,chr11,57530738,57530808,1,7736748
H1|chr11:65267517-65267635,chr11,65267517,65267635,H1|chr11:65630249-65630308,chr11,65630249,65630308,1,362732
H1|chr11:65267544-65267635,chr11,65267544,65267635,H1|chr11:65630249-65630308,chr11,65630249,65630308,1,362705
H1|chr11:65267582-65267619,chr11,65267582,65267619,H1|chr11:65317810-65317882,chr11,65317810,65317882,1,50228
H1|chr11:65267696-65267791,chr11,65267696,65267791,H1|chr11:314629-314647,chr11,314629,314647,1,64953067
H1|chr11:65267697-65267797,chr11,65267697,65267797,H1|chr11:43703297-43703339,chr11,43703297,43703339,1,21564400
H1|chr11:65267697-65267794,chr11,65267697,65267794,H1|chr11:43703297-43703339,chr11,43703297,43703339,1,21564400
H1|chr11:65267697-65267791,chr11,65267697,65267791,H1|chr11:314629-314647,chr11,314629,314647,1,64953068
H1|chr11:65267724-65267848,chr11,65267724,65267848,H1|chr11:67196237-67196331,chr11,67196237,67196331,1,1928513
H1|chr11:65267771-65267803,chr11,65267771,65267803,H1|chr11:62436359-62436500,chr11,62436359,62436500,1,2831412
H1|chr11:65267772-65267803,chr11,65267772,65267803,H1|chr11:62436359-62436392,chr11,62436359,62436392,1,2831413
H1|chr11:65268042-65268142,chr11,65268042,65268142,H1|chr11:67210361-67210497,chr11,67210361,67210497,1,1942319
H1|chr11:66178376-66178444,chr11,66178376,66178444,H1|chr11:66188262-66188316,chr11,66188262,66188316,1,9886
H1|chr11:66178406-66178444,chr11,66178406,66178444,H1|chr11:66188266-66188416,chr11,66188266,66188416,1,9860
H1|chr11:66178922-66179044,chr11,66178922,66179044,H1|chr11:66187337-66187361,chr11,66187337,66187361,1,8415
H1|chr11:66178951-66179098,chr11,66178951,66179098,H1|chr11:66187337-66187361,chr11,66187337,66187361,1,8386
H1|chr11:66180343-66180372,chr11,66180343,66180372,H1|chr11:66187595-66187726,chr11,66187595,66187726,1,7252
H1|chr11:66180353-66180372,chr11,66180353,66180372,H1|chr11:66187595-66187726,chr11,66187595,66187726,1,7242
H1|chr11:67761715-67761766,chr11,67761715,67761766,H1|chr11:67481867-67481979,chr11,67481867,67481979,1,279848
H1|chr11:67761715-67761753,chr11,67761715,67761753,H1|chr11:67481867-67481979,chr11,67481867,67481979,1,279848
H1|chr11:67761965-67762022,chr11,67761965,67762022,H1|chr11:67482324-67482416,chr11,67482324,67482416,1,279641
H1|chr11:67762379-67762515,chr11,67762379,67762515,H1|chr11:67482539-67482641,chr11,67482539,67482641,1,279840
H1|chr11:67957004-67957061,chr11,67957004,67957061,H1|chr11:67887060-67887210,chr11,67887060,67887210,1,69944
H1|chr11:67957007-67957061,chr11,67957007,67957061,H1|chr11:67887186-67887281,chr11,67887186,67887281,1,69821
H1|chr11:68096238-68096281,chr11,68096238,68096281,H1|chr11:67887060-67887210,chr11,67887060,67887210,1,209178
H1|chr11:68120516-68120566,chr11,68120516,68120566,H1|chr11:67887458-67887507,chr11,67887458,67887507,1,233058
H1|chr11:68218955-68219010,chr11,68218955,68219010,H1|chr11:68042717-68042771,chr11,68042717,68042771,1,176238
H1|chr11:68474475-68474503,chr11,68474475,68474503,H1|chr11:68518246-68518293,chr11,68518246,68518293,1,43771
H1|chr11:70493722-70493765,chr11,70493722,70493765,H1|chr11:94275700-94275807,chr11,94275700,94275807,1,23781978
H1|chr11:70493723-70493777,chr11,70493723,70493777,H1|chr11:94275700-94275807,chr11,94275700,94275807,1,23781977
H1|chr11:76026972-76027044,chr11,76026972,76027044,H1|chr11:61722118-61722196,chr11,61722118,61722196,1,14304854
H1|chr11:76026972-76027043,chr11,76026972,76027043,H1|chr11:61722118-61722196,chr11,61722118,61722196,1,14304854
H1|chr11:84359630-84359710,chr11,84359630,84359710,H1|chr11:73308092-73308150,chr11,73308092,73308150,1,11051538
H1|chr11:84359635-84359711,chr11,84359635,84359711,H1|chr11:73308092-73308150,chr11,73308092,73308150,1,11051543
H1|chr11:84359635-84359710,chr11,84359635,84359710,H1|chr11:73308092-73308150,chr11,73308092,73308150,1,11051543
H1|chr11:84359635-84359680,chr11,84359635,84359680,H1|chr11:73308092-73308150,chr11,73308092,73308150,1,11051543
H1|chr11:92051376-92051496,chr11,92051376,92051496,H1|chr11:93478175-93478208,chr11,93478175,93478208,1,1426799
H1|chr11:92051376-92051492,chr11,92051376,92051492,H1|chr11:93478175-93478208,chr11,93478175,93478208,1,1426799
H1|chr11:94386709-94386745,chr11,94386709,94386745,H1|chr11:73586672-73586736,chr11,73586672,73586736,1,20800037
H1|chr11:100591971-100592015,chr11,100591971,100592015,H1|chr11:95657564-95657637,chr11,95657564,95657637,1,4934407
H1|chr11:100605485-100605547,chr11,100605485,100605547,H1|chr11:77529980-77530035,chr11,77529980,77530035,1,23075505
H1|chr11:100605485-100605546,chr11,100605485,100605546,H1|chr11:77529980-77530035,chr11,77529980,77530035,1,23075505
H1|chr11:100608711-100608830,chr11,100608711,100608830,H1|chr11:102962074-102962094,chr11,102962074,102962094,1,2353363
H1|chr11:113720784-113720884,chr11,113720784,113720884,H1|chr11:93969066-93969113,chr11,93969066,93969113,1,19751718
H1|chr11:116107660-116107747,chr11,116107660,116107747,H1|chr11:17031896-17031971,chr11,17031896,17031971,1,99075764
H1|chr11:116107679-116107747,chr11,116107679,116107747,H1|chr11:17031896-17031972,chr11,17031896,17031972,1,99075783
H1|chr11:116107715-116107747,chr11,116107715,116107747,H1|chr11:17031896-17031971,chr11,17031896,17031971,1,99075819
H1|chr11:118577559-118577696,chr11,118577559,118577696,H1|chr11:119078325-119078418,chr11,119078325,119078418,1,500766
H1|chr11:118583250-118583309,chr11,118583250,118583309,H1|chr11:119077886-119077967,chr11,119077886,119077967,1,494636
H1|chr11:119570518-119570594,chr11,119570518,119570594,H1|chr11:120204553-120204615,chr11,120204553,120204615,1,634035
H1|chr11:119584523-119584592,chr11,119584523,119584592,H1|chr11:120208117-120208172,chr11,120208117,120208172,1,623594
H1|chr11:119585084-119585193,chr11,119585084,119585193,H1|chr11:47236852-47236893,chr11,47236852,47236893,1,72348232
H1|chr11:119585134-119585281,chr11,119585134,119585281,H1|chr11:47236852-47236893,chr11,47236852,47236893,1,72348282
H1|chr11:121350289-121350370,chr11,121350289,121350370,H1|chr11:67235764-67235809,chr11,67235764,67235809,1,54114525
H1|chr11:121350289-121350339,chr11,121350289,121350339,H1|chr11:67235764-67235809,chr11,67235764,67235809,1,54114525
H1|chr11:123365748-123365855,chr11,123365748,123365855,H1|chr11:57298952-57298993,chr11,57298952,57298993,1,66066796
H1|chr11:123365748-123365839,chr11,123365748,123365839,H1|chr11:57298952-57298993,chr11,57298952,57298993,1,66066796
H1|chr11:123365750-123365855,chr11,123365750,123365855,H1|chr11:57298952-57298993,chr11,57298952,57298993,1,66066798
H1|chr11:126211809-126211869,chr11,126211809,126211869,H1|chr11:126221166-126221217,chr11,126221166,126221217,1,9357
H1|chr11:126212087-126212217,chr11,126212087,126212217,H1|chr11:126225336-126225367,chr11,126225336,126225367,1,13249
H1|chr11:126212098-126212217,chr11,126212098,126212217,H1|chr11:126225336-126225367,chr11,126225336,126225367,1,13238
H1|chr11:126212154-126212217,chr11,126212154,126212217,H1|chr11:126225336-126225383,chr11,126225336,126225383,1,13182
H1|chr11:126212154-126212216,chr11,126212154,126212216,H1|chr11:126225387-126225442,chr11,126225387,126225442,1,13233
H1|chr11:126213730-126213779,chr11,126213730,126213779,H1|chr11:126221336-126221401,chr11,126221336,126221401,1,7606
H1|chr11:126215996-126216051,chr11,126215996,126216051,H1|chr11:126221924-126222052,chr11,126221924,126222052,1,5928
H1|chr11:126216029-126216051,chr11,126216029,126216051,H1|chr11:126221924-126222052,chr11,126221924,126222052,1,5895
H1|chr11:126216162-126216285,chr11,126216162,126216285,H1|chr11:126224620-126224691,chr11,126224620,126224691,1,8458
H1|chr11:126216206-126216285,chr11,126216206,126216285,H1|chr11:126224620-126224691,chr11,126224620,126224691,1,8414
H1|chr11:128464676-128464729,chr11,128464676,128464729,H1|chr11:30347958-30348011,chr11,30347958,30348011,1,98116718
H1|chr11:129952405-129952463,chr11,129952405,129952463,H1|chr11:129871391-129871481,chr11,129871391,129871481,1,81014
H1|chr11:129955468-129955556,chr11,129955468,129955556,H1|chr11:129874921-129874982,chr11,129874921,129874982,1,80547
H1|chr11:129955481-129955556,chr11,129955481,129955556,H1|chr11:129874921-129874996,chr11,129874921,129874996,1,80560
H1|chr11:134137448-134137527,chr11,134137448,134137527,H1|chr11:134140689-134140754,chr11,134140689,134140754,1,3241
H1|chr11:134137451-134137527,chr11,134137451,134137527,H1|chr11:134140689-134140754,chr11,134140689,134140754,1,3238
H1|chr11:134137490-134137606,chr11,134137490,134137606,H1|chr11:134142414-134142448,chr11,134142414,134142448,1,4924
H1|chr11:134137523-134137673,chr11,134137523,134137673,H1|chr11:134142414-134142448,chr11,134142414,134142448,1,4891
H1|chr12:2865020-2865065,chr12,2865020,2865065,H1|chr12:57116194-57116299,chr12,57116194,57116299,1,54251174
H1|chr12:2865024-2865167,chr12,2865024,2865167,H1|chr12:57116194-57116299,chr12,57116194,57116299,1,54251170
H1|chr12:3214885-3214943,chr12,3214885,3214943,H1|chr12:5351238-5351330,chr12,5351238,5351330,1,2136353
H1|chr12:3214885-3214939,chr12,3214885,3214939,H1|chr12:5351238-5351334,chr12,5351238,5351334,1,2136353
H1|chr12:5312938-5313012,chr12,5312938,5313012,H1|chr12:5351125-5351200,chr12,5351125,5351200,1,38187
H1|chr12:5313964-5313997,chr12,5313964,5313997,H1|chr12:5353118-5353182,chr12,5353118,5353182,1,39154
H1|chr12:5330539-5330651,chr12,5330539,5330651,H1|chr12:5350995-5351078,chr12,5350995,5351078,1,20456
H1|chr12:5330539-5330606,chr12,5330539,5330606,H1|chr12:5350995-5351078,chr12,5350995,5351078,1,20456
H1|chr12:5331387-5331473,chr12,5331387,5331473,H1|chr12:5352588-5352619,chr12,5352588,5352619,1,21201
H1|chr12:5359010-5359107,chr12,5359010,5359107,H1|chr12:5351549-5351587,chr12,5351549,5351587,1,7461
H1|chr12:5359033-5359109,chr12,5359033,5359109,H1|chr12:5351551-5351625,chr12,5351551,5351625,1,7482
H1|chr12:5359680-5359701,chr12,5359680,5359701,H1|chr12:5351172-5351215,chr12,5351172,5351215,1,8508
H1|chr12:5359707-5359821,chr12,5359707,5359821,H1|chr12:5351172-5351215,chr12,5351172,5351215,1,8535
H1|chr12:5359817-5359877,chr12,5359817,5359877,H1|chr12:5351008-5351155,chr12,5351008,5351155,1,8809
H1|chr12:5362567-5362651,chr12,5362567,5362651,H1|chr12:5351186-5351222,chr12,5351186,5351222,1,11381
H1|chr12:5362572-5362712,chr12,5362572,5362712,H1|chr12:5351186-5351222,chr12,5351186,5351222,1,11386
H1|chr12:5365352-5365411,chr12,5365352,5365411,H1|chr12:5352773-5352831,chr12,5352773,5352831,1,12579
H1|chr12:5369373-5369419,chr12,5369373,5369419,H1|chr12:5349542-5349622,chr12,5349542,5349622,1,19831
H1|chr12:5372478-5372596,chr12,5372478,5372596,H1|chr12:5352422-5352454,chr12,5352422,5352454,1,20056
H1|chr12:5377454-5377596,chr12,5377454,5377596,H1|chr12:5349668-5349818,chr12,5349668,5349818,1,27786
H1|chr12:6722452-6722538,chr12,6722452,6722538,H1|chr12:6718560-6718590,chr12,6718560,6718590,1,3892
H1|chr12:6722559-6722610,chr12,6722559,6722610,H1|chr12:6719813-6719942,chr12,6719813,6719942,1,2746
H1|chr12:6722559-6722580,chr12,6722559,6722580,H1|chr12:6719813-6719942,chr12,6719813,6719942,1,2746
H1|chr12:6723004-6723106,chr12,6723004,6723106,H1|chr12:6718531-6718558,chr12,6718531,6718558,1,4473
H1|chr12:6727154-6727189,chr12,6727154,6727189,H1|chr12:6716822-6716871,chr12,6716822,6716871,1,10332
H1|chr12:7071115-7071146,chr12,7071115,7071146,H1|chr12:7034250-7034344,chr12,7034250,7034344,1,36865
H1|chr12:7952414-7952455,chr12,7952414,7952455,H1|chr12:7943550-7943670,chr12,7943550,7943670,1,8864
H1|chr12:7952860-7952925,chr12,7952860,7952925,H1|chr12:7941318-7941397,chr12,7941318,7941397,1,11542
H1|chr12:7952860-7952921,chr12,7952860,7952921,H1|chr12:7941318-7941397,chr12,7941318,7941397,1,11542
H1|chr12:8058223-8058286,chr12,8058223,8058286,H1|chr12:56511219-56511294,chr12,56511219,56511294,1,48452996
H1|chr12:8058223-8058285,chr12,8058223,8058285,H1|chr12:56511218-56511294,chr12,56511218,56511294,1,48452995
H1|chr12:8068288-8068325,chr12,8068288,8068325,H1|chr12:8046167-8046256,chr12,8046167,8046256,1,22121
H1|chr12:8068288-8068317,chr12,8068288,8068317,H1|chr12:8046182-8046256,chr12,8046182,8046256,1,22106
H1|chr12:8068652-8068748,chr12,8068652,8068748,H1|chr12:8046182-8046247,chr12,8046182,8046247,1,22470
H1|chr12:8068654-8068739,chr12,8068654,8068739,H1|chr12:8046182-8046247,chr12,8046182,8046247,1,22472
H1|chr12:8121721-8121868,chr12,8121721,8121868,H1|chr12:8166498-8166534,chr12,8166498,8166534,1,44777
H1|chr12:8121870-8121984,chr12,8121870,8121984,H1|chr12:8166498-8166534,chr12,8166498,8166534,1,44628
H1|chr12:8123032-8123128,chr12,8123032,8123128,H1|chr12:8164571-8164632,chr12,8164571,8164632,1,41539
H1|chr12:8123039-8123128,chr12,8123039,8123128,H1|chr12:8164571-8164632,chr12,8164571,8164632,1,41532
H1|chr12:8875431-8875485,chr12,8875431,8875485,H1|chr12:8186539-8186598,chr12,8186539,8186598,1,688892
H1|chr12:9058960-9059060,chr12,9058960,9059060,H1|chr12:9061632-9061699,chr12,9061632,9061699,1,2672
H1|chr12:9058960-9059043,chr12,9058960,9059043,H1|chr12:9061632-9061699,chr12,9061632,9061699,1,2672
H1|chr12:9058965-9059063,chr12,9058965,9059063,H1|chr12:9062131-9062281,chr12,9062131,9062281,1,3166
H1|chr12:9059231-9059272,chr12,9059231,9059272,H1|chr12:9061842-9061941,chr12,9061842,9061941,1,2611
H1|chr12:9059499-9059541,chr12,9059499,9059541,H1|chr12:9063290-9063378,chr12,9063290,9063378,1,3791
H1|chr12:9060327-9060455,chr12,9060327,9060455,H1|chr12:9061616-9061652,chr12,9061616,9061652,1,1289
H1|chr12:9060334-9060359,chr12,9060334,9060359,H1|chr12:9062126-9062222,chr12,9062126,9062222,1,1792
H1|chr12:9060341-9060455,chr12,9060341,9060455,H1|chr12:9061616-9061652,chr12,9061616,9061652,1,1275
H1|chr12:9060354-9060504,chr12,9060354,9060504,H1|chr12:9061564-9061618,chr12,9061564,9061618,1,1210
H1|chr12:9060357-9060485,chr12,9060357,9060485,H1|chr12:9061575-9061597,chr12,9061575,9061597,1,1218
H1|chr12:9060367-9060474,chr12,9060367,9060474,H1|chr12:9062511-9062545,chr12,9062511,9062545,1,2144
H1|chr12:9060368-9060474,chr12,9060368,9060474,H1|chr12:9062511-9062545,chr12,9062511,9062545,1,2143
H1|chr12:24397950-24398021,chr12,24397950,24398021,H1|chr12:85304710-85304773,chr12,85304710,85304773,1,60906760
H1|chr12:24397951-24398021,chr12,24397951,24398021,H1|chr12:85304710-85304773,chr12,85304710,85304773,1,60906759
H1|chr12:26133640-26133712,chr12,26133640,26133712,H1|chr12:19593855-19593907,chr12,19593855,19593907,1,6539785
H1|chr12:26133640-26133710,chr12,26133640,26133710,H1|chr12:19593855-19593907,chr12,19593855,19593907,1,6539785
H1|chr12:26138728-26138807,chr12,26138728,26138807,H1|chr12:19594575-19594640,chr12,19594575,19594640,1,6544153
H1|chr12:26138728-26138805,chr12,26138728,26138805,H1|chr12:19594572-19594640,chr12,19594572,19594640,1,6544156
H1|chr12:26139999-26140143,chr12,26139999,26140143,H1|chr12:7052063-7052120,chr12,7052063,7052120,1,19087936
H1|chr12:26140149-26140242,chr12,26140149,26140242,H1|chr12:7052063-7052120,chr12,7052063,7052120,1,19088086
H1|chr12:31457335-31457376,chr12,31457335,31457376,H1|chr12:4383726-4383800,chr12,4383726,4383800,1,27073609
H1|chr12:31458794-31458905,chr12,31458794,31458905,H1|chr12:19595870-19595966,chr12,19595870,19595966,1,11862924
H1|chr12:31458851-31458905,chr12,31458851,31458905,H1|chr12:19595870-19595966,chr12,19595870,19595966,1,11862981
H1|chr12:31463141-31463223,chr12,31463141,31463223,H1|chr12:53847785-53847853,chr12,53847785,53847853,1,22384644
H1|chr12:31463141-31463218,chr12,31463141,31463218,H1|chr12:53847785-53847853,chr12,53847785,53847853,1,22384644
H1|chr12:31463414-31463509,chr12,31463414,31463509,H1|chr12:53847300-53847352,chr12,53847300,53847352,1,22383886
H1|chr12:31464842-31464901,chr12,31464842,31464901,H1|chr12:4385827-4385929,chr12,4385827,4385929,1,27079015
H1|chr12:31464842-31464890,chr12,31464842,31464890,H1|chr12:4385827-4385929,chr12,4385827,4385929,1,27079015
H1|chr12:31469268-31469349,chr12,31469268,31469349,H1|chr12:53847338-53847420,chr12,53847338,53847420,1,22378070
H1|chr12:31469268-31469330,chr12,31469268,31469330,H1|chr12:53847338-53847420,chr12,53847338,53847420,1,22378070
H1|chr12:31664749-31664861,chr12,31664749,31664861,H1|chr12:50560277-50560341,chr12,50560277,50560341,1,18895528
H1|chr12:31664780-31664862,chr12,31664780,31664862,H1|chr12:50560277-50560341,chr12,50560277,50560341,1,18895497
H1|chr12:31666039-31666177,chr12,31666039,31666177,H1|chr12:31475882-31475980,chr12,31475882,31475980,1,190157
H1|chr12:31666125-31666177,chr12,31666125,31666177,H1|chr12:31475882-31475980,chr12,31475882,31475980,1,190243
H1|chr12:31679034-31679081,chr12,31679034,31679081,H1|chr12:31476525-31476628,chr12,31476525,31476628,1,202509
H1|chr12:31679035-31679080,chr12,31679035,31679080,H1|chr12:31476525-31476628,chr12,31476525,31476628,1,202510
H1|chr12:32331995-32332127,chr12,32331995,32332127,H1|chr12:6772109-6772127,chr12,6772109,6772127,1,25559886
H1|chr12:32428474-32428543,chr12,32428474,32428543,H1|chr12:54655314-54655384,chr12,54655314,54655384,1,22226840
H1|chr12:32428505-32428543,chr12,32428505,32428543,H1|chr12:54655272-54655384,chr12,54655272,54655384,1,22226767
H1|chr12:32428506-32428543,chr12,32428506,32428543,H1|chr12:54655272-54655384,chr12,54655272,54655384,1,22226766
H1|chr12:32601257-32601356,chr12,32601257,32601356,H1|chr12:57115524-57115588,chr12,57115524,57115588,1,24514267
H1|chr12:32601788-32601852,chr12,32601788,32601852,H1|chr12:32114376-32114396,chr12,32114376,32114396,1,487412
H1|chr12:32602631-32602711,chr12,32602631,32602711,H1|chr12:76430192-76430262,chr12,76430192,76430262,1,43827561
H1|chr12:32605956-32606006,chr12,32605956,32606006,H1|chr12:65005841-65005958,chr12,65005841,65005958,1,32399885
H1|chr12:32605956-32605987,chr12,32605956,32605987,H1|chr12:65005841-65005960,chr12,65005841,65005960,1,32399885
H1|chr12:41186359-41186382,chr12,41186359,41186382,H1|chr12:57499727-57499764,chr12,57499727,57499764,1,16313368
H1|chr12:46783113-46783240,chr12,46783113,46783240,H1|chr12:56402366-56402386,chr12,56402366,56402386,1,9619253
H1|chr12:46783113-46783239,chr12,46783113,46783239,H1|chr12:56402365-56402386,chr12,56402365,56402386,1,9619252
H1|chr12:52217038-52217140,chr12,52217038,52217140,H1|chr12:52208754-52208773,chr12,52208754,52208773,1,8284
H1|chr12:52237157-52237248,chr12,52237157,52237248,H1|chr12:52207353-52207391,chr12,52207353,52207391,1,29804
H1|chr12:52238586-52238642,chr12,52238586,52238642,H1|chr12:56139935-56140047,chr12,56139935,56140047,1,3901349
H1|chr12:52238586-52238640,chr12,52238586,52238640,H1|chr12:56139935-56140047,chr12,56139935,56140047,1,3901349
H1|chr12:52238586-52238621,chr12,52238586,52238621,H1|chr12:56139935-56140047,chr12,56139935,56140047,1,3901349
H1|chr12:52240872-52240924,chr12,52240872,52240924,H1|chr12:49582042-49582093,chr12,49582042,49582093,1,2658830
H1|chr12:52242356-52242437,chr12,52242356,52242437,H1|chr12:52211217-52211276,chr12,52211217,52211276,1,31139
H1|chr12:52242357-52242437,chr12,52242357,52242437,H1|chr12:52211217-52211276,chr12,52211217,52211276,1,31140
H1|chr12:56131128-56131207,chr12,56131128,56131207,H1|chr12:56136967-56137017,chr12,56136967,56137017,1,5839
H1|chr12:56131129-56131207,chr12,56131129,56131207,H1|chr12:56136967-56137017,chr12,56136967,56137017,1,5838
H1|chr12:56131162-56131197,chr12,56131162,56131197,H1|chr12:56132017-56132119,chr12,56132017,56132119,1,855
H1|chr12:57650664-57650723,chr12,57650664,57650723,H1|chr12:57635805-57635857,chr12,57635805,57635857,1,14859
H1|chr12:57655188-57655206,chr12,57655188,57655206,H1|chr12:57636442-57636532,chr12,57636442,57636532,1,18746
H1|chr12:59717533-59717623,chr12,59717533,59717623,H1|chr12:64799114-64799197,chr12,64799114,64799197,1,5081581
H1|chr12:59717558-59717599,chr12,59717558,59717599,H1|chr12:64800557-64800615,chr12,64800557,64800615,1,5082999
H1|chr12:59718893-59718943,chr12,59718893,59718943,H1|chr12:120933034-120933062,chr12,120933034,120933062,1,61214141
H1|chr12:59720166-59720219,chr12,59720166,59720219,H1|chr12:46660325-46660353,chr12,46660325,46660353,1,13059841
H1|chr12:59720166-59720208,chr12,59720166,59720208,H1|chr12:46660325-46660353,chr12,46660325,46660353,1,13059841
H1|chr12:59720474-59720550,chr12,59720474,59720550,H1|chr12:70761292-70761344,chr12,70761292,70761344,1,11040818
H1|chr12:59722191-59722286,chr12,59722191,59722286,H1|chr12:46660819-46660865,chr12,46660819,46660865,1,13061372
H1|chr12:59722192-59722286,chr12,59722192,59722286,H1|chr12:46660819-46660865,chr12,46660819,46660865,1,13061373
H1|chr12:63110817-63110839,chr12,63110817,63110839,H1|chr12:57474571-57474627,chr12,57474571,57474627,1,5636246
H1|chr12:64258811-64258897,chr12,64258811,64258897,H1|chr12:51628926-51628996,chr12,51628926,51628996,1,12629885
H1|chr12:64258818-64258898,chr12,64258818,64258898,H1|chr12:51628926-51628996,chr12,51628926,51628996,1,12629892
H1|chr12:64274990-64275031,chr12,64274990,64275031,H1|chr12:62998571-62998647,chr12,62998571,62998647,1,1276419
H1|chr12:64274990-64275029,chr12,64274990,64275029,H1|chr12:62998571-62998647,chr12,62998571,62998647,1,1276419
H1|chr12:64277444-64277558,chr12,64277444,64277558,H1|chr12:56140101-56140148,chr12,56140101,56140148,1,8137343
H1|chr12:64277460-64277558,chr12,64277460,64277558,H1|chr12:56140101-56140134,chr12,56140101,56140134,1,8137359
H1|chr12:64280637-64280721,chr12,64280637,64280721,H1|chr12:62998640-62998669,chr12,62998640,62998669,1,1281997
H1|chr12:77266418-77266506,chr12,77266418,77266506,H1|chr12:76477316-76477364,chr12,76477316,76477364,1,789102
H1|chr12:79941259-79941409,chr12,79941259,79941409,H1|chr12:80084874-80084895,chr12,80084874,80084895,1,143615
H1|chr12:79945634-79945783,chr12,79945634,79945783,H1|chr12:80082727-80082815,chr12,80082727,80082815,1,137093
H1|chr12:79945638-79945737,chr12,79945638,79945737,H1|chr12:120556632-120556683,chr12,120556632,120556683,1,40610994
H1|chr12:79945719-79945778,chr12,79945719,79945778,H1|chr12:80082727-80082815,chr12,80082727,80082815,1,137008
H1|chr12:79947822-79947921,chr12,79947822,79947921,H1|chr12:79939566-79939592,chr12,79939566,79939592,1,8256
H1|chr12:95967461-95967508,chr12,95967461,95967508,H1|chr12:95946141-95946195,chr12,95946141,95946195,1,21320
H1|chr12:95967461-95967503,chr12,95967461,95967503,H1|chr12:95946141-95946195,chr12,95946141,95946195,1,21320
H1|chr12:95967973-95967995,chr12,95967973,95967995,H1|chr12:95946602-95946749,chr12,95946602,95946749,1,21371
H1|chr12:95968384-95968466,chr12,95968384,95968466,H1|chr12:95947041-95947136,chr12,95947041,95947136,1,21343
H1|chr12:95969156-95969201,chr12,95969156,95969201,H1|chr12:95947006-95947100,chr12,95947006,95947100,1,22150
H1|chr12:95969160-95969197,chr12,95969160,95969197,H1|chr12:95947006-95947100,chr12,95947006,95947100,1,22154
H1|chr12:97955211-97955257,chr12,97955211,97955257,H1|chr12:6813601-6813741,chr12,6813601,6813741,1,91141610
H1|chr12:102214704-102214788,chr12,102214704,102214788,H1|chr12:98990541-98990566,chr12,98990541,98990566,1,3224163
H1|chr12:114028202-114028239,chr12,114028202,114028239,H1|chr12:46660015-46660099,chr12,46660015,46660099,1,67368187
H1|chr12:120526703-120526758,chr12,120526703,120526758,H1|chr12:120633280-120633340,chr12,120633280,120633340,1,106577
H1|chr12:120529970-120530036,chr12,120529970,120530036,H1|chr12:120633668-120633743,chr12,120633668,120633743,1,103698
H1|chr12:120529971-120530035,chr12,120529971,120530035,H1|chr12:120633668-120633743,chr12,120633668,120633743,1,103697
H1|chr12:120544627-120544685,chr12,120544627,120544685,H1|chr12:120633593-120633661,chr12,120633593,120633661,1,88966
H1|chr12:120797710-120797748,chr12,120797710,120797748,H1|chr12:8398948-8398994,chr12,8398948,8398994,1,112398762
H1|chr12:120797710-120797733,chr12,120797710,120797733,H1|chr12:8398948-8398994,chr12,8398948,8398994,1,112398762
H1|chr12:120817729-120817787,chr12,120817729,120817787,H1|chr12:120962228-120962320,chr12,120962228,120962320,1,144499
H1|chr12:120817732-120817794,chr12,120817732,120817794,H1|chr12:120962785-120962847,chr12,120962785,120962847,1,145053
H1|chr12:120817732-120817793,chr12,120817732,120817793,H1|chr12:120962230-120962318,chr12,120962230,120962318,1,144498
H1|chr12:120817734-120817797,chr12,120817734,120817797,H1|chr12:120962238-120962324,chr12,120962238,120962324,1,144504
H1|chr12:125037805-125037856,chr12,125037805,125037856,H1|chr12:110718279-110718339,chr12,110718279,110718339,1,14319526
H1|chr12:125037808-125037856,chr12,125037808,125037856,H1|chr12:110718279-110718339,chr12,110718279,110718339,1,14319529
H1|chr12:125045072-125045178,chr12,125045072,125045178,H1|chr12:110721038-110721097,chr12,110721038,110721097,1,14324034
H1|chr12:125045088-125045178,chr12,125045088,125045178,H1|chr12:110721038-110721097,chr12,110721038,110721097,1,14324050
H1|chr12:125692012-125692107,chr12,125692012,125692107,H1|chr12:129311681-129311725,chr12,129311681,129311725,1,3619669
H1|chr12:130261715-130261837,chr12,130261715,130261837,H1|chr12:53401592-53401651,chr12,53401592,53401651,1,76860123
H1|chr12:130261715-130261806,chr12,130261715,130261806,H1|chr12:53401592-53401651,chr12,53401592,53401651,1,76860123
H1|chr12:130261716-130261837,chr12,130261716,130261837,H1|chr12:53401592-53401651,chr12,53401592,53401651,1,76860124
H1|chr13:28737205-28737237,chr13,28737205,28737237,H1|chr13:28676462-28676574,chr13,28676462,28676574,1,60743
H1|chr13:28986209-28986310,chr13,28986209,28986310,H1|chr13:30168915-30168946,chr13,30168915,30168946,1,1182706
H1|chr13:28988220-28988256,chr13,28988220,28988256,H1|chr13:30168526-30168676,chr13,30168526,30168676,1,1180306
H1|chr13:29049700-29049744,chr13,29049700,29049744,H1|chr13:37579296-37579331,chr13,37579296,37579331,1,8529596
H1|chr13:29056269-29056419,chr13,29056269,29056419,H1|chr13:37579032-37579088,chr13,37579032,37579088,1,8522763
H1|chr13:29056330-29056424,chr13,29056330,29056424,H1|chr13:37579032-37579088,chr13,37579032,37579088,1,8522702
H1|chr13:41151746-41151784,chr13,41151746,41151784,H1|chr13:50515125-50515237,chr13,50515125,50515237,1,9363379
H1|chr13:41151747-41151814,chr13,41151747,41151814,H1|chr13:50515125-50515237,chr13,50515125,50515237,1,9363378
H1|chr13:41165977-41166011,chr13,41165977,41166011,H1|chr13:50514859-50514879,chr13,50514859,50514879,1,9348882
H1|chr13:41170111-41170217,chr13,41170111,41170217,H1|chr13:42534123-42534167,chr13,42534123,42534167,1,1364012
H1|chr13:45082882-45082924,chr13,45082882,45082924,H1|chr13:45916942-45917049,chr13,45916942,45917049,1,834060
H1|chr13:51734992-51735070,chr13,51734992,51735070,H1|chr13:51797502-51797538,chr13,51797502,51797538,1,62510
H1|chr13:51734993-51735070,chr13,51734993,51735070,H1|chr13:51797502-51797538,chr13,51797502,51797538,1,62509
H1|chr13:51736779-51736910,chr13,51736779,51736910,H1|chr13:51751012-51751037,chr13,51751012,51751037,1,14233
H1|chr13:51736785-51736910,chr13,51736785,51736910,H1|chr13:51751012-51751037,chr13,51751012,51751037,1,14227
H1|chr13:51737432-51737546,chr13,51737432,51737546,H1|chr13:51751108-51751141,chr13,51751108,51751141,1,13676
H1|chr13:51745656-51745709,chr13,51745656,51745709,H1|chr13:51799022-51799069,chr13,51799022,51799069,1,53366
H1|chr13:51745678-51745736,chr13,51745678,51745736,H1|chr13:51798990-51799044,chr13,51798990,51799044,1,53312
H1|chr13:51812232-51812382,chr13,51812232,51812382,H1|chr13:51751195-51751287,chr13,51751195,51751287,1,61037
H1|chr13:51814424-51814453,chr13,51814424,51814453,H1|chr13:52159427-52159535,chr13,52159427,52159535,1,345003
H1|chr13:51829005-51829074,chr13,51829005,51829074,H1|chr13:52160060-52160114,chr13,52160060,52160114,1,331055
H1|chr13:54785029-54785151,chr13,54785029,54785151,H1|chr13:73355585-73355654,chr13,73355585,73355654,1,18570556
H1|chr13:54785029-54785110,chr13,54785029,54785110,H1|chr13:73355585-73355654,chr13,73355585,73355654,1,18570556
H1|chr13:54785074-54785151,chr13,54785074,54785151,H1|chr13:73355585-73355654,chr13,73355585,73355654,1,18570511
H1|chr13:56151994-56152102,chr13,56151994,56152102,H1|chr13:95360427-95360460,chr13,95360427,95360460,1,39208433
H1|chr13:56151994-56152101,chr13,56151994,56152101,H1|chr13:95360427-95360460,chr13,95360427,95360460,1,39208433
H1|chr13:56154852-56154874,chr13,56154852,56154874,H1|chr13:47127885-47127952,chr13,47127885,47127952,1,9026967
H1|chr13:56156179-56156327,chr13,56156179,56156327,H1|chr13:25876130-25876206,chr13,25876130,25876206,1,30280049
H1|chr13:56156253-56156327,chr13,56156253,56156327,H1|chr13:25876130-25876206,chr13,25876130,25876206,1,30280123
H1|chr13:56156292-56156441,chr13,56156292,56156441,H1|chr13:25878247-25878343,chr13,25878247,25878343,1,30278045
H1|chr13:56156306-56156364,chr13,56156306,56156364,H1|chr13:24007607-24007741,chr13,24007607,24007741,1,32148699
H1|chr13:56156532-56156587,chr13,56156532,56156587,H1|chr13:41363344-41363436,chr13,41363344,41363436,1,14793188
H1|chr13:56156538-56156587,chr13,56156538,56156587,H1|chr13:41363344-41363436,chr13,41363344,41363436,1,14793194
H1|chr13:56156923-56157030,chr13,56156923,56157030,H1|chr13:60740792-60740842,chr13,60740792,60740842,1,4583869
H1|chr13:56156930-56157030,chr13,56156930,56157030,H1|chr13:60740792-60740842,chr13,60740792,60740842,1,4583862
H1|chr13:56156948-56157030,chr13,56156948,56157030,H1|chr13:60740792-60740842,chr13,60740792,60740842,1,4583844
H1|chr13:56234646-56234688,chr13,56234646,56234688,H1|chr13:98631356-98631422,chr13,98631356,98631422,1,42396710
H1|chr13:56234651-56234688,chr13,56234651,56234688,H1|chr13:98631356-98631422,chr13,98631356,98631422,1,42396705
H1|chr13:56235167-56235231,chr13,56235167,56235231,H1|chr13:51750896-51750976,chr13,51750896,51750976,1,4484271
H1|chr13:56235167-56235226,chr13,56235167,56235226,H1|chr13:51750896-51750976,chr13,51750896,51750976,1,4484271
H1|chr13:56238772-56238885,chr13,56238772,56238885,H1|chr13:42619409-42619460,chr13,42619409,42619460,1,13619363
H1|chr13:56240461-56240494,chr13,56240461,56240494,H1|chr13:42620143-42620253,chr13,42620143,42620253,1,13620318
H1|chr13:56240462-56240504,chr13,56240462,56240504,H1|chr13:42620143-42620253,chr13,42620143,42620253,1,13620319
H1|chr13:56244688-56244813,chr13,56244688,56244813,H1|chr13:98630729-98630753,chr13,98630729,98630753,1,42386041
H1|chr13:56244688-56244795,chr13,56244688,56244795,H1|chr13:98630729-98630753,chr13,98630729,98630753,1,42386041
H1|chr13:56244689-56244813,chr13,56244689,56244813,H1|chr13:98630729-98630753,chr13,98630729,98630753,1,42386040
H1|chr13:93922250-93922345,chr13,93922250,93922345,H1|chr13:93878983-93879011,chr13,93878983,93879011,1,43267
H1|chr13:93922251-93922345,chr13,93922251,93922345,H1|chr13:93878983-93879011,chr13,93878983,93879011,1,43268
H1|chr13:107163215-107163314,chr13,107163215,107163314,H1|chr13:107187632-107187664,chr13,107187632,107187664,1,24417
H1|chr13:107166814-107166861,chr13,107166814,107166861,H1|chr13:107187924-107187992,chr13,107187924,107187992,1,21110
H1|chr13:114993512-114993551,chr13,114993512,114993551,H1|chr13:114995473-114995544,chr13,114995473,114995544,1,1961
H1|chr13:114994321-114994392,chr13,114994321,114994392,H1|chr13:114995537-114995616,chr13,114995537,114995616,1,1216
H1|chr13:114994483-114994523,chr13,114994483,114994523,H1|chr13:114995473-114995544,chr13,114995473,114995544,1,990
H1|chr14:23464429-23464500,chr14,23464429,23464500,H1|chr14:23449763-23449909,chr14,23449763,23449909,1,14666
H1|chr14:23630912-23630992,chr14,23630912,23630992,H1|chr14:24016946-24016986,chr14,24016946,24016986,1,386034
H1|chr14:23633243-23633299,chr14,23633243,23633299,H1|chr14:24042483-24042577,chr14,24042483,24042577,1,409240
H1|chr14:23633244-23633336,chr14,23633244,23633336,H1|chr14:24042483-24042577,chr14,24042483,24042577,1,409239
H1|chr14:23643706-23643735,chr14,23643706,23643735,H1|chr14:24044454-24044543,chr14,24044454,24044543,1,400748
H1|chr14:38658922-38658956,chr14,38658922,38658956,H1|chr14:38675199-38675307,chr14,38675199,38675307,1,16277
H1|chr14:38658922-38658954,chr14,38658922,38658954,H1|chr14:38675199-38675307,chr14,38675199,38675307,1,16277
H1|chr14:38660238-38660353,chr14,38660238,38660353,H1|chr14:38675116-38675147,chr14,38675116,38675147,1,14878
H1|chr14:38660287-38660405,chr14,38660287,38660405,H1|chr14:38674335-38674365,chr14,38674335,38674365,1,14048
H1|chr14:38660289-38660405,chr14,38660289,38660405,H1|chr14:38674335-38674365,chr14,38674335,38674365,1,14046
H1|chr14:38660291-38660422,chr14,38660291,38660422,H1|chr14:38676995-38677023,chr14,38676995,38677023,1,16704
H1|chr14:38660291-38660413,chr14,38660291,38660413,H1|chr14:38676995-38677023,chr14,38676995,38677023,1,16704
H1|chr14:38660295-38660445,chr14,38660295,38660445,H1|chr14:38675116-38675147,chr14,38675116,38675147,1,14821
H1|chr14:38660347-38660448,chr14,38660347,38660448,H1|chr14:38674759-38674839,chr14,38674759,38674839,1,14412
H1|chr14:38660347-38660389,chr14,38660347,38660389,H1|chr14:38674759-38674839,chr14,38674759,38674839,1,14412
H1|chr14:38660652-38660792,chr14,38660652,38660792,H1|chr14:38673847-38673980,chr14,38673847,38673980,1,13195
H1|chr14:38660951-38660999,chr14,38660951,38660999,H1|chr14:23450343-23450445,chr14,23450343,23450445,1,15210608
H1|chr14:38660952-38661001,chr14,38660952,38661001,H1|chr14:23450343-23450445,chr14,23450343,23450445,1,15210609
H1|chr14:38660952-38660994,chr14,38660952,38660994,H1|chr14:23450342-23450445,chr14,23450342,23450445,1,15210610
H1|chr14:38661041-38661162,chr14,38661041,38661162,H1|chr14:38673202-38673234,chr14,38673202,38673234,1,12161
H1|chr14:38661041-38661159,chr14,38661041,38661159,H1|chr14:38673202-38673234,chr14,38673202,38673234,1,12161
H1|chr14:38661080-38661121,chr14,38661080,38661121,H1|chr14:38673960-38674096,chr14,38673960,38674096,1,12880
H1|chr14:38661082-38661117,chr14,38661082,38661117,H1|chr14:38676924-38676971,chr14,38676924,38676971,1,15842
H1|chr14:38661097-38661137,chr14,38661097,38661137,H1|chr14:38675133-38675283,chr14,38675133,38675283,1,14036
H1|chr14:38661148-38661224,chr14,38661148,38661224,H1|chr14:38673915-38673986,chr14,38673915,38673986,1,12767
H1|chr14:38661182-38661290,chr14,38661182,38661290,H1|chr14:38676289-38676331,chr14,38676289,38676331,1,15107
H1|chr14:38661182-38661239,chr14,38661182,38661239,H1|chr14:38676267-38676331,chr14,38676267,38676331,1,15085
H1|chr14:38661197-38661308,chr14,38661197,38661308,H1|chr14:38673111-38673156,chr14,38673111,38673156,1,11914
H1|chr14:38661203-38661308,chr14,38661203,38661308,H1|chr14:38673111-38673156,chr14,38673111,38673156,1,11908
H1|chr14:38661606-38661695,chr14,38661606,38661695,H1|chr14:38676715-38676737,chr14,38676715,38676737,1,15109
H1|chr14:38661626-38661727,chr14,38661626,38661727,H1|chr14:38673911-38673958,chr14,38673911,38673958,1,12285
H1|chr14:38661649-38661733,chr14,38661649,38661733,H1|chr14:38677936-38677957,chr14,38677936,38677957,1,16287
H1|chr14:38662433-38662554,chr14,38662433,38662554,H1|chr14:38673213-38673251,chr14,38673213,38673251,1,10780
H1|chr14:38662433-38662545,chr14,38662433,38662545,H1|chr14:38673213-38673251,chr14,38673213,38673251,1,10780
H1|chr14:38662436-38662488,chr14,38662436,38662488,H1|chr14:38673687-38673785,chr14,38673687,38673785,1,11251
H1|chr14:38662475-38662559,chr14,38662475,38662559,H1|chr14:38673163-38673206,chr14,38673163,38673206,1,10688
H1|chr14:38662476-38662559,chr14,38662476,38662559,H1|chr14:38673164-38673206,chr14,38673164,38673206,1,10688
H1|chr14:38662755-38662901,chr14,38662755,38662901,H1|chr14:38674454-38674497,chr14,38674454,38674497,1,11699
H1|chr14:38662755-38662862,chr14,38662755,38662862,H1|chr14:38674454-38674497,chr14,38674454,38674497,1,11699
H1|chr14:38662755-38662824,chr14,38662755,38662824,H1|chr14:38673102-38673220,chr14,38673102,38673220,1,10347
H1|chr14:38662755-38662823,chr14,38662755,38662823,H1|chr14:38673102-38673220,chr14,38673102,38673220,1,10347
H1|chr14:38662756-38662829,chr14,38662756,38662829,H1|chr14:38674415-38674501,chr14,38674415,38674501,1,11659
H1|chr14:38662756-38662815,chr14,38662756,38662815,H1|chr14:38674415-38674501,chr14,38674415,38674501,1,11659
H1|chr14:38662758-38662874,chr14,38662758,38662874,H1|chr14:38675127-38675205,chr14,38675127,38675205,1,12369
H1|chr14:38662758-38662817,chr14,38662758,38662817,H1|chr14:38675127-38675205,chr14,38675127,38675205,1,12369
H1|chr14:38662788-38662874,chr14,38662788,38662874,H1|chr14:38672669-38672704,chr14,38672669,38672704,1,9881
H1|chr14:38662795-38662824,chr14,38662795,38662824,H1|chr14:38673159-38673212,chr14,38673159,38673212,1,10364
H1|chr14:38662795-38662823,chr14,38662795,38662823,H1|chr14:38673159-38673212,chr14,38673159,38673212,1,10364
H1|chr14:38662796-38662872,chr14,38662796,38662872,H1|chr14:38673183-38673211,chr14,38673183,38673211,1,10387
H1|chr14:38663005-38663127,chr14,38663005,38663127,H1|chr14:38672238-38672263,chr14,38672238,38672263,1,9233
H1|chr14:38663272-38663317,chr14,38663272,38663317,H1|chr14:38674335-38674380,chr14,38674335,38674380,1,11063
H1|chr14:38663432-38663508,chr14,38663432,38663508,H1|chr14:38673966-38674038,chr14,38673966,38674038,1,10534
H1|chr14:38664555-38664615,chr14,38664555,38664615,H1|chr14:38674527-38674614,chr14,38674527,38674614,1,9972
H1|chr14:38664688-38664704,chr14,38664688,38664704,H1|chr14:38672264-38672307,chr14,38672264,38672307,1,7576
H1|chr14:38664785-38664849,chr14,38664785,38664849,H1|chr14:38673040-38673092,chr14,38673040,38673092,1,8255
H1|chr14:38664797-38664860,chr14,38664797,38664860,H1|chr14:38675419-38675506,chr14,38675419,38675506,1,10622
H1|chr14:38664821-38664887,chr14,38664821,38664887,H1|chr14:38674533-38674642,chr14,38674533,38674642,1,9712
H1|chr14:38664826-38664886,chr14,38664826,38664886,H1|chr14:38675981-38676067,chr14,38675981,38676067,1,11155
H1|chr14:38664852-38664934,chr14,38664852,38664934,H1|chr14:38677488-38677542,chr14,38677488,38677542,1,12636
H1|chr14:38664852-38664931,chr14,38664852,38664931,H1|chr14:38677565-38677604,chr14,38677565,38677604,1,12713
H1|chr14:38664932-38665033,chr14,38664932,38665033,H1|chr14:38674533-38674564,chr14,38674533,38674564,1,9601
H1|chr14:38664993-38665022,chr14,38664993,38665022,H1|chr14:38672239-38672313,chr14,38672239,38672313,1,7246
H1|chr14:38664998-38665044,chr14,38664998,38665044,H1|chr14:38672284-38672415,chr14,38672284,38672415,1,7286
H1|chr14:38665101-38665153,chr14,38665101,38665153,H1|chr14:38673291-38673327,chr14,38673291,38673327,1,8190
H1|chr14:38665104-38665199,chr14,38665104,38665199,H1|chr14:38672434-38672469,chr14,38672434,38672469,1,7330
H1|chr14:38665106-38665140,chr14,38665106,38665140,H1|chr14:38676948-38677036,chr14,38676948,38677036,1,11842
H1|chr14:38665109-38665195,chr14,38665109,38665195,H1|chr14:38674560-38674577,chr14,38674560,38674577,1,9451
H1|chr14:38665113-38665195,chr14,38665113,38665195,H1|chr14:38674560-38674581,chr14,38674560,38674581,1,9447
H1|chr14:38665149-38665215,chr14,38665149,38665215,H1|chr14:38673469-38673504,chr14,38673469,38673504,1,8320
H1|chr14:38665221-38665241,chr14,38665221,38665241,H1|chr14:38672370-38672490,chr14,38672370,38672490,1,7149
H1|chr14:38665471-38665551,chr14,38665471,38665551,H1|chr14:38674749-38674783,chr14,38674749,38674783,1,9278
H1|chr14:38665483-38665557,chr14,38665483,38665557,H1|chr14:38672699-38672745,chr14,38672699,38672745,1,7216
H1|chr14:38665484-38665557,chr14,38665484,38665557,H1|chr14:38672699-38672745,chr14,38672699,38672745,1,7215
H1|chr14:38665506-38665611,chr14,38665506,38665611,H1|chr14:38674923-38674949,chr14,38674923,38674949,1,9417
H1|chr14:38665507-38665657,chr14,38665507,38665657,H1|chr14:38675993-38676104,chr14,38675993,38676104,1,10486
H1|chr14:38665600-38665662,chr14,38665600,38665662,H1|chr14:38672294-38672318,chr14,38672294,38672318,1,6694
H1|chr14:38665640-38665776,chr14,38665640,38665776,H1|chr14:38674943-38675017,chr14,38674943,38675017,1,9303
H1|chr14:38665643-38665719,chr14,38665643,38665719,H1|chr14:38674943-38675017,chr14,38674943,38675017,1,9300
H1|chr14:38665643-38665678,chr14,38665643,38665678,H1|chr14:38675993-38676104,chr14,38675993,38676104,1,10350
H1|chr14:38665752-38665837,chr14,38665752,38665837,H1|chr14:38672656-38672785,chr14,38672656,38672785,1,6904
H1|chr14:38665753-38665837,chr14,38665753,38665837,H1|chr14:38672656-38672781,chr14,38672656,38672781,1,6903
H1|chr14:38665753-38665774,chr14,38665753,38665774,H1|chr14:38672656-38672785,chr14,38672656,38672785,1,6903
H1|chr14:38665775-38665838,chr14,38665775,38665838,H1|chr14:38674190-38674258,chr14,38674190,38674258,1,8415
H1|chr14:38665776-38665838,chr14,38665776,38665838,H1|chr14:38674190-38674258,chr14,38674190,38674258,1,8414
H1|chr14:38665786-38665854,chr14,38665786,38665854,H1|chr14:38676823-38676922,chr14,38676823,38676922,1,11037
H1|chr14:38665803-38665854,chr14,38665803,38665854,H1|chr14:38676823-38676922,chr14,38676823,38676922,1,11020
H1|chr14:38665837-38665937,chr14,38665837,38665937,H1|chr14:38673484-38673540,chr14,38673484,38673540,1,7647
H1|chr14:38665837-38665927,chr14,38665837,38665927,H1|chr14:38673484-38673540,chr14,38673484,38673540,1,7647
H1|chr14:62175395-62175503,chr14,62175395,62175503,H1|chr14:62230101-62230197,chr14,62230101,62230197,1,54706
H1|chr14:62175449-62175503,chr14,62175449,62175503,H1|chr14:62230101-62230197,chr14,62230101,62230197,1,54652
H1|chr14:62175984-62176019,chr14,62175984,62176019,H1|chr14:62232132-62232244,chr14,62232132,62232244,1,56148
H1|chr14:64861580-64861614,chr14,64861580,64861614,H1|chr14:65011983-65012112,chr14,65011983,65012112,1,150403
H1|chr14:65332659-65332731,chr14,65332659,65332731,H1|chr14:64108093-64108157,chr14,64108093,64108157,1,1224566
H1|chr14:65332660-65332731,chr14,65332660,65332731,H1|chr14:64108093-64108157,chr14,64108093,64108157,1,1224567
H1|chr14:68968735-68968865,chr14,68968735,68968865,H1|chr14:35342722-35342767,chr14,35342722,35342767,1,33626013
H1|chr14:68968735-68968863,chr14,68968735,68968863,H1|chr14:35342722-35342767,chr14,35342722,35342767,1,33626013
H1|chr14:68968760-68968865,chr14,68968760,68968865,H1|chr14:35342722-35342767,chr14,35342722,35342767,1,33626038
H1|chr14:69407116-69407196,chr14,69407116,69407196,H1|chr14:71788826-71788884,chr14,71788826,71788884,1,2381710
H1|chr14:69407116-69407192,chr14,69407116,69407192,H1|chr14:71788826-71788884,chr14,71788826,71788884,1,2381710
H1|chr14:71124566-71124695,chr14,71124566,71124695,H1|chr14:74356674-74356796,chr14,74356674,74356796,1,3232108
H1|chr14:71124566-71124671,chr14,71124566,71124671,H1|chr14:74356674-74356795,chr14,74356674,74356795,1,3232108
H1|chr14:71394149-71394189,chr14,71394149,71394189,H1|chr14:70825230-70825336,chr14,70825230,70825336,1,568919
H1|chr14:71394151-71394186,chr14,71394151,71394186,H1|chr14:70825230-70825336,chr14,70825230,70825336,1,568921
H1|chr14:71394334-71394403,chr14,71394334,71394403,H1|chr14:51709727-51709760,chr14,51709727,51709760,1,19684607
H1|chr14:89764147-89764242,chr14,89764147,89764242,H1|chr14:20800335-20800370,chr14,20800335,20800370,1,68963812
H1|chr14:89812271-89812337,chr14,89812271,89812337,H1|chr14:56586549-56586632,chr14,56586549,56586632,1,33225722
H1|chr14:89813647-89813731,chr14,89813647,89813731,H1|chr14:91975251-91975307,chr14,91975251,91975307,1,2161604
H1|chr14:89813648-89813731,chr14,89813648,89813731,H1|chr14:91975251-91975307,chr14,91975251,91975307,1,2161603
H1|chr14:89821229-89821338,chr14,89821229,89821338,H1|chr14:91975151-91975220,chr14,91975151,91975220,1,2153922
H1|chr14:89821260-89821341,chr14,89821260,89821341,H1|chr14:91975151-91975220,chr14,91975151,91975220,1,2153891
H1|chr14:89824837-89824869,chr14,89824837,89824869,H1|chr14:93579975-93580019,chr14,93579975,93580019,1,3755138
H1|chr14:89848057-89848135,chr14,89848057,89848135,H1|chr14:21734857-21734921,chr14,21734857,21734921,1,68113200
H1|chr14:89850194-89850271,chr14,89850194,89850271,H1|chr14:21734857-21734921,chr14,21734857,21734921,1,68115337
H1|chr14:89854116-89854225,chr14,89854116,89854225,H1|chr14:99735926-99735957,chr14,99735926,99735957,1,9881810
H1|chr14:89854116-89854222,chr14,89854116,89854222,H1|chr14:99735926-99735957,chr14,99735926,99735957,1,9881810
H1|chr14:89856195-89856222,chr14,89856195,89856222,H1|chr14:59934682-59934783,chr14,59934682,59934783,1,29921513
H1|chr14:89856195-89856221,chr14,89856195,89856221,H1|chr14:59934682-59934783,chr14,59934682,59934783,1,29921513
H1|chr14:89861092-89861165,chr14,89861092,89861165,H1|chr14:59933974-59934026,chr14,59933974,59934026,1,29927118
H1|chr14:89908140-89908220,chr14,89908140,89908220,H1|chr14:30396121-30396191,chr14,30396121,30396191,1,59512019
H1|chr14:96345790-96345907,chr14,96345790,96345907,H1|chr14:91723180-91723272,chr14,91723180,91723272,1,4622610
H1|chr14:96345790-96345906,chr14,96345790,96345906,H1|chr14:91723180-91723272,chr14,91723180,91723272,1,4622610
H1|chr14:96345850-96345908,chr14,96345850,96345908,H1|chr14:91723180-91723272,chr14,91723180,91723272,1,4622670
H1|chr14:96353875-96353892,chr14,96353875,96353892,H1|chr14:90424188-90424282,chr14,90424188,90424282,1,5929687
H1|chr14:97037889-97037947,chr14,97037889,97037947,H1|chr14:91975320-91975399,chr14,91975320,91975399,1,5062569
H1|chr14:99721710-99721763,chr14,99721710,99721763,H1|chr14:74356377-74356434,chr14,74356377,74356434,1,25365333
H1|chr14:99722185-99722260,chr14,99722185,99722260,H1|chr14:99737888-99737955,chr14,99737888,99737955,1,15703
H1|chr14:99722186-99722260,chr14,99722186,99722260,H1|chr14:99737888-99737956,chr14,99737888,99737956,1,15702
H1|chr14:99723548-99723698,chr14,99723548,99723698,H1|chr14:99737959-99738099,chr14,99737959,99738099,1,14411
H1|chr14:99723585-99723646,chr14,99723585,99723646,H1|chr14:99737890-99737979,chr14,99737890,99737979,1,14305
H1|chr14:99723586-99723713,chr14,99723586,99723713,H1|chr14:99737890-99737979,chr14,99737890,99737979,1,14304
H1|chr14:99725563-99725630,chr14,99725563,99725630,H1|chr14:99737890-99737988,chr14,99737890,99737988,1,12327
H1|chr14:99725563-99725615,chr14,99725563,99725615,H1|chr14:99737890-99737988,chr14,99737890,99737988,1,12327
H1|chr14:99728084-99728153,chr14,99728084,99728153,H1|chr14:99737883-99737963,chr14,99737883,99737963,1,9799
H1|chr14:99728091-99728166,chr14,99728091,99728166,H1|chr14:99737882-99737963,chr14,99737882,99737963,1,9791
H1|chr14:99728100-99728166,chr14,99728100,99728166,H1|chr14:99737883-99737963,chr14,99737883,99737963,1,9783
H1|chr14:100132129-100132227,chr14,100132129,100132227,H1|chr14:100068853-100068905,chr14,100068853,100068905,1,63276
H1|chr14:100132130-100132242,chr14,100132130,100132242,H1|chr14:100068853-100068905,chr14,100068853,100068905,1,63277
H1|chr14:100661499-100661635,chr14,100661499,100661635,H1|chr14:100703625-100703654,chr14,100703625,100703654,1,42126
H1|chr14:100661510-100661631,chr14,100661510,100661631,H1|chr14:100703625-100703654,chr14,100703625,100703654,1,42115
H1|chr14:100661534-100661635,chr14,100661534,100661635,H1|chr14:100703625-100703654,chr14,100703625,100703654,1,42091
H1|chr14:100713049-100713106,chr14,100713049,100713106,H1|chr14:103060748-103060803,chr14,103060748,103060803,1,2347699
H1|chr14:105286793-105286841,chr14,105286793,105286841,H1|chr14:105330048-105330132,chr14,105330048,105330132,1,43255
H1|chr14:105288698-105288812,chr14,105288698,105288812,H1|chr14:105306174-105306309,chr14,105306174,105306309,1,17476
H1|chr14:105289997-105290056,chr14,105289997,105290056,H1|chr14:105306166-105306257,chr14,105306166,105306257,1,16169
H1|chr14:105291832-105291907,chr14,105291832,105291907,H1|chr14:105331122-105331158,chr14,105331122,105331158,1,39290
H1|chr14:105291832-105291905,chr14,105291832,105291905,H1|chr14:105331122-105331158,chr14,105331122,105331158,1,39290
H1|chr14:105311256-105311363,chr14,105311256,105311363,H1|chr14:105328680-105328723,chr14,105328680,105328723,1,17424
H1|chr14:105311349-105311499,chr14,105311349,105311499,H1|chr14:105328680-105328723,chr14,105328680,105328723,1,17331
H1|chr14:105312359-105312465,chr14,105312359,105312465,H1|chr14:105330224-105330260,chr14,105330224,105330260,1,17865
H1|chr14:105312377-105312447,chr14,105312377,105312447,H1|chr14:105329919-105329961,chr14,105329919,105329961,1,17542
H1|chr14:105313364-105313438,chr14,105313364,105313438,H1|chr14:105301079-105301127,chr14,105301079,105301127,1,12285
H1|chr14:105313912-105313974,chr14,105313912,105313974,H1|chr14:105330492-105330573,chr14,105330492,105330573,1,16580
H1|chr14:105313915-105313974,chr14,105313915,105313974,H1|chr14:105330492-105330573,chr14,105330492,105330573,1,16577
H1|chr14:105314636-105314728,chr14,105314636,105314728,H1|chr14:105329361-105329419,chr14,105329361,105329419,1,14725
H1|chr14:105314638-105314759,chr14,105314638,105314759,H1|chr14:105329361-105329419,chr14,105329361,105329419,1,14723
H1|chr14:105314644-105314704,chr14,105314644,105314704,H1|chr14:105329726-105329790,chr14,105329726,105329790,1,15082
H1|chr14:105315393-105315529,chr14,105315393,105315529,H1|chr14:105307081-105307187,chr14,105307081,105307187,1,8312
H1|chr14:105315612-105315712,chr14,105315612,105315712,H1|chr14:105328916-105328966,chr14,105328916,105328966,1,13304
H1|chr14:105315614-105315712,chr14,105315614,105315712,H1|chr14:105328916-105328966,chr14,105328916,105328966,1,13302
H1|chr14:105315706-105315786,chr14,105315706,105315786,H1|chr14:105330981-105331015,chr14,105330981,105331015,1,15275
H1|chr14:105315974-105316091,chr14,105315974,105316091,H1|chr14:105329104-105329253,chr14,105329104,105329253,1,13130
H1|chr14:105316466-105316511,chr14,105316466,105316511,H1|chr14:105329229-105329315,chr14,105329229,105329315,1,12763
H1|chr14:105316589-105316697,chr14,105316589,105316697,H1|chr14:105300200-105300229,chr14,105300200,105300229,1,16389
H1|chr14:105316589-105316669,chr14,105316589,105316669,H1|chr14:105330135-105330184,chr14,105330135,105330184,1,13546
H1|chr14:105317817-105317947,chr14,105317817,105317947,H1|chr14:105331047-105331135,chr14,105331047,105331135,1,13230
H1|chr14:105318410-105318445,chr14,105318410,105318445,H1|chr14:105329446-105329541,chr14,105329446,105329541,1,11036
H1|chr14:105318819-105318854,chr14,105318819,105318854,H1|chr14:105329669-105329784,chr14,105329669,105329784,1,10850
H1|chr14:105318863-105318909,chr14,105318863,105318909,H1|chr14:105307012-105307069,chr14,105307012,105307069,1,11851
H1|chr14:105318863-105318907,chr14,105318863,105318907,H1|chr14:105307012-105307069,chr14,105307012,105307069,1,11851
H1|chr14:105319955-105319977,chr14,105319955,105319977,H1|chr14:105328859-105328918,chr14,105328859,105328918,1,8904
H1|chr14:105319956-105319977,chr14,105319956,105319977,H1|chr14:105328859-105328918,chr14,105328859,105328918,1,8903
H1|chr14:105320048-105320074,chr14,105320048,105320074,H1|chr14:105329615-105329661,chr14,105329615,105329661,1,9567
H1|chr14:105320252-105320386,chr14,105320252,105320386,H1|chr14:105330983-105331010,chr14,105330983,105331010,1,10731
H1|chr14:105320252-105320375,chr14,105320252,105320375,H1|chr14:105330983-105331010,chr14,105330983,105331010,1,10731
H1|chr14:105320285-105320339,chr14,105320285,105320339,H1|chr14:105327862-105327946,chr14,105327862,105327946,1,7577
H1|chr14:105320287-105320339,chr14,105320287,105320339,H1|chr14:105327862-105327946,chr14,105327862,105327946,1,7575
H1|chr14:105320393-105320450,chr14,105320393,105320450,H1|chr14:105330754-105330889,chr14,105330754,105330889,1,10361
H1|chr14:105320414-105320464,chr14,105320414,105320464,H1|chr14:105329813-105329868,chr14,105329813,105329868,1,9399
H1|chr14:105320861-105320947,chr14,105320861,105320947,H1|chr14:105329886-105329929,chr14,105329886,105329929,1,9025
H1|chr14:105320946-105321020,chr14,105320946,105321020,H1|chr14:105327422-105327478,chr14,105327422,105327478,1,6476
H1|chr14:105320985-105321133,chr14,105320985,105321133,H1|chr14:105327590-105327633,chr14,105327590,105327633,1,6605
H1|chr14:105321241-105321284,chr14,105321241,105321284,H1|chr14:105327073-105327100,chr14,105327073,105327100,1,5832
H1|chr14:105321358-105321418,chr14,105321358,105321418,H1|chr14:105327070-105327126,chr14,105327070,105327126,1,5712
H1|chr14:105321473-105321506,chr14,105321473,105321506,H1|chr14:105326890-105326921,chr14,105326890,105326921,1,5417
H1|chr14:105321473-105321505,chr14,105321473,105321505,H1|chr14:105329513-105329567,chr14,105329513,105329567,1,8040
H1|chr14:105321481-105321506,chr14,105321481,105321506,H1|chr14:105326890-105326921,chr14,105326890,105326921,1,5409
H1|chr14:105321486-105321505,chr14,105321486,105321505,H1|chr14:105329513-105329571,chr14,105329513,105329571,1,8027
H1|chr14:105321631-105321719,chr14,105321631,105321719,H1|chr14:105326841-105326884,chr14,105326841,105326884,1,5210
H1|chr14:105321658-105321763,chr14,105321658,105321763,H1|chr14:105326690-105326751,chr14,105326690,105326751,1,5032
H1|chr14:105321658-105321731,chr14,105321658,105321731,H1|chr14:105326637-105326681,chr14,105326637,105326681,1,4979
H1|chr14:105321658-105321728,chr14,105321658,105321728,H1|chr14:105326963-105326983,chr14,105326963,105326983,1,5305
H1|chr14:105321676-105321763,chr14,105321676,105321763,H1|chr14:105326690-105326751,chr14,105326690,105326751,1,5014
H1|chr14:105321692-105321763,chr14,105321692,105321763,H1|chr14:105326690-105326751,chr14,105326690,105326751,1,4998
H1|chr14:105321825-105321940,chr14,105321825,105321940,H1|chr14:105328862-105328954,chr14,105328862,105328954,1,7037
H1|chr14:105321882-105321940,chr14,105321882,105321940,H1|chr14:105328862-105328954,chr14,105328862,105328954,1,6980
H1|chr14:105322258-105322322,chr14,105322258,105322322,H1|chr14:105328859-105328917,chr14,105328859,105328917,1,6601
H1|chr14:105322259-105322308,chr14,105322259,105322308,H1|chr14:105328859-105328918,chr14,105328859,105328918,1,6600
H1|chr14:105322724-105322798,chr14,105322724,105322798,H1|chr14:105329908-105329984,chr14,105329908,105329984,1,7184
H1|chr14:105322725-105322847,chr14,105322725,105322847,H1|chr14:105329908-105329984,chr14,105329908,105329984,1,7183
H1|chr14:105323197-105323286,chr14,105323197,105323286,H1|chr14:105329211-105329288,chr14,105329211,105329288,1,6014
H1|chr14:105323213-105323286,chr14,105323213,105323286,H1|chr14:105329211-105329288,chr14,105329211,105329288,1,5998
H1|chr14:105323241-105323323,chr14,105323241,105323323,H1|chr14:105327422-105327478,chr14,105327422,105327478,1,4181
H1|chr15:25781145-25781182,chr15,25781145,25781182,H1|chr15:25684312-25684462,chr15,25684312,25684462,1,96833
H1|chr15:25783888-25784038,chr15,25783888,25784038,H1|chr15:25687757-25687795,chr15,25687757,25687795,1,96131
H1|chr15:25783943-25784055,chr15,25783943,25784055,H1|chr15:25687757-25687795,chr15,25687757,25687795,1,96186
H1|chr15:25784436-25784561,chr15,25784436,25784561,H1|chr15:25687563-25687626,chr15,25687563,25687626,1,96873
H1|chr15:25784474-25784561,chr15,25784474,25784561,H1|chr15:25687563-25687626,chr15,25687563,25687626,1,96911
H1|chr15:25784587-25784607,chr15,25784587,25784607,H1|chr15:25687832-25687919,chr15,25687832,25687919,1,96755
H1|chr15:26893511-26893566,chr15,26893511,26893566,H1|chr15:25202011-25202058,chr15,25202011,25202058,1,1691500
H1|chr15:26928127-26928185,chr15,26928127,26928185,H1|chr15:63337013-63337086,chr15,63337013,63337086,1,36408886
H1|chr15:26928128-26928185,chr15,26928128,26928185,H1|chr15:63337013-63337086,chr15,63337013,63337086,1,36408885
H1|chr15:28835001-28835151,chr15,28835001,28835151,H1|chr15:28566896-28567046,chr15,28566896,28567046,1,268105
H1|chr15:28835011-28835161,chr15,28835011,28835161,H1|chr15:28566669-28566816,chr15,28566669,28566816,1,268342
H1|chr15:28835020-28835170,chr15,28835020,28835170,H1|chr15:28566878-28567028,chr15,28566878,28567028,1,268142
H1|chr15:28835026-28835176,chr15,28835026,28835176,H1|chr15:28566865-28566936,chr15,28566865,28566936,1,268161
H1|chr15:28835026-28835175,chr15,28835026,28835175,H1|chr15:28566824-28566974,chr15,28566824,28566974,1,268202
H1|chr15:28835042-28835192,chr15,28835042,28835192,H1|chr15:28566666-28566691,chr15,28566666,28566691,1,268376
H1|chr15:28835043-28835193,chr15,28835043,28835193,H1|chr15:28566950-28567077,chr15,28566950,28567077,1,268093
H1|chr15:28835046-28835195,chr15,28835046,28835195,H1|chr15:28566822-28566944,chr15,28566822,28566944,1,268224
H1|chr15:40178354-40178392,chr15,40178354,40178392,H1|chr15:41625209-41625321,chr15,41625209,41625321,1,1446855
H1|chr15:40188217-40188255,chr15,40188217,40188255,H1|chr15:34634867-34634979,chr15,34634867,34634979,1,5553350
H1|chr15:40188283-40188368,chr15,40188283,40188368,H1|chr15:34634460-34634525,chr15,34634460,34634525,1,5553823
H1|chr15:40196862-40196969,chr15,40196862,40196969,H1|chr15:41244541-41244617,chr15,41244541,41244617,1,1047679
H1|chr15:40196862-40196932,chr15,40196862,40196932,H1|chr15:41244537-41244617,chr15,41244537,41244617,1,1047675
H1|chr15:40196862-40196931,chr15,40196862,40196931,H1|chr15:41244541-41244617,chr15,41244541,41244617,1,1047679
H1|chr15:40198517-40198567,chr15,40198517,40198567,H1|chr15:40074484-40074535,chr15,40074484,40074535,1,124033
H1|chr15:40198518-40198568,chr15,40198518,40198568,H1|chr15:40074485-40074535,chr15,40074485,40074535,1,124033
H1|chr15:40198538-40198568,chr15,40198538,40198568,H1|chr15:40074485-40074535,chr15,40074485,40074535,1,124053
H1|chr15:53088466-53088492,chr15,53088466,53088492,H1|chr15:53082280-53082385,chr15,53082280,53082385,1,6186
H1|chr15:53091392-53091415,chr15,53091392,53091415,H1|chr15:53083414-53083494,chr15,53083414,53083494,1,7978
H1|chr15:53093107-53093159,chr15,53093107,53093159,H1|chr15:53087079-53087125,chr15,53087079,53087125,1,6028
H1|chr15:53093107-53093158,chr15,53093107,53093158,H1|chr15:53087079-53087125,chr15,53087079,53087125,1,6028
H1|chr15:53094172-53094262,chr15,53094172,53094262,H1|chr15:53086262-53086320,chr15,53086262,53086320,1,7910
H1|chr15:53094172-53094258,chr15,53094172,53094258,H1|chr15:53086262-53086320,chr15,53086262,53086320,1,7910
H1|chr15:53094234-53094312,chr15,53094234,53094312,H1|chr15:53085415-53085494,chr15,53085415,53085494,1,8819
H1|chr15:53094234-53094301,chr15,53094234,53094301,H1|chr15:53085415-53085494,chr15,53085415,53085494,1,8819
H1|chr15:53094288-53094383,chr15,53094288,53094383,H1|chr15:53085880-53085971,chr15,53085880,53085971,1,8408
H1|chr15:53094327-53094386,chr15,53094327,53094386,H1|chr15:53085880-53085971,chr15,53085880,53085971,1,8447
H1|chr15:53094407-53094454,chr15,53094407,53094454,H1|chr15:53084024-53084127,chr15,53084024,53084127,1,10383
H1|chr15:53094481-53094546,chr15,53094481,53094546,H1|chr15:53084024-53084127,chr15,53084024,53084127,1,10457
H1|chr15:53095200-53095243,chr15,53095200,53095243,H1|chr15:53073458-53073535,chr15,53073458,53073535,1,21742
H1|chr15:53095845-53095914,chr15,53095845,53095914,H1|chr15:53082829-53082962,chr15,53082829,53082962,1,13016
H1|chr15:53096839-53096897,chr15,53096839,53096897,H1|chr15:53076121-53076195,chr15,53076121,53076195,1,20718
H1|chr15:59611758-59611829,chr15,59611758,59611829,H1|chr15:70386282-70386311,chr15,70386282,70386311,1,10774524
H1|chr15:59611759-59611829,chr15,59611759,59611829,H1|chr15:70386282-70386311,chr15,70386282,70386311,1,10774523
H1|chr15:62745300-62745353,chr15,62745300,62745353,H1|chr15:63342904-63342998,chr15,63342904,63342998,1,597604
H1|chr15:62745338-62745413,chr15,62745338,62745413,H1|chr15:63342904-63342998,chr15,63342904,63342998,1,597566
H1|chr15:62749781-62749855,chr15,62749781,62749855,H1|chr15:63336427-63336469,chr15,63336427,63336469,1,586646
H1|chr15:62752355-62752393,chr15,62752355,62752393,H1|chr15:63336433-63336528,chr15,63336433,63336528,1,584078
H1|chr15:62752509-62752558,chr15,62752509,62752558,H1|chr15:63344666-63344815,chr15,63344666,63344815,1,592157
H1|chr15:64927179-64927213,chr15,64927179,64927213,H1|chr15:63341705-63341821,chr15,63341705,63341821,1,1585474
H1|chr15:64927180-64927244,chr15,64927180,64927244,H1|chr15:63341705-63341821,chr15,63341705,63341821,1,1585475
H1|chr15:64984326-64984370,chr15,64984326,64984370,H1|chr15:64995632-64995707,chr15,64995632,64995707,1,11306
H1|chr15:64985162-64985203,chr15,64985162,64985203,H1|chr15:64995568-64995718,chr15,64995568,64995718,1,10406
H1|chr15:64985771-64985815,chr15,64985771,64985815,H1|chr15:64995903-64996009,chr15,64995903,64996009,1,10132
H1|chr15:64986020-64986071,chr15,64986020,64986071,H1|chr15:40702234-40702357,chr15,40702234,40702357,1,24283786
H1|chr15:65023868-65023907,chr15,65023868,65023907,H1|chr15:64995122-64995237,chr15,64995122,64995237,1,28746
H1|chr15:65023868-65023900,chr15,65023868,65023900,H1|chr15:64995122-64995237,chr15,64995122,64995237,1,28746
H1|chr15:65024007-65024065,chr15,65024007,65024065,H1|chr15:64994550-64994568,chr15,64994550,64994568,1,29457
H1|chr15:65024503-65024584,chr15,65024503,65024584,H1|chr15:65713341-65713379,chr15,65713341,65713379,1,688838
H1|chr15:65024507-65024584,chr15,65024507,65024584,H1|chr15:65713341-65713379,chr15,65713341,65713379,1,688834
H1|chr15:65024633-65024661,chr15,65024633,65024661,H1|chr15:65122246-65122382,chr15,65122246,65122382,1,97613
H1|chr15:65024823-65024895,chr15,65024823,65024895,H1|chr15:64994719-64994797,chr15,64994719,64994797,1,30104
H1|chr15:65024856-65024933,chr15,65024856,65024933,H1|chr15:64994991-64995064,chr15,64994991,64995064,1,29865
H1|chr15:65098315-65098348,chr15,65098315,65098348,H1|chr15:65071401-65071458,chr15,65071401,65071458,1,26914
H1|chr15:65100595-65100698,chr15,65100595,65100698,H1|chr15:65070203-65070258,chr15,65070203,65070258,1,30392
H1|chr15:65100595-65100685,chr15,65100595,65100685,H1|chr15:65070203-65070258,chr15,65070203,65070258,1,30392
H1|chr15:65128348-65128429,chr15,65128348,65128429,H1|chr15:65130916-65130948,chr15,65130916,65130948,1,2568
H1|chr15:65128348-65128414,chr15,65128348,65128414,H1|chr15:65119495-65119645,chr15,65119495,65119645,1,8853
H1|chr15:65128401-65128467,chr15,65128401,65128467,H1|chr15:65130584-65130667,chr15,65130584,65130667,1,2183
H1|chr15:65128401-65128462,chr15,65128401,65128462,H1|chr15:65130584-65130667,chr15,65130584,65130667,1,2183
H1|chr15:65128420-65128452,chr15,65128420,65128452,H1|chr15:65132263-65132330,chr15,65132263,65132330,1,3843
H1|chr15:65128424-65128452,chr15,65128424,65128452,H1|chr15:65132263-65132330,chr15,65132263,65132330,1,3839
H1|chr15:65128461-65128559,chr15,65128461,65128559,H1|chr15:65131163-65131215,chr15,65131163,65131215,1,2702
H1|chr15:65128500-65128559,chr15,65128500,65128559,H1|chr15:65131163-65131215,chr15,65131163,65131215,1,2663
H1|chr15:65128530-65128584,chr15,65128530,65128584,H1|chr15:65130455-65130558,chr15,65130455,65130558,1,1925
H1|chr15:65128530-65128576,chr15,65128530,65128576,H1|chr15:65130455-65130558,chr15,65130455,65130558,1,1925
H1|chr15:65128539-65128587,chr15,65128539,65128587,H1|chr15:65131706-65131744,chr15,65131706,65131744,1,3167
H1|chr15:65128540-65128646,chr15,65128540,65128646,H1|chr15:65131759-65131783,chr15,65131759,65131783,1,3219
H1|chr15:65128548-65128637,chr15,65128548,65128637,H1|chr15:65122295-65122392,chr15,65122295,65122392,1,6253
H1|chr15:65128551-65128591,chr15,65128551,65128591,H1|chr15:65132595-65132726,chr15,65132595,65132726,1,4044
H1|chr15:65128572-65128591,chr15,65128572,65128591,H1|chr15:65132595-65132726,chr15,65132595,65132726,1,4023
H1|chr15:65128586-65128638,chr15,65128586,65128638,H1|chr15:65122295-65122392,chr15,65122295,65122392,1,6291
H1|chr15:65147679-65147770,chr15,65147679,65147770,H1|chr15:65130927-65130952,chr15,65130927,65130952,1,16752
H1|chr15:65147680-65147770,chr15,65147680,65147770,H1|chr15:65130927-65130952,chr15,65130927,65130952,1,16753
H1|chr15:65147681-65147770,chr15,65147681,65147770,H1|chr15:65130927-65130952,chr15,65130927,65130952,1,16754
H1|chr15:65164173-65164207,chr15,65164173,65164207,H1|chr15:65129205-65129299,chr15,65129205,65129299,1,34968
H1|chr15:65166099-65166171,chr15,65166099,65166171,H1|chr15:65131016-65131092,chr15,65131016,65131092,1,35083
H1|chr15:65698275-65698356,chr15,65698275,65698356,H1|chr15:93614880-93614904,chr15,93614880,93614904,1,27916605
H1|chr15:65698275-65698355,chr15,65698275,65698355,H1|chr15:93614880-93614904,chr15,93614880,93614904,1,27916605
H1|chr15:66704270-66704330,chr15,66704270,66704330,H1|chr15:64992699-64992731,chr15,64992699,64992731,1,1711571
H1|chr15:66709854-66709895,chr15,66709854,66709895,H1|chr15:64993342-64993437,chr15,64993342,64993437,1,1716512
H1|chr15:66709854-66709894,chr15,66709854,66709894,H1|chr15:64993342-64993437,chr15,64993342,64993437,1,1716512
H1|chr15:66758986-66759029,chr15,66758986,66759029,H1|chr15:41053028-41053135,chr15,41053028,41053135,1,25705958
H1|chr15:66758987-66759029,chr15,66758987,66759029,H1|chr15:41053028-41053135,chr15,41053028,41053135,1,25705959
H1|chr15:68073248-68073298,chr15,68073248,68073298,H1|chr15:68116415-68116467,chr15,68116415,68116467,1,43167
H1|chr15:68076276-68076383,chr15,68076276,68076383,H1|chr15:68110216-68110282,chr15,68110216,68110282,1,33940
H1|chr15:68076299-68076383,chr15,68076299,68076383,H1|chr15:68110216-68110282,chr15,68110216,68110282,1,33917
H1|chr15:68083304-68083380,chr15,68083304,68083380,H1|chr15:68107906-68107944,chr15,68107906,68107944,1,24602
H1|chr15:68083304-68083343,chr15,68083304,68083343,H1|chr15:68107906-68107944,chr15,68107906,68107944,1,24602
H1|chr15:71678706-71678797,chr15,71678706,71678797,H1|chr15:67359896-67359928,chr15,67359896,67359928,1,4318810
H1|chr15:71678707-71678797,chr15,71678707,71678797,H1|chr15:67359896-67359928,chr15,67359896,67359928,1,4318811
H1|chr15:71678707-71678793,chr15,71678707,71678793,H1|chr15:67359896-67359928,chr15,67359896,67359928,1,4318811
H1|chr15:72929407-72929556,chr15,72929407,72929556,H1|chr15:74392546-74392562,chr15,74392546,74392562,1,1463139
H1|chr15:72929408-72929557,chr15,72929408,72929557,H1|chr15:74392546-74392623,chr15,74392546,74392623,1,1463138
H1|chr15:72929433-72929583,chr15,72929433,72929583,H1|chr15:74392546-74392568,chr15,74392546,74392568,1,1463113
H1|chr15:78607284-78607323,chr15,78607284,78607323,H1|chr15:78630829-78630878,chr15,78630829,78630878,1,23545
H1|chr15:78621232-78621382,chr15,78621232,78621382,H1|chr15:78631437-78631471,chr15,78631437,78631471,1,10205
H1|chr15:78621321-78621437,chr15,78621321,78621437,H1|chr15:78631437-78631471,chr15,78631437,78631471,1,10116
H1|chr15:78623206-78623224,chr15,78623206,78623224,H1|chr15:78627781-78627890,chr15,78627781,78627890,1,4575
H1|chr15:85937946-85937984,chr15,85937946,85937984,H1|chr15:85294483-85294557,chr15,85294483,85294557,1,643463
H1|chr15:85937946-85937970,chr15,85937946,85937970,H1|chr15:85294483-85294557,chr15,85294483,85294557,1,643463
H1|chr15:85937996-85938146,chr15,85937996,85938146,H1|chr15:85294483-85294557,chr15,85294483,85294557,1,643513
H1|chr15:89047595-89047689,chr15,89047595,89047689,H1|chr15:59226453-59226536,chr15,59226453,59226536,1,29821142
H1|chr15:89047624-89047691,chr15,89047624,89047691,H1|chr15:59226453-59226536,chr15,59226453,59226536,1,29821171
H1|chr15:89153255-89153334,chr15,89153255,89153334,H1|chr15:89161319-89161400,chr15,89161319,89161400,1,8064
H1|chr15:89153265-89153334,chr15,89153265,89153334,H1|chr15:89161319-89161400,chr15,89161319,89161400,1,8054
H1|chr15:89154607-89154688,chr15,89154607,89154688,H1|chr15:89160331-89160381,chr15,89160331,89160381,1,5724
H1|chr15:89154607-89154664,chr15,89154607,89154664,H1|chr15:89160331-89160381,chr15,89160331,89160381,1,5724
H1|chr15:89154739-89154838,chr15,89154739,89154838,H1|chr15:89160331-89160381,chr15,89160331,89160381,1,5592
H1|chr15:89445379-89445406,chr15,89445379,89445406,H1|chr15:89441345-89441461,chr15,89441345,89441461,1,4034
H1|chr15:89446817-89446894,chr15,89446817,89446894,H1|chr15:89441540-89441603,chr15,89441540,89441603,1,5277
H1|chr15:89446817-89446892,chr15,89446817,89446892,H1|chr15:89441540-89441603,chr15,89441540,89441603,1,5277
H1|chr15:89446895-89446947,chr15,89446895,89446947,H1|chr15:89441552-89441611,chr15,89441552,89441611,1,5343
H1|chr15:89450844-89450888,chr15,89450844,89450888,H1|chr15:89440295-89440364,chr15,89440295,89440364,1,10549
H1|chr15:92505161-92505205,chr15,92505161,92505205,H1|chr15:77713817-77713850,chr15,77713817,77713850,1,14791344
H1|chr15:92554946-92555006,chr15,92554946,92555006,H1|chr15:30113130-30113220,chr15,30113130,30113220,1,62441816
H1|chr15:92554947-92555047,chr15,92554947,92555047,H1|chr15:30113130-30113220,chr15,30113130,30113220,1,62441817
H1|chr15:93463116-93463180,chr15,93463116,93463180,H1|chr15:93615313-93615355,chr15,93615313,93615355,1,152197
H1|chr15:93463119-93463180,chr15,93463119,93463180,H1|chr15:93615313-93615355,chr15,93615313,93615355,1,152194
H1|chr15:93465751-93465784,chr15,93465751,93465784,H1|chr15:93612814-93612928,chr15,93612814,93612928,1,147063
H1|chr15:93465753-93465829,chr15,93465753,93465829,H1|chr15:93612814-93612928,chr15,93612814,93612928,1,147061
H1|chr15:99206248-99206326,chr15,99206248,99206326,H1|chr15:99191843-99191893,chr15,99191843,99191893,1,14405
H1|chr15:99206248-99206323,chr15,99206248,99206323,H1|chr15:99191843-99191893,chr15,99191843,99191893,1,14405
H1|chr15:99206318-99206379,chr15,99206318,99206379,H1|chr15:93613375-93613435,chr15,93613375,93613435,1,5592943
H1|chr15:99206901-99206963,chr15,99206901,99206963,H1|chr15:93611855-93611984,chr15,93611855,93611984,1,5595046
H1|chr15:99206901-99206916,chr15,99206901,99206916,H1|chr15:93611855-93611984,chr15,93611855,93611984,1,5595046
H1|chr15:99234332-99234443,chr15,99234332,99234443,H1|chr15:93614933-93614957,chr15,93614933,93614957,1,5619399
H1|chr15:99243856-99243887,chr15,99243856,99243887,H1|chr15:68522617-68522658,chr15,68522617,68522658,1,30721239
H1|chr15:99256239-99256291,chr15,99256239,99256291,H1|chr15:99191454-99191526,chr15,99191454,99191526,1,64785
H1|chr15:99256269-99256296,chr15,99256269,99256296,H1|chr15:99191889-99191984,chr15,99191889,99191984,1,64380
H1|chr15:99256269-99256294,chr15,99256269,99256294,H1|chr15:99191889-99191984,chr15,99191889,99191984,1,64380
H1|chr15:99266121-99266156,chr15,99266121,99266156,H1|chr15:93427205-93427314,chr15,93427205,93427314,1,5838916
H1|chr15:99270444-99270478,chr15,99270444,99270478,H1|chr15:101790426-101790503,chr15,101790426,101790503,1,2519982
H1|chr15:99270444-99270476,chr15,99270444,99270476,H1|chr15:101790426-101790503,chr15,101790426,101790503,1,2519982
H1|chr15:99272827-99272896,chr15,99272827,99272896,H1|chr15:93427205-93427273,chr15,93427205,93427273,1,5845622
H1|chr15:99272828-99272951,chr15,99272828,99272951,H1|chr15:93427250-93427274,chr15,93427250,93427274,1,5845578
H1|chr15:99308099-99308186,chr15,99308099,99308186,H1|chr15:78438981-78439028,chr15,78438981,78439028,1,20869118
H1|chr15:99308101-99308186,chr15,99308101,99308186,H1|chr15:78438981-78439028,chr15,78438981,78439028,1,20869120
H1|chr15:99310236-99310271,chr15,99310236,99310271,H1|chr15:99191860-99192005,chr15,99191860,99192005,1,118376
H1|chr15:99313341-99313486,chr15,99313341,99313486,H1|chr15:64993636-64993741,chr15,64993636,64993741,1,34319705
H1|chr15:99313447-99313486,chr15,99313447,99313486,H1|chr15:64993636-64993741,chr15,64993636,64993741,1,34319811
H1|chr15:99315811-99315866,chr15,99315811,99315866,H1|chr15:91498795-91498883,chr15,91498795,91498883,1,7817016
H1|chr15:99316597-99316620,chr15,99316597,99316620,H1|chr15:89166644-89166719,chr15,89166644,89166719,1,10149953
H1|chr15:99318581-99318611,chr15,99318581,99318611,H1|chr15:89165602-89165735,chr15,89165602,89165735,1,10152979
H1|chr15:99319857-99319931,chr15,99319857,99319931,H1|chr15:99191845-99191884,chr15,99191845,99191884,1,128012
H1|chr15:99319857-99319930,chr15,99319857,99319930,H1|chr15:99191845-99191884,chr15,99191845,99191884,1,128012
H1|chr15:99319994-99320024,chr15,99319994,99320024,H1|chr15:99191854-99191870,chr15,99191854,99191870,1,128140
H1|chr15:99334292-99334358,chr15,99334292,99334358,H1|chr15:64992893-64992966,chr15,64992893,64992966,1,34341399
H1|chr15:99338834-99338905,chr15,99338834,99338905,H1|chr15:100106844-100106890,chr15,100106844,100106890,1,768010
H1|chr15:99338834-99338904,chr15,99338834,99338904,H1|chr15:100106844-100106890,chr15,100106844,100106890,1,768010
H1|chr15:99341838-99341860,chr15,99341838,99341860,H1|chr15:99192035-99192124,chr15,99192035,99192124,1,149803
H1|chr15:99343918-99343956,chr15,99343918,99343956,H1|chr15:69109909-69109936,chr15,69109909,69109936,1,30234009
H1|chr15:99343927-99343954,chr15,99343927,99343954,H1|chr15:69109909-69109938,chr15,69109909,69109938,1,30234018
H1|chr15:99344182-99344312,chr15,99344182,99344312,H1|chr15:64994218-64994353,chr15,64994218,64994353,1,34349964
H1|chr15:99359232-99359328,chr15,99359232,99359328,H1|chr15:99191781-99191841,chr15,99191781,99191841,1,167451
H1|chr15:99359232-99359322,chr15,99359232,99359322,H1|chr15:99191781-99191841,chr15,99191781,99191841,1,167451
H1|chr16:800818-800860,chr16,800818,800860,H1|chr16:794586-794710,chr16,794586,794710,1,6232
H1|chr16:800835-800861,chr16,800835,800861,H1|chr16:794586-794710,chr16,794586,794710,1,6249
H1|chr16:800926-801014,chr16,800926,801014,H1|chr16:795606-795643,chr16,795606,795643,1,5320
H1|chr16:801105-801234,chr16,801105,801234,H1|chr16:791407-791428,chr16,791407,791428,1,9698
H1|chr16:801107-801243,chr16,801107,801243,H1|chr16:791407-791428,chr16,791407,791428,1,9700
H1|chr16:1329260-1329304,chr16,1329260,1329304,H1|chr16:444607-444659,chr16,444607,444659,1,884653
H1|chr16:1329260-1329302,chr16,1329260,1329302,H1|chr16:444607-444679,chr16,444607,444679,1,884653
H1|chr16:1351955-1352102,chr16,1351955,1352102,H1|chr16:1355098-1355167,chr16,1355098,1355167,1,3143
H1|chr16:1351955-1352089,chr16,1351955,1352089,H1|chr16:1355093-1355166,chr16,1355093,1355166,1,3138
H1|chr16:1352104-1352185,chr16,1352104,1352185,H1|chr16:1355098-1355167,chr16,1355098,1355167,1,2994
H1|chr16:1352113-1352187,chr16,1352113,1352187,H1|chr16:1355100-1355166,chr16,1355100,1355166,1,2987
H1|chr16:2176364-2176444,chr16,2176364,2176444,H1|chr16:690416-690531,chr16,690416,690531,1,1485948
H1|chr16:2654244-2654314,chr16,2654244,2654314,H1|chr16:2733066-2733131,chr16,2733066,2733131,1,78822
H1|chr16:3004659-3004676,chr16,3004659,3004676,H1|chr16:3011383-3011520,chr16,3011383,3011520,1,6724
H1|chr16:3004741-3004871,chr16,3004741,3004871,H1|chr16:3013685-3013716,chr16,3013685,3013716,1,8944
H1|chr16:3004760-3004871,chr16,3004760,3004871,H1|chr16:3013685-3013716,chr16,3013685,3013716,1,8925
H1|chr16:3005577-3005628,chr16,3005577,3005628,H1|chr16:3010230-3010380,chr16,3010230,3010380,1,4653
H1|chr16:3006150-3006188,chr16,3006150,3006188,H1|chr16:3013378-3013442,chr16,3013378,3013442,1,7228
H1|chr16:3006151-3006188,chr16,3006151,3006188,H1|chr16:3013378-3013442,chr16,3013378,3013442,1,7227
H1|chr16:3038831-3038871,chr16,3038831,3038871,H1|chr16:3144972-3145082,chr16,3144972,3145082,1,106141
H1|chr16:3038833-3038924,chr16,3038833,3038924,H1|chr16:3144972-3145082,chr16,3144972,3145082,1,106139
H1|chr16:3042732-3042788,chr16,3042732,3042788,H1|chr16:3032654-3032782,chr16,3032654,3032782,1,10078
H1|chr16:3045961-3046021,chr16,3045961,3046021,H1|chr16:3175050-3175097,chr16,3175050,3175097,1,129089
H1|chr16:3046021-3046107,chr16,3046021,3046107,H1|chr16:3083623-3083687,chr16,3083623,3083687,1,37602
H1|chr16:3046023-3046107,chr16,3046023,3046107,H1|chr16:3083623-3083687,chr16,3083623,3083687,1,37600
H1|chr16:3046198-3046245,chr16,3046198,3046245,H1|chr16:3155396-3155471,chr16,3155396,3155471,1,109198
H1|chr16:3046199-3046245,chr16,3046199,3046245,H1|chr16:3155396-3155471,chr16,3155396,3155471,1,109197
H1|chr16:3046203-3046245,chr16,3046203,3046245,H1|chr16:3155396-3155471,chr16,3155396,3155471,1,109193
H1|chr16:3050915-3050982,chr16,3050915,3050982,H1|chr16:3031531-3031579,chr16,3031531,3031579,1,19384
H1|chr16:3051480-3051585,chr16,3051480,3051585,H1|chr16:3083476-3083510,chr16,3083476,3083510,1,31996
H1|chr16:3052173-3052212,chr16,3052173,3052212,H1|chr16:3035319-3035356,chr16,3035319,3035356,1,16854
H1|chr16:3052533-3052607,chr16,3052533,3052607,H1|chr16:3148330-3148390,chr16,3148330,3148390,1,95797
H1|chr16:3053122-3053172,chr16,3053122,3053172,H1|chr16:3031480-3031630,chr16,3031480,3031630,1,21642
H1|chr16:3053431-3053520,chr16,3053431,3053520,H1|chr16:3154736-3154771,chr16,3154736,3154771,1,101305
H1|chr16:3055629-3055721,chr16,3055629,3055721,H1|chr16:3062267-3062313,chr16,3062267,3062313,1,6638
H1|chr16:3862550-3862608,chr16,3862550,3862608,H1|chr16:9769469-9769545,chr16,9769469,9769545,1,5906919
H1|chr16:3862550-3862607,chr16,3862550,3862607,H1|chr16:9769469-9769545,chr16,9769469,9769545,1,5906919
H1|chr16:3920411-3920492,chr16,3920411,3920492,H1|chr16:89284321-89284384,chr16,89284321,89284384,1,85363910
H1|chr16:3920411-3920462,chr16,3920411,3920462,H1|chr16:89284321-89284384,chr16,89284321,89284384,1,85363910
H1|chr16:3920411-3920461,chr16,3920411,3920461,H1|chr16:89284321-89284384,chr16,89284321,89284384,1,85363910
H1|chr16:4340466-4340487,chr16,4340466,4340487,H1|chr16:4324446-4324596,chr16,4324446,4324596,1,16020
H1|chr16:4343254-4343348,chr16,4343254,4343348,H1|chr16:4326380-4326433,chr16,4326380,4326433,1,16874
H1|chr16:4343270-4343420,chr16,4343270,4343420,H1|chr16:4326380-4326433,chr16,4326380,4326433,1,16890
H1|chr16:4345153-4345189,chr16,4345153,4345189,H1|chr16:4399994-4400109,chr16,4399994,4400109,1,54841
H1|chr16:4345156-4345189,chr16,4345156,4345189,H1|chr16:4399994-4400109,chr16,4399994,4400109,1,54838
H1|chr16:4347818-4347842,chr16,4347818,4347842,H1|chr16:4324372-4324426,chr16,4324372,4324426,1,23446
H1|chr16:4356687-4356814,chr16,4356687,4356814,H1|chr16:4396071-4396094,chr16,4396071,4396094,1,39384
H1|chr16:4357144-4357177,chr16,4357144,4357177,H1|chr16:4324142-4324201,chr16,4324142,4324201,1,33002
H1|chr16:4370100-4370145,chr16,4370100,4370145,H1|chr16:4321699-4321787,chr16,4321699,4321787,1,48401
H1|chr16:4370100-4370144,chr16,4370100,4370144,H1|chr16:4321699-4321787,chr16,4321699,4321787,1,48401
H1|chr16:8943763-8943796,chr16,8943763,8943796,H1|chr16:8958162-8958291,chr16,8958162,8958291,1,14399
H1|chr16:8943782-8943816,chr16,8943782,8943816,H1|chr16:8956577-8956674,chr16,8956577,8956674,1,12795
H1|chr16:8943783-8943816,chr16,8943783,8943816,H1|chr16:8956577-8956674,chr16,8956577,8956674,1,12794
H1|chr16:8943833-8943870,chr16,8943833,8943870,H1|chr16:9058500-9058526,chr16,9058500,9058526,1,114667
H1|chr16:8943850-8943950,chr16,8943850,8943950,H1|chr16:9058500-9058526,chr16,9058500,9058526,1,114650
H1|chr16:8943857-8943922,chr16,8943857,8943922,H1|chr16:9057330-9057361,chr16,9057330,9057361,1,113473
H1|chr16:8943862-8943950,chr16,8943862,8943950,H1|chr16:9058500-9058526,chr16,9058500,9058526,1,114638
H1|chr16:8944422-8944539,chr16,8944422,8944539,H1|chr16:9055783-9055816,chr16,9055783,9055816,1,111361
H1|chr16:8944431-8944473,chr16,8944431,8944473,H1|chr16:8961775-8961919,chr16,8961775,8961919,1,17344
H1|chr16:8944564-8944714,chr16,8944564,8944714,H1|chr16:9055783-9055816,chr16,9055783,9055816,1,111219
H1|chr16:8944698-8944734,chr16,8944698,8944734,H1|chr16:8957392-8957464,chr16,8957392,8957464,1,12694
H1|chr16:8945137-8945218,chr16,8945137,8945218,H1|chr16:31126890-31126942,chr16,31126890,31126942,1,22181753
H1|chr16:8946511-8946559,chr16,8946511,8946559,H1|chr16:8960236-8960324,chr16,8960236,8960324,1,13725
H1|chr16:8946511-8946556,chr16,8946511,8946556,H1|chr16:8960236-8960324,chr16,8960236,8960324,1,13725
H1|chr16:9797682-9797764,chr16,9797682,9797764,H1|chr16:9769552-9769620,chr16,9769552,9769620,1,28130
H1|chr16:9797739-9797889,chr16,9797739,9797889,H1|chr16:9769552-9769620,chr16,9769552,9769620,1,28187
H1|chr16:9798239-9798367,chr16,9798239,9798367,H1|chr16:9775607-9775661,chr16,9775607,9775661,1,22632
H1|chr16:9798239-9798335,chr16,9798239,9798335,H1|chr16:9775607-9775661,chr16,9775607,9775661,1,22632
H1|chr16:9799263-9799373,chr16,9799263,9799373,H1|chr16:9771916-9771956,chr16,9771916,9771956,1,27347
H1|chr16:9799359-9799509,chr16,9799359,9799509,H1|chr16:9771916-9771956,chr16,9771916,9771956,1,27443
H1|chr16:9800037-9800100,chr16,9800037,9800100,H1|chr16:56717613-56717695,chr16,56717613,56717695,1,46917576
H1|chr16:9800039-9800166,chr16,9800039,9800166,H1|chr16:56717613-56717695,chr16,56717613,56717695,1,46917574
H1|chr16:9800289-9800409,chr16,9800289,9800409,H1|chr16:9769579-9769605,chr16,9769579,9769605,1,30710
H1|chr16:9800289-9800388,chr16,9800289,9800388,H1|chr16:9769579-9769605,chr16,9769579,9769605,1,30710
H1|chr16:9800301-9800450,chr16,9800301,9800450,H1|chr16:9769579-9769605,chr16,9769579,9769605,1,30722
H1|chr16:9800460-9800492,chr16,9800460,9800492,H1|chr16:9772806-9772869,chr16,9772806,9772869,1,27654
H1|chr16:9800519-9800566,chr16,9800519,9800566,H1|chr16:9773048-9773147,chr16,9773048,9773147,1,27471
H1|chr16:9800519-9800558,chr16,9800519,9800558,H1|chr16:9773048-9773147,chr16,9773048,9773147,1,27471
H1|chr16:9800652-9800801,chr16,9800652,9800801,H1|chr16:9773315-9773366,chr16,9773315,9773366,1,27337
H1|chr16:9800718-9800782,chr16,9800718,9800782,H1|chr16:9768427-9768525,chr16,9768427,9768525,1,32291
H1|chr16:9801255-9801316,chr16,9801255,9801316,H1|chr16:88728875-88728963,chr16,88728875,88728963,1,78927620
H1|chr16:9801257-9801316,chr16,9801257,9801316,H1|chr16:88728875-88728963,chr16,88728875,88728963,1,78927618
H1|chr16:9801437-9801468,chr16,9801437,9801468,H1|chr16:9770108-9770185,chr16,9770108,9770185,1,31329
H1|chr16:9801851-9801888,chr16,9801851,9801888,H1|chr16:9774447-9774538,chr16,9774447,9774538,1,27404
H1|chr16:9802157-9802183,chr16,9802157,9802183,H1|chr16:9775661-9775725,chr16,9775661,9775725,1,26496
H1|chr16:9802465-9802578,chr16,9802465,9802578,H1|chr16:9775235-9775285,chr16,9775235,9775285,1,27230
H1|chr16:9802465-9802565,chr16,9802465,9802565,H1|chr16:9775235-9775285,chr16,9775235,9775285,1,27230
H1|chr16:9803485-9803520,chr16,9803485,9803520,H1|chr16:9773472-9773613,chr16,9773472,9773613,1,30013
H1|chr16:9805012-9805107,chr16,9805012,9805107,H1|chr16:9771889-9771945,chr16,9771889,9771945,1,33123
H1|chr16:9805012-9805106,chr16,9805012,9805106,H1|chr16:9771889-9771945,chr16,9771889,9771945,1,33123
H1|chr16:9805244-9805293,chr16,9805244,9805293,H1|chr16:9771714-9771864,chr16,9771714,9771864,1,33530
H1|chr16:9805319-9805385,chr16,9805319,9805385,H1|chr16:9768701-9768759,chr16,9768701,9768759,1,36618
H1|chr16:9805346-9805412,chr16,9805346,9805412,H1|chr16:9774407-9774446,chr16,9774407,9774446,1,30939
H1|chr16:9805358-9805468,chr16,9805358,9805468,H1|chr16:9774036-9774127,chr16,9774036,9774127,1,31322
H1|chr16:9805358-9805466,chr16,9805358,9805466,H1|chr16:9774036-9774127,chr16,9774036,9774127,1,31322
H1|chr16:9805413-9805506,chr16,9805413,9805506,H1|chr16:9770171-9770214,chr16,9770171,9770214,1,35242
H1|chr16:9805427-9805507,chr16,9805427,9805507,H1|chr16:9772051-9772162,chr16,9772051,9772162,1,33376
H1|chr16:9805427-9805466,chr16,9805427,9805466,H1|chr16:9772051-9772162,chr16,9772051,9772162,1,33376
H1|chr16:9806187-9806286,chr16,9806187,9806286,H1|chr16:9774303-9774422,chr16,9774303,9774422,1,31884
H1|chr16:9806187-9806218,chr16,9806187,9806218,H1|chr16:9774303-9774422,chr16,9774303,9774422,1,31884
H1|chr16:9806432-9806531,chr16,9806432,9806531,H1|chr16:9774959-9774993,chr16,9774959,9774993,1,31473
H1|chr16:9806432-9806530,chr16,9806432,9806530,H1|chr16:9774959-9774993,chr16,9774959,9774993,1,31473
H1|chr16:9806634-9806666,chr16,9806634,9806666,H1|chr16:9772181-9772299,chr16,9772181,9772299,1,34453
H1|chr16:9806719-9806869,chr16,9806719,9806869,H1|chr16:9772181-9772299,chr16,9772181,9772299,1,34538
H1|chr16:9807001-9807082,chr16,9807001,9807082,H1|chr16:9772577-9772642,chr16,9772577,9772642,1,34424
H1|chr16:9807001-9807043,chr16,9807001,9807043,H1|chr16:9772577-9772642,chr16,9772577,9772642,1,34424
H1|chr16:9909828-9909858,chr16,9909828,9909858,H1|chr16:9769834-9769982,chr16,9769834,9769982,1,139994
H1|chr16:9913199-9913315,chr16,9913199,9913315,H1|chr16:9768494-9768558,chr16,9768494,9768558,1,144705
H1|chr16:9913199-9913282,chr16,9913199,9913282,H1|chr16:9768494-9768558,chr16,9768494,9768558,1,144705
H1|chr16:13034955-13035054,chr16,13034955,13035054,H1|chr16:74699759-74699784,chr16,74699759,74699784,1,61664804
H1|chr16:13041092-13041172,chr16,13041092,13041172,H1|chr16:68878235-68878302,chr16,68878235,68878302,1,55837143
H1|chr16:13108855-13108888,chr16,13108855,13108888,H1|chr16:4520530-4520580,chr16,4520530,4520580,1,8588325
H1|chr16:13247434-13247483,chr16,13247434,13247483,H1|chr16:4900256-4900321,chr16,4900256,4900321,1,8347178
H1|chr16:13247434-13247482,chr16,13247434,13247482,H1|chr16:4900256-4900321,chr16,4900256,4900321,1,8347178
H1|chr16:13250222-13250300,chr16,13250222,13250300,H1|chr16:3186642-3186720,chr16,3186642,3186720,1,10063580
H1|chr16:13250616-13250697,chr16,13250616,13250697,H1|chr16:89781171-89781279,chr16,89781171,89781279,1,76530555
H1|chr16:13250616-13250658,chr16,13250616,13250658,H1|chr16:89781171-89781279,chr16,89781171,89781279,1,76530555
H1|chr16:13250616-13250657,chr16,13250616,13250657,H1|chr16:89781171-89781279,chr16,89781171,89781279,1,76530555
H1|chr16:13260625-13260642,chr16,13260625,13260642,H1|chr16:3146950-3147069,chr16,3146950,3147069,1,10113675
H1|chr16:14398685-14398740,chr16,14398685,14398740,H1|chr16:3066913-3067054,chr16,3066913,3067054,1,11331772
H1|chr16:14602124-14602183,chr16,14602124,14602183,H1|chr16:11759670-11759727,chr16,11759670,11759727,1,2842454
H1|chr16:14602148-14602238,chr16,14602148,14602238,H1|chr16:11759786-11759816,chr16,11759786,11759816,1,2842362
H1|chr16:14602149-14602238,chr16,14602149,14602238,H1|chr16:11759786-11759816,chr16,11759786,11759816,1,2842363
H1|chr16:15241506-15241555,chr16,15241506,15241555,H1|chr16:2178832-2178904,chr16,2178832,2178904,1,13062674
H1|chr16:15241549-15241601,chr16,15241549,15241601,H1|chr16:2182857-2182922,chr16,2182857,2182922,1,13058692
H1|chr16:15241851-15241969,chr16,15241851,15241969,H1|chr16:2179148-2179181,chr16,2179148,2179181,1,13062703
H1|chr16:15242166-15242222,chr16,15242166,15242222,H1|chr16:2179530-2179613,chr16,2179530,2179613,1,13062636
H1|chr16:15242178-15242255,chr16,15242178,15242255,H1|chr16:2179526-2179649,chr16,2179526,2179649,1,13062652
H1|chr16:15242258-15242385,chr16,15242258,15242385,H1|chr16:2179515-2179659,chr16,2179515,2179659,1,13062743
H1|chr16:15242272-15242416,chr16,15242272,15242416,H1|chr16:2179508-2179547,chr16,2179508,2179547,1,13062764
H1|chr16:15242293-15242409,chr16,15242293,15242409,H1|chr16:2179585-2179720,chr16,2179585,2179720,1,13062708
H1|chr16:15243152-15243302,chr16,15243152,15243302,H1|chr16:2180575-2180621,chr16,2180575,2180621,1,13062577
H1|chr16:15243163-15243313,chr16,15243163,15243313,H1|chr16:2180497-2180624,chr16,2180497,2180624,1,13062666
H1|chr16:15245141-15245213,chr16,15245141,15245213,H1|chr16:2182659-2182709,chr16,2182659,2182709,1,13062482
H1|chr16:15245694-15245809,chr16,15245694,15245809,H1|chr16:2183080-2183120,chr16,2183080,2183120,1,13062614
H1|chr16:15245811-15245922,chr16,15245811,15245922,H1|chr16:2182997-2183120,chr16,2182997,2183120,1,13062814
H1|chr16:15245815-15245921,chr16,15245815,15245921,H1|chr16:2183054-2183108,chr16,2183054,2183108,1,13062761
H1|chr16:15248429-15248570,chr16,15248429,15248570,H1|chr16:2014046-2014147,chr16,2014046,2014147,1,13234383
H1|chr16:15248430-15248570,chr16,15248430,15248570,H1|chr16:2014046-2014147,chr16,2014046,2014147,1,13234384
H1|chr16:16074918-16075019,chr16,16074918,16075019,H1|chr16:68679845-68679887,chr16,68679845,68679887,1,52604927
H1|chr16:16074922-16075019,chr16,16074922,16075019,H1|chr16:68679845-68679887,chr16,68679845,68679887,1,52604923
H1|chr16:16084770-16084821,chr16,16084770,16084821,H1|chr16:14726925-14727033,chr16,14726925,14727033,1,1357845
H1|chr16:16084782-16084824,chr16,16084782,16084824,H1|chr16:14726925-14727033,chr16,14726925,14727033,1,1357857
H1|chr16:17400082-17400119,chr16,17400082,17400119,H1|chr16:56659135-56659248,chr16,56659135,56659248,1,39259053
H1|chr16:21513523-21513669,chr16,21513523,21513669,H1|chr16:18937922-18937978,chr16,18937922,18937978,1,2575601
H1|chr16:21513590-21513738,chr16,21513590,21513738,H1|chr16:18937861-18937990,chr16,18937861,18937990,1,2575729
H1|chr16:21513590-21513728,chr16,21513590,21513728,H1|chr16:18937861-18937990,chr16,18937861,18937990,1,2575729
H1|chr16:21513608-21513758,chr16,21513608,21513758,H1|chr16:18937922-18937976,chr16,18937922,18937976,1,2575686
H1|chr16:21513609-21513747,chr16,21513609,21513747,H1|chr16:18937861-18937974,chr16,18937861,18937974,1,2575748
H1|chr16:21513609-21513687,chr16,21513609,21513687,H1|chr16:18937922-18937975,chr16,18937922,18937975,1,2575687
H1|chr16:21513611-21513761,chr16,21513611,21513761,H1|chr16:18937909-18938059,chr16,18937909,18938059,1,2575702
H1|chr16:21513611-21513662,chr16,21513611,21513662,H1|chr16:18937909-18938059,chr16,18937909,18938059,1,2575702
H1|chr16:21513614-21513763,chr16,21513614,21513763,H1|chr16:18937922-18937988,chr16,18937922,18937988,1,2575692
H1|chr16:21513615-21513760,chr16,21513615,21513760,H1|chr16:18937922-18937973,chr16,18937922,18937973,1,2575693
H1|chr16:21513615-21513689,chr16,21513615,21513689,H1|chr16:18937946-18938025,chr16,18937946,18938025,1,2575669
H1|chr16:21513616-21513766,chr16,21513616,21513766,H1|chr16:18937922-18937978,chr16,18937922,18937978,1,2575694
H1|chr16:21513633-21513732,chr16,21513633,21513732,H1|chr16:18937922-18937973,chr16,18937922,18937973,1,2575711
H1|chr16:21513635-21513732,chr16,21513635,21513732,H1|chr16:18937922-18937975,chr16,18937922,18937975,1,2575713
H1|chr16:21513636-21513732,chr16,21513636,21513732,H1|chr16:18937922-18937976,chr16,18937922,18937976,1,2575714
H1|chr16:21513637-21513732,chr16,21513637,21513732,H1|chr16:18937922-18937976,chr16,18937922,18937976,1,2575715
H1|chr16:21513638-21513732,chr16,21513638,21513732,H1|chr16:18937922-18937978,chr16,18937922,18937978,1,2575716
H1|chr16:21513643-21513732,chr16,21513643,21513732,H1|chr16:18937922-18937983,chr16,18937922,18937983,1,2575721
H1|chr16:21513644-21513732,chr16,21513644,21513732,H1|chr16:18937900-18938014,chr16,18937900,18938014,1,2575744
H1|chr16:21513645-21513732,chr16,21513645,21513732,H1|chr16:18937922-18937982,chr16,18937922,18937982,1,2575723
H1|chr16:21513648-21513732,chr16,21513648,21513732,H1|chr16:18937922-18937976,chr16,18937922,18937976,1,2575726
H1|chr16:21513651-21513732,chr16,21513651,21513732,H1|chr16:18937922-18937988,chr16,18937922,18937988,1,2575729
H1|chr16:21513653-21513732,chr16,21513653,21513732,H1|chr16:18937922-18937980,chr16,18937922,18937980,1,2575731
H1|chr16:21513653-21513707,chr16,21513653,21513707,H1|chr16:18937930-18937990,chr16,18937930,18937990,1,2575723
H1|chr16:21513654-21513732,chr16,21513654,21513732,H1|chr16:18937922-18937988,chr16,18937922,18937988,1,2575732
H1|chr16:21513658-21513763,chr16,21513658,21513763,H1|chr16:18937861-18938001,chr16,18937861,18938001,1,2575797
H1|chr16:21525352-21525416,chr16,21525352,21525416,H1|chr16:19724238-19724307,chr16,19724238,19724307,1,1801114
H1|chr16:21527911-21527952,chr16,21527911,21527952,H1|chr16:87899143-87899287,chr16,87899143,87899287,1,66371232
H1|chr16:21528355-21528480,chr16,21528355,21528480,H1|chr16:87899717-87899843,chr16,87899717,87899843,1,66371362
H1|chr16:21529545-21529641,chr16,21529545,21529641,H1|chr16:19730380-19730484,chr16,19730380,19730484,1,1799165
H1|chr16:21529545-21529591,chr16,21529545,21529591,H1|chr16:19730380-19730484,chr16,19730380,19730484,1,1799165
H1|chr16:21530307-21530409,chr16,21530307,21530409,H1|chr16:87899441-87899489,chr16,87899441,87899489,1,66369134
H1|chr16:21530808-21530958,chr16,21530808,21530958,H1|chr16:87902223-87902373,chr16,87902223,87902373,1,66371415
H1|chr16:21530824-21530974,chr16,21530824,21530974,H1|chr16:87902229-87902374,chr16,87902229,87902374,1,66371405
H1|chr16:21530830-21530977,chr16,21530830,21530977,H1|chr16:87902223-87902373,chr16,87902223,87902373,1,66371393
H1|chr16:23134739-23134832,chr16,23134739,23134832,H1|chr16:3084482-3084539,chr16,3084482,3084539,1,20050257
H1|chr16:23134739-23134823,chr16,23134739,23134823,H1|chr16:3084473-3084539,chr16,3084473,3084539,1,20050266
H1|chr16:23137474-23137520,chr16,23137474,23137520,H1|chr16:31713415-31713486,chr16,31713415,31713486,1,8575941
H1|chr16:23137475-23137520,chr16,23137475,23137520,H1|chr16:31713414-31713455,chr16,31713414,31713455,1,8575939
H1|chr16:23146550-23146691,chr16,23146550,23146691,H1|chr16:3073657-3073720,chr16,3073657,3073720,1,20072893
H1|chr16:23146550-23146634,chr16,23146550,23146634,H1|chr16:3073657-3073720,chr16,3073657,3073720,1,20072893
H1|chr16:23152734-23152799,chr16,23152734,23152799,H1|chr16:25273834-25273875,chr16,25273834,25273875,1,2121100
H1|chr16:23152738-23152799,chr16,23152738,23152799,H1|chr16:25273836-25273874,chr16,25273836,25273874,1,2121098
H1|chr16:23429919-23429968,chr16,23429919,23429968,H1|chr16:23520325-23520409,chr16,23520325,23520409,1,90406
H1|chr16:23429921-23429968,chr16,23429921,23429968,H1|chr16:23520325-23520409,chr16,23520325,23520409,1,90404
H1|chr16:24750191-24750286,chr16,24750191,24750286,H1|chr16:24739719-24739770,chr16,24739719,24739770,1,10472
H1|chr16:24750323-24750384,chr16,24750323,24750384,H1|chr16:25120399-25120453,chr16,25120399,25120453,1,370076
H1|chr16:24750493-24750525,chr16,24750493,24750525,H1|chr16:9772562-9772712,chr16,9772562,9772712,1,14977931
H1|chr16:24751926-24751990,chr16,24751926,24751990,H1|chr16:25270819-25270958,chr16,25270819,25270958,1,518893
H1|chr16:24753211-24753274,chr16,24753211,24753274,H1|chr16:9769317-9769367,chr16,9769317,9769367,1,14983894
H1|chr16:24758751-24758837,chr16,24758751,24758837,H1|chr16:25270624-25270701,chr16,25270624,25270701,1,511873
H1|chr16:24758767-24758837,chr16,24758767,24758837,H1|chr16:25270624-25270701,chr16,25270624,25270701,1,511857
H1|chr16:24758882-24758960,chr16,24758882,24758960,H1|chr16:31723555-31723616,chr16,31723555,31723616,1,6964673
H1|chr16:24760027-24760071,chr16,24760027,24760071,H1|chr16:788787-788881,chr16,788787,788881,1,23971240
H1|chr16:24760028-24760071,chr16,24760028,24760071,H1|chr16:788787-788881,chr16,788787,788881,1,23971241
H1|chr16:24760092-24760117,chr16,24760092,24760117,H1|chr16:25271063-25271187,chr16,25271063,25271187,1,510971
H1|chr16:24761191-24761331,chr16,24761191,24761331,H1|chr16:9773984-9774043,chr16,9773984,9774043,1,14987207
H1|chr16:24761229-24761320,chr16,24761229,24761320,H1|chr16:9773984-9774043,chr16,9773984,9774043,1,14987245
H1|chr16:24765034-24765063,chr16,24765034,24765063,H1|chr16:58662800-58662921,chr16,58662800,58662921,1,33897766
H1|chr16:24765039-24765063,chr16,24765039,24765063,H1|chr16:58662800-58662921,chr16,58662800,58662921,1,33897761
H1|chr16:24768076-24768148,chr16,24768076,24768148,H1|chr16:793208-793283,chr16,793208,793283,1,23974868
H1|chr16:24770819-24770890,chr16,24770819,24770890,H1|chr16:24736822-24736876,chr16,24736822,24736876,1,33997
H1|chr16:24770819-24770889,chr16,24770819,24770889,H1|chr16:24736822-24736876,chr16,24736822,24736876,1,33997
H1|chr16:24771415-24771488,chr16,24771415,24771488,H1|chr16:31725155-31725232,chr16,31725155,31725232,1,6953740
H1|chr16:24773051-24773164,chr16,24773051,24773164,H1|chr16:277677-277711,chr16,277677,277711,1,24495374
H1|chr16:24774030-24774117,chr16,24774030,24774117,H1|chr16:9769534-9769591,chr16,9769534,9769591,1,15004496
H1|chr16:24774616-24774722,chr16,24774616,24774722,H1|chr16:25117081-25117118,chr16,25117081,25117118,1,342465
H1|chr16:24777862-24777890,chr16,24777862,24777890,H1|chr16:791546-791622,chr16,791546,791622,1,23986316
H1|chr16:24781834-24781889,chr16,24781834,24781889,H1|chr16:285620-285727,chr16,285620,285727,1,24496214
H1|chr16:29086626-29086773,chr16,29086626,29086773,H1|chr16:15187570-15187720,chr16,15187570,15187720,1,13899056
H1|chr16:29086635-29086781,chr16,29086635,29086781,H1|chr16:15187570-15187720,chr16,15187570,15187720,1,13899065
H1|chr16:29620850-29621000,chr16,29620850,29621000,H1|chr16:87899093-87899199,chr16,87899093,87899199,1,58278243
H1|chr16:29620926-29621076,chr16,29620926,29621076,H1|chr16:87899047-87899194,chr16,87899047,87899194,1,58278121
H1|chr16:29620938-29621082,chr16,29620938,29621082,H1|chr16:87899050-87899200,chr16,87899050,87899200,1,58278112
H1|chr16:29620945-29621094,chr16,29620945,29621094,H1|chr16:87899090-87899234,chr16,87899090,87899234,1,58278145
H1|chr16:29620957-29621107,chr16,29620957,29621107,H1|chr16:87899079-87899229,chr16,87899079,87899229,1,58278122
H1|chr16:29620959-29621088,chr16,29620959,29621088,H1|chr16:87899035-87899166,chr16,87899035,87899166,1,58278076
H1|chr16:29621025-29621171,chr16,29621025,29621171,H1|chr16:87899058-87899205,chr16,87899058,87899205,1,58278033
H1|chr16:29621034-29621184,chr16,29621034,29621184,H1|chr16:87899046-87899196,chr16,87899046,87899196,1,58278012
H1|chr16:29621077-29621227,chr16,29621077,29621227,H1|chr16:87899037-87899185,chr16,87899037,87899185,1,58277960
H1|chr16:29621120-29621270,chr16,29621120,29621270,H1|chr16:87899087-87899234,chr16,87899087,87899234,1,58277967
H1|chr16:29621123-29621201,chr16,29621123,29621201,H1|chr16:87899042-87899192,chr16,87899042,87899192,1,58277919
H1|chr16:29622083-29622210,chr16,29622083,29622210,H1|chr16:87900158-87900285,chr16,87900158,87900285,1,58278075
H1|chr16:29622130-29622148,chr16,29622130,29622148,H1|chr16:87899068-87899217,chr16,87899068,87899217,1,58276938
H1|chr16:31462966-31463050,chr16,31462966,31463050,H1|chr16:31466043-31466109,chr16,31466043,31466109,1,3077
H1|chr16:31463164-31463227,chr16,31463164,31463227,H1|chr16:31467965-31468020,chr16,31467965,31468020,1,4801
H1|chr16:31463176-31463210,chr16,31463176,31463210,H1|chr16:31465346-31465426,chr16,31465346,31465426,1,2170
H1|chr16:31463191-31463227,chr16,31463191,31463227,H1|chr16:31467965-31468020,chr16,31467965,31468020,1,4774
H1|chr16:31463335-31463485,chr16,31463335,31463485,H1|chr16:31467501-31467631,chr16,31467501,31467631,1,4166
H1|chr16:31463395-31463478,chr16,31463395,31463478,H1|chr16:31466116-31466183,chr16,31466116,31466183,1,2721
H1|chr16:31463400-31463540,chr16,31463400,31463540,H1|chr16:31467657-31467720,chr16,31467657,31467720,1,4257
H1|chr16:31463452-31463539,chr16,31463452,31463539,H1|chr16:31467657-31467720,chr16,31467657,31467720,1,4205
H1|chr16:31463472-31463519,chr16,31463472,31463519,H1|chr16:31467541-31467691,chr16,31467541,31467691,1,4069
H1|chr16:31463497-31463647,chr16,31463497,31463647,H1|chr16:31465883-31465940,chr16,31465883,31465940,1,2386
H1|chr16:31463547-31463601,chr16,31463547,31463601,H1|chr16:31467556-31467647,chr16,31467556,31467647,1,4009
H1|chr16:31463547-31463599,chr16,31463547,31463599,H1|chr16:31467556-31467647,chr16,31467556,31467647,1,4009
H1|chr16:31463565-31463695,chr16,31463565,31463695,H1|chr16:31467493-31467566,chr16,31467493,31467566,1,3928
H1|chr16:31463565-31463676,chr16,31463565,31463676,H1|chr16:31467511-31467622,chr16,31467511,31467622,1,3946
H1|chr16:31463590-31463683,chr16,31463590,31463683,H1|chr16:31465883-31465940,chr16,31465883,31465940,1,2293
H1|chr16:31463622-31463695,chr16,31463622,31463695,H1|chr16:31467493-31467566,chr16,31467493,31467566,1,3871
H1|chr16:31463629-31463709,chr16,31463629,31463709,H1|chr16:31467477-31467582,chr16,31467477,31467582,1,3848
H1|chr16:31463629-31463707,chr16,31463629,31463707,H1|chr16:31465892-31465917,chr16,31465892,31465917,1,2263
H1|chr16:31463629-31463699,chr16,31463629,31463699,H1|chr16:31465892-31465917,chr16,31465892,31465917,1,2263
H1|chr16:31463635-31463707,chr16,31463635,31463707,H1|chr16:31465892-31465917,chr16,31465892,31465917,1,2257
H1|chr16:31463643-31463676,chr16,31463643,31463676,H1|chr16:31467511-31467622,chr16,31467511,31467622,1,3868
H1|chr16:31463675-31463709,chr16,31463675,31463709,H1|chr16:31467477-31467582,chr16,31467477,31467582,1,3802
H1|chr16:31463800-31463823,chr16,31463800,31463823,H1|chr16:31467554-31467704,chr16,31467554,31467704,1,3754
H1|chr16:31463890-31463948,chr16,31463890,31463948,H1|chr16:31467207-31467339,chr16,31467207,31467339,1,3317
H1|chr16:31463890-31463908,chr16,31463890,31463908,H1|chr16:31467207-31467339,chr16,31467207,31467339,1,3317
H1|chr16:31464003-31464054,chr16,31464003,31464054,H1|chr16:31465010-31465039,chr16,31465010,31465039,1,1007
H1|chr16:31464004-31464090,chr16,31464004,31464090,H1|chr16:31465014-31465040,chr16,31465014,31465040,1,1010
H1|chr16:31464037-31464160,chr16,31464037,31464160,H1|chr16:31467029-31467062,chr16,31467029,31467062,1,2992
H1|chr16:31464043-31464160,chr16,31464043,31464160,H1|chr16:31467029-31467062,chr16,31467029,31467062,1,2986
H1|chr16:31464187-31464224,chr16,31464187,31464224,H1|chr16:31464819-31464912,chr16,31464819,31464912,1,632
H1|chr16:31464202-31464229,chr16,31464202,31464229,H1|chr16:31467472-31467622,chr16,31467472,31467622,1,3270
H1|chr16:49638064-49638144,chr16,49638064,49638144,H1|chr16:56717553-56717608,chr16,56717553,56717608,1,7079489
H1|chr16:49638070-49638144,chr16,49638070,49638144,H1|chr16:56717553-56717608,chr16,56717553,56717608,1,7079483
H1|chr16:53114530-53114637,chr16,53114530,53114637,H1|chr16:56461910-56461950,chr16,56461910,56461950,1,3347380
H1|chr16:53114534-53114684,chr16,53114534,53114684,H1|chr16:56461910-56461950,chr16,56461910,56461950,1,3347376
H1|chr16:53114613-53114684,chr16,53114613,53114684,H1|chr16:56461910-56461950,chr16,56461910,56461950,1,3347297
H1|chr16:65261859-65261899,chr16,65261859,65261899,H1|chr16:67228423-67228461,chr16,67228423,67228461,1,1966564
H1|chr16:65263445-65263543,chr16,65263445,65263543,H1|chr16:68774150-68774234,chr16,68774150,68774234,1,3510705
H1|chr16:65263445-65263511,chr16,65263445,65263511,H1|chr16:68774150-68774234,chr16,68774150,68774234,1,3510705
H1|chr16:65263869-65263921,chr16,65263869,65263921,H1|chr16:68776073-68776109,chr16,68776073,68776109,1,3512204
H1|chr16:65266322-65266394,chr16,65266322,65266394,H1|chr16:48637648-48637721,chr16,48637648,48637721,1,16628674
H1|chr16:65267792-65267863,chr16,65267792,65267863,H1|chr16:48643495-48643560,chr16,48643495,48643560,1,16624297
H1|chr16:65267792-65267862,chr16,65267792,65267862,H1|chr16:48643495-48643560,chr16,48643495,48643560,1,16624297
H1|chr16:66772149-66772261,chr16,66772149,66772261,H1|chr16:58663074-58663110,chr16,58663074,58663110,1,8109075
H1|chr16:66772152-66772281,chr16,66772152,66772281,H1|chr16:58663074-58663110,chr16,58663074,58663110,1,8109078
H1|chr16:66772181-66772281,chr16,66772181,66772281,H1|chr16:58663074-58663111,chr16,58663074,58663111,1,8109107
H1|chr16:67891491-67891534,chr16,67891491,67891534,H1|chr16:57516105-57516243,chr16,57516105,57516243,1,10375386
H1|chr16:67954233-67954258,chr16,67954233,67954258,H1|chr16:67972359-67972444,chr16,67972359,67972444,1,18126
H1|chr16:67954234-67954258,chr16,67954234,67954258,H1|chr16:67972359-67972444,chr16,67972359,67972444,1,18125
H1|chr16:67954415-67954462,chr16,67954415,67954462,H1|chr16:67966644-67966747,chr16,67966644,67966747,1,12229
H1|chr16:67958670-67958811,chr16,67958670,67958811,H1|chr16:67968904-67969024,chr16,67968904,67969024,1,10234
H1|chr16:67958671-67958811,chr16,67958671,67958811,H1|chr16:67968904-67969024,chr16,67968904,67969024,1,10233
H1|chr16:67958784-67958810,chr16,67958784,67958810,H1|chr16:67968904-67969024,chr16,67968904,67969024,1,10120
H1|chr16:67959164-67959246,chr16,67959164,67959246,H1|chr16:67967239-67967282,chr16,67967239,67967282,1,8075
H1|chr16:67960181-67960252,chr16,67960181,67960252,H1|chr16:67971048-67971108,chr16,67971048,67971108,1,10867
H1|chr16:69030474-69030545,chr16,69030474,69030545,H1|chr16:68772531-68772607,chr16,68772531,68772607,1,257943
H1|chr16:69030474-69030541,chr16,69030474,69030541,H1|chr16:68772531-68772607,chr16,68772531,68772607,1,257943
H1|chr16:70453366-70453452,chr16,70453366,70453452,H1|chr16:9769579-9769643,chr16,9769579,9769643,1,60683787
H1|chr16:70453367-70453452,chr16,70453367,70453452,H1|chr16:9769579-9769644,chr16,9769579,9769644,1,60683788
H1|chr16:70740127-70740222,chr16,70740127,70740222,H1|chr16:2288981-2289080,chr16,2288981,2289080,1,68451146
H1|chr16:70740172-70740223,chr16,70740172,70740223,H1|chr16:2288981-2289080,chr16,2288981,2289080,1,68451191
H1|chr16:70743527-70743621,chr16,70743527,70743621,H1|chr16:70561853-70561922,chr16,70561853,70561922,1,181674
H1|chr16:70743527-70743608,chr16,70743527,70743608,H1|chr16:70561853-70561922,chr16,70561853,70561922,1,181674
H1|chr16:70746625-70746643,chr16,70746625,70746643,H1|chr16:70559260-70559410,chr16,70559260,70559410,1,187365
H1|chr16:75099851-75099920,chr16,75099851,75099920,H1|chr16:75018566-75018596,chr16,75018566,75018596,1,81285
H1|chr16:75099852-75099920,chr16,75099852,75099920,H1|chr16:75018565-75018596,chr16,75018565,75018596,1,81287
H1|chr16:75550021-75550171,chr16,75550021,75550171,H1|chr16:75497349-75497499,chr16,75497349,75497499,1,52672
H1|chr16:75550390-75550418,chr16,75550390,75550418,H1|chr16:75497675-75497742,chr16,75497675,75497742,1,52715
H1|chr16:75550529-75550586,chr16,75550529,75550586,H1|chr16:75498043-75498193,chr16,75498043,75498193,1,52486
H1|chr16:81519829-81519879,chr16,81519829,81519879,H1|chr16:84402467-84402542,chr16,84402467,84402542,1,2882638
H1|chr16:81519846-81519879,chr16,81519846,81519879,H1|chr16:84402467-84402540,chr16,84402467,84402540,1,2882621
H1|chr16:84627196-84627282,chr16,84627196,84627282,H1|chr16:84731056-84731120,chr16,84731056,84731120,1,103860
H1|chr16:84630293-84630357,chr16,84630293,84630357,H1|chr16:84734486-84734548,chr16,84734486,84734548,1,104193
H1|chr16:84636243-84636324,chr16,84636243,84636324,H1|chr16:84734340-84734384,chr16,84734340,84734384,1,98097
H1|chr16:84636244-84636324,chr16,84636244,84636324,H1|chr16:84734340-84734384,chr16,84734340,84734384,1,98096
H1|chr16:84636253-84636324,chr16,84636253,84636324,H1|chr16:84734340-84734384,chr16,84734340,84734384,1,98087
H1|chr16:84747081-84747160,chr16,84747081,84747160,H1|chr16:84729828-84729856,chr16,84729828,84729856,1,17253
H1|chr16:84747629-84747741,chr16,84747629,84747741,H1|chr16:84730939-84731003,chr16,84730939,84731003,1,16690
H1|chr16:84747658-84747741,chr16,84747658,84747741,H1|chr16:84730939-84731003,chr16,84730939,84731003,1,16719
H1|chr16:84766306-84766353,chr16,84766306,84766353,H1|chr16:58660789-58660879,chr16,58660789,58660879,1,26105517
H1|chr16:85465537-85465658,chr16,85465537,85465658,H1|chr16:85640492-85640542,chr16,85640492,85640542,1,174955
H1|chr16:85465537-85465637,chr16,85465537,85465637,H1|chr16:85640492-85640542,chr16,85640492,85640542,1,174955
H1|chr16:85473123-85473192,chr16,85473123,85473192,H1|chr16:3072408-3072484,chr16,3072408,3072484,1,82400715
H1|chr16:85475187-85475237,chr16,85475187,85475237,H1|chr16:3092276-3092369,chr16,3092276,3092369,1,82382911
H1|chr16:85487726-85487820,chr16,85487726,85487820,H1|chr16:85647652-85647750,chr16,85647652,85647750,1,159926
H1|chr16:85487768-85487820,chr16,85487768,85487820,H1|chr16:85647652-85647750,chr16,85647652,85647750,1,159884
H1|chr16:85493971-85493994,chr16,85493971,85493994,H1|chr16:69365950-69366057,chr16,69365950,69366057,1,16128021
H1|chr16:85493971-85493993,chr16,85493971,85493993,H1|chr16:69365950-69366057,chr16,69365950,69366057,1,16128021
H1|chr16:85498503-85498607,chr16,85498503,85498607,H1|chr16:85644410-85644462,chr16,85644410,85644462,1,145907
H1|chr16:85498512-85498607,chr16,85498512,85498607,H1|chr16:85644410-85644462,chr16,85644410,85644462,1,145898
H1|chr16:85508352-85508477,chr16,85508352,85508477,H1|chr16:85647575-85647605,chr16,85647575,85647605,1,139223
H1|chr16:85508357-85508477,chr16,85508357,85508477,H1|chr16:85647575-85647605,chr16,85647575,85647605,1,139218
H1|chr16:85544338-85544419,chr16,85544338,85544419,H1|chr16:85640908-85640929,chr16,85640908,85640929,1,96570
H1|chr16:85544338-85544418,chr16,85544338,85544418,H1|chr16:85640908-85640929,chr16,85640908,85640929,1,96570
H1|chr16:85550030-85550068,chr16,85550030,85550068,H1|chr16:85645940-85646010,chr16,85645940,85646010,1,95910
H1|chr16:85582212-85582279,chr16,85582212,85582279,H1|chr16:85642004-85642043,chr16,85642004,85642043,1,59792
H1|chr16:85588094-85588179,chr16,85588094,85588179,H1|chr16:85641906-85641968,chr16,85641906,85641968,1,53812
H1|chr16:85589151-85589202,chr16,85589151,85589202,H1|chr16:85641906-85641968,chr16,85641906,85641968,1,52755
H1|chr16:85589483-85589542,chr16,85589483,85589542,H1|chr16:85646625-85646671,chr16,85646625,85646671,1,57142
H1|chr16:85593094-85593203,chr16,85593094,85593203,H1|chr16:3356478-3356594,chr16,3356478,3356594,1,82236616
H1|chr16:85603896-85603971,chr16,85603896,85603971,H1|chr16:85645661-85645692,chr16,85645661,85645692,1,41765
H1|chr16:85603899-85603971,chr16,85603899,85603971,H1|chr16:85645661-85645692,chr16,85645661,85645692,1,41762
H1|chr16:85603939-85604070,chr16,85603939,85604070,H1|chr16:85642804-85642884,chr16,85642804,85642884,1,38865
H1|chr16:85604000-85604070,chr16,85604000,85604070,H1|chr16:85642804-85642884,chr16,85642804,85642884,1,38804
H1|chr16:85604115-85604260,chr16,85604115,85604260,H1|chr16:85646134-85646208,chr16,85646134,85646208,1,42019
H1|chr16:85604120-85604196,chr16,85604120,85604196,H1|chr16:85646134-85646208,chr16,85646134,85646208,1,42014
H1|chr16:85608421-85608476,chr16,85608421,85608476,H1|chr16:85640482-85640574,chr16,85640482,85640574,1,32061
H1|chr16:85609547-85609626,chr16,85609547,85609626,H1|chr16:85644356-85644375,chr16,85644356,85644375,1,34809
H1|chr16:85611429-85611528,chr16,85611429,85611528,H1|chr16:85647338-85647376,chr16,85647338,85647376,1,35909
H1|chr16:85614098-85614198,chr16,85614098,85614198,H1|chr16:85644379-85644395,chr16,85644379,85644395,1,30281
H1|chr16:85614098-85614197,chr16,85614098,85614197,H1|chr16:85644379-85644395,chr16,85644379,85644395,1,30281
H1|chr16:85615054-85615202,chr16,85615054,85615202,H1|chr16:85644730-85644807,chr16,85644730,85644807,1,29676
H1|chr16:85615054-85615087,chr16,85615054,85615087,H1|chr16:85644775-85644807,chr16,85644775,85644807,1,29721
H1|chr16:85615136-85615209,chr16,85615136,85615209,H1|chr16:85644730-85644807,chr16,85644730,85644807,1,29594
H1|chr16:85615338-85615376,chr16,85615338,85615376,H1|chr16:85643378-85643421,chr16,85643378,85643421,1,28040
H1|chr16:85617069-85617217,chr16,85617069,85617217,H1|chr16:85648383-85648418,chr16,85648383,85648418,1,31314
H1|chr16:85617102-85617217,chr16,85617102,85617217,H1|chr16:85648383-85648418,chr16,85648383,85648418,1,31281
H1|chr16:85627055-85627160,chr16,85627055,85627160,H1|chr16:85641671-85641707,chr16,85641671,85641707,1,14616
H1|chr16:85627079-85627160,chr16,85627079,85627160,H1|chr16:85641849-85641989,chr16,85641849,85641989,1,14770
H1|chr16:85627471-85627562,chr16,85627471,85627562,H1|chr16:85640453-85640531,chr16,85640453,85640531,1,12982
H1|chr16:85627490-85627562,chr16,85627490,85627562,H1|chr16:85640453-85640531,chr16,85640453,85640531,1,12963
H1|chr16:85630204-85630244,chr16,85630204,85630244,H1|chr16:85645514-85645601,chr16,85645514,85645601,1,15310
H1|chr16:85630422-85630485,chr16,85630422,85630485,H1|chr16:85641856-85641901,chr16,85641856,85641901,1,11434
H1|chr16:85635795-85635830,chr16,85635795,85635830,H1|chr16:85642440-85642496,chr16,85642440,85642496,1,6645
H1|chr16:85635957-85635989,chr16,85635957,85635989,H1|chr16:85642667-85642770,chr16,85642667,85642770,1,6710
H1|chr16:85636525-85636623,chr16,85636525,85636623,H1|chr16:85645119-85645170,chr16,85645119,85645170,1,8594
H1|chr16:85636888-85636971,chr16,85636888,85636971,H1|chr16:85640453-85640505,chr16,85640453,85640505,1,3565
H1|chr16:85637968-85638118,chr16,85637968,85638118,H1|chr16:85640908-85640985,chr16,85640908,85640985,1,2940
H1|chr16:85638049-85638122,chr16,85638049,85638122,H1|chr16:85640908-85640985,chr16,85640908,85640985,1,2859
H1|chr16:85638702-85638742,chr16,85638702,85638742,H1|chr16:85640212-85640322,chr16,85640212,85640322,1,1510
H1|chr16:85638982-85639053,chr16,85638982,85639053,H1|chr16:85641456-85641534,chr16,85641456,85641534,1,2474
H1|chr16:85638983-85639053,chr16,85638983,85639053,H1|chr16:85641456-85641534,chr16,85641456,85641534,1,2473
H1|chr16:85639133-85639220,chr16,85639133,85639220,H1|chr16:85642737-85642800,chr16,85642737,85642800,1,3604
H1|chr16:85639134-85639222,chr16,85639134,85639222,H1|chr16:85642737-85642800,chr16,85642737,85642800,1,3603
H1|chr16:85653732-85653826,chr16,85653732,85653826,H1|chr16:85642917-85643028,chr16,85642917,85643028,1,10815
H1|chr16:85653732-85653771,chr16,85653732,85653771,H1|chr16:85642917-85643028,chr16,85642917,85643028,1,10815
H1|chr16:85658605-85658707,chr16,85658605,85658707,H1|chr16:85640924-85640943,chr16,85640924,85640943,1,17681
H1|chr16:85658917-85659007,chr16,85658917,85659007,H1|chr16:85644765-85644812,chr16,85644765,85644812,1,14152
H1|chr16:87861680-87861711,chr16,87861680,87861711,H1|chr16:87899446-87899592,chr16,87899446,87899592,1,37766
H1|chr16:87861703-87861736,chr16,87861703,87861736,H1|chr16:87899170-87899287,chr16,87899170,87899287,1,37467
H1|chr16:87861703-87861735,chr16,87861703,87861735,H1|chr16:87899170-87899287,chr16,87899170,87899287,1,37467
H1|chr16:88449520-88449642,chr16,88449520,88449642,H1|chr16:88491214-88491273,chr16,88491214,88491273,1,41694
H1|chr16:88449570-88449662,chr16,88449570,88449662,H1|chr16:88491214-88491280,chr16,88491214,88491280,1,41644
H1|chr16:88449575-88449662,chr16,88449575,88449662,H1|chr16:88491214-88491273,chr16,88491214,88491273,1,41639
H1|chr16:88449580-88449662,chr16,88449580,88449662,H1|chr16:88491214-88491280,chr16,88491214,88491280,1,41634
H1|chr16:89419603-89419684,chr16,89419603,89419684,H1|chr16:89628517-89628540,chr16,89628517,89628540,1,208914
H1|chr16:89420478-89420571,chr16,89420478,89420571,H1|chr16:89628853-89628889,chr16,89628853,89628889,1,208375
H1|chr16:89420946-89421017,chr16,89420946,89421017,H1|chr16:90088131-90088160,chr16,90088131,90088160,1,667185
H1|chr16:89420946-89420995,chr16,89420946,89420995,H1|chr16:90088131-90088160,chr16,90088131,90088160,1,667185
H1|chr16:89421022-89421068,chr16,89421022,89421068,H1|chr16:87898988-87899089,chr16,87898988,87899089,1,1522034
H1|chr16:89438649-89438762,chr16,89438649,89438762,H1|chr16:89272075-89272112,chr16,89272075,89272112,1,166574
H1|chr16:89442878-89442995,chr16,89442878,89442995,H1|chr16:23606457-23606489,chr16,23606457,23606489,1,65836421
H1|chr16:89442879-89442991,chr16,89442879,89442991,H1|chr16:23606457-23606489,chr16,23606457,23606489,1,65836422
H1|chr16:89448420-89448473,chr16,89448420,89448473,H1|chr16:89780779-89780877,chr16,89780779,89780877,1,332359
H1|chr16:89448420-89448472,chr16,89448420,89448472,H1|chr16:89780779-89780877,chr16,89780779,89780877,1,332359
H1|chr16:89449166-89449197,chr16,89449166,89449197,H1|chr16:89285021-89285140,chr16,89285021,89285140,1,164145
H1|chr16:89454343-89454427,chr16,89454343,89454427,H1|chr16:89285398-89285437,chr16,89285398,89285437,1,168945
H1|chr16:89454561-89454626,chr16,89454561,89454626,H1|chr16:89886407-89886518,chr16,89886407,89886518,1,431846
H1|chr16:89454561-89454598,chr16,89454561,89454598,H1|chr16:89886407-89886518,chr16,89886407,89886518,1,431846
H1|chr16:89455601-89455678,chr16,89455601,89455678,H1|chr16:87897669-87897742,chr16,87897669,87897742,1,1557932
H1|chr16:89460927-89461049,chr16,89460927,89461049,H1|chr16:89625240-89625268,chr16,89625240,89625268,1,164313
H1|chr16:89461425-89461522,chr16,89461425,89461522,H1|chr16:89782798-89782845,chr16,89782798,89782845,1,321373
H1|chr16:89461426-89461521,chr16,89461426,89461521,H1|chr16:89782798-89782845,chr16,89782798,89782845,1,321372
H1|chr16:89464384-89464469,chr16,89464384,89464469,H1|chr16:89786676-89786712,chr16,89786676,89786712,1,322292
H1|chr16:89465921-89466071,chr16,89465921,89466071,H1|chr16:1757271-1757290,chr16,1757271,1757290,1,87708650
H1|chr16:89465951-89466082,chr16,89465951,89466082,H1|chr16:1757271-1757290,chr16,1757271,1757290,1,87708680
H1|chr16:89469212-89469313,chr16,89469212,89469313,H1|chr16:89268397-89268439,chr16,89268397,89268439,1,200815
H1|chr16:89469265-89469314,chr16,89469265,89469314,H1|chr16:89268396-89268438,chr16,89268396,89268438,1,200869
H1|chr16:89471648-89471679,chr16,89471648,89471679,H1|chr16:23604006-23604156,chr16,23604006,23604156,1,65867642
H1|chr16:89472299-89472449,chr16,89472299,89472449,H1|chr16:3449191-3449268,chr16,3449191,3449268,1,86023108
H1|chr16:89472444-89472517,chr16,89472444,89472517,H1|chr16:3449191-3449268,chr16,3449191,3449268,1,86023253
H1|chr16:89472796-89472880,chr16,89472796,89472880,H1|chr16:89284913-89285019,chr16,89284913,89285019,1,187883
H1|chr16:89472796-89472834,chr16,89472796,89472834,H1|chr16:89284913-89285019,chr16,89284913,89285019,1,187883
H1|chr16:89473449-89473563,chr16,89473449,89473563,H1|chr16:89781858-89781960,chr16,89781858,89781960,1,308409
H1|chr16:89473545-89473672,chr16,89473545,89473672,H1|chr16:89270709-89270757,chr16,89270709,89270757,1,202836
H1|chr16:89473545-89473640,chr16,89473545,89473640,H1|chr16:89270709-89270757,chr16,89270709,89270757,1,202836
H1|chr16:89473546-89473672,chr16,89473546,89473672,H1|chr16:89270709-89270757,chr16,89270709,89270757,1,202837
H1|chr16:89476250-89476299,chr16,89476250,89476299,H1|chr16:89887958-89888039,chr16,89887958,89888039,1,411708
H1|chr16:89477329-89477424,chr16,89477329,89477424,H1|chr16:89270852-89270907,chr16,89270852,89270907,1,206477
H1|chr16:89477329-89477422,chr16,89477329,89477422,H1|chr16:89270852-89270907,chr16,89270852,89270907,1,206477
H1|chr16:89479206-89479251,chr16,89479206,89479251,H1|chr16:89780394-89780485,chr16,89780394,89780485,1,301188
H1|chr16:89480212-89480256,chr16,89480212,89480256,H1|chr16:87900238-87900344,chr16,87900238,87900344,1,1579974
H1|chr16:89480631-89480673,chr16,89480631,89480673,H1|chr16:14727639-14727683,chr16,14727639,14727683,1,74752992
H1|chr16:89480631-89480666,chr16,89480631,89480666,H1|chr16:14727639-14727683,chr16,14727639,14727683,1,74752992
H1|chr16:89481443-89481542,chr16,89481443,89481542,H1|chr16:88867824-88867862,chr16,88867824,88867862,1,613619
H1|chr16:89481445-89481544,chr16,89481445,89481544,H1|chr16:88867827-88867862,chr16,88867827,88867862,1,613618
H1|chr16:89481445-89481541,chr16,89481445,89481541,H1|chr16:88867827-88867862,chr16,88867827,88867862,1,613618
H1|chr16:89482054-89482204,chr16,89482054,89482204,H1|chr16:89779669-89779721,chr16,89779669,89779721,1,297615
H1|chr16:89482163-89482245,chr16,89482163,89482245,H1|chr16:89779669-89779721,chr16,89779669,89779721,1,297506
H1|chr16:89482777-89482869,chr16,89482777,89482869,H1|chr16:89772333-89772391,chr16,89772333,89772391,1,289556
H1|chr16:89483062-89483138,chr16,89483062,89483138,H1|chr16:90088002-90088076,chr16,90088002,90088076,1,604940
H1|chr16:89497794-89497828,chr16,89497794,89497828,H1|chr16:89781197-89781347,chr16,89781197,89781347,1,283403
H1|chr16:89509849-89509974,chr16,89509849,89509974,H1|chr16:88870774-88870799,chr16,88870774,88870799,1,639075
H1|chr16:89509926-89510076,chr16,89509926,89510076,H1|chr16:88870774-88870799,chr16,88870774,88870799,1,639152
H1|chr16:89544246-89544322,chr16,89544246,89544322,H1|chr16:89781194-89781242,chr16,89781194,89781242,1,236948
H1|chr16:89544565-89544597,chr16,89544565,89544597,H1|chr16:89780336-89780486,chr16,89780336,89780486,1,235771
H1|chr17:801909-801931,chr17,801909,801931,H1|chr17:62918452-62918580,chr17,62918452,62918580,1,62116543
H1|chr17:830765-830859,chr17,830765,830859,H1|chr17:48424838-48424872,chr17,48424838,48424872,1,47594073
H1|chr17:830765-830854,chr17,830765,830854,H1|chr17:48424824-48424871,chr17,48424824,48424871,1,47594059
H1|chr17:849357-849381,chr17,849357,849381,H1|chr17:1360568-1360687,chr17,1360568,1360687,1,511211
H1|chr17:858915-859042,chr17,858915,859042,H1|chr17:1360679-1360729,chr17,1360679,1360729,1,501764
H1|chr17:858943-859045,chr17,858943,859045,H1|chr17:1360676-1360728,chr17,1360676,1360728,1,501733
H1|chr17:859002-859099,chr17,859002,859099,H1|chr17:1360626-1360712,chr17,1360626,1360712,1,501624
H1|chr17:1977233-1977309,chr17,1977233,1977309,H1|chr17:3542056-3542128,chr17,3542056,3542128,1,1564823
H1|chr17:2798892-2799035,chr17,2798892,2799035,H1|chr17:80378550-80378700,chr17,80378550,80378700,1,77579658
H1|chr17:2798902-2799035,chr17,2798902,2799035,H1|chr17:80378483-80378633,chr17,80378483,80378633,1,77579581
H1|chr17:9233358-9233406,chr17,9233358,9233406,H1|chr17:7194735-7194805,chr17,7194735,7194805,1,2038623
H1|chr17:9233358-9233405,chr17,9233358,9233405,H1|chr17:7194735-7194802,chr17,7194735,7194802,1,2038623
H1|chr17:16350236-16350288,chr17,16350236,16350288,H1|chr17:18906713-18906772,chr17,18906713,18906772,1,2556477
H1|chr17:16350265-16350288,chr17,16350265,16350288,H1|chr17:18906713-18906772,chr17,18906713,18906772,1,2556448
H1|chr17:16350266-16350288,chr17,16350266,16350288,H1|chr17:18906713-18906772,chr17,18906713,18906772,1,2556447
H1|chr17:17002119-17002214,chr17,17002119,17002214,H1|chr17:17726151-17726206,chr17,17726151,17726206,1,724032
H1|chr17:17002119-17002177,chr17,17002119,17002177,H1|chr17:17726151-17726206,chr17,17726151,17726206,1,724032
H1|chr17:17002120-17002225,chr17,17002120,17002225,H1|chr17:17726151-17726206,chr17,17726151,17726206,1,724031
H1|chr17:17042958-17043003,chr17,17042958,17043003,H1|chr17:30676265-30676367,chr17,30676265,30676367,1,13633307
H1|chr17:17042961-17043020,chr17,17042961,17043020,H1|chr17:30676265-30676367,chr17,30676265,30676367,1,13633304
H1|chr17:18314335-18314483,chr17,18314335,18314483,H1|chr17:20436717-20436789,chr17,20436717,20436789,1,2122382
H1|chr17:18314350-18314499,chr17,18314350,18314499,H1|chr17:20436693-20436745,chr17,20436693,20436745,1,2122343
H1|chr17:18316528-18316678,chr17,18316528,18316678,H1|chr17:20434293-20434424,chr17,20434293,20434424,1,2117765
H1|chr17:18316650-18316796,chr17,18316650,18316796,H1|chr17:20434261-20434407,chr17,20434261,20434407,1,2117611
H1|chr17:19357135-19357182,chr17,19357135,19357182,H1|chr17:38514240-38514328,chr17,38514240,38514328,1,19157105
H1|chr17:27355990-27356025,chr17,27355990,27356025,H1|chr17:27190479-27190589,chr17,27190479,27190589,1,165511
H1|chr17:27355990-27356023,chr17,27355990,27356023,H1|chr17:27190479-27190589,chr17,27190479,27190589,1,165511
H1|chr17:27358292-27358321,chr17,27358292,27358321,H1|chr17:27138404-27138477,chr17,27138404,27138477,1,219888
H1|chr17:27474997-27475092,chr17,27474997,27475092,H1|chr17:42191043-42191074,chr17,42191043,42191074,1,14716046
H1|chr17:27474997-27475091,chr17,27474997,27475091,H1|chr17:42191043-42191074,chr17,42191043,42191074,1,14716046
H1|chr17:27475054-27475092,chr17,27475054,27475092,H1|chr17:42191043-42191074,chr17,42191043,42191074,1,14715989
H1|chr17:29030383-29030512,chr17,29030383,29030512,H1|chr17:29057347-29057387,chr17,29057347,29057387,1,26964
H1|chr17:29034740-29034812,chr17,29034740,29034812,H1|chr17:29054858-29054905,chr17,29054858,29054905,1,20118
H1|chr17:29038778-29038822,chr17,29038778,29038822,H1|chr17:7383903-7384045,chr17,7383903,7384045,1,21654875
H1|chr17:29039069-29039120,chr17,29039069,29039120,H1|chr17:27718472-27718569,chr17,27718472,27718569,1,1320597
H1|chr17:29042372-29042449,chr17,29042372,29042449,H1|chr17:27717418-27717461,chr17,27717418,27717461,1,1324954
H1|chr17:29043463-29043517,chr17,29043463,29043517,H1|chr17:27718424-27718467,chr17,27718424,27718467,1,1325039
H1|chr17:29043464-29043517,chr17,29043464,29043517,H1|chr17:27718424-27718467,chr17,27718424,27718467,1,1325040
H1|chr17:30848761-30848838,chr17,30848761,30848838,H1|chr17:25606479-25606544,chr17,25606479,25606544,1,5242282
H1|chr17:34972656-34972721,chr17,34972656,34972721,H1|chr17:34949625-34949731,chr17,34949625,34949731,1,23031
H1|chr17:34972656-34972700,chr17,34972656,34972700,H1|chr17:34949625-34949731,chr17,34949625,34949731,1,23031
H1|chr17:34977161-34977204,chr17,34977161,34977204,H1|chr17:34959275-34959325,chr17,34959275,34959325,1,17886
H1|chr17:34977236-34977274,chr17,34977236,34977274,H1|chr17:34959275-34959325,chr17,34959275,34959325,1,17961
H1|chr17:34977622-34977655,chr17,34977622,34977655,H1|chr17:34959156-34959241,chr17,34959156,34959241,1,18466
H1|chr17:35048806-35048874,chr17,35048806,35048874,H1|chr17:35075760-35075803,chr17,35075760,35075803,1,26954
H1|chr17:35052421-35052470,chr17,35052421,35052470,H1|chr17:35076963-35077064,chr17,35076963,35077064,1,24542
H1|chr17:35052422-35052531,chr17,35052422,35052531,H1|chr17:35076963-35077064,chr17,35076963,35077064,1,24541
H1|chr17:35079505-35079525,chr17,35079505,35079525,H1|chr17:44318787-44318889,chr17,44318787,44318889,1,9239282
H1|chr17:36560337-36560382,chr17,36560337,36560382,H1|chr17:36507883-36507942,chr17,36507883,36507942,1,52454
H1|chr17:36561552-36561605,chr17,36561552,36561605,H1|chr17:36507821-36507936,chr17,36507821,36507936,1,53731
H1|chr17:36561552-36561587,chr17,36561552,36561587,H1|chr17:36507821-36507936,chr17,36507821,36507936,1,53731
H1|chr17:36575684-36575754,chr17,36575684,36575754,H1|chr17:36580476-36580534,chr17,36580476,36580534,1,4792
H1|chr17:36575740-36575768,chr17,36575740,36575768,H1|chr17:36580640-36580760,chr17,36580640,36580760,1,4900
H1|chr17:36575833-36575869,chr17,36575833,36575869,H1|chr17:36579648-36579737,chr17,36579648,36579737,1,3815
H1|chr17:36575879-36575914,chr17,36575879,36575914,H1|chr17:36584033-36584129,chr17,36584033,36584129,1,8154
H1|chr17:36575903-36576031,chr17,36575903,36576031,H1|chr17:36580622-36580691,chr17,36580622,36580691,1,4719
H1|chr17:36575950-36576031,chr17,36575950,36576031,H1|chr17:36580622-36580691,chr17,36580622,36580691,1,4672
H1|chr17:36576047-36576100,chr17,36576047,36576100,H1|chr17:36582459-36582540,chr17,36582459,36582540,1,6412
H1|chr17:36576282-36576372,chr17,36576282,36576372,H1|chr17:36608483-36608566,chr17,36608483,36608566,1,32201
H1|chr17:36577005-36577066,chr17,36577005,36577066,H1|chr17:36580547-36580578,chr17,36580547,36580578,1,3542
H1|chr17:36577471-36577584,chr17,36577471,36577584,H1|chr17:36612344-36612363,chr17,36612344,36612363,1,34873
H1|chr17:36577473-36577584,chr17,36577473,36577584,H1|chr17:36612344-36612363,chr17,36612344,36612363,1,34871
H1|chr17:36577533-36577591,chr17,36577533,36577591,H1|chr17:36582201-36582317,chr17,36582201,36582317,1,4668
H1|chr17:36577557-36577591,chr17,36577557,36577591,H1|chr17:36582201-36582317,chr17,36582201,36582317,1,4644
H1|chr17:36577834-36577951,chr17,36577834,36577951,H1|chr17:36610436-36610460,chr17,36610436,36610460,1,32602
H1|chr17:36577906-36577996,chr17,36577906,36577996,H1|chr17:36581206-36581236,chr17,36581206,36581236,1,3300
H1|chr17:36577937-36577981,chr17,36577937,36577981,H1|chr17:36580511-36580573,chr17,36580511,36580573,1,2574
H1|chr17:36577954-36577972,chr17,36577954,36577972,H1|chr17:36610436-36610460,chr17,36610436,36610460,1,32482
H1|chr17:36578041-36578147,chr17,36578041,36578147,H1|chr17:36612604-36612705,chr17,36612604,36612705,1,34563
H1|chr17:36578097-36578134,chr17,36578097,36578134,H1|chr17:36581792-36581860,chr17,36581792,36581860,1,3695
H1|chr17:36578098-36578147,chr17,36578098,36578147,H1|chr17:36612604-36612705,chr17,36612604,36612705,1,34506
H1|chr17:36578198-36578288,chr17,36578198,36578288,H1|chr17:36584361-36584421,chr17,36584361,36584421,1,6163
H1|chr17:36578603-36578627,chr17,36578603,36578627,H1|chr17:36580044-36580156,chr17,36580044,36580156,1,1441
H1|chr17:36578614-36578664,chr17,36578614,36578664,H1|chr17:36581172-36581262,chr17,36581172,36581262,1,2558
H1|chr17:36578818-36578899,chr17,36578818,36578899,H1|chr17:36580689-36580719,chr17,36580689,36580719,1,1871
H1|chr17:36578913-36579004,chr17,36578913,36579004,H1|chr17:36580536-36580603,chr17,36580536,36580603,1,1623
H1|chr17:36578921-36579004,chr17,36578921,36579004,H1|chr17:36580536-36580603,chr17,36580536,36580603,1,1615
H1|chr17:36579067-36579118,chr17,36579067,36579118,H1|chr17:36580718-36580788,chr17,36580718,36580788,1,1651
H1|chr17:36597032-36597148,chr17,36597032,36597148,H1|chr17:79820781-79820815,chr17,79820781,79820815,1,43223749
H1|chr17:36599814-36599833,chr17,36599814,36599833,H1|chr17:36582166-36582316,chr17,36582166,36582316,1,17648
H1|chr17:36602459-36602510,chr17,36602459,36602510,H1|chr17:36583656-36583711,chr17,36583656,36583711,1,18803
H1|chr17:36602986-36603037,chr17,36602986,36603037,H1|chr17:36579972-36580051,chr17,36579972,36580051,1,23014
H1|chr17:36603532-36603677,chr17,36603532,36603677,H1|chr17:36579809-36579889,chr17,36579809,36579889,1,23723
H1|chr17:36603532-36603602,chr17,36603532,36603602,H1|chr17:36579809-36579889,chr17,36579809,36579889,1,23723
H1|chr17:36603532-36603596,chr17,36603532,36603596,H1|chr17:36579809-36579889,chr17,36579809,36579889,1,23723
H1|chr17:36604288-36604318,chr17,36604288,36604318,H1|chr17:36580716-36580786,chr17,36580716,36580786,1,23572
H1|chr17:36604356-36604390,chr17,36604356,36604390,H1|chr17:36583664-36583806,chr17,36583664,36583806,1,20692
H1|chr17:36606344-36606405,chr17,36606344,36606405,H1|chr17:36584300-36584352,chr17,36584300,36584352,1,22044
H1|chr17:37037062-37037152,chr17,37037062,37037152,H1|chr17:28804582-28804611,chr17,28804582,28804611,1,8232480
H1|chr17:37037062-37037134,chr17,37037062,37037134,H1|chr17:28804582-28804611,chr17,28804582,28804611,1,8232480
H1|chr17:37037302-37037340,chr17,37037302,37037340,H1|chr17:27892808-27892916,chr17,27892808,27892916,1,9144494
H1|chr17:37038007-37038055,chr17,37038007,37038055,H1|chr17:27892852-27892916,chr17,27892852,27892916,1,9145155
H1|chr17:37038013-37038055,chr17,37038013,37038055,H1|chr17:27892808-27892916,chr17,27892808,27892916,1,9145205
H1|chr17:38267903-38267981,chr17,38267903,38267981,H1|chr17:38273510-38273596,chr17,38273510,38273596,1,5607
H1|chr17:38267903-38267967,chr17,38267903,38267967,H1|chr17:38273511-38273596,chr17,38273511,38273596,1,5608
H1|chr17:38269247-38269315,chr17,38269247,38269315,H1|chr17:38277292-38277354,chr17,38277292,38277354,1,8045
H1|chr17:38270350-38270426,chr17,38270350,38270426,H1|chr17:38278091-38278140,chr17,38278091,38278140,1,7741
H1|chr17:38270351-38270426,chr17,38270351,38270426,H1|chr17:38278091-38278140,chr17,38278091,38278140,1,7740
H1|chr17:38270484-38270566,chr17,38270484,38270566,H1|chr17:38275895-38276009,chr17,38275895,38276009,1,5411
H1|chr17:40471653-40471702,chr17,40471653,40471702,H1|chr17:4170041-4170134,chr17,4170041,4170134,1,36301612
H1|chr17:40471653-40471701,chr17,40471653,40471701,H1|chr17:4170041-4170134,chr17,4170041,4170134,1,36301612
H1|chr17:41399727-41399813,chr17,41399727,41399813,H1|chr17:41281176-41281240,chr17,41281176,41281240,1,118551
H1|chr17:41399864-41399889,chr17,41399864,41399889,H1|chr17:41281176-41281240,chr17,41281176,41281240,1,118688
H1|chr17:41400181-41400245,chr17,41400181,41400245,H1|chr17:41277935-41277993,chr17,41277935,41277993,1,122246
H1|chr17:41400273-41400387,chr17,41400273,41400387,H1|chr17:40730722-40730778,chr17,40730722,40730778,1,669551
H1|chr17:41400274-41400368,chr17,41400274,41400368,H1|chr17:40730722-40730778,chr17,40730722,40730778,1,669552
H1|chr17:41400274-41400365,chr17,41400274,41400365,H1|chr17:40730722-40730778,chr17,40730722,40730778,1,669552
H1|chr17:43657711-43657836,chr17,43657711,43657836,H1|chr17:65826239-65826264,chr17,65826239,65826264,1,22168528
H1|chr17:43657721-43657871,chr17,43657721,43657871,H1|chr17:65826239-65826264,chr17,65826239,65826264,1,22168518
H1|chr17:43657748-43657803,chr17,43657748,43657803,H1|chr17:43321657-43321680,chr17,43321657,43321680,1,336091
H1|chr17:43657767-43657803,chr17,43657767,43657803,H1|chr17:43321657-43321680,chr17,43321657,43321680,1,336110
H1|chr17:43658365-43658385,chr17,43658365,43658385,H1|chr17:65825338-65825366,chr17,65825338,65825366,1,22166973
H1|chr17:43662011-43662064,chr17,43662011,43662064,H1|chr17:62915430-62915532,chr17,62915430,62915532,1,19253419
H1|chr17:43662011-43662056,chr17,43662011,43662056,H1|chr17:62915430-62915532,chr17,62915430,62915532,1,19253419
H1|chr17:43662081-43662164,chr17,43662081,43662164,H1|chr17:62915431-62915519,chr17,62915431,62915519,1,19253350
H1|chr17:43662087-43662164,chr17,43662087,43662164,H1|chr17:62915431-62915523,chr17,62915431,62915523,1,19253344
H1|chr17:43662196-43662343,chr17,43662196,43662343,H1|chr17:62915448-62915582,chr17,62915448,62915582,1,19253252
H1|chr17:43662236-43662386,chr17,43662236,43662386,H1|chr17:62915431-62915532,chr17,62915431,62915532,1,19253195
H1|chr17:43662239-43662387,chr17,43662239,43662387,H1|chr17:62915431-62915537,chr17,62915431,62915537,1,19253192
H1|chr17:43662242-43662387,chr17,43662242,43662387,H1|chr17:62915431-62915539,chr17,62915431,62915539,1,19253189
H1|chr17:43662243-43662387,chr17,43662243,43662387,H1|chr17:62915431-62915528,chr17,62915431,62915528,1,19253188
H1|chr17:43662341-43662491,chr17,43662341,43662491,H1|chr17:62915454-62915582,chr17,62915454,62915582,1,19253113
H1|chr17:43662342-43662490,chr17,43662342,43662490,H1|chr17:62915467-62915583,chr17,62915467,62915583,1,19253125
H1|chr17:43662345-43662495,chr17,43662345,43662495,H1|chr17:62915471-62915583,chr17,62915471,62915583,1,19253126
H1|chr17:43662347-43662497,chr17,43662347,43662497,H1|chr17:62915476-62915575,chr17,62915476,62915575,1,19253129
H1|chr17:43662348-43662498,chr17,43662348,43662498,H1|chr17:62915456-62915579,chr17,62915456,62915579,1,19253108
H1|chr17:43662354-43662496,chr17,43662354,43662496,H1|chr17:62915428-62915577,chr17,62915428,62915577,1,19253074
H1|chr17:43662355-43662496,chr17,43662355,43662496,H1|chr17:62915485-62915582,chr17,62915485,62915582,1,19253130
H1|chr17:43662356-43662496,chr17,43662356,43662496,H1|chr17:62915459-62915583,chr17,62915459,62915583,1,19253103
H1|chr17:43662364-43662508,chr17,43662364,43662508,H1|chr17:62915467-62915583,chr17,62915467,62915583,1,19253103
H1|chr17:43662364-43662497,chr17,43662364,43662497,H1|chr17:62915413-62915539,chr17,62915413,62915539,1,19253049
H1|chr17:43662369-43662519,chr17,43662369,43662519,H1|chr17:62915469-62915579,chr17,62915469,62915579,1,19253100
H1|chr17:43662373-43662520,chr17,43662373,43662520,H1|chr17:62915456-62915575,chr17,62915456,62915575,1,19253083
H1|chr17:43662377-43662527,chr17,43662377,43662527,H1|chr17:62915476-62915582,chr17,62915476,62915582,1,19253099
H1|chr17:43662377-43662479,chr17,43662377,43662479,H1|chr17:62915435-62915521,chr17,62915435,62915521,1,19253058
H1|chr17:43662379-43662524,chr17,43662379,43662524,H1|chr17:62915467-62915575,chr17,62915467,62915575,1,19253088
H1|chr17:43662388-43662535,chr17,43662388,43662535,H1|chr17:62915438-62915577,chr17,62915438,62915577,1,19253050
H1|chr17:43662408-43662524,chr17,43662408,43662524,H1|chr17:62915431-62915538,chr17,62915431,62915538,1,19253023
H1|chr17:43662412-43662520,chr17,43662412,43662520,H1|chr17:62915431-62915538,chr17,62915431,62915538,1,19253019
H1|chr17:43662412-43662516,chr17,43662412,43662516,H1|chr17:62915431-62915525,chr17,62915431,62915525,1,19253019
H1|chr17:43662424-43662521,chr17,43662424,43662521,H1|chr17:62915431-62915538,chr17,62915431,62915538,1,19253007
H1|chr17:43662434-43662515,chr17,43662434,43662515,H1|chr17:62915425-62915559,chr17,62915425,62915559,1,19252991
H1|chr17:43662439-43662523,chr17,43662439,43662523,H1|chr17:62915431-62915538,chr17,62915431,62915538,1,19252992
H1|chr17:43662451-43662522,chr17,43662451,43662522,H1|chr17:62915431-62915538,chr17,62915431,62915538,1,19252980
H1|chr17:43662451-43662516,chr17,43662451,43662516,H1|chr17:62915431-62915520,chr17,62915431,62915520,1,19252980
H1|chr17:43662475-43662527,chr17,43662475,43662527,H1|chr17:62915431-62915570,chr17,62915431,62915570,1,19252956
H1|chr17:43662485-43662512,chr17,43662485,43662512,H1|chr17:62915431-62915529,chr17,62915431,62915529,1,19252946
H1|chr17:43662634-43662764,chr17,43662634,43662764,H1|chr17:62915633-62915783,chr17,62915633,62915783,1,19252999
H1|chr17:43662661-43662811,chr17,43662661,43662811,H1|chr17:62915755-62915900,chr17,62915755,62915900,1,19253094
H1|chr17:43662661-43662810,chr17,43662661,43662810,H1|chr17:62915755-62915900,chr17,62915755,62915900,1,19253094
H1|chr17:43662691-43662832,chr17,43662691,43662832,H1|chr17:62915631-62915780,chr17,62915631,62915780,1,19252940
H1|chr17:43662723-43662759,chr17,43662723,43662759,H1|chr17:62915766-62915912,chr17,62915766,62915912,1,19253043
H1|chr17:44186596-44186629,chr17,44186596,44186629,H1|chr17:75086770-75086850,chr17,75086770,75086850,1,30900174
H1|chr17:44189906-44190048,chr17,44189906,44190048,H1|chr17:44316959-44316996,chr17,44316959,44316996,1,127053
H1|chr17:44189928-44190041,chr17,44189928,44190041,H1|chr17:44316959-44316996,chr17,44316959,44316996,1,127031
H1|chr17:44204982-44205045,chr17,44204982,44205045,H1|chr17:44316442-44316518,chr17,44316442,44316518,1,111460
H1|chr17:44205143-44205225,chr17,44205143,44205225,H1|chr17:63055940-63055970,chr17,63055940,63055970,1,18850797
H1|chr17:44205143-44205182,chr17,44205143,44205182,H1|chr17:63055942-63055970,chr17,63055942,63055970,1,18850799
H1|chr17:44205156-44205225,chr17,44205156,44205225,H1|chr17:63055940-63055970,chr17,63055940,63055970,1,18850784
H1|chr17:44205156-44205182,chr17,44205156,44205182,H1|chr17:63055942-63055970,chr17,63055942,63055970,1,18850786
H1|chr17:44205508-44205578,chr17,44205508,44205578,H1|chr17:65972955-65973008,chr17,65972955,65973008,1,21767447
H1|chr17:44205511-44205578,chr17,44205511,44205578,H1|chr17:65972955-65973008,chr17,65972955,65973008,1,21767444
H1|chr17:44210595-44210641,chr17,44210595,44210641,H1|chr17:46133004-46133095,chr17,46133004,46133095,1,1922409
H1|chr17:44210596-44210644,chr17,44210596,44210644,H1|chr17:46132997-46133095,chr17,46132997,46133095,1,1922401
H1|chr17:44211874-44211947,chr17,44211874,44211947,H1|chr17:38329274-38329339,chr17,38329274,38329339,1,5882600
H1|chr17:44212772-44212886,chr17,44212772,44212886,H1|chr17:62918454-62918551,chr17,62918454,62918551,1,18705682
H1|chr17:44212772-44212878,chr17,44212772,44212878,H1|chr17:62918454-62918518,chr17,62918454,62918518,1,18705682
H1|chr17:44212772-44212874,chr17,44212772,44212874,H1|chr17:62918449-62918580,chr17,62918449,62918580,1,18705677
H1|chr17:44212772-44212871,chr17,44212772,44212871,H1|chr17:62918454-62918543,chr17,62918454,62918543,1,18705682
H1|chr17:44212772-44212865,chr17,44212772,44212865,H1|chr17:62918454-62918526,chr17,62918454,62918526,1,18705682
H1|chr17:44212772-44212848,chr17,44212772,44212848,H1|chr17:62918449-62918587,chr17,62918449,62918587,1,18705677
H1|chr17:44212772-44212829,chr17,44212772,44212829,H1|chr17:62918454-62918532,chr17,62918454,62918532,1,18705682
H1|chr17:44212772-44212821,chr17,44212772,44212821,H1|chr17:62918449-62918589,chr17,62918449,62918589,1,18705677
H1|chr17:44212772-44212817,chr17,44212772,44212817,H1|chr17:62918505-62918586,chr17,62918505,62918586,1,18705733
H1|chr17:44212775-44212886,chr17,44212775,44212886,H1|chr17:62918454-62918532,chr17,62918454,62918532,1,18705679
H1|chr17:44212775-44212878,chr17,44212775,44212878,H1|chr17:62918449-62918584,chr17,62918449,62918584,1,18705674
H1|chr17:44212775-44212874,chr17,44212775,44212874,H1|chr17:62918449-62918592,chr17,62918449,62918592,1,18705674
H1|chr17:44212775-44212871,chr17,44212775,44212871,H1|chr17:62918454-62918543,chr17,62918454,62918543,1,18705679
H1|chr17:44212775-44212860,chr17,44212775,44212860,H1|chr17:62918449-62918584,chr17,62918449,62918584,1,18705674
H1|chr17:44212775-44212858,chr17,44212775,44212858,H1|chr17:62918454-62918553,chr17,62918454,62918553,1,18705679
H1|chr17:44212775-44212857,chr17,44212775,44212857,H1|chr17:62918454-62918518,chr17,62918454,62918518,1,18705679
H1|chr17:44212775-44212856,chr17,44212775,44212856,H1|chr17:62918454-62918518,chr17,62918454,62918518,1,18705679
H1|chr17:44212775-44212854,chr17,44212775,44212854,H1|chr17:62918449-62918596,chr17,62918449,62918596,1,18705674
H1|chr17:44212775-44212853,chr17,44212775,44212853,H1|chr17:62918454-62918530,chr17,62918454,62918530,1,18705679
H1|chr17:44212775-44212849,chr17,44212775,44212849,H1|chr17:62918454-62918530,chr17,62918454,62918530,1,18705679
H1|chr17:44212775-44212847,chr17,44212775,44212847,H1|chr17:62918454-62918532,chr17,62918454,62918532,1,18705679
H1|chr17:44212775-44212844,chr17,44212775,44212844,H1|chr17:62918454-62918532,chr17,62918454,62918532,1,18705679
H1|chr17:44212775-44212841,chr17,44212775,44212841,H1|chr17:62918454-62918518,chr17,62918454,62918518,1,18705679
H1|chr17:44212775-44212837,chr17,44212775,44212837,H1|chr17:62918454-62918532,chr17,62918454,62918532,1,18705679
H1|chr17:44212775-44212836,chr17,44212775,44212836,H1|chr17:62918454-62918543,chr17,62918454,62918543,1,18705679
H1|chr17:44212775-44212835,chr17,44212775,44212835,H1|chr17:62918454-62918530,chr17,62918454,62918530,1,18705679
H1|chr17:44212775-44212829,chr17,44212775,44212829,H1|chr17:62918454-62918532,chr17,62918454,62918532,1,18705679
H1|chr17:44212775-44212828,chr17,44212775,44212828,H1|chr17:62918454-62918551,chr17,62918454,62918551,1,18705679
H1|chr17:44212775-44212827,chr17,44212775,44212827,H1|chr17:62918454-62918552,chr17,62918454,62918552,1,18705679
H1|chr17:44212775-44212826,chr17,44212775,44212826,H1|chr17:62918454-62918532,chr17,62918454,62918532,1,18705679
H1|chr17:44212775-44212825,chr17,44212775,44212825,H1|chr17:62918454-62918553,chr17,62918454,62918553,1,18705679
H1|chr17:44212775-44212824,chr17,44212775,44212824,H1|chr17:62918454-62918532,chr17,62918454,62918532,1,18705679
H1|chr17:44212775-44212823,chr17,44212775,44212823,H1|chr17:62918454-62918532,chr17,62918454,62918532,1,18705679
H1|chr17:44212775-44212822,chr17,44212775,44212822,H1|chr17:62918454-62918532,chr17,62918454,62918532,1,18705679
H1|chr17:44212775-44212821,chr17,44212775,44212821,H1|chr17:62918454-62918534,chr17,62918454,62918534,1,18705679
H1|chr17:44212775-44212820,chr17,44212775,44212820,H1|chr17:62918454-62918555,chr17,62918454,62918555,1,18705679
H1|chr17:44212775-44212819,chr17,44212775,44212819,H1|chr17:62918454-62918524,chr17,62918454,62918524,1,18705679
H1|chr17:44212775-44212818,chr17,44212775,44212818,H1|chr17:62918454-62918532,chr17,62918454,62918532,1,18705679
H1|chr17:44212775-44212812,chr17,44212775,44212812,H1|chr17:62918454-62918566,chr17,62918454,62918566,1,18705679
H1|chr17:44212775-44212807,chr17,44212775,44212807,H1|chr17:62918454-62918571,chr17,62918454,62918571,1,18705679
H1|chr17:44212775-44212805,chr17,44212775,44212805,H1|chr17:62918454-62918571,chr17,62918454,62918571,1,18705679
H1|chr17:44212776-44212821,chr17,44212776,44212821,H1|chr17:62918453-62918556,chr17,62918453,62918556,1,18705677
H1|chr17:44212780-44212855,chr17,44212780,44212855,H1|chr17:62918454-62918526,chr17,62918454,62918526,1,18705674
H1|chr17:44212780-44212853,chr17,44212780,44212853,H1|chr17:62918449-62918524,chr17,62918449,62918524,1,18705669
H1|chr17:44212780-44212850,chr17,44212780,44212850,H1|chr17:62918449-62918597,chr17,62918449,62918597,1,18705669
H1|chr17:44212780-44212849,chr17,44212780,44212849,H1|chr17:62918457-62918607,chr17,62918457,62918607,1,18705677
H1|chr17:44212780-44212848,chr17,44212780,44212848,H1|chr17:62918449-62918587,chr17,62918449,62918587,1,18705669
H1|chr17:44212780-44212843,chr17,44212780,44212843,H1|chr17:62918454-62918560,chr17,62918454,62918560,1,18705674
H1|chr17:44212780-44212842,chr17,44212780,44212842,H1|chr17:62918449-62918585,chr17,62918449,62918585,1,18705669
H1|chr17:44212780-44212841,chr17,44212780,44212841,H1|chr17:62918449-62918538,chr17,62918449,62918538,1,18705669
H1|chr17:44212780-44212838,chr17,44212780,44212838,H1|chr17:62918449-62918526,chr17,62918449,62918526,1,18705669
H1|chr17:44212780-44212837,chr17,44212780,44212837,H1|chr17:62918449-62918535,chr17,62918449,62918535,1,18705669
H1|chr17:44212780-44212836,chr17,44212780,44212836,H1|chr17:62918449-62918580,chr17,62918449,62918580,1,18705669
H1|chr17:44212780-44212835,chr17,44212780,44212835,H1|chr17:62918486-62918633,chr17,62918486,62918633,1,18705706
H1|chr17:44212780-44212829,chr17,44212780,44212829,H1|chr17:62918454-62918532,chr17,62918454,62918532,1,18705674
H1|chr17:44212780-44212828,chr17,44212780,44212828,H1|chr17:62918454-62918532,chr17,62918454,62918532,1,18705674
H1|chr17:44212780-44212827,chr17,44212780,44212827,H1|chr17:62918454-62918543,chr17,62918454,62918543,1,18705674
H1|chr17:44212780-44212826,chr17,44212780,44212826,H1|chr17:62918449-62918589,chr17,62918449,62918589,1,18705669
H1|chr17:44212780-44212825,chr17,44212780,44212825,H1|chr17:62918449-62918554,chr17,62918449,62918554,1,18705669
H1|chr17:44212780-44212824,chr17,44212780,44212824,H1|chr17:62918454-62918532,chr17,62918454,62918532,1,18705674
H1|chr17:44212780-44212823,chr17,44212780,44212823,H1|chr17:62918454-62918532,chr17,62918454,62918532,1,18705674
H1|chr17:44212780-44212822,chr17,44212780,44212822,H1|chr17:62918454-62918532,chr17,62918454,62918532,1,18705674
H1|chr17:44212780-44212821,chr17,44212780,44212821,H1|chr17:62918449-62918572,chr17,62918449,62918572,1,18705669
H1|chr17:44212780-44212820,chr17,44212780,44212820,H1|chr17:62918449-62918558,chr17,62918449,62918558,1,18705669
H1|chr17:44212780-44212819,chr17,44212780,44212819,H1|chr17:62918454-62918524,chr17,62918454,62918524,1,18705674
H1|chr17:44212780-44212818,chr17,44212780,44212818,H1|chr17:62918454-62918532,chr17,62918454,62918532,1,18705674
H1|chr17:44212780-44212817,chr17,44212780,44212817,H1|chr17:62918449-62918587,chr17,62918449,62918587,1,18705669
H1|chr17:44212780-44212816,chr17,44212780,44212816,H1|chr17:62918449-62918528,chr17,62918449,62918528,1,18705669
H1|chr17:44212780-44212815,chr17,44212780,44212815,H1|chr17:62918449-62918572,chr17,62918449,62918572,1,18705669
H1|chr17:44212780-44212814,chr17,44212780,44212814,H1|chr17:62918449-62918597,chr17,62918449,62918597,1,18705669
H1|chr17:44212780-44212812,chr17,44212780,44212812,H1|chr17:62918449-62918567,chr17,62918449,62918567,1,18705669
H1|chr17:44212780-44212811,chr17,44212780,44212811,H1|chr17:62918449-62918568,chr17,62918449,62918568,1,18705669
H1|chr17:44212780-44212810,chr17,44212780,44212810,H1|chr17:62918449-62918586,chr17,62918449,62918586,1,18705669
H1|chr17:44212780-44212808,chr17,44212780,44212808,H1|chr17:62918452-62918580,chr17,62918452,62918580,1,18705672
H1|chr17:44212780-44212807,chr17,44212780,44212807,H1|chr17:62918449-62918572,chr17,62918449,62918572,1,18705669
H1|chr17:44212780-44212806,chr17,44212780,44212806,H1|chr17:62918449-62918584,chr17,62918449,62918584,1,18705669
H1|chr17:44212780-44212805,chr17,44212780,44212805,H1|chr17:62918449-62918574,chr17,62918449,62918574,1,18705669
H1|chr17:44212780-44212804,chr17,44212780,44212804,H1|chr17:62918449-62918555,chr17,62918449,62918555,1,18705669
H1|chr17:44212780-44212803,chr17,44212780,44212803,H1|chr17:62918480-62918628,chr17,62918480,62918628,1,18705700
H1|chr17:44212780-44212802,chr17,44212780,44212802,H1|chr17:62918449-62918519,chr17,62918449,62918519,1,18705669
H1|chr17:44212780-44212801,chr17,44212780,44212801,H1|chr17:62918449-62918591,chr17,62918449,62918591,1,18705669
H1|chr17:44212782-44212886,chr17,44212782,44212886,H1|chr17:62918449-62918590,chr17,62918449,62918590,1,18705667
H1|chr17:44212782-44212841,chr17,44212782,44212841,H1|chr17:62918449-62918597,chr17,62918449,62918597,1,18705667
H1|chr17:44212782-44212821,chr17,44212782,44212821,H1|chr17:62918454-62918532,chr17,62918454,62918532,1,18705672
H1|chr17:44212786-44212835,chr17,44212786,44212835,H1|chr17:62918449-62918587,chr17,62918449,62918587,1,18705663
H1|chr17:44212810-44212853,chr17,44212810,44212853,H1|chr17:62918449-62918572,chr17,62918449,62918572,1,18705639
H1|chr17:44212819-44212853,chr17,44212819,44212853,H1|chr17:62918449-62918586,chr17,62918449,62918586,1,18705630
H1|chr17:44212822-44212972,chr17,44212822,44212972,H1|chr17:62918449-62918583,chr17,62918449,62918583,1,18705627
H1|chr17:44212863-44212936,chr17,44212863,44212936,H1|chr17:62918449-62918574,chr17,62918449,62918574,1,18705586
H1|chr17:44212908-44212998,chr17,44212908,44212998,H1|chr17:62918454-62918551,chr17,62918454,62918551,1,18705546
H1|chr17:44212922-44212993,chr17,44212922,44212993,H1|chr17:62918455-62918534,chr17,62918455,62918534,1,18705533
H1|chr17:44212927-44213035,chr17,44212927,44213035,H1|chr17:62918455-62918534,chr17,62918455,62918534,1,18705528
H1|chr17:44212927-44212960,chr17,44212927,44212960,H1|chr17:62918454-62918552,chr17,62918454,62918552,1,18705527
H1|chr17:44212928-44212973,chr17,44212928,44212973,H1|chr17:62918497-62918626,chr17,62918497,62918626,1,18705569
H1|chr17:44212939-44212964,chr17,44212939,44212964,H1|chr17:62918449-62918563,chr17,62918449,62918563,1,18705510
H1|chr17:44212973-44213035,chr17,44212973,44213035,H1|chr17:62918455-62918534,chr17,62918455,62918534,1,18705482
H1|chr17:44212974-44213045,chr17,44212974,44213045,H1|chr17:62918813-62918888,chr17,62918813,62918888,1,18705839
H1|chr17:44212998-44213030,chr17,44212998,44213030,H1|chr17:62918456-62918571,chr17,62918456,62918571,1,18705458
H1|chr17:44213003-44213031,chr17,44213003,44213031,H1|chr17:62918459-62918581,chr17,62918459,62918581,1,18705456
H1|chr17:44213003-44213027,chr17,44213003,44213027,H1|chr17:62918459-62918585,chr17,62918459,62918585,1,18705456
H1|chr17:44213046-44213141,chr17,44213046,44213141,H1|chr17:62918485-62918518,chr17,62918485,62918518,1,18705439
H1|chr17:44213073-44213188,chr17,44213073,44213188,H1|chr17:62918516-62918587,chr17,62918516,62918587,1,18705443
H1|chr17:44213073-44213146,chr17,44213073,44213146,H1|chr17:62918516-62918587,chr17,62918516,62918587,1,18705443
H1|chr17:44213284-44213329,chr17,44213284,44213329,H1|chr17:44316439-44316547,chr17,44316439,44316547,1,103155
H1|chr17:44213284-44213326,chr17,44213284,44213326,H1|chr17:44316439-44316547,chr17,44316439,44316547,1,103155
H1|chr17:44213511-44213582,chr17,44213511,44213582,H1|chr17:62918449-62918520,chr17,62918449,62918520,1,18704938
H1|chr17:44213540-44213616,chr17,44213540,44213616,H1|chr17:44316163-44316272,chr17,44316163,44316272,1,102623
H1|chr17:44213541-44213617,chr17,44213541,44213617,H1|chr17:44316105-44316162,chr17,44316105,44316162,1,102564
H1|chr17:44215376-44215416,chr17,44215376,44215416,H1|chr17:46135238-46135347,chr17,46135238,46135347,1,1919862
H1|chr17:44215429-44215470,chr17,44215429,44215470,H1|chr17:46135238-46135347,chr17,46135238,46135347,1,1919809
H1|chr17:44216070-44216215,chr17,44216070,44216215,H1|chr17:62918638-62918656,chr17,62918638,62918656,1,18702568
H1|chr17:44216083-44216215,chr17,44216083,44216215,H1|chr17:62918638-62918656,chr17,62918638,62918656,1,18702555
H1|chr17:44216192-44216231,chr17,44216192,44216231,H1|chr17:44316593-44316648,chr17,44316593,44316648,1,100401
H1|chr17:44231871-44231917,chr17,44231871,44231917,H1|chr17:44318254-44318400,chr17,44318254,44318400,1,86383
H1|chr17:44233480-44233535,chr17,44233480,44233535,H1|chr17:44316142-44316222,chr17,44316142,44316222,1,82662
H1|chr17:44337861-44337923,chr17,44337861,44337923,H1|chr17:44319419-44319472,chr17,44319419,44319472,1,18442
H1|chr17:44338038-44338088,chr17,44338038,44338088,H1|chr17:44316440-44316585,chr17,44316440,44316585,1,21598
H1|chr17:44338089-44338202,chr17,44338089,44338202,H1|chr17:44318719-44318774,chr17,44318719,44318774,1,19370
H1|chr17:44338089-44338177,chr17,44338089,44338177,H1|chr17:44318719-44318774,chr17,44318719,44318774,1,19370
H1|chr17:44338843-44338909,chr17,44338843,44338909,H1|chr17:44316165-44316240,chr17,44316165,44316240,1,22678
H1|chr17:44341069-44341158,chr17,44341069,44341158,H1|chr17:44319851-44319912,chr17,44319851,44319912,1,21218
H1|chr17:44341557-44341626,chr17,44341557,44341626,H1|chr17:44316336-44316417,chr17,44316336,44316417,1,25221
H1|chr17:44341694-44341751,chr17,44341694,44341751,H1|chr17:44318774-44318887,chr17,44318774,44318887,1,22920
H1|chr17:44341694-44341728,chr17,44341694,44341728,H1|chr17:44318774-44318887,chr17,44318774,44318887,1,22920
H1|chr17:47087693-47087780,chr17,47087693,47087780,H1|chr17:47024083-47024117,chr17,47024083,47024117,1,63610
H1|chr17:47089175-47089215,chr17,47089175,47089215,H1|chr17:46985111-46985155,chr17,46985111,46985155,1,104064
H1|chr17:47093065-47093176,chr17,47093065,47093176,H1|chr17:46987415-46987449,chr17,46987415,46987449,1,105650
H1|chr17:47093065-47093175,chr17,47093065,47093175,H1|chr17:46987415-46987449,chr17,46987415,46987449,1,105650
H1|chr17:47942339-47942379,chr17,47942339,47942379,H1|chr17:47928292-47928358,chr17,47928292,47928358,1,14047
H1|chr17:47946306-47946420,chr17,47946306,47946420,H1|chr17:43322472-43322559,chr17,43322472,43322559,1,4623834
H1|chr17:47946307-47946418,chr17,47946307,47946418,H1|chr17:43322472-43322559,chr17,43322472,43322559,1,4623835
H1|chr17:47946357-47946420,chr17,47946357,47946420,H1|chr17:43322472-43322559,chr17,43322472,43322559,1,4623885
H1|chr17:47948592-47948667,chr17,47948592,47948667,H1|chr17:47928243-47928393,chr17,47928243,47928393,1,20349
H1|chr17:55390992-55391043,chr17,55390992,55391043,H1|chr17:47755037-47755094,chr17,47755037,47755094,1,7635955
H1|chr17:55390993-55391043,chr17,55390993,55391043,H1|chr17:47755037-47755094,chr17,47755037,47755094,1,7635956
H1|chr17:55510590-55510611,chr17,55510590,55510611,H1|chr17:1733520-1733646,chr17,1733520,1733646,1,53777070
H1|chr17:55510593-55510611,chr17,55510593,55510611,H1|chr17:1733520-1733646,chr17,1733520,1733646,1,53777073
H1|chr17:57913836-57913882,chr17,57913836,57913882,H1|chr17:56084039-56084082,chr17,56084039,56084082,1,1829797
H1|chr17:57916810-57916879,chr17,57916810,57916879,H1|chr17:56084163-56084192,chr17,56084163,56084192,1,1832647
H1|chr17:62832375-62832525,chr17,62832375,62832525,H1|chr17:43567170-43567320,chr17,43567170,43567320,1,19265205
H1|chr17:62832379-62832529,chr17,62832379,62832529,H1|chr17:43567254-43567404,chr17,43567254,43567404,1,19265125
H1|chr17:63546374-63546524,chr17,63546374,63546524,H1|chr17:26369038-26369065,chr17,26369038,26369065,1,37177336
H1|chr17:63546412-63546535,chr17,63546412,63546535,H1|chr17:26369038-26369065,chr17,26369038,26369065,1,37177374
H1|chr17:64564790-64564828,chr17,64564790,64564828,H1|chr17:65825032-65825071,chr17,65825032,65825071,1,1260242
H1|chr17:64741580-64741627,chr17,64741580,64741627,H1|chr17:65819949-65820084,chr17,65819949,65820084,1,1078369
H1|chr17:65464780-65464857,chr17,65464780,65464857,H1|chr17:65246575-65246600,chr17,65246575,65246600,1,218205
H1|chr17:65485001-65485061,chr17,65485001,65485061,H1|chr17:65244793-65244863,chr17,65244793,65244863,1,240208
H1|chr17:65485001-65485059,chr17,65485001,65485059,H1|chr17:65244793-65244863,chr17,65244793,65244863,1,240208
H1|chr17:66201688-66201758,chr17,66201688,66201758,H1|chr17:65822514-65822594,chr17,65822514,65822594,1,379174
H1|chr17:66202178-66202215,chr17,66202178,66202215,H1|chr17:65823321-65823374,chr17,65823321,65823374,1,378857
H1|chr17:66202386-66202413,chr17,66202386,66202413,H1|chr17:65822498-65822552,chr17,65822498,65822552,1,379888
H1|chr17:66202421-66202486,chr17,66202421,66202486,H1|chr17:65826236-65826292,chr17,65826236,65826292,1,376185
H1|chr17:74126177-74126272,chr17,74126177,74126272,H1|chr17:74122254-74122300,chr17,74122254,74122300,1,3923
H1|chr17:74126196-74126258,chr17,74126196,74126258,H1|chr17:74119654-74119804,chr17,74119654,74119804,1,6542
H1|chr17:74126227-74126272,chr17,74126227,74126272,H1|chr17:74122254-74122300,chr17,74122254,74122300,1,3973
H1|chr17:74126341-74126375,chr17,74126341,74126375,H1|chr17:74117754-74117863,chr17,74117754,74117863,1,8587
H1|chr17:74126387-74126429,chr17,74126387,74126429,H1|chr17:74119039-74119094,chr17,74119039,74119094,1,7348
H1|chr17:74126387-74126428,chr17,74126387,74126428,H1|chr17:74120174-74120205,chr17,74120174,74120205,1,6213
H1|chr17:74126595-74126650,chr17,74126595,74126650,H1|chr17:74118525-74118567,chr17,74118525,74118567,1,8070
H1|chr17:74126769-74126804,chr17,74126769,74126804,H1|chr17:74118414-74118549,chr17,74118414,74118549,1,8355
H1|chr17:74126936-74127041,chr17,74126936,74127041,H1|chr17:74120174-74120205,chr17,74120174,74120205,1,6762
H1|chr17:74126936-74127015,chr17,74126936,74127015,H1|chr17:74120126-74120205,chr17,74120126,74120205,1,6810
H1|chr17:74127919-74128042,chr17,74127919,74128042,H1|chr17:74121570-74121597,chr17,74121570,74121597,1,6349
H1|chr17:74127968-74128042,chr17,74127968,74128042,H1|chr17:74121570-74121646,chr17,74121570,74121646,1,6398
H1|chr17:74127980-74128075,chr17,74127980,74128075,H1|chr17:74121181-74121222,chr17,74121181,74121222,1,6799
H1|chr17:74127980-74128074,chr17,74127980,74128074,H1|chr17:74121181-74121222,chr17,74121181,74121222,1,6799
H1|chr17:74128501-74128589,chr17,74128501,74128589,H1|chr17:74120240-74120388,chr17,74120240,74120388,1,8261
H1|chr17:74128501-74128580,chr17,74128501,74128580,H1|chr17:74120138-74120205,chr17,74120138,74120205,1,8363
H1|chr17:74128501-74128579,chr17,74128501,74128579,H1|chr17:74120151-74120205,chr17,74120151,74120205,1,8350
H1|chr17:74128501-74128575,chr17,74128501,74128575,H1|chr17:74120079-74120154,chr17,74120079,74120154,1,8422
H1|chr17:74128501-74128574,chr17,74128501,74128574,H1|chr17:74120079-74120154,chr17,74120079,74120154,1,8422
H1|chr17:74128591-74128638,chr17,74128591,74128638,H1|chr17:74119045-74119094,chr17,74119045,74119094,1,9546
H1|chr17:74414452-74414549,chr17,74414452,74414549,H1|chr17:75448413-75448509,chr17,75448413,75448509,1,1033961
H1|chr17:74414840-74414959,chr17,74414840,74414959,H1|chr17:74121063-74121118,chr17,74121063,74121118,1,293777
H1|chr17:74414865-74414960,chr17,74414865,74414960,H1|chr17:74121063-74121118,chr17,74121063,74121118,1,293802
H1|chr17:74414898-74414960,chr17,74414898,74414960,H1|chr17:74121063-74121118,chr17,74121063,74121118,1,293835
H1|chr17:74423559-74423709,chr17,74423559,74423709,H1|chr17:75451945-75451988,chr17,75451945,75451988,1,1028386
H1|chr17:74425158-74425195,chr17,74425158,74425195,H1|chr17:74257559-74257606,chr17,74257559,74257606,1,167599
H1|chr17:74426082-74426158,chr17,74426082,74426158,H1|chr17:74378366-74378440,chr17,74378366,74378440,1,47716
H1|chr17:74428375-74428413,chr17,74428375,74428413,H1|chr17:6540099-6540165,chr17,6540099,6540165,1,67888276
H1|chr17:74439201-74439234,chr17,74439201,74439234,H1|chr17:65825367-65825474,chr17,65825367,65825474,1,8613834
H1|chr17:74439203-74439251,chr17,74439203,74439251,H1|chr17:65825367-65825474,chr17,65825367,65825474,1,8613836
H1|chr17:74439203-74439250,chr17,74439203,74439250,H1|chr17:65825367-65825474,chr17,65825367,65825474,1,8613836
H1|chr17:74439539-74439638,chr17,74439539,74439638,H1|chr17:74262692-74262772,chr17,74262692,74262772,1,176847
H1|chr17:74555103-74555133,chr17,74555103,74555133,H1|chr17:74448227-74448323,chr17,74448227,74448323,1,106876
H1|chr17:74559008-74559031,chr17,74559008,74559031,H1|chr17:74448669-74448796,chr17,74448669,74448796,1,110339
H1|chr17:74559010-74559058,chr17,74559010,74559058,H1|chr17:74448669-74448796,chr17,74448669,74448796,1,110341
H1|chr17:75384956-75385056,chr17,75384956,75385056,H1|chr17:75137343-75137391,chr17,75137343,75137391,1,247613
H1|chr17:78087337-78087382,chr17,78087337,78087382,H1|chr17:7466012-7466082,chr17,7466012,7466082,1,70621325
H1|chr17:78087340-78087382,chr17,78087340,78087382,H1|chr17:7466011-7466082,chr17,7466011,7466082,1,70621329
H1|chr17:78087340-78087381,chr17,78087340,78087381,H1|chr17:7466012-7466082,chr17,7466012,7466082,1,70621328
H1|chr17:80064946-80065056,chr17,80064946,80065056,H1|chr17:80058466-80058561,chr17,80058466,80058561,1,6480
H1|chr17:80066383-80066405,chr17,80066383,80066405,H1|chr17:80057610-80057705,chr17,80057610,80057705,1,8773
H1|chr17:80067438-80067488,chr17,80067438,80067488,H1|chr17:80058268-80058358,chr17,80058268,80058358,1,9170
H1|chr17:80067570-80067643,chr17,80067570,80067643,H1|chr17:80058268-80058358,chr17,80058268,80058358,1,9302
H1|chr17:80524562-80524654,chr17,80524562,80524654,H1|chr17:27169319-27169336,chr17,27169319,27169336,1,53355243
H1|chr17:80524564-80524654,chr17,80524564,80524654,H1|chr17:27169319-27169336,chr17,27169319,27169336,1,53355245
H1|chr18:3588017-3588114,chr18,3588017,3588114,H1|chr18:19179476-19179522,chr18,19179476,19179522,1,15591459
H1|chr18:3588018-3588110,chr18,3588018,3588110,H1|chr18:19179476-19179522,chr18,19179476,19179522,1,15591458
H1|chr18:3588043-3588110,chr18,3588043,3588110,H1|chr18:19179476-19179522,chr18,19179476,19179522,1,15591433
H1|chr18:3605780-3605869,chr18,3605780,3605869,H1|chr18:3454238-3454276,chr18,3454238,3454276,1,151542
H1|chr18:3609025-3609068,chr18,3609025,3609068,H1|chr18:3453465-3453540,chr18,3453465,3453540,1,155560
H1|chr18:3609025-3609065,chr18,3609025,3609065,H1|chr18:3453465-3453540,chr18,3453465,3453540,1,155560
H1|chr18:3618646-3618718,chr18,3618646,3618718,H1|chr18:3453383-3453460,chr18,3453383,3453460,1,165263
H1|chr18:3618646-3618683,chr18,3618646,3618683,H1|chr18:3453383-3453496,chr18,3453383,3453496,1,165263
H1|chr18:4108501-4108583,chr18,4108501,4108583,H1|chr18:22009286-22009322,chr18,22009286,22009322,1,17900785
H1|chr18:8623947-8624042,chr18,8623947,8624042,H1|chr18:3450664-3450713,chr18,3450664,3450713,1,5173283
H1|chr18:8623947-8624038,chr18,8623947,8624038,H1|chr18:3450664-3450713,chr18,3450664,3450713,1,5173283
H1|chr18:8629405-8629433,chr18,8629405,8629433,H1|chr18:8707637-8707759,chr18,8707637,8707759,1,78232
H1|chr18:8629405-8629432,chr18,8629405,8629432,H1|chr18:8707637-8707759,chr18,8707637,8707759,1,78232
H1|chr18:46456993-46457115,chr18,46456993,46457115,H1|chr18:46477185-46477218,chr18,46477185,46477218,1,20192
H1|chr18:46456993-46457107,chr18,46456993,46457107,H1|chr18:46477185-46477218,chr18,46477185,46477218,1,20192
H1|chr18:46457425-46457527,chr18,46457425,46457527,H1|chr18:46477360-46477391,chr18,46477360,46477391,1,19935
H1|chr18:46468053-46468086,chr18,46468053,46468086,H1|chr18:46478869-46478930,chr18,46478869,46478930,1,10816
H1|chr18:46490178-46490247,chr18,46490178,46490247,H1|chr18:46478151-46478203,chr18,46478151,46478203,1,12027
H1|chr18:46490190-46490219,chr18,46490190,46490219,H1|chr18:46478151-46478203,chr18,46478151,46478203,1,12039
H1|chr18:53011132-53011181,chr18,53011132,53011181,H1|chr18:24445171-24445244,chr18,24445171,24445244,1,28565961
H1|chr18:53441689-53441774,chr18,53441689,53441774,H1|chr18:12882223-12882279,chr18,12882223,12882279,1,40559466
H1|chr18:60392072-60392138,chr18,60392072,60392138,H1|chr18:60189721-60189786,chr18,60189721,60189786,1,202351
H1|chr18:60396537-60396612,chr18,60396537,60396612,H1|chr18:56533846-56533921,chr18,56533846,56533921,1,3862691
H1|chr18:60404309-60404431,chr18,60404309,60404431,H1|chr18:43661195-43661223,chr18,43661195,43661223,1,16743114
H1|chr18:60404322-60404472,chr18,60404322,60404472,H1|chr18:43661195-43661223,chr18,43661195,43661223,1,16743127
H1|chr18:60427879-60427910,chr18,60427879,60427910,H1|chr18:60186134-60186227,chr18,60186134,60186227,1,241745
H1|chr18:60430550-60430584,chr18,60430550,60430584,H1|chr18:65183319-65183385,chr18,65183319,65183385,1,4752769
H1|chr18:60465019-60465091,chr18,60465019,60465091,H1|chr18:56534472-56534546,chr18,56534472,56534546,1,3930547
H1|chr18:60465879-60465924,chr18,60465879,60465924,H1|chr18:59995733-59995777,chr18,59995733,59995777,1,470146
H1|chr18:77937413-77937465,chr18,77937413,77937465,H1|chr18:77867925-77867950,chr18,77867925,77867950,1,69488
H1|chr18:77937918-77937940,chr18,77937918,77937940,H1|chr18:77868259-77868362,chr18,77868259,77868362,1,69659
H1|chr19:782997-783041,chr19,782997,783041,H1|chr19:630986-631069,chr19,630986,631069,1,152011
H1|chr19:782997-783038,chr19,782997,783038,H1|chr19:630986-631069,chr19,630986,631069,1,152011
H1|chr19:784033-784135,chr19,784033,784135,H1|chr19:793245-793314,chr19,793245,793314,1,9212
H1|chr19:784033-784113,chr19,784033,784113,H1|chr19:793245-793314,chr19,793245,793314,1,9212
H1|chr19:784132-784184,chr19,784132,784184,H1|chr19:631016-631157,chr19,631016,631157,1,153116
H1|chr19:784616-784663,chr19,784616,784663,H1|chr19:793188-793286,chr19,793188,793286,1,8572
H1|chr19:785400-785542,chr19,785400,785542,H1|chr19:793385-793532,chr19,793385,793532,1,7985
H1|chr19:786139-786289,chr19,786139,786289,H1|chr19:35632825-35632858,chr19,35632825,35632858,1,34846686
H1|chr19:786175-786292,chr19,786175,786292,H1|chr19:35632825-35632858,chr19,35632825,35632858,1,34846650
H1|chr19:787299-787321,chr19,787299,787321,H1|chr19:792491-792542,chr19,792491,792542,1,5192
H1|chr19:787322-787385,chr19,787322,787385,H1|chr19:792491-792542,chr19,792491,792542,1,5169
H1|chr19:787502-787540,chr19,787502,787540,H1|chr19:799123-799245,chr19,799123,799245,1,11621
H1|chr19:788223-788307,chr19,788223,788307,H1|chr19:915340-915406,chr19,915340,915406,1,127117
H1|chr19:788400-788453,chr19,788400,788453,H1|chr19:638203-638278,chr19,638203,638278,1,150197
H1|chr19:789255-789295,chr19,789255,789295,H1|chr19:794041-794155,chr19,794041,794155,1,4786
H1|chr19:789259-789295,chr19,789259,789295,H1|chr19:794041-794155,chr19,794041,794155,1,4782
H1|chr19:789703-789811,chr19,789703,789811,H1|chr19:792090-792207,chr19,792090,792207,1,2387
H1|chr19:789783-789811,chr19,789783,789811,H1|chr19:792090-792207,chr19,792090,792207,1,2307
H1|chr19:789929-789957,chr19,789929,789957,H1|chr19:792425-792542,chr19,792425,792542,1,2496
H1|chr19:2950501-2950542,chr19,2950501,2950542,H1|chr19:2949521-2949614,chr19,2949521,2949614,1,980
H1|chr19:2950561-2950603,chr19,2950561,2950603,H1|chr19:2947941-2948016,chr19,2947941,2948016,1,2620
H1|chr19:3447228-3447297,chr19,3447228,3447297,H1|chr19:3575941-3576000,chr19,3575941,3576000,1,128713
H1|chr19:3447260-3447295,chr19,3447260,3447295,H1|chr19:3575942-3575990,chr19,3575942,3575990,1,128682
H1|chr19:3462246-3462283,chr19,3462246,3462283,H1|chr19:3569515-3569588,chr19,3569515,3569588,1,107269
H1|chr19:3681062-3681173,chr19,3681062,3681173,H1|chr19:3883757-3883777,chr19,3883757,3883777,1,202695
H1|chr19:3681103-3681233,chr19,3681103,3681233,H1|chr19:3883757-3883777,chr19,3883757,3883777,1,202654
H1|chr19:3681104-3681233,chr19,3681104,3681233,H1|chr19:3883757-3883777,chr19,3883757,3883777,1,202653
H1|chr19:3684462-3684520,chr19,3684462,3684520,H1|chr19:3883318-3883384,chr19,3883318,3883384,1,198856
H1|chr19:5805340-5805423,chr19,5805340,5805423,H1|chr19:5823778-5823811,chr19,5823778,5823811,1,18438
H1|chr19:5805341-5805423,chr19,5805341,5805423,H1|chr19:5823778-5823818,chr19,5823778,5823818,1,18437
H1|chr19:5805360-5805423,chr19,5805360,5805423,H1|chr19:5823778-5823811,chr19,5823778,5823811,1,18418
H1|chr19:5805360-5805422,chr19,5805360,5805422,H1|chr19:5823778-5823811,chr19,5823778,5823811,1,18418
H1|chr19:5805363-5805423,chr19,5805363,5805423,H1|chr19:5823778-5823818,chr19,5823778,5823818,1,18415
H1|chr19:5805495-5805591,chr19,5805495,5805591,H1|chr19:5823775-5823829,chr19,5823775,5823829,1,18280
H1|chr19:7863988-7864094,chr19,7863988,7864094,H1|chr19:8455832-8455939,chr19,8455832,8455939,1,591844
H1|chr19:7864045-7864094,chr19,7864045,7864094,H1|chr19:8455838-8455939,chr19,8455838,8455939,1,591793
H1|chr19:8593217-8593257,chr19,8593217,8593257,H1|chr19:8673790-8673839,chr19,8673790,8673839,1,80573
H1|chr19:8599040-8599062,chr19,8599040,8599062,H1|chr19:8673629-8673652,chr19,8673629,8673652,1,74589
H1|chr19:8599561-8599631,chr19,8599561,8599631,H1|chr19:9694447-9694494,chr19,9694447,9694494,1,1094886
H1|chr19:8599561-8599629,chr19,8599561,8599629,H1|chr19:9694447-9694494,chr19,9694447,9694494,1,1094886
H1|chr19:10573829-10573929,chr19,10573829,10573929,H1|chr19:49257162-49257286,chr19,49257162,49257286,1,38683333
H1|chr19:10573829-10573852,chr19,10573829,10573852,H1|chr19:49257158-49257285,chr19,49257158,49257285,1,38683329
H1|chr19:10573830-10573851,chr19,10573830,10573851,H1|chr19:49257162-49257286,chr19,49257162,49257286,1,38683332
H1|chr19:10990517-10990608,chr19,10990517,10990608,H1|chr19:11709064-11709174,chr19,11709064,11709174,1,718547
H1|chr19:10990517-10990606,chr19,10990517,10990606,H1|chr19:11709064-11709174,chr19,11709064,11709174,1,718547
H1|chr19:10990568-10990608,chr19,10990568,10990608,H1|chr19:11709064-11709174,chr19,11709064,11709174,1,718496
H1|chr19:13952706-13952743,chr19,13952706,13952743,H1|chr19:13948226-13948353,chr19,13948226,13948353,1,4480
H1|chr19:13952721-13952743,chr19,13952721,13952743,H1|chr19:13948226-13948353,chr19,13948226,13948353,1,4495
H1|chr19:13953200-13953249,chr19,13953200,13953249,H1|chr19:13947771-13947827,chr19,13947771,13947827,1,5429
H1|chr19:13953207-13953249,chr19,13953207,13953249,H1|chr19:13947771-13947827,chr19,13947771,13947827,1,5436
H1|chr19:13953258-13953281,chr19,13953258,13953281,H1|chr19:13947927-13948077,chr19,13947927,13948077,1,5331
H1|chr19:13953587-13953694,chr19,13953587,13953694,H1|chr19:13947501-13947520,chr19,13947501,13947520,1,6086
H1|chr19:13953589-13953708,chr19,13953589,13953708,H1|chr19:13947493-13947520,chr19,13947493,13947520,1,6096
H1|chr19:13953589-13953703,chr19,13953589,13953703,H1|chr19:13947496-13947520,chr19,13947496,13947520,1,6093
H1|chr19:13953589-13953702,chr19,13953589,13953702,H1|chr19:13947477-13947520,chr19,13947477,13947520,1,6112
H1|chr19:13953589-13953701,chr19,13953589,13953701,H1|chr19:13947486-13947520,chr19,13947486,13947520,1,6103
H1|chr19:13953589-13953699,chr19,13953589,13953699,H1|chr19:13947494-13947520,chr19,13947494,13947520,1,6095
H1|chr19:13953589-13953694,chr19,13953589,13953694,H1|chr19:13947501-13947520,chr19,13947501,13947520,1,6088
H1|chr19:13953589-13953692,chr19,13953589,13953692,H1|chr19:13947477-13947520,chr19,13947477,13947520,1,6112
H1|chr19:13953589-13953690,chr19,13953589,13953690,H1|chr19:13947494-13947520,chr19,13947494,13947520,1,6095
H1|chr19:13953589-13953674,chr19,13953589,13953674,H1|chr19:13947477-13947520,chr19,13947477,13947520,1,6112
H1|chr19:13953589-13953673,chr19,13953589,13953673,H1|chr19:13947494-13947520,chr19,13947494,13947520,1,6095
H1|chr19:13953589-13953664,chr19,13953589,13953664,H1|chr19:13947492-13947520,chr19,13947492,13947520,1,6097
H1|chr19:13953589-13953655,chr19,13953589,13953655,H1|chr19:13947494-13947520,chr19,13947494,13947520,1,6095
H1|chr19:13953589-13953654,chr19,13953589,13953654,H1|chr19:13947484-13947520,chr19,13947484,13947520,1,6105
H1|chr19:13953589-13953649,chr19,13953589,13953649,H1|chr19:13947485-13947520,chr19,13947485,13947520,1,6104
H1|chr19:13953589-13953642,chr19,13953589,13953642,H1|chr19:13947497-13947520,chr19,13947497,13947520,1,6092
H1|chr19:13953589-13953636,chr19,13953589,13953636,H1|chr19:13947486-13947520,chr19,13947486,13947520,1,6103
H1|chr19:13953593-13953674,chr19,13953593,13953674,H1|chr19:13947477-13947520,chr19,13947477,13947520,1,6116
H1|chr19:13953620-13953690,chr19,13953620,13953690,H1|chr19:13947494-13947520,chr19,13947494,13947520,1,6126
H1|chr19:13953661-13953764,chr19,13953661,13953764,H1|chr19:13947497-13947520,chr19,13947497,13947520,1,6164
H1|chr19:13953679-13953713,chr19,13953679,13953713,H1|chr19:13947485-13947520,chr19,13947485,13947520,1,6194
H1|chr19:13961400-13961498,chr19,13961400,13961498,H1|chr19:13947494-13947520,chr19,13947494,13947520,1,13906
H1|chr19:14365800-14365898,chr19,14365800,14365898,H1|chr19:14525440-14525471,chr19,14525440,14525471,1,159640
H1|chr19:14368842-14368916,chr19,14368842,14368916,H1|chr19:14530892-14530941,chr19,14530892,14530941,1,162050
H1|chr19:14648639-14648686,chr19,14648639,14648686,H1|chr19:14611299-14611353,chr19,14611299,14611353,1,37340
H1|chr19:14663489-14663539,chr19,14663489,14663539,H1|chr19:14603192-14603261,chr19,14603192,14603261,1,60297
H1|chr19:15404824-15404933,chr19,15404824,15404933,H1|chr19:12889964-12890065,chr19,12889964,12890065,1,2514860
H1|chr19:15404824-15404869,chr19,15404824,15404869,H1|chr19:12889964-12890065,chr19,12889964,12890065,1,2514860
H1|chr19:17645310-17645382,chr19,17645310,17645382,H1|chr19:17529407-17529464,chr19,17529407,17529464,1,115903
H1|chr19:17891180-17891259,chr19,17891180,17891259,H1|chr19:17969199-17969250,chr19,17969199,17969250,1,78019
H1|chr19:17892163-17892215,chr19,17892163,17892215,H1|chr19:17971285-17971344,chr19,17971285,17971344,1,79122
H1|chr19:20480676-20480762,chr19,20480676,20480762,H1|chr19:47287554-47287625,chr19,47287554,47287625,1,26806878
H1|chr19:20480684-20480762,chr19,20480684,20480762,H1|chr19:47287553-47287625,chr19,47287553,47287625,1,26806869
H1|chr19:28916550-28916605,chr19,28916550,28916605,H1|chr19:39519203-39519245,chr19,39519203,39519245,1,10602653
H1|chr19:28916552-28916605,chr19,28916552,28916605,H1|chr19:39519203-39519245,chr19,39519203,39519245,1,10602651
H1|chr19:30348669-30348729,chr19,30348669,30348729,H1|chr19:58364408-58364477,chr19,58364408,58364477,1,28015739
H1|chr19:34144193-34144224,chr19,34144193,34144224,H1|chr19:51306154-51306304,chr19,51306154,51306304,1,17161961
H1|chr19:35554394-35554450,chr19,35554394,35554450,H1|chr19:35480677-35480725,chr19,35480677,35480725,1,73717
H1|chr19:35555868-35555934,chr19,35555868,35555934,H1|chr19:35487935-35487960,chr19,35487935,35487960,1,67933
H1|chr19:35581907-35582024,chr19,35581907,35582024,H1|chr19:35604250-35604310,chr19,35604250,35604310,1,22343
H1|chr19:35581936-35582024,chr19,35581936,35582024,H1|chr19:35604250-35604310,chr19,35604250,35604310,1,22314
H1|chr19:35581960-35582024,chr19,35581960,35582024,H1|chr19:35604250-35604300,chr19,35604250,35604300,1,22290
H1|chr19:35581963-35582024,chr19,35581963,35582024,H1|chr19:35604250-35604293,chr19,35604250,35604293,1,22287
H1|chr19:35585223-35585343,chr19,35585223,35585343,H1|chr19:35602543-35602590,chr19,35602543,35602590,1,17320
H1|chr19:35588297-35588328,chr19,35588297,35588328,H1|chr19:35602502-35602608,chr19,35602502,35602608,1,14205
H1|chr19:38480568-38480639,chr19,38480568,38480639,H1|chr19:36000664-36000702,chr19,36000664,36000702,1,2479904
H1|chr19:38481010-38481055,chr19,38481010,38481055,H1|chr19:37160075-37160210,chr19,37160075,37160210,1,1320935
H1|chr19:38501077-38501193,chr19,38501077,38501193,H1|chr19:38745945-38745979,chr19,38745945,38745979,1,244868
H1|chr19:38533111-38533159,chr19,38533111,38533159,H1|chr19:3969266-3969302,chr19,3969266,3969302,1,34563845
H1|chr19:38542421-38542568,chr19,38542421,38542568,H1|chr19:3972191-3972292,chr19,3972191,3972292,1,34570230
H1|chr19:38933487-38933597,chr19,38933487,38933597,H1|chr19:39139155-39139179,chr19,39139155,39139179,1,205668
H1|chr19:38940897-38940941,chr19,38940897,38940941,H1|chr19:39139001-39139071,chr19,39139001,39139071,1,198104
H1|chr19:39127688-39127733,chr19,39127688,39127733,H1|chr19:59057611-59057671,chr19,59057611,59057671,1,19929923
H1|chr19:39127689-39127733,chr19,39127689,39127733,H1|chr19:59057611-59057672,chr19,59057611,59057672,1,19929922
H1|chr19:39152083-39152199,chr19,39152083,39152199,H1|chr19:39465315-39465416,chr19,39465315,39465416,1,313232
H1|chr19:39152151-39152200,chr19,39152151,39152200,H1|chr19:39465315-39465416,chr19,39465315,39465416,1,313164
H1|chr19:39158070-39158092,chr19,39158070,39158092,H1|chr19:39466063-39466205,chr19,39466063,39466205,1,307993
H1|chr19:41681735-41681761,chr19,41681735,41681761,H1|chr19:41699864-41699958,chr19,41699864,41699958,1,18129
H1|chr19:41690986-41691095,chr19,41690986,41691095,H1|chr19:41698776-41698823,chr19,41698776,41698823,1,7790
H1|chr19:41691011-41691095,chr19,41691011,41691095,H1|chr19:41698776-41698823,chr19,41698776,41698823,1,7765
H1|chr19:45302556-45302588,chr19,45302556,45302588,H1|chr19:45308543-45308577,chr19,45308543,45308577,1,5987
H1|chr19:45302557-45302588,chr19,45302557,45302588,H1|chr19:45308543-45308572,chr19,45308543,45308572,1,5986
H1|chr19:45302640-45302755,chr19,45302640,45302755,H1|chr19:45308543-45308577,chr19,45308543,45308577,1,5903
H1|chr19:46065055-46065093,chr19,46065055,46065093,H1|chr19:19244361-19244449,chr19,19244361,19244449,1,26820694
H1|chr19:46065055-46065092,chr19,46065055,46065092,H1|chr19:19244361-19244449,chr19,19244361,19244449,1,26820694
H1|chr19:46077407-46077498,chr19,46077407,46077498,H1|chr19:46392810-46392869,chr19,46392810,46392869,1,315403
H1|chr19:46871675-46871771,chr19,46871675,46871771,H1|chr19:47287695-47287824,chr19,47287695,47287824,1,416020
H1|chr19:46871675-46871696,chr19,46871675,46871696,H1|chr19:47287695-47287824,chr19,47287695,47287824,1,416020
H1|chr19:46875149-46875174,chr19,46875149,46875174,H1|chr19:47287487-47287542,chr19,47287487,47287542,1,412338
H1|chr19:47200747-47200834,chr19,47200747,47200834,H1|chr19:14527403-14527461,chr19,14527403,14527461,1,32673344
H1|chr19:47200751-47200834,chr19,47200751,47200834,H1|chr19:14527403-14527461,chr19,14527403,14527461,1,32673348
H1|chr19:47363958-47363991,chr19,47363958,47363991,H1|chr19:47356004-47356074,chr19,47356004,47356074,1,7954
H1|chr19:47363958-47363990,chr19,47363958,47363990,H1|chr19:47356004-47356074,chr19,47356004,47356074,1,7954
H1|chr19:47364952-47364974,chr19,47364952,47364974,H1|chr19:47556032-47556099,chr19,47556032,47556099,1,191080
H1|chr19:47365188-47365253,chr19,47365188,47365253,H1|chr19:47733116-47733178,chr19,47733116,47733178,1,367928
H1|chr19:47365438-47365513,chr19,47365438,47365513,H1|chr19:47730763-47730817,chr19,47730763,47730817,1,365325
H1|chr19:47743759-47743879,chr19,47743759,47743879,H1|chr19:47731059-47731135,chr19,47731059,47731135,1,12700
H1|chr19:47743759-47743833,chr19,47743759,47743833,H1|chr19:47731059-47731135,chr19,47731059,47731135,1,12700
H1|chr19:47743874-47743939,chr19,47743874,47743939,H1|chr19:47738768-47738841,chr19,47738768,47738841,1,5106
H1|chr19:48119561-48119657,chr19,48119561,48119657,H1|chr19:47977739-47977792,chr19,47977739,47977792,1,141822
H1|chr19:48119561-48119653,chr19,48119561,48119653,H1|chr19:47977739-47977792,chr19,47977739,47977792,1,141822
H1|chr19:48120519-48120581,chr19,48120519,48120581,H1|chr19:52776718-52776741,chr19,52776718,52776741,1,4656199
H1|chr19:48120519-48120579,chr19,48120519,48120579,H1|chr19:52776718-52776741,chr19,52776718,52776741,1,4656199
H1|chr19:48125701-48125766,chr19,48125701,48125766,H1|chr19:48250685-48250749,chr19,48250685,48250749,1,124984
H1|chr19:48127103-48127129,chr19,48127103,48127129,H1|chr19:47976008-47976029,chr19,47976008,47976029,1,151095
H1|chr19:48225025-48225084,chr19,48225025,48225084,H1|chr19:48280396-48280443,chr19,48280396,48280443,1,55371
H1|chr19:48231856-48231962,chr19,48231856,48231962,H1|chr19:48280642-48280688,chr19,48280642,48280688,1,48786
H1|chr19:48231858-48231962,chr19,48231858,48231962,H1|chr19:48280642-48280688,chr19,48280642,48280688,1,48784
H1|chr19:48997903-48997981,chr19,48997903,48997981,H1|chr19:48110960-48111032,chr19,48110960,48111032,1,886943
H1|chr19:51830412-51830527,chr19,51830412,51830527,H1|chr19:53074132-53074180,chr19,53074132,53074180,1,1243720
H1|chr19:51830431-51830528,chr19,51830431,51830528,H1|chr19:53074132-53074180,chr19,53074132,53074180,1,1243701
H1|chr19:51830465-51830528,chr19,51830465,51830528,H1|chr19:53074132-53074180,chr19,53074132,53074180,1,1243667
H1|chr19:54096785-54096857,chr19,54096785,54096857,H1|chr19:54023349-54023406,chr19,54023349,54023406,1,73436
H1|chr19:54334018-54334103,chr19,54334018,54334103,H1|chr19:52408039-52408102,chr19,52408039,52408102,1,1925979
H1|chr19:54334019-54334103,chr19,54334019,54334103,H1|chr19:52408039-52408102,chr19,52408039,52408102,1,1925980
H1|chr19:54334500-54334584,chr19,54334500,54334584,H1|chr19:52407983-52408041,chr19,52407983,52408041,1,1926517
H1|chr19:54334502-54334584,chr19,54334502,54334584,H1|chr19:52407983-52408041,chr19,52407983,52408041,1,1926519
H1|chr19:54456844-54456863,chr19,54456844,54456863,H1|chr19:54464952-54465058,chr19,54464952,54465058,1,8108
H1|chr19:54456875-54456905,chr19,54456875,54456905,H1|chr19:54462998-54463059,chr19,54462998,54463059,1,6123
H1|chr19:54457429-54457465,chr19,54457429,54457465,H1|chr19:54462820-54462900,chr19,54462820,54462900,1,5391
H1|chr19:54458309-54458362,chr19,54458309,54458362,H1|chr19:54466205-54466326,chr19,54466205,54466326,1,7896
H1|chr19:54460784-54460835,chr19,54460784,54460835,H1|chr19:54461761-54461866,chr19,54461761,54461866,1,977
H1|chr19:54460784-54460829,chr19,54460784,54460829,H1|chr19:54461761-54461866,chr19,54461761,54461866,1,977
H1|chr19:54933125-54933167,chr19,54933125,54933167,H1|chr19:8213536-8213644,chr19,8213536,8213644,1,46719589
H1|chr19:54933126-54933214,chr19,54933126,54933214,H1|chr19:8213535-8213597,chr19,8213535,8213597,1,46719591
H1|chr19:54934854-54934991,chr19,54934854,54934991,H1|chr19:1408901-1408981,chr19,1408901,1408981,1,53525953
H1|chr19:54941878-54941894,chr19,54941878,54941894,H1|chr19:6735598-6735635,chr19,6735598,6735635,1,48206280
H1|chr19:54947102-54947190,chr19,54947102,54947190,H1|chr19:13055820-13055960,chr19,13055820,13055960,1,41891282
H1|chr19:54947104-54947190,chr19,54947104,54947190,H1|chr19:13055820-13055960,chr19,13055820,13055960,1,41891284
H1|chr19:54949102-54949241,chr19,54949102,54949241,H1|chr19:58691781-58691810,chr19,58691781,58691810,1,3742679
H1|chr19:54949121-54949241,chr19,54949121,54949241,H1|chr19:58691781-58691811,chr19,58691781,58691811,1,3742660
H1|chr19:54949167-54949241,chr19,54949167,54949241,H1|chr19:58691781-58691810,chr19,58691781,58691810,1,3742614
H1|chr19:54949600-54949718,chr19,54949600,54949718,H1|chr19:54954177-54954244,chr19,54954177,54954244,1,4577
H1|chr19:54949600-54949683,chr19,54949600,54949683,H1|chr19:54954177-54954244,chr19,54954177,54954244,1,4577
H1|chr19:54949643-54949736,chr19,54949643,54949736,H1|chr19:54953977-54954028,chr19,54953977,54954028,1,4334
H1|chr19:54950459-54950565,chr19,54950459,54950565,H1|chr19:54955032-54955076,chr19,54955032,54955076,1,4573
H1|chr19:54950460-54950573,chr19,54950460,54950573,H1|chr19:54955032-54955076,chr19,54955032,54955076,1,4572
H1|chr19:54950589-54950649,chr19,54950589,54950649,H1|chr19:1411058-1411150,chr19,1411058,1411150,1,53539531
H1|chr19:54950589-54950644,chr19,54950589,54950644,H1|chr19:1411058-1411150,chr19,1411058,1411150,1,53539531
H1|chr19:54950607-54950641,chr19,54950607,54950641,H1|chr19:54954182-54954297,chr19,54954182,54954297,1,3575
H1|chr19:54950608-54950641,chr19,54950608,54950641,H1|chr19:54954182-54954297,chr19,54954182,54954297,1,3574
H1|chr19:58313147-58313250,chr19,58313147,58313250,H1|chr19:58364529-58364589,chr19,58364529,58364589,1,51382
H1|chr19:58313160-58313250,chr19,58313160,58313250,H1|chr19:58364529-58364589,chr19,58364529,58364589,1,51369
H1|chr19:58314892-58315009,chr19,58314892,58315009,H1|chr19:58364529-58364563,chr19,58364529,58364563,1,49637
H1|chr19:58314892-58314984,chr19,58314892,58314984,H1|chr19:58364529-58364563,chr19,58364529,58364563,1,49637
H1|chr20:249508-249619,chr20,249508,249619,H1|chr20:523391-523424,chr20,523391,523424,1,273883
H1|chr20:249508-249608,chr20,249508,249608,H1|chr20:523391-523424,chr20,523391,523424,1,273883
H1|chr20:249509-249619,chr20,249509,249619,H1|chr20:523391-523424,chr20,523391,523424,1,273882
H1|chr20:17921300-17921402,chr20,17921300,17921402,H1|chr20:17943731-17943792,chr20,17943731,17943792,1,22431
H1|chr20:17921313-17921402,chr20,17921313,17921402,H1|chr20:17943731-17943792,chr20,17943731,17943792,1,22418
H1|chr20:17921519-17921568,chr20,17921519,17921568,H1|chr20:17946554-17946621,chr20,17946554,17946621,1,25035
H1|chr20:30149499-30149593,chr20,30149499,30149593,H1|chr20:30308410-30308440,chr20,30308410,30308440,1,158911
H1|chr20:30155449-30155595,chr20,30155449,30155595,H1|chr20:40244654-40244715,chr20,40244654,40244715,1,10089205
H1|chr20:30155557-30155646,chr20,30155557,30155646,H1|chr20:40244654-40244715,chr20,40244654,40244715,1,10089097
H1|chr20:30158266-30158285,chr20,30158266,30158285,H1|chr20:40245812-40245882,chr20,40245812,40245882,1,10087546
H1|chr20:30158266-30158284,chr20,30158266,30158284,H1|chr20:40245812-40245882,chr20,40245812,40245882,1,10087546
H1|chr20:30159719-30159787,chr20,30159719,30159787,H1|chr20:31352640-31352669,chr20,31352640,31352669,1,1192921
H1|chr20:30160645-30160746,chr20,30160645,30160746,H1|chr20:30189554-30189599,chr20,30189554,30189599,1,28909
H1|chr20:30167764-30167803,chr20,30167764,30167803,H1|chr20:30308348-30308448,chr20,30308348,30308448,1,140584
H1|chr20:30168310-30168334,chr20,30168310,30168334,H1|chr20:30190225-30190372,chr20,30190225,30190372,1,21915
H1|chr20:30170428-30170502,chr20,30170428,30170502,H1|chr20:30192352-30192386,chr20,30192352,30192386,1,21924
H1|chr20:30170429-30170502,chr20,30170429,30170502,H1|chr20:30192352-30192386,chr20,30192352,30192386,1,21923
H1|chr20:30172658-30172801,chr20,30172658,30172801,H1|chr20:31353784-31353862,chr20,31353784,31353862,1,1181126
H1|chr20:30172658-30172730,chr20,30172658,30172730,H1|chr20:31353784-31353862,chr20,31353784,31353862,1,1181126
H1|chr20:30173108-30173172,chr20,30173108,30173172,H1|chr20:30190570-30190633,chr20,30190570,30190633,1,17462
H1|chr20:30173114-30173194,chr20,30173114,30173194,H1|chr20:30189262-30189329,chr20,30189262,30189329,1,16148
H1|chr20:30174492-30174551,chr20,30174492,30174551,H1|chr20:30194356-30194413,chr20,30194356,30194413,1,19864
H1|chr20:30174493-30174551,chr20,30174493,30174551,H1|chr20:30194373-30194414,chr20,30194373,30194414,1,19880
H1|chr20:30175539-30175595,chr20,30175539,30175595,H1|chr20:30189554-30189599,chr20,30189554,30189599,1,14015
H1|chr20:30177998-30178061,chr20,30177998,30178061,H1|chr20:30189427-30189575,chr20,30189427,30189575,1,11429
H1|chr20:30180425-30180463,chr20,30180425,30180463,H1|chr20:30188891-30188922,chr20,30188891,30188922,1,8466
H1|chr20:30180428-30180463,chr20,30180428,30180463,H1|chr20:30188854-30188925,chr20,30188854,30188925,1,8426
H1|chr20:30181301-30181371,chr20,30181301,30181371,H1|chr20:30192694-30192744,chr20,30192694,30192744,1,11393
H1|chr20:30181571-30181642,chr20,30181571,30181642,H1|chr20:30192694-30192744,chr20,30192694,30192744,1,11123
H1|chr20:30182047-30182117,chr20,30182047,30182117,H1|chr20:30188821-30188901,chr20,30188821,30188901,1,6774
H1|chr20:30182069-30182216,chr20,30182069,30182216,H1|chr20:30188821-30188901,chr20,30188821,30188901,1,6752
H1|chr20:30183419-30183489,chr20,30183419,30183489,H1|chr20:30194404-30194478,chr20,30194404,30194478,1,10985
H1|chr20:30183420-30183488,chr20,30183420,30183488,H1|chr20:30194404-30194478,chr20,30194404,30194478,1,10984
H1|chr20:30184739-30184781,chr20,30184739,30184781,H1|chr20:30191477-30191546,chr20,30191477,30191546,1,6738
H1|chr20:30285146-30285202,chr20,30285146,30285202,H1|chr20:45946752-45946842,chr20,45946752,45946842,1,15661606
H1|chr20:30285146-30285199,chr20,30285146,30285199,H1|chr20:45946752-45946842,chr20,45946752,45946842,1,15661606
H1|chr20:30287308-30287363,chr20,30287308,30287363,H1|chr20:30190851-30190943,chr20,30190851,30190943,1,96457
H1|chr20:30291063-30291123,chr20,30291063,30291123,H1|chr20:30556587-30556641,chr20,30556587,30556641,1,265524
H1|chr20:30294355-30294458,chr20,30294355,30294458,H1|chr20:45944173-45944207,chr20,45944173,45944207,1,15649818
H1|chr20:30298636-30298756,chr20,30298636,30298756,H1|chr20:30551123-30551149,chr20,30551123,30551149,1,252487
H1|chr20:30298637-30298755,chr20,30298637,30298755,H1|chr20:30551123-30551149,chr20,30551123,30551149,1,252486
H1|chr20:31264582-31264636,chr20,31264582,31264636,H1|chr20:31282587-31282704,chr20,31282587,31282704,1,18005
H1|chr20:31264606-31264639,chr20,31264606,31264639,H1|chr20:31282587-31282704,chr20,31282587,31282704,1,17981
H1|chr20:31267227-31267252,chr20,31267227,31267252,H1|chr20:31280301-31280423,chr20,31280301,31280423,1,13074
H1|chr20:31267228-31267252,chr20,31267228,31267252,H1|chr20:31280301-31280423,chr20,31280301,31280423,1,13073
H1|chr20:31268197-31268255,chr20,31268197,31268255,H1|chr20:31281492-31281555,chr20,31281492,31281555,1,13295
H1|chr20:31268198-31268255,chr20,31268198,31268255,H1|chr20:31281492-31281555,chr20,31281492,31281555,1,13294
H1|chr20:31285635-31285711,chr20,31285635,31285711,H1|chr20:31280001-31280033,chr20,31280001,31280033,1,5634
H1|chr20:31285711-31285782,chr20,31285711,31285782,H1|chr20:31279693-31279793,chr20,31279693,31279793,1,6018
H1|chr20:31285732-31285782,chr20,31285732,31285782,H1|chr20:31279693-31279793,chr20,31279693,31279793,1,6039
H1|chr20:31285961-31286018,chr20,31285961,31286018,H1|chr20:5105229-5105316,chr20,5105229,5105316,1,26180732
H1|chr20:31285961-31286017,chr20,31285961,31286017,H1|chr20:5105222-5105316,chr20,5105222,5105316,1,26180739
H1|chr20:31285961-31286016,chr20,31285961,31286016,H1|chr20:5105222-5105316,chr20,5105222,5105316,1,26180739
H1|chr20:31285969-31285991,chr20,31285969,31285991,H1|chr20:31282654-31282771,chr20,31282654,31282771,1,3315
H1|chr20:31286143-31286189,chr20,31286143,31286189,H1|chr20:31282631-31282735,chr20,31282631,31282735,1,3512
H1|chr20:31286936-31287023,chr20,31286936,31287023,H1|chr20:31282901-31282964,chr20,31282901,31282964,1,4035
H1|chr20:31287123-31287199,chr20,31287123,31287199,H1|chr20:31282310-31282384,chr20,31282310,31282384,1,4813
H1|chr20:31287126-31287260,chr20,31287126,31287260,H1|chr20:31353347-31353375,chr20,31353347,31353375,1,66221
H1|chr20:31287126-31287248,chr20,31287126,31287248,H1|chr20:31353347-31353375,chr20,31353347,31353375,1,66221
H1|chr20:31287244-31287304,chr20,31287244,31287304,H1|chr20:31280444-31280502,chr20,31280444,31280502,1,6800
H1|chr20:31287244-31287302,chr20,31287244,31287302,H1|chr20:31280444-31280502,chr20,31280444,31280502,1,6800
H1|chr20:31287289-31287348,chr20,31287289,31287348,H1|chr20:31282764-31282836,chr20,31282764,31282836,1,4525
H1|chr20:31287737-31287801,chr20,31287737,31287801,H1|chr20:31352694-31352717,chr20,31352694,31352717,1,64957
H1|chr20:31288014-31288079,chr20,31288014,31288079,H1|chr20:31282909-31282935,chr20,31282909,31282935,1,5105
H1|chr20:31288370-31288432,chr20,31288370,31288432,H1|chr20:31282616-31282710,chr20,31282616,31282710,1,5754
H1|chr20:31288376-31288432,chr20,31288376,31288432,H1|chr20:31282616-31282710,chr20,31282616,31282710,1,5760
H1|chr20:31288610-31288738,chr20,31288610,31288738,H1|chr20:31280778-31280809,chr20,31280778,31280809,1,7832
H1|chr20:31288610-31288729,chr20,31288610,31288729,H1|chr20:31280778-31280809,chr20,31280778,31280809,1,7832
H1|chr20:31288615-31288765,chr20,31288615,31288765,H1|chr20:31281277-31281427,chr20,31281277,31281427,1,7338
H1|chr20:31288623-31288663,chr20,31288623,31288663,H1|chr20:31283623-31283764,chr20,31283623,31283764,1,5000
H1|chr20:31288627-31288663,chr20,31288627,31288663,H1|chr20:31283623-31283764,chr20,31283623,31283764,1,5004
H1|chr20:31288630-31288663,chr20,31288630,31288663,H1|chr20:31283623-31283764,chr20,31283623,31283764,1,5007
H1|chr20:31288703-31288757,chr20,31288703,31288757,H1|chr20:31280723-31280813,chr20,31280723,31280813,1,7980
H1|chr20:31288789-31288929,chr20,31288789,31288929,H1|chr20:31280002-31280042,chr20,31280002,31280042,1,8787
H1|chr20:31288789-31288895,chr20,31288789,31288895,H1|chr20:31280002-31280042,chr20,31280002,31280042,1,8787
H1|chr20:31288972-31289053,chr20,31288972,31289053,H1|chr20:31279735-31279820,chr20,31279735,31279820,1,9237
H1|chr20:31288972-31289037,chr20,31288972,31289037,H1|chr20:31279735-31279820,chr20,31279735,31279820,1,9237
H1|chr20:31289321-31289353,chr20,31289321,31289353,H1|chr20:31279553-31279642,chr20,31279553,31279642,1,9768
H1|chr20:31289909-31289979,chr20,31289909,31289979,H1|chr20:31282371-31282451,chr20,31282371,31282451,1,7538
H1|chr20:31289909-31289978,chr20,31289909,31289978,H1|chr20:31282371-31282451,chr20,31282371,31282451,1,7538
H1|chr20:31289924-31290032,chr20,31289924,31290032,H1|chr20:31280306-31280385,chr20,31280306,31280385,1,9618
H1|chr20:31289924-31289995,chr20,31289924,31289995,H1|chr20:31280306-31280385,chr20,31280306,31280385,1,9618
H1|chr20:31290109-31290177,chr20,31290109,31290177,H1|chr20:31279402-31279456,chr20,31279402,31279456,1,10707
H1|chr20:31291366-31291385,chr20,31291366,31291385,H1|chr20:31280791-31280921,chr20,31280791,31280921,1,10575
H1|chr20:31291366-31291384,chr20,31291366,31291384,H1|chr20:31280791-31280921,chr20,31280791,31280921,1,10575
H1|chr20:31295212-31295354,chr20,31295212,31295354,H1|chr20:31281912-31281945,chr20,31281912,31281945,1,13300
H1|chr20:31295237-31295354,chr20,31295237,31295354,H1|chr20:31281912-31281945,chr20,31281912,31281945,1,13325
H1|chr20:31341283-31341353,chr20,31341283,31341353,H1|chr20:31334986-31335136,chr20,31334986,31335136,1,6297
H1|chr20:31355475-31355557,chr20,31355475,31355557,H1|chr20:60959040-60959096,chr20,60959040,60959096,1,29603565
H1|chr20:31356201-31356242,chr20,31356201,31356242,H1|chr20:31281035-31281111,chr20,31281035,31281111,1,75166
H1|chr20:31356202-31356242,chr20,31356202,31356242,H1|chr20:31281035-31281111,chr20,31281035,31281111,1,75167
H1|chr20:31356556-31356589,chr20,31356556,31356589,H1|chr20:31282659-31282762,chr20,31282659,31282762,1,73897
H1|chr20:31356893-31356970,chr20,31356893,31356970,H1|chr20:36149215-36149235,chr20,36149215,36149235,1,4792322
H1|chr20:31357071-31357149,chr20,31357071,31357149,H1|chr20:31281983-31282052,chr20,31281983,31282052,1,75088
H1|chr20:31357542-31357579,chr20,31357542,31357579,H1|chr20:31336180-31336267,chr20,31336180,31336267,1,21362
H1|chr20:31357982-31358073,chr20,31357982,31358073,H1|chr20:33101442-33101496,chr20,33101442,33101496,1,1743460
H1|chr20:31358608-31358707,chr20,31358608,31358707,H1|chr20:33872883-33872914,chr20,33872883,33872914,1,2514275
H1|chr20:31358608-31358692,chr20,31358608,31358692,H1|chr20:33872883-33872914,chr20,33872883,33872914,1,2514275
H1|chr20:31359111-31359154,chr20,31359111,31359154,H1|chr20:31330918-31330985,chr20,31330918,31330985,1,28193
H1|chr20:31359112-31359154,chr20,31359112,31359154,H1|chr20:31330918-31330985,chr20,31330918,31330985,1,28194
H1|chr20:31359158-31359252,chr20,31359158,31359252,H1|chr20:31333409-31333492,chr20,31333409,31333492,1,25749
H1|chr20:31359158-31359225,chr20,31359158,31359225,H1|chr20:31333409-31333492,chr20,31333409,31333492,1,25749
H1|chr20:31360462-31360494,chr20,31360462,31360494,H1|chr20:47898769-47898853,chr20,47898769,47898853,1,16538307
H1|chr20:31377728-31377778,chr20,31377728,31377778,H1|chr20:32078618-32078700,chr20,32078618,32078700,1,700890
H1|chr20:31377728-31377777,chr20,31377728,31377777,H1|chr20:32078618-32078700,chr20,32078618,32078700,1,700890
H1|chr20:31378295-31378388,chr20,31378295,31378388,H1|chr20:47899931-47899982,chr20,47899931,47899982,1,16521636
H1|chr20:31378295-31378343,chr20,31378295,31378343,H1|chr20:47899931-47899978,chr20,47899931,47899978,1,16521636
H1|chr20:31378856-31378897,chr20,31378856,31378897,H1|chr20:47896408-47896481,chr20,47896408,47896481,1,16517552
H1|chr20:31378856-31378895,chr20,31378856,31378895,H1|chr20:47896408-47896481,chr20,47896408,47896481,1,16517552
H1|chr20:31379926-31379955,chr20,31379926,31379955,H1|chr20:32078490-32078555,chr20,32078490,32078555,1,698564
H1|chr20:31381467-31381558,chr20,31381467,31381558,H1|chr20:33099396-33099436,chr20,33099396,33099436,1,1717929
H1|chr20:31381939-31382013,chr20,31381939,31382013,H1|chr20:47898786-47898831,chr20,47898786,47898831,1,16516847
H1|chr20:31385157-31385216,chr20,31385157,31385216,H1|chr20:33871264-33871346,chr20,33871264,33871346,1,2486107
H1|chr20:31385361-31385461,chr20,31385361,31385461,H1|chr20:60960937-60961021,chr20,60960937,60961021,1,29575576
H1|chr20:31385364-31385430,chr20,31385364,31385430,H1|chr20:60960937-60961021,chr20,60960937,60961021,1,29575573
H1|chr20:31385661-31385756,chr20,31385661,31385756,H1|chr20:31403948-31403977,chr20,31403948,31403977,1,18287
H1|chr20:31385857-31385928,chr20,31385857,31385928,H1|chr20:47899471-47899549,chr20,47899471,47899549,1,16513614
H1|chr20:31385858-31385948,chr20,31385858,31385948,H1|chr20:47899471-47899549,chr20,47899471,47899549,1,16513613
H1|chr20:31388914-31388988,chr20,31388914,31388988,H1|chr20:31331072-31331128,chr20,31331072,31331128,1,57842
H1|chr20:31388914-31388987,chr20,31388914,31388987,H1|chr20:31331072-31331128,chr20,31331072,31331128,1,57842
H1|chr20:31392453-31392483,chr20,31392453,31392483,H1|chr20:36150169-36150286,chr20,36150169,36150286,1,4757716
H1|chr20:31392453-31392474,chr20,31392453,31392474,H1|chr20:36150169-36150286,chr20,36150169,36150286,1,4757716
H1|chr20:31393512-31393555,chr20,31393512,31393555,H1|chr20:31404643-31404793,chr20,31404643,31404793,1,11131
H1|chr20:31452338-31452393,chr20,31452338,31452393,H1|chr20:31402869-31402971,chr20,31402869,31402971,1,49469
H1|chr20:31452345-31452393,chr20,31452345,31452393,H1|chr20:31402869-31402971,chr20,31402869,31402971,1,49476
H1|chr20:38902268-38902293,chr20,38902268,38902293,H1|chr20:57430349-57430435,chr20,57430349,57430435,1,18528081
H1|chr20:38902268-38902292,chr20,38902268,38902292,H1|chr20:57430349-57430435,chr20,57430349,57430435,1,18528081
H1|chr20:38902924-38903021,chr20,38902924,38903021,H1|chr20:57425428-57425521,chr20,57425428,57425521,1,18522504
H1|chr20:44619576-44619648,chr20,44619576,44619648,H1|chr20:44637955-44638021,chr20,44637955,44638021,1,18379
H1|chr20:44625428-44625497,chr20,44625428,44625497,H1|chr20:44635864-44635923,chr20,44635864,44635923,1,10436
H1|chr20:44709356-44709422,chr20,44709356,44709422,H1|chr20:48534290-48534438,chr20,48534290,48534438,1,3824934
H1|chr20:44709362-44709422,chr20,44709362,44709422,H1|chr20:48534290-48534438,chr20,48534290,48534438,1,3824928
H1|chr20:45934099-45934206,chr20,45934099,45934206,H1|chr20:45988252-45988281,chr20,45988252,45988281,1,54153
H1|chr20:45941944-45941980,chr20,45941944,45941980,H1|chr20:45989967-45990021,chr20,45989967,45990021,1,48023
H1|chr20:45942049-45942111,chr20,45942049,45942111,H1|chr20:45989442-45989524,chr20,45989442,45989524,1,47393
H1|chr20:45942052-45942111,chr20,45942052,45942111,H1|chr20:45989442-45989524,chr20,45989442,45989524,1,47390
H1|chr20:45954832-45954982,chr20,45954832,45954982,H1|chr20:45988965-45988990,chr20,45988965,45988990,1,34133
H1|chr20:45954888-45955013,chr20,45954888,45955013,H1|chr20:45988965-45988990,chr20,45988965,45988990,1,34077
H1|chr20:45954993-45955097,chr20,45954993,45955097,H1|chr20:45987373-45987416,chr20,45987373,45987416,1,32380
H1|chr20:45955352-45955399,chr20,45955352,45955399,H1|chr20:45990185-45990261,chr20,45990185,45990261,1,34833
H1|chr20:45955353-45955399,chr20,45955353,45955399,H1|chr20:45990185-45990261,chr20,45990185,45990261,1,34832
H1|chr20:45955929-45956022,chr20,45955929,45956022,H1|chr20:45989884-45989919,chr20,45989884,45989919,1,33955
H1|chr20:45956962-45957003,chr20,45956962,45957003,H1|chr20:45988352-45988468,chr20,45988352,45988468,1,31390
H1|chr20:45957597-45957642,chr20,45957597,45957642,H1|chr20:45990051-45990144,chr20,45990051,45990144,1,32454
H1|chr20:45959782-45959901,chr20,45959782,45959901,H1|chr20:45990446-45990521,chr20,45990446,45990521,1,30664
H1|chr20:45959826-45959901,chr20,45959826,45959901,H1|chr20:45990446-45990521,chr20,45990446,45990521,1,30620
H1|chr20:45962903-45962962,chr20,45962903,45962962,H1|chr20:45989321-45989397,chr20,45989321,45989397,1,26418
H1|chr20:45962904-45962962,chr20,45962904,45962962,H1|chr20:45989321-45989397,chr20,45989321,45989397,1,26417
H1|chr20:45966996-45967081,chr20,45966996,45967081,H1|chr20:45986428-45986489,chr20,45986428,45986489,1,19432
H1|chr20:45966997-45967081,chr20,45966997,45967081,H1|chr20:45986428-45986489,chr20,45986428,45986489,1,19431
H1|chr20:45967662-45967715,chr20,45967662,45967715,H1|chr20:62495319-62495412,chr20,62495319,62495412,1,16527657
H1|chr20:45967663-45967715,chr20,45967663,45967715,H1|chr20:62495361-62495413,chr20,62495361,62495413,1,16527698
H1|chr20:45970630-45970729,chr20,45970630,45970729,H1|chr20:45985783-45985831,chr20,45985783,45985831,1,15153
H1|chr20:45970631-45970738,chr20,45970631,45970738,H1|chr20:45985783-45985831,chr20,45985783,45985831,1,15152
H1|chr20:45991658-45991757,chr20,45991658,45991757,H1|chr20:45989610-45989632,chr20,45989610,45989632,1,2048
H1|chr20:45991866-45991939,chr20,45991866,45991939,H1|chr20:45988564-45988638,chr20,45988564,45988638,1,3302
H1|chr20:45991868-45991939,chr20,45991868,45991939,H1|chr20:45988564-45988638,chr20,45988564,45988638,1,3304
H1|chr20:45992173-45992285,chr20,45992173,45992285,H1|chr20:45988320-45988350,chr20,45988320,45988350,1,3853
H1|chr20:45992199-45992302,chr20,45992199,45992302,H1|chr20:45989362-45989389,chr20,45989362,45989389,1,2837
H1|chr20:45992266-45992364,chr20,45992266,45992364,H1|chr20:45985989-45986083,chr20,45985989,45986083,1,6277
H1|chr20:45992266-45992319,chr20,45992266,45992319,H1|chr20:45985989-45986083,chr20,45985989,45986083,1,6277
H1|chr20:45992544-45992652,chr20,45992544,45992652,H1|chr20:45989433-45989453,chr20,45989433,45989453,1,3111
H1|chr20:45992707-45992852,chr20,45992707,45992852,H1|chr20:45987198-45987347,chr20,45987198,45987347,1,5509
H1|chr20:45993375-45993434,chr20,45993375,45993434,H1|chr20:45987472-45987522,chr20,45987472,45987522,1,5903
H1|chr20:45993414-45993465,chr20,45993414,45993465,H1|chr20:45989826-45989923,chr20,45989826,45989923,1,3588
H1|chr20:45993431-45993465,chr20,45993431,45993465,H1|chr20:45989826-45989923,chr20,45989826,45989923,1,3605
H1|chr20:45993632-45993753,chr20,45993632,45993753,H1|chr20:45987564-45987587,chr20,45987564,45987587,1,6068
H1|chr20:45993632-45993749,chr20,45993632,45993749,H1|chr20:45987564-45987587,chr20,45987564,45987587,1,6068
H1|chr20:45993884-45993946,chr20,45993884,45993946,H1|chr20:45987521-45987671,chr20,45987521,45987671,1,6363
H1|chr20:45993885-45994016,chr20,45993885,45994016,H1|chr20:45988447-45988466,chr20,45988447,45988466,1,5438
H1|chr20:45993891-45994024,chr20,45993891,45994024,H1|chr20:45988447-45988466,chr20,45988447,45988466,1,5444
H1|chr20:45994729-45994814,chr20,45994729,45994814,H1|chr20:45990471-45990506,chr20,45990471,45990506,1,4258
H1|chr20:45995310-45995357,chr20,45995310,45995357,H1|chr20:44988158-44988277,chr20,44988158,44988277,1,1007152
H1|chr20:45995326-45995357,chr20,45995326,45995357,H1|chr20:44988158-44988277,chr20,44988158,44988277,1,1007168
H1|chr20:45995418-45995530,chr20,45995418,45995530,H1|chr20:45988644-45988689,chr20,45988644,45988689,1,6774
H1|chr20:45995425-45995530,chr20,45995425,45995530,H1|chr20:45988644-45988689,chr20,45988644,45988689,1,6781
H1|chr20:45996164-45996227,chr20,45996164,45996227,H1|chr20:45989170-45989225,chr20,45989170,45989225,1,6994
H1|chr20:45996164-45996226,chr20,45996164,45996226,H1|chr20:45989170-45989225,chr20,45989170,45989225,1,6994
H1|chr20:45996224-45996311,chr20,45996224,45996311,H1|chr20:45988653-45988712,chr20,45988653,45988712,1,7571
H1|chr20:45996488-45996556,chr20,45996488,45996556,H1|chr20:45989906-45989983,chr20,45989906,45989983,1,6582
H1|chr20:45996488-45996555,chr20,45996488,45996555,H1|chr20:45989906-45989983,chr20,45989906,45989983,1,6582
H1|chr20:45996994-45997061,chr20,45996994,45997061,H1|chr20:45989009-45989056,chr20,45989009,45989056,1,7985
H1|chr20:45997673-45997699,chr20,45997673,45997699,H1|chr20:45988107-45988215,chr20,45988107,45988215,1,9566
H1|chr20:45997693-45997795,chr20,45997693,45997795,H1|chr20:45990071-45990125,chr20,45990071,45990125,1,7622
H1|chr20:45997693-45997789,chr20,45997693,45997789,H1|chr20:45990071-45990125,chr20,45990071,45990125,1,7622
H1|chr20:45997737-45997862,chr20,45997737,45997862,H1|chr20:45989751-45989787,chr20,45989751,45989787,1,7986
H1|chr20:45997741-45997760,chr20,45997741,45997760,H1|chr20:45989837-45989939,chr20,45989837,45989939,1,7904
H1|chr20:45997750-45997863,chr20,45997750,45997863,H1|chr20:45989751-45989787,chr20,45989751,45989787,1,7999
H1|chr20:45997785-45997844,chr20,45997785,45997844,H1|chr20:45985523-45985633,chr20,45985523,45985633,1,12262
H1|chr20:45997785-45997831,chr20,45997785,45997831,H1|chr20:45985534-45985633,chr20,45985534,45985633,1,12251
H1|chr20:45997785-45997830,chr20,45997785,45997830,H1|chr20:45985534-45985633,chr20,45985534,45985633,1,12251
H1|chr20:45997785-45997825,chr20,45997785,45997825,H1|chr20:45985523-45985633,chr20,45985523,45985633,1,12262
H1|chr20:45997836-45997855,chr20,45997836,45997855,H1|chr20:45987360-45987507,chr20,45987360,45987507,1,10476
H1|chr20:46000969-46000993,chr20,46000969,46000993,H1|chr20:45988329-45988430,chr20,45988329,45988430,1,12640
H1|chr20:46279174-46279292,chr20,46279174,46279292,H1|chr20:42294708-42294792,chr20,42294708,42294792,1,3984466
H1|chr20:47905686-47905767,chr20,47905686,47905767,H1|chr20:17951809-17951863,chr20,17951809,17951863,1,29953877
H1|chr20:47905689-47905743,chr20,47905689,47905743,H1|chr20:17951809-17951866,chr20,17951809,17951866,1,29953880
H1|chr20:47905855-47905936,chr20,47905855,47905936,H1|chr20:47896738-47896814,chr20,47896738,47896814,1,9117
H1|chr20:47905865-47905939,chr20,47905865,47905939,H1|chr20:47896738-47896814,chr20,47896738,47896814,1,9127
H1|chr20:47905927-47906055,chr20,47905927,47906055,H1|chr20:47897903-47897954,chr20,47897903,47897954,1,8024
H1|chr20:47905960-47906055,chr20,47905960,47906055,H1|chr20:47897903-47897954,chr20,47897903,47897954,1,8057
H1|chr20:47906098-47906170,chr20,47906098,47906170,H1|chr20:47898666-47898744,chr20,47898666,47898744,1,7432
H1|chr20:47906477-47906623,chr20,47906477,47906623,H1|chr20:47895943-47896000,chr20,47895943,47896000,1,10534
H1|chr20:47906538-47906625,chr20,47906538,47906625,H1|chr20:47898669-47898732,chr20,47898669,47898732,1,7869
H1|chr20:47906538-47906623,chr20,47906538,47906623,H1|chr20:47898669-47898732,chr20,47898669,47898732,1,7869
H1|chr20:47906702-47906805,chr20,47906702,47906805,H1|chr20:47896059-47896177,chr20,47896059,47896177,1,10643
H1|chr20:47906794-47906825,chr20,47906794,47906825,H1|chr20:47896604-47896741,chr20,47896604,47896741,1,10190
H1|chr20:47907080-47907140,chr20,47907080,47907140,H1|chr20:47897826-47897916,chr20,47897826,47897916,1,9254
H1|chr20:47907093-47907120,chr20,47907093,47907120,H1|chr20:47896527-47896623,chr20,47896527,47896623,1,10566
H1|chr20:47907329-47907382,chr20,47907329,47907382,H1|chr20:47900102-47900179,chr20,47900102,47900179,1,7227
H1|chr20:47907574-47907592,chr20,47907574,47907592,H1|chr20:47896487-47896635,chr20,47896487,47896635,1,11087
H1|chr20:47907639-47907666,chr20,47907639,47907666,H1|chr20:47900117-47900240,chr20,47900117,47900240,1,7522
H1|chr20:47907640-47907723,chr20,47907640,47907723,H1|chr20:47899574-47899640,chr20,47899574,47899640,1,8066
H1|chr20:47907675-47907736,chr20,47907675,47907736,H1|chr20:47897891-47898040,chr20,47897891,47898040,1,9784
H1|chr20:47907735-47907808,chr20,47907735,47907808,H1|chr20:47899892-47899987,chr20,47899892,47899987,1,7843
H1|chr20:47907769-47907809,chr20,47907769,47907809,H1|chr20:47899892-47899987,chr20,47899892,47899987,1,7877
H1|chr20:47907842-47907922,chr20,47907842,47907922,H1|chr20:47897071-47897184,chr20,47897071,47897184,1,10771
H1|chr20:47907842-47907876,chr20,47907842,47907876,H1|chr20:47897071-47897184,chr20,47897071,47897184,1,10771
H1|chr20:47907843-47907864,chr20,47907843,47907864,H1|chr20:47898195-47898340,chr20,47898195,47898340,1,9648
H1|chr20:47907921-47907966,chr20,47907921,47907966,H1|chr20:47897134-47897189,chr20,47897134,47897189,1,10787
H1|chr20:47908689-47908789,chr20,47908689,47908789,H1|chr20:47896807-47896886,chr20,47896807,47896886,1,11882
H1|chr20:47908718-47908789,chr20,47908718,47908789,H1|chr20:47896807-47896886,chr20,47896807,47896886,1,11911
H1|chr20:47909086-47909178,chr20,47909086,47909178,H1|chr20:47896589-47896669,chr20,47896589,47896669,1,12497
H1|chr20:47909112-47909179,chr20,47909112,47909179,H1|chr20:47896589-47896669,chr20,47896589,47896669,1,12523
H1|chr20:47911207-47911324,chr20,47911207,47911324,H1|chr20:47899212-47899294,chr20,47899212,47899294,1,11995
H1|chr20:47911256-47911324,chr20,47911256,47911324,H1|chr20:47899212-47899294,chr20,47899212,47899294,1,12044
H1|chr20:47914226-47914282,chr20,47914226,47914282,H1|chr20:47897079-47897174,chr20,47897079,47897174,1,17147
H1|chr20:47914226-47914281,chr20,47914226,47914281,H1|chr20:47897079-47897174,chr20,47897079,47897174,1,17147
H1|chr20:47922121-47922197,chr20,47922121,47922197,H1|chr20:47898046-47898120,chr20,47898046,47898120,1,24075
H1|chr20:48297677-48297754,chr20,48297677,48297754,H1|chr20:47896107-47896171,chr20,47896107,47896171,1,401570
H1|chr20:48298506-48298550,chr20,48298506,48298550,H1|chr20:47898653-47898735,chr20,47898653,47898735,1,399853
H1|chr20:48301850-48301889,chr20,48301850,48301889,H1|chr20:47896578-47896667,chr20,47896578,47896667,1,405272
H1|chr20:48384428-48384481,chr20,48384428,48384481,H1|chr20:48424842-48424916,chr20,48424842,48424916,1,40414
H1|chr20:50581579-50581642,chr20,50581579,50581642,H1|chr20:47898619-47898724,chr20,47898619,47898724,1,2682960
H1|chr20:50581597-50581642,chr20,50581597,50581642,H1|chr20:47898619-47898724,chr20,47898619,47898724,1,2682978
H1|chr20:55776350-55776380,chr20,55776350,55776380,H1|chr20:57467838-57467927,chr20,57467838,57467927,1,1691488
H1|chr20:55776351-55776380,chr20,55776351,55776380,H1|chr20:57467838-57467927,chr20,57467838,57467927,1,1691487
H1|chr20:55779526-55779612,chr20,55779526,55779612,H1|chr20:57467643-57467666,chr20,57467643,57467666,1,1688117
H1|chr20:55779526-55779576,chr20,55779526,55779576,H1|chr20:57467643-57467666,chr20,57467643,57467666,1,1688117
H1|chr20:55786959-55787049,chr20,55786959,55787049,H1|chr20:57467855-57467883,chr20,57467855,57467883,1,1680896
H1|chr20:55786960-55787049,chr20,55786960,55787049,H1|chr20:57467855-57467883,chr20,57467855,57467883,1,1680895
H1|chr20:57249689-57249733,chr20,57249689,57249733,H1|chr20:57424403-57424444,chr20,57424403,57424444,1,174714
H1|chr20:57249773-57249882,chr20,57249773,57249882,H1|chr20:57424403-57424444,chr20,57424403,57424444,1,174630
H1|chr20:57249785-57249882,chr20,57249785,57249882,H1|chr20:57424403-57424444,chr20,57424403,57424444,1,174618
H1|chr20:60951184-60951300,chr20,60951184,60951300,H1|chr20:60944818-60944847,chr20,60944818,60944847,1,6366
H1|chr20:60951319-60951338,chr20,60951319,60951338,H1|chr20:60944818-60944847,chr20,60944818,60944847,1,6501
H1|chr20:60951849-60951884,chr20,60951849,60951884,H1|chr20:60960494-60960574,chr20,60960494,60960574,1,8645
H1|chr20:60952295-60952408,chr20,60952295,60952408,H1|chr20:60945421-60945553,chr20,60945421,60945553,1,6874
H1|chr20:60952371-60952500,chr20,60952371,60952500,H1|chr20:60961630-60961651,chr20,60961630,60961651,1,9259
H1|chr20:60952373-60952433,chr20,60952373,60952433,H1|chr20:60961365-60961449,chr20,60961365,60961449,1,8992
H1|chr20:60952403-60952433,chr20,60952403,60952433,H1|chr20:60961365-60961449,chr20,60961365,60961449,1,8962
H1|chr20:60953347-60953405,chr20,60953347,60953405,H1|chr20:60958997-60959062,chr20,60958997,60959062,1,5650
H1|chr20:62486125-62486151,chr20,62486125,62486151,H1|chr20:62489934-62490058,chr20,62489934,62490058,1,3809
H1|chr20:62486127-62486151,chr20,62486127,62486151,H1|chr20:62489934-62490058,chr20,62489934,62490058,1,3807
H1|chr20:62487089-62487173,chr20,62487089,62487173,H1|chr20:62495967-62495992,chr20,62495967,62495992,1,8878
H1|chr20:62487337-62487427,chr20,62487337,62487427,H1|chr20:62488998-62489028,chr20,62488998,62489028,1,1661
H1|chr21:33678499-33678621,chr21,33678499,33678621,H1|chr21:32932792-32932841,chr21,32932792,32932841,1,745707
H1|chr21:33678499-33678600,chr21,33678499,33678600,H1|chr21:32932792-32932841,chr21,32932792,32932841,1,745707
H1|chr21:33678499-33678599,chr21,33678499,33678599,H1|chr21:32932792-32932841,chr21,32932792,32932841,1,745707
H1|chr21:33678502-33678621,chr21,33678502,33678621,H1|chr21:32932792-32932841,chr21,32932792,32932841,1,745710
H1|chr21:33865196-33865218,chr21,33865196,33865218,H1|chr21:33034324-33034448,chr21,33034324,33034448,1,830872
H1|chr21:33865197-33865254,chr21,33865197,33865254,H1|chr21:33034324-33034448,chr21,33034324,33034448,1,830873
H1|chr21:33936844-33936920,chr21,33936844,33936920,H1|chr21:33784322-33784357,chr21,33784322,33784357,1,152522
H1|chr21:33937048-33937104,chr21,33937048,33937104,H1|chr21:33783244-33783302,chr21,33783244,33783302,1,153804
H1|chr21:40454551-40454601,chr21,40454551,40454601,H1|chr21:17103894-17103981,chr21,17103894,17103981,1,23350657
H1|chr21:44344340-44344445,chr21,44344340,44344445,H1|chr21:44527535-44527580,chr21,44527535,44527580,1,183195
H1|chr21:44344399-44344477,chr21,44344399,44344477,H1|chr21:44527128-44527169,chr21,44527128,44527169,1,182729
H1|chr21:44344400-44344477,chr21,44344400,44344477,H1|chr21:44527128-44527169,chr21,44527128,44527169,1,182728
H1|chr21:44380494-44380544,chr21,44380494,44380544,H1|chr21:44392873-44392973,chr21,44392873,44392973,1,12379
H1|chr21:44380495-44380577,chr21,44380495,44380577,H1|chr21:44392873-44392973,chr21,44392873,44392973,1,12378
H1|chr21:44502761-44502866,chr21,44502761,44502866,H1|chr21:44501728-44501834,chr21,44501728,44501834,1,1033
H1|chr21:44502823-44502867,chr21,44502823,44502867,H1|chr21:44501728-44501834,chr21,44501728,44501834,1,1095
H1|chr21:44502890-44502946,chr21,44502890,44502946,H1|chr21:44500962-44501033,chr21,44500962,44501033,1,1928
H1|chr21:44502891-44502946,chr21,44502891,44502946,H1|chr21:44500962-44501033,chr21,44500962,44501033,1,1929
H1|chr21:44503111-44503165,chr21,44503111,44503165,H1|chr21:44500292-44500388,chr21,44500292,44500388,1,2819
H1|chr21:44503112-44503165,chr21,44503112,44503165,H1|chr21:44500292-44500388,chr21,44500292,44500388,1,2820
H1|chr21:44503438-44503557,chr21,44503438,44503557,H1|chr21:44500115-44500150,chr21,44500115,44500150,1,3323
H1|chr21:44503438-44503548,chr21,44503438,44503548,H1|chr21:44500115-44500150,chr21,44500115,44500150,1,3323
H1|chr21:44503438-44503546,chr21,44503438,44503546,H1|chr21:44500115-44500150,chr21,44500115,44500150,1,3323
H1|chr21:44503459-44503508,chr21,44503459,44503508,H1|chr21:44501781-44501887,chr21,44501781,44501887,1,1678
H1|chr21:44503459-44503503,chr21,44503459,44503503,H1|chr21:44501781-44501887,chr21,44501781,44501887,1,1678
H1|chr21:44503998-44504058,chr21,44503998,44504058,H1|chr21:44500327-44500417,chr21,44500327,44500417,1,3671
H1|chr21:44504000-44504080,chr21,44504000,44504080,H1|chr21:44500327-44500417,chr21,44500327,44500417,1,3673
H1|chr21:44504635-44504713,chr21,44504635,44504713,H1|chr21:44501491-44501567,chr21,44501491,44501567,1,3144
H1|chr21:44504752-44504825,chr21,44504752,44504825,H1|chr21:44501491-44501567,chr21,44501491,44501567,1,3261
H1|chr21:44505129-44505243,chr21,44505129,44505243,H1|chr21:44501983-44502030,chr21,44501983,44502030,1,3146
H1|chr21:44505129-44505227,chr21,44505129,44505227,H1|chr21:44501982-44502034,chr21,44501982,44502034,1,3147
H1|chr21:44505438-44505481,chr21,44505438,44505481,H1|chr21:44499310-44499436,chr21,44499310,44499436,1,6128
H1|chr21:44505655-44505733,chr21,44505655,44505733,H1|chr21:44498337-44498404,chr21,44498337,44498404,1,7318
H1|chr21:44505661-44505746,chr21,44505661,44505746,H1|chr21:44498337-44498404,chr21,44498337,44498404,1,7324
H1|chr21:44505852-44505900,chr21,44505852,44505900,H1|chr21:44497663-44497785,chr21,44497663,44497785,1,8189
H1|chr21:44505872-44505900,chr21,44505872,44505900,H1|chr21:44497663-44497785,chr21,44497663,44497785,1,8209
H1|chr21:44506934-44507008,chr21,44506934,44507008,H1|chr21:44499464-44499523,chr21,44499464,44499523,1,7470
H1|chr21:45238216-45238330,chr21,45238216,45238330,H1|chr21:44493929-44493959,chr21,44493929,44493959,1,744287
H1|chr21:45238216-45238260,chr21,45238216,45238260,H1|chr21:44493929-44493959,chr21,44493929,44493959,1,744287
H1|chr21:45238250-45238330,chr21,45238250,45238330,H1|chr21:44493929-44493959,chr21,44493929,44493959,1,744321
H1|chr22:17851575-17851637,chr22,17851575,17851637,H1|chr22:18041949-18042017,chr22,18041949,18042017,1,190374
H1|chr22:17851605-17851637,chr22,17851605,17851637,H1|chr22:18041949-18042017,chr22,18041949,18042017,1,190344
H1|chr22:17855081-17855165,chr22,17855081,17855165,H1|chr22:18038740-18038833,chr22,18038740,18038833,1,183659
H1|chr22:17859306-17859408,chr22,17859306,17859408,H1|chr22:18040114-18040232,chr22,18040114,18040232,1,180808
H1|chr22:17859307-17859408,chr22,17859307,17859408,H1|chr22:18040114-18040232,chr22,18040114,18040232,1,180807
H1|chr22:17859376-17859408,chr22,17859376,17859408,H1|chr22:18040114-18040232,chr22,18040114,18040232,1,180738
H1|chr22:17860560-17860642,chr22,17860560,17860642,H1|chr22:18040073-18040113,chr22,18040073,18040113,1,179513
H1|chr22:17860992-17861026,chr22,17860992,17861026,H1|chr22:20070958-20071039,chr22,20070958,20071039,1,2209966
H1|chr22:17861160-17861198,chr22,17861160,17861198,H1|chr22:18041949-18042017,chr22,18041949,18042017,1,180789
H1|chr22:17861160-17861180,chr22,17861160,17861180,H1|chr22:18041949-18042017,chr22,18041949,18042017,1,180789
H1|chr22:17862598-17862626,chr22,17862598,17862626,H1|chr22:42314661-42314733,chr22,42314661,42314733,1,24452063
H1|chr22:17869527-17869602,chr22,17869527,17869602,H1|chr22:18039179-18039217,chr22,18039179,18039217,1,169652
H1|chr22:17869528-17869602,chr22,17869528,17869602,H1|chr22:18039179-18039217,chr22,18039179,18039217,1,169651
H1|chr22:17869601-17869751,chr22,17869601,17869751,H1|chr22:18110998-18111051,chr22,18110998,18111051,1,241397
H1|chr22:17869694-17869797,chr22,17869694,17869797,H1|chr22:18110877-18110894,chr22,18110877,18110894,1,241183
H1|chr22:17869727-17869822,chr22,17869727,17869822,H1|chr22:18110998-18111051,chr22,18110998,18111051,1,241271
H1|chr22:17872050-17872148,chr22,17872050,17872148,H1|chr22:41840320-41840337,chr22,41840320,41840337,1,23968270
H1|chr22:17872050-17872147,chr22,17872050,17872147,H1|chr22:41840320-41840337,chr22,41840320,41840337,1,23968270
H1|chr22:17872050-17872143,chr22,17872050,17872143,H1|chr22:41840320-41840337,chr22,41840320,41840337,1,23968270
H1|chr22:17872051-17872147,chr22,17872051,17872147,H1|chr22:41840320-41840337,chr22,41840320,41840337,1,23968269
H1|chr22:17873363-17873392,chr22,17873363,17873392,H1|chr22:18041583-18041694,chr22,18041583,18041694,1,168220
H1|chr22:17875083-17875121,chr22,17875083,17875121,H1|chr22:18039823-18039903,chr22,18039823,18039903,1,164740
H1|chr22:17875084-17875121,chr22,17875084,17875121,H1|chr22:18039823-18039903,chr22,18039823,18039903,1,164739
H1|chr22:17880734-17880785,chr22,17880734,17880785,H1|chr22:42325991-42326086,chr22,42325991,42326086,1,24445257
H1|chr22:17881821-17881895,chr22,17881821,17881895,H1|chr22:18111253-18111329,chr22,18111253,18111329,1,229432
H1|chr22:17886269-17886385,chr22,17886269,17886385,H1|chr22:20069975-20070055,chr22,20069975,20070055,1,2183706
H1|chr22:17886269-17886339,chr22,17886269,17886339,H1|chr22:20069975-20070055,chr22,20069975,20070055,1,2183706
H1|chr22:17893705-17893767,chr22,17893705,17893767,H1|chr22:20068251-20068335,chr22,20068251,20068335,1,2174546
H1|chr22:17896614-17896651,chr22,17896614,17896651,H1|chr22:18038783-18038868,chr22,18038783,18038868,1,142169
H1|chr22:17915220-17915302,chr22,17915220,17915302,H1|chr22:42326715-42326788,chr22,42326715,42326788,1,24411495
H1|chr22:17915225-17915302,chr22,17915225,17915302,H1|chr22:42326715-42326788,chr22,42326715,42326788,1,24411490
H1|chr22:17916603-17916657,chr22,17916603,17916657,H1|chr22:18039897-18039997,chr22,18039897,18039997,1,123294
H1|chr22:17916603-17916653,chr22,17916603,17916653,H1|chr22:18039897-18039997,chr22,18039897,18039997,1,123294
H1|chr22:17942142-17942214,chr22,17942142,17942214,H1|chr22:18122386-18122430,chr22,18122386,18122430,1,180244
H1|chr22:17946530-17946623,chr22,17946530,17946623,H1|chr22:18122005-18122062,chr22,18122005,18122062,1,175475
H1|chr22:18469998-18470094,chr22,18469998,18470094,H1|chr22:20795182-20795240,chr22,20795182,20795240,1,2325184
H1|chr22:18470002-18470094,chr22,18470002,18470094,H1|chr22:20795182-20795240,chr22,20795182,20795240,1,2325180
H1|chr22:19857040-19857102,chr22,19857040,19857102,H1|chr22:19844401-19844484,chr22,19844401,19844484,1,12639
H1|chr22:19858201-19858308,chr22,19858201,19858308,H1|chr22:19847320-19847339,chr22,19847320,19847339,1,10881
H1|chr22:22008728-22008751,chr22,22008728,22008751,H1|chr22:20116240-20116348,chr22,20116240,20116348,1,1892488
H1|chr22:22008728-22008749,chr22,22008728,22008749,H1|chr22:20116238-20116348,chr22,20116238,20116348,1,1892490
H1|chr22:22009725-22009769,chr22,22009725,22009769,H1|chr22:21767838-21767898,chr22,21767838,21767898,1,241887
H1|chr22:23536306-23536409,chr22,23536306,23536409,H1|chr22:50766666-50766785,chr22,50766666,50766785,1,27230360
H1|chr22:23536306-23536337,chr22,23536306,23536337,H1|chr22:50766666-50766785,chr22,50766666,50766785,1,27230360
H1|chr22:23570509-23570562,chr22,23570509,23570562,H1|chr22:22653734-22653812,chr22,22653734,22653812,1,916775
H1|chr22:23570616-23570688,chr22,23570616,23570688,H1|chr22:22653734-22653812,chr22,22653734,22653812,1,916882
H1|chr22:25792753-25792774,chr22,25792753,25792774,H1|chr22:19844191-19844307,chr22,19844191,19844307,1,5948562
H1|chr22:26972941-26973033,chr22,26972941,26973033,H1|chr22:20068566-20068597,chr22,20068566,20068597,1,6904375
H1|chr22:29697404-29697493,chr22,29697404,29697493,H1|chr22:29697595-29697656,chr22,29697595,29697656,1,191
H1|chr22:29697416-29697475,chr22,29697416,29697475,H1|chr22:29697768-29697918,chr22,29697768,29697918,1,352
H1|chr22:32725834-32725875,chr22,32725834,32725875,H1|chr22:32027145-32027245,chr22,32027145,32027245,1,698689
H1|chr22:32725836-32725875,chr22,32725836,32725875,H1|chr22:32027145-32027245,chr22,32027145,32027245,1,698691
H1|chr22:33435713-33435751,chr22,33435713,33435751,H1|chr22:45400498-45400532,chr22,45400498,45400532,1,11964785
H1|chr22:33437379-33437433,chr22,33437379,33437433,H1|chr22:19846668-19846739,chr22,19846668,19846739,1,13590711
H1|chr22:33437380-33437433,chr22,33437380,33437433,H1|chr22:19846668-19846739,chr22,19846668,19846739,1,13590712
H1|chr22:33437384-33437433,chr22,33437384,33437433,H1|chr22:19846668-19846739,chr22,19846668,19846739,1,13590716
H1|chr22:33445198-33445257,chr22,33445198,33445257,H1|chr22:42079847-42079924,chr22,42079847,42079924,1,8634649
H1|chr22:33726694-33726793,chr22,33726694,33726793,H1|chr22:33198237-33198306,chr22,33198237,33198306,1,528457
H1|chr22:33726694-33726775,chr22,33726694,33726775,H1|chr22:33198237-33198306,chr22,33198237,33198306,1,528457
H1|chr22:33726762-33726793,chr22,33726762,33726793,H1|chr22:33198237-33198306,chr22,33198237,33198306,1,528525
H1|chr22:34229886-34229980,chr22,34229886,34229980,H1|chr22:38006455-38006511,chr22,38006455,38006511,1,3776569
H1|chr22:34242980-34243077,chr22,34242980,34243077,H1|chr22:33452543-33452632,chr22,33452543,33452632,1,790437
H1|chr22:34243042-34243077,chr22,34243042,34243077,H1|chr22:33452543-33452632,chr22,33452543,33452632,1,790499
H1|chr22:34299907-34300016,chr22,34299907,34300016,H1|chr22:38008033-38008055,chr22,38008033,38008055,1,3708126
H1|chr22:34306816-34306915,chr22,34306816,34306915,H1|chr22:33452357-33452452,chr22,33452357,33452452,1,854459
H1|chr22:34306816-34306871,chr22,34306816,34306871,H1|chr22:33452357-33452452,chr22,33452357,33452452,1,854459
H1|chr22:35828932-35829074,chr22,35828932,35829074,H1|chr22:35796916-35796966,chr22,35796916,35796966,1,32016
H1|chr22:35828990-35829090,chr22,35828990,35829090,H1|chr22:35796916-35796966,chr22,35796916,35796966,1,32074
H1|chr22:35845956-35846021,chr22,35845956,35846021,H1|chr22:35796981-35797101,chr22,35796981,35797101,1,48975
H1|chr22:36411369-36411435,chr22,36411369,36411435,H1|chr22:36906478-36906512,chr22,36906478,36906512,1,495109
H1|chr22:36411369-36411434,chr22,36411369,36411434,H1|chr22:36906431-36906512,chr22,36906431,36906512,1,495062
H1|chr22:36771117-36771235,chr22,36771117,36771235,H1|chr22:45562692-45562734,chr22,45562692,45562734,1,8791575
H1|chr22:36771132-36771235,chr22,36771132,36771235,H1|chr22:45562692-45562734,chr22,45562692,45562734,1,8791560
H1|chr22:38026525-38026675,chr22,38026525,38026675,H1|chr22:38032642-38032729,chr22,38032642,38032729,1,6117
H1|chr22:38028295-38028385,chr22,38028295,38028385,H1|chr22:38033995-38034051,chr22,38033995,38034051,1,5700
H1|chr22:38030300-38030384,chr22,38030300,38030384,H1|chr22:38032599-38032707,chr22,38032599,38032707,1,2299
H1|chr22:38030342-38030384,chr22,38030342,38030384,H1|chr22:38032599-38032707,chr22,38032599,38032707,1,2257
H1|chr22:38213917-38213954,chr22,38213917,38213954,H1|chr22:38214673-38214823,chr22,38214673,38214823,1,756
H1|chr22:38213917-38213949,chr22,38213917,38213949,H1|chr22:38214673-38214704,chr22,38214673,38214704,1,756
H1|chr22:38214121-38214138,chr22,38214121,38214138,H1|chr22:38214907-38214995,chr22,38214907,38214995,1,786
H1|chr22:38214129-38214186,chr22,38214129,38214186,H1|chr22:38214485-38214542,chr22,38214485,38214542,1,356
H1|chr22:38653877-38653970,chr22,38653877,38653970,H1|chr22:39051993-39052045,chr22,39051993,39052045,1,398116
H1|chr22:38653877-38653967,chr22,38653877,38653967,H1|chr22:39051993-39052045,chr22,39051993,39052045,1,398116
H1|chr22:38658513-38658572,chr22,38658513,38658572,H1|chr22:39053625-39053702,chr22,39053625,39053702,1,395112
H1|chr22:38727570-38727640,chr22,38727570,38727640,H1|chr22:41683574-41683718,chr22,41683574,41683718,1,2956004
H1|chr22:38731309-38731374,chr22,38731309,38731374,H1|chr22:41680835-41680867,chr22,41680835,41680867,1,2949526
H1|chr22:38731310-38731374,chr22,38731310,38731374,H1|chr22:41680835-41680867,chr22,41680835,41680867,1,2949525
H1|chr22:38779914-38779934,chr22,38779914,38779934,H1|chr22:38901101-38901225,chr22,38901101,38901225,1,121187
H1|chr22:38779995-38780049,chr22,38779995,38780049,H1|chr22:38900867-38900912,chr22,38900867,38900912,1,120872
H1|chr22:38785625-38785684,chr22,38785625,38785684,H1|chr22:51019673-51019770,chr22,51019673,51019770,1,12234048
H1|chr22:38785634-38785685,chr22,38785634,38785685,H1|chr22:51019673-51019770,chr22,51019673,51019770,1,12234039
H1|chr22:38785876-38785955,chr22,38785876,38785955,H1|chr22:51020440-51020583,chr22,51020440,51020583,1,12234564
H1|chr22:38787014-38787153,chr22,38787014,38787153,H1|chr22:39053321-39053370,chr22,39053321,39053370,1,266307
H1|chr22:38787014-38787151,chr22,38787014,38787151,H1|chr22:39053321-39053370,chr22,39053321,39053370,1,266307
H1|chr22:38787014-38787115,chr22,38787014,38787115,H1|chr22:39053321-39053370,chr22,39053321,39053370,1,266307
H1|chr22:39575225-39575277,chr22,39575225,39575277,H1|chr22:40576440-40576485,chr22,40576440,40576485,1,1001215
H1|chr22:39575226-39575277,chr22,39575226,39575277,H1|chr22:40576440-40576485,chr22,40576440,40576485,1,1001214
H1|chr22:42660024-42660099,chr22,42660024,42660099,H1|chr22:22011496-22011571,chr22,22011496,22011571,1,20648528
H1|chr22:42660024-42660060,chr22,42660024,42660060,H1|chr22:22011496-22011610,chr22,22011496,22011610,1,20648528
H1|chr22:42969262-42969339,chr22,42969262,42969339,H1|chr22:21272884-21273001,chr22,21272884,21273001,1,21696378
H1|chr22:42976243-42976280,chr22,42976243,42976280,H1|chr22:42914489-42914583,chr22,42914489,42914583,1,61754
H1|chr22:42977545-42977641,chr22,42977545,42977641,H1|chr22:42915393-42915447,chr22,42915393,42915447,1,62152
H1|chr22:42977594-42977644,chr22,42977594,42977644,H1|chr22:42915393-42915447,chr22,42915393,42915447,1,62201
H1|chr22:42977604-42977693,chr22,42977604,42977693,H1|chr22:42915410-42915469,chr22,42915410,42915469,1,62194
H1|chr22:42977604-42977692,chr22,42977604,42977692,H1|chr22:42915418-42915469,chr22,42915418,42915469,1,62186
H1|chr22:42977604-42977690,chr22,42977604,42977690,H1|chr22:42915405-42915469,chr22,42915405,42915469,1,62199
H1|chr22:42977612-42977696,chr22,42977612,42977696,H1|chr22:42915551-42915665,chr22,42915551,42915665,1,62061
H1|chr22:45179691-45179744,chr22,45179691,45179744,H1|chr22:20846197-20846292,chr22,20846197,20846292,1,24333494
H1|chr22:45182725-45182764,chr22,45182725,45182764,H1|chr22:45409835-45409946,chr22,45409835,45409946,1,227110
H1|chr22:45194075-45194132,chr22,45194075,45194132,H1|chr22:45404142-45404235,chr22,45404142,45404235,1,210067
H1|chr22:45194080-45194155,chr22,45194080,45194155,H1|chr22:45404142-45404235,chr22,45404142,45404235,1,210062
H1|chr22:45196173-45196258,chr22,45196173,45196258,H1|chr22:45409686-45409727,chr22,45409686,45409727,1,213513
H1|chr22:45197422-45197494,chr22,45197422,45197494,H1|chr22:38901160-38901235,chr22,38901160,38901235,1,6296262
H1|chr22:45197423-45197493,chr22,45197423,45197493,H1|chr22:38901160-38901235,chr22,38901160,38901235,1,6296263
H1|chr22:45199870-45199911,chr22,45199870,45199911,H1|chr22:42347900-42347973,chr22,42347900,42347973,1,2851970
H1|chr22:45199870-45199909,chr22,45199870,45199909,H1|chr22:42347900-42347973,chr22,42347900,42347973,1,2851970
H1|chr22:45199871-45199909,chr22,45199871,45199909,H1|chr22:42347900-42347973,chr22,42347900,42347973,1,2851971
H1|chr22:45201543-45201607,chr22,45201543,45201607,H1|chr22:38794529-38794602,chr22,38794529,38794602,1,6407014
H1|chr22:45207578-45207700,chr22,45207578,45207700,H1|chr22:38901180-38901330,chr22,38901180,38901330,1,6306398
H1|chr22:45344311-45344387,chr22,45344311,45344387,H1|chr22:42326133-42326188,chr22,42326133,42326188,1,3018178
H1|chr22:45346077-45346187,chr22,45346077,45346187,H1|chr22:50221144-50221206,chr22,50221144,50221206,1,4875067
H1|chr22:45346078-45346187,chr22,45346078,45346187,H1|chr22:50221144-50221206,chr22,50221144,50221206,1,4875066
H1|chr22:45346099-45346187,chr22,45346099,45346187,H1|chr22:50221144-50221206,chr22,50221144,50221206,1,4875045
H1|chr22:45346100-45346187,chr22,45346100,45346187,H1|chr22:50221144-50221206,chr22,50221144,50221206,1,4875044
H1|chr22:45356545-45356656,chr22,45356545,45356656,H1|chr22:38053979-38053996,chr22,38053979,38053996,1,7302566
H1|chr22:45356546-45356656,chr22,45356546,45356656,H1|chr22:38053979-38053996,chr22,38053979,38053996,1,7302567
H1|chr22:45359314-45359345,chr22,45359314,45359345,H1|chr22:45559120-45559208,chr22,45559120,45559208,1,199806
H1|chr22:45359315-45359345,chr22,45359315,45359345,H1|chr22:45559120-45559208,chr22,45559120,45559208,1,199805
H1|chr22:45361629-45361702,chr22,45361629,45361702,H1|chr22:45560251-45560299,chr22,45560251,45560299,1,198622
H1|chr22:45365429-45365482,chr22,45365429,45365482,H1|chr22:38059190-38059287,chr22,38059190,38059287,1,7306239
H1|chr22:45365429-45365480,chr22,45365429,45365480,H1|chr22:38059190-38059287,chr22,38059190,38059287,1,7306239
H1|chr22:45368394-45368449,chr22,45368394,45368449,H1|chr22:42326018-42326113,chr22,42326018,42326113,1,3042376
H1|chr22:45397838-45397884,chr22,45397838,45397884,H1|chr22:40575355-40575435,chr22,40575355,40575435,1,4822483
H1|chr22:45397840-45397884,chr22,45397840,45397884,H1|chr22:40575355-40575435,chr22,40575355,40575435,1,4822485
H1|chr22:46894863-46894935,chr22,46894863,46894935,H1|chr22:46968534-46968586,chr22,46968534,46968586,1,73671
H1|chr22:46894865-46894935,chr22,46894865,46894935,H1|chr22:46968534-46968586,chr22,46968534,46968586,1,73669
H1|chr22:46894870-46894935,chr22,46894870,46894935,H1|chr22:46968534-46968585,chr22,46968534,46968585,1,73664
H1|chr1:6178-6238,chr1,6178,6238,H1|chr1:149671927-149671991,chr1,149671927,149671991,0,149665749
H1|chr1:30720-30804,chr1,30720,30804,H1|chr1:33650432-33650497,chr1,33650432,33650497,0,33619712
H1|chr1:99380-99404,chr1,99380,99404,H1|chr1:43425628-43425721,chr1,43425628,43425721,0,43326248
H1|chr1:130016-130064,chr1,130016,130064,H1|chr1:100597556-100597658,chr1,100597556,100597658,0,100467540
H1|chr1:218704-218798,chr1,218704,218798,H1|chr1:211750354-211750382,chr1,211750354,211750382,0,211531650
H1|chr1:247637-247666,chr1,247637,247666,H1|chr1:113498957-113499072,chr1,113498957,113499072,0,113251320
H1|chr1:273339-273391,chr1,273339,273391,H1|chr1:213034651-213034719,chr1,213034651,213034719,0,212761312
H1|chr1:388473-388567,chr1,388473,388567,H1|chr1:211750354-211750382,chr1,211750354,211750382,0,211361881
H1|chr1:464735-464797,chr1,464735,464797,H1|chr1:213120365-213120411,chr1,213120365,213120411,0,212655630
H1|chr1:495922-495988,chr1,495922,495988,H1|chr1:182762122-182762206,chr1,182762122,182762206,0,182266200
H1|chr1:561672-561800,chr1,561672,561800,H1|chr1:1287496-1287591,chr1,1287496,1287591,0,725824
H1|chr1:610856-610924,chr1,610856,610924,H1|chr1:150266946-150267002,chr1,150266946,150267002,0,149656090
H1|chr1:808650-808709,chr1,808650,808709,H1|chr1:150530600-150530664,chr1,150530600,150530664,0,149721950
H1|chr1:1089737-1089800,chr1,1089737,1089800,H1|chr1:90310869-90310893,chr1,90310869,90310893,0,89221132
H1|chr1:1172280-1172304,chr1,1172280,1172304,H1|chr1:156676445-156676571,chr1,156676445,156676571,0,155504165
H1|chr1:1286257-1286336,chr1,1286257,1286336,H1|chr1:150603910-150603950,chr1,150603910,150603950,0,149317653
H1|chr1:1479680-1479753,chr1,1479680,1479753,H1|chr1:150603919-150603974,chr1,150603919,150603974,0,149124239
H1|chr1:1527884-1527957,chr1,1527884,1527957,H1|chr1:150603919-150603974,chr1,150603919,150603974,0,149076035
H1|chr1:1678443-1678477,chr1,1678443,1678477,H1|chr1:113616884-113616945,chr1,113616884,113616945,0,111938441
H1|chr1:1807258-1807320,chr1,1807258,1807320,H1|chr1:149672017-149672081,chr1,149672017,149672081,0,147864759
H1|chr1:1861191-1861280,chr1,1861191,1861280,H1|chr1:62662362-62662423,chr1,62662362,62662423,0,60801171
H1|chr1:1979766-1979803,chr1,1979766,1979803,H1|chr1:27665977-27666063,chr1,27665977,27666063,0,25686211
H1|chr1:2077630-2077687,chr1,2077630,2077687,H1|chr1:155540703-155540792,chr1,155540703,155540792,0,153463073
H1|chr1:2615845-2615967,chr1,2615845,2615967,H1|chr1:156644244-156644308,chr1,156644244,156644308,0,154028399
H1|chr1:2627739-2627781,chr1,2627739,2627781,H1|chr1:38479287-38479340,chr1,38479287,38479340,0,35851548
H1|chr1:2629877-2630005,chr1,2629877,2630005,H1|chr1:27321952-27321971,chr1,27321952,27321971,0,24692075
H1|chr1:2631784-2631834,chr1,2631784,2631834,H1|chr1:2046144-2046243,chr1,2046144,2046243,0,585640
H1|chr1:2924763-2924815,chr1,2924763,2924815,H1|chr1:120254826-120254901,chr1,120254826,120254901,0,117330063
H1|chr1:3220907-3221057,chr1,3220907,3221057,H1|chr1:148560467-148560617,chr1,148560467,148560617,0,145339560
H1|chr1:3755402-3755447,chr1,3755402,3755447,H1|chr1:939876-939981,chr1,939876,939981,0,2815526
H1|chr1:3981297-3981433,chr1,3981297,3981433,H1|chr1:154971268-154971345,chr1,154971268,154971345,0,150989971
H1|chr1:4410399-4410513,chr1,4410399,4410513,H1|chr1:245025565-245025606,chr1,245025565,245025606,0,240615166
H1|chr1:4488060-4488151,chr1,4488060,4488151,H1|chr1:155170808-155170867,chr1,155170808,155170867,0,150682748
H1|chr1:4551723-4551765,chr1,4551723,4551765,H1|chr1:19579058-19579166,chr1,19579058,19579166,0,15027335
H1|chr1:5055312-5055338,chr1,5055312,5055338,H1|chr1:149671927-149672002,chr1,149671927,149672002,0,144616615
H1|chr1:5344701-5344825,chr1,5344701,5344825,H1|chr1:39326250-39326323,chr1,39326250,39326323,0,33981549
H1|chr1:5511205-5511236,chr1,5511205,5511236,H1|chr1:10004154-10004283,chr1,10004154,10004283,0,4492949
H1|chr1:5541773-5541882,chr1,5541773,5541882,H1|chr1:45790789-45790827,chr1,45790789,45790827,0,40249016
H1|chr1:5608624-5608687,chr1,5608624,5608687,H1|chr1:27674714-27674801,chr1,27674714,27674801,0,22066090
H1|chr1:5922962-5922999,chr1,5922962,5922999,H1|chr1:224302933-224302995,chr1,224302933,224302995,0,218379971
H1|chr1:6213619-6213683,chr1,6213619,6213683,H1|chr1:900250-900300,chr1,900250,900300,0,5313369
H1|chr1:6265838-6265865,chr1,6265838,6265865,H1|chr1:156673740-156673815,chr1,156673740,156673815,0,150407902
H1|chr1:6277839-6277926,chr1,6277839,6277926,H1|chr1:173445770-173445838,chr1,173445770,173445838,0,167167931
H1|chr1:6443409-6443451,chr1,6443409,6443451,H1|chr1:201944885-201944972,chr1,201944885,201944972,0,195501476
H1|chr1:6946862-6946953,chr1,6946862,6946953,H1|chr1:155170808-155170867,chr1,155170808,155170867,0,148223946
H1|chr1:7080168-7080231,chr1,7080168,7080231,H1|chr1:27335574-27335651,chr1,27335574,27335651,0,20255406
H1|chr1:7407595-7407717,chr1,7407595,7407717,H1|chr1:40994911-40994935,chr1,40994911,40994935,0,33587316
H1|chr1:7450820-7450881,chr1,7450820,7450881,H1|chr1:247498694-247498764,chr1,247498694,247498764,0,240047874
H1|chr1:7622426-7622468,chr1,7622426,7622468,H1|chr1:229551323-229551408,chr1,229551323,229551408,0,221928897
H1|chr1:7779465-7779552,chr1,7779465,7779552,H1|chr1:9241762-9241882,chr1,9241762,9241882,0,1462297
H1|chr1:7835784-7835827,chr1,7835784,7835827,H1|chr1:120254854-120254901,chr1,120254854,120254901,0,112419070
H1|chr1:8070505-8070542,chr1,8070505,8070542,H1|chr1:27669232-27669345,chr1,27669232,27669345,0,19598727
H1|chr1:8148810-8148885,chr1,8148810,8148885,H1|chr1:26758317-26758364,chr1,26758317,26758364,0,18609507
H1|chr1:8227587-8227660,chr1,8227587,8227660,H1|chr1:41442828-41442978,chr1,41442828,41442978,0,33215241
H1|chr1:8749110-8749129,chr1,8749110,8749129,H1|chr1:225839810-225839958,chr1,225839810,225839958,0,217090700
H1|chr1:8838043-8838061,chr1,8838043,8838061,H1|chr1:32864247-32864305,chr1,32864247,32864305,0,24026204
H1|chr1:9467404-9467498,chr1,9467404,9467498,H1|chr1:27665560-27665597,chr1,27665560,27665597,0,18198156
H1|chr1:9522988-9523079,chr1,9522988,9523079,H1|chr1:233433698-233433809,chr1,233433698,233433809,0,223910710
H1|chr1:9529444-9529534,chr1,9529444,9529534,H1|chr1:27321562-27321616,chr1,27321562,27321616,0,17792118
H1|chr1:9543373-9543455,chr1,9543373,9543455,H1|chr1:156644244-156644308,chr1,156644244,156644308,0,147100871
H1|chr1:9637877-9637948,chr1,9637877,9637948,H1|chr1:27336301-27336368,chr1,27336301,27336368,0,17698424
H1|chr1:9678365-9678462,chr1,9678365,9678462,H1|chr1:229407755-229407792,chr1,229407755,229407792,0,219729390
H1|chr1:9801695-9801731,chr1,9801695,9801731,H1|chr1:148558086-148558235,chr1,148558086,148558235,0,138756391
H1|chr1:9890625-9890708,chr1,9890625,9890708,H1|chr1:2133434-2133467,chr1,2133434,2133467,0,7757191
H1|chr1:10129284-10129373,chr1,10129284,10129373,H1|chr1:26799083-26799197,chr1,26799083,26799197,0,16669799
H1|chr1:10416884-10416911,chr1,10416884,10416911,H1|chr1:213033780-213033870,chr1,213033780,213033870,0,202616896
H1|chr1:10654181-10654269,chr1,10654181,10654269,H1|chr1:211750354-211750382,chr1,211750354,211750382,0,201096173
H1|chr1:10957310-10957412,chr1,10957310,10957412,H1|chr1:44116656-44116677,chr1,44116656,44116677,0,33159346
H1|chr1:10975803-10975860,chr1,10975803,10975860,H1|chr1:11111038-11111118,chr1,11111038,11111118,0,135235
H1|chr1:11160893-11160918,chr1,11160893,11160918,H1|chr1:11717545-11717695,chr1,11717545,11717695,0,556652
H1|chr1:11380324-11380378,chr1,11380324,11380378,H1|chr1:244998093-244998193,chr1,244998093,244998193,0,233617769
H1|chr1:11561879-11561963,chr1,11561879,11561963,H1|chr1:200381605-200381652,chr1,200381605,200381652,0,188819726
H1|chr1:11827627-11827736,chr1,11827627,11827736,H1|chr1:148557601-148557656,chr1,148557601,148557656,0,136729974
H1|chr1:11830653-11830731,chr1,11830653,11830731,H1|chr1:27321601-27321624,chr1,27321601,27321624,0,15490948
H1|chr1:12005868-12005924,chr1,12005868,12005924,H1|chr1:224626350-224626406,chr1,224626350,224626406,0,212620482
H1|chr1:12140881-12140992,chr1,12140881,12140992,H1|chr1:156645604-156645633,chr1,156645604,156645633,0,144504723
H1|chr1:12187739-12187843,chr1,12187739,12187843,H1|chr1:25559252-25559290,chr1,25559252,25559290,0,13371513
H1|chr1:12283561-12283623,chr1,12283561,12283623,H1|chr1:173640372-173640488,chr1,173640372,173640488,0,161356811
H1|chr1:12903252-12903313,chr1,12903252,12903313,H1|chr1:224545401-224545421,chr1,224545401,224545421,0,211642149
H1|chr1:12913681-12913766,chr1,12913681,12913766,H1|chr1:156700779-156700844,chr1,156700779,156700844,0,143787098
H1|chr1:12976600-12976687,chr1,12976600,12976687,H1|chr1:82265657-82265709,chr1,82265657,82265709,0,69289057
H1|chr1:13135851-13135950,chr1,13135851,13135950,H1|chr1:149671927-149671991,chr1,149671927,149671991,0,136536076
H1|chr1:13215341-13215369,chr1,13215341,13215369,H1|chr1:203826574-203826712,chr1,203826574,203826712,0,190611233
H1|chr1:13538272-13538343,chr1,13538272,13538343,H1|chr1:17867605-17867648,chr1,17867605,17867648,0,4329333
H1|chr1:13593743-13593802,chr1,13593743,13593802,H1|chr1:229550203-229550294,chr1,229550203,229550294,0,215956460
H1|chr1:13825730-13825799,chr1,13825730,13825799,H1|chr1:62664559-62664647,chr1,62664559,62664647,0,48838829
H1|chr1:14061878-14061993,chr1,14061878,14061993,H1|chr1:28970813-28970833,chr1,28970813,28970833,0,14908935
H1|chr1:15101770-15101834,chr1,15101770,15101834,H1|chr1:109235987-109236058,chr1,109235987,109236058,0,94134217
H1|chr1:15181622-15181723,chr1,15181622,15181723,H1|chr1:44116656-44116677,chr1,44116656,44116677,0,28935034
H1|chr1:15197490-15197572,chr1,15197490,15197572,H1|chr1:62665219-62665287,chr1,62665219,62665287,0,47467729
H1|chr1:15260456-15260484,chr1,15260456,15260484,H1|chr1:200861397-200861480,chr1,200861397,200861480,0,185600941
H1|chr1:15276358-15276435,chr1,15276358,15276435,H1|chr1:33171322-33171350,chr1,33171322,33171350,0,17894964
H1|chr1:15521242-15521300,chr1,15521242,15521300,H1|chr1:229550276-229550326,chr1,229550276,229550326,0,214029034
H1|chr1:15767764-15767789,chr1,15767764,15767789,H1|chr1:150546667-150546725,chr1,150546667,150546725,0,134778903
H1|chr1:16102195-16102284,chr1,16102195,16102284,H1|chr1:43425525-43425582,chr1,43425525,43425582,0,27323330
H1|chr1:17315447-17315514,chr1,17315447,17315514,H1|chr1:150266945-150267002,chr1,150266945,150267002,0,132951498
H1|chr1:17439278-17439301,chr1,17439278,17439301,H1|chr1:28263428-28263542,chr1,28263428,28263542,0,10824150
H1|chr1:17538637-17538668,chr1,17538637,17538668,H1|chr1:247267051-247267156,chr1,247267051,247267156,0,229728414
H1|chr1:17651127-17651236,chr1,17651127,17651236,H1|chr1:245025565-245025606,chr1,245025565,245025606,0,227374438
H1|chr1:18454513-18454561,chr1,18454513,18454561,H1|chr1:150534225-150534312,chr1,150534225,150534312,0,132079712
H1|chr1:18502003-18502081,chr1,18502003,18502081,H1|chr1:173445900-173445923,chr1,173445900,173445923,0,154943897
H1|chr1:18758991-18759057,chr1,18758991,18759057,H1|chr1:173445930-173446008,chr1,173445930,173446008,0,154686939
H1|chr1:18845897-18846001,chr1,18845897,18846001,H1|chr1:939881-939924,chr1,939881,939924,0,17906016
H1|chr1:18872347-18872431,chr1,18872347,18872431,H1|chr1:224545401-224545421,chr1,224545401,224545421,0,205673054
H1|chr1:19078374-19078440,chr1,19078374,19078440,H1|chr1:62664591-62664710,chr1,62664591,62664710,0,43586217
H1|chr1:19363050-19363145,chr1,19363050,19363145,H1|chr1:36024278-36024313,chr1,36024278,36024313,0,16661228
H1|chr1:19435551-19435597,chr1,19435551,19435597,H1|chr1:33646320-33646421,chr1,33646320,33646421,0,14210769
H1|chr1:19453729-19453775,chr1,19453729,19453775,H1|chr1:110950825-110950874,chr1,110950825,110950874,0,91497096
H1|chr1:19616301-19616365,chr1,19616301,19616365,H1|chr1:109235987-109236058,chr1,109235987,109236058,0,89619686
H1|chr1:19928042-19928122,chr1,19928042,19928122,H1|chr1:26756269-26756338,chr1,26756269,26756338,0,6828227
H1|chr1:20254442-20254505,chr1,20254442,20254505,H1|chr1:244998093-244998129,chr1,244998093,244998129,0,224743651
H1|chr1:21230846-21230971,chr1,21230846,21230971,H1|chr1:150604751-150604771,chr1,150604751,150604771,0,129373905
H1|chr1:21290969-21291008,chr1,21290969,21291008,H1|chr1:27321972-27322025,chr1,27321972,27322025,0,6031003
H1|chr1:21459371-21459471,chr1,21459371,21459471,H1|chr1:173639303-173639337,chr1,173639303,173639337,0,152179932
H1|chr1:21464415-21464540,chr1,21464415,21464540,H1|chr1:174844596-174844623,chr1,174844596,174844623,0,153380181
H1|chr1:21544529-21544565,chr1,21544529,21544565,H1|chr1:149674699-149674788,chr1,149674699,149674788,0,128130170
H1|chr1:22015116-22015206,chr1,22015116,22015206,H1|chr1:62665021-62665118,chr1,62665021,62665118,0,40649905
H1|chr1:22053268-22053343,chr1,22053268,22053343,H1|chr1:182762122-182762197,chr1,182762122,182762197,0,160708854
H1|chr1:22137199-22137235,chr1,22137199,22137235,H1|chr1:149672536-149672595,chr1,149672536,149672595,0,127535337
H1|chr1:22149654-22149681,chr1,22149654,22149681,H1|chr1:1287733-1287833,chr1,1287733,1287833,0,20861921
H1|chr1:22154870-22154895,chr1,22154870,22154895,H1|chr1:44882217-44882287,chr1,44882217,44882287,0,22727347
H1|chr1:22276968-22277062,chr1,22276968,22277062,H1|chr1:149671950-149672006,chr1,149671950,149672006,0,127394982
H1|chr1:22436683-22436730,chr1,22436683,22436730,H1|chr1:16378499-16378601,chr1,16378499,16378601,0,6058184
H1|chr1:22622134-22622196,chr1,22622134,22622196,H1|chr1:155102271-155102421,chr1,155102271,155102421,0,132480137
H1|chr1:22691919-22691936,chr1,22691919,22691936,H1|chr1:1334294-1334390,chr1,1334294,1334390,0,21357625
H1|chr1:22785727-22785780,chr1,22785727,22785780,H1|chr1:32402358-32402437,chr1,32402358,32402437,0,9616631
H1|chr1:23151759-23151832,chr1,23151759,23151832,H1|chr1:224545167-224545195,chr1,224545167,224545195,0,201393408
H1|chr1:23352339-23352404,chr1,23352339,23352404,H1|chr1:76254163-76254212,chr1,76254163,76254212,0,52901824
H1|chr1:23510529-23510548,chr1,23510529,23510548,H1|chr1:113497846-113497932,chr1,113497846,113497932,0,89987317
H1|chr1:23921160-23921231,chr1,23921160,23921231,H1|chr1:229551334-229551371,chr1,229551334,229551371,0,205630174
H1|chr1:24177791-24177808,chr1,24177791,24177808,H1|chr1:63153325-63153411,chr1,63153325,63153411,0,38975534
H1|chr1:24547816-24547889,chr1,24547816,24547889,H1|chr1:6675654-6675721,chr1,6675654,6675721,0,17872162
H1|chr1:24658586-24658634,chr1,24658586,24658634,H1|chr1:100597556-100597658,chr1,100597556,100597658,0,75938970
H1|chr1:24914235-24914319,chr1,24914235,24914319,H1|chr1:33650432-33650497,chr1,33650432,33650497,0,8736197
H1|chr1:25144382-25144442,chr1,25144382,25144442,H1|chr1:25560308-25560351,chr1,25560308,25560351,0,415926
H1|chr1:25307537-25307592,chr1,25307537,25307592,H1|chr1:213035035-213035127,chr1,213035035,213035127,0,187727498
H1|chr1:25539518-25539606,chr1,25539518,25539606,H1|chr1:62664118-62664180,chr1,62664118,62664180,0,37124600
H1|chr1:25553821-25553877,chr1,25553821,25553877,H1|chr1:33646320-33646421,chr1,33646320,33646421,0,8092499
H1|chr1:26299117-26299175,chr1,26299117,26299175,H1|chr1:155540703-155540792,chr1,155540703,155540792,0,129241586
H1|chr1:26692561-26692586,chr1,26692561,26692586,H1|chr1:150546667-150546725,chr1,150546667,150546725,0,123854106
H1|chr1:26786183-26786280,chr1,26786183,26786280,H1|chr1:100597556-100597658,chr1,100597556,100597658,0,73811373
H1|chr1:27140166-27140243,chr1,27140166,27140243,H1|chr1:8761281-8761330,chr1,8761281,8761330,0,18378885
H1|chr1:27168924-27169024,chr1,27168924,27169024,H1|chr1:27334720-27334823,chr1,27334720,27334823,0,165796
H1|chr1:27187984-27188091,chr1,27187984,27188091,H1|chr1:173445789-173445825,chr1,173445789,173445825,0,146257805
H1|chr1:27342421-27342522,chr1,27342421,27342522,H1|chr1:27664891-27664940,chr1,27664891,27664940,0,322470
H1|chr1:27612704-27612754,chr1,27612704,27612754,H1|chr1:173641053-173641106,chr1,173641053,173641106,0,146028349
H1|chr1:27740832-27740895,chr1,27740832,27740895,H1|chr1:27674714-27674801,chr1,27674714,27674801,0,66118
H1|chr1:28153615-28153668,chr1,28153615,28153668,H1|chr1:26757460-26757557,chr1,26757460,26757557,0,1396155
H1|chr1:28454932-28454963,chr1,28454932,28454963,H1|chr1:26758437-26758470,chr1,26758437,26758470,0,1696495
H1|chr1:28469591-28469609,chr1,28469591,28469609,H1|chr1:62664107-62664194,chr1,62664107,62664194,0,34194516
H1|chr1:28764764-28764787,chr1,28764764,28764787,H1|chr1:1362779-1362847,chr1,1362779,1362847,0,27401985
H1|chr1:28836310-28836413,chr1,28836310,28836413,H1|chr1:113496707-113496769,chr1,113496707,113496769,0,84660397
H1|chr1:28857724-28857811,chr1,28857724,28857811,H1|chr1:213125257-213125305,chr1,213125257,213125305,0,184267533
H1|chr1:29103052-29103118,chr1,29103052,29103118,H1|chr1:204047094-204047178,chr1,204047094,204047178,0,174944042
H1|chr1:29228055-29228117,chr1,29228055,29228117,H1|chr1:90309796-90309866,chr1,90309796,90309866,0,61081741
H1|chr1:29568841-29568893,chr1,29568841,29568893,H1|chr1:201944878-201944990,chr1,201944878,201944990,0,172376037
H1|chr1:29833240-29833269,chr1,29833240,29833269,H1|chr1:39488838-39488959,chr1,39488838,39488959,0,9655598
H1|chr1:30030021-30030168,chr1,30030021,30030168,H1|chr1:17244740-17244848,chr1,17244740,17244848,0,12785281
H1|chr1:30091797-30091843,chr1,30091797,30091843,H1|chr1:62664287-62664370,chr1,62664287,62664370,0,32572490
H1|chr1:30346042-30346171,chr1,30346042,30346171,H1|chr1:149671918-149672003,chr1,149671918,149672003,0,119325876
H1|chr1:30404598-30404709,chr1,30404598,30404709,H1|chr1:156645604-156645633,chr1,156645604,156645633,0,126241006
H1|chr1:30545418-30545530,chr1,30545418,30545530,H1|chr1:149671939-149671991,chr1,149671939,149671991,0,119126521
H1|chr1:31123369-31123427,chr1,31123369,31123427,H1|chr1:32862687-32862833,chr1,32862687,32862833,0,1739318
H1|chr1:31863332-31863470,chr1,31863332,31863470,H1|chr1:149675740-149675835,chr1,149675740,149675835,0,117812408
H1|chr1:32254921-32255071,chr1,32254921,32255071,H1|chr1:12683157-12683242,chr1,12683157,12683242,0,19571764
H1|chr1:32304573-32304695,chr1,32304573,32304695,H1|chr1:39487313-39487347,chr1,39487313,39487347,0,7182740
H1|chr1:32317780-32317833,chr1,32317780,32317833,H1|chr1:148558160-148558307,chr1,148558160,148558307,0,116240380
H1|chr1:32416770-32416837,chr1,32416770,32416837,H1|chr1:62662729-62662808,chr1,62662729,62662808,0,30245959
H1|chr1:32428394-32428517,chr1,32428394,32428517,H1|chr1:62660926-62660950,chr1,62660926,62660950,0,30232532
H1|chr1:32670174-32670283,chr1,32670174,32670283,H1|chr1:213034767-213034798,chr1,213034767,213034798,0,180364593
H1|chr1:32723522-32723597,chr1,32723522,32723597,H1|chr1:84544433-84544506,chr1,84544433,84544506,0,51820911
H1|chr1:32824472-32824499,chr1,32824472,32824499,H1|chr1:235269818-235269867,chr1,235269818,235269867,0,202445346
H1|chr1:32870367-32870394,chr1,32870367,32870394,H1|chr1:27322036-27322105,chr1,27322036,27322105,0,5548331
H1|chr1:33023668-33023752,chr1,33023668,33023752,H1|chr1:200381605-200381652,chr1,200381605,200381652,0,167357937
H1|chr1:33215657-33215681,chr1,33215657,33215681,H1|chr1:213034485-213034527,chr1,213034485,213034527,0,179818828
H1|chr1:33438729-33438843,chr1,33438729,33438843,H1|chr1:27321864-27321946,chr1,27321864,27321946,0,6116865
H1|chr1:33443005-33443091,chr1,33443005,33443091,H1|chr1:213035135-213035276,chr1,213035135,213035276,0,179592130
H1|chr1:33475661-33475729,chr1,33475661,33475729,H1|chr1:40205074-40205133,chr1,40205074,40205133,0,6729413
H1|chr1:33574747-33574767,chr1,33574747,33574767,H1|chr1:62663454-62663572,chr1,62663454,62663572,0,29088707
H1|chr1:33672797-33672854,chr1,33672797,33672854,H1|chr1:26757495-26757581,chr1,26757495,26757581,0,6915302
H1|chr1:34038753-34038803,chr1,34038753,34038803,H1|chr1:150534225-150534312,chr1,150534225,150534312,0,116495472
H1|chr1:34094358-34094382,chr1,34094358,34094382,H1|chr1:150546667-150546725,chr1,150546667,150546725,0,116452309
H1|chr1:34101643-34101716,chr1,34101643,34101716,H1|chr1:16537491-16537553,chr1,16537491,16537553,0,17564152
H1|chr1:34333377-34333517,chr1,34333377,34333517,H1|chr1:62664471-62664591,chr1,62664471,62664591,0,28331094
H1|chr1:34405553-34405572,chr1,34405553,34405572,H1|chr1:161736497-161736591,chr1,161736497,161736591,0,127330944
H1|chr1:35439854-35439910,chr1,35439854,35439910,H1|chr1:57043510-57043603,chr1,57043510,57043603,0,21603656
H1|chr1:35500245-35500336,chr1,35500245,35500336,H1|chr1:27665925-27665950,chr1,27665925,27665950,0,7834320
H1|chr1:35553823-35553919,chr1,35553823,35553919,H1|chr1:109757297-109757326,chr1,109757297,109757326,0,74203474
H1|chr1:35628334-35628358,chr1,35628334,35628358,H1|chr1:173448532-173448574,chr1,173448532,173448574,0,137820198
H1|chr1:35941796-35941816,chr1,35941796,35941816,H1|chr1:244998093-244998160,chr1,244998093,244998160,0,209056297
H1|chr1:36072491-36072508,chr1,36072491,36072508,H1|chr1:16090285-16090391,chr1,16090285,16090391,0,19982206
H1|chr1:36091767-36091830,chr1,36091767,36091830,H1|chr1:229551314-229551370,chr1,229551314,229551370,0,193459547
H1|chr1:36417598-36417629,chr1,36417598,36417629,H1|chr1:156644525-156644626,chr1,156644525,156644626,0,120226927
H1|chr1:36420221-36420333,chr1,36420221,36420333,H1|chr1:17247227-17247299,chr1,17247227,17247299,0,19172994
H1|chr1:36476823-36476851,chr1,36476823,36476851,H1|chr1:113498953-113499075,chr1,113498953,113499075,0,77022130
H1|chr1:36746280-36746312,chr1,36746280,36746312,H1|chr1:233430135-233430219,chr1,233430135,233430219,0,196683855
H1|chr1:37217852-37217946,chr1,37217852,37217946,H1|chr1:6507204-6507257,chr1,6507204,6507257,0,30710648
H1|chr1:37277750-37277888,chr1,37277750,37277888,H1|chr1:149671938-149671972,chr1,149671938,149671972,0,112394188
H1|chr1:37286575-37286600,chr1,37286575,37286600,H1|chr1:39569810-39569908,chr1,39569810,39569908,0,2283235
H1|chr1:37513206-37513307,chr1,37513206,37513307,H1|chr1:229407755-229407792,chr1,229407755,229407792,0,191894549
H1|chr1:37899902-37900003,chr1,37899902,37900003,H1|chr1:9649394-9649488,chr1,9649394,9649488,0,28250508
H1|chr1:38361841-38361950,chr1,38361841,38361950,H1|chr1:45790789-45790827,chr1,45790789,45790827,0,7428948
H1|chr1:38756515-38756573,chr1,38756515,38756573,H1|chr1:27321994-27322046,chr1,27321994,27322046,0,11434521
H1|chr1:39345264-39345394,chr1,39345264,39345394,H1|chr1:224302535-224302555,chr1,224302535,224302555,0,184957271
H1|chr1:39406574-39406699,chr1,39406574,39406699,H1|chr1:62664146-62664170,chr1,62664146,62664170,0,23257572
H1|chr1:39494896-39494930,chr1,39494896,39494930,H1|chr1:33115836-33115916,chr1,33115836,33115916,0,6379060
H1|chr1:39638352-39638462,chr1,39638352,39638462,H1|chr1:229551323-229551392,chr1,229551323,229551392,0,189912971
H1|chr1:39664860-39664905,chr1,39664860,39664905,H1|chr1:25593055-25593202,chr1,25593055,25593202,0,14071805
H1|chr1:39880555-39880611,chr1,39880555,39880611,H1|chr1:9649394-9649488,chr1,9649394,9649488,0,30231161
H1|chr1:39883369-39883388,chr1,39883369,39883388,H1|chr1:151434320-151434433,chr1,151434320,151434433,0,111550951
H1|chr1:39912026-39912072,chr1,39912026,39912072,H1|chr1:19579058-19579166,chr1,19579058,19579166,0,20332968
H1|chr1:40736281-40736311,chr1,40736281,40736311,H1|chr1:27667660-27667780,chr1,27667660,27667780,0,13068621
H1|chr1:40778908-40778958,chr1,40778908,40778958,H1|chr1:229548886-229548937,chr1,229548886,229548937,0,188769978
H1|chr1:40820178-40820196,chr1,40820178,40820196,H1|chr1:63153325-63153411,chr1,63153325,63153411,0,22333147
H1|chr1:41163723-41163798,chr1,41163723,41163798,H1|chr1:213034132-213034207,chr1,213034132,213034207,0,171870409
H1|chr1:41927456-41927492,chr1,41927456,41927492,H1|chr1:173445770-173445787,chr1,173445770,173445787,0,131518314
H1|chr1:42411730-42411880,chr1,42411730,42411880,H1|chr1:149671924-149672028,chr1,149671924,149672028,0,107260194
H1|chr1:42560965-42561027,chr1,42560965,42561027,H1|chr1:90309796-90309866,chr1,90309796,90309866,0,47748831
H1|chr1:42664708-42664769,chr1,42664708,42664769,H1|chr1:247498241-247498391,chr1,247498241,247498391,0,204833533
H1|chr1:42801455-42801473,chr1,42801455,42801473,H1|chr1:173640372-173640447,chr1,173640372,173640447,0,130838917
H1|chr1:42903924-42903955,chr1,42903924,42903955,H1|chr1:244998093-244998129,chr1,244998093,244998129,0,202094169
H1|chr1:43057167-43057187,chr1,43057167,43057187,H1|chr1:222883343-222883466,chr1,222883343,222883466,0,179826176
H1|chr1:43150703-43150777,chr1,43150703,43150777,H1|chr1:173445900-173445923,chr1,173445900,173445923,0,130295197
H1|chr1:43246923-43247073,chr1,43246923,43247073,H1|chr1:150292114-150292143,chr1,150292114,150292143,0,107045191
H1|chr1:43315020-43315060,chr1,43315020,43315060,H1|chr1:156675592-156675702,chr1,156675592,156675702,0,113360572
H1|chr1:43351879-43351940,chr1,43351879,43351940,H1|chr1:224542771-224542847,chr1,224542771,224542847,0,181190892
H1|chr1:44098026-44098100,chr1,44098026,44098100,H1|chr1:229548663-229548696,chr1,229548663,229548696,0,185450637
H1|chr1:44230927-44230982,chr1,44230927,44230982,H1|chr1:26756213-26756246,chr1,26756213,26756246,0,17474714
H1|chr1:44412786-44412897,chr1,44412786,44412897,H1|chr1:111991116-111991134,chr1,111991116,111991134,0,67578330
H1|chr1:44630568-44630620,chr1,44630568,44630620,H1|chr1:27335610-27335642,chr1,27335610,27335642,0,17294958
H1|chr1:44938506-44938625,chr1,44938506,44938625,H1|chr1:57111896-57111925,chr1,57111896,57111925,0,12173390
H1|chr1:44999184-44999232,chr1,44999184,44999232,H1|chr1:150534225-150534312,chr1,150534225,150534312,0,105535041
H1|chr1:45095695-45095771,chr1,45095695,45095771,H1|chr1:26758317-26758364,chr1,26758317,26758364,0,18337378
H1|chr1:45104920-45104951,chr1,45104920,45104951,H1|chr1:113498953-113499075,chr1,113498953,113499075,0,68394033
H1|chr1:45283651-45283749,chr1,45283651,45283749,H1|chr1:229550204-229550252,chr1,229550204,229550252,0,184266553
H1|chr1:45288285-45288328,chr1,45288285,45288328,H1|chr1:229551315-229551411,chr1,229551315,229551411,0,184263030
H1|chr1:45307591-45307655,chr1,45307591,45307655,H1|chr1:62662729-62662808,chr1,62662729,62662808,0,17355138
H1|chr1:45422665-45422723,chr1,45422665,45422723,H1|chr1:229550276-229550326,chr1,229550276,229550326,0,184127611
H1|chr1:45503111-45503207,chr1,45503111,45503207,H1|chr1:213034523-213034557,chr1,213034523,213034557,0,167531412
H1|chr1:45684245-45684272,chr1,45684245,45684272,H1|chr1:171455045-171455153,chr1,171455045,171455153,0,125770800
H1|chr1:45750856-45750903,chr1,45750856,45750903,H1|chr1:16378499-16378601,chr1,16378499,16378601,0,29372357
H1|chr1:46096555-46096588,chr1,46096555,46096588,H1|chr1:173442871-173442959,chr1,173442871,173442959,0,127346316
H1|chr1:46118065-46118080,chr1,46118065,46118080,H1|chr1:17244796-17244834,chr1,17244796,17244834,0,28873269
H1|chr1:46218637-46218706,chr1,46218637,46218706,H1|chr1:17247237-17247302,chr1,17247237,17247302,0,28971400
H1|chr1:46299135-46299206,chr1,46299135,46299206,H1|chr1:27667660-27667780,chr1,27667660,27667780,0,18631475
H1|chr1:46335609-46335687,chr1,46335609,46335687,H1|chr1:17246195-17246236,chr1,17246195,17246236,0,29089414
H1|chr1:46627463-46627613,chr1,46627463,46627613,H1|chr1:149672177-149672327,chr1,149672177,149672327,0,103044714
H1|chr1:46695546-46695664,chr1,46695546,46695664,H1|chr1:149671942-149671989,chr1,149671942,149671989,0,102976396
H1|chr1:47008140-47008184,chr1,47008140,47008184,H1|chr1:244998093-244998164,chr1,244998093,244998164,0,197989953
H1|chr1:47335923-47335971,chr1,47335923,47335971,H1|chr1:16378499-16378601,chr1,16378499,16378601,0,30957424
H1|chr1:47504895-47504950,chr1,47504895,47504950,H1|chr1:9649394-9649488,chr1,9649394,9649488,0,37855501
H1|chr1:47609875-47609985,chr1,47609875,47609985,H1|chr1:111991116-111991134,chr1,111991116,111991134,0,64381241
H1|chr1:47838295-47838327,chr1,47838295,47838327,H1|chr1:27338539-27338657,chr1,27338539,27338657,0,20499756
H1|chr1:47917777-47917887,chr1,47917777,47917887,H1|chr1:109757476-109757516,chr1,109757476,109757516,0,61839699
H1|chr1:48170035-48170104,chr1,48170035,48170104,H1|chr1:62661636-62661714,chr1,62661636,62661714,0,14491601
H1|chr1:48377985-48378079,chr1,48377985,48378079,H1|chr1:36024278-36024313,chr1,36024278,36024313,0,12353707
H1|chr1:48390543-48390625,chr1,48390543,48390625,H1|chr1:85358425-85358493,chr1,85358425,85358493,0,36967882
H1|chr1:48561954-48562004,chr1,48561954,48562004,H1|chr1:114701057-114701157,chr1,114701057,114701157,0,66139103
H1|chr1:48778401-48778508,chr1,48778401,48778508,H1|chr1:2510066-2510216,chr1,2510066,2510216,0,46268335
H1|chr1:48779267-48779355,chr1,48779267,48779355,H1|chr1:62664118-62664180,chr1,62664118,62664180,0,13884851
H1|chr1:48820011-48820102,chr1,48820011,48820102,H1|chr1:200380942-200381001,chr1,200380942,200381001,0,151560931
H1|chr1:49079294-49079365,chr1,49079294,49079365,H1|chr1:235269818-235269868,chr1,235269818,235269868,0,186190524
H1|chr1:49325774-49325852,chr1,49325774,49325852,H1|chr1:213034451-213034520,chr1,213034451,213034520,0,163708677
H1|chr1:49590709-49590752,chr1,49590709,49590752,H1|chr1:229551315-229551411,chr1,229551315,229551411,0,179960606
H1|chr1:49673841-49673873,chr1,49673841,49673873,H1|chr1:113496707-113496769,chr1,113496707,113496769,0,63822866
H1|chr1:49906066-49906141,chr1,49906066,49906141,H1|chr1:62661276-62661351,chr1,62661276,62661351,0,12755210
H1|chr1:50159087-50159187,chr1,50159087,50159187,H1|chr1:62661560-62661590,chr1,62661560,62661590,0,12502473
H1|chr1:50234811-50234887,chr1,50234811,50234887,H1|chr1:26758317-26758364,chr1,26758317,26758364,0,23476494
H1|chr1:50356369-50356442,chr1,50356369,50356442,H1|chr1:225964104-225964236,chr1,225964104,225964236,0,175607735
H1|chr1:50534274-50534321,chr1,50534274,50534321,H1|chr1:62664107-62664178,chr1,62664107,62664178,0,12129833
H1|chr1:50661050-50661073,chr1,50661050,50661073,H1|chr1:39572206-39572301,chr1,39572206,39572301,0,11088844
H1|chr1:51082768-51082898,chr1,51082768,51082898,H1|chr1:224302535-224302555,chr1,224302535,224302555,0,173219767
H1|chr1:51155875-51155944,chr1,51155875,51155944,H1|chr1:149672535-149672595,chr1,149672535,149672595,0,98516660
H1|chr1:51622447-51622573,chr1,51622447,51622573,H1|chr1:174844596-174844623,chr1,174844596,174844623,0,123222149
H1|chr1:51659549-51659583,chr1,51659549,51659583,H1|chr1:113616884-113616945,chr1,113616884,113616945,0,61957335
H1|chr1:52188430-52188503,chr1,52188430,52188503,H1|chr1:154971268-154971345,chr1,154971268,154971345,0,102782838
H1|chr1:53212669-53212703,chr1,53212669,53212703,H1|chr1:11725213-11725268,chr1,11725213,11725268,0,41487456
H1|chr1:53413127-53413230,chr1,53413127,53413230,H1|chr1:149671942-149671989,chr1,149671942,149671989,0,96258815
H1|chr1:53603380-53603413,chr1,53603380,53603413,H1|chr1:26758439-26758470,chr1,26758439,26758470,0,26844941
H1|chr1:53660765-53660826,chr1,53660765,53660826,H1|chr1:149671927-149671991,chr1,149671927,149671991,0,96011162
H1|chr1:53710463-53710540,chr1,53710463,53710540,H1|chr1:6675654-6675721,chr1,6675654,6675721,0,47034809
H1|chr1:53868805-53868831,chr1,53868805,53868831,H1|chr1:27322036-27322105,chr1,27322036,27322105,0,26546769
H1|chr1:53926349-53926440,chr1,53926349,53926440,H1|chr1:43425525-43425582,chr1,43425525,43425582,0,10500824
H1|chr1:54453975-54453994,chr1,54453975,54453994,H1|chr1:225839810-225839958,chr1,225839810,225839958,0,171385835
H1|chr1:54473573-54473616,chr1,54473573,54473616,H1|chr1:244998093-244998216,chr1,244998093,244998216,0,190524520
H1|chr1:54635980-54636065,chr1,54635980,54636065,H1|chr1:14923804-14923834,chr1,14923804,14923834,0,39712176
H1|chr1:54706777-54706857,chr1,54706777,54706857,H1|chr1:149671932-149672002,chr1,149671932,149672002,0,94965155
H1|chr1:54891749-54891804,chr1,54891749,54891804,H1|chr1:213035035-213035127,chr1,213035035,213035127,0,158143286
H1|chr1:55158235-55158312,chr1,55158235,55158312,H1|chr1:8761281-8761330,chr1,8761281,8761330,0,46396954
H1|chr1:55562657-55562758,chr1,55562657,55562758,H1|chr1:213036018-213036067,chr1,213036018,213036067,0,157473361
H1|chr1:55706611-55706665,chr1,55706611,55706665,H1|chr1:213033749-213033834,chr1,213033749,213033834,0,157327138
H1|chr1:55875889-55875985,chr1,55875889,55875985,H1|chr1:156859718-156859736,chr1,156859718,156859736,0,100983829
H1|chr1:56082633-56082664,chr1,56082633,56082664,H1|chr1:109235987-109236058,chr1,109235987,109236058,0,53153354
H1|chr1:56159229-56159335,chr1,56159229,56159335,H1|chr1:11728473-11728508,chr1,11728473,11728508,0,44430756
H1|chr1:56604460-56604514,chr1,56604460,56604514,H1|chr1:2134364-2134384,chr1,2134364,2134384,0,54470096
H1|chr1:56979671-56979752,chr1,56979671,56979752,H1|chr1:229551057-229551115,chr1,229551057,229551115,0,172571386
H1|chr1:57055491-57055511,chr1,57055491,57055511,H1|chr1:213034264-213034394,chr1,213034264,213034394,0,155978773
H1|chr1:57087705-57087798,chr1,57087705,57087798,H1|chr1:173639292-173639333,chr1,173639292,173639333,0,116551587
H1|chr1:57157303-57157368,chr1,57157303,57157368,H1|chr1:76254163-76254212,chr1,76254163,76254212,0,19096860
H1|chr1:57178259-57178343,chr1,57178259,57178343,H1|chr1:247499489-247499564,chr1,247499489,247499564,0,190321230
H1|chr1:57713257-57713339,chr1,57713257,57713339,H1|chr1:44818973-44819006,chr1,44818973,44819006,0,12894284
H1|chr1:57867839-57867906,chr1,57867839,57867906,H1|chr1:62664049-62664134,chr1,62664049,62664134,0,4796210
H1|chr1:57916795-57916879,chr1,57916795,57916879,H1|chr1:173444991-173445040,chr1,173444991,173445040,0,115528196
H1|chr1:58025316-58025356,chr1,58025316,58025356,H1|chr1:110950825-110950874,chr1,110950825,110950874,0,52925509
H1|chr1:58108092-58108148,chr1,58108092,58108148,H1|chr1:173445839-173445879,chr1,173445839,173445879,0,115337747
H1|chr1:58135513-58135599,chr1,58135513,58135599,H1|chr1:149671927-149671991,chr1,149671927,149671991,0,91536414
H1|chr1:58246670-58246817,chr1,58246670,58246817,H1|chr1:17244740-17244848,chr1,17244740,17244848,0,41001930
H1|chr1:58344116-58344187,chr1,58344116,58344187,H1|chr1:27336301-27336368,chr1,27336301,27336368,0,31007815
H1|chr1:58469838-58469904,chr1,58469838,58469904,H1|chr1:247499687-247499771,chr1,247499687,247499771,0,189029849
H1|chr1:58676037-58676159,chr1,58676037,58676159,H1|chr1:39487313-39487347,chr1,39487313,39487347,0,19188724
H1|chr1:58930574-58930677,chr1,58930574,58930677,H1|chr1:156859718-156859736,chr1,156859718,156859736,0,97929144
H1|chr1:58958061-58958088,chr1,58958061,58958088,H1|chr1:44882217-44882287,chr1,44882217,44882287,0,14075844
H1|chr1:58993044-58993144,chr1,58993044,58993144,H1|chr1:62661560-62661590,chr1,62661560,62661590,0,3668516
H1|chr1:59193058-59193136,chr1,59193058,59193136,H1|chr1:151513611-151513656,chr1,151513611,151513656,0,92320553
H1|chr1:59286893-59286957,chr1,59286893,59286957,H1|chr1:100597556-100597658,chr1,100597556,100597658,0,41310663
H1|chr1:59343304-59343361,chr1,59343304,59343361,H1|chr1:229549464-229549494,chr1,229549464,229549494,0,170206160
H1|chr1:59806608-59806658,chr1,59806608,59806658,H1|chr1:27321873-27321947,chr1,27321873,27321947,0,32484735
H1|chr1:60082781-60082931,chr1,60082781,60082931,H1|chr1:53190169-53190215,chr1,53190169,53190215,0,6892612
H1|chr1:60129686-60129727,chr1,60129686,60129727,H1|chr1:182809558-182809664,chr1,182809558,182809664,0,122679872
H1|chr1:60587954-60588003,chr1,60587954,60588003,H1|chr1:114701058-114701104,chr1,114701058,114701104,0,54113104
H1|chr1:60721070-60721131,chr1,60721070,60721131,H1|chr1:62664049-62664134,chr1,62664049,62664134,0,1942979
H1|chr1:60914797-60914858,chr1,60914797,60914858,H1|chr1:224542771-224542847,chr1,224542771,224542847,0,163627974
H1|chr1:61083016-61083154,chr1,61083016,61083154,H1|chr1:153939559-153939709,chr1,153939559,153939709,0,92856543
H1|chr1:61349171-61349289,chr1,61349171,61349289,H1|chr1:2046144-2046239,chr1,2046144,2046239,0,59303027
H1|chr1:61504786-61504884,chr1,61504786,61504884,H1|chr1:244998093-244998124,chr1,244998093,244998124,0,183493307
H1|chr1:62233441-62233524,chr1,62233441,62233524,H1|chr1:39457411-39457456,chr1,39457411,39457456,0,22776030
H1|chr1:62272100-62272191,chr1,62272100,62272191,H1|chr1:25559252-25559290,chr1,25559252,25559290,0,36712848
H1|chr1:62387274-62387331,chr1,62387274,62387331,H1|chr1:11111038-11111118,chr1,11111038,11111118,0,51276236
H1|chr1:62760500-62760596,chr1,62760500,62760596,H1|chr1:213033330-213033480,chr1,213033330,213033480,0,150272830
H1|chr1:62820195-62820245,chr1,62820195,62820245,H1|chr1:27321873-27321947,chr1,27321873,27321947,0,35498322
H1|chr1:62858182-62858322,chr1,62858182,62858322,H1|chr1:244998093-244998124,chr1,244998093,244998124,0,182139911
H1|chr1:62965484-62965524,chr1,62965484,62965524,H1|chr1:43150232-43150342,chr1,43150232,43150342,0,19815252
H1|chr1:63007582-63007641,chr1,63007582,63007641,H1|chr1:229550203-229550294,chr1,229550203,229550294,0,166542621
H1|chr1:63222841-63222903,chr1,63222841,63222903,H1|chr1:62664559-62664647,chr1,62664559,62664647,0,558282
H1|chr1:63799137-63799240,chr1,63799137,63799240,H1|chr1:149671942-149671989,chr1,149671942,149671989,0,85872805
H1|chr1:63859906-63859969,chr1,63859906,63859969,H1|chr1:213034078-213034165,chr1,213034078,213034165,0,149174172
H1|chr1:63916491-63916596,chr1,63916491,63916596,H1|chr1:229549899-229549944,chr1,229549899,229549944,0,165633408
H1|chr1:64017232-64017315,chr1,64017232,64017315,H1|chr1:213036101-213036133,chr1,213036101,213036133,0,149018869
H1|chr1:64133677-64133734,chr1,64133677,64133734,H1|chr1:155540703-155540792,chr1,155540703,155540792,0,91407026
H1|chr1:64376169-64376202,chr1,64376169,64376202,H1|chr1:33115836-33115916,chr1,33115836,33115916,0,31260333
H1|chr1:64686391-64686452,chr1,64686391,64686452,H1|chr1:149671927-149671991,chr1,149671927,149671991,0,84985536
H1|chr1:64867280-64867412,chr1,64867280,64867412,H1|chr1:33171348-33171364,chr1,33171348,33171364,0,31695932
H1|chr1:65201639-65201735,chr1,65201639,65201735,H1|chr1:62663363-62663513,chr1,62663363,62663513,0,2538276
H1|chr1:65241398-65241477,chr1,65241398,65241477,H1|chr1:150603910-150603950,chr1,150603910,150603950,0,85362512
H1|chr1:65413456-65413483,chr1,65413456,65413483,H1|chr1:44882217-44882287,chr1,44882217,44882287,0,20531239
H1|chr1:65803826-65803903,chr1,65803826,65803903,H1|chr1:213034879-213034924,chr1,213034879,213034924,0,147231053
H1|chr1:65915436-65915504,chr1,65915436,65915504,H1|chr1:40205074-40205133,chr1,40205074,40205133,0,25710362
H1|chr1:66119339-66119428,chr1,66119339,66119428,H1|chr1:149671927-149671988,chr1,149671927,149671988,0,83552588
H1|chr1:66163832-66163880,chr1,66163832,66163880,H1|chr1:200381594-200381631,chr1,200381594,200381631,0,134217762
H1|chr1:66209512-66209558,chr1,66209512,66209558,H1|chr1:200381911-200382015,chr1,200381911,200382015,0,134172399
H1|chr1:66361109-66361214,chr1,66361109,66361214,H1|chr1:6507203-6507238,chr1,6507203,6507238,0,59853906
H1|chr1:66430629-66430669,chr1,66430629,66430669,H1|chr1:229550283-229550339,chr1,229550283,229550339,0,163119654
H1|chr1:66649333-66649401,chr1,66649333,66649401,H1|chr1:245025639-245025692,chr1,245025639,245025692,0,178376306
H1|chr1:66809547-66809611,chr1,66809547,66809611,H1|chr1:43421862-43421996,chr1,43421862,43421996,0,23387685
H1|chr1:67062831-67062971,chr1,67062831,67062971,H1|chr1:62664471-62664591,chr1,62664471,62664591,0,4398360
H1|chr1:67589561-67589663,chr1,67589561,67589663,H1|chr1:44116656-44116677,chr1,44116656,44116677,0,23472905
H1|chr1:67624299-67624324,chr1,67624299,67624324,H1|chr1:44882217-44882287,chr1,44882217,44882287,0,22742082
H1|chr1:67752079-67752191,chr1,67752079,67752191,H1|chr1:62663255-62663293,chr1,62663255,62663293,0,5088824
H1|chr1:67932721-67932846,chr1,67932721,67932846,H1|chr1:150604751-150604771,chr1,150604751,150604771,0,82672030
H1|chr1:68240283-68240432,chr1,68240283,68240432,H1|chr1:43427836-43427911,chr1,43427836,43427911,0,24812447
H1|chr1:68326891-68327008,chr1,68326891,68327008,H1|chr1:229551316-229551349,chr1,229551316,229551349,0,161224425
H1|chr1:68472722-68472837,chr1,68472722,68472837,H1|chr1:27321347-27321388,chr1,27321347,27321388,0,41151375
H1|chr1:68899633-68899677,chr1,68899633,68899677,H1|chr1:110950825-110950874,chr1,110950825,110950874,0,42051192
H1|chr1:68983412-68983516,chr1,68983412,68983516,H1|chr1:939881-939924,chr1,939881,939924,0,68043531
H1|chr1:69280907-69280957,chr1,69280907,69280957,H1|chr1:229548886-229548937,chr1,229548886,229548937,0,160267979
H1|chr1:69473664-69473749,chr1,69473664,69473749,H1|chr1:156700779-156700844,chr1,156700779,156700844,0,87227115
H1|chr1:69692458-69692500,chr1,69692458,69692500,H1|chr1:39488838-39488959,chr1,39488838,39488959,0,30203620
H1|chr1:69838124-69838179,chr1,69838124,69838179,H1|chr1:1287496-1287591,chr1,1287496,1287591,0,68550628
H1|chr1:69984959-69985075,chr1,69984959,69985075,H1|chr1:27669232-27669345,chr1,27669232,27669345,0,42315727
H1|chr1:70016795-70016861,chr1,70016795,70016861,H1|chr1:64240704-64240747,chr1,64240704,64240747,0,5776091
H1|chr1:70101475-70101501,chr1,70101475,70101501,H1|chr1:93912336-93912415,chr1,93912336,93912415,0,23810861
H1|chr1:70351815-70351911,chr1,70351815,70351911,H1|chr1:62663363-62663513,chr1,62663363,62663513,0,7688452
H1|chr1:70656035-70656096,chr1,70656035,70656096,H1|chr1:229549472-229549529,chr1,229549472,229549529,0,158893437
H1|chr1:71129950-71130035,chr1,71129950,71130035,H1|chr1:26757405-26757470,chr1,26757405,26757470,0,44372545
H1|chr1:71383732-71383882,chr1,71383732,71383882,H1|chr1:149671927-149671988,chr1,149671927,149671988,0,78288195
H1|chr1:71550168-71550213,chr1,71550168,71550213,H1|chr1:205534520-205534567,chr1,205534520,205534567,0,133984352
H1|chr1:71939724-71939812,chr1,71939724,71939812,H1|chr1:173444379-173444431,chr1,173444379,173444431,0,101504655
H1|chr1:72105102-72105137,chr1,72105102,72105137,H1|chr1:229551298-229551369,chr1,229551298,229551369,0,157446196
H1|chr1:72485077-72485227,chr1,72485077,72485227,H1|chr1:27050545-27050570,chr1,27050545,27050570,0,45434532
H1|chr1:72661562-72661672,chr1,72661562,72661672,H1|chr1:173445002-173445038,chr1,173445002,173445038,0,100783440
H1|chr1:72734540-72734623,chr1,72734540,72734623,H1|chr1:149671928-149671995,chr1,149671928,149671995,0,76937388
H1|chr1:72948752-72948902,chr1,72948752,72948902,H1|chr1:148763414-148763563,chr1,148763414,148763563,0,75814662
H1|chr1:72985089-72985148,chr1,72985089,72985148,H1|chr1:9349991-9350074,chr1,9349991,9350074,0,63635098
H1|chr1:73140521-73140544,chr1,73140521,73140544,H1|chr1:39572206-39572301,chr1,39572206,39572301,0,33568315
H1|chr1:73403847-73403885,chr1,73403847,73403885,H1|chr1:40994875-40994935,chr1,40994875,40994935,0,32408972
H1|chr1:73473255-73473365,chr1,73473255,73473365,H1|chr1:109757476-109757516,chr1,109757476,109757516,0,36284221
H1|chr1:73804656-73804729,chr1,73804656,73804729,H1|chr1:224545167-224545195,chr1,224545167,224545195,0,150740511
H1|chr1:74513156-74513192,chr1,74513156,74513192,H1|chr1:148558086-148558235,chr1,148558086,148558235,0,74044930
H1|chr1:74793998-74794050,chr1,74793998,74794050,H1|chr1:939691-939766,chr1,939691,939766,0,73854307
H1|chr1:74968978-74969104,chr1,74968978,74969104,H1|chr1:38231511-38231530,chr1,38231511,38231530,0,36737467
H1|chr1:75030351-75030368,chr1,75030351,75030368,H1|chr1:151434320-151434433,chr1,151434320,151434433,0,76403969
H1|chr1:75531640-75531707,chr1,75531640,75531707,H1|chr1:62662729-62662808,chr1,62662729,62662808,0,12868911
H1|chr1:75655811-75655886,chr1,75655811,75655886,H1|chr1:62661276-62661351,chr1,62661276,62661351,0,12994535
H1|chr1:75817866-75817911,chr1,75817866,75817911,H1|chr1:229549678-229549744,chr1,229549678,229549744,0,153731812
H1|chr1:75858778-75858830,chr1,75858778,75858830,H1|chr1:178064476-178064626,chr1,178064476,178064626,0,102205698
H1|chr1:76717359-76717382,chr1,76717359,76717382,H1|chr1:38478788-38478876,chr1,38478788,38478876,0,38238571
H1|chr1:76818894-76818980,chr1,76818894,76818980,H1|chr1:155170803-155170867,chr1,155170803,155170867,0,78351909
H1|chr1:76831556-76831649,chr1,76831556,76831649,H1|chr1:173445244-173445306,chr1,173445244,173445306,0,96613688
H1|chr1:76921343-76921381,chr1,76921343,76921381,H1|chr1:120255826-120255892,chr1,120255826,120255892,0,43334483
H1|chr1:77205917-77205944,chr1,77205917,77205944,H1|chr1:156673740-156673815,chr1,156673740,156673815,0,79467823
H1|chr1:77284795-77284829,chr1,77284795,77284829,H1|chr1:939705-939821,chr1,939705,939821,0,76345090
H1|chr1:77505177-77505221,chr1,77505177,77505221,H1|chr1:120254826-120254900,chr1,120254826,120254900,0,42749649
H1|chr1:77542027-77542137,chr1,77542027,77542137,H1|chr1:41830744-41830777,chr1,41830744,41830777,0,35711283
H1|chr1:77554857-77555004,chr1,77554857,77555004,H1|chr1:62663255-62663293,chr1,62663255,62663293,0,14891602
H1|chr1:77779077-77779165,chr1,77779077,77779165,H1|chr1:93915010-93915160,chr1,93915010,93915160,0,16135933
H1|chr1:78004064-78004144,chr1,78004064,78004144,H1|chr1:149671932-149672002,chr1,149671932,149672002,0,71667868
H1|chr1:78213683-78213805,chr1,78213683,78213805,H1|chr1:156644244-156644308,chr1,156644244,156644308,0,78430561
H1|chr1:78261832-78261964,chr1,78261832,78261964,H1|chr1:76254250-76254289,chr1,76254250,76254289,0,2007582
H1|chr1:78263819-78263931,chr1,78263819,78263931,H1|chr1:149671939-149671991,chr1,149671939,149671991,0,71408120
H1|chr1:78350393-78350460,chr1,78350393,78350460,H1|chr1:62664049-62664134,chr1,62664049,62664134,0,15686344
H1|chr1:78428777-78428803,chr1,78428777,78428803,H1|chr1:1287733-1287833,chr1,1287733,1287833,0,77141044
H1|chr1:78555506-78555559,chr1,78555506,78555559,H1|chr1:173448532-173448574,chr1,173448532,173448574,0,94893026
H1|chr1:79228002-79228151,chr1,79228002,79228151,H1|chr1:229549458-229549492,chr1,229549458,229549492,0,150321456
H1|chr1:79337709-79337781,chr1,79337709,79337781,H1|chr1:16537491-16537553,chr1,16537491,16537553,0,62800218
H1|chr1:79692915-79692997,chr1,79692915,79692997,H1|chr1:113496707-113496775,chr1,113496707,113496775,0,33803792
H1|chr1:79942818-79942968,chr1,79942818,79942968,H1|chr1:148763414-148763563,chr1,148763414,148763563,0,68820596
H1|chr1:79970287-79970312,chr1,79970287,79970312,H1|chr1:6547221-6547266,chr1,6547221,6547266,0,73423066
H1|chr1:80138712-80138789,chr1,80138712,80138789,H1|chr1:47800592-47800649,chr1,47800592,47800649,0,32338120
H1|chr1:80289297-80289443,chr1,80289297,80289443,H1|chr1:213034078-213034165,chr1,213034078,213034165,0,132744781
H1|chr1:80333605-80333660,chr1,80333605,80333660,H1|chr1:1287496-1287591,chr1,1287496,1287591,0,79046109
H1|chr1:80930072-80930135,chr1,80930072,80930135,H1|chr1:213034078-213034165,chr1,213034078,213034165,0,132104006
H1|chr1:81561670-81561715,chr1,81561670,81561715,H1|chr1:86046742-86046792,chr1,86046742,86046792,0,4485072
H1|chr1:81781764-81781834,chr1,81781764,81781834,H1|chr1:149671946-149671972,chr1,149671946,149671972,0,67890182
H1|chr1:81958712-81958730,chr1,81958712,81958730,H1|chr1:173443005-173443114,chr1,173443005,173443114,0,91484293
H1|chr1:82510005-82510040,chr1,82510005,82510040,H1|chr1:11725213-11725268,chr1,11725213,11725268,0,70784792
H1|chr1:82892668-82892725,chr1,82892668,82892725,H1|chr1:173444475-173444536,chr1,173444475,173444536,0,90551807
H1|chr1:83067176-83067211,chr1,83067176,83067211,H1|chr1:40205399-40205531,chr1,40205399,40205531,0,42861777
H1|chr1:83072413-83072455,chr1,83072413,83072455,H1|chr1:19579058-19579166,chr1,19579058,19579166,0,63493355
H1|chr1:83294617-83294680,chr1,83294617,83294680,H1|chr1:16378499-16378601,chr1,16378499,16378601,0,66916118
H1|chr1:83489076-83489094,chr1,83489076,83489094,H1|chr1:161736497-161736591,chr1,161736497,161736591,0,78247421
H1|chr1:83698164-83698261,chr1,83698164,83698261,H1|chr1:229407755-229407792,chr1,229407755,229407792,0,145709591
H1|chr1:83761465-83761512,chr1,83761465,83761512,H1|chr1:27672171-27672199,chr1,27672171,27672199,0,56089294
H1|chr1:83886929-83887009,chr1,83886929,83887009,H1|chr1:62664035-62664099,chr1,62664035,62664099,0,21222894
H1|chr1:84057761-84057893,chr1,84057761,84057893,H1|chr1:76254250-76254289,chr1,76254250,76254289,0,7803511
H1|chr1:84386364-84386428,chr1,84386364,84386428,H1|chr1:900250-900300,chr1,900250,900300,0,83486114
H1|chr1:84471101-84471161,chr1,84471101,84471161,H1|chr1:150531630-150531718,chr1,150531630,150531718,0,66060529
H1|chr1:84505160-84505189,chr1,84505160,84505189,H1|chr1:16378499-16378601,chr1,16378499,16378601,0,68126661
H1|chr1:84630698-84630786,chr1,84630698,84630786,H1|chr1:222883343-222883466,chr1,222883343,222883466,0,138252645
H1|chr1:84880709-84880738,chr1,84880709,84880738,H1|chr1:1289123-1289244,chr1,1289123,1289244,0,83591586
H1|chr1:84881381-84881469,chr1,84881381,84881469,H1|chr1:211750354-211750382,chr1,211750354,211750382,0,126868973
H1|chr1:84953473-84953622,chr1,84953473,84953622,H1|chr1:229549458-229549492,chr1,229549458,229549492,0,144595985
H1|chr1:84988362-84988410,chr1,84988362,84988410,H1|chr1:200381594-200381631,chr1,200381594,200381631,0,115393232
H1|chr1:85008533-85008606,chr1,85008533,85008606,H1|chr1:39458209-39458286,chr1,39458209,39458286,0,45550324
H1|chr1:85046942-85047019,chr1,85046942,85047019,H1|chr1:40205074-40205133,chr1,40205074,40205133,0,44841868
H1|chr1:85125321-85125422,chr1,85125321,85125422,H1|chr1:939881-939924,chr1,939881,939924,0,84185440
H1|chr1:85203105-85203173,chr1,85203105,85203173,H1|chr1:213030715-213030816,chr1,213030715,213030816,0,127827610
H1|chr1:85311194-85311244,chr1,85311194,85311244,H1|chr1:178064476-178064626,chr1,178064476,178064626,0,92753282
H1|chr1:85348414-85348512,chr1,85348414,85348512,H1|chr1:229550204-229550252,chr1,229550204,229550252,0,144201790
H1|chr1:85411764-85411808,chr1,85411764,85411808,H1|chr1:173441829-173441973,chr1,173441829,173441973,0,88030065
H1|chr1:85658653-85658684,chr1,85658653,85658684,H1|chr1:150536182-150536200,chr1,150536182,150536200,0,64877529
H1|chr1:86121090-86121126,chr1,86121090,86121126,H1|chr1:233433698-233433809,chr1,233433698,233433809,0,147312608
H1|chr1:86304499-86304648,chr1,86304499,86304648,H1|chr1:43427836-43427911,chr1,43427836,43427911,0,42876663
H1|chr1:86401042-86401124,chr1,86401042,86401124,H1|chr1:27674714-27674801,chr1,27674714,27674801,0,58726328
H1|chr1:86438416-86438458,chr1,86438416,86438458,H1|chr1:229551323-229551408,chr1,229551323,229551408,0,143112907
H1|chr1:86440640-86440723,chr1,86440640,86440723,H1|chr1:173444991-173445040,chr1,173444991,173445040,0,87004351
H1|chr1:86616205-86616261,chr1,86616205,86616261,H1|chr1:173445839-173445879,chr1,173445839,173445879,0,86829634
H1|chr1:86960423-86960468,chr1,86960423,86960468,H1|chr1:16538130-16538221,chr1,16538130,16538221,0,70422293
H1|chr1:87254331-87254370,chr1,87254331,87254370,H1|chr1:62664357-62664401,chr1,62664357,62664401,0,24589974
H1|chr1:87324351-87324442,chr1,87324351,87324442,H1|chr1:200380942-200381001,chr1,200380942,200381001,0,113056591
H1|chr1:87365518-87365624,chr1,87365518,87365624,H1|chr1:76254163-76254212,chr1,76254163,76254212,0,11111355
H1|chr1:87451880-87451935,chr1,87451880,87451935,H1|chr1:150530600-150530664,chr1,150530600,150530664,0,63078720
H1|chr1:87573474-87573500,chr1,87573474,87573500,H1|chr1:156673540-156673664,chr1,156673540,156673664,0,69100066
H1|chr1:87847934-87848017,chr1,87847934,87848017,H1|chr1:213036101-213036133,chr1,213036101,213036133,0,125188167
H1|chr1:87850139-87850209,chr1,87850139,87850209,H1|chr1:17247303-17247453,chr1,17247303,17247453,0,70602836
H1|chr1:88113657-88113738,chr1,88113657,88113738,H1|chr1:51703507-51703545,chr1,51703507,51703545,0,36410150
H1|chr1:88192209-88192270,chr1,88192209,88192270,H1|chr1:247498241-247498391,chr1,247498241,247498391,0,159306032
H1|chr1:88243292-88243337,chr1,88243292,88243337,H1|chr1:86046742-86046792,chr1,86046742,86046792,0,2196550
H1|chr1:88538766-88538799,chr1,88538766,88538799,H1|chr1:33115836-33115916,chr1,33115836,33115916,0,55422930
H1|chr1:88778314-88778375,chr1,88778314,88778375,H1|chr1:224545401-224545421,chr1,224545401,224545421,0,135767087
H1|chr1:88918515-88918553,chr1,88918515,88918553,H1|chr1:229550025-229550124,chr1,229550025,229550124,0,140631510
H1|chr1:88946309-88946378,chr1,88946309,88946378,H1|chr1:27667660-27667780,chr1,27667660,27667780,0,61278649
H1|chr1:89094079-89094099,chr1,89094079,89094099,H1|chr1:62663454-62663572,chr1,62663454,62663572,0,26430625
H1|chr1:89188667-89188754,chr1,89188667,89188754,H1|chr1:16134831-16134861,chr1,16134831,16134861,0,73053836
H1|chr1:89824016-89824088,chr1,89824016,89824088,H1|chr1:45312261-45312280,chr1,45312261,45312280,0,44511755
H1|chr1:90104683-90104744,chr1,90104683,90104744,H1|chr1:229549472-229549529,chr1,229549472,229549529,0,139444789
H1|chr1:90223265-90223355,chr1,90223265,90223355,H1|chr1:39457411-39457456,chr1,39457411,39457456,0,50765854
H1|chr1:90320076-90320101,chr1,90320076,90320101,H1|chr1:93912336-93912415,chr1,93912336,93912415,0,3592260
H1|chr1:90510127-90510228,chr1,90510127,90510228,H1|chr1:213036018-213036067,chr1,213036018,213036067,0,122525891
H1|chr1:90596994-90597081,chr1,90596994,90597081,H1|chr1:82265657-82265709,chr1,82265657,82265709,0,8331337
H1|chr1:90601894-90601925,chr1,90601894,90601925,H1|chr1:10004154-10004283,chr1,10004154,10004283,0,80597740
H1|chr1:90839067-90839085,chr1,90839067,90839085,H1|chr1:173640372-173640447,chr1,173640372,173640447,0,82801305
H1|chr1:90929551-90929690,chr1,90929551,90929690,H1|chr1:27321952-27321971,chr1,27321952,27321971,0,63607599
H1|chr1:91001199-91001332,chr1,91001199,91001332,H1|chr1:148556781-148556834,chr1,148556781,148556834,0,57555582
H1|chr1:91169060-91169118,chr1,91169060,91169118,H1|chr1:32862687-32862833,chr1,32862687,32862833,0,58306373
H1|chr1:91407263-91407358,chr1,91407263,91407358,H1|chr1:36920007-36920076,chr1,36920007,36920076,0,54487256
H1|chr1:91837692-91837765,chr1,91837692,91837765,H1|chr1:17867605-17867648,chr1,17867605,17867648,0,73970087
H1|chr1:91925158-91925197,chr1,91925158,91925197,H1|chr1:27321972-27322025,chr1,27321972,27322025,0,64603186
H1|chr1:92304811-92304862,chr1,92304811,92304862,H1|chr1:939876-939981,chr1,939876,939981,0,91364935
H1|chr1:92399505-92399567,chr1,92399505,92399567,H1|chr1:173640372-173640488,chr1,173640372,173640488,0,81240867
H1|chr1:92410322-92410380,chr1,92410322,92410380,H1|chr1:27321994-27322046,chr1,27321994,27322046,0,65088328
H1|chr1:92442385-92442470,chr1,92442385,92442470,H1|chr1:149671950-149672006,chr1,149671950,149672006,0,57229565
H1|chr1:92571448-92571494,chr1,92571448,92571494,H1|chr1:110950825-110950874,chr1,110950825,110950874,0,18379377
H1|chr1:92650348-92650472,chr1,92650348,92650472,H1|chr1:17243472-17243492,chr1,17243472,17243492,0,75406876
H1|chr1:92774215-92774305,chr1,92774215,92774305,H1|chr1:39457411-39457456,chr1,39457411,39457456,0,53316804
H1|chr1:93080890-93081005,chr1,93080890,93081005,H1|chr1:149671938-149671972,chr1,149671938,149671972,0,56591048
H1|chr1:93131006-93131072,chr1,93131006,93131072,H1|chr1:173445930-173446008,chr1,173445930,173446008,0,80314924
H1|chr1:93298374-93298401,chr1,93298374,93298401,H1|chr1:62663157-62663254,chr1,62663157,62663254,0,30635217
H1|chr1:93587112-93587196,chr1,93587112,93587196,H1|chr1:156859718-156859743,chr1,156859718,156859743,0,63272606
H1|chr1:93770623-93770716,chr1,93770623,93770716,H1|chr1:173639292-173639333,chr1,173639292,173639333,0,79868669
H1|chr1:93945739-93945766,chr1,93945739,93945766,H1|chr1:43425628-43425721,chr1,43425628,43425721,0,50520111
H1|chr1:94044015-94044073,chr1,94044015,94044073,H1|chr1:11111038-11111118,chr1,11111038,11111118,0,82932977
H1|chr1:94260147-94260187,chr1,94260147,94260187,H1|chr1:156675592-156675702,chr1,156675592,156675702,0,62415445
H1|chr1:94290958-94291046,chr1,94290958,94291046,H1|chr1:150536007-150536157,chr1,150536007,150536157,0,56245049
H1|chr1:94609181-94609239,chr1,94609181,94609239,H1|chr1:17247295-17247445,chr1,17247295,17247445,0,77361886
H1|chr1:95208636-95208693,chr1,95208636,95208693,H1|chr1:173444475-173444536,chr1,173444475,173444536,0,78235839
H1|chr1:95240482-95240552,chr1,95240482,95240552,H1|chr1:43427836-43427911,chr1,43427836,43427911,0,51812646
H1|chr1:95258036-95258146,chr1,95258036,95258146,H1|chr1:26757495-26757581,chr1,26757495,26757581,0,68500541
H1|chr1:95370467-95370538,chr1,95370467,95370538,H1|chr1:17867605-17867648,chr1,17867605,17867648,0,77502862
H1|chr1:96046664-96046755,chr1,96046664,96046755,H1|chr1:245025666-245025725,chr1,245025666,245025725,0,148979002
H1|chr1:96151447-96151484,chr1,96151447,96151484,H1|chr1:224302933-224302995,chr1,224302933,224302995,0,128151486
H1|chr1:96275047-96275162,chr1,96275047,96275162,H1|chr1:173836043-173836074,chr1,173836043,173836074,0,77560996
H1|chr1:96541862-96541926,chr1,96541862,96541926,H1|chr1:62662729-62662808,chr1,62662729,62662808,0,33879133
H1|chr1:96787817-96787856,chr1,96787817,96787856,H1|chr1:62664357-62664401,chr1,62664357,62664401,0,34123460
H1|chr1:96867225-96867340,chr1,96867225,96867340,H1|chr1:28970813-28970833,chr1,28970813,28970833,0,67896412
H1|chr1:97304758-97304814,chr1,97304758,97304814,H1|chr1:9649394-9649488,chr1,9649394,9649488,0,87655364
H1|chr1:97437220-97437267,chr1,97437220,97437267,H1|chr1:120254826-120254901,chr1,120254826,120254901,0,22817606
H1|chr1:97752871-97752972,chr1,97752871,97752972,H1|chr1:44116656-44116677,chr1,44116656,44116677,0,53636215
H1|chr1:97764801-97764827,chr1,97764801,97764827,H1|chr1:78442373-78442520,chr1,78442373,78442520,0,19322428
H1|chr1:98538967-98539067,chr1,98538967,98539067,H1|chr1:173639303-173639337,chr1,173639303,173639337,0,75100336
H1|chr1:98641118-98641227,chr1,98641118,98641227,H1|chr1:62664118-62664180,chr1,62664118,62664180,0,35977000
H1|chr1:98720869-98720935,chr1,98720869,98720935,H1|chr1:204047094-204047178,chr1,204047094,204047178,0,105326225
H1|chr1:98736023-98736075,chr1,98736023,98736075,H1|chr1:120254826-120254901,chr1,120254826,120254901,0,21518803
H1|chr1:98870374-98870464,chr1,98870374,98870464,H1|chr1:62664516-62664573,chr1,62664516,62664573,0,36205858
H1|chr1:98966243-98966325,chr1,98966243,98966325,H1|chr1:173445765-173445833,chr1,173445765,173445833,0,74479522
H1|chr1:99008828-99008902,chr1,99008828,99008902,H1|chr1:229548663-229548696,chr1,229548663,229548696,0,130539835
H1|chr1:99079273-99079380,chr1,99079273,99079380,H1|chr1:173445789-173445825,chr1,173445789,173445825,0,74366516
H1|chr1:99343116-99343162,chr1,99343116,99343162,H1|chr1:156675592-156675702,chr1,156675592,156675702,0,57332476
H1|chr1:99674406-99674542,chr1,99674406,99674542,H1|chr1:1188543-1188666,chr1,1188543,1188666,0,98485863
H1|chr1:99689064-99689087,chr1,99689064,99689087,H1|chr1:203765096-203765148,chr1,203765096,203765148,0,104076032
H1|chr1:100711713-100711739,chr1,100711713,100711739,H1|chr1:27322036-27322105,chr1,27322036,27322105,0,73389677
H1|chr1:100742434-100742488,chr1,100742434,100742488,H1|chr1:32402358-32402437,chr1,32402358,32402437,0,68340076
H1|chr1:100746268-100746345,chr1,100746268,100746345,H1|chr1:47800592-47800649,chr1,47800592,47800649,0,52945676
H1|chr1:100809847-100809907,chr1,100809847,100809907,H1|chr1:229550204-229550294,chr1,229550204,229550294,0,128740357
H1|chr1:101183648-101183723,chr1,101183648,101183723,H1|chr1:26758317-26758364,chr1,26758317,26758364,0,74425331
H1|chr1:101420746-101420822,chr1,101420746,101420822,H1|chr1:39326250-39326323,chr1,39326250,39326323,0,62094496
H1|chr1:101571504-101571584,chr1,101571504,101571584,H1|chr1:225998464-225998535,chr1,225998464,225998535,0,124426960
H1|chr1:101607221-101607362,chr1,101607221,101607362,H1|chr1:62665219-62665287,chr1,62665219,62665287,0,38942002
H1|chr1:101840159-101840248,chr1,101840159,101840248,H1|chr1:149671927-149671988,chr1,149671927,149671988,0,47831768
H1|chr1:101907691-101907771,chr1,101907691,101907771,H1|chr1:44818973-44819006,chr1,44818973,44819006,0,57088718
H1|chr1:102108587-102108620,chr1,102108587,102108620,H1|chr1:11725212-11725268,chr1,11725212,11725268,0,90383375
H1|chr1:102652262-102652380,chr1,102652262,102652380,H1|chr1:229549899-229549944,chr1,229549899,229549944,0,126897637
H1|chr1:102861900-102862047,chr1,102861900,102862047,H1|chr1:62663255-62663293,chr1,62663255,62663293,0,40198645
H1|chr1:103012349-103012492,chr1,103012349,103012492,H1|chr1:229551337-229551388,chr1,229551337,229551388,0,126538988
H1|chr1:103143114-103143132,chr1,103143114,103143132,H1|chr1:155538443-155538575,chr1,155538443,155538575,0,52395329
H1|chr1:103476495-103476582,chr1,103476495,103476582,H1|chr1:247499480-247499581,chr1,247499480,247499581,0,144022985
H1|chr1:103734588-103734672,chr1,103734588,103734672,H1|chr1:156859718-156859743,chr1,156859718,156859743,0,53125130
H1|chr1:104058662-104058787,chr1,104058662,104058787,H1|chr1:229550204-229550258,chr1,229550204,229550258,0,125491542
H1|chr1:104123026-104123122,chr1,104123026,104123122,H1|chr1:156859718-156859736,chr1,156859718,156859736,0,52736692
H1|chr1:104794377-104794467,chr1,104794377,104794467,H1|chr1:225962659-225962717,chr1,225962659,225962717,0,121168282
H1|chr1:104813508-104813615,chr1,104813508,104813615,H1|chr1:27321276-27321306,chr1,27321276,27321306,0,77492232
H1|chr1:104872532-104872547,chr1,104872532,104872547,H1|chr1:17244796-17244834,chr1,17244796,17244834,0,87627736
H1|chr1:104889122-104889208,chr1,104889122,104889208,H1|chr1:154244254-154244299,chr1,154244254,154244299,0,49355132
H1|chr1:105049771-105049820,chr1,105049771,105049820,H1|chr1:939691-939766,chr1,939691,939766,0,104110080
H1|chr1:105509096-105509164,chr1,105509096,105509164,H1|chr1:150603874-150603945,chr1,150603874,150603945,0,45094778
H1|chr1:105629663-105629723,chr1,105629663,105629723,H1|chr1:27321994-27322046,chr1,27321994,27322046,0,78307669
H1|chr1:105853130-105853246,chr1,105853130,105853246,H1|chr1:173442583-173442651,chr1,173442583,173442651,0,67589453
H1|chr1:106132221-106132274,chr1,106132221,106132274,H1|chr1:26757460-26757557,chr1,26757460,26757557,0,79374761
H1|chr1:106237590-106237640,chr1,106237590,106237640,H1|chr1:222887078-222887113,chr1,222887078,222887113,0,116649488
H1|chr1:106375532-106375564,chr1,106375532,106375564,H1|chr1:244998093-244998140,chr1,244998093,244998140,0,138622561
H1|chr1:106502997-106503088,chr1,106502997,106503088,H1|chr1:27665925-27665950,chr1,27665925,27665950,0,78837072
H1|chr1:106633327-106633477,chr1,106633327,106633477,H1|chr1:85358425-85358493,chr1,85358425,85358493,0,21274902
H1|chr1:106650138-106650245,chr1,106650138,106650245,H1|chr1:2510066-2510216,chr1,2510066,2510216,0,104140072
H1|chr1:106660031-106660100,chr1,106660031,106660100,H1|chr1:17247237-17247302,chr1,17247237,17247302,0,89412794
H1|chr1:106937555-106937670,chr1,106937555,106937670,H1|chr1:149671938-149671972,chr1,149671938,149671972,0,42734383
H1|chr1:107019561-107019606,chr1,107019561,107019606,H1|chr1:17247219-17247240,chr1,17247219,17247240,0,89772342
H1|chr1:107064383-107064445,chr1,107064383,107064445,H1|chr1:149672017-149672081,chr1,149672017,149672081,0,42607634
H1|chr1:107141917-107141953,chr1,107141917,107141953,H1|chr1:173445770-173445787,chr1,173445770,173445787,0,66303853
H1|chr1:107295073-107295122,chr1,107295073,107295122,H1|chr1:213030715-213030816,chr1,213030715,213030816,0,105735642
H1|chr1:107516475-107516556,chr1,107516475,107516556,H1|chr1:149671932-149672001,chr1,149671932,149672001,0,42155457
H1|chr1:107542700-107542788,chr1,107542700,107542788,H1|chr1:173445244-173445306,chr1,173445244,173445306,0,65902544
H1|chr1:107622437-107622483,chr1,107622437,107622483,H1|chr1:19579058-19579166,chr1,19579058,19579166,0,88043379
H1|chr1:107678843-107678881,chr1,107678843,107678881,H1|chr1:40994875-40994935,chr1,40994875,40994935,0,66683968
H1|chr1:107735526-107735589,chr1,107735526,107735589,H1|chr1:229551323-229551408,chr1,229551323,229551408,0,121815797
H1|chr1:107740721-107740871,chr1,107740721,107740871,H1|chr1:62661636-62661714,chr1,62661636,62661714,0,45079085
H1|chr1:107768000-107768063,chr1,107768000,107768063,H1|chr1:44819210-44819275,chr1,44819210,44819275,0,62948790
H1|chr1:107782927-107783028,chr1,107782927,107783028,H1|chr1:939881-939924,chr1,939881,939924,0,106843046
H1|chr1:107788605-107788755,chr1,107788605,107788755,H1|chr1:148560467-148560617,chr1,148560467,148560617,0,40771862
H1|chr1:107915890-107915999,chr1,107915890,107915999,H1|chr1:27321347-27321388,chr1,27321347,27321388,0,80594543
H1|chr1:107970855-107970920,chr1,107970855,107970920,H1|chr1:173445930-173446008,chr1,173445930,173446008,0,65475075
H1|chr1:108044712-108044794,chr1,108044712,108044794,H1|chr1:57043510-57043603,chr1,57043510,57043603,0,51001202
H1|chr1:108121641-108121695,chr1,108121641,108121695,H1|chr1:213033749-213033834,chr1,213033749,213033834,0,104912108
H1|chr1:108303096-108303173,chr1,108303096,108303173,H1|chr1:84544433-84544506,chr1,84544433,84544506,0,23758663
H1|chr1:108482100-108482239,chr1,108482100,108482239,H1|chr1:27321952-27321971,chr1,27321952,27321971,0,81160148
H1|chr1:109052794-109052877,chr1,109052794,109052877,H1|chr1:2133434-2133467,chr1,2133434,2133467,0,106919360
H1|chr1:109270808-109270899,chr1,109270808,109270899,H1|chr1:245025666-245025725,chr1,245025666,245025725,0,135754858
H1|chr1:109502806-109502890,chr1,109502806,109502890,H1|chr1:224545401-224545421,chr1,224545401,224545421,0,115042595
H1|chr1:109520101-109520144,chr1,109520101,109520144,H1|chr1:120254854-120254901,chr1,120254854,120254901,0,10734753
H1|chr1:109759761-109759841,chr1,109759761,109759841,H1|chr1:8761281-8761330,chr1,8761281,8761330,0,100998480
H1|chr1:109813243-109813330,chr1,109813243,109813330,H1|chr1:213125257-213125305,chr1,213125257,213125305,0,103312014
H1|chr1:109967541-109967631,chr1,109967541,109967631,H1|chr1:225962659-225962717,chr1,225962659,225962717,0,115995118
H1|chr1:109982830-109982850,chr1,109982830,109982850,H1|chr1:213034264-213034394,chr1,213034264,213034394,0,103051434
H1|chr1:110041419-110041528,chr1,110041419,110041528,H1|chr1:27321347-27321388,chr1,27321347,27321388,0,82720072
H1|chr1:110043634-110043662,chr1,110043634,110043662,H1|chr1:212967439-212967534,chr1,212967439,212967534,0,102923805
H1|chr1:110339392-110339417,chr1,110339392,110339417,H1|chr1:93912336-93912415,chr1,93912336,93912415,0,16427056
H1|chr1:110430070-110430094,chr1,110430070,110430094,H1|chr1:150546667-150546725,chr1,150546667,150546725,0,40116597
H1|chr1:110502344-110502468,chr1,110502344,110502468,H1|chr1:17243472-17243492,chr1,17243472,17243492,0,93258872
H1|chr1:110580998-110581148,chr1,110580998,110581148,H1|chr1:36854280-36854430,chr1,36854280,36854430,0,73726718
H1|chr1:110603869-110603967,chr1,110603869,110603967,H1|chr1:6507186-6507238,chr1,6507186,6507238,0,104096683
H1|chr1:110658281-110658332,chr1,110658281,110658332,H1|chr1:939876-939981,chr1,939876,939981,0,109718405
H1|chr1:110833071-110833164,chr1,110833071,110833164,H1|chr1:27321562-27321616,chr1,27321562,27321616,0,83511509
H1|chr1:111021989-111022047,chr1,111021989,111022047,H1|chr1:17247295-17247445,chr1,17247295,17247445,0,93774694
H1|chr1:111339277-111339316,chr1,111339277,111339316,H1|chr1:153959862-153959949,chr1,153959862,153959949,0,42620585
H1|chr1:111459340-111459490,chr1,111459340,111459490,H1|chr1:17243718-17243865,chr1,17243718,17243865,0,94215622
H1|chr1:111477646-111477763,chr1,111477646,111477763,H1|chr1:27669232-27669345,chr1,27669232,27669345,0,83808414
H1|chr1:111485367-111485399,chr1,111485367,111485399,H1|chr1:26756462-26756558,chr1,26756462,26756558,0,84728905
H1|chr1:111497737-111497817,chr1,111497737,111497817,H1|chr1:225998464-225998535,chr1,225998464,225998535,0,114500727
H1|chr1:111683831-111683897,chr1,111683831,111683897,H1|chr1:62664591-62664710,chr1,62664591,62664710,0,49019240
H1|chr1:111871420-111871482,chr1,111871420,111871482,H1|chr1:229551361-229551405,chr1,229551361,229551405,0,117679941
H1|chr1:111906529-111906557,chr1,111906529,111906557,H1|chr1:171455045-171455153,chr1,171455045,171455153,0,59548516
H1|chr1:112098272-112098347,chr1,112098272,112098347,H1|chr1:213034132-213034207,chr1,213034132,213034207,0,100935860
H1|chr1:112126322-112126366,chr1,112126322,112126366,H1|chr1:244998093-244998164,chr1,244998093,244998164,0,132871771
H1|chr1:112339511-112339549,chr1,112339511,112339549,H1|chr1:247496652-247496744,chr1,247496652,247496744,0,135157141
H1|chr1:112341196-112341254,chr1,112341196,112341254,H1|chr1:11111038-11111118,chr1,11111038,11111118,0,101230158
H1|chr1:112450489-112450639,chr1,112450489,112450639,H1|chr1:33650432-33650497,chr1,33650432,33650497,0,78800057
H1|chr1:112600794-112600865,chr1,112600794,112600865,H1|chr1:229551334-229551371,chr1,229551334,229551371,0,116950540
H1|chr1:112683691-112683837,chr1,112683691,112683837,H1|chr1:213034078-213034165,chr1,213034078,213034165,0,100350387
H1|chr1:112923898-112923932,chr1,112923898,112923932,H1|chr1:173640372-173640488,chr1,173640372,173640488,0,60716474
H1|chr1:113006072-113006139,chr1,113006072,113006139,H1|chr1:150266945-150267002,chr1,150266945,150267002,0,37260873
H1|chr1:113033823-113033913,chr1,113033823,113033913,H1|chr1:27321354-27321403,chr1,27321354,27321403,0,85712469
H1|chr1:113248235-113248362,chr1,113248235,113248362,H1|chr1:156859718-156859736,chr1,156859718,156859736,0,43611483
H1|chr1:113357173-113357323,chr1,113357173,113357323,H1|chr1:17243634-17243784,chr1,17243634,17243784,0,96113539
H1|chr1:113384766-113384916,chr1,113384766,113384916,H1|chr1:148763364-148763514,chr1,148763364,148763514,0,35378598
H1|chr1:113480609-113480732,chr1,113480609,113480732,H1|chr1:26757495-26757581,chr1,26757495,26757581,0,86723114
H1|chr1:113690085-113690105,chr1,113690085,113690105,H1|chr1:213034116-213034224,chr1,213034116,213034224,0,99344031
H1|chr1:113813156-113813229,chr1,113813156,113813229,H1|chr1:154974144-154974194,chr1,154974144,154974194,0,41160988
H1|chr1:114308155-114308235,chr1,114308155,114308235,H1|chr1:229549460-229549517,chr1,229549460,229549517,0,115241305
H1|chr1:114554551-114554570,chr1,114554551,114554570,H1|chr1:113497846-113497932,chr1,113497846,113497932,0,1056705
H1|chr1:114988391-114988474,chr1,114988391,114988474,H1|chr1:214453069-214453180,chr1,214453069,214453180,0,99464678
H1|chr1:115292816-115292875,chr1,115292816,115292875,H1|chr1:149671927-149671989,chr1,149671927,149671989,0,34379111
H1|chr1:115643904-115643977,chr1,115643904,115643977,H1|chr1:41442828-41442978,chr1,41442828,41442978,0,74201076
H1|chr1:116117068-116117202,chr1,116117068,116117202,H1|chr1:109757476-109757516,chr1,109757476,109757516,0,6359592
H1|chr1:116485552-116485615,chr1,116485552,116485615,H1|chr1:44819210-44819275,chr1,44819210,44819275,0,71666342
H1|chr1:116513397-116513493,chr1,116513397,116513493,H1|chr1:213034523-213034557,chr1,213034523,213034557,0,96521126
H1|chr1:116800213-116800322,chr1,116800213,116800322,H1|chr1:213034767-213034798,chr1,213034767,213034798,0,96234554
H1|chr1:117807678-117807794,chr1,117807678,117807794,H1|chr1:27669232-27669345,chr1,27669232,27669345,0,90138446
H1|chr1:118706813-118706916,chr1,118706813,118706916,H1|chr1:113496707-113496769,chr1,113496707,113496769,0,5210106
H1|chr1:118753010-118753160,chr1,118753010,118753160,H1|chr1:2046144-2046239,chr1,2046144,2046239,0,116706866
H1|chr1:119436806-119436857,chr1,119436806,119436857,H1|chr1:156676445-156676571,chr1,156676445,156676571,0,37239639
H1|chr1:119465500-119465625,chr1,119465500,119465625,H1|chr1:174844596-174844623,chr1,174844596,174844623,0,55379096
H1|chr1:119900017-119900090,chr1,119900017,119900090,H1|chr1:45312261-45312280,chr1,45312261,45312280,0,74587756
H1|chr1:120038920-120038991,chr1,120038920,120038991,H1|chr1:235269818-235269868,chr1,235269818,235269868,0,115230898
H1|chr1:120202382-120202421,chr1,120202382,120202421,H1|chr1:214453069-214453180,chr1,214453069,214453180,0,94250687
H1|chr1:120291387-120291505,chr1,120291387,120291505,H1|chr1:173836043-173836074,chr1,173836043,173836074,0,53544656
H1|chr1:120723945-120723989,chr1,120723945,120723989,H1|chr1:6846834-6846916,chr1,6846834,6846916,0,113877111
H1|chr1:121022973-121023057,chr1,121022973,121023057,H1|chr1:224545401-224545421,chr1,224545401,224545421,0,103522428
H1|chr1:121287694-121287730,chr1,121287694,121287730,H1|chr1:213035285-213035424,chr1,213035285,213035424,0,91747591
H1|chr1:121906048-121906092,chr1,121906048,121906092,H1|chr1:27665977-27666063,chr1,27665977,27666063,0,94240071
H1|chr1:121947365-121947431,chr1,121947365,121947431,H1|chr1:245025639-245025692,chr1,245025639,245025692,0,123078274
H1|chr1:122062001-122062061,chr1,122062001,122062061,H1|chr1:149671927-149671991,chr1,149671927,149671991,0,27609926
H1|chr1:122151647-122151674,chr1,122151647,122151674,H1|chr1:62663157-62663254,chr1,62663157,62663254,0,59488490
H1|chr1:122628503-122628535,chr1,122628503,122628535,H1|chr1:27338539-27338657,chr1,27338539,27338657,0,95289964
H1|chr1:122774834-122774930,chr1,122774834,122774930,H1|chr1:6507203-6507238,chr1,6507203,6507238,0,116267631
H1|chr1:122919126-122919150,chr1,122919126,122919150,H1|chr1:38478788-38478876,chr1,38478788,38478876,0,84440338
H1|chr1:122986686-122986766,chr1,122986686,122986766,H1|chr1:149671946-149671972,chr1,149671946,149671972,0,26685260
H1|chr1:123028097-123028120,chr1,123028097,123028120,H1|chr1:38478788-38478876,chr1,38478788,38478876,0,84549309
H1|chr1:123777787-123777865,chr1,123777787,123777865,H1|chr1:62664118-62664190,chr1,62664118,62664190,0,61113669
H1|chr1:123871114-123871219,chr1,123871114,123871219,H1|chr1:6507203-6507238,chr1,6507203,6507238,0,117363911
H1|chr1:124624011-124624091,chr1,124624011,124624091,H1|chr1:8761281-8761330,chr1,8761281,8761330,0,115862730
H1|chr1:124833658-124833706,chr1,124833658,124833706,H1|chr1:27338539-27338657,chr1,27338539,27338657,0,97495119
H1|chr1:125408452-125408602,chr1,125408452,125408602,H1|chr1:149671921-149671980,chr1,149671921,149671980,0,24263469
H1|chr1:125615163-125615252,chr1,125615163,125615252,H1|chr1:213126455-213126483,chr1,213126455,213126483,0,87511292
H1|chr1:125783223-125783279,chr1,125783223,125783279,H1|chr1:39572206-39572301,chr1,39572206,39572301,0,86211017
H1|chr1:125938549-125938650,chr1,125938549,125938650,H1|chr1:27664891-27664940,chr1,27664891,27664940,0,98273658
H1|chr1:126032381-126032441,chr1,126032381,126032441,H1|chr1:27321994-27322046,chr1,27321994,27322046,0,98710387
H1|chr1:126120777-126120927,chr1,126120777,126120927,H1|chr1:148763364-148763514,chr1,148763364,148763514,0,22642587
H1|chr1:126296745-126296773,chr1,126296745,126296773,H1|chr1:113498953-113499075,chr1,113498953,113499075,0,12797792
H1|chr1:126439108-126439224,chr1,126439108,126439224,H1|chr1:229549458-229549492,chr1,229549458,229549492,0,103110350
H1|chr1:126704855-126705002,chr1,126704855,126705002,H1|chr1:149671971-149672054,chr1,149671971,149672054,0,22967116
H1|chr1:126811257-126811332,chr1,126811257,126811332,H1|chr1:1187426-1187484,chr1,1187426,1187484,0,125623831
H1|chr1:127071112-127071173,chr1,127071112,127071173,H1|chr1:26757495-26757581,chr1,26757495,26757581,0,100313617
H1|chr1:127766429-127766539,chr1,127766429,127766539,H1|chr1:111991116-111991134,chr1,111991116,111991134,0,15775313
H1|chr1:127779928-127780038,chr1,127779928,127780038,H1|chr1:204045403-204045425,chr1,204045403,204045425,0,76265475
H1|chr1:127877138-127877156,chr1,127877138,127877156,H1|chr1:213034116-213034224,chr1,213034116,213034224,0,85156978
H1|chr1:128087305-128087401,chr1,128087305,128087401,H1|chr1:6507203-6507238,chr1,6507203,6507238,0,121580102
H1|chr1:128298900-128298967,chr1,128298900,128298967,H1|chr1:44116450-44116497,chr1,44116450,44116497,0,84182450
H1|chr1:128417585-128417614,chr1,128417585,128417614,H1|chr1:1289123-1289244,chr1,1289123,1289244,0,127128462
H1|chr1:128571267-128571330,chr1,128571267,128571330,H1|chr1:43421862-43421996,chr1,43421862,43421996,0,85149405
H1|chr1:128587864-128587946,chr1,128587864,128587946,H1|chr1:62665219-62665287,chr1,62665219,62665287,0,65922645
H1|chr1:128595602-128595658,chr1,128595602,128595658,H1|chr1:156306555-156306622,chr1,156306555,156306622,0,27710953
H1|chr1:128716143-128716206,chr1,128716143,128716206,H1|chr1:43421862-43421996,chr1,43421862,43421996,0,85294281
H1|chr1:128859642-128859792,chr1,128859642,128859792,H1|chr1:148558227-148558286,chr1,148558227,148558286,0,19698585
H1|chr1:129004890-129004998,chr1,129004890,129004998,H1|chr1:225998464-225998492,chr1,225998464,225998492,0,96993574
H1|chr1:129155056-129155117,chr1,129155056,129155117,H1|chr1:214452008-214452080,chr1,214452008,214452080,0,85296952
H1|chr1:129215446-129215528,chr1,129215446,129215528,H1|chr1:173445765-173445833,chr1,173445765,173445833,0,44230319
H1|chr1:129312126-129312162,chr1,129312126,129312162,H1|chr1:26758512-26758626,chr1,26758512,26758626,0,102553614
H1|chr1:129339920-129340013,chr1,129339920,129340013,H1|chr1:149672502-149672586,chr1,149672502,149672586,0,20332582
H1|chr1:129392781-129392924,chr1,129392781,129392924,H1|chr1:229551337-229551388,chr1,229551337,229551388,0,100158556
H1|chr1:129476440-129476499,chr1,129476440,129476499,H1|chr1:1289123-1289244,chr1,1289123,1289244,0,128187317
H1|chr1:129489472-129489590,chr1,129489472,129489590,H1|chr1:2046144-2046239,chr1,2046144,2046239,0,127443328
H1|chr1:129528700-129528733,chr1,129528700,129528733,H1|chr1:173442871-173442959,chr1,173442871,173442959,0,43914171
H1|chr1:129577020-129577064,chr1,129577020,129577064,H1|chr1:110950825-110950874,chr1,110950825,110950874,0,18626195
H1|chr1:130103110-130103199,chr1,130103110,130103199,H1|chr1:43425525-43425582,chr1,43425525,43425582,0,86677585
H1|chr1:130139665-130139690,chr1,130139665,130139690,H1|chr1:39569810-39569908,chr1,39569810,39569908,0,90569855
H1|chr1:130153971-130154027,chr1,130153971,130154027,H1|chr1:156306555-156306622,chr1,156306555,156306622,0,26152584
H1|chr1:130204642-130204765,chr1,130204642,130204765,H1|chr1:148556466-148556616,chr1,148556466,148556616,0,18351824
H1|chr1:130210820-130210929,chr1,130210820,130210929,H1|chr1:149671928-149671995,chr1,149671928,149671995,0,19461108
H1|chr1:130304047-130304113,chr1,130304047,130304113,H1|chr1:245025639-245025692,chr1,245025639,245025692,0,114721592
H1|chr1:130388250-130388400,chr1,130388250,130388400,H1|chr1:17243634-17243784,chr1,17243634,17243784,0,113144616
H1|chr1:130407629-130407684,chr1,130407629,130407684,H1|chr1:62663305-62663377,chr1,62663305,62663377,0,67744324
H1|chr1:130450166-130450231,chr1,130450166,130450231,H1|chr1:173445930-173446008,chr1,173445930,173446008,0,42995764
H1|chr1:130464211-130464288,chr1,130464211,130464288,H1|chr1:40205074-40205133,chr1,40205074,40205133,0,90259137
H1|chr1:130497442-130497527,chr1,130497442,130497527,H1|chr1:224545401-224545421,chr1,224545401,224545421,0,94047959
H1|chr1:130668664-130668686,chr1,130668664,130668686,H1|chr1:27337678-27337759,chr1,27337678,27337759,0,103330986
H1|chr1:130745475-130745515,chr1,130745475,130745515,H1|chr1:229550283-229550339,chr1,229550283,229550339,0,98804808
H1|chr1:131133948-131134016,chr1,131133948,131134016,H1|chr1:245025639-245025692,chr1,245025639,245025692,0,113891691
H1|chr1:131389371-131389454,chr1,131389371,131389454,H1|chr1:214453069-214453180,chr1,214453069,214453180,0,83063698
H1|chr1:131502234-131502308,chr1,131502234,131502308,H1|chr1:1410045-1410179,chr1,1410045,1410179,0,130092189
H1|chr1:131735176-131735221,chr1,131735176,131735221,H1|chr1:27335516-27335579,chr1,27335516,27335579,0,104399660
H1|chr1:131887493-131887529,chr1,131887493,131887529,H1|chr1:26758512-26758626,chr1,26758512,26758626,0,105128981
H1|chr1:132073018-132073047,chr1,132073018,132073047,H1|chr1:16378499-16378601,chr1,16378499,16378601,0,115694519
H1|chr1:132359082-132359118,chr1,132359082,132359118,H1|chr1:149674699-149674788,chr1,149674699,149674788,0,17315617
H1|chr1:132364100-132364185,chr1,132364100,132364185,H1|chr1:82265657-82265709,chr1,82265657,82265709,0,50098443
H1|chr1:132408269-132408306,chr1,132408269,132408306,H1|chr1:27665977-27666063,chr1,27665977,27666063,0,104742292
H1|chr1:132484044-132484157,chr1,132484044,132484157,H1|chr1:213033763-213033800,chr1,213033763,213033800,0,80549719
H1|chr1:132750781-132750866,chr1,132750781,132750866,H1|chr1:14923804-14923834,chr1,14923804,14923834,0,117826977
H1|chr1:133087775-133087827,chr1,133087775,133087827,H1|chr1:26756213-26756246,chr1,26756213,26756246,0,106331562
H1|chr1:133562408-133562436,chr1,133562408,133562436,H1|chr1:154948691-154948809,chr1,154948691,154948809,0,21386283
H1|chr1:133896636-133896660,chr1,133896636,133896660,H1|chr1:43425628-43425721,chr1,43425628,43425721,0,90471008
H1|chr1:134064913-134064978,chr1,134064913,134064978,H1|chr1:229551326-229551370,chr1,229551326,229551370,0,95486413
H1|chr1:134186137-134186248,chr1,134186137,134186248,H1|chr1:149671927-149671966,chr1,149671927,149671966,0,15485790
H1|chr1:134214917-134214934,chr1,134214917,134214934,H1|chr1:1334294-1334390,chr1,1334294,1334390,0,132880623
H1|chr1:134244924-134244999,chr1,134244924,134244999,H1|chr1:936562-936637,chr1,936562,936637,0,133308362
H1|chr1:134473678-134473730,chr1,134473678,134473730,H1|chr1:213034651-213034719,chr1,213034651,213034719,0,78560973
H1|chr1:134483057-134483170,chr1,134483057,134483170,H1|chr1:213033763-213033800,chr1,213033763,213033800,0,78550706
H1|chr1:134726486-134726560,chr1,134726486,134726560,H1|chr1:36855361-36855422,chr1,36855361,36855422,0,97871125
H1|chr1:135172355-135172432,chr1,135172355,135172432,H1|chr1:6675654-6675721,chr1,6675654,6675721,0,128496701
H1|chr1:135332454-135332535,chr1,135332454,135332535,H1|chr1:36920007-36920076,chr1,36920007,36920076,0,98412447
H1|chr1:135685767-135685842,chr1,135685767,135685842,H1|chr1:936562-936637,chr1,936562,936637,0,134749205
H1|chr1:136222462-136222490,chr1,136222462,136222490,H1|chr1:212967439-212967534,chr1,212967439,212967534,0,76744977
H1|chr1:136242856-136242916,chr1,136242856,136242916,H1|chr1:25560308-25560351,chr1,25560308,25560351,0,110682548
H1|chr1:136293249-136293365,chr1,136293249,136293365,H1|chr1:39487313-39487347,chr1,39487313,39487347,0,96805936
H1|chr1:136674138-136674161,chr1,136674138,136674161,H1|chr1:244998093-244998170,chr1,244998093,244998170,0,108323955
H1|chr1:136934306-136934358,chr1,136934306,136934358,H1|chr1:229550283-229550327,chr1,229550283,229550327,0,92615977
H1|chr1:137139521-137139631,chr1,137139521,137139631,H1|chr1:26757405-26757470,chr1,26757405,26757470,0,110382116
H1|chr1:137788440-137788570,chr1,137788440,137788570,H1|chr1:150604751-150604771,chr1,150604751,150604771,0,12816311
H1|chr1:137888959-137889000,chr1,137888959,137889000,H1|chr1:182809558-182809664,chr1,182809558,182809664,0,44920599
H1|chr1:137990406-137990439,chr1,137990406,137990439,H1|chr1:148558551-148558700,chr1,148558551,148558700,0,10568145
H1|chr1:138224293-138224338,chr1,138224293,138224338,H1|chr1:25593055-25593202,chr1,25593055,25593202,0,112631238
H1|chr1:138406235-138406321,chr1,138406235,138406321,H1|chr1:149671927-149671991,chr1,149671927,149671991,0,11265692
H1|chr1:138413842-138413903,chr1,138413842,138413903,H1|chr1:27667332-27667371,chr1,27667332,27667371,0,110746510
H1|chr1:138667141-138667220,chr1,138667141,138667220,H1|chr1:36855361-36855422,chr1,36855361,36855422,0,101811780
H1|chr1:138905018-138905082,chr1,138905018,138905082,H1|chr1:6299990-6300076,chr1,6299990,6300076,0,132605028
H1|chr1:139080143-139080293,chr1,139080143,139080293,H1|chr1:148560509-148560659,chr1,148560509,148560659,0,9480366
H1|chr1:139214885-139214942,chr1,139214885,139214942,H1|chr1:150292114-150292143,chr1,150292114,150292143,0,11077229
H1|chr1:139803036-139803148,chr1,139803036,139803148,H1|chr1:17247227-17247299,chr1,17247227,17247299,0,122555809
H1|chr1:140018595-140018680,chr1,140018595,140018680,H1|chr1:224545401-224545421,chr1,224545401,224545421,0,84526806
H1|chr1:140164244-140164385,chr1,140164244,140164385,H1|chr1:62665219-62665287,chr1,62665219,62665287,0,77499025
H1|chr1:140609851-140610001,chr1,140609851,140610001,H1|chr1:2046144-2046239,chr1,2046144,2046239,0,138563707
H1|chr1:141025397-141025442,chr1,141025397,141025442,H1|chr1:939876-939981,chr1,939876,939981,0,140085521
H1|chr1:141135492-141135603,chr1,141135492,141135603,H1|chr1:76254250-76254289,chr1,76254250,76254289,0,64881242
H1|chr1:141135991-141136046,chr1,141135991,141136046,H1|chr1:62663305-62663377,chr1,62663305,62663377,0,78472686
H1|chr1:141395799-141395949,chr1,141395799,141395949,H1|chr1:150604751-150604771,chr1,150604751,150604771,0,9208952
H1|chr1:141717155-141717278,chr1,141717155,141717278,H1|chr1:26757495-26757581,chr1,26757495,26757581,0,114959660
H1|chr1:141871572-141871660,chr1,141871572,141871660,H1|chr1:16134831-16134861,chr1,16134831,16134861,0,125736741
H1|chr1:141939458-141939504,chr1,141939458,141939504,H1|chr1:51703507-51703545,chr1,51703507,51703545,0,90235951
H1|chr1:142204628-142204778,chr1,142204628,142204778,H1|chr1:27050545-27050570,chr1,27050545,27050570,0,115154083
H1|chr1:142483417-142483474,chr1,142483417,142483474,H1|chr1:229548719-229548777,chr1,229548719,229548777,0,87065302
H1|chr1:142672141-142672195,chr1,142672141,142672195,H1|chr1:244998093-244998193,chr1,244998093,244998193,0,102325952
H1|chr1:142777544-142777578,chr1,142777544,142777578,H1|chr1:33115836-33115916,chr1,33115836,33115916,0,109661708
H1|chr1:142854447-142854563,chr1,142854447,142854563,H1|chr1:173442583-173442651,chr1,173442583,173442651,0,30588136
H1|chr1:143065006-143065043,chr1,143065006,143065043,H1|chr1:27669232-27669345,chr1,27669232,27669345,0,115395774
H1|chr1:143121812-143121832,chr1,143121812,143121832,H1|chr1:244998093-244998160,chr1,244998093,244998160,0,101876281
H1|chr1:143259128-143259173,chr1,143259128,143259173,H1|chr1:205534520-205534567,chr1,205534520,205534567,0,62275392
H1|chr1:143350074-143350163,chr1,143350074,143350163,H1|chr1:26799083-26799197,chr1,26799083,26799197,0,116550991
H1|chr1:143360198-143360267,chr1,143360198,143360267,H1|chr1:52455857-52455889,chr1,52455857,52455889,0,90904341
H1|chr1:143502760-143502813,chr1,143502760,143502813,H1|chr1:156700156-156700249,chr1,156700156,156700249,0,13197396
H1|chr1:143665507-143665542,chr1,143665507,143665542,H1|chr1:224624835-224624890,chr1,224624835,224624890,0,80959328
H1|chr1:144135777-144135909,chr1,144135777,144135909,H1|chr1:33171348-33171364,chr1,33171348,33171364,0,110964429
H1|chr1:144219689-144219756,chr1,144219689,144219756,H1|chr1:27051382-27051440,chr1,27051382,27051440,0,117168307
H1|chr1:144382510-144382587,chr1,144382510,144382587,H1|chr1:16677890-16677932,chr1,16677890,16677932,0,127704620
H1|chr1:144675356-144675398,chr1,144675356,144675398,H1|chr1:39488838-39488959,chr1,39488838,39488959,0,105186518
H1|chr1:144731439-144731554,chr1,144731439,144731554,H1|chr1:173836043-173836074,chr1,173836043,173836074,0,29104604
H1|chr1:144876800-144876950,chr1,144876800,144876950,H1|chr1:150604751-150604771,chr1,150604751,150604771,0,5727951
H1|chr1:144966246-144966327,chr1,144966246,144966327,H1|chr1:27674714-27674801,chr1,27674714,27674801,0,117291532
H1|chr1:145122513-145122539,chr1,145122513,145122539,H1|chr1:156673540-156673664,chr1,156673540,156673664,0,11551027
H1|chr1:145320856-145320902,chr1,145320856,145320902,H1|chr1:33646320-33646421,chr1,33646320,33646421,0,111674536
H1|chr1:145477498-145477626,chr1,145477498,145477626,H1|chr1:27321952-27321971,chr1,27321952,27321971,0,118155546
H1|chr1:146036888-146036948,chr1,146036888,146036948,H1|chr1:11712632-11712664,chr1,11712632,11712664,0,134324256
H1|chr1:146058002-146058028,chr1,146058002,146058028,H1|chr1:93912336-93912415,chr1,93912336,93912415,0,52145666
H1|chr1:146074520-146074588,chr1,146074520,146074588,H1|chr1:150603874-150603945,chr1,150603874,150603945,0,4529354
H1|chr1:146173929-146174052,chr1,146173929,146174052,H1|chr1:174844596-174844623,chr1,174844596,174844623,0,28670667
H1|chr1:147264281-147264380,chr1,147264281,147264380,H1|chr1:229550204-229550252,chr1,229550204,229550252,0,82285923
H1|chr1:147494780-147494868,chr1,147494780,147494868,H1|chr1:150536007-150536157,chr1,150536007,150536157,0,3041227
H1|chr1:147507484-147507512,chr1,147507484,147507512,H1|chr1:154948691-154948809,chr1,154948691,154948809,0,7441207
H1|chr1:147610389-147610483,chr1,147610389,147610483,H1|chr1:149671950-149672006,chr1,149671950,149672006,0,2061561
H1|chr1:148059457-148059602,chr1,148059457,148059602,H1|chr1:224302535-224302555,chr1,224302535,224302555,0,76243078
H1|chr1:148397746-148397827,chr1,148397746,148397827,H1|chr1:149671932-149672001,chr1,149671932,149672001,0,1274186
H1|chr1:148454558-148454618,chr1,148454558,148454618,H1|chr1:150531630-150531718,chr1,150531630,150531718,0,2077072
H1|chr1:148710335-148710359,chr1,148710335,148710359,H1|chr1:173448532-173448574,chr1,173448532,173448574,0,24738197
H1|chr1:148943300-148943322,chr1,148943300,148943322,H1|chr1:213034341-213034487,chr1,213034341,213034487,0,64091041
H1|chr1:149331798-149331876,chr1,149331798,149331876,H1|chr1:17246195-17246236,chr1,17246195,17246236,0,132085603
H1|chr1:149441546-149441619,chr1,149441546,149441619,H1|chr1:154971268-154971345,chr1,154971268,154971345,0,5529722
H1|chr1:149641814-149641885,chr1,149641814,149641885,H1|chr1:229551057-229551111,chr1,229551057,229551111,0,79909243
H1|chr1:149693831-149693948,chr1,149693831,149693948,H1|chr1:229551316-229551349,chr1,229551316,229551349,0,79857485
H1|chr1:149720659-149720763,chr1,149720659,149720763,H1|chr1:39488015-39488058,chr1,39488015,39488058,0,110232644
H1|chr1:149780006-149780083,chr1,149780006,149780083,H1|chr1:39326250-39326323,chr1,39326250,39326323,0,110453756
H1|chr1:149885856-149885901,chr1,149885856,149885901,H1|chr1:229549678-229549744,chr1,229549678,229549744,0,79663822
H1|chr1:149927778-149927916,chr1,149927778,149927916,H1|chr1:149671938-149671972,chr1,149671938,149671972,0,255840
H1|chr1:149972715-149972768,chr1,149972715,149972768,H1|chr1:148558160-148558307,chr1,148558160,148558307,0,1414555
H1|chr1:150044796-150044829,chr1,150044796,150044829,H1|chr1:148558551-148558700,chr1,148558551,148558700,0,1486245
H1|chr1:150216797-150216817,chr1,150216797,150216817,H1|chr1:173987813-173987943,chr1,173987813,173987943,0,23771016
H1|chr1:150471664-150471757,chr1,150471664,150471757,H1|chr1:173445244-173445306,chr1,173445244,173445306,0,22973580
H1|chr1:150930291-150930409,chr1,150930291,150930409,H1|chr1:149671942-149671989,chr1,149671942,149671989,0,1258349
H1|chr1:151733457-151733496,chr1,151733457,151733496,H1|chr1:200380942-200381014,chr1,200380942,200381014,0,48647485
H1|chr1:151759046-151759067,chr1,151759046,151759067,H1|chr1:27321384-27321502,chr1,27321384,27321502,0,124437662
H1|chr1:151903591-151903701,chr1,151903591,151903701,H1|chr1:26757495-26757581,chr1,26757495,26757581,0,125146096
H1|chr1:151938843-151938874,chr1,151938843,151938874,H1|chr1:247267051-247267156,chr1,247267051,247267156,0,95328208
H1|chr1:152712584-152712631,chr1,152712584,152712631,H1|chr1:120254826-120254901,chr1,120254826,120254901,0,32457758
H1|chr1:152987273-152987388,chr1,152987273,152987388,H1|chr1:27321347-27321388,chr1,27321347,27321388,0,125665926
H1|chr1:153044500-153044566,chr1,153044500,153044566,H1|chr1:64240704-64240747,chr1,64240704,64240747,0,88803796
H1|chr1:153324382-153324492,chr1,153324382,153324492,H1|chr1:41830744-41830777,chr1,41830744,41830777,0,111493638
H1|chr1:153504707-153504738,chr1,153504707,153504738,H1|chr1:26758437-26758470,chr1,26758437,26758470,0,126746270
H1|chr1:153864914-153864973,chr1,153864914,153864973,H1|chr1:17247206-17247240,chr1,17247206,17247240,0,136617708
H1|chr1:154365934-154365963,chr1,154365934,154365963,H1|chr1:113498957-113499072,chr1,113498957,113499072,0,40866977
H1|chr1:154485074-154485101,chr1,154485074,154485101,H1|chr1:213033780-213033870,chr1,213033780,213033870,0,58548706
H1|chr1:154853808-154853886,chr1,154853808,154853886,H1|chr1:213034451-213034520,chr1,213034451,213034520,0,58180643
H1|chr1:155028312-155028347,chr1,155028312,155028347,H1|chr1:224624835-224624890,chr1,224624835,224624890,0,69596523
H1|chr1:156158142-156158199,chr1,156158142,156158199,H1|chr1:229550154-229550247,chr1,229550154,229550247,0,73392012
H1|chr1:156765456-156765525,chr1,156765456,156765525,H1|chr1:62664559-62664647,chr1,62664559,62664647,0,94100897
H1|chr1:156893897-156893974,chr1,156893897,156893974,H1|chr1:16677890-16677932,chr1,16677890,16677932,0,140216007
H1|chr1:156990912-156990935,chr1,156990912,156990935,H1|chr1:203765096-203765148,chr1,203765096,203765148,0,46774184
H1|chr1:156991422-156991510,chr1,156991422,156991510,H1|chr1:156700779-156700844,chr1,156700779,156700844,0,290643
H1|chr1:157840638-157840720,chr1,157840638,157840720,H1|chr1:85358425-85358493,chr1,85358425,85358493,0,72482213
H1|chr1:157880497-157880576,chr1,157880497,157880576,H1|chr1:36855361-36855422,chr1,36855361,36855422,0,121025136
H1|chr1:157990232-157990379,chr1,157990232,157990379,H1|chr1:17243646-17243793,chr1,17243646,17243793,0,140746586
H1|chr1:158082665-158082730,chr1,158082665,158082730,H1|chr1:247499489-247499564,chr1,247499489,247499564,0,89416824
H1|chr1:158083762-158083796,chr1,158083762,158083796,H1|chr1:173640372-173640488,chr1,173640372,173640488,0,15556610
H1|chr1:158136173-158136231,chr1,158136173,158136231,H1|chr1:155540703-155540792,chr1,155540703,155540792,0,2595470
H1|chr1:158252152-158252280,chr1,158252152,158252280,H1|chr1:1287496-1287591,chr1,1287496,1287591,0,156964656
H1|chr1:158555446-158555471,chr1,158555446,158555471,H1|chr1:6547221-6547266,chr1,6547221,6547266,0,152008225
H1|chr1:158785702-158785779,chr1,158785702,158785779,H1|chr1:84544433-84544506,chr1,84544433,84544506,0,74241269
H1|chr1:158816564-158816629,chr1,158816564,158816629,H1|chr1:32642426-32642469,chr1,32642426,32642469,0,126174138
H1|chr1:159033402-159033465,chr1,159033402,159033465,H1|chr1:229551323-229551408,chr1,229551323,229551408,0,70517921
H1|chr1:159202249-159202323,chr1,159202249,159202323,H1|chr1:173444950-173445006,chr1,173444950,173445006,0,14242701
H1|chr1:159499465-159499539,chr1,159499465,159499539,H1|chr1:173445900-173445923,chr1,173445900,173445923,0,13946435
H1|chr1:159536317-159536413,chr1,159536317,159536413,H1|chr1:109757297-109757326,chr1,109757297,109757326,0,49779020
H1|chr1:159685962-159685998,chr1,159685962,159685998,H1|chr1:149672536-149672595,chr1,149672536,149672595,0,10013426
H1|chr1:159988519-159988591,chr1,159988519,159988591,H1|chr1:45312261-45312280,chr1,45312261,45312280,0,114676258
H1|chr1:160903134-160903250,chr1,160903134,160903250,H1|chr1:39487313-39487347,chr1,39487313,39487347,0,121415821
H1|chr1:161649377-161649436,chr1,161649377,161649436,H1|chr1:200381911-200382015,chr1,200381911,200382015,0,38732534
H1|chr1:161665956-161665978,chr1,161665956,161665978,H1|chr1:27337678-27337759,chr1,27337678,27337759,0,134328278
H1|chr1:161669347-161669399,chr1,161669347,161669399,H1|chr1:229550283-229550327,chr1,229550283,229550327,0,67880936
H1|chr1:161758575-161758634,chr1,161758575,161758634,H1|chr1:149671927-149671989,chr1,149671927,149671989,0,12086648
H1|chr1:161885377-161885463,chr1,161885377,161885463,H1|chr1:213035135-213035276,chr1,213035135,213035276,0,51149758
H1|chr1:161917592-161917715,chr1,161917592,161917715,H1|chr1:62663973-62663993,chr1,62663973,62663993,0,99253619
H1|chr1:162142935-162143036,chr1,162142935,162143036,H1|chr1:229407755-229407792,chr1,229407755,229407792,0,67264820
H1|chr1:162350905-162350995,chr1,162350905,162350995,H1|chr1:27665925-27665950,chr1,27665925,27665950,0,134684980
H1|chr1:163163560-163163628,chr1,163163560,163163628,H1|chr1:150266946-150267002,chr1,150266946,150267002,0,12896614
H1|chr1:163301397-163301460,chr1,163301397,163301460,H1|chr1:17867605-17867648,chr1,17867605,17867648,0,145433792
H1|chr1:163668975-163669057,chr1,163668975,163669057,H1|chr1:229551057-229551115,chr1,229551057,229551115,0,65882082
H1|chr1:163812303-163812389,chr1,163812303,163812389,H1|chr1:155170803-155170867,chr1,155170803,155170867,0,8641500
H1|chr1:164012016-164012066,chr1,164012016,164012066,H1|chr1:150534225-150534312,chr1,150534225,150534312,0,13477791
H1|chr1:164954605-164954622,chr1,164954605,164954622,H1|chr1:63153325-63153411,chr1,63153325,63153411,0,101801280
H1|chr1:165396130-165396280,chr1,165396130,165396280,H1|chr1:148560509-148560659,chr1,148560509,148560659,0,16835621
H1|chr1:165588170-165588268,chr1,165588170,165588268,H1|chr1:149671939-149671991,chr1,149671939,149671991,0,15916231
H1|chr1:165770071-165770099,chr1,165770071,165770099,H1|chr1:200861397-200861480,chr1,200861397,200861480,0,35091326
H1|chr1:165772477-165772515,chr1,165772477,165772515,H1|chr1:173445833-173445910,chr1,173445833,173445910,0,7673356
H1|chr1:165912936-165913049,chr1,165912936,165913049,H1|chr1:27321530-27321567,chr1,27321530,27321567,0,138591406
H1|chr1:165951800-165951846,chr1,165951800,165951846,H1|chr1:156675592-156675702,chr1,156675592,156675702,0,9276208
H1|chr1:166020223-166020316,chr1,166020223,166020316,H1|chr1:213032695-213032739,chr1,213032695,213032739,0,47012472
H1|chr1:166229994-166230015,chr1,166229994,166230015,H1|chr1:2046144-2046243,chr1,2046144,2046243,0,164183850
H1|chr1:166348740-166348798,chr1,166348740,166348798,H1|chr1:178064305-178064351,chr1,178064305,178064351,0,11715565
H1|chr1:166479220-166479304,chr1,166479220,166479304,H1|chr1:247499489-247499564,chr1,247499489,247499564,0,81020269
H1|chr1:166960553-166960638,chr1,166960553,166960638,H1|chr1:26757405-26757470,chr1,26757405,26757470,0,140203148
H1|chr1:167257758-167257881,chr1,167257758,167257881,H1|chr1:174844596-174844623,chr1,174844596,174844623,0,7586838
H1|chr1:167776790-167776857,chr1,167776790,167776857,H1|chr1:27051382-27051440,chr1,27051382,27051440,0,140725408
H1|chr1:168259292-168259332,chr1,168259292,168259332,H1|chr1:173442472-173442499,chr1,173442472,173442499,0,5183180
H1|chr1:168416618-168416654,chr1,168416618,168416654,H1|chr1:213035285-213035424,chr1,213035285,213035424,0,44618667
H1|chr1:168778007-168778025,chr1,168778007,168778025,H1|chr1:213034116-213034224,chr1,213034116,213034224,0,44256109
H1|chr1:168830014-168830077,chr1,168830014,168830077,H1|chr1:90310869-90310893,chr1,90310869,90310893,0,78519145
H1|chr1:169283810-169283924,chr1,169283810,169283924,H1|chr1:245025565-245025606,chr1,245025565,245025606,0,75741755
H1|chr1:169522923-169522972,chr1,169522923,169522972,H1|chr1:939691-939766,chr1,939691,939766,0,168583232
H1|chr1:169545349-169545402,chr1,169545349,169545402,H1|chr1:156700156-156700249,chr1,156700156,156700249,0,12845193
H1|chr1:170113249-170113308,chr1,170113249,170113308,H1|chr1:150530600-150530664,chr1,150530600,150530664,0,19582649
H1|chr1:170206364-170206474,chr1,170206364,170206474,H1|chr1:204045403-204045425,chr1,204045403,204045425,0,33839039
H1|chr1:170582271-170582310,chr1,170582271,170582310,H1|chr1:200380942-200381014,chr1,200380942,200381014,0,29798671
H1|chr1:170668747-170668823,chr1,170668747,170668823,H1|chr1:27321601-27321624,chr1,27321601,27321624,0,143347146
H1|chr1:170732675-170732693,chr1,170732675,170732693,H1|chr1:151513611-151513656,chr1,151513611,151513656,0,19219064
H1|chr1:171052213-171052293,chr1,171052213,171052293,H1|chr1:11728473-11728508,chr1,11728473,11728508,0,159323740
H1|chr1:171117178-171117217,chr1,171117178,171117217,H1|chr1:173445854-173445896,chr1,173445854,173445896,0,2328676
H1|chr1:171550347-171550437,chr1,171550347,171550437,H1|chr1:62662226-62662269,chr1,62662226,62662269,0,108888121
H1|chr1:171643745-171643769,chr1,171643745,171643769,H1|chr1:213034485-213034527,chr1,213034485,213034527,0,41390740
H1|chr1:171667620-171667670,chr1,171667620,171667670,H1|chr1:2046144-2046243,chr1,2046144,2046243,0,169621476
H1|chr1:171765344-171765378,chr1,171765344,171765378,H1|chr1:11725213-11725268,chr1,11725213,11725268,0,160040131
H1|chr1:171797984-171798101,chr1,171797984,171798101,H1|chr1:148556612-148556762,chr1,148556612,148556762,0,23241372
H1|chr1:171852571-171852642,chr1,171852571,171852642,H1|chr1:27667660-27667780,chr1,27667660,27667780,0,144184911
H1|chr1:171901429-171901484,chr1,171901429,171901484,H1|chr1:9649394-9649488,chr1,9649394,9649488,0,162252035
H1|chr1:171975165-171975245,chr1,171975165,171975245,H1|chr1:229549460-229549517,chr1,229549460,229549517,0,57574295
H1|chr1:172331282-172331356,chr1,172331282,172331356,H1|chr1:1410045-1410179,chr1,1410045,1410179,0,170921237
H1|chr1:173065607-173065647,chr1,173065607,173065647,H1|chr1:62661337-62661447,chr1,62661337,62661447,0,110404270
H1|chr1:173131293-173131420,chr1,173131293,173131420,H1|chr1:156859718-156859736,chr1,156859718,156859736,0,16271575
H1|chr1:173200172-173200291,chr1,173200172,173200291,H1|chr1:173836043-173836074,chr1,173836043,173836074,0,635871
H1|chr1:173246753-173246819,chr1,173246753,173246819,H1|chr1:15254131-15254203,chr1,15254131,15254203,0,157992622
H1|chr1:173409263-173409370,chr1,173409263,173409370,H1|chr1:17244636-17244678,chr1,17244636,17244678,0,156164627
H1|chr1:173420147-173420164,chr1,173420147,173420164,H1|chr1:151434320-151434433,chr1,151434320,151434433,0,21985827
H1|chr1:173425195-173425260,chr1,173425195,173425260,H1|chr1:32642426-32642469,chr1,32642426,32642469,0,140782769
H1|chr1:173638655-173638764,chr1,173638655,173638764,H1|chr1:57111896-57111925,chr1,57111896,57111925,0,116526759
H1|chr1:173651459-173651595,chr1,173651459,173651595,H1|chr1:154971268-154971345,chr1,154971268,154971345,0,18680191
H1|chr1:173700522-173700628,chr1,173700522,173700628,H1|chr1:76254163-76254212,chr1,76254163,76254212,0,97446359
H1|chr1:174001964-174002054,chr1,174001964,174002054,H1|chr1:27321354-27321403,chr1,27321354,27321403,0,146680610
H1|chr1:174105925-174106016,chr1,174105925,174106016,H1|chr1:26757551-26757619,chr1,26757551,26757619,0,147348374
H1|chr1:174159160-174159207,chr1,174159160,174159207,H1|chr1:62664107-62664178,chr1,62664107,62664178,0,111495053
H1|chr1:174397128-174397189,chr1,174397128,174397189,H1|chr1:12683157-12683242,chr1,12683157,12683242,0,161713971
H1|chr1:174554981-174555035,chr1,174554981,174555035,H1|chr1:32402358-32402437,chr1,32402358,32402437,0,142152623
H1|chr1:175093542-175093584,chr1,175093542,175093584,H1|chr1:201944885-201944972,chr1,201944885,201944972,0,26851343
H1|chr1:175137370-175137468,chr1,175137370,175137468,H1|chr1:149671939-149671991,chr1,149671939,149671991,0,25465431
H1|chr1:175249171-175249299,chr1,175249171,175249299,H1|chr1:156673540-156673664,chr1,156673540,156673664,0,18575631
H1|chr1:175279022-175279104,chr1,175279022,175279104,H1|chr1:27666674-27666731,chr1,27666674,27666731,0,147612348
H1|chr1:175602658-175602676,chr1,175602658,175602676,H1|chr1:155538443-155538575,chr1,155538443,155538575,0,20064215
H1|chr1:175754216-175754366,chr1,175754216,175754366,H1|chr1:149671939-149672016,chr1,149671939,149672016,0,26082277
H1|chr1:175862246-175862371,chr1,175862246,175862371,H1|chr1:53190165-53190215,chr1,53190165,53190215,0,122672081
H1|chr1:176526854-176526932,chr1,176526854,176526932,H1|chr1:27321601-27321624,chr1,27321601,27321624,0,149205253
H1|chr1:176578349-176578474,chr1,176578349,176578474,H1|chr1:53190165-53190215,chr1,53190165,53190215,0,123388184
H1|chr1:177262269-177262297,chr1,177262269,177262297,H1|chr1:171455045-171455153,chr1,171455045,171455153,0,5807224
H1|chr1:177714260-177714341,chr1,177714260,177714341,H1|chr1:149672464-149672595,chr1,149672464,149672595,0,28041796
H1|chr1:177893251-177893301,chr1,177893251,177893301,H1|chr1:222887078-222887113,chr1,222887078,222887113,0,44993827
H1|chr1:178187178-178187210,chr1,178187178,178187210,H1|chr1:2510000-2510114,chr1,2510000,2510114,0,175677178
H1|chr1:178556969-178557051,chr1,178556969,178557051,H1|chr1:44818973-44819006,chr1,44818973,44819006,0,133737996
H1|chr1:178900207-178900288,chr1,178900207,178900288,H1|chr1:149672464-149672595,chr1,149672464,149672595,0,29227743
H1|chr1:179215281-179215302,chr1,179215281,179215302,H1|chr1:10004154-10004283,chr1,10004154,10004283,0,169211127
H1|chr1:179232317-179232411,chr1,179232317,179232411,H1|chr1:36024278-36024313,chr1,36024278,36024313,0,143208039
H1|chr1:179396954-179396975,chr1,179396954,179396975,H1|chr1:2046144-2046243,chr1,2046144,2046243,0,177350810
H1|chr1:179644154-179644210,chr1,179644154,179644210,H1|chr1:224626350-224626406,chr1,224626350,224626406,0,44982196
H1|chr1:179853915-179854000,chr1,179853915,179854000,H1|chr1:154244253-154244300,chr1,154244253,154244300,0,25609662
H1|chr1:180391379-180391410,chr1,180391379,180391410,H1|chr1:62664591-62664710,chr1,62664591,62664710,0,117726788
H1|chr1:180941921-180941967,chr1,180941921,180941967,H1|chr1:200381911-200382015,chr1,200381911,200382015,0,19439990
H1|chr1:182033351-182033444,chr1,182033351,182033444,H1|chr1:27321562-27321616,chr1,27321562,27321616,0,154711789
H1|chr1:182678532-182678619,chr1,182678532,182678619,H1|chr1:173445770-173445838,chr1,173445770,173445838,0,9232762
H1|chr1:182736978-182736998,chr1,182736978,182736998,H1|chr1:173987813-173987943,chr1,173987813,173987943,0,8749165
H1|chr1:182795194-182795344,chr1,182795194,182795344,H1|chr1:149671927-149671988,chr1,149671927,149671988,0,33123267
H1|chr1:182860949-182861096,chr1,182860949,182861096,H1|chr1:6507186-6507238,chr1,6507186,6507238,0,176353763
H1|chr1:182937134-182937216,chr1,182937134,182937216,H1|chr1:57043510-57043603,chr1,57043510,57043603,0,125893624
H1|chr1:183010317-183010373,chr1,183010317,183010373,H1|chr1:57043510-57043603,chr1,57043510,57043603,0,125966807
H1|chr1:183240465-183240483,chr1,183240465,183240483,H1|chr1:63153325-63153411,chr1,63153325,63153411,0,120087140
H1|chr1:183245034-183245093,chr1,183245034,183245093,H1|chr1:17247205-17247237,chr1,17247205,17247237,0,165997829
H1|chr1:183257577-183257627,chr1,183257577,183257627,H1|chr1:173641053-173641106,chr1,173641053,173641106,0,9616524
H1|chr1:183319378-183319409,chr1,183319378,183319409,H1|chr1:156644525-156644626,chr1,156644525,156644626,0,26674853
H1|chr1:183427206-183427270,chr1,183427206,183427270,H1|chr1:6299990-6300076,chr1,6299990,6300076,0,177127216
H1|chr1:183628209-183628282,chr1,183628209,183628282,H1|chr1:17867605-17867648,chr1,17867605,17867648,0,165760604
H1|chr1:183628782-183628912,chr1,183628782,183628912,H1|chr1:150604751-150604771,chr1,150604751,150604771,0,33024031
H1|chr1:183700545-183700618,chr1,183700545,183700618,H1|chr1:45312261-45312280,chr1,45312261,45312280,0,138388284
H1|chr1:183927307-183927396,chr1,183927307,183927396,H1|chr1:213126455-213126483,chr1,213126455,213126483,0,29199148
H1|chr1:184242663-184242707,chr1,184242663,184242707,H1|chr1:120254826-120254900,chr1,120254826,120254900,0,63987837
H1|chr1:184649934-184650046,chr1,184649934,184650046,H1|chr1:150292114-150292143,chr1,150292114,150292143,0,34357820
H1|chr1:185262537-185262618,chr1,185262537,185262618,H1|chr1:229551057-229551115,chr1,229551057,229551115,0,44288520
H1|chr1:185287655-185287673,chr1,185287655,185287673,H1|chr1:173443005-173443114,chr1,173443005,173443114,0,11844650
H1|chr1:185389524-185389645,chr1,185389524,185389645,H1|chr1:27050545-27050570,chr1,27050545,27050570,0,158338979
H1|chr1:185730158-185730267,chr1,185730158,185730267,H1|chr1:156645604-156645633,chr1,156645604,156645633,0,29084554
H1|chr1:185887568-185887659,chr1,185887568,185887659,H1|chr1:25559252-25559290,chr1,25559252,25559290,0,160328316
H1|chr1:186060645-186060694,chr1,186060645,186060694,H1|chr1:173445836-173445933,chr1,173445836,173445933,0,12614809
H1|chr1:186478123-186478143,chr1,186478123,186478143,H1|chr1:213034116-213034224,chr1,213034116,213034224,0,26555993
H1|chr1:186487261-186487350,chr1,186487261,186487350,H1|chr1:36024278-36024312,chr1,36024278,36024312,0,150462983
H1|chr1:186559969-186559987,chr1,186559969,186559987,H1|chr1:151513611-151513656,chr1,151513611,151513656,0,35046358
H1|chr1:186650213-186650273,chr1,186650213,186650273,H1|chr1:229550204-229550294,chr1,229550204,229550294,0,42899991
H1|chr1:186883451-186883500,chr1,186883451,186883500,H1|chr1:213030715-213030816,chr1,213030715,213030816,0,26147264
H1|chr1:187126393-187126477,chr1,187126393,187126477,H1|chr1:16537031-16537093,chr1,16537031,16537093,0,170589362
H1|chr1:187209924-187210050,chr1,187209924,187210050,H1|chr1:38231511-38231530,chr1,38231511,38231530,0,148978413
H1|chr1:187474442-187474520,chr1,187474442,187474520,H1|chr1:151513611-151513656,chr1,151513611,151513656,0,35960831
H1|chr1:187989139-187989156,chr1,187989139,187989156,H1|chr1:16090285-16090391,chr1,16090285,16090391,0,171898854
H1|chr1:188257065-188257169,chr1,188257065,188257169,H1|chr1:39488015-39488058,chr1,39488015,39488058,0,148769050
H1|chr1:188347840-188347944,chr1,188347840,188347944,H1|chr1:25559252-25559290,chr1,25559252,25559290,0,162788588
H1|chr1:188374550-188374616,chr1,188374550,188374616,H1|chr1:247499687-247499771,chr1,247499687,247499771,0,59125137
H1|chr1:188602518-188602606,chr1,188602518,188602606,H1|chr1:16134831-16134861,chr1,16134831,16134861,0,172467687
H1|chr1:188616782-188616847,chr1,188616782,188616847,H1|chr1:247499489-247499564,chr1,247499489,247499564,0,58882707
H1|chr1:188647923-188647972,chr1,188647923,188647972,H1|chr1:114701058-114701104,chr1,114701058,114701104,0,73946865
H1|chr1:188708367-188708411,chr1,188708367,188708411,H1|chr1:205534520-205534567,chr1,205534520,205534567,0,16826153
H1|chr1:188992279-188992309,chr1,188992279,188992309,H1|chr1:229551317-229551404,chr1,229551317,229551404,0,40559038
H1|chr1:189115000-189115097,chr1,189115000,189115097,H1|chr1:100597556-100597658,chr1,100597556,100597658,0,88517444
H1|chr1:189198531-189198566,chr1,189198531,189198566,H1|chr1:11725213-11725268,chr1,11725213,11725268,0,177473318
H1|chr1:189439694-189439753,chr1,189439694,189439753,H1|chr1:1289123-1289244,chr1,1289123,1289244,0,188150571
H1|chr1:189498082-189498123,chr1,189498082,189498123,H1|chr1:213123468-213123532,chr1,213123468,213123532,0,23625386
H1|chr1:189509810-189509871,chr1,189509810,189509871,H1|chr1:62664049-62664134,chr1,62664049,62664134,0,126845761
H1|chr1:189771524-189771664,chr1,189771524,189771664,H1|chr1:244998093-244998124,chr1,244998093,244998124,0,55226569
H1|chr1:189992321-189992354,chr1,189992321,189992354,H1|chr1:26758439-26758470,chr1,26758439,26758470,0,163233882
H1|chr1:190151381-190151462,chr1,190151381,190151462,H1|chr1:27674714-27674801,chr1,27674714,27674801,0,162476667
H1|chr1:190637406-190637479,chr1,190637406,190637479,H1|chr1:154974144-154974194,chr1,154974144,154974194,0,35663262
H1|chr1:190937225-190937302,chr1,190937225,190937302,H1|chr1:33171322-33171350,chr1,33171322,33171350,0,157765903
H1|chr1:190948937-190949037,chr1,190948937,190949037,H1|chr1:27334720-27334823,chr1,27334720,27334823,0,163614217
H1|chr1:190963832-190963930,chr1,190963832,190963930,H1|chr1:244998093-244998124,chr1,244998093,244998124,0,54034261
H1|chr1:191586004-191586044,chr1,191586004,191586044,H1|chr1:229550210-229550314,chr1,229550210,229550314,0,37964206
H1|chr1:191641264-191641354,chr1,191641264,191641354,H1|chr1:27665925-27665950,chr1,27665925,27665950,0,163975339
H1|chr1:191901662-191901707,chr1,191901662,191901707,H1|chr1:17247219-17247240,chr1,17247219,17247240,0,174654443
H1|chr1:191974899-191974917,chr1,191974899,191974917,H1|chr1:62664107-62664194,chr1,62664107,62664194,0,129310792
H1|chr1:192451074-192451185,chr1,192451074,192451185,H1|chr1:76254250-76254289,chr1,76254250,76254289,0,116196824
H1|chr1:192736866-192736893,chr1,192736866,192736893,H1|chr1:235269818-235269867,chr1,235269818,235269867,0,42532952
H1|chr1:192864612-192864687,chr1,192864612,192864687,H1|chr1:84544433-84544506,chr1,84544433,84544506,0,108320179
H1|chr1:193005812-193005899,chr1,193005812,193005899,H1|chr1:247499480-247499581,chr1,247499480,247499581,0,54493668
H1|chr1:193325951-193326031,chr1,193325951,193326031,H1|chr1:62664035-62664099,chr1,62664035,62664099,0,130661916
H1|chr1:193571661-193571706,chr1,193571661,193571706,H1|chr1:16538130-16538221,chr1,16538130,16538221,0,177033531
H1|chr1:193818125-193818169,chr1,193818125,193818169,H1|chr1:6846834-6846916,chr1,6846834,6846916,0,186971291
H1|chr1:194098285-194098365,chr1,194098285,194098365,H1|chr1:11728473-11728508,chr1,11728473,11728508,0,182369812
H1|chr1:194104661-194104710,chr1,194104661,194104710,H1|chr1:173445836-173445933,chr1,173445836,173445933,0,20658825
H1|chr1:194171504-194171542,chr1,194171504,194171542,H1|chr1:247496652-247496744,chr1,247496652,247496744,0,53325148
H1|chr1:194476895-194476979,chr1,194476895,194476979,H1|chr1:173444991-173445040,chr1,173444991,173445040,0,21031904
H1|chr1:195073749-195073858,chr1,195073749,195073858,H1|chr1:57111896-57111925,chr1,57111896,57111925,0,137961853
H1|chr1:195074175-195074249,chr1,195074175,195074249,H1|chr1:36855361-36855422,chr1,36855361,36855422,0,158218814
H1|chr1:195280306-195280456,chr1,195280306,195280456,H1|chr1:148558227-148558286,chr1,148558227,148558286,0,46722079
H1|chr1:195468133-195468197,chr1,195468133,195468197,H1|chr1:100597556-100597658,chr1,100597556,100597658,0,94870577
H1|chr1:195739741-195739829,chr1,195739741,195739829,H1|chr1:93915010-93915160,chr1,93915010,93915160,0,101824731
H1|chr1:195769927-195769964,chr1,195769927,195769964,H1|chr1:229550284-229550397,chr1,229550284,229550397,0,33780357
H1|chr1:195796494-195796563,chr1,195796494,195796563,H1|chr1:245025639-245025692,chr1,245025639,245025692,0,49229145
H1|chr1:195846277-195846332,chr1,195846277,195846332,H1|chr1:26756213-26756246,chr1,26756213,26756246,0,169090064
H1|chr1:196317803-196317888,chr1,196317803,196317888,H1|chr1:16537031-16537093,chr1,16537031,16537093,0,179780772
H1|chr1:196454896-196454959,chr1,196454896,196454959,H1|chr1:27335574-27335651,chr1,27335574,27335651,0,169119322
H1|chr1:196510182-196510250,chr1,196510182,196510250,H1|chr1:213030715-213030816,chr1,213030715,213030816,0,16520533
H1|chr1:196807640-196807763,chr1,196807640,196807763,H1|chr1:62663973-62663993,chr1,62663973,62663993,0,134143667
H1|chr1:196885236-196885321,chr1,196885236,196885321,H1|chr1:149671950-149672006,chr1,149671950,149672006,0,47213286
H1|chr1:196977716-196977759,chr1,196977716,196977759,H1|chr1:244998093-244998216,chr1,244998093,244998216,0,48020377
H1|chr1:197471416-197471550,chr1,197471416,197471550,H1|chr1:62660926-62660950,chr1,62660926,62660950,0,134810490
H1|chr1:197590887-197590918,chr1,197590887,197590918,H1|chr1:109235987-109236058,chr1,109235987,109236058,0,88354900
H1|chr1:197772763-197772869,chr1,197772763,197772869,H1|chr1:224628383-224628412,chr1,224628383,224628412,0,26855620
H1|chr1:198016521-198016575,chr1,198016521,198016575,H1|chr1:156700156-156700249,chr1,156700156,156700249,0,41316365
H1|chr1:198698926-198698984,chr1,198698926,198698984,H1|chr1:178064305-178064351,chr1,178064305,178064351,0,20634621
H1|chr1:198793049-198793182,chr1,198793049,198793182,H1|chr1:148556781-148556834,chr1,148556781,148556834,0,50236268
H1|chr1:199021275-199021368,chr1,199021275,199021368,H1|chr1:213032695-213032739,chr1,213032695,213032739,0,14011420
H1|chr1:199652570-199652623,chr1,199652570,199652623,H1|chr1:173448532-173448574,chr1,173448532,173448574,0,26204038
H1|chr1:199811091-199811148,chr1,199811091,199811148,H1|chr1:229550154-229550247,chr1,229550154,229550247,0,29739063
H1|chr1:199875811-199875877,chr1,199875811,199875877,H1|chr1:229550965-229551011,chr1,229550965,229551011,0,29675154
H1|chr1:200048816-200048926,chr1,200048816,200048926,H1|chr1:229551323-229551392,chr1,229551323,229551392,0,29502507
H1|chr1:200230990-200231140,chr1,200230990,200231140,H1|chr1:149672177-149672327,chr1,149672177,149672327,0,50558813
H1|chr1:200477730-200477797,chr1,200477730,200477797,H1|chr1:11726636-11726745,chr1,11726636,11726745,0,188751094
H1|chr1:200480858-200480928,chr1,200480858,200480928,H1|chr1:17247303-17247453,chr1,17247303,17247453,0,183233555
H1|chr1:200536137-200536165,chr1,200536137,200536165,H1|chr1:203826574-203826712,chr1,203826574,203826712,0,3290437
H1|chr1:200559422-200559473,chr1,200559422,200559473,H1|chr1:27321497-27321546,chr1,27321497,27321546,0,173237925
H1|chr1:201108992-201109065,chr1,201108992,201109065,H1|chr1:6675654-6675721,chr1,6675654,6675721,0,194433338
H1|chr1:201241275-201241341,chr1,201241275,201241341,H1|chr1:15254131-15254203,chr1,15254131,15254203,0,185987144
H1|chr1:201298800-201298840,chr1,201298800,201298840,H1|chr1:43150232-43150342,chr1,43150232,43150342,0,158148568
H1|chr1:201314285-201314411,chr1,201314285,201314411,H1|chr1:174844596-174844623,chr1,174844596,174844623,0,26469689
H1|chr1:201356925-201357032,chr1,201356925,201357032,H1|chr1:17244636-17244678,chr1,17244636,17244678,0,184112289
H1|chr1:201795365-201795515,chr1,201795365,201795515,H1|chr1:17243718-17243865,chr1,17243718,17243865,0,184551647
H1|chr1:201804123-201804179,chr1,201804123,201804179,H1|chr1:39572206-39572301,chr1,39572206,39572301,0,162231917
H1|chr1:202028291-202028378,chr1,202028291,202028378,H1|chr1:16134831-16134861,chr1,16134831,16134861,0,185893460
H1|chr1:202151237-202151343,chr1,202151237,202151343,H1|chr1:224628383-224628412,chr1,224628383,224628412,0,22477146
H1|chr1:202202224-202202287,chr1,202202224,202202287,H1|chr1:17867605-17867648,chr1,17867605,17867648,0,184334619
H1|chr1:202367041-202367061,chr1,202367041,202367061,H1|chr1:222883343-222883466,chr1,222883343,222883466,0,20516302
H1|chr1:202389127-202389236,chr1,202389127,202389236,H1|chr1:149671928-149671995,chr1,149671928,149671995,0,52717199
H1|chr1:202613728-202613779,chr1,202613728,202613779,H1|chr1:156676445-156676571,chr1,156676445,156676571,0,45937283
H1|chr1:202758376-202758475,chr1,202758376,202758475,H1|chr1:939705-939821,chr1,939705,939821,0,201818671
H1|chr1:202865277-202865411,chr1,202865277,202865411,H1|chr1:62660926-62660950,chr1,62660926,62660950,0,140204351
H1|chr1:202934421-202934534,chr1,202934421,202934534,H1|chr1:27321530-27321567,chr1,27321530,27321567,0,175612891
H1|chr1:203365247-203365299,chr1,203365247,203365299,H1|chr1:120254826-120254900,chr1,120254826,120254900,0,83110421
H1|chr1:203533423-203533518,chr1,203533423,203533518,H1|chr1:36920007-36920076,chr1,36920007,36920076,0,166613416
H1|chr1:203830679-203830730,chr1,203830679,203830730,H1|chr1:27321497-27321546,chr1,27321497,27321546,0,176509182
H1|chr1:203846944-203847042,chr1,203846944,203847042,H1|chr1:6507186-6507238,chr1,6507186,6507238,0,197339758
H1|chr1:203920945-203921029,chr1,203920945,203921029,H1|chr1:16537031-16537093,chr1,16537031,16537093,0,187383914
H1|chr1:203955107-203955232,chr1,203955107,203955232,H1|chr1:229550204-229550258,chr1,229550204,229550258,0,25595097
H1|chr1:203987162-203987227,chr1,203987162,203987227,H1|chr1:229551326-229551370,chr1,229551326,229551370,0,25564164
H1|chr1:204100215-204100306,chr1,204100215,204100306,H1|chr1:233433698-233433809,chr1,233433698,233433809,0,29333483
H1|chr1:204267686-204267709,chr1,204267686,204267709,H1|chr1:28263428-28263542,chr1,28263428,28263542,0,176004258
H1|chr1:204841443-204841530,chr1,204841443,204841530,H1|chr1:9241762-9241882,chr1,9241762,9241882,0,195599681
H1|chr1:205322320-205322465,chr1,205322320,205322465,H1|chr1:224302535-224302555,chr1,224302535,224302555,0,18980215
H1|chr1:205370819-205370873,chr1,205370819,205370873,H1|chr1:156700156-156700249,chr1,156700156,156700249,0,48670663
H1|chr1:205373634-205373784,chr1,205373634,205373784,H1|chr1:149671921-149671980,chr1,149671921,149671980,0,55701713
H1|chr1:205405767-205405857,chr1,205405767,205405857,H1|chr1:27321562-27321616,chr1,27321562,27321616,0,178084205
H1|chr1:205455067-205455093,chr1,205455067,205455093,H1|chr1:1287733-1287833,chr1,1287733,1287833,0,204167334
H1|chr1:205471552-205471688,chr1,205471552,205471688,H1|chr1:1188543-1188666,chr1,1188543,1188666,0,204283009
H1|chr1:205604654-205604713,chr1,205604654,205604713,H1|chr1:9349991-9350074,chr1,9349991,9350074,0,196254663
H1|chr1:205643899-205643951,chr1,205643899,205643951,H1|chr1:120254826-120254900,chr1,120254826,120254900,0,85389073
H1|chr1:205974883-205974956,chr1,205974883,205974956,H1|chr1:16537491-16537553,chr1,16537491,16537553,0,189437392
H1|chr1:206024255-206024376,chr1,206024255,206024376,H1|chr1:27050545-27050570,chr1,27050545,27050570,0,178973710
H1|chr1:206065923-206066004,chr1,206065923,206066004,H1|chr1:51703507-51703545,chr1,51703507,51703545,0,154362416
H1|chr1:206322784-206322913,chr1,206322784,206322913,H1|chr1:149671918-149672003,chr1,149671918,149672003,0,56650866
H1|chr1:206462168-206462199,chr1,206462168,206462199,H1|chr1:113498953-113499075,chr1,113498953,113499075,0,92963215
H1|chr1:206482955-206483037,chr1,206482955,206483037,H1|chr1:113496707-113496775,chr1,113496707,113496775,0,92986248
H1|chr1:206596380-206596413,chr1,206596380,206596413,H1|chr1:11725212-11725268,chr1,11725212,11725268,0,194871168
H1|chr1:206662784-206662808,chr1,206662784,206662808,H1|chr1:38478788-38478876,chr1,38478788,38478876,0,168183996
H1|chr1:206890464-206890540,chr1,206890464,206890540,H1|chr1:150292114-150292143,chr1,150292114,150292143,0,56598350
H1|chr1:206896642-206896754,chr1,206896642,206896754,H1|chr1:150292114-150292143,chr1,150292114,150292143,0,56604528
H1|chr1:207182388-207182440,chr1,207182388,207182440,H1|chr1:27335610-27335642,chr1,27335610,27335642,0,179846778
H1|chr1:207228746-207228837,chr1,207228746,207228837,H1|chr1:26757551-26757619,chr1,26757551,26757619,0,180471195
H1|chr1:207327036-207327103,chr1,207327036,207327103,H1|chr1:44116450-44116497,chr1,44116450,44116497,0,163210586
H1|chr1:207503936-207504050,chr1,207503936,207504050,H1|chr1:27321864-27321946,chr1,27321864,27321946,0,180182072
H1|chr1:207614296-207614418,chr1,207614296,207614418,H1|chr1:40994911-40994935,chr1,40994911,40994935,0,166619385
H1|chr1:207689290-207689376,chr1,207689290,207689376,H1|chr1:154244254-154244299,chr1,154244254,154244299,0,53445036
H1|chr1:207716372-207716410,chr1,207716372,207716410,H1|chr1:229550025-229550124,chr1,229550025,229550124,0,21833653
H1|chr1:208139471-208139553,chr1,208139471,208139553,H1|chr1:27666674-27666731,chr1,27666674,27666731,0,180472797
H1|chr1:208163669-208163730,chr1,208163669,208163730,H1|chr1:247498694-247498764,chr1,247498694,247498764,0,39335025
H1|chr1:208513009-208513159,chr1,208513009,208513159,H1|chr1:36854280-36854430,chr1,36854280,36854430,0,171658729
H1|chr1:208669503-208669545,chr1,208669503,208669545,H1|chr1:38479287-38479340,chr1,38479287,38479340,0,170190216
H1|chr1:208766462-208766521,chr1,208766462,208766521,H1|chr1:17247205-17247237,chr1,17247205,17247237,0,191519257
H1|chr1:208879615-208879647,chr1,208879615,208879647,H1|chr1:233430135-233430219,chr1,233430135,233430219,0,24550520
H1|chr1:208981547-208981581,chr1,208981547,208981581,H1|chr1:939705-939821,chr1,939705,939821,0,208041842
H1|chr1:209023486-209023513,chr1,209023486,209023513,H1|chr1:1287733-1287833,chr1,1287733,1287833,0,207735753
H1|chr1:209262943-209263013,chr1,209262943,209263013,H1|chr1:149671939-149672016,chr1,149671939,149672016,0,59591004
H1|chr1:209445172-209445211,chr1,209445172,209445211,H1|chr1:153959862-153959949,chr1,153959862,153959949,0,55485310
H1|chr1:209626309-209626386,chr1,209626309,209626386,H1|chr1:43425691-43425748,chr1,43425691,43425748,0,166200618
H1|chr1:209644532-209644609,chr1,209644532,209644609,H1|chr1:39326250-39326323,chr1,39326250,39326323,0,170318282
H1|chr1:209810353-209810371,chr1,209810353,209810371,H1|chr1:32864247-32864305,chr1,32864247,32864305,0,176946106
H1|chr1:210035982-210036085,chr1,210035982,210036085,H1|chr1:156859718-156859736,chr1,156859718,156859736,0,53176264
H1|chr1:210087869-210087952,chr1,210087869,210087952,H1|chr1:149671928-149671995,chr1,149671928,149671995,0,60415941
H1|chr1:210141773-210141813,chr1,210141773,210141813,H1|chr1:173442472-173442499,chr1,173442472,173442499,0,36699301
H1|chr1:210153096-210153213,chr1,210153096,210153213,H1|chr1:27669232-27669345,chr1,27669232,27669345,0,182483864
H1|chr1:210213919-210214018,chr1,210213919,210214018,H1|chr1:149671927-149671991,chr1,149671927,149671991,0,60541992
H1|chr1:210276120-210276147,chr1,210276120,210276147,H1|chr1:27322036-27322105,chr1,27322036,27322105,0,182954084
H1|chr1:210292843-210292949,chr1,210292843,210292949,H1|chr1:11728473-11728508,chr1,11728473,11728508,0,198564370
H1|chr1:210297780-210297903,chr1,210297780,210297903,H1|chr1:62660926-62660950,chr1,62660926,62660950,0,147636854
H1|chr1:210478732-210478841,chr1,210478732,210478841,H1|chr1:148557601-148557656,chr1,148557601,148557656,0,61921131
H1|chr1:210556612-210556730,chr1,210556612,210556730,H1|chr1:229549899-229549944,chr1,229549899,229549944,0,18993287
H1|chr1:210570074-210570136,chr1,210570074,210570136,H1|chr1:229551361-229551405,chr1,229551361,229551405,0,18981287
H1|chr1:210697459-210697503,chr1,210697459,210697503,H1|chr1:205534520-205534567,chr1,205534520,205534567,0,5162939
H1|chr1:210866479-210866527,chr1,210866479,210866527,H1|chr1:16378499-16378601,chr1,16378499,16378601,0,194487980
H1|chr1:210921363-210921438,chr1,210921363,210921438,H1|chr1:182762122-182762197,chr1,182762122,182762197,0,28159241
H1|chr1:210969895-210970033,chr1,210969895,210970033,H1|chr1:149675740-149675835,chr1,149675740,149675835,0,61294155
H1|chr1:211053756-211053825,chr1,211053756,211053825,H1|chr1:149672535-149672595,chr1,149672535,149672595,0,61381221
H1|chr1:211151685-211151813,chr1,211151685,211151813,H1|chr1:156673540-156673664,chr1,156673540,156673664,0,54478145
H1|chr1:211280302-211280364,chr1,211280302,211280364,H1|chr1:155102271-155102421,chr1,155102271,155102421,0,56178031
H1|chr1:211336256-211336340,chr1,211336256,211336340,H1|chr1:224545401-224545421,chr1,224545401,224545421,0,13209145
H1|chr1:211392178-211392266,chr1,211392178,211392266,H1|chr1:156700779-156700844,chr1,156700779,156700844,0,54691399
H1|chr1:211591122-211591170,chr1,211591122,211591170,H1|chr1:27338539-27338657,chr1,27338539,27338657,0,184252583
H1|chr1:211787517-211787599,chr1,211787517,211787599,H1|chr1:26757551-26757619,chr1,26757551,26757619,0,185029966
H1|chr1:211835880-211835920,chr1,211835880,211835920,H1|chr1:110950825-110950874,chr1,110950825,110950874,0,100885055
H1|chr1:211888732-211888882,chr1,211888732,211888882,H1|chr1:33650432-33650497,chr1,33650432,33650497,0,178238300
H1|chr1:211995754-211995836,chr1,211995754,211995836,H1|chr1:26757551-26757619,chr1,26757551,26757619,0,185238203
H1|chr1:212015602-212015662,chr1,212015602,212015662,H1|chr1:11712632-11712664,chr1,11712632,11712664,0,200302970
H1|chr1:212054684-212054761,chr1,212054684,212054761,H1|chr1:213034879-213034924,chr1,213034879,213034924,0,980195
H1|chr1:212092895-212093045,chr1,212092895,212093045,H1|chr1:85358425-85358493,chr1,85358425,85358493,0,126734470
H1|chr1:212164549-212164593,chr1,212164549,212164593,H1|chr1:27665977-27666063,chr1,27665977,27666063,0,184498572
H1|chr1:212247843-212247882,chr1,212247843,212247882,H1|chr1:173445854-173445896,chr1,173445854,173445896,0,38801989
H1|chr1:212654222-212654346,chr1,212654222,212654346,H1|chr1:39326250-39326323,chr1,39326250,39326323,0,173327972
H1|chr1:212696827-212696897,chr1,212696827,212696897,H1|chr1:149671946-149671972,chr1,149671946,149671972,0,63024881
H1|chr1:212779063-212779134,chr1,212779063,212779134,H1|chr1:229551057-229551111,chr1,229551057,229551111,0,16771994
H1|chr1:213092715-213092746,chr1,213092715,213092746,H1|chr1:150536182-150536200,chr1,150536182,150536200,0,62556533
H1|chr1:213232183-213232272,chr1,213232183,213232272,H1|chr1:62662362-62662423,chr1,62662362,62662423,0,150569821
H1|chr1:213583964-213584049,chr1,213583964,213584049,H1|chr1:16537031-16537093,chr1,16537031,16537093,0,197046933
H1|chr1:213590553-213590636,chr1,213590553,213590636,H1|chr1:39457411-39457456,chr1,39457411,39457456,0,174133142
H1|chr1:213720689-213720729,chr1,213720689,213720729,H1|chr1:62661337-62661447,chr1,62661337,62661447,0,151059352
H1|chr1:213760129-213760223,chr1,213760129,213760223,H1|chr1:27665560-27665597,chr1,27665560,27665597,0,186094569
H1|chr1:214342180-214342246,chr1,214342180,214342246,H1|chr1:229550965-229551011,chr1,229550965,229551011,0,15208785
H1|chr1:214468108-214468180,chr1,214468108,214468180,H1|chr1:16537491-16537553,chr1,16537491,16537553,0,197930617
H1|chr1:214524042-214524101,chr1,214524042,214524101,H1|chr1:200381911-200382015,chr1,200381911,200382015,0,14142131
H1|chr1:214860456-214860546,chr1,214860456,214860546,H1|chr1:62664516-62664573,chr1,62664516,62664573,0,152195940
H1|chr1:216066613-216066689,chr1,216066613,216066689,H1|chr1:150292114-150292143,chr1,150292114,150292143,0,65774499
H1|chr1:216134510-216134580,chr1,216134510,216134580,H1|chr1:43427836-43427911,chr1,43427836,43427911,0,172706674
H1|chr1:216481404-216481513,chr1,216481404,216481513,H1|chr1:245025565-245025606,chr1,245025565,245025606,0,28544161
H1|chr1:216659103-216659211,chr1,216659103,216659211,H1|chr1:225998464-225998492,chr1,225998464,225998492,0,9339361
H1|chr1:216700582-216700623,chr1,216700582,216700623,H1|chr1:213123468-213123532,chr1,213123468,213123532,0,3577114
H1|chr1:216736458-216736608,chr1,216736458,216736608,H1|chr1:149671939-149672016,chr1,149671939,149672016,0,67064519
H1|chr1:216967615-216967765,chr1,216967615,216967765,H1|chr1:62661636-62661714,chr1,62661636,62661714,0,154305979
H1|chr1:217340005-217340100,chr1,217340005,217340100,H1|chr1:36024278-36024313,chr1,36024278,36024313,0,181315727
H1|chr1:217722477-217722554,chr1,217722477,217722554,H1|chr1:43425691-43425748,chr1,43425691,43425748,0,174296786
H1|chr1:217729852-217729902,chr1,217729852,217729902,H1|chr1:114701057-114701157,chr1,114701057,114701157,0,103028795
H1|chr1:217830740-217830851,chr1,217830740,217830851,H1|chr1:111991116-111991134,chr1,111991116,111991134,0,105839624
H1|chr1:217847775-217847794,chr1,217847775,217847794,H1|chr1:161736497-161736591,chr1,161736497,161736591,0,56111278
H1|chr1:217966753-217966869,chr1,217966753,217966869,H1|chr1:229549458-229549492,chr1,229549458,229549492,0,11582705
H1|chr1:218106767-218106802,chr1,218106767,218106802,H1|chr1:39490404-39490554,chr1,39490404,39490554,0,178616363
H1|chr1:218361802-218361831,chr1,218361802,218361831,H1|chr1:39488838-39488959,chr1,39488838,39488959,0,178872964
H1|chr1:218376706-218376736,chr1,218376706,218376736,H1|chr1:229551317-229551404,chr1,229551317,229551404,0,11174611
H1|chr1:218503132-218503153,chr1,218503132,218503153,H1|chr1:10004154-10004283,chr1,10004154,10004283,0,208498978
H1|chr1:218543716-218543809,chr1,218543716,218543809,H1|chr1:149672502-149672586,chr1,149672502,149672586,0,68871214
H1|chr1:218706320-218706443,chr1,218706320,218706443,H1|chr1:148556783-148556810,chr1,148556783,148556810,0,70149537
H1|chr1:218954175-218954282,chr1,218954175,218954282,H1|chr1:39488015-39488058,chr1,39488015,39488058,0,179466160
H1|chr1:218989101-218989251,chr1,218989101,218989251,H1|chr1:53190169-53190215,chr1,53190169,53190215,0,165798932
H1|chr1:219016667-219016805,chr1,219016667,219016805,H1|chr1:153939559-153939709,chr1,153939559,153939709,0,65077108
H1|chr1:219055487-219055577,chr1,219055487,219055577,H1|chr1:62665021-62665118,chr1,62665021,62665118,0,156390466
H1|chr1:219347694-219347844,chr1,219347694,219347844,H1|chr1:12683157-12683242,chr1,12683157,12683242,0,206664537
H1|chr1:219532139-219532200,chr1,219532139,219532200,H1|chr1:214452008-214452080,chr1,214452008,214452080,0,5080131
H1|chr1:219772170-219772240,chr1,219772170,219772240,H1|chr1:149671939-149672016,chr1,149671939,149672016,0,70100231
H1|chr1:220572515-220572625,chr1,220572515,220572625,H1|chr1:26757405-26757470,chr1,26757405,26757470,0,193815110
H1|chr1:220845981-220846070,chr1,220845981,220846070,H1|chr1:36024278-36024312,chr1,36024278,36024312,0,184821703
H1|chr1:221263414-221263476,chr1,221263414,221263476,H1|chr1:62664559-62664647,chr1,62664559,62664647,0,158598855
H1|chr1:221305664-221305686,chr1,221305664,221305686,H1|chr1:213034341-213034487,chr1,213034341,213034487,0,8271323
H1|chr1:221565004-221565103,chr1,221565004,221565103,H1|chr1:229550204-229550252,chr1,229550204,229550252,0,7985200
H1|chr1:222713814-222713961,chr1,222713814,222713961,H1|chr1:6507186-6507238,chr1,6507186,6507238,0,216206628
H1|chr1:222765833-222765879,chr1,222765833,222765879,H1|chr1:51703507-51703545,chr1,51703507,51703545,0,171062326
H1|chr1:222769632-222769714,chr1,222769632,222769714,H1|chr1:27674714-27674801,chr1,27674714,27674801,0,195094918
H1|chr1:222892384-222892464,chr1,222892384,222892464,H1|chr1:149671946-149671972,chr1,149671946,149671972,0,73220438
H1|chr1:223176902-223176942,chr1,223176902,223176942,H1|chr1:229550210-229550314,chr1,229550210,229550314,0,6373308
H1|chr1:223207776-223207864,chr1,223207776,223207864,H1|chr1:173444379-173444431,chr1,173444379,173444431,0,49763397
H1|chr1:223235024-223235069,chr1,223235024,223235069,H1|chr1:27335516-27335579,chr1,27335516,27335579,0,195899508
H1|chr1:223243472-223243595,chr1,223243472,223243595,H1|chr1:148556783-148556810,chr1,148556783,148556810,0,74686689
H1|chr1:223812151-223812172,chr1,223812151,223812172,H1|chr1:27321384-27321502,chr1,27321384,27321502,0,196490767
H1|chr1:224014580-224014606,chr1,224014580,224014606,H1|chr1:149671927-149672002,chr1,149671927,149672002,0,74342653
H1|chr1:224067415-224067484,chr1,224067415,224067484,H1|chr1:52455857-52455889,chr1,52455857,52455889,0,171611558
H1|chr1:224076805-224076855,chr1,224076805,224076855,H1|chr1:178064476-178064626,chr1,178064476,178064626,0,46012329
H1|chr1:224165583-224165635,chr1,224165583,224165635,H1|chr1:939691-939766,chr1,939691,939766,0,223225892
H1|chr1:224597376-224597501,chr1,224597376,224597501,H1|chr1:62664146-62664170,chr1,62664146,62664170,0,161933230
H1|chr1:224818592-224818622,chr1,224818592,224818622,H1|chr1:27667660-27667780,chr1,27667660,27667780,0,197150932
H1|chr1:224829663-224829715,chr1,224829663,224829715,H1|chr1:178064476-178064626,chr1,178064476,178064626,0,46765187
H1|chr1:224880289-224880350,chr1,224880289,224880350,H1|chr1:12683157-12683242,chr1,12683157,12683242,0,212197132
H1|chr1:225012882-225012957,chr1,225012882,225012957,H1|chr1:1187426-1187484,chr1,1187426,1187484,0,223825456
H1|chr1:225055302-225055353,chr1,225055302,225055353,H1|chr1:247498083-247498154,chr1,247498083,247498154,0,22442781
H1|chr1:225230514-225230549,chr1,225230514,225230549,H1|chr1:229551298-229551369,chr1,229551298,229551369,0,4320784
H1|chr1:225458749-225458899,chr1,225458749,225458899,H1|chr1:149671924-149672028,chr1,149671924,149672028,0,75786825
H1|chr1:225787496-225787577,chr1,225787496,225787577,H1|chr1:213034451-213034520,chr1,213034451,213034520,0,12753045
H1|chr1:226006027-226006100,chr1,226006027,226006100,H1|chr1:39458209-39458286,chr1,39458209,39458286,0,186547818
H1|chr1:226088706-226088796,chr1,226088706,226088796,H1|chr1:62662226-62662269,chr1,62662226,62662269,0,163426480
H1|chr1:226238374-226238421,chr1,226238374,226238421,H1|chr1:27672171-27672199,chr1,27672171,27672199,0,198566203
H1|chr1:226533237-226533293,chr1,226533237,226533293,H1|chr1:33646320-33646421,chr1,33646320,33646421,0,192886917
H1|chr1:226975960-226976077,chr1,226975960,226976077,H1|chr1:148556612-148556762,chr1,148556612,148556762,0,78419348
H1|chr1:227105643-227105706,chr1,227105643,227105706,H1|chr1:16378499-16378601,chr1,16378499,16378601,0,210727144
H1|chr1:227185950-227186038,chr1,227185950,227186038,H1|chr1:173445244-173445306,chr1,173445244,173445306,0,53740706
H1|chr1:227264225-227264276,chr1,227264225,227264276,H1|chr1:200381594-200381631,chr1,200381594,200381631,0,26882631
H1|chr1:227535711-227535780,chr1,227535711,227535780,H1|chr1:27667660-27667780,chr1,27667660,27667780,0,199868051
H1|chr1:227811153-227811208,chr1,227811153,227811208,H1|chr1:150530600-150530664,chr1,150530600,150530664,0,77280553
H1|chr1:227994444-227994553,chr1,227994444,227994553,H1|chr1:62664118-62664180,chr1,62664118,62664180,0,165330326
H1|chr1:228248762-228248819,chr1,228248762,228248819,H1|chr1:150292114-150292143,chr1,150292114,150292143,0,77956648
H1|chr1:228543795-228543840,chr1,228543795,228543840,H1|chr1:12681167-12681215,chr1,12681167,12681215,0,215862628
H1|chr1:228864393-228864467,chr1,228864393,228864467,H1|chr1:173444950-173445006,chr1,173444950,173445006,0,55419443
H1|chr1:229059387-229059446,chr1,229059387,229059446,H1|chr1:17247206-17247240,chr1,17247206,17247240,0,211812181
H1|chr1:229238319-229238379,chr1,229238319,229238379,H1|chr1:9349991-9350074,chr1,9349991,9350074,0,219888328
H1|chr1:229331415-229331440,chr1,229331415,229331440,H1|chr1:11717545-11717695,chr1,11717545,11717695,0,217613870
H1|chr1:229364715-229364760,chr1,229364715,229364760,H1|chr1:12681167-12681215,chr1,12681167,12681215,0,216683548
H1|chr1:229589498-229589583,chr1,229589498,229589583,H1|chr1:154244253-154244300,chr1,154244253,154244300,0,75345245
H1|chr1:229660642-229660747,chr1,229660642,229660747,H1|chr1:229549899-229549944,chr1,229549899,229549944,0,110743
H1|chr1:229791482-229791514,chr1,229791482,229791514,H1|chr1:244998093-244998140,chr1,244998093,244998140,0,15206611
H1|chr1:230085477-230085553,chr1,230085477,230085553,H1|chr1:39326250-39326323,chr1,39326250,39326323,0,190759227
H1|chr1:230110240-230110277,chr1,230110240,230110277,H1|chr1:10005151-10005300,chr1,10005151,10005300,0,220105089
H1|chr1:230110484-230110547,chr1,230110484,230110547,H1|chr1:229551314-229551370,chr1,229551314,229551370,0,559170
H1|chr1:230250298-230250330,chr1,230250298,230250330,H1|chr1:26756462-26756558,chr1,26756462,26756558,0,203493836
H1|chr1:230331680-230331761,chr1,230331680,230331761,H1|chr1:36920007-36920076,chr1,36920007,36920076,0,193411673
H1|chr1:230906552-230906579,chr1,230906552,230906579,H1|chr1:171455045-171455153,chr1,171455045,171455153,0,59451507
H1|chr1:230961442-230961524,chr1,230961442,230961524,H1|chr1:156644244-156644308,chr1,156644244,156644308,0,74317198
H1|chr1:230965912-230966011,chr1,230965912,230966011,H1|chr1:939705-939821,chr1,939705,939821,0,230026207
H1|chr1:231226290-231226384,chr1,231226290,231226384,H1|chr1:6507204-6507257,chr1,6507204,6507257,0,224719086
H1|chr1:232285611-232285718,chr1,232285611,232285718,H1|chr1:27321276-27321306,chr1,27321276,27321306,0,204964335
H1|chr1:232936247-232936278,chr1,232936247,232936278,H1|chr1:62664591-62664710,chr1,62664591,62664710,0,170271656
H1|chr1:233022025-233022087,chr1,233022025,233022087,H1|chr1:213120365-213120411,chr1,213120365,213120411,0,19901660
H1|chr1:233034284-233034310,chr1,233034284,233034310,H1|chr1:78442373-78442520,chr1,78442373,78442520,0,154591911
H1|chr1:233206311-233206392,chr1,233206311,233206392,H1|chr1:213034451-213034520,chr1,213034451,213034520,0,20171860
H1|chr1:233508980-233509114,chr1,233508980,233509114,H1|chr1:109757476-109757516,chr1,109757476,109757516,0,123751504
H1|chr1:233805806-233805929,chr1,233805806,233805929,H1|chr1:148556466-148556616,chr1,148556466,148556616,0,85249340
H1|chr1:233951523-233951630,chr1,233951523,233951630,H1|chr1:39488015-39488058,chr1,39488015,39488058,0,194463508
H1|chr1:234706907-234707054,chr1,234706907,234707054,H1|chr1:149671971-149672054,chr1,149671971,149672054,0,85034936
H1|chr1:234735433-234735490,chr1,234735433,234735490,H1|chr1:229549464-229549494,chr1,229549464,229549494,0,5185969
H1|chr1:234755944-234755983,chr1,234755944,234755983,H1|chr1:214453069-214453180,chr1,214453069,214453180,0,20302875
H1|chr1:234845554-234845642,chr1,234845554,234845642,H1|chr1:222883343-222883466,chr1,222883343,222883466,0,11962211
H1|chr1:235095353-235095405,chr1,235095353,235095405,H1|chr1:26756213-26756246,chr1,26756213,26756246,0,208339140
H1|chr1:235254047-235254110,chr1,235254047,235254110,H1|chr1:244998093-244998129,chr1,244998093,244998129,0,9744046
H1|chr1:235865110-235865162,chr1,235865110,235865162,H1|chr1:201944878-201944990,chr1,201944878,201944990,0,33920232
H1|chr1:236396211-236396289,chr1,236396211,236396289,H1|chr1:173445900-173445923,chr1,173445900,173445923,0,62950311
H1|chr1:236446471-236446556,chr1,236446471,236446556,H1|chr1:82265657-82265709,chr1,82265657,82265709,0,154180814
H1|chr1:236884586-236884736,chr1,236884586,236884736,H1|chr1:150292114-150292143,chr1,150292114,150292143,0,86592472
H1|chr1:237079656-237079716,chr1,237079656,237079716,H1|chr1:9349991-9350074,chr1,9349991,9350074,0,227729665
H1|chr1:237102861-237102962,chr1,237102861,237102962,H1|chr1:9649394-9649488,chr1,9649394,9649488,0,227453467
H1|chr1:237278542-237278586,chr1,237278542,237278586,H1|chr1:173441829-173441973,chr1,173441829,173441973,0,63836713
H1|chr1:237839159-237839212,chr1,237839159,237839212,H1|chr1:32402358-32402437,chr1,32402358,32402437,0,205436801
H1|chr1:237841415-237841442,chr1,237841415,237841442,H1|chr1:43425628-43425721,chr1,43425628,43425721,0,194415787
H1|chr1:237886017-237886074,chr1,237886017,237886074,H1|chr1:26757495-26757581,chr1,26757495,26757581,0,211128522
H1|chr1:238231054-238231105,chr1,238231054,238231105,H1|chr1:247498083-247498154,chr1,247498083,247498154,0,9267029
H1|chr1:238334919-238334951,chr1,238334919,238334951,H1|chr1:2510000-2510114,chr1,2510000,2510114,0,235824919
H1|chr1:238768189-238768208,chr1,238768189,238768208,H1|chr1:151434320-151434433,chr1,151434320,151434433,0,87333869
H1|chr1:239028290-239028322,chr1,239028290,239028322,H1|chr1:113496707-113496769,chr1,113496707,113496769,0,125531583
H1|chr1:239127670-239127716,chr1,239127670,239127716,H1|chr1:62664287-62664370,chr1,62664287,62664370,0,176463383
H1|chr1:239168476-239168525,chr1,239168476,239168525,H1|chr1:247499480-247499581,chr1,247499480,247499581,0,8331004
H1|chr1:239434776-239434859,chr1,239434776,239434859,H1|chr1:173444991-173445040,chr1,173444991,173445040,0,65989785
H1|chr1:239622992-239623070,chr1,239622992,239623070,H1|chr1:62664118-62664190,chr1,62664118,62664190,0,176958874
H1|chr1:239863384-239863421,chr1,239863384,239863421,H1|chr1:10005151-10005300,chr1,10005151,10005300,0,229858233
H1|chr1:239959699-239959818,chr1,239959699,239959818,H1|chr1:173836043-173836074,chr1,173836043,173836074,0,66123656
H1|chr1:240277809-240277885,chr1,240277809,240277885,H1|chr1:27321601-27321624,chr1,27321601,27321624,0,212956208
H1|chr1:240812431-240812466,chr1,240812431,240812466,H1|chr1:39490404-39490554,chr1,39490404,39490554,0,201322027
H1|chr1:240828442-240828524,chr1,240828442,240828524,H1|chr1:229551057-229551115,chr1,229551057,229551115,0,11277385
H1|chr1:240857660-240857727,chr1,240857660,240857727,H1|chr1:11726636-11726745,chr1,11726636,11726745,0,229131024
H1|chr1:240984546-240984595,chr1,240984546,240984595,H1|chr1:247499480-247499581,chr1,247499480,247499581,0,6514934
H1|chr1:241429878-241429935,chr1,241429878,241429935,H1|chr1:229548719-229548777,chr1,229548719,229548777,0,11881159
H1|chr1:241524500-241524561,chr1,241524500,241524561,H1|chr1:27667332-27667371,chr1,27667332,27667371,0,213857168
H1|chr1:242016099-242016195,chr1,242016099,242016195,H1|chr1:213033330-213033480,chr1,213033330,213033480,0,28982769
H1|chr1:242305043-242305094,chr1,242305043,242305094,H1|chr1:200381594-200381631,chr1,200381594,200381631,0,41923449
H1|chr1:242324620-242324651,chr1,242324620,242324651,H1|chr1:244998093-244998129,chr1,244998093,244998129,0,2673473
H1|chr1:243430385-243430403,chr1,243430385,243430403,H1|chr1:161736497-161736591,chr1,161736497,161736591,0,81693888
H1|chr1:243788056-243788092,chr1,243788056,243788092,H1|chr1:233433698-233433809,chr1,233433698,233433809,0,10354358
H1|chr1:243998593-243998740,chr1,243998593,243998740,H1|chr1:17243646-17243793,chr1,17243646,17243793,0,226754947
H1|chr1:244273235-244273326,chr1,244273235,244273326,H1|chr1:43425525-43425582,chr1,43425525,43425582,0,200847710
H1|chr1:244500136-244500216,chr1,244500136,244500216,H1|chr1:26756269-26756338,chr1,26756269,26756338,0,217743867
H1|chr1:245035462-245035526,chr1,245035462,245035526,H1|chr1:43421862-43421996,chr1,43421862,43421996,0,201613600
H1|chr1:245080626-245080692,chr1,245080626,245080692,H1|chr1:182762122-182762206,chr1,182762122,182762206,0,62318504
H1|chr1:245157315-245157395,chr1,245157315,245157395,H1|chr1:44818973-44819006,chr1,44818973,44819006,0,200338342
H1|chr1:245246754-245246792,chr1,245246754,245246792,H1|chr1:120255826-120255892,chr1,120255826,120255892,0,124990928
H1|chr1:245645911-245645948,chr1,245645911,245645948,H1|chr1:229550284-229550397,chr1,229550284,229550397,0,16095627
H1|chr1:246381228-246381297,chr1,246381228,246381297,H1|chr1:245025639-245025692,chr1,245025639,245025692,0,1355589
H1|chr1:246613202-246613275,chr1,246613202,246613275,H1|chr1:225964104-225964236,chr1,225964104,225964236,0,20649098
H1|chr1:246739527-246739637,chr1,246739527,246739637,H1|chr1:173445002-173445038,chr1,173445002,173445038,0,73294525
H1|chr1:246785532-246785641,chr1,246785532,246785641,H1|chr1:156645604-156645633,chr1,156645604,156645633,0,90139928
H1|chr1:247243902-247244020,chr1,247243902,247244020,H1|chr1:173836043-173836074,chr1,173836043,173836074,0,73407859
H1|chr1:247306563-247306598,chr1,247306563,247306598,H1|chr1:40205399-40205531,chr1,40205399,40205531,0,207101164
H1|chr1:247323083-247323106,chr1,247323083,247323106,H1|chr1:1362779-1362847,chr1,1362779,1362847,0,245960304
H1|chr1:247560011-247560123,chr1,247560011,247560123,H1|chr1:62663255-62663293,chr1,62663255,62663293,0,184896756
H1|chr1:247659391-247659460,chr1,247659391,247659460,H1|chr1:62661636-62661714,chr1,62661636,62661714,0,184997755
H1|chr1:247797674-247797698,chr1,247797674,247797698,H1|chr1:156676445-156676571,chr1,156676445,156676571,0,91121229
H1|chr1:248117132-248117155,chr1,248117132,248117155,H1|chr1:244998093-244998170,chr1,244998093,244998170,0,3119039
H1|chr1:248617436-248617490,chr1,248617436,248617490,H1|chr1:2134364-2134384,chr1,2134364,2134384,0,246483072
H1|chr1:248647018-248647079,chr1,248647018,248647079,H1|chr1:26757495-26757581,chr1,26757495,26757581,0,221889523
H1|chr1:248809923-248810042,chr1,248809923,248810042,H1|chr1:57111896-57111925,chr1,57111896,57111925,0,191698027
H1|chr1:248844241-248844279,chr1,248844241,248844279,H1|chr1:173445833-173445910,chr1,173445833,173445910,0,75398408
H1|chr1:249166760-249166871,chr1,249166760,249166871,H1|chr1:149671927-149671966,chr1,149671927,149671966,0,99494833
H1|chr2:572155-572196,chr2,572155,572196,H1|chr2:233254604-233254653,chr2,233254604,233254653,0,232682449
H1|chr2:756533-756566,chr2,756533,756566,H1|chr2:44390032-44390104,chr2,44390032,44390104,0,43633499
H1|chr2:1249625-1249653,chr2,1249625,1249653,H1|chr2:85195737-85195843,chr2,85195737,85195843,0,83946112
H1|chr2:2292418-2292442,chr2,2292418,2292442,H1|chr2:64071696-64071819,chr2,64071696,64071819,0,61779278
H1|chr2:2572613-2572717,chr2,2572613,2572717,H1|chr2:85196544-85196596,chr2,85196544,85196596,0,82623931
H1|chr2:3785182-3785246,chr2,3785182,3785246,H1|chr2:74228466-74228549,chr2,74228466,74228549,0,70443284
H1|chr2:3854279-3854418,chr2,3854279,3854418,H1|chr2:64073001-64073039,chr2,64073001,64073039,0,60218722
H1|chr2:4196879-4196912,chr2,4196879,4196912,H1|chr2:44390016-44390099,chr2,44390016,44390099,0,40193137
H1|chr2:4312632-4312685,chr2,4312632,4312685,H1|chr2:210868185-210868236,chr2,210868185,210868236,0,206555553
H1|chr2:4324612-4324697,chr2,4324612,4324697,H1|chr2:85195468-85195499,chr2,85195468,85195499,0,80870856
H1|chr2:4375676-4375765,chr2,4375676,4375765,H1|chr2:85193754-85193796,chr2,85193754,85193796,0,80818078
H1|chr2:5856249-5856347,chr2,5856249,5856347,H1|chr2:85193425-85193520,chr2,85193425,85193520,0,79337176
H1|chr2:6000437-6000538,chr2,6000437,6000538,H1|chr2:100105776-100105803,chr2,100105776,100105803,0,94105339
H1|chr2:8694520-8694654,chr2,8694520,8694654,H1|chr2:64079813-64079834,chr2,64079813,64079834,0,55385293
H1|chr2:8751867-8751921,chr2,8751867,8751921,H1|chr2:96873342-96873400,chr2,96873342,96873400,0,88121475
H1|chr2:9057949-9057973,chr2,9057949,9057973,H1|chr2:20549380-20549445,chr2,20549380,20549445,0,11491431
H1|chr2:9283850-9283930,chr2,9283850,9283930,H1|chr2:56151467-56151534,chr2,56151467,56151534,0,46867617
H1|chr2:9378552-9378609,chr2,9378552,9378609,H1|chr2:216975430-216975483,chr2,216975430,216975483,0,207596878
H1|chr2:9672604-9672655,chr2,9672604,9672655,H1|chr2:85195048-85195118,chr2,85195048,85195118,0,75522444
H1|chr2:9984500-9984563,chr2,9984500,9984563,H1|chr2:68477743-68477794,chr2,68477743,68477794,0,58493243
H1|chr2:10811478-10811538,chr2,10811478,10811538,H1|chr2:101619972-101620051,chr2,101619972,101620051,0,90808494
H1|chr2:11513129-11513170,chr2,11513129,11513170,H1|chr2:233254604-233254653,chr2,233254604,233254653,0,221741475
H1|chr2:11565179-11565232,chr2,11565179,11565232,H1|chr2:219645846-219645940,chr2,219645846,219645940,0,208080667
H1|chr2:11584455-11584544,chr2,11584455,11584544,H1|chr2:198367061-198367119,chr2,198367061,198367119,0,186782606
H1|chr2:12055577-12055619,chr2,12055577,12055619,H1|chr2:3626877-3626913,chr2,3626877,3626913,0,8428700
H1|chr2:12347439-12347529,chr2,12347439,12347529,H1|chr2:201977034-201977094,chr2,201977034,201977094,0,189629595
H1|chr2:13416298-13416328,chr2,13416298,13416328,H1|chr2:85196099-85196199,chr2,85196099,85196199,0,71779801
H1|chr2:13460244-13460271,chr2,13460244,13460271,H1|chr2:161348906-161348982,chr2,161348906,161348982,0,147888662
H1|chr2:14084548-14084663,chr2,14084548,14084663,H1|chr2:25047649-25047727,chr2,25047649,25047727,0,10963101
H1|chr2:14403474-14403562,chr2,14403474,14403562,H1|chr2:85196544-85196596,chr2,85196544,85196596,0,70793070
H1|chr2:14970650-14970751,chr2,14970650,14970751,H1|chr2:55500209-55500245,chr2,55500209,55500245,0,40529559
H1|chr2:16054800-16054832,chr2,16054800,16054832,H1|chr2:64075685-64075783,chr2,64075685,64075783,0,48020885
H1|chr2:16326068-16326150,chr2,16326068,16326150,H1|chr2:233256439-233256485,chr2,233256439,233256485,0,216930371
H1|chr2:16377189-16377237,chr2,16377189,16377237,H1|chr2:56154642-56154705,chr2,56154642,56154705,0,39777453
H1|chr2:16400304-16400355,chr2,16400304,16400355,H1|chr2:85199583-85199633,chr2,85199583,85199633,0,68799279
H1|chr2:16737434-16737584,chr2,16737434,16737584,H1|chr2:74230236-74230363,chr2,74230236,74230363,0,57492802
H1|chr2:16865540-16865585,chr2,16865540,16865585,H1|chr2:85197430-85197535,chr2,85197430,85197535,0,68331890
H1|chr2:17461362-17461394,chr2,17461362,17461394,H1|chr2:233255829-233255947,chr2,233255829,233255947,0,215794467
H1|chr2:17528039-17528084,chr2,17528039,17528084,H1|chr2:56154642-56154705,chr2,56154642,56154705,0,38626603
H1|chr2:18733064-18733083,chr2,18733064,18733083,H1|chr2:12860158-12860259,chr2,12860158,12860259,0,5872906
H1|chr2:18784393-18784429,chr2,18784393,18784429,H1|chr2:233562214-233562328,chr2,233562214,233562328,0,214777821
H1|chr2:19181329-19181358,chr2,19181329,19181358,H1|chr2:85194817-85194967,chr2,85194817,85194967,0,66013488
H1|chr2:21062046-21062141,chr2,21062046,21062141,H1|chr2:85193598-85193710,chr2,85193598,85193710,0,64131552
H1|chr2:23360623-23360647,chr2,23360623,23360647,H1|chr2:9145767-9145825,chr2,9145767,9145825,0,14214856
H1|chr2:25510256-25510322,chr2,25510256,25510322,H1|chr2:85767287-85767337,chr2,85767287,85767337,0,60257031
H1|chr2:25876035-25876068,chr2,25876035,25876068,H1|chr2:85193344-85193397,chr2,85193344,85193397,0,59317309
H1|chr2:26057777-26057850,chr2,26057777,26057850,H1|chr2:26257871-26257948,chr2,26257871,26257948,0,200094
H1|chr2:26390738-26390782,chr2,26390738,26390782,H1|chr2:26986715-26986795,chr2,26986715,26986795,0,595977
H1|chr2:26912116-26912206,chr2,26912116,26912206,H1|chr2:73052535-73052569,chr2,73052535,73052569,0,46140419
H1|chr2:27411501-27411543,chr2,27411501,27411543,H1|chr2:232324310-232324395,chr2,232324310,232324395,0,204912809
H1|chr2:27684331-27684370,chr2,27684331,27684370,H1|chr2:220429367-220429425,chr2,220429367,220429425,0,192745036
H1|chr2:28829487-28829591,chr2,28829487,28829591,H1|chr2:85196544-85196596,chr2,85196544,85196596,0,56367057
H1|chr2:29021182-29021202,chr2,29021182,29021202,H1|chr2:219645846-219645936,chr2,219645846,219645936,0,190624664
H1|chr2:29377076-29377157,chr2,29377076,29377157,H1|chr2:219523093-219523133,chr2,219523093,219523133,0,190146017
H1|chr2:29543541-29543563,chr2,29543541,29543563,H1|chr2:74404195-74404344,chr2,74404195,74404344,0,44860654
H1|chr2:30451556-30451595,chr2,30451556,30451595,H1|chr2:64078995-64079070,chr2,64078995,64079070,0,33627439
H1|chr2:30900828-30900884,chr2,30900828,30900884,H1|chr2:121491941-121492085,chr2,121491941,121492085,0,90591113
H1|chr2:34725280-34725318,chr2,34725280,34725318,H1|chr2:96873342-96873400,chr2,96873342,96873400,0,62148062
H1|chr2:34755107-34755127,chr2,34755107,34755127,H1|chr2:74404195-74404344,chr2,74404195,74404344,0,39649088
H1|chr2:35093633-35093674,chr2,35093633,35093674,H1|chr2:27602472-27602529,chr2,27602472,27602529,0,7491161
H1|chr2:36240259-36240325,chr2,36240259,36240325,H1|chr2:64077889-64077925,chr2,64077889,64077925,0,27837630
H1|chr2:36334063-36334088,chr2,36334063,36334088,H1|chr2:20549340-20549446,chr2,20549340,20549446,0,15784723
H1|chr2:36734997-36735095,chr2,36734997,36735095,H1|chr2:85193425-85193520,chr2,85193425,85193520,0,48458428
H1|chr2:36797751-36797783,chr2,36797751,36797783,H1|chr2:75937290-75937384,chr2,75937290,75937384,0,39139539
H1|chr2:37962317-37962417,chr2,37962317,37962417,H1|chr2:36584988-36585056,chr2,36584988,36585056,0,1377329
H1|chr2:38924630-38924666,chr2,38924630,38924666,H1|chr2:232576700-232576795,chr2,232576700,232576795,0,193652070
H1|chr2:39428420-39428467,chr2,39428420,39428467,H1|chr2:48758191-48758263,chr2,48758191,48758263,0,9329771
H1|chr2:39922159-39922237,chr2,39922159,39922237,H1|chr2:198367061-198367119,chr2,198367061,198367119,0,158444902
H1|chr2:41411008-41411097,chr2,41411008,41411097,H1|chr2:85193754-85193796,chr2,85193754,85193796,0,43782746
H1|chr2:41450022-41450101,chr2,41450022,41450101,H1|chr2:242637941-242637971,chr2,242637941,242637971,0,201187919
H1|chr2:42213690-42213719,chr2,42213690,42213719,H1|chr2:85197100-85197191,chr2,85197100,85197191,0,42983410
H1|chr2:43365139-43365160,chr2,43365139,43365160,H1|chr2:239331447-239331569,chr2,239331447,239331569,0,195966308
H1|chr2:45289525-45289552,chr2,45289525,45289552,H1|chr2:85197100-85197191,chr2,85197100,85197191,0,39907575
H1|chr2:45480165-45480206,chr2,45480165,45480206,H1|chr2:85195165-85195274,chr2,85195165,85195274,0,39715000
H1|chr2:45635542-45635605,chr2,45635542,45635605,H1|chr2:68477743-68477794,chr2,68477743,68477794,0,22842201
H1|chr2:46150978-46151071,chr2,46150978,46151071,H1|chr2:85195165-85195274,chr2,85195165,85195274,0,39044187
H1|chr2:46321010-46321067,chr2,46321010,46321067,H1|chr2:63853479-63853556,chr2,63853479,63853556,0,17532469
H1|chr2:46819640-46819678,chr2,46819640,46819678,H1|chr2:61296130-61296185,chr2,61296130,61296185,0,14476490
H1|chr2:47531864-47531888,chr2,47531864,47531888,H1|chr2:9145767-9145825,chr2,9145767,9145825,0,38386097
H1|chr2:47882190-47882209,chr2,47882190,47882209,H1|chr2:85195503-85195634,chr2,85195503,85195634,0,37313313
H1|chr2:48654040-48654059,chr2,48654040,48654059,H1|chr2:74227193-74227231,chr2,74227193,74227231,0,25573153
H1|chr2:49190060-49190093,chr2,49190060,49190093,H1|chr2:44390032-44390104,chr2,44390032,44390104,0,4800028
H1|chr2:49513783-49513824,chr2,49513783,49513824,H1|chr2:37192803-37192828,chr2,37192803,37192828,0,12320980
H1|chr2:51048388-51048455,chr2,51048388,51048455,H1|chr2:85194536-85194626,chr2,85194536,85194626,0,34146148
H1|chr2:52598673-52598695,chr2,52598673,52598695,H1|chr2:74404195-74404344,chr2,74404195,74404344,0,21805522
H1|chr2:52619099-52619128,chr2,52619099,52619128,H1|chr2:64070923-64070997,chr2,64070923,64070997,0,11451824
H1|chr2:53047935-53047998,chr2,53047935,53047998,H1|chr2:216877634-216877718,chr2,216877634,216877718,0,163829699
H1|chr2:53095153-53095171,chr2,53095153,53095171,H1|chr2:85194170-85194315,chr2,85194170,85194315,0,32099017
H1|chr2:53848299-53848325,chr2,53848299,53848325,H1|chr2:171783562-171783683,chr2,171783562,171783683,0,117935263
H1|chr2:54062798-54062866,chr2,54062798,54062866,H1|chr2:85197005-85197076,chr2,85197005,85197076,0,31134207
H1|chr2:54651540-54651597,chr2,54651540,54651597,H1|chr2:37192803-37192828,chr2,37192803,37192828,0,17458737
H1|chr2:55700349-55700374,chr2,55700349,55700374,H1|chr2:75937290-75937384,chr2,75937290,75937384,0,20236941
H1|chr2:55988096-55988158,chr2,55988096,55988158,H1|chr2:201980227-201980372,chr2,201980227,201980372,0,145992131
H1|chr2:56721538-56721565,chr2,56721538,56721565,H1|chr2:64074765-64074836,chr2,64074765,64074836,0,7353227
H1|chr2:58329026-58329111,chr2,58329026,58329111,H1|chr2:85193927-85193953,chr2,85193927,85193953,0,26864901
H1|chr2:59657928-59658013,chr2,59657928,59658013,H1|chr2:64078378-64078516,chr2,64078378,64078516,0,4420450
H1|chr2:59812498-59812543,chr2,59812498,59812543,H1|chr2:56154642-56154705,chr2,56154642,56154705,0,3657856
H1|chr2:61388906-61388929,chr2,61388906,61388929,H1|chr2:121011482-121011513,chr2,121011482,121011513,0,59622576
H1|chr2:62076234-62076306,chr2,62076234,62076306,H1|chr2:171782654-171782702,chr2,171782654,171782702,0,109706420
H1|chr2:62286370-62286440,chr2,62286370,62286440,H1|chr2:160472120-160472198,chr2,160472120,160472198,0,98185750
H1|chr2:62577960-62577980,chr2,62577960,62577980,H1|chr2:121011482-121011513,chr2,121011482,121011513,0,58433522
H1|chr2:62801589-62801631,chr2,62801589,62801631,H1|chr2:239331035-239331171,chr2,239331035,239331171,0,176529446
H1|chr2:62953967-62954006,chr2,62953967,62954006,H1|chr2:64066619-64066683,chr2,64066619,64066683,0,1112652
H1|chr2:63062359-63062437,chr2,63062359,63062437,H1|chr2:198367061-198367119,chr2,198367061,198367119,0,135304702
H1|chr2:63999165-63999230,chr2,63999165,63999230,H1|chr2:201173096-201173156,chr2,201173096,201173156,0,137173931
H1|chr2:63999189-63999282,chr2,63999189,63999282,H1|chr2:85193754-85193796,chr2,85193754,85193796,0,21194565
H1|chr2:64210235-64210331,chr2,64210235,64210331,H1|chr2:64370258-64370312,chr2,64370258,64370312,0,160023
H1|chr2:64908047-64908140,chr2,64908047,64908140,H1|chr2:85195165-85195274,chr2,85195165,85195274,0,20287118
H1|chr2:65451862-65451978,chr2,65451862,65451978,H1|chr2:85197069-85197098,chr2,85197069,85197098,0,19745207
H1|chr2:65530467-65530511,chr2,65530467,65530511,H1|chr2:85195789-85195929,chr2,85195789,85195929,0,19665322
H1|chr2:65644111-65644192,chr2,65644111,65644192,H1|chr2:216975430-216975483,chr2,216975430,216975483,0,151331319
H1|chr2:67023229-67023319,chr2,67023229,67023319,H1|chr2:73052535-73052569,chr2,73052535,73052569,0,6029306
H1|chr2:67799824-67799973,chr2,67799824,67799973,H1|chr2:86949632-86949780,chr2,86949632,86949780,0,19149808
H1|chr2:68147332-68147414,chr2,68147332,68147414,H1|chr2:55495140-55495208,chr2,55495140,55495208,0,12652192
H1|chr2:68578699-68578788,chr2,68578699,68578788,H1|chr2:198367061-198367119,chr2,198367061,198367119,0,129788362
H1|chr2:69004713-69004758,chr2,69004713,69004758,H1|chr2:48758191-48758263,chr2,48758191,48758263,0,20246522
H1|chr2:69798065-69798155,chr2,69798065,69798155,H1|chr2:201977034-201977094,chr2,201977034,201977094,0,132178969
H1|chr2:69881145-69881244,chr2,69881145,69881244,H1|chr2:85193996-85194033,chr2,85193996,85194033,0,15312851
H1|chr2:69978131-69978154,chr2,69978131,69978154,H1|chr2:233255849-233255907,chr2,233255849,233255907,0,163277718
H1|chr2:70590230-70590272,chr2,70590230,70590272,H1|chr2:176032563-176032624,chr2,176032563,176032624,0,105442333
H1|chr2:70823303-70823342,chr2,70823303,70823342,H1|chr2:61296130-61296185,chr2,61296130,61296185,0,9527173
H1|chr2:71342627-71342680,chr2,71342627,71342680,H1|chr2:210868185-210868236,chr2,210868185,210868236,0,139525558
H1|chr2:73965499-73965532,chr2,73965499,73965532,H1|chr2:44390016-44390099,chr2,44390016,44390099,0,29575483
H1|chr2:74147399-74147489,chr2,74147399,74147489,H1|chr2:44397944-44397966,chr2,44397944,44397966,0,29749455
H1|chr2:74296990-74297090,chr2,74296990,74297090,H1|chr2:85821149-85821199,chr2,85821149,85821199,0,11524159
H1|chr2:75041716-75041750,chr2,75041716,75041750,H1|chr2:85196941-85196996,chr2,85196941,85196996,0,10155225
H1|chr2:75598314-75598376,chr2,75598314,75598376,H1|chr2:85196099-85196199,chr2,85196099,85196199,0,9597785
H1|chr2:75677200-75677241,chr2,75677200,75677241,H1|chr2:37192803-37192828,chr2,37192803,37192828,0,38484397
H1|chr2:75865336-75865391,chr2,75865336,75865391,H1|chr2:85193996-85194033,chr2,85193996,85194033,0,9328660
H1|chr2:75904187-75904237,chr2,75904187,75904237,H1|chr2:121489886-121489939,chr2,121489886,121489939,0,45585699
H1|chr2:76078349-76078365,chr2,76078349,76078365,H1|chr2:232575357-232575507,chr2,232575357,232575507,0,156497008
H1|chr2:76311130-76311168,chr2,76311130,76311168,H1|chr2:219435070-219435136,chr2,219435070,219435136,0,143123940
H1|chr2:76477702-76477734,chr2,76477702,76477734,H1|chr2:77748360-77748402,chr2,77748360,77748402,0,1270658
H1|chr2:76574256-76574313,chr2,76574256,76574313,H1|chr2:63853479-63853556,chr2,63853479,63853556,0,12720777
H1|chr2:78033029-78033070,chr2,78033029,78033070,H1|chr2:27602472-27602529,chr2,27602472,27602529,0,50430557
H1|chr2:78132238-78132300,chr2,78132238,78132300,H1|chr2:201980227-201980372,chr2,201980227,201980372,0,123847989
H1|chr2:79050315-79050404,chr2,79050315,79050404,H1|chr2:73052535-73052569,chr2,73052535,73052569,0,5997780
H1|chr2:79817159-79817236,chr2,79817159,79817236,H1|chr2:242637941-242637971,chr2,242637941,242637971,0,162820782
H1|chr2:80178434-80178485,chr2,80178434,80178485,H1|chr2:85197430-85197535,chr2,85197430,85197535,0,5018996
H1|chr2:80653017-80653068,chr2,80653017,80653068,H1|chr2:85195048-85195118,chr2,85195048,85195118,0,4542031
H1|chr2:80964304-80964349,chr2,80964304,80964349,H1|chr2:85195503-85195634,chr2,85195503,85195634,0,4231199
H1|chr2:81414527-81414584,chr2,81414527,81414584,H1|chr2:37192803-37192828,chr2,37192803,37192828,0,44221724
H1|chr2:81857528-81857578,chr2,81857528,81857578,H1|chr2:151342517-151342616,chr2,151342517,151342616,0,69484989
H1|chr2:82037098-82037213,chr2,82037098,82037213,H1|chr2:25047649-25047727,chr2,25047649,25047727,0,56989449
H1|chr2:82236399-82236547,chr2,82236399,82236547,H1|chr2:85195480-85195504,chr2,85195480,85195504,0,2959081
H1|chr2:82929367-82929435,chr2,82929367,82929435,H1|chr2:77748360-77748395,chr2,77748360,77748395,0,5181007
H1|chr2:83144305-83144334,chr2,83144305,83144334,H1|chr2:64070923-64070997,chr2,64070923,64070997,0,19073382
H1|chr2:84048391-84048436,chr2,84048391,84048436,H1|chr2:189155953-189156058,chr2,189155953,189156058,0,105107562
H1|chr2:84809012-84809080,chr2,84809012,84809080,H1|chr2:85197005-85197076,chr2,85197005,85197076,0,387993
H1|chr2:84991100-84991206,chr2,84991100,84991206,H1|chr2:64369754-64369770,chr2,64369754,64369770,0,20621346
H1|chr2:85062997-85063029,chr2,85062997,85063029,H1|chr2:96873342-96873400,chr2,96873342,96873400,0,11810345
H1|chr2:85082735-85082835,chr2,85082735,85082835,H1|chr2:64066452-64066569,chr2,64066452,64066569,0,21016283
H1|chr2:85414144-85414190,chr2,85414144,85414190,H1|chr2:61764360-61764391,chr2,61764360,61764391,0,23649784
H1|chr2:85779577-85779630,chr2,85779577,85779630,H1|chr2:63851164-63851220,chr2,63851164,63851220,0,21928413
H1|chr2:87311763-87311784,chr2,87311763,87311784,H1|chr2:239331447-239331569,chr2,239331447,239331569,0,152019684
H1|chr2:87416088-87416141,chr2,87416088,87416141,H1|chr2:219645846-219645940,chr2,219645846,219645940,0,132229758
H1|chr2:87449083-87449191,chr2,87449083,87449191,H1|chr2:74230258-74230408,chr2,74230258,74230408,0,13218825
H1|chr2:87641267-87641333,chr2,87641267,87641333,H1|chr2:85767287-85767337,chr2,85767287,85767337,0,1873980
H1|chr2:88490984-88491060,chr2,88490984,88491060,H1|chr2:56151467-56151534,chr2,56151467,56151534,0,32339517
H1|chr2:88803989-88804097,chr2,88803989,88804097,H1|chr2:233562214-233562328,chr2,233562214,233562328,0,144758225
H1|chr2:89017957-89017986,chr2,89017957,89017986,H1|chr2:85194817-85194967,chr2,85194817,85194967,0,3823140
H1|chr2:89439582-89439636,chr2,89439582,89439636,H1|chr2:64370827-64370864,chr2,64370827,64370864,0,25068755
H1|chr2:89881047-89881162,chr2,89881047,89881162,H1|chr2:203102996-203103056,chr2,203102996,203103056,0,113221949
H1|chr2:90287534-90287573,chr2,90287534,90287573,H1|chr2:220429367-220429425,chr2,220429367,220429425,0,130141833
H1|chr2:90392454-90392490,chr2,90392454,90392490,H1|chr2:233562214-233562328,chr2,233562214,233562328,0,143169760
H1|chr2:90704456-90704528,chr2,90704456,90704528,H1|chr2:16084497-16084563,chr2,16084497,16084563,0,74619959
H1|chr2:91382338-91382453,chr2,91382338,91382453,H1|chr2:203102996-203103056,chr2,203102996,203103056,0,111720658
H1|chr2:91653114-91653144,chr2,91653114,91653144,H1|chr2:85196099-85196199,chr2,85196099,85196199,0,6457015
H1|chr2:94031396-94031443,chr2,94031396,94031443,H1|chr2:64069624-64069712,chr2,64069624,64069712,0,29961772
H1|chr2:95561068-95561154,chr2,95561068,95561154,H1|chr2:64076404-64076433,chr2,64076404,64076433,0,31484664
H1|chr2:95647489-95647517,chr2,95647489,95647517,H1|chr2:85193643-85193765,chr2,85193643,85193765,0,10453846
H1|chr2:95838011-95838079,chr2,95838011,95838079,H1|chr2:85194082-85194152,chr2,85194082,85194152,0,10643929
H1|chr2:96057787-96057873,chr2,96057787,96057873,H1|chr2:85193927-85193953,chr2,85193927,85193953,0,10863860
H1|chr2:96267099-96267159,chr2,96267099,96267159,H1|chr2:85195377-85195474,chr2,85195377,85195474,0,11071722
H1|chr2:96319479-96319629,chr2,96319479,96319629,H1|chr2:85197069-85197098,chr2,85197069,85197098,0,11122410
H1|chr2:96667479-96667545,chr2,96667479,96667545,H1|chr2:85194082-85194152,chr2,85194082,85194152,0,11473397
H1|chr2:96824103-96824145,chr2,96824103,96824145,H1|chr2:232324310-232324395,chr2,232324310,232324395,0,135500207
H1|chr2:97707118-97707165,chr2,97707118,97707165,H1|chr2:171783562-171783683,chr2,171783562,171783683,0,74076444
H1|chr2:98060756-98060870,chr2,98060756,98060870,H1|chr2:85196780-85196809,chr2,85196780,85196809,0,12863976
H1|chr2:98117852-98117934,chr2,98117852,98117934,H1|chr2:85194127-85194213,chr2,85194127,85194213,0,12923725
H1|chr2:98763381-98763407,chr2,98763381,98763407,H1|chr2:85195733-85195843,chr2,85195733,85195843,0,13567648
H1|chr2:100491153-100491193,chr2,100491153,100491193,H1|chr2:176032563-176032624,chr2,176032563,176032624,0,75541410
H1|chr2:101741371-101741439,chr2,101741371,101741439,H1|chr2:85194082-85194152,chr2,85194082,85194152,0,16547289
H1|chr2:102028525-102028580,chr2,102028525,102028580,H1|chr2:85193425-85193520,chr2,85193425,85193520,0,16835100
H1|chr2:102705587-102705616,chr2,102705587,102705616,H1|chr2:85197100-85197191,chr2,85197100,85197191,0,17508487
H1|chr2:103393828-103393872,chr2,103393828,103393872,H1|chr2:37192803-37192827,chr2,37192803,37192827,0,66201025
H1|chr2:103964347-103964387,chr2,103964347,103964387,H1|chr2:85199608-85199713,chr2,85199608,85199713,0,18764739
H1|chr2:104314623-104314661,chr2,104314623,104314661,H1|chr2:85193598-85193710,chr2,85193598,85193710,0,19121025
H1|chr2:104514586-104514624,chr2,104514586,104514624,H1|chr2:85193598-85193710,chr2,85193598,85193710,0,19320988
H1|chr2:105411846-105411922,chr2,105411846,105411922,H1|chr2:242637941-242637971,chr2,242637941,242637971,0,137226095
H1|chr2:108792064-108792137,chr2,108792064,108792137,H1|chr2:26257871-26257948,chr2,26257871,26257948,0,82534193
H1|chr2:109233075-109233158,chr2,109233075,109233158,H1|chr2:170551530-170551594,chr2,170551530,170551594,0,61318455
H1|chr2:110616851-110616877,chr2,110616851,110616877,H1|chr2:85195733-85195843,chr2,85195733,85195843,0,25421118
H1|chr2:110716595-110716640,chr2,110716595,110716640,H1|chr2:85195503-85195634,chr2,85195503,85195634,0,25521092
H1|chr2:110958770-110958919,chr2,110958770,110958919,H1|chr2:86949632-86949780,chr2,86949632,86949780,0,24009138
H1|chr2:111123952-111123990,chr2,111123952,111123990,H1|chr2:220429367-220429425,chr2,220429367,220429425,0,109305415
H1|chr2:111135188-111135240,chr2,111135188,111135240,H1|chr2:121492831-121492880,chr2,121492831,121492880,0,10357643
H1|chr2:111990535-111990585,chr2,111990535,111990585,H1|chr2:151342517-151342616,chr2,151342517,151342616,0,39351982
H1|chr2:112144028-112144094,chr2,112144028,112144094,H1|chr2:160472120-160472198,chr2,160472120,160472198,0,48328092
H1|chr2:112262565-112262618,chr2,112262565,112262618,H1|chr2:63851164-63851220,chr2,63851164,63851220,0,48411401
H1|chr2:113271086-113271215,chr2,113271086,113271215,H1|chr2:64079813-64079834,chr2,64079813,64079834,0,49191273
H1|chr2:114510485-114510510,chr2,114510485,114510510,H1|chr2:75937290-75937384,chr2,75937290,75937384,0,38573195
H1|chr2:115607584-115607609,chr2,115607584,115607609,H1|chr2:9145767-9145825,chr2,9145767,9145825,0,106461817
H1|chr2:116448305-116448344,chr2,116448305,116448344,H1|chr2:61296130-61296185,chr2,61296130,61296185,0,55152175
H1|chr2:116702193-116702295,chr2,116702193,116702295,H1|chr2:64370258-64370312,chr2,64370258,64370312,0,52331935
H1|chr2:118925549-118925631,chr2,118925549,118925631,H1|chr2:55495140-55495208,chr2,55495140,55495208,0,63430409
H1|chr2:119258123-119258148,chr2,119258123,119258148,H1|chr2:20549340-20549446,chr2,20549340,20549446,0,98708783
H1|chr2:120139442-120139515,chr2,120139442,120139515,H1|chr2:85197461-85197559,chr2,85197461,85197559,0,34941981
H1|chr2:120246003-120246035,chr2,120246003,120246035,H1|chr2:77748360-77748402,chr2,77748360,77748402,0,42497643
H1|chr2:120844141-120844183,chr2,120844141,120844183,H1|chr2:176032563-176032624,chr2,176032563,176032624,0,55188422
H1|chr2:121118561-121118629,chr2,121118561,121118629,H1|chr2:171782400-171782443,chr2,171782400,171782443,0,50663839
H1|chr2:121311228-121311281,chr2,121311228,121311281,H1|chr2:85196063-85196142,chr2,85196063,85196142,0,36115165
H1|chr2:122334738-122334833,chr2,122334738,122334833,H1|chr2:85193598-85193710,chr2,85193598,85193710,0,37141140
H1|chr2:122947683-122947739,chr2,122947683,122947739,H1|chr2:3626569-3626719,chr2,3626569,3626719,0,119321114
H1|chr2:123076750-123076783,chr2,123076750,123076783,H1|chr2:85193344-85193397,chr2,85193344,85193397,0,37883406
H1|chr2:123084297-123084335,chr2,123084297,123084335,H1|chr2:85767259-85767322,chr2,85767259,85767322,0,37317038
H1|chr2:123231595-123231707,chr2,123231595,123231707,H1|chr2:64073001-64073039,chr2,64073001,64073039,0,59158594
H1|chr2:123494391-123494427,chr2,123494391,123494427,H1|chr2:85195030-85195071,chr2,85195030,85195071,0,38299361
H1|chr2:124843450-124843490,chr2,124843450,124843490,H1|chr2:85199608-85199713,chr2,85199608,85199713,0,39643842
H1|chr2:126619554-126619622,chr2,126619554,126619622,H1|chr2:171782400-171782443,chr2,171782400,171782443,0,45162846
H1|chr2:127042873-127043023,chr2,127042873,127043023,H1|chr2:85197069-85197098,chr2,85197069,85197098,0,41845804
H1|chr2:127140677-127140806,chr2,127140677,127140806,H1|chr2:64079813-64079834,chr2,64079813,64079834,0,63060864
H1|chr2:128008507-128008527,chr2,128008507,128008527,H1|chr2:121011482-121011513,chr2,121011482,121011513,0,6997025
H1|chr2:128248808-128248904,chr2,128248808,128248904,H1|chr2:85196063-85196142,chr2,85196063,85196142,0,43052745
H1|chr2:128999999-129000018,chr2,128999999,129000018,H1|chr2:74227193-74227231,chr2,74227193,74227231,0,54772806
H1|chr2:129410742-129410827,chr2,129410742,129410827,H1|chr2:64078378-64078516,chr2,64078378,64078516,0,65332364
H1|chr2:130648053-130648094,chr2,130648053,130648094,H1|chr2:85195165-85195274,chr2,85195165,85195274,0,45452888
H1|chr2:130695022-130695056,chr2,130695022,130695056,H1|chr2:85193344-85193397,chr2,85193344,85193397,0,45501678
H1|chr2:130948067-130948150,chr2,130948067,130948150,H1|chr2:170551530-170551594,chr2,170551530,170551594,0,39603463
H1|chr2:132577748-132577822,chr2,132577748,132577822,H1|chr2:26257868-26257944,chr2,26257868,26257944,0,106319880
H1|chr2:133166996-133167084,chr2,133166996,133167084,H1|chr2:85196544-85196596,chr2,85196544,85196596,0,47970452
H1|chr2:133921706-133921725,chr2,133921706,133921725,H1|chr2:85195503-85195634,chr2,85195503,85195634,0,48726203
H1|chr2:133972887-133972988,chr2,133972887,133972988,H1|chr2:74226838-74226869,chr2,74226838,74226869,0,59746049
H1|chr2:134002956-134003030,chr2,134002956,134003030,H1|chr2:26257868-26257944,chr2,26257868,26257944,0,107745088
H1|chr2:134041181-134041204,chr2,134041181,134041204,H1|chr2:233255849-233255907,chr2,233255849,233255907,0,99214668
H1|chr2:134725259-134725298,chr2,134725259,134725298,H1|chr2:64066619-64066683,chr2,64066619,64066683,0,70658640
H1|chr2:135033538-135033592,chr2,135033538,135033592,H1|chr2:64370827-64370864,chr2,64370827,64370864,0,70662711
H1|chr2:135481793-135481859,chr2,135481793,135481859,H1|chr2:160472120-160472198,chr2,160472120,160472198,0,24990327
H1|chr2:135639120-135639156,chr2,135639120,135639156,H1|chr2:85195030-85195071,chr2,85195030,85195071,0,50444090
H1|chr2:135947109-135947149,chr2,135947109,135947149,H1|chr2:220429367-220429425,chr2,220429367,220429425,0,84482258
H1|chr2:136216840-136216926,chr2,136216840,136216926,H1|chr2:64076404-64076433,chr2,64076404,64076433,0,72140436
H1|chr2:136251869-136251924,chr2,136251869,136251924,H1|chr2:63851164-63851220,chr2,63851164,63851220,0,72400705
H1|chr2:138373765-138373854,chr2,138373765,138373854,H1|chr2:85196063-85196108,chr2,85196063,85196108,0,53177702
H1|chr2:138575770-138575798,chr2,138575770,138575798,H1|chr2:64070923-64070997,chr2,64070923,64070997,0,74504847
H1|chr2:138706967-138707003,chr2,138706967,138707003,H1|chr2:232576700-232576795,chr2,232576700,232576795,0,93869733
H1|chr2:138732421-138732466,chr2,138732421,138732466,H1|chr2:48758191-48758263,chr2,48758191,48758263,0,89974230
H1|chr2:138864367-138864412,chr2,138864367,138864412,H1|chr2:85197430-85197535,chr2,85197430,85197535,0,53666937
H1|chr2:139142451-139142495,chr2,139142451,139142495,H1|chr2:187455962-187456011,chr2,187455962,187456011,0,48313511
H1|chr2:139594943-139594991,chr2,139594943,139594991,H1|chr2:56154642-56154705,chr2,56154642,56154705,0,83440301
H1|chr2:141613189-141613219,chr2,141613189,141613219,H1|chr2:64079254-64079343,chr2,64079254,64079343,0,77533935
H1|chr2:142202331-142202413,chr2,142202331,142202413,H1|chr2:170551530-170551594,chr2,170551530,170551594,0,28349199
H1|chr2:142348812-142348868,chr2,142348812,142348868,H1|chr2:121492831-121492880,chr2,121492831,121492880,0,20855981
H1|chr2:142827040-142827126,chr2,142827040,142827126,H1|chr2:85195468-85195499,chr2,85195468,85195499,0,57631572
H1|chr2:142949012-142949121,chr2,142949012,142949121,H1|chr2:85195480-85195504,chr2,85195480,85195504,0,57753532
H1|chr2:143545180-143545204,chr2,143545180,143545204,H1|chr2:64071696-64071819,chr2,64071696,64071819,0,79473484
H1|chr2:144797952-144798007,chr2,144797952,144798007,H1|chr2:232324215-232324306,chr2,232324215,232324306,0,87526263
H1|chr2:144952505-144952577,chr2,144952505,144952577,H1|chr2:16084497-16084563,chr2,16084497,16084563,0,128868008
H1|chr2:145232034-145232076,chr2,145232034,145232076,H1|chr2:239331035-239331171,chr2,239331035,239331171,0,94099001
H1|chr2:145938755-145938837,chr2,145938755,145938837,H1|chr2:36584988-36585056,chr2,36584988,36585056,0,109353767
H1|chr2:146741571-146741634,chr2,146741571,146741634,H1|chr2:216877634-216877718,chr2,216877634,216877718,0,70136063
H1|chr2:146840388-146840469,chr2,146840388,146840469,H1|chr2:219523093-219523133,chr2,219523093,219523133,0,72682705
H1|chr2:148853943-148853971,chr2,148853943,148853971,H1|chr2:44390003-44390104,chr2,44390003,44390104,0,104463940
H1|chr2:150717632-150717676,chr2,150717632,150717676,H1|chr2:85193658-85193724,chr2,85193658,85193724,0,65523974
H1|chr2:150761976-150762001,chr2,150761976,150762001,H1|chr2:88354550-88354648,chr2,88354550,88354648,0,62407426
H1|chr2:150925692-150925722,chr2,150925692,150925722,H1|chr2:64081478-64081617,chr2,64081478,64081617,0,86844214
H1|chr2:152381890-152381966,chr2,152381890,152381966,H1|chr2:242637941-242637971,chr2,242637941,242637971,0,90256051
H1|chr2:152558796-152558823,chr2,152558796,152558823,H1|chr2:161348906-161348982,chr2,161348906,161348982,0,8790110
H1|chr2:152608671-152608718,chr2,152608671,152608718,H1|chr2:171783562-171783683,chr2,171783562,171783683,0,19174891
H1|chr2:152676682-152676726,chr2,152676682,152676726,H1|chr2:37192803-37192827,chr2,37192803,37192827,0,115483879
H1|chr2:152736143-152736190,chr2,152736143,152736190,H1|chr2:85197935-85198038,chr2,85197935,85198038,0,67538208
H1|chr2:152891497-152891544,chr2,152891497,152891544,H1|chr2:85197935-85198038,chr2,85197935,85198038,0,67693562
H1|chr2:153759064-153759132,chr2,153759064,153759132,H1|chr2:77748360-77748395,chr2,77748360,77748395,0,76010704
H1|chr2:154177641-154177742,chr2,154177641,154177742,H1|chr2:55500209-55500245,chr2,55500209,55500245,0,98677432
H1|chr2:155940859-155940884,chr2,155940859,155940884,H1|chr2:64079595-64079720,chr2,64079595,64079720,0,91861264
H1|chr2:156326028-156326068,chr2,156326028,156326068,H1|chr2:187455674-187455761,chr2,187455674,187455761,0,31129646
H1|chr2:156582112-156582156,chr2,156582112,156582156,H1|chr2:187455962-187456011,chr2,187455962,187456011,0,30873850
H1|chr2:156654754-156654804,chr2,156654754,156654804,H1|chr2:151342517-151342616,chr2,151342517,151342616,0,5312237
H1|chr2:157313385-157313451,chr2,157313385,157313451,H1|chr2:64077889-64077925,chr2,64077889,64077925,0,93235496
H1|chr2:157470701-157470747,chr2,157470701,157470747,H1|chr2:61764360-61764391,chr2,61764360,61764391,0,95706341
H1|chr2:157883554-157883601,chr2,157883554,157883601,H1|chr2:85194011-85194114,chr2,85194011,85194114,0,72689543
H1|chr2:158422640-158422713,chr2,158422640,158422713,H1|chr2:26986802-26986867,chr2,26986802,26986867,0,131435838
H1|chr2:159010010-159010057,chr2,159010010,159010057,H1|chr2:85194011-85194114,chr2,85194011,85194114,0,73815999
H1|chr2:159460275-159460360,chr2,159460275,159460360,H1|chr2:85195468-85195499,chr2,85195468,85195499,0,74264807
H1|chr2:159553494-159553518,chr2,159553494,159553518,H1|chr2:20549380-20549445,chr2,20549380,20549445,0,139004114
H1|chr2:161053214-161053320,chr2,161053214,161053320,H1|chr2:64369754-64369770,chr2,64369754,64369770,0,96683460
H1|chr2:161329695-161329754,chr2,161329695,161329754,H1|chr2:96873342-96873401,chr2,96873342,96873401,0,64456353
H1|chr2:161940563-161940645,chr2,161940563,161940645,H1|chr2:36584988-36585056,chr2,36584988,36585056,0,125355575
H1|chr2:162120929-162120949,chr2,162120929,162120949,H1|chr2:219645846-219645936,chr2,219645846,219645936,0,57524917
H1|chr2:164234057-164234161,chr2,164234057,164234161,H1|chr2:64369754-64369770,chr2,64369754,64369770,0,99864303
H1|chr2:164379679-164379723,chr2,164379679,164379723,H1|chr2:85195789-85195929,chr2,85195789,85195929,0,79183890
H1|chr2:165201517-165201537,chr2,165201517,165201537,H1|chr2:74404195-74404344,chr2,74404195,74404344,0,90797322
H1|chr2:165353254-165353310,chr2,165353254,165353310,H1|chr2:121492831-121492880,chr2,121492831,121492880,0,43860423
H1|chr2:166058096-166058123,chr2,166058096,166058123,H1|chr2:64074765-64074836,chr2,64074765,64074836,0,101983331
H1|chr2:166337103-166337130,chr2,166337103,166337130,H1|chr2:85197100-85197191,chr2,85197100,85197191,0,81140003
H1|chr2:166539005-166539100,chr2,166539005,166539100,H1|chr2:85195472-85195498,chr2,85195472,85195498,0,81343533
H1|chr2:166902793-166902831,chr2,166902793,166902831,H1|chr2:61296130-61296185,chr2,61296130,61296185,0,105606663
H1|chr2:167055828-167055873,chr2,167055828,167055873,H1|chr2:189155953-189156058,chr2,189155953,189156058,0,22100125
H1|chr2:167371027-167371082,chr2,167371027,167371082,H1|chr2:74228258-74228371,chr2,74228258,74228371,0,93142769
H1|chr2:167393590-167393672,chr2,167393590,167393672,H1|chr2:170551530-170551594,chr2,170551530,170551594,0,3157940
H1|chr2:167436948-167436996,chr2,167436948,167436996,H1|chr2:85195377-85195474,chr2,85195377,85195474,0,82241571
H1|chr2:167538883-167538991,chr2,167538883,167538991,H1|chr2:74230258-74230408,chr2,74230258,74230408,0,93308625
H1|chr2:168127065-168127097,chr2,168127065,168127097,H1|chr2:44390032-44390104,chr2,44390032,44390104,0,123737033
H1|chr2:168322668-168322757,chr2,168322668,168322757,H1|chr2:85196063-85196108,chr2,85196063,85196108,0,83126605
H1|chr2:168833741-168833803,chr2,168833741,168833803,H1|chr2:101619972-101620051,chr2,101619972,101620051,0,67213769
H1|chr2:168834965-168834988,chr2,168834965,168834988,H1|chr2:64074765-64074836,chr2,64074765,64074836,0,104760200
H1|chr2:169283208-169283347,chr2,169283208,169283347,H1|chr2:64073001-64073039,chr2,64073001,64073039,0,105210207
H1|chr2:169814591-169814638,chr2,169814591,169814638,H1|chr2:64069624-64069712,chr2,64069624,64069712,0,105744967
H1|chr2:170398554-170398578,chr2,170398554,170398578,H1|chr2:85195737-85195843,chr2,85195737,85195843,0,85202817
H1|chr2:170942121-170942223,chr2,170942121,170942223,H1|chr2:64370258-64370312,chr2,64370258,64370312,0,106571863
H1|chr2:171272180-171272247,chr2,171272180,171272247,H1|chr2:64081445-64081506,chr2,64081445,64081506,0,107190735
H1|chr2:172284035-172284160,chr2,172284035,172284160,H1|chr2:64076404-64076433,chr2,64076404,64076433,0,108207631
H1|chr2:172679546-172679662,chr2,172679546,172679662,H1|chr2:85197069-85197098,chr2,85197069,85197098,0,87482477
H1|chr2:172769089-172769210,chr2,172769089,172769210,H1|chr2:64076404-64076433,chr2,64076404,64076433,0,108692685
H1|chr2:173946198-173946328,chr2,173946198,173946328,H1|chr2:85195405-85195424,chr2,85195405,85195424,0,88750793
H1|chr2:174202241-174202296,chr2,174202241,174202296,H1|chr2:85193425-85193520,chr2,85193425,85193520,0,89008816
H1|chr2:174662026-174662072,chr2,174662026,174662072,H1|chr2:219435091-219435195,chr2,219435091,219435195,0,44773065
H1|chr2:174788661-174788699,chr2,174788661,174788699,H1|chr2:219435070-219435136,chr2,219435070,219435136,0,44646409
H1|chr2:174879941-174880037,chr2,174879941,174880037,H1|chr2:64370258-64370312,chr2,64370258,64370312,0,110509683
H1|chr2:175321009-175321104,chr2,175321009,175321104,H1|chr2:85195472-85195498,chr2,85195472,85195498,0,90125537
H1|chr2:175451866-175451959,chr2,175451866,175451959,H1|chr2:85193754-85193796,chr2,85193754,85193796,0,90258112
H1|chr2:175524213-175524243,chr2,175524213,175524243,H1|chr2:44390032-44390104,chr2,44390032,44390104,0,131134181
H1|chr2:175784624-175784747,chr2,175784624,175784747,H1|chr2:36584988-36585056,chr2,36584988,36585056,0,139199636
H1|chr2:176037305-176037335,chr2,176037305,176037335,H1|chr2:64081478-64081617,chr2,64081478,64081617,0,111955827
H1|chr2:176293378-176293413,chr2,176293378,176293413,H1|chr2:85199386-85199484,chr2,85199386,85199484,0,91093992
H1|chr2:176801446-176801525,chr2,176801446,176801525,H1|chr2:16085310-16085419,chr2,16085310,16085419,0,160716136
H1|chr2:176955086-176955207,chr2,176955086,176955207,H1|chr2:201977034-201977094,chr2,201977034,201977094,0,25021948
H1|chr2:177430894-177430950,chr2,177430894,177430950,H1|chr2:3626569-3626719,chr2,3626569,3626719,0,173804325
H1|chr2:178669436-178669466,chr2,178669436,178669466,H1|chr2:44390032-44390104,chr2,44390032,44390104,0,134279404
H1|chr2:180060673-180060708,chr2,180060673,180060708,H1|chr2:3621528-3621583,chr2,3621528,3621583,0,176439145
H1|chr2:180074909-180074954,chr2,180074909,180074954,H1|chr2:201174808-201174883,chr2,201174808,201174883,0,21099899
H1|chr2:181035902-181035981,chr2,181035902,181035981,H1|chr2:64072583-64072633,chr2,64072583,64072633,0,116963319
H1|chr2:183459624-183459681,chr2,183459624,183459681,H1|chr2:216975430-216975483,chr2,216975430,216975483,0,33515806
H1|chr2:183598706-183598746,chr2,183598706,183598746,H1|chr2:187455674-187455761,chr2,187455674,187455761,0,3856968
H1|chr2:184898952-184899015,chr2,184898952,184899015,H1|chr2:201173096-201173156,chr2,201173096,201173156,0,16274144
H1|chr2:185015345-185015383,chr2,185015345,185015383,H1|chr2:85767259-85767322,chr2,85767259,85767322,0,99248086
H1|chr2:185033351-185033376,chr2,185033351,185033376,H1|chr2:64079595-64079720,chr2,64079595,64079720,0,120953756
H1|chr2:185847000-185847028,chr2,185847000,185847028,H1|chr2:85193643-85193765,chr2,85193643,85193765,0,100653357
H1|chr2:185982525-185982559,chr2,185982525,185982559,H1|chr2:85196941-85196996,chr2,85196941,85196996,0,100785584
H1|chr2:186682667-186682739,chr2,186682667,186682739,H1|chr2:171782654-171782702,chr2,171782654,171782702,0,14900013
H1|chr2:187078713-187078832,chr2,187078713,187078832,H1|chr2:86947934-86948079,chr2,86947934,86948079,0,100130779
H1|chr2:187648969-187649042,chr2,187648969,187649042,H1|chr2:26986802-26986867,chr2,26986802,26986867,0,160662167
H1|chr2:187922446-187922546,chr2,187922446,187922546,H1|chr2:64066452-64066569,chr2,64066452,64066569,0,123855994
H1|chr2:188047395-188047413,chr2,188047395,188047413,H1|chr2:85194170-85194315,chr2,85194170,85194315,0,102853225
H1|chr2:189380867-189380895,chr2,189380867,189380895,H1|chr2:64070923-64070997,chr2,64070923,64070997,0,125309944
H1|chr2:189500453-189500481,chr2,189500453,189500481,H1|chr2:44390003-44390104,chr2,44390003,44390104,0,145110450
H1|chr2:189541882-189541952,chr2,189541882,189541952,H1|chr2:160472120-160472198,chr2,160472120,160472198,0,29069762
H1|chr2:189709677-189709763,chr2,189709677,189709763,H1|chr2:85193927-85193953,chr2,85193927,85193953,0,104515750
H1|chr2:189992281-189992375,chr2,189992281,189992375,H1|chr2:85195472-85195498,chr2,85195472,85195498,0,104796809
H1|chr2:190053351-190053385,chr2,190053351,190053385,H1|chr2:85193344-85193397,chr2,85193344,85193397,0,104860007
H1|chr2:190386200-190386289,chr2,190386200,190386289,H1|chr2:73052535-73052569,chr2,73052535,73052569,0,117333665
H1|chr2:190417900-190418025,chr2,190417900,190418025,H1|chr2:64076404-64076433,chr2,64076404,64076433,0,126341496
H1|chr2:190524007-190524051,chr2,190524007,190524051,H1|chr2:26986715-26986795,chr2,26986715,26986795,0,163537292
H1|chr2:190694425-190694519,chr2,190694425,190694519,H1|chr2:85195472-85195498,chr2,85195472,85195498,0,105498953
H1|chr2:190724018-190724122,chr2,190724018,190724122,H1|chr2:189155953-189156058,chr2,189155953,189156058,0,1568065
H1|chr2:191058343-191058398,chr2,191058343,191058398,H1|chr2:232324215-232324306,chr2,232324215,232324306,0,41265872
H1|chr2:191096692-191096724,chr2,191096692,191096724,H1|chr2:233255829-233255947,chr2,233255829,233255947,0,42159137
H1|chr2:191339469-191339502,chr2,191339469,191339502,H1|chr2:77747758-77747875,chr2,77747758,77747875,0,113591711
H1|chr2:191372755-191372816,chr2,191372755,191372816,H1|chr2:85194127-85194213,chr2,85194127,85194213,0,106178628
H1|chr2:191618419-191618472,chr2,191618419,191618472,H1|chr2:64079595-64079720,chr2,64079595,64079720,0,127538824
H1|chr2:192178415-192178468,chr2,192178415,192178468,H1|chr2:233256501-233256638,chr2,233256501,233256638,0,41078086
H1|chr2:192621751-192621837,chr2,192621751,192621837,H1|chr2:85195468-85195499,chr2,85195468,85195499,0,107426283
H1|chr2:192682872-192682923,chr2,192682872,192682923,H1|chr2:85197430-85197535,chr2,85197430,85197535,0,107485442
H1|chr2:193553830-193553870,chr2,193553830,193553870,H1|chr2:176032563-176032624,chr2,176032563,176032624,0,17521267
H1|chr2:193738762-193738817,chr2,193738762,193738817,H1|chr2:63851164-63851220,chr2,63851164,63851220,0,129887598
H1|chr2:194066102-194066214,chr2,194066102,194066214,H1|chr2:64073001-64073039,chr2,64073001,64073039,0,129993101
H1|chr2:194302744-194302848,chr2,194302744,194302848,H1|chr2:64369754-64369770,chr2,64369754,64369770,0,129932990
H1|chr2:194429027-194429098,chr2,194429027,194429098,H1|chr2:85195840-85195958,chr2,85195840,85195958,0,109233187
H1|chr2:194884859-194884901,chr2,194884859,194884901,H1|chr2:187455674-187455761,chr2,187455674,187455761,0,7429185
H1|chr2:195000734-195000834,chr2,195000734,195000834,H1|chr2:36584988-36585056,chr2,36584988,36585056,0,158415746
H1|chr2:195409325-195409433,chr2,195409325,195409433,H1|chr2:233562214-233562328,chr2,233562214,233562328,0,38152889
H1|chr2:195453959-195454001,chr2,195453959,195454001,H1|chr2:27602472-27602529,chr2,27602472,27602529,0,167851487
H1|chr2:195647634-195647748,chr2,195647634,195647748,H1|chr2:85196780-85196809,chr2,85196780,85196809,0,110450854
H1|chr2:195669881-195669971,chr2,195669881,195669971,H1|chr2:44397944-44397966,chr2,44397944,44397966,0,151271937
H1|chr2:196316367-196316488,chr2,196316367,196316488,H1|chr2:201977034-201977094,chr2,201977034,201977094,0,5660667
H1|chr2:196372206-196372244,chr2,196372206,196372244,H1|chr2:220429367-220429425,chr2,220429367,220429425,0,24057161
H1|chr2:197034102-197034225,chr2,197034102,197034225,H1|chr2:36584988-36585056,chr2,36584988,36585056,0,160449114
H1|chr2:197477262-197477308,chr2,197477262,197477308,H1|chr2:219435091-219435195,chr2,219435091,219435195,0,21957829
H1|chr2:198520640-198520744,chr2,198520640,198520744,H1|chr2:189155953-189156058,chr2,189155953,189156058,0,9364687
H1|chr2:198622189-198622319,chr2,198622189,198622319,H1|chr2:85195405-85195424,chr2,85195405,85195424,0,113426784
H1|chr2:198776456-198776536,chr2,198776456,198776536,H1|chr2:56151467-56151534,chr2,56151467,56151534,0,142624989
H1|chr2:199558577-199558627,chr2,199558577,199558627,H1|chr2:151342517-151342616,chr2,151342517,151342616,0,48216060
H1|chr2:201179825-201179892,chr2,201179825,201179892,H1|chr2:64081445-64081506,chr2,64081445,64081506,0,137098380
H1|chr2:201225037-201225069,chr2,201225037,201225069,H1|chr2:96873342-96873400,chr2,96873342,96873400,0,104351695
H1|chr2:202306852-202306875,chr2,202306852,202306875,H1|chr2:64074765-64074836,chr2,64074765,64074836,0,138232087
H1|chr2:203001469-203001548,chr2,203001469,203001548,H1|chr2:242637941-242637971,chr2,242637941,242637971,0,39636472
H1|chr2:203008735-203008751,chr2,203008735,203008751,H1|chr2:232575357-232575507,chr2,232575357,232575507,0,29566622
H1|chr2:203072762-203072787,chr2,203072762,203072787,H1|chr2:9145767-9145825,chr2,9145767,9145825,0,193926995
H1|chr2:203591238-203591301,chr2,203591238,203591301,H1|chr2:201173096-201173156,chr2,201173096,201173156,0,2418142
H1|chr2:204353623-204353700,chr2,204353623,204353700,H1|chr2:242637941-242637971,chr2,242637941,242637971,0,38284318
H1|chr2:204948544-204948604,chr2,204948544,204948604,H1|chr2:101619972-101620051,chr2,101619972,101620051,0,103328572
H1|chr2:205170037-205170065,chr2,205170037,205170065,H1|chr2:85195737-85195843,chr2,85195737,85195843,0,119974300
H1|chr2:205501750-205501829,chr2,205501750,205501829,H1|chr2:16085310-16085419,chr2,16085310,16085419,0,189416440
H1|chr2:206073836-206073986,chr2,206073836,206073986,H1|chr2:74230236-74230363,chr2,74230236,74230363,0,131843600
H1|chr2:206092034-206092078,chr2,206092034,206092078,H1|chr2:85193658-85193724,chr2,85193658,85193724,0,120898376
H1|chr2:206236180-206236256,chr2,206236180,206236256,H1|chr2:160472120-160472198,chr2,160472120,160472198,0,45764060
H1|chr2:206293336-206293371,chr2,206293336,206293371,H1|chr2:85199386-85199484,chr2,85199386,85199484,0,121093950
H1|chr2:207266113-207266212,chr2,207266113,207266212,H1|chr2:85193996-85194033,chr2,85193996,85194033,0,122072117
H1|chr2:207823310-207823361,chr2,207823310,207823361,H1|chr2:85199583-85199633,chr2,85199583,85199633,0,122623727
H1|chr2:207872854-207872988,chr2,207872854,207872988,H1|chr2:64079813-64079834,chr2,64079813,64079834,0,143793041
H1|chr2:208582548-208582633,chr2,208582548,208582633,H1|chr2:85193927-85193953,chr2,85193927,85193953,0,123388621
H1|chr2:209538185-209538233,chr2,209538185,209538233,H1|chr2:85195377-85195474,chr2,85195377,85195474,0,124342808
H1|chr2:209570817-209570917,chr2,209570817,209570917,H1|chr2:85821149-85821199,chr2,85821149,85821199,0,123749668
H1|chr2:211831149-211831270,chr2,211831149,211831270,H1|chr2:64076404-64076433,chr2,64076404,64076433,0,147754745
H1|chr2:212299488-212299549,chr2,212299488,212299549,H1|chr2:85194127-85194213,chr2,85194127,85194213,0,127105361
H1|chr2:213416740-213416811,chr2,213416740,213416811,H1|chr2:85195840-85195958,chr2,85195840,85195958,0,128220900
H1|chr2:214828963-214829082,chr2,214828963,214829082,H1|chr2:86947934-86948079,chr2,86947934,86948079,0,127881029
H1|chr2:215056118-215056170,chr2,215056118,215056170,H1|chr2:85197461-85197559,chr2,85197461,85197559,0,129858657
H1|chr2:215890778-215890860,chr2,215890778,215890860,H1|chr2:233256439-233256485,chr2,233256439,233256485,0,17365661
H1|chr2:215960633-215960688,chr2,215960633,215960688,H1|chr2:85193996-85194033,chr2,85193996,85194033,0,130766637
H1|chr2:216854277-216854356,chr2,216854277,216854356,H1|chr2:64072583-64072633,chr2,64072583,64072633,0,152781694
H1|chr2:217009872-217009904,chr2,217009872,217009904,H1|chr2:44390032-44390104,chr2,44390032,44390104,0,172619840
H1|chr2:217821412-217821474,chr2,217821412,217821474,H1|chr2:101619972-101620051,chr2,101619972,101620051,0,116201440
H1|chr2:217909769-217909804,chr2,217909769,217909804,H1|chr2:3621528-3621583,chr2,3621528,3621583,0,214288241
H1|chr2:219108176-219108249,chr2,219108176,219108249,H1|chr2:85197461-85197559,chr2,85197461,85197559,0,133910715
H1|chr2:219394026-219394049,chr2,219394026,219394049,H1|chr2:121011482-121011513,chr2,121011482,121011513,0,98382544
H1|chr2:220876301-220876354,chr2,220876301,220876354,H1|chr2:233256501-233256638,chr2,233256501,233256638,0,12380200
H1|chr2:221357388-221357413,chr2,221357388,221357413,H1|chr2:88354550-88354648,chr2,88354550,88354648,0,133002838
H1|chr2:222084431-222084502,chr2,222084431,222084502,H1|chr2:85193850-85193886,chr2,85193850,85193886,0,136890581
H1|chr2:222713781-222713862,chr2,222713781,222713862,H1|chr2:216975430-216975483,chr2,216975430,216975483,0,5738351
H1|chr2:223029789-223029827,chr2,223029789,223029827,H1|chr2:96873342-96873400,chr2,96873342,96873400,0,126156447
H1|chr2:223059135-223059177,chr2,223059135,223059177,H1|chr2:187455674-187455761,chr2,187455674,187455761,0,35603461
H1|chr2:223166427-223166536,chr2,223166427,223166536,H1|chr2:85195480-85195504,chr2,85195480,85195504,0,137970947
H1|chr2:225082040-225082104,chr2,225082040,225082104,H1|chr2:74228466-74228549,chr2,74228466,74228549,0,150853574
H1|chr2:225096757-225096799,chr2,225096757,225096799,H1|chr2:3626877-3626913,chr2,3626877,3626913,0,221469880
H1|chr2:225822848-225822949,chr2,225822848,225822949,H1|chr2:74226838-74226869,chr2,74226838,74226869,0,151596010
H1|chr2:225834284-225834360,chr2,225834284,225834360,H1|chr2:160472120-160472198,chr2,160472120,160472198,0,65362164
H1|chr2:226880314-226880344,chr2,226880314,226880344,H1|chr2:64079254-64079343,chr2,64079254,64079343,0,162801060
H1|chr2:226972966-226973018,chr2,226972966,226973018,H1|chr2:121492831-121492880,chr2,121492831,121492880,0,105480135
H1|chr2:227121975-227122123,chr2,227121975,227122123,H1|chr2:85195480-85195504,chr2,85195480,85195504,0,141926495
H1|chr2:227928986-227929052,chr2,227928986,227929052,H1|chr2:85194082-85194152,chr2,85194082,85194152,0,142734904
H1|chr2:228325040-228325094,chr2,228325040,228325094,H1|chr2:96873342-96873400,chr2,96873342,96873400,0,131451698
H1|chr2:228365216-228365266,chr2,228365216,228365266,H1|chr2:121489886-121489939,chr2,121489886,121489939,0,106875330
H1|chr2:228949046-228949122,chr2,228949046,228949122,H1|chr2:56151467-56151534,chr2,56151467,56151534,0,172797579
H1|chr2:229064935-229064967,chr2,229064935,229064967,H1|chr2:64075685-64075783,chr2,64075685,64075783,0,164989250
H1|chr2:229430440-229430564,chr2,229430440,229430564,H1|chr2:56151467-56151534,chr2,56151467,56151534,0,173278973
H1|chr2:229439400-229439462,chr2,229439400,229439462,H1|chr2:85196099-85196199,chr2,85196099,85196199,0,144243301
H1|chr2:230299399-230299458,chr2,230299399,230299458,H1|chr2:96873342-96873401,chr2,96873342,96873401,0,133426057
H1|chr2:230688846-230688885,chr2,230688846,230688885,H1|chr2:64078995-64079070,chr2,64078995,64079070,0,166609851
H1|chr2:230801100-230801124,chr2,230801100,230801124,H1|chr2:85195737-85195843,chr2,85195737,85195843,0,145605363
H1|chr2:232084290-232084342,chr2,232084290,232084342,H1|chr2:85197461-85197559,chr2,85197461,85197559,0,146886829
H1|chr2:232864504-232864557,chr2,232864504,232864557,H1|chr2:64079595-64079720,chr2,64079595,64079720,0,168784909
H1|chr2:233007821-233007922,chr2,233007821,233007922,H1|chr2:100105776-100105803,chr2,100105776,100105803,0,132902045
H1|chr2:233118622-233118669,chr2,233118622,233118669,H1|chr2:48758191-48758263,chr2,48758191,48758263,0,184360431
H1|chr2:233669348-233669367,chr2,233669348,233669367,H1|chr2:12860158-12860259,chr2,12860158,12860259,0,220809190
H1|chr2:233994051-233994091,chr2,233994051,233994091,H1|chr2:220429367-220429425,chr2,220429367,220429425,0,13564684
H1|chr2:234713578-234713604,chr2,234713578,234713604,H1|chr2:171783562-171783683,chr2,171783562,171783683,0,62930016
H1|chr2:235062810-235062852,chr2,235062810,235062852,H1|chr2:27602472-27602529,chr2,27602472,27602529,0,207460338
H1|chr2:235950231-235950302,chr2,235950231,235950302,H1|chr2:85193850-85193886,chr2,85193850,85193886,0,150756381
H1|chr2:235999435-235999480,chr2,235999435,235999480,H1|chr2:201174808-201174883,chr2,201174808,201174883,0,34824627
H1|chr2:237783433-237783515,chr2,237783433,237783515,H1|chr2:85194127-85194213,chr2,85194127,85194213,0,152589306
H1|chr2:238004876-238004909,chr2,238004876,238004909,H1|chr2:77747758-77747875,chr2,77747758,77747875,0,160257118
H1|chr2:238487473-238487569,chr2,238487473,238487569,H1|chr2:85196063-85196142,chr2,85196063,85196142,0,153291410
H1|chr2:239117681-239117737,chr2,239117681,239117737,H1|chr2:121491941-121492085,chr2,121491941,121492085,0,117625740
H1|chr2:240995100-240995224,chr2,240995100,240995224,H1|chr2:56151467-56151534,chr2,56151467,56151534,0,184843633
H1|chr2:241049908-241049963,chr2,241049908,241049963,H1|chr2:74228258-74228371,chr2,74228258,74228371,0,166821650
H1|chr2:241401214-241401281,chr2,241401214,241401281,H1|chr2:85194536-85194626,chr2,85194536,85194626,0,156206678
H1|chr2:241568615-241568668,chr2,241568615,241568668,H1|chr2:85196063-85196142,chr2,85196063,85196142,0,156372552
H1|chr2:242134148-242134180,chr2,242134148,242134180,H1|chr2:75937290-75937384,chr2,75937290,75937384,0,166196858
H1|chr2:242184935-242184995,chr2,242184935,242184995,H1|chr2:85195377-85195474,chr2,85195377,85195474,0,156989558
H1|chr2:242938603-242938668,chr2,242938603,242938668,H1|chr2:201173096-201173156,chr2,201173096,201173156,0,41765507
H1|chr3:463966-464022,chr3,463966,464022,H1|chr3:32859468-32859491,chr3,32859468,32859491,0,32395502
H1|chr3:574615-574712,chr3,574615,574712,H1|chr3:57198970-57199032,chr3,57198970,57199032,0,56624355
H1|chr3:769396-769427,chr3,769396,769427,H1|chr3:179043159-179043309,chr3,179043159,179043309,0,178273763
H1|chr3:1177276-1177321,chr3,1177276,1177321,H1|chr3:185651901-185652013,chr3,185651901,185652013,0,184474625
H1|chr3:1178891-1178958,chr3,1178891,1178958,H1|chr3:71630987-71631070,chr3,71630987,71631070,0,70452096
H1|chr3:1366824-1366915,chr3,1366824,1366915,H1|chr3:186523025-186523064,chr3,186523025,186523064,0,185156201
H1|chr3:1509675-1509756,chr3,1509675,1509756,H1|chr3:121608534-121608595,chr3,121608534,121608595,0,120098859
H1|chr3:2247280-2247301,chr3,2247280,2247301,H1|chr3:32823908-32824028,chr3,32823908,32824028,0,30576628
H1|chr3:2989390-2989418,chr3,2989390,2989418,H1|chr3:32826194-32826299,chr3,32826194,32826299,0,29836804
H1|chr3:3755496-3755587,chr3,3755496,3755587,H1|chr3:132132582-132132732,chr3,132132582,132132732,0,128377086
H1|chr3:3891747-3891815,chr3,3891747,3891815,H1|chr3:9434619-9434681,chr3,9434619,9434681,0,5542872
H1|chr3:4219548-4219607,chr3,4219548,4219607,H1|chr3:32826712-32826803,chr3,32826712,32826803,0,28607164
H1|chr3:4377041-4377091,chr3,4377041,4377091,H1|chr3:172167501-172167558,chr3,172167501,172167558,0,167790460
H1|chr3:4443448-4443598,chr3,4443448,4443598,H1|chr3:32855747-32855790,chr3,32855747,32855790,0,28412299
H1|chr3:5392435-5392513,chr3,5392435,5392513,H1|chr3:32860692-32860729,chr3,32860692,32860729,0,27468257
H1|chr3:6883688-6883789,chr3,6883688,6883789,H1|chr3:32858010-32858044,chr3,32858010,32858044,0,25974322
H1|chr3:7276811-7276875,chr3,7276811,7276875,H1|chr3:32727381-32727467,chr3,32727381,32727467,0,25450570
H1|chr3:7618123-7618228,chr3,7618123,7618228,H1|chr3:109053733-109053795,chr3,109053733,109053795,0,101435610
H1|chr3:7811991-7812032,chr3,7811991,7812032,H1|chr3:61547340-61547402,chr3,61547340,61547402,0,53735349
H1|chr3:8148070-8148165,chr3,8148070,8148165,H1|chr3:32854492-32854582,chr3,32854492,32854582,0,24706422
H1|chr3:8250935-8251031,chr3,8250935,8251031,H1|chr3:186897918-186897969,chr3,186897918,186897969,0,178646983
H1|chr3:8869426-8869506,chr3,8869426,8869506,H1|chr3:172471099-172471143,chr3,172471099,172471143,0,163601673
H1|chr3:9112754-9112880,chr3,9112754,9112880,H1|chr3:32856989-32857013,chr3,32856989,32857013,0,23744235
H1|chr3:9318264-9318326,chr3,9318264,9318326,H1|chr3:32858336-32858486,chr3,32858336,32858486,0,23540072
H1|chr3:9558479-9558529,chr3,9558479,9558529,H1|chr3:32858344-32858469,chr3,32858344,32858469,0,23299865
H1|chr3:9701577-9701634,chr3,9701577,9701634,H1|chr3:69100317-69100463,chr3,69100317,69100463,0,59398740
H1|chr3:9899842-9899953,chr3,9899842,9899953,H1|chr3:186898096-186898195,chr3,186898096,186898195,0,176998254
H1|chr3:10008793-10008901,chr3,10008793,10008901,H1|chr3:109061286-109061344,chr3,109061286,109061344,0,99052493
H1|chr3:10173767-10173840,chr3,10173767,10173840,H1|chr3:32824970-32824991,chr3,32824970,32824991,0,22651203
H1|chr3:10768750-10768841,chr3,10768750,10768841,H1|chr3:32824723-32824782,chr3,32824723,32824782,0,22055973
H1|chr3:10876174-10876243,chr3,10876174,10876243,H1|chr3:50546335-50546381,chr3,50546335,50546381,0,39670161
H1|chr3:11585746-11585808,chr3,11585746,11585808,H1|chr3:187458527-187458581,chr3,187458527,187458581,0,175872781
H1|chr3:11793025-11793082,chr3,11793025,11793082,H1|chr3:32823662-32823746,chr3,32823662,32823746,0,21030637
H1|chr3:12534717-12534864,chr3,12534717,12534864,H1|chr3:32824480-32824498,chr3,32824480,32824498,0,20289763
H1|chr3:13161320-13161370,chr3,13161320,13161370,H1|chr3:113458999-113459064,chr3,113458999,113459064,0,100297679
H1|chr3:13449446-13449518,chr3,13449446,13449518,H1|chr3:196364099-196364163,chr3,196364099,196364163,0,182914653
H1|chr3:13560415-13560476,chr3,13560415,13560476,H1|chr3:61547340-61547404,chr3,61547340,61547404,0,47986925
H1|chr3:13591086-13591218,chr3,13591086,13591218,H1|chr3:32824480-32824498,chr3,32824480,32824498,0,19233394
H1|chr3:13945678-13945784,chr3,13945678,13945784,H1|chr3:109055753-109055794,chr3,109055753,109055794,0,95110075
H1|chr3:14079966-14080056,chr3,14079966,14080056,H1|chr3:33142475-33142529,chr3,33142475,33142529,0,19062509
H1|chr3:15215656-15215701,chr3,15215656,15215701,H1|chr3:185654620-185654725,chr3,185654620,185654725,0,170438964
H1|chr3:16509038-16509185,chr3,16509038,16509185,H1|chr3:32856989-32857013,chr3,32856989,32857013,0,16347951
H1|chr3:17397952-17398007,chr3,17397952,17398007,H1|chr3:32859240-32859314,chr3,32859240,32859314,0,15461288
H1|chr3:17425753-17425792,chr3,17425753,17425792,H1|chr3:14552273-14552310,chr3,14552273,14552310,0,2873480
H1|chr3:17550810-17550867,chr3,17550810,17550867,H1|chr3:32856857-32856919,chr3,32856857,32856919,0,15306047
H1|chr3:17822707-17822809,chr3,17822707,17822809,H1|chr3:32858010-32858044,chr3,32858010,32858044,0,15035303
H1|chr3:17833591-17833620,chr3,17833591,17833620,H1|chr3:52567152-52567232,chr3,52567152,52567232,0,34733561
H1|chr3:18017636-18017718,chr3,18017636,18017718,H1|chr3:185653990-185654044,chr3,185653990,185654044,0,167636354
H1|chr3:18063705-18063822,chr3,18063705,18063822,H1|chr3:53324303-53324356,chr3,53324303,53324356,0,35260598
H1|chr3:19416168-19416276,chr3,19416168,19416276,H1|chr3:109061286-109061344,chr3,109061286,109061344,0,89645118
H1|chr3:19559919-19559953,chr3,19559919,19559953,H1|chr3:57198970-57199032,chr3,57198970,57199032,0,37639051
H1|chr3:19726483-19726545,chr3,19726483,19726545,H1|chr3:172167501-172167558,chr3,172167501,172167558,0,152441018
H1|chr3:19785755-19785827,chr3,19785755,19785827,H1|chr3:196364099-196364163,chr3,196364099,196364163,0,176578344
H1|chr3:20203528-20203603,chr3,20203528,20203603,H1|chr3:186897232-186897296,chr3,186897232,186897296,0,166693704
H1|chr3:20621410-20621497,chr3,20621410,20621497,H1|chr3:32858444-32858495,chr3,32858444,32858495,0,12237034
H1|chr3:20629566-20629637,chr3,20629566,20629637,H1|chr3:109054374-109054524,chr3,109054374,109054524,0,88424808
H1|chr3:20675947-20676032,chr3,20675947,20676032,H1|chr3:109053733-109053795,chr3,109053733,109053795,0,88377786
H1|chr3:20686919-20686979,chr3,20686919,20686979,H1|chr3:132380403-132380498,chr3,132380403,132380498,0,111693484
H1|chr3:21647486-21647569,chr3,21647486,21647569,H1|chr3:185653990-185654044,chr3,185653990,185654044,0,164006504
H1|chr3:21797922-21797943,chr3,21797922,21797943,H1|chr3:109057710-109057839,chr3,109057710,109057839,0,87259788
H1|chr3:21831782-21831891,chr3,21831782,21831891,H1|chr3:33836089-33836127,chr3,33836089,33836127,0,12004307
H1|chr3:21960295-21960320,chr3,21960295,21960320,H1|chr3:25705074-25705145,chr3,25705074,25705145,0,3744779
H1|chr3:22148007-22148047,chr3,22148007,22148047,H1|chr3:32825203-32825353,chr3,32825203,32825353,0,10677196
H1|chr3:22869439-22869488,chr3,22869439,22869488,H1|chr3:129035926-129036012,chr3,129035926,129036012,0,106166487
H1|chr3:22876416-22876486,chr3,22876416,22876486,H1|chr3:32615499-32615579,chr3,32615499,32615579,0,9739083
H1|chr3:22987322-22987341,chr3,22987322,22987341,H1|chr3:44040848-44040998,chr3,44040848,44040998,0,21053526
H1|chr3:23194435-23194503,chr3,23194435,23194503,H1|chr3:32857103-32857147,chr3,32857103,32857147,0,9662668
H1|chr3:24098666-24098773,chr3,24098666,24098773,H1|chr3:40547902-40547939,chr3,40547902,40547939,0,16449236
H1|chr3:24162301-24162407,chr3,24162301,24162407,H1|chr3:109055753-109055794,chr3,109055753,109055794,0,84893452
H1|chr3:24423087-24423141,chr3,24423087,24423141,H1|chr3:185654620-185654704,chr3,185654620,185654704,0,161231533
H1|chr3:25000240-25000278,chr3,25000240,25000278,H1|chr3:32857983-32858100,chr3,32857983,32858100,0,7857743
H1|chr3:25234672-25234723,chr3,25234672,25234723,H1|chr3:109055958-109056057,chr3,109055958,109056057,0,83821286
H1|chr3:25374909-25374950,chr3,25374909,25374950,H1|chr3:182970771-182970820,chr3,182970771,182970820,0,157595862
H1|chr3:25414228-25414319,chr3,25414228,25414319,H1|chr3:33839144-33839217,chr3,33839144,33839217,0,8424916
H1|chr3:25430001-25430101,chr3,25430001,25430101,H1|chr3:39445061-39445152,chr3,39445061,39445152,0,14015060
H1|chr3:25801513-25801611,chr3,25801513,25801611,H1|chr3:109052036-109052079,chr3,109052036,109052079,0,83250523
H1|chr3:25862042-25862073,chr3,25862042,25862073,H1|chr3:32862304-32862454,chr3,32862304,32862454,0,7000262
H1|chr3:26449738-26449794,chr3,26449738,26449794,H1|chr3:32859240-32859314,chr3,32859240,32859314,0,6409502
H1|chr3:26582645-26582666,chr3,26582645,26582666,H1|chr3:32861147-32861260,chr3,32861147,32861260,0,6278502
H1|chr3:26824859-26824986,chr3,26824859,26824986,H1|chr3:32858398-32858496,chr3,32858398,32858496,0,6033539
H1|chr3:27178276-27178368,chr3,27178276,27178368,H1|chr3:39456126-39456178,chr3,39456126,39456178,0,12277850
H1|chr3:27187269-27187397,chr3,27187269,27187397,H1|chr3:32859470-32859492,chr3,32859470,32859492,0,5672201
H1|chr3:27932050-27932081,chr3,27932050,27932081,H1|chr3:170075721-170075848,chr3,170075721,170075848,0,142143671
H1|chr3:28055366-28055427,chr3,28055366,28055427,H1|chr3:14219318-14219403,chr3,14219318,14219403,0,13836048
H1|chr3:28382475-28382584,chr3,28382475,28382584,H1|chr3:32859086-32859153,chr3,32859086,32859153,0,4476611
H1|chr3:28661071-28661143,chr3,28661071,28661143,H1|chr3:109057927-109058077,chr3,109057927,109058077,0,80396856
H1|chr3:29013652-29013752,chr3,29013652,29013752,H1|chr3:32861237-32861287,chr3,32861237,32861287,0,3847585
H1|chr3:29073380-29073422,chr3,29073380,29073422,H1|chr3:53324242-53324293,chr3,53324242,53324293,0,24250862
H1|chr3:29094455-29094492,chr3,29094455,29094492,H1|chr3:44669705-44669818,chr3,44669705,44669818,0,15575250
H1|chr3:29209052-29209116,chr3,29209052,29209116,H1|chr3:32862603-32862634,chr3,32862603,32862634,0,3653551
H1|chr3:29318004-29318154,chr3,29318004,29318154,H1|chr3:32855747-32855790,chr3,32855747,32855790,0,3537743
H1|chr3:30040184-30040236,chr3,30040184,30040236,H1|chr3:197678276-197678374,chr3,197678276,197678374,0,167638092
H1|chr3:30120338-30120371,chr3,30120338,30120371,H1|chr3:39445778-39445833,chr3,39445778,39445833,0,9325440
H1|chr3:30295565-30295663,chr3,30295565,30295663,H1|chr3:63849254-63849390,chr3,63849254,63849390,0,33553689
H1|chr3:30529408-30529444,chr3,30529408,30529444,H1|chr3:25705074-25705145,chr3,25705074,25705145,0,4824334
H1|chr3:30639486-30639551,chr3,30639486,30639551,H1|chr3:32854776-32854910,chr3,32854776,32854910,0,2215290
H1|chr3:30700647-30700709,chr3,30700647,30700709,H1|chr3:47839629-47839673,chr3,47839629,47839673,0,17138982
H1|chr3:31094957-31095004,chr3,31094957,31095004,H1|chr3:32856925-32857043,chr3,32856925,32857043,0,1761968
H1|chr3:32143192-32143312,chr3,32143192,32143312,H1|chr3:185655301-185655331,chr3,185655301,185655331,0,153512109
H1|chr3:33108819-33108859,chr3,33108819,33108859,H1|chr3:38067505-38067570,chr3,38067505,38067570,0,4958686
H1|chr3:33140538-33140649,chr3,33140538,33140649,H1|chr3:186898096-186898195,chr3,186898096,186898195,0,153757558
H1|chr3:33362060-33362142,chr3,33362060,33362142,H1|chr3:185653990-185654044,chr3,185653990,185654044,0,152291930
H1|chr3:33687125-33687165,chr3,33687125,33687165,H1|chr3:13115628-13115738,chr3,13115628,13115738,0,20571497
H1|chr3:34452483-34452514,chr3,34452483,34452514,H1|chr3:185826554-185826612,chr3,185826554,185826612,0,151374071
H1|chr3:34548384-34548497,chr3,34548384,34548497,H1|chr3:47206740-47206784,chr3,47206740,47206784,0,12658356
H1|chr3:34737693-34737759,chr3,34737693,34737759,H1|chr3:32860638-32860722,chr3,32860638,32860722,0,1877055
H1|chr3:34855872-34855899,chr3,34855872,34855899,H1|chr3:9434619-9434679,chr3,9434619,9434679,0,25421253
H1|chr3:34877467-34877560,chr3,34877467,34877560,H1|chr3:50542247-50542304,chr3,50542247,50542304,0,15664780
H1|chr3:34942140-34942204,chr3,34942140,34942204,H1|chr3:150129913-150129968,chr3,150129913,150129968,0,115187773
H1|chr3:34964090-34964170,chr3,34964090,34964170,H1|chr3:172471099-172471143,chr3,172471099,172471143,0,137507009
H1|chr3:35100750-35100862,chr3,35100750,35100862,H1|chr3:32861811-32861888,chr3,32861811,32861888,0,2238939
H1|chr3:35305422-35305515,chr3,35305422,35305515,H1|chr3:32858514-32858571,chr3,32858514,32858571,0,2446908
H1|chr3:35376920-35377016,chr3,35376920,35377016,H1|chr3:132131844-132131886,chr3,132131844,132131886,0,96754924
H1|chr3:35439858-35439939,chr3,35439858,35439939,H1|chr3:9442761-9442830,chr3,9442761,9442830,0,25997097
H1|chr3:35719658-35719716,chr3,35719658,35719716,H1|chr3:32858850-32858878,chr3,32858850,32858878,0,2860808
H1|chr3:35744444-35744542,chr3,35744444,35744542,H1|chr3:33142475-33142529,chr3,33142475,33142529,0,2601969
H1|chr3:35750126-35750236,chr3,35750126,35750236,H1|chr3:47206778-47206818,chr3,47206778,47206818,0,11456652
H1|chr3:35828357-35828408,chr3,35828357,35828408,H1|chr3:32857591-32857662,chr3,32857591,32857662,0,2970766
H1|chr3:35972686-35972717,chr3,35972686,35972717,H1|chr3:39445778-39445833,chr3,39445778,39445833,0,3473092
H1|chr3:36199510-36199562,chr3,36199510,36199562,H1|chr3:32858398-32858496,chr3,32858398,32858496,0,3341112
H1|chr3:36714480-36714573,chr3,36714480,36714573,H1|chr3:32615499-32615579,chr3,32615499,32615579,0,4098981
H1|chr3:36930439-36930491,chr3,36930439,36930491,H1|chr3:32858502-32858600,chr3,32858502,32858600,0,4071937
H1|chr3:37036318-37036464,chr3,37036318,37036464,H1|chr3:32858541-32858637,chr3,32858541,32858637,0,4177777
H1|chr3:37657441-37657531,chr3,37657441,37657531,H1|chr3:32612841-32612901,chr3,32612841,32612901,0,5044600
H1|chr3:37745662-37745723,chr3,37745662,37745723,H1|chr3:61547340-61547404,chr3,61547340,61547404,0,23801678
H1|chr3:38093623-38093673,chr3,38093623,38093673,H1|chr3:32858398-32858496,chr3,32858398,32858496,0,5235225
H1|chr3:38116649-38116713,chr3,38116649,38116713,H1|chr3:32862603-32862634,chr3,32862603,32862634,0,5254046
H1|chr3:38149194-38149243,chr3,38149194,38149243,H1|chr3:32854883-32854970,chr3,32854883,32854970,0,5294311
H1|chr3:38191297-38191416,chr3,38191297,38191416,H1|chr3:32858076-32858107,chr3,32858076,32858107,0,5333221
H1|chr3:38916426-38916560,chr3,38916426,38916560,H1|chr3:32861237-32861287,chr3,32861237,32861287,0,6055189
H1|chr3:39067102-39067182,chr3,39067102,39067182,H1|chr3:179371602-179371633,chr3,179371602,179371633,0,140304500
H1|chr3:39562311-39562383,chr3,39562311,39562383,H1|chr3:33142479-33142540,chr3,33142479,33142540,0,6419832
H1|chr3:39737187-39737211,chr3,39737187,39737211,H1|chr3:61548212-61548318,chr3,61548212,61548318,0,21811025
H1|chr3:39932323-39932393,chr3,39932323,39932393,H1|chr3:50542247-50542311,chr3,50542247,50542311,0,10609924
H1|chr3:40528323-40528362,chr3,40528323,40528362,H1|chr3:32861011-32861126,chr3,32861011,32861126,0,7667312
H1|chr3:41181646-41181744,chr3,41181646,41181744,H1|chr3:33142475-33142529,chr3,33142475,33142529,0,8039171
H1|chr3:41345677-41345761,chr3,41345677,41345761,H1|chr3:57198970-57199032,chr3,57198970,57199032,0,15853293
H1|chr3:41728983-41729035,chr3,41728983,41729035,H1|chr3:33142470-33142540,chr3,33142470,33142540,0,8586513
H1|chr3:41776605-41776645,chr3,41776605,41776645,H1|chr3:39455473-39455533,chr3,39455473,39455533,0,2321132
H1|chr3:42329328-42329377,chr3,42329328,42329377,H1|chr3:32854883-32854970,chr3,32854883,32854970,0,9474445
H1|chr3:42696455-42696587,chr3,42696455,42696587,H1|chr3:32824480-32824498,chr3,32824480,32824498,0,9871975
H1|chr3:42829621-42829651,chr3,42829621,42829651,H1|chr3:51573508-51573658,chr3,51573508,51573658,0,8743887
H1|chr3:42901504-42901551,chr3,42901504,42901551,H1|chr3:132374862-132374951,chr3,132374862,132374951,0,89473358
H1|chr3:43245604-43245696,chr3,43245604,43245696,H1|chr3:39445029-39445087,chr3,39445029,39445087,0,3800575
H1|chr3:43257463-43257498,chr3,43257463,43257498,H1|chr3:32857195-32857311,chr3,32857195,32857311,0,10400268
H1|chr3:43426057-43426134,chr3,43426057,43426134,H1|chr3:33839144-33839217,chr3,33839144,33839217,0,9586913
H1|chr3:43662802-43662840,chr3,43662802,43662840,H1|chr3:32857983-32858100,chr3,32857983,32858100,0,10804819
H1|chr3:43858854-43858905,chr3,43858854,43858905,H1|chr3:12528203-12528282,chr3,12528203,12528282,0,31330651
H1|chr3:43885141-43885205,chr3,43885141,43885205,H1|chr3:32727381-32727467,chr3,32727381,32727467,0,11157760
H1|chr3:43968031-43968139,chr3,43968031,43968139,H1|chr3:33836089-33836127,chr3,33836089,33836127,0,10131942
H1|chr3:43984747-43984803,chr3,43984747,43984803,H1|chr3:3844035-3844094,chr3,3844035,3844094,0,40140712
H1|chr3:44362152-44362222,chr3,44362152,44362222,H1|chr3:197678276-197678374,chr3,197678276,197678374,0,153316124
H1|chr3:44629351-44629370,chr3,44629351,44629370,H1|chr3:44040848-44040998,chr3,44040848,44040998,0,588503
H1|chr3:44642706-44642820,chr3,44642706,44642820,H1|chr3:186898097-186898195,chr3,186898097,186898195,0,142255391
H1|chr3:44721667-44721737,chr3,44721667,44721737,H1|chr3:32859297-32859331,chr3,32859297,32859331,0,11862370
H1|chr3:44767463-44767486,chr3,44767463,44767486,H1|chr3:185825706-185825754,chr3,185825706,185825754,0,141058243
H1|chr3:44996535-44996594,chr3,44996535,44996594,H1|chr3:109055958-109056057,chr3,109055958,109056057,0,64059423
H1|chr3:45058892-45059036,chr3,45058892,45059036,H1|chr3:49174838-49174943,chr3,49174838,49174943,0,4115946
H1|chr3:45459885-45459985,chr3,45459885,45459985,H1|chr3:39445061-39445152,chr3,39445061,39445152,0,6014824
H1|chr3:45592638-45592704,chr3,45592638,45592704,H1|chr3:185652733-185652791,chr3,185652733,185652791,0,140060095
H1|chr3:45801937-45802037,chr3,45801937,45802037,H1|chr3:32859105-32859177,chr3,32859105,32859177,0,12942832
H1|chr3:45952847-45952912,chr3,45952847,45952912,H1|chr3:186650084-186650109,chr3,186650084,186650109,0,140697237
H1|chr3:46022793-46022843,chr3,46022793,46022843,H1|chr3:179044902-179044985,chr3,179044902,179044985,0,133022109
H1|chr3:46879930-46879954,chr3,46879930,46879954,H1|chr3:32856925-32857043,chr3,32856925,32857043,0,14023005
H1|chr3:47326420-47326481,chr3,47326420,47326481,H1|chr3:32857065-32857151,chr3,32857065,32857151,0,14469355
H1|chr3:48127477-48127513,chr3,48127477,48127513,H1|chr3:132380403-132380498,chr3,132380403,132380498,0,84252926
H1|chr3:48423839-48423929,chr3,48423839,48423929,H1|chr3:32612841-32612901,chr3,32612841,32612901,0,15810998
H1|chr3:48533615-48533671,chr3,48533615,48533671,H1|chr3:49054264-49054315,chr3,49054264,49054315,0,520649
H1|chr3:49249197-49249259,chr3,49249197,49249259,H1|chr3:32858336-32858486,chr3,32858336,32858486,0,16390861
H1|chr3:49402751-49402778,chr3,49402751,49402778,H1|chr3:14219318-14219402,chr3,14219318,14219402,0,35183433
H1|chr3:50327051-50327113,chr3,50327051,50327113,H1|chr3:136581528-136581616,chr3,136581528,136581616,0,86254477
H1|chr3:51169348-51169440,chr3,51169348,51169440,H1|chr3:109061286-109061344,chr3,109061286,109061344,0,57891938
H1|chr3:51872073-51872170,chr3,51872073,51872170,H1|chr3:109054472-109054570,chr3,109054472,109054570,0,57182399
H1|chr3:51957047-51957168,chr3,51957047,51957168,H1|chr3:47206778-47206818,chr3,47206778,47206818,0,4750269
H1|chr3:51960062-51960138,chr3,51960062,51960138,H1|chr3:172471099-172471143,chr3,172471099,172471143,0,120511037
H1|chr3:52168418-52168551,chr3,52168418,52168551,H1|chr3:32856558-32856575,chr3,32856558,32856575,0,19311860
H1|chr3:52189607-52189657,chr3,52189607,52189657,H1|chr3:179044902-179044985,chr3,179044902,179044985,0,126855295
H1|chr3:53532177-53532243,chr3,53532177,53532243,H1|chr3:186650084-186650109,chr3,186650084,186650109,0,133117907
H1|chr3:54514100-54514232,chr3,54514100,54514232,H1|chr3:32858076-32858107,chr3,32858076,32858107,0,21656024
H1|chr3:55343463-55343560,chr3,55343463,55343560,H1|chr3:132137780-132137833,chr3,132137780,132137833,0,76794317
H1|chr3:55710234-55710288,chr3,55710234,55710288,H1|chr3:185654620-185654704,chr3,185654620,185654704,0,129944386
H1|chr3:55800590-55800655,chr3,55800590,55800655,H1|chr3:32859321-32859386,chr3,32859321,32859386,0,22941269
H1|chr3:55894430-55894544,chr3,55894430,55894544,H1|chr3:186898097-186898195,chr3,186898097,186898195,0,131003667
H1|chr3:56193353-56193441,chr3,56193353,56193441,H1|chr3:32857065-32857151,chr3,32857065,32857151,0,23336288
H1|chr3:56490830-56490855,chr3,56490830,56490855,H1|chr3:32858344-32858469,chr3,32858344,32858469,0,23632486
H1|chr3:57004753-57004810,chr3,57004753,57004810,H1|chr3:185541807-185541848,chr3,185541807,185541848,0,128537054
H1|chr3:57337430-57337482,chr3,57337430,57337482,H1|chr3:32858502-32858600,chr3,32858502,32858600,0,24478928
H1|chr3:57664545-57664674,chr3,57664545,57664674,H1|chr3:32727332-32727431,chr3,32727332,32727431,0,24937213
H1|chr3:57835644-57835705,chr3,57835644,57835705,H1|chr3:136581528-136581616,chr3,136581528,136581616,0,78745884
H1|chr3:58232924-58233039,chr3,58232924,58233039,H1|chr3:39455638-39455661,chr3,39455638,39455661,0,18777286
H1|chr3:58423961-58424107,chr3,58423961,58424107,H1|chr3:185547586-185547669,chr3,185547586,185547669,0,127123625
H1|chr3:59146383-59146433,chr3,59146383,59146433,H1|chr3:32854883-32854970,chr3,32854883,32854970,0,26291500
H1|chr3:59320876-59320928,chr3,59320876,59320928,H1|chr3:197678276-197678374,chr3,197678276,197678374,0,138357400
H1|chr3:59469519-59469539,chr3,59469519,59469539,H1|chr3:32823908-32824028,chr3,32823908,32824028,0,26645611
H1|chr3:60090272-60090329,chr3,60090272,60090329,H1|chr3:186650187-186650232,chr3,186650187,186650232,0,126559915
H1|chr3:60744684-60744776,chr3,60744684,60744776,H1|chr3:32824723-32824782,chr3,32824723,32824782,0,27919961
H1|chr3:60842784-60842885,chr3,60842784,60842885,H1|chr3:32859318-32859354,chr3,32859318,32859354,0,27983466
H1|chr3:61092741-61092877,chr3,61092741,61092877,H1|chr3:53324233-53324265,chr3,53324233,53324265,0,7768508
H1|chr3:61131432-61131517,chr3,61131432,61131517,H1|chr3:109058515-109058546,chr3,109058515,109058546,0,47927083
H1|chr3:61251819-61251873,chr3,61251819,61251873,H1|chr3:32826821-32826879,chr3,32826821,32826879,0,28424998
H1|chr3:61404697-61404831,chr3,61404697,61404831,H1|chr3:32861237-32861287,chr3,32861237,32861287,0,28543460
H1|chr3:61686379-61686474,chr3,61686379,61686474,H1|chr3:186897918-186897969,chr3,186897918,186897969,0,125211539
H1|chr3:61783758-61783808,chr3,61783758,61783808,H1|chr3:12528203-12528282,chr3,12528203,12528282,0,49255555
H1|chr3:61970298-61970368,chr3,61970298,61970368,H1|chr3:197678276-197678374,chr3,197678276,197678374,0,135707978
H1|chr3:63328296-63328365,chr3,63328296,63328365,H1|chr3:50546335-50546381,chr3,50546335,50546381,0,12781961
H1|chr3:63900182-63900258,chr3,63900182,63900258,H1|chr3:172471099-172471143,chr3,172471099,172471143,0,108570917
H1|chr3:64015972-64016057,chr3,64015972,64016057,H1|chr3:85007162-85007194,chr3,85007162,85007194,0,20991190
H1|chr3:64214594-64214687,chr3,64214594,64214687,H1|chr3:32858514-32858571,chr3,32858514,32858571,0,31356080
H1|chr3:64894389-64894486,chr3,64894389,64894486,H1|chr3:109054472-109054570,chr3,109054472,109054570,0,44160083
H1|chr3:65004274-65004357,chr3,65004274,65004357,H1|chr3:195363784-195363934,chr3,195363784,195363934,0,130359510
H1|chr3:65567793-65567854,chr3,65567793,65567854,H1|chr3:14219318-14219403,chr3,14219318,14219403,0,51348475
H1|chr3:66306838-66306910,chr3,66306838,66306910,H1|chr3:186897468-186897553,chr3,186897468,186897553,0,120590630
H1|chr3:66706267-66706376,chr3,66706267,66706376,H1|chr3:33836089-33836127,chr3,33836089,33836127,0,32870178
H1|chr3:66777300-66777359,chr3,66777300,66777359,H1|chr3:32826712-32826803,chr3,32826712,32826803,0,33950588
H1|chr3:66777720-66777771,chr3,66777720,66777771,H1|chr3:48754359-48754448,chr3,48754359,48754448,0,18023361
H1|chr3:67230584-67230686,chr3,67230584,67230686,H1|chr3:32858010-32858044,chr3,32858010,32858044,0,34372574
H1|chr3:67671026-67671058,chr3,67671026,67671058,H1|chr3:18485586-18485702,chr3,18485586,18485702,0,49185440
H1|chr3:68528631-68528740,chr3,68528631,68528740,H1|chr3:52007380-52007414,chr3,52007380,52007414,0,16521251
H1|chr3:68813227-68813280,chr3,68813227,68813280,H1|chr3:113458979-113459061,chr3,113458979,113459061,0,44645752
H1|chr3:68951566-68951639,chr3,68951566,68951639,H1|chr3:32858642-32858701,chr3,32858642,32858701,0,36092924
H1|chr3:69001675-69001695,chr3,69001675,69001695,H1|chr3:32855827-32855974,chr3,32855827,32855974,0,36145848
H1|chr3:69645918-69646011,chr3,69645918,69646011,H1|chr3:3843954-3844001,chr3,3843954,3844001,0,65801964
H1|chr3:70418606-70418689,chr3,70418606,70418689,H1|chr3:185653990-185654044,chr3,185653990,185654044,0,115235384
H1|chr3:70426847-70426944,chr3,70426847,70426944,H1|chr3:57198970-57199032,chr3,57198970,57199032,0,13227877
H1|chr3:70761029-70761080,chr3,70761029,70761080,H1|chr3:185654950-185655006,chr3,185654950,185655006,0,114893921
H1|chr3:70984787-70984873,chr3,70984787,70984873,H1|chr3:32857451-32857555,chr3,32857451,32857555,0,38127336
H1|chr3:71230743-71230807,chr3,71230743,71230807,H1|chr3:150129913-150129968,chr3,150129913,150129968,0,78899170
H1|chr3:71254837-71254922,chr3,71254837,71254922,H1|chr3:109053733-109053795,chr3,109053733,109053795,0,37798896
H1|chr3:71403888-71403954,chr3,71403888,71403954,H1|chr3:186650084-186650109,chr3,186650084,186650109,0,115246196
H1|chr3:71722241-71722268,chr3,71722241,71722268,H1|chr3:9434619-9434679,chr3,9434619,9434679,0,62287622
H1|chr3:71833038-71833140,chr3,71833038,71833140,H1|chr3:14219318-14219403,chr3,14219318,14219403,0,57613720
H1|chr3:72047940-72047995,chr3,72047940,72047995,H1|chr3:109054648-109054798,chr3,109054648,109054798,0,37006708
H1|chr3:72672170-72672270,chr3,72672170,72672270,H1|chr3:32859105-32859177,chr3,32859105,32859177,0,39813065
H1|chr3:73072861-73072929,chr3,73072861,73072929,H1|chr3:32862603-32862634,chr3,32862603,32862634,0,40210258
H1|chr3:73369336-73369417,chr3,73369336,73369417,H1|chr3:121608534-121608595,chr3,121608534,121608595,0,48239198
H1|chr3:73441367-73441514,chr3,73441367,73441514,H1|chr3:32856989-32857013,chr3,32856989,32857013,0,40584378
H1|chr3:73478975-73479076,chr3,73478975,73479076,H1|chr3:9442761-9442830,chr3,9442761,9442830,0,64036214
H1|chr3:74041641-74041671,chr3,74041641,74041671,H1|chr3:14553425-14553538,chr3,14553425,14553538,0,59488216
H1|chr3:74776705-74776826,chr3,74776705,74776826,H1|chr3:47206778-47206818,chr3,47206778,47206818,0,27569927
H1|chr3:74809773-74809816,chr3,74809773,74809816,H1|chr3:32862716-32862793,chr3,32862716,32862793,0,41947057
H1|chr3:75035527-75035547,chr3,75035527,75035547,H1|chr3:32823908-32824028,chr3,32823908,32824028,0,42211619
H1|chr3:75190693-75190774,chr3,75190693,75190774,H1|chr3:32862317-32862353,chr3,32862317,32862353,0,42328376
H1|chr3:75283990-75284021,chr3,75283990,75284021,H1|chr3:39445778-39445833,chr3,39445778,39445833,0,35838212
H1|chr3:75625700-75625727,chr3,75625700,75625727,H1|chr3:185544967-185545117,chr3,185544967,185545117,0,109919267
H1|chr3:76037220-76037367,chr3,76037220,76037367,H1|chr3:32824480-32824498,chr3,32824480,32824498,0,43212740
H1|chr3:76180966-76181036,chr3,76180966,76181036,H1|chr3:39456260-39456332,chr3,39456260,39456332,0,36724706
H1|chr3:76228377-76228430,chr3,76228377,76228430,H1|chr3:32856857-32856919,chr3,32856857,32856919,0,43371520
H1|chr3:76340072-76340175,chr3,76340072,76340175,H1|chr3:3843518-3843578,chr3,3843518,3843578,0,72496554
H1|chr3:76384820-76384917,chr3,76384820,76384917,H1|chr3:14219318-14219402,chr3,14219318,14219402,0,62165502
H1|chr3:76505775-76505840,chr3,76505775,76505840,H1|chr3:186897468-186897553,chr3,186897468,186897553,0,110391693
H1|chr3:76742203-76742329,chr3,76742203,76742329,H1|chr3:32856989-32857013,chr3,32856989,32857013,0,43885214
H1|chr3:76992525-76992582,chr3,76992525,76992582,H1|chr3:185541807-185541848,chr3,185541807,185541848,0,108549282
H1|chr3:77338740-77338823,chr3,77338740,77338823,H1|chr3:32859086-32859153,chr3,32859086,32859153,0,44479654
H1|chr3:77457132-77457182,chr3,77457132,77457182,H1|chr3:32854883-32854970,chr3,32854883,32854970,0,44602249
H1|chr3:77840129-77840174,chr3,77840129,77840174,H1|chr3:185651901-185652013,chr3,185651901,185652013,0,107811772
H1|chr3:78408687-78408777,chr3,78408687,78408777,H1|chr3:33142475-33142529,chr3,33142475,33142529,0,45266212
H1|chr3:78462272-78462367,chr3,78462272,78462367,H1|chr3:33840763-33840827,chr3,33840763,33840827,0,44621509
H1|chr3:78708356-78708479,chr3,78708356,78708479,H1|chr3:32863898-32863925,chr3,32863898,32863925,0,45844458
H1|chr3:78919844-78919896,chr3,78919844,78919896,H1|chr3:32826813-32826879,chr3,32826813,32826879,0,46093031
H1|chr3:79191277-79191332,chr3,79191277,79191332,H1|chr3:32859240-32859314,chr3,32859240,32859314,0,46332037
H1|chr3:79283226-79283270,chr3,79283226,79283270,H1|chr3:48482685-48482835,chr3,48482685,48482835,0,30800541
H1|chr3:79520174-79520195,chr3,79520174,79520195,H1|chr3:32861147-32861260,chr3,32861147,32861260,0,46659027
H1|chr3:80117113-80117213,chr3,80117113,80117213,H1|chr3:193851731-193851781,chr3,193851731,193851781,0,113734618
H1|chr3:80400234-80400291,chr3,80400234,80400291,H1|chr3:32856857-32856919,chr3,32856857,32856919,0,47543377
H1|chr3:80497708-80497751,chr3,80497708,80497751,H1|chr3:32857451-32857555,chr3,32857451,32857555,0,47640257
H1|chr3:80502209-80502264,chr3,80502209,80502264,H1|chr3:51573679-51573815,chr3,51573679,51573815,0,28928530
H1|chr3:80575263-80575314,chr3,80575263,80575314,H1|chr3:195721335-195721434,chr3,195721335,195721434,0,115146072
H1|chr3:80624462-80624514,chr3,80624462,80624514,H1|chr3:33142470-33142540,chr3,33142470,33142540,0,47481992
H1|chr3:81175675-81175740,chr3,81175675,81175740,H1|chr3:186650084-186650109,chr3,186650084,186650109,0,105474409
H1|chr3:81317572-81317648,chr3,81317572,81317648,H1|chr3:185546064-185546083,chr3,185546064,185546083,0,104228492
H1|chr3:83040926-83040951,chr3,83040926,83040951,H1|chr3:25705074-25705145,chr3,25705074,25705145,0,57335852
H1|chr3:83092827-83092929,chr3,83092827,83092929,H1|chr3:32860638-32860722,chr3,32860638,32860722,0,50232189
H1|chr3:83243824-83243965,chr3,83243824,83243965,H1|chr3:185655301-185655331,chr3,185655301,185655331,0,102411477
H1|chr3:83372547-83372685,chr3,83372547,83372685,H1|chr3:39445029-39445087,chr3,39445029,39445087,0,43927518
H1|chr3:83378368-83378474,chr3,83378368,83378474,H1|chr3:47206740-47206784,chr3,47206740,47206784,0,36171628
H1|chr3:83395467-83395525,chr3,83395467,83395525,H1|chr3:32858850-32858878,chr3,32858850,32858878,0,50536617
H1|chr3:84123217-84123274,chr3,84123217,84123274,H1|chr3:109053396-109053440,chr3,109053396,109053440,0,24930179
H1|chr3:84168283-84168355,chr3,84168283,84168355,H1|chr3:14552275-14552310,chr3,14552275,14552310,0,69616008
H1|chr3:84261029-84261170,chr3,84261029,84261170,H1|chr3:185655301-185655331,chr3,185655301,185655331,0,101394272
H1|chr3:84964339-84964442,chr3,84964339,84964442,H1|chr3:32858514-32858571,chr3,32858514,32858571,0,52105825
H1|chr3:85759980-85760011,chr3,85759980,85760011,H1|chr3:170075721-170075848,chr3,170075721,170075848,0,84315741
H1|chr3:86321219-86321311,chr3,86321219,86321311,H1|chr3:39456126-39456178,chr3,39456126,39456178,0,46865093
H1|chr3:86370166-86370247,chr3,86370166,86370247,H1|chr3:32860692-32860729,chr3,32860692,32860729,0,53509474
H1|chr3:86515272-86515340,chr3,86515272,86515340,H1|chr3:32857103-32857147,chr3,32857103,32857147,0,53658169
H1|chr3:86901293-86901369,chr3,86901293,86901369,H1|chr3:186897817-186897891,chr3,186897817,186897891,0,99996524
H1|chr3:88907443-88907497,chr3,88907443,88907497,H1|chr3:32825629-32825768,chr3,32825629,32825768,0,56081814
H1|chr3:89258792-89258878,chr3,89258792,89258878,H1|chr3:32857451-32857555,chr3,32857451,32857555,0,56401341
H1|chr3:89426892-89426998,chr3,89426892,89426998,H1|chr3:47206740-47206784,chr3,47206740,47206784,0,42220152
H1|chr3:89509499-89509577,chr3,89509499,89509577,H1|chr3:32860692-32860729,chr3,32860692,32860729,0,56648807
H1|chr3:89982940-89983043,chr3,89982940,89983043,H1|chr3:3843518-3843578,chr3,3843518,3843578,0,86139422
H1|chr3:91148713-91148733,chr3,91148713,91148733,H1|chr3:32855827-32855974,chr3,32855827,32855974,0,58292886
H1|chr3:91158855-91158901,chr3,91158855,91158901,H1|chr3:185652568-185652602,chr3,185652568,185652602,0,94493713
H1|chr3:91316149-91316240,chr3,91316149,91316240,H1|chr3:132132582-132132732,chr3,132132582,132132732,0,40816433
H1|chr3:91634007-91634045,chr3,91634007,91634045,H1|chr3:185651901-185652013,chr3,185651901,185652013,0,94017894
H1|chr3:91877925-91878075,chr3,91877925,91878075,H1|chr3:149947594-149947611,chr3,149947594,149947611,0,58069669
H1|chr3:91925769-91925836,chr3,91925769,91925836,H1|chr3:71630987-71631070,chr3,71630987,71631070,0,20294782
H1|chr3:92836488-92836561,chr3,92836488,92836561,H1|chr3:32861811-32861888,chr3,32861811,32861888,0,59974677
H1|chr3:93623861-93623912,chr3,93623861,93623912,H1|chr3:186898096-186898195,chr3,186898096,186898195,0,93274235
H1|chr3:93746452-93746555,chr3,93746452,93746555,H1|chr3:32858514-32858571,chr3,32858514,32858571,0,60887938
H1|chr3:93768358-93768428,chr3,93768358,93768428,H1|chr3:196364099-196364163,chr3,196364099,196364163,0,102595741
H1|chr3:94056516-94056541,chr3,94056516,94056541,H1|chr3:32858344-32858469,chr3,32858344,32858469,0,61198172
H1|chr3:94605956-94606079,chr3,94605956,94606079,H1|chr3:32863898-32863925,chr3,32863898,32863925,0,61742058
H1|chr3:94736692-94736821,chr3,94736692,94736821,H1|chr3:32727332-32727431,chr3,32727332,32727431,0,62009360
H1|chr3:95109779-95109889,chr3,95109779,95109889,H1|chr3:47206778-47206818,chr3,47206778,47206818,0,47903001
H1|chr3:95111682-95111779,chr3,95111682,95111779,H1|chr3:53324303-53324356,chr3,53324303,53324356,0,41787379
H1|chr3:95186109-95186174,chr3,95186109,95186174,H1|chr3:32859321-32859386,chr3,32859321,32859386,0,62326788
H1|chr3:95207896-95207980,chr3,95207896,95207980,H1|chr3:150481528-150481587,chr3,150481528,150481587,0,55273632
H1|chr3:95227425-95227552,chr3,95227425,95227552,H1|chr3:69128454-69128474,chr3,69128454,69128474,0,26098971
H1|chr3:95730853-95730950,chr3,95730853,95730950,H1|chr3:132137780-132137833,chr3,132137780,132137833,0,36406927
H1|chr3:95929476-95929526,chr3,95929476,95929526,H1|chr3:32859459-32859519,chr3,32859459,32859519,0,63070017
H1|chr3:95963145-95963189,chr3,95963145,95963189,H1|chr3:48482685-48482835,chr3,48482685,48482835,0,47480460
H1|chr3:96043805-96043868,chr3,96043805,96043868,H1|chr3:150129911-150129968,chr3,150129911,150129968,0,54086106
H1|chr3:96390835-96390884,chr3,96390835,96390884,H1|chr3:129035926-129036012,chr3,129035926,129036012,0,32645091
H1|chr3:96801277-96801390,chr3,96801277,96801390,H1|chr3:47206740-47206784,chr3,47206740,47206784,0,49594537
H1|chr3:96940194-96940245,chr3,96940194,96940245,H1|chr3:185654950-185655006,chr3,185654950,185655006,0,88714756
H1|chr3:97135341-97135417,chr3,97135341,97135417,H1|chr3:185546064-185546083,chr3,185546064,185546083,0,88410723
H1|chr3:97221288-97221329,chr3,97221288,97221329,H1|chr3:132376767-132376806,chr3,132376767,132376806,0,35155479
H1|chr3:97595902-97595956,chr3,97595902,97595956,H1|chr3:32826821-32826879,chr3,32826821,32826879,0,64769081
H1|chr3:98044593-98044644,chr3,98044593,98044644,H1|chr3:109055958-109056057,chr3,109055958,109056057,0,11011365
H1|chr3:98224121-98224212,chr3,98224121,98224212,H1|chr3:186523025-186523064,chr3,186523025,186523064,0,88298904
H1|chr3:98539560-98539661,chr3,98539560,98539661,H1|chr3:32859318-32859354,chr3,32859318,32859354,0,65680242
H1|chr3:98953384-98953467,chr3,98953384,98953467,H1|chr3:195363784-195363934,chr3,195363784,195363934,0,96410400
H1|chr3:99579178-99579213,chr3,99579178,99579213,H1|chr3:32861011-32861126,chr3,32861011,32861126,0,66718167
H1|chr3:99618956-99618988,chr3,99618956,99618988,H1|chr3:18485586-18485702,chr3,18485586,18485702,0,81133370
H1|chr3:99635786-99635849,chr3,99635786,99635849,H1|chr3:61547340-61547402,chr3,61547340,61547402,0,38088446
H1|chr3:99776945-99777028,chr3,99776945,99777028,H1|chr3:32857791-32857823,chr3,32857791,32857823,0,66919154
H1|chr3:100588247-100588335,chr3,100588247,100588335,H1|chr3:187461995-187462013,chr3,187461995,187462013,0,86873748
H1|chr3:100754924-100755038,chr3,100754924,100755038,H1|chr3:15902092-15902203,chr3,15902092,15902203,0,84852832
H1|chr3:100826946-100827019,chr3,100826946,100827019,H1|chr3:71630987-71631070,chr3,71630987,71631070,0,29195959
H1|chr3:100844443-100844516,chr3,100844443,100844516,H1|chr3:32858642-32858701,chr3,32858642,32858701,0,67985801
H1|chr3:101316957-101317057,chr3,101316957,101317057,H1|chr3:193851731-193851781,chr3,193851731,193851781,0,92534774
H1|chr3:101918382-101918504,chr3,101918382,101918504,H1|chr3:32858296-32858324,chr3,32858296,32858324,0,69060086
H1|chr3:102046190-102046326,chr3,102046190,102046326,H1|chr3:53324233-53324265,chr3,53324233,53324265,0,48721957
H1|chr3:102077605-102077682,chr3,102077605,102077682,H1|chr3:193851731-193851804,chr3,193851731,193851804,0,91774126
H1|chr3:102146242-102146277,chr3,102146242,102146277,H1|chr3:32861011-32861126,chr3,32861011,32861126,0,69285231
H1|chr3:102603107-102603178,chr3,102603107,102603178,H1|chr3:197678749-197678826,chr3,197678749,197678826,0,95075642
H1|chr3:103142094-103142132,chr3,103142094,103142132,H1|chr3:185651901-185652013,chr3,185651901,185652013,0,82509807
H1|chr3:103184356-103184397,chr3,103184356,103184397,H1|chr3:182970771-182970820,chr3,182970771,182970820,0,79786415
H1|chr3:103682475-103682514,chr3,103682475,103682514,H1|chr3:32861011-32861126,chr3,32861011,32861126,0,70821464
H1|chr3:103721259-103721330,chr3,103721259,103721330,H1|chr3:197678749-197678826,chr3,197678749,197678826,0,93957490
H1|chr3:103740370-103740432,chr3,103740370,103740432,H1|chr3:172167501-172167558,chr3,172167501,172167558,0,68427131
H1|chr3:103867705-103867814,chr3,103867705,103867814,H1|chr3:32859086-32859153,chr3,32859086,32859153,0,71008619
H1|chr3:104548145-104548169,chr3,104548145,104548169,H1|chr3:32856925-32857043,chr3,32856925,32857043,0,71691220
H1|chr3:104781115-104781164,chr3,104781115,104781164,H1|chr3:135915173-135915230,chr3,135915173,135915230,0,31134058
H1|chr3:104785707-104785804,chr3,104785707,104785804,H1|chr3:129351749-129351881,chr3,129351749,129351881,0,24566042
H1|chr3:104838988-104839121,chr3,104838988,104839121,H1|chr3:32856558-32856575,chr3,32856558,32856575,0,71982430
H1|chr3:106045052-106045092,chr3,106045052,106045092,H1|chr3:39455473-39455533,chr3,39455473,39455533,0,66589579
H1|chr3:106075809-106075879,chr3,106075809,106075879,H1|chr3:50542247-50542311,chr3,50542247,50542311,0,55533562
H1|chr3:106295528-106295626,chr3,106295528,106295626,H1|chr3:63849254-63849390,chr3,63849254,63849390,0,42446274
H1|chr3:107722714-107722765,chr3,107722714,107722765,H1|chr3:32857591-32857662,chr3,32857591,32857662,0,74865123
H1|chr3:107766503-107766527,chr3,107766503,107766527,H1|chr3:150802116-150802195,chr3,150802116,150802195,0,43035613
H1|chr3:108112233-108112285,chr3,108112233,108112285,H1|chr3:179371657-179371724,chr3,179371657,179371724,0,71259424
H1|chr3:108167101-108167145,chr3,108167101,108167145,H1|chr3:9883826-9883908,chr3,9883826,9883908,0,98283275
H1|chr3:108339469-108339550,chr3,108339469,108339550,H1|chr3:186897232-186897296,chr3,186897232,186897296,0,78557763
H1|chr3:108535900-108536001,chr3,108535900,108536001,H1|chr3:9442761-9442830,chr3,9442761,9442830,0,99093139
H1|chr3:108681641-108681689,chr3,108681641,108681689,H1|chr3:32727332-32727431,chr3,32727332,32727431,0,75954309
H1|chr3:108793543-108793604,chr3,108793543,108793604,H1|chr3:32857065-32857151,chr3,32857065,32857151,0,75936478
H1|chr3:109242411-109242457,chr3,109242411,109242457,H1|chr3:185540266-185540335,chr3,185540266,185540335,0,76297855
H1|chr3:109537096-109537120,chr3,109537096,109537120,H1|chr3:150802116-150802195,chr3,150802116,150802195,0,41265020
H1|chr3:109587971-109588050,chr3,109587971,109588050,H1|chr3:109053733-109053798,chr3,109053733,109053798,0,534238
H1|chr3:109602169-109602241,chr3,109602169,109602241,H1|chr3:14552275-14552310,chr3,14552275,14552310,0,95049894
H1|chr3:110663762-110663906,chr3,110663762,110663906,H1|chr3:49174838-49174943,chr3,49174838,49174943,0,61488924
H1|chr3:110712927-110712987,chr3,110712927,110712987,H1|chr3:61547340-61547402,chr3,61547340,61547402,0,49165587
H1|chr3:110765247-110765367,chr3,110765247,110765367,H1|chr3:185655301-185655331,chr3,185655301,185655331,0,74890054
H1|chr3:110854011-110854061,chr3,110854011,110854061,H1|chr3:32858398-32858496,chr3,32858398,32858496,0,77995613
H1|chr3:111225199-111225270,chr3,111225199,111225270,H1|chr3:109054374-109054524,chr3,109054374,109054524,0,2170825
H1|chr3:111389464-111389527,chr3,111389464,111389527,H1|chr3:135912712-135912778,chr3,135912712,135912778,0,24523248
H1|chr3:111752135-111752191,chr3,111752135,111752191,H1|chr3:49054264-49054315,chr3,49054264,49054315,0,62697871
H1|chr3:111865577-111865677,chr3,111865577,111865677,H1|chr3:32855747-32855790,chr3,32855747,32855790,0,79009830
H1|chr3:111890107-111890147,chr3,111890107,111890147,H1|chr3:38067505-38067570,chr3,38067505,38067570,0,73822602
H1|chr3:111959127-111959177,chr3,111959127,111959177,H1|chr3:195721337-195721437,chr3,195721337,195721437,0,83762210
H1|chr3:112447723-112447802,chr3,112447723,112447802,H1|chr3:32826162-32826241,chr3,32826162,32826241,0,79621561
H1|chr3:112516858-112516920,chr3,112516858,112516920,H1|chr3:47839629-47839673,chr3,47839629,47839673,0,64677229
H1|chr3:112672316-112672409,chr3,112672316,112672409,H1|chr3:3843954-3844001,chr3,3843954,3844001,0,108828362
H1|chr3:112765517-112765619,chr3,112765517,112765619,H1|chr3:32860638-32860722,chr3,32860638,32860722,0,79904879
H1|chr3:112767434-112767484,chr3,112767434,112767484,H1|chr3:172167501-172167558,chr3,172167501,172167558,0,59400067
H1|chr3:112960207-112960266,chr3,112960207,112960266,H1|chr3:109055958-109056057,chr3,109055958,109056057,0,3904249
H1|chr3:113000044-113000077,chr3,113000044,113000077,H1|chr3:18485586-18485702,chr3,18485586,18485702,0,94514458
H1|chr3:113038098-113038156,chr3,113038098,113038156,H1|chr3:52002435-52002502,chr3,52002435,52002502,0,61035663
H1|chr3:113256468-113256523,chr3,113256468,113256523,H1|chr3:3844133-3844183,chr3,3844133,3844183,0,109412335
H1|chr3:113328277-113328360,chr3,113328277,113328360,H1|chr3:109058515-109058546,chr3,109058515,109058546,0,4269762
H1|chr3:113809160-113809246,chr3,113809160,113809246,H1|chr3:32857791-32857823,chr3,32857791,32857823,0,80951369
H1|chr3:114378216-114378307,chr3,114378216,114378307,H1|chr3:33839144-33839217,chr3,33839144,33839217,0,80539072
H1|chr3:114812239-114812334,chr3,114812239,114812334,H1|chr3:32854492-32854582,chr3,32854492,32854582,0,81957747
H1|chr3:114912602-114912715,chr3,114912602,114912715,H1|chr3:39455638-39455663,chr3,39455638,39455663,0,75456964
H1|chr3:114977287-114977437,chr3,114977287,114977437,H1|chr3:32858296-32858324,chr3,32858296,32858324,0,82118991
H1|chr3:115324468-115324570,chr3,115324468,115324570,H1|chr3:14219318-14219403,chr3,14219318,14219403,0,101105150
H1|chr3:115607530-115607622,chr3,115607530,115607622,H1|chr3:32824723-32824782,chr3,32824723,32824782,0,82782807
H1|chr3:115785629-115785726,chr3,115785629,115785726,H1|chr3:32856565-32856595,chr3,32856565,32856595,0,82929064
H1|chr3:115807632-115807717,chr3,115807632,115807717,H1|chr3:85007162-85007194,chr3,85007162,85007194,0,30800470
H1|chr3:116156671-116156743,chr3,116156671,116156743,H1|chr3:186897468-186897553,chr3,186897468,186897553,0,70740797
H1|chr3:116605168-116605247,chr3,116605168,116605247,H1|chr3:32858611-32858640,chr3,32858611,32858640,0,83746557
H1|chr3:116838048-116838175,chr3,116838048,116838175,H1|chr3:32858398-32858496,chr3,32858398,32858496,0,83979650
H1|chr3:116838093-116838215,chr3,116838093,116838215,H1|chr3:32612841-32612901,chr3,32612841,32612901,0,84225252
H1|chr3:117008917-117008997,chr3,117008917,117008997,H1|chr3:179371602-179371633,chr3,179371602,179371633,0,62362685
H1|chr3:117200277-117200353,chr3,117200277,117200353,H1|chr3:186897817-186897891,chr3,186897817,186897891,0,69697540
H1|chr3:117458493-117458534,chr3,117458493,117458534,H1|chr3:61547340-61547402,chr3,61547340,61547402,0,55911153
H1|chr3:118951281-118951349,chr3,118951281,118951349,H1|chr3:39456258-39456332,chr3,39456258,39456332,0,79495023
H1|chr3:119087510-119087570,chr3,119087510,119087570,H1|chr3:32854492-32854582,chr3,32854492,32854582,0,86233018
H1|chr3:119982087-119982134,chr3,119982087,119982134,H1|chr3:52930446-52930526,chr3,52930446,52930526,0,67051641
H1|chr3:120093606-120093703,chr3,120093606,120093703,H1|chr3:129351749-129351881,chr3,129351749,129351881,0,9258143
H1|chr3:120099793-120099835,chr3,120099793,120099835,H1|chr3:53324242-53324293,chr3,53324242,53324293,0,66775551
H1|chr3:120114422-120114465,chr3,120114422,120114465,H1|chr3:32857451-32857555,chr3,32857451,32857555,0,87256971
H1|chr3:120257431-120257531,chr3,120257431,120257531,H1|chr3:32855747-32855790,chr3,32855747,32855790,0,87401684
H1|chr3:120618964-120619003,chr3,120618964,120619003,H1|chr3:13115617-13115682,chr3,13115617,13115682,0,107503347
H1|chr3:120680277-120680300,chr3,120680277,120680300,H1|chr3:185825706-185825754,chr3,185825706,185825754,0,65145429
H1|chr3:121116660-121116710,chr3,121116660,121116710,H1|chr3:195721337-195721437,chr3,195721337,195721437,0,74604677
H1|chr3:121153584-121153657,chr3,121153584,121153657,H1|chr3:32861811-32861888,chr3,32861811,32861888,0,88291773
H1|chr3:121183842-121183863,chr3,121183842,121183863,H1|chr3:32823908-32824028,chr3,32823908,32824028,0,88359934
H1|chr3:121562410-121562489,chr3,121562410,121562489,H1|chr3:109053733-109053798,chr3,109053733,109053798,0,12508677
H1|chr3:121835123-121835183,chr3,121835123,121835183,H1|chr3:61547340-61547402,chr3,61547340,61547402,0,60287783
H1|chr3:122485310-122485347,chr3,122485310,122485347,H1|chr3:44669705-44669818,chr3,44669705,44669818,0,77815605
H1|chr3:122506857-122506943,chr3,122506857,122506943,H1|chr3:33840763-33840827,chr3,33840763,33840827,0,88666094
H1|chr3:122603335-122603363,chr3,122603335,122603363,H1|chr3:32826194-32826299,chr3,32826194,32826299,0,89777141
H1|chr3:122672461-122672542,chr3,122672461,122672542,H1|chr3:32862317-32862353,chr3,32862317,32862353,0,89810144
H1|chr3:122919667-122919706,chr3,122919667,122919706,H1|chr3:14552273-14552310,chr3,14552273,14552310,0,108367394
H1|chr3:122964443-122964542,chr3,122964443,122964542,H1|chr3:109052036-109052079,chr3,109052036,109052079,0,13912407
H1|chr3:123818041-123818125,chr3,123818041,123818125,H1|chr3:185652691-185652744,chr3,185652691,185652744,0,61834650
H1|chr3:124097569-124097664,chr3,124097569,124097664,H1|chr3:39456126-39456178,chr3,39456126,39456178,0,84641443
H1|chr3:124259489-124259607,chr3,124259489,124259607,H1|chr3:53324233-53324265,chr3,53324233,53324265,0,70935256
H1|chr3:124321880-124321921,chr3,124321880,124321921,H1|chr3:132376767-132376806,chr3,132376767,132376806,0,8054887
H1|chr3:124760824-124760851,chr3,124760824,124760851,H1|chr3:43731287-43731361,chr3,43731287,43731361,0,81029537
H1|chr3:124825859-124825927,chr3,124825859,124825927,H1|chr3:32826712-32826803,chr3,32826712,32826803,0,91999147
H1|chr3:126039979-126040006,chr3,126039979,126040006,H1|chr3:185544967-185545117,chr3,185544967,185545117,0,59504988
H1|chr3:126382931-126383014,chr3,126382931,126383014,H1|chr3:32857791-32857823,chr3,32857791,32857823,0,93525140
H1|chr3:126590058-126590104,chr3,126590058,126590104,H1|chr3:185540266-185540335,chr3,185540266,185540335,0,58950208
H1|chr3:127307015-127307165,chr3,127307015,127307165,H1|chr3:32856558-32856575,chr3,32856558,32856575,0,94450457
H1|chr3:127341484-127341547,chr3,127341484,127341547,H1|chr3:150129911-150129968,chr3,150129911,150129968,0,22788427
H1|chr3:128734222-128734312,chr3,128734222,128734312,H1|chr3:3843518-3843578,chr3,3843518,3843578,0,124890704
H1|chr3:128903100-128903156,chr3,128903100,128903156,H1|chr3:32859468-32859491,chr3,32859468,32859491,0,96043632
H1|chr3:130024407-130024521,chr3,130024407,130024521,H1|chr3:15902092-15902203,chr3,15902092,15902203,0,114122315
H1|chr3:130317444-130317531,chr3,130317444,130317531,H1|chr3:32858444-32858495,chr3,32858444,32858495,0,97459000
H1|chr3:130382493-130382547,chr3,130382493,130382547,H1|chr3:32825629-32825768,chr3,32825629,32825768,0,97556864
H1|chr3:130551003-130551069,chr3,130551003,130551069,H1|chr3:185652733-185652791,chr3,185652733,185652791,0,55101730
H1|chr3:130683278-130683370,chr3,130683278,130683370,H1|chr3:39445029-39445087,chr3,39445029,39445087,0,91238249
H1|chr3:130766731-130766764,chr3,130766731,130766764,H1|chr3:18485586-18485702,chr3,18485586,18485702,0,112281145
H1|chr3:130992694-130992822,chr3,130992694,130992822,H1|chr3:149947594-149947611,chr3,149947594,149947611,0,18954900
H1|chr3:131039047-131039130,chr3,131039047,131039130,H1|chr3:109058515-109058546,chr3,109058515,109058546,0,21980532
H1|chr3:131147893-131147942,chr3,131147893,131147942,H1|chr3:135915173-135915230,chr3,135915173,135915230,0,4767280
H1|chr3:131303474-131303567,chr3,131303474,131303567,H1|chr3:32615499-32615579,chr3,32615499,32615579,0,98687975
H1|chr3:131820532-131820575,chr3,131820532,131820575,H1|chr3:9883826-9883907,chr3,9883826,9883907,0,121936706
H1|chr3:132161814-132161854,chr3,132161814,132161854,H1|chr3:32826162-32826240,chr3,32826162,32826240,0,99335652
H1|chr3:132603511-132603590,chr3,132603511,132603590,H1|chr3:32826162-32826241,chr3,32826162,32826241,0,99777349
H1|chr3:132958973-132959051,chr3,132958973,132959051,H1|chr3:32859105-32859177,chr3,32859105,32859177,0,100099868
H1|chr3:133011760-133011862,chr3,133011760,133011862,H1|chr3:109054399-109054549,chr3,109054399,109054549,0,23957361
H1|chr3:133535551-133535598,chr3,133535551,133535598,H1|chr3:132374862-132374951,chr3,132374862,132374951,0,1160689
H1|chr3:133750492-133750583,chr3,133750492,133750583,H1|chr3:32824723-32824782,chr3,32824723,32824782,0,100925769
H1|chr3:133943202-133943270,chr3,133943202,133943270,H1|chr3:32824970-32824991,chr3,32824970,32824991,0,101118232
H1|chr3:134349148-134349169,chr3,134349148,134349169,H1|chr3:109057710-109057839,chr3,109057710,109057839,0,25291438
H1|chr3:134539738-134539781,chr3,134539738,134539781,H1|chr3:32862716-32862793,chr3,32862716,32862793,0,101677022
H1|chr3:135333366-135333417,chr3,135333366,135333417,H1|chr3:12528203-12528282,chr3,12528203,12528282,0,122805163
H1|chr3:135436087-135436184,chr3,135436087,135436184,H1|chr3:14219318-14219402,chr3,14219318,14219402,0,121216769
H1|chr3:135796610-135796672,chr3,135796610,135796672,H1|chr3:136581528-136581616,chr3,136581528,136581616,0,784918
H1|chr3:136172830-136172913,chr3,136172830,136172913,H1|chr3:150481528-150481587,chr3,150481528,150481587,0,14308698
H1|chr3:136212342-136212410,chr3,136212342,136212410,H1|chr3:32824970-32824991,chr3,32824970,32824991,0,103387372
H1|chr3:136866379-136866397,chr3,136866379,136866397,H1|chr3:32826979-32827042,chr3,32826979,32827042,0,104039400
H1|chr3:137913542-137913602,chr3,137913542,137913602,H1|chr3:32854492-32854582,chr3,32854492,32854582,0,105059050
H1|chr3:138171925-138171958,chr3,138171925,138171958,H1|chr3:39445778-39445833,chr3,39445778,39445833,0,98726147
H1|chr3:138175248-138175370,chr3,138175248,138175370,H1|chr3:32858296-32858324,chr3,32858296,32858324,0,105316952
H1|chr3:138600297-138600392,chr3,138600297,138600392,H1|chr3:39456126-39456178,chr3,39456126,39456178,0,99144171
H1|chr3:138603837-138603900,chr3,138603837,138603900,H1|chr3:61547340-61547402,chr3,61547340,61547402,0,77056497
H1|chr3:139025416-139025566,chr3,139025416,139025566,H1|chr3:195363879-195363953,chr3,195363879,195363953,0,56338463
H1|chr3:140167113-140167183,chr3,140167113,140167183,H1|chr3:196364099-196364163,chr3,196364099,196364163,0,56196986
H1|chr3:140509862-140509893,chr3,140509862,140509893,H1|chr3:32862304-32862454,chr3,32862304,32862454,0,107647558
H1|chr3:141186634-141186762,chr3,141186634,141186762,H1|chr3:149947594-149947611,chr3,149947594,149947611,0,8760960
H1|chr3:141265782-141265858,chr3,141265782,141265858,H1|chr3:179371602-179371633,chr3,179371602,179371633,0,38105820
H1|chr3:141481044-141481153,chr3,141481044,141481153,H1|chr3:52007380-52007414,chr3,52007380,52007414,0,89473664
H1|chr3:141563933-141564065,chr3,141563933,141564065,H1|chr3:32858076-32858107,chr3,32858076,32858107,0,108705857
H1|chr3:141604777-141604865,chr3,141604777,141604865,H1|chr3:32857065-32857151,chr3,32857065,32857151,0,108747712
H1|chr3:141995326-141995453,chr3,141995326,141995453,H1|chr3:69128454-69128474,chr3,69128454,69128474,0,72866872
H1|chr3:142100601-142100651,chr3,142100601,142100651,H1|chr3:32859459-32859519,chr3,32859459,32859519,0,109241142
H1|chr3:142203904-142203940,chr3,142203904,142203940,H1|chr3:132380403-132380498,chr3,132380403,132380498,0,9823501
H1|chr3:142574513-142574562,chr3,142574513,142574562,H1|chr3:48754359-48754448,chr3,48754359,48754448,0,93820154
H1|chr3:142864561-142864608,chr3,142864561,142864608,H1|chr3:32856925-32857043,chr3,32856925,32857043,0,110007636
H1|chr3:143001790-143001814,chr3,143001790,143001814,H1|chr3:61548212-61548318,chr3,61548212,61548318,0,81453578
H1|chr3:143055695-143055750,chr3,143055695,143055750,H1|chr3:185541807-185541848,chr3,185541807,185541848,0,42486112
H1|chr3:143401495-143401531,chr3,143401495,143401531,H1|chr3:186523853-186523937,chr3,186523853,186523937,0,43122358
H1|chr3:144365737-144365773,chr3,144365737,144365773,H1|chr3:25705074-25705145,chr3,25705074,25705145,0,118660663
H1|chr3:144489939-144489986,chr3,144489939,144489986,H1|chr3:52930446-52930526,chr3,52930446,52930526,0,91559493
H1|chr3:144509209-144509236,chr3,144509209,144509236,H1|chr3:14219318-14219402,chr3,14219318,14219402,0,130289891
H1|chr3:144693442-144693592,chr3,144693442,144693592,H1|chr3:195363879-195363953,chr3,195363879,195363953,0,50670437
H1|chr3:144757008-144757076,chr3,144757008,144757076,H1|chr3:39456258-39456332,chr3,39456258,39456332,0,105300750
H1|chr3:144912967-144913095,chr3,144912967,144913095,H1|chr3:32859470-32859492,chr3,32859470,32859492,0,112053497
H1|chr3:145065013-145065065,chr3,145065013,145065065,H1|chr3:32826813-32826879,chr3,32826813,32826879,0,112238200
H1|chr3:145325096-145325173,chr3,145325096,145325173,H1|chr3:33839144-33839217,chr3,33839144,33839217,0,111485952
H1|chr3:145732616-145732699,chr3,145732616,145732699,H1|chr3:32859086-32859153,chr3,32859086,32859153,0,112873530
H1|chr3:145907196-145907246,chr3,145907196,145907246,H1|chr3:32857591-32857662,chr3,32857591,32857662,0,113049605
H1|chr3:146738733-146738801,chr3,146738733,146738801,H1|chr3:32862603-32862634,chr3,32862603,32862634,0,113876130
H1|chr3:147006633-147006779,chr3,147006633,147006779,H1|chr3:32858541-32858637,chr3,32858541,32858637,0,114148092
H1|chr3:147463947-147464097,chr3,147463947,147464097,H1|chr3:32858296-32858324,chr3,32858296,32858324,0,114605651
H1|chr3:147645661-147645749,chr3,147645661,147645749,H1|chr3:187461995-187462013,chr3,187461995,187462013,0,39816334
H1|chr3:147780973-147781059,chr3,147780973,147781059,H1|chr3:33840763-33840827,chr3,33840763,33840827,0,113940210
H1|chr3:147934785-147934836,chr3,147934785,147934836,H1|chr3:186898096-186898195,chr3,186898096,186898195,0,38963311
H1|chr3:148398919-148398969,chr3,148398919,148398969,H1|chr3:32858344-32858469,chr3,32858344,32858469,0,115540575
H1|chr3:148448745-148448845,chr3,148448745,148448845,H1|chr3:32861237-32861287,chr3,32861237,32861287,0,115587508
H1|chr3:149243866-149243923,chr3,149243866,149243923,H1|chr3:69100317-69100463,chr3,69100317,69100463,0,80143549
H1|chr3:149262273-149262354,chr3,149262273,149262354,H1|chr3:172471099-172471143,chr3,172471099,172471143,0,23208826
H1|chr3:149787451-149787490,chr3,149787451,149787490,H1|chr3:13115617-13115682,chr3,13115617,13115682,0,136671834
H1|chr3:150380842-150380892,chr3,150380842,150380892,H1|chr3:12528203-12528282,chr3,12528203,12528282,0,137852639
H1|chr3:150522694-150522724,chr3,150522694,150522724,H1|chr3:51573508-51573658,chr3,51573508,51573658,0,98949186
H1|chr3:150858323-150858421,chr3,150858323,150858421,H1|chr3:109052036-109052079,chr3,109052036,109052079,0,41806287
H1|chr3:151097309-151097364,chr3,151097309,151097364,H1|chr3:3844133-3844183,chr3,3844133,3844183,0,147253176
H1|chr3:151133324-151133396,chr3,151133324,151133396,H1|chr3:44669705-44669818,chr3,44669705,44669818,0,106463619
H1|chr3:151388309-151388349,chr3,151388309,151388349,H1|chr3:32826162-32826240,chr3,32826162,32826240,0,118562147
H1|chr3:151839354-151839437,chr3,151839354,151839437,H1|chr3:150481528-150481587,chr3,150481528,150481587,0,1357826
H1|chr3:151920657-151920749,chr3,151920657,151920749,H1|chr3:109061286-109061344,chr3,109061286,109061344,0,42859371
H1|chr3:151962920-151963022,chr3,151962920,151963022,H1|chr3:185539893-185539924,chr3,185539893,185539924,0,33576973
H1|chr3:152083036-152083063,chr3,152083036,152083063,H1|chr3:43731287-43731361,chr3,43731287,43731361,0,108351749
H1|chr3:152324634-152324716,chr3,152324634,152324716,H1|chr3:32858410-32858468,chr3,32858410,32858468,0,119466224
H1|chr3:153168584-153168643,chr3,153168584,153168643,H1|chr3:39445061-39445152,chr3,39445061,39445152,0,113723523
H1|chr3:153759348-153759366,chr3,153759348,153759366,H1|chr3:109053733-109053798,chr3,109053733,109053798,0,44705615
H1|chr3:153805813-153805910,chr3,153805813,153805910,H1|chr3:32856565-32856595,chr3,32856565,32856595,0,120949248
H1|chr3:154333963-154334020,chr3,154333963,154334020,H1|chr3:109053396-109053440,chr3,109053396,109053440,0,45280567
H1|chr3:155000630-155000711,chr3,155000630,155000711,H1|chr3:9442761-9442830,chr3,9442761,9442830,0,145557869
H1|chr3:155339296-155339352,chr3,155339296,155339352,H1|chr3:3844035-3844094,chr3,3844035,3844094,0,151495261
H1|chr3:155420651-155420766,chr3,155420651,155420766,H1|chr3:39455638-39455661,chr3,39455638,39455661,0,115965013
H1|chr3:155584892-155584998,chr3,155584892,155584998,H1|chr3:39450367-39450474,chr3,39450367,39450474,0,116134525
H1|chr3:155939602-155939650,chr3,155939602,155939650,H1|chr3:32727332-32727431,chr3,32727332,32727431,0,123212270
H1|chr3:156166966-156167078,chr3,156166966,156167078,H1|chr3:32861811-32861888,chr3,32861811,32861888,0,123305155
H1|chr3:156243479-156243584,chr3,156243479,156243584,H1|chr3:109053733-109053795,chr3,109053733,109053795,0,47189746
H1|chr3:156400405-156400439,chr3,156400405,156400439,H1|chr3:32857195-32857311,chr3,32857195,32857311,0,123543210
H1|chr3:156403568-156403640,chr3,156403568,156403640,H1|chr3:33142479-33142540,chr3,33142479,33142540,0,123261089
H1|chr3:156544182-156544217,chr3,156544182,156544217,H1|chr3:32857195-32857311,chr3,32857195,32857311,0,123686987
H1|chr3:156903710-156903770,chr3,156903710,156903770,H1|chr3:132380403-132380498,chr3,132380403,132380498,0,24523307
H1|chr3:157143929-157144031,chr3,157143929,157144031,H1|chr3:109054399-109054549,chr3,109054399,109054549,0,48089530
H1|chr3:157677129-157677173,chr3,157677129,157677173,H1|chr3:9883826-9883908,chr3,9883826,9883908,0,147793303
H1|chr3:158131282-158131316,chr3,158131282,158131316,H1|chr3:57198970-57199032,chr3,57198970,57199032,0,100932312
H1|chr3:158135784-158135856,chr3,158135784,158135856,H1|chr3:109057927-109058077,chr3,109057927,109058077,0,49077857
H1|chr3:158427831-158427977,chr3,158427831,158427977,H1|chr3:185547586-185547669,chr3,185547586,185547669,0,27119755
H1|chr3:158889200-158889259,chr3,158889200,158889259,H1|chr3:39445061-39445152,chr3,39445061,39445152,0,119444139
H1|chr3:159498283-159498339,chr3,159498283,159498339,H1|chr3:32859240-32859314,chr3,32859240,32859314,0,126639043
H1|chr3:159698801-159698878,chr3,159698801,159698878,H1|chr3:193851731-193851804,chr3,193851731,193851804,0,34152930
H1|chr3:159746825-159746893,chr3,159746825,159746893,H1|chr3:9434619-9434681,chr3,9434619,9434681,0,150312206
H1|chr3:161245515-161245569,chr3,161245515,161245569,H1|chr3:32858541-32858637,chr3,32858541,32858637,0,128386974
H1|chr3:161467399-161467450,chr3,161467399,161467450,H1|chr3:195721335-195721434,chr3,195721335,195721434,0,34253936
H1|chr3:161757307-161757353,chr3,161757307,161757353,H1|chr3:185652568-185652602,chr3,185652568,185652602,0,23895261
H1|chr3:161964309-161964340,chr3,161964309,161964340,H1|chr3:179043159-179043309,chr3,179043159,179043309,0,17078850
H1|chr3:162089873-162089968,chr3,162089873,162089968,H1|chr3:186897918-186897969,chr3,186897918,186897969,0,24808045
H1|chr3:163040079-163040174,chr3,163040079,163040174,H1|chr3:33143313-33143355,chr3,33143313,33143355,0,129896766
H1|chr3:163137304-163137370,chr3,163137304,163137370,H1|chr3:32860638-32860722,chr3,32860638,32860722,0,130276666
H1|chr3:163429058-163429089,chr3,163429058,163429089,H1|chr3:185826554-185826612,chr3,185826554,185826612,0,22397496
H1|chr3:163502321-163502405,chr3,163502321,163502405,H1|chr3:150481528-150481587,chr3,150481528,150481587,0,13020793
H1|chr3:163655329-163655382,chr3,163655329,163655382,H1|chr3:113458979-113459061,chr3,113458979,113459061,0,50196350
H1|chr3:163927498-163927582,chr3,163927498,163927582,H1|chr3:57198970-57199032,chr3,57198970,57199032,0,106728528
H1|chr3:164345448-164345523,chr3,164345448,164345523,H1|chr3:186897232-186897296,chr3,186897232,186897296,0,22551784
H1|chr3:164606334-164606389,chr3,164606334,164606389,H1|chr3:185541807-185541848,chr3,185541807,185541848,0,20935473
H1|chr3:164713389-164713456,chr3,164713389,164713456,H1|chr3:150129913-150129968,chr3,150129913,150129968,0,14583476
H1|chr3:165093788-165093883,chr3,165093788,165093883,H1|chr3:33143313-33143355,chr3,33143313,33143355,0,131950475
H1|chr3:165512803-165512848,chr3,165512803,165512848,H1|chr3:185654620-185654725,chr3,185654620,185654725,0,20141817
H1|chr3:165878807-165878957,chr3,165878807,165878957,H1|chr3:149947594-149947611,chr3,149947594,149947611,0,15931213
H1|chr3:166257344-166257494,chr3,166257344,166257494,H1|chr3:195363784-195363934,chr3,195363784,195363934,0,29106440
H1|chr3:166845360-166845510,chr3,166845360,166845510,H1|chr3:32856558-32856575,chr3,32856558,32856575,0,133988802
H1|chr3:167060725-167060780,chr3,167060725,167060780,H1|chr3:51573679-51573815,chr3,51573679,51573815,0,115487046
H1|chr3:167698292-167698399,chr3,167698292,167698399,H1|chr3:40547902-40547939,chr3,40547902,40547939,0,127150390
H1|chr3:168114803-168114868,chr3,168114803,168114868,H1|chr3:186897468-186897553,chr3,186897468,186897553,0,18782665
H1|chr3:168431868-168431908,chr3,168431868,168431908,H1|chr3:32825203-32825353,chr3,32825203,32825353,0,135606665
H1|chr3:168710644-168710737,chr3,168710644,168710737,H1|chr3:50542247-50542304,chr3,50542247,50542304,0,118168397
H1|chr3:169235401-169235491,chr3,169235401,169235491,H1|chr3:3843518-3843578,chr3,3843518,3843578,0,165391883
H1|chr3:169699588-169699667,chr3,169699588,169699667,H1|chr3:32858611-32858640,chr3,32858611,32858640,0,136840977
H1|chr3:169919940-169920010,chr3,169919940,169920010,H1|chr3:135912712-135912778,chr3,135912712,135912778,0,34007228
H1|chr3:170318095-170318192,chr3,170318095,170318192,H1|chr3:53324303-53324356,chr3,53324303,53324356,0,116993792
H1|chr3:172115664-172115760,chr3,172115664,172115760,H1|chr3:132131844-132131886,chr3,132131844,132131886,0,39983820
H1|chr3:172260575-172260679,chr3,172260575,172260679,H1|chr3:185539893-185539924,chr3,185539893,185539924,0,13279318
H1|chr3:172320241-172320337,chr3,172320241,172320337,H1|chr3:186897918-186897969,chr3,186897918,186897969,0,14577677
H1|chr3:173148682-173148752,chr3,173148682,173148752,H1|chr3:32615499-32615579,chr3,32615499,32615579,0,140533183
H1|chr3:173168520-173168578,chr3,173168520,173168578,H1|chr3:52002435-52002502,chr3,52002435,52002502,0,121166085
H1|chr3:173353836-173353875,chr3,173353836,173353875,H1|chr3:132137780-132137849,chr3,132137780,132137849,0,41216056
H1|chr3:173574038-173574155,chr3,173574038,173574155,H1|chr3:53324303-53324356,chr3,53324303,53324356,0,120249735
H1|chr3:174050952-174051056,chr3,174050952,174051056,H1|chr3:185539893-185539924,chr3,185539893,185539924,0,11488941
H1|chr3:174456750-174456780,chr3,174456750,174456780,H1|chr3:14553425-14553538,chr3,14553425,14553538,0,159903325
H1|chr3:174502593-174502675,chr3,174502593,174502675,H1|chr3:32858410-32858468,chr3,32858410,32858468,0,141644183
H1|chr3:174640419-174640448,chr3,174640419,174640448,H1|chr3:52567152-52567232,chr3,52567152,52567232,0,122073267
H1|chr3:175198887-175198939,chr3,175198887,175198939,H1|chr3:179371657-179371724,chr3,179371657,179371724,0,4172770
H1|chr3:175415800-175415852,chr3,175415800,175415852,H1|chr3:32858398-32858496,chr3,32858398,32858496,0,142557402
H1|chr3:175492667-175492720,chr3,175492667,175492720,H1|chr3:32856857-32856919,chr3,32856857,32856919,0,142635810
H1|chr3:175900383-175900501,chr3,175900383,175900501,H1|chr3:53324233-53324265,chr3,53324233,53324265,0,122576150
H1|chr3:176164538-176164611,chr3,176164538,176164611,H1|chr3:32824970-32824991,chr3,32824970,32824991,0,143339568
H1|chr3:176686255-176686356,chr3,176686255,176686356,H1|chr3:32858010-32858044,chr3,32858010,32858044,0,143828245
H1|chr3:177376944-177377029,chr3,177376944,177377029,H1|chr3:109058515-109058546,chr3,109058515,109058546,0,68318429
H1|chr3:177399601-177399658,chr3,177399601,177399658,H1|chr3:32823662-32823746,chr3,32823662,32823746,0,144575939
H1|chr3:177589564-177589632,chr3,177589564,177589632,H1|chr3:32826712-32826803,chr3,32826712,32826803,0,144762852
H1|chr3:178288907-178288938,chr3,178288907,178288938,H1|chr3:18485587-18485702,chr3,18485587,18485702,0,159803320
H1|chr3:178684601-178684720,chr3,178684601,178684720,H1|chr3:32858076-32858107,chr3,32858076,32858107,0,145826525
H1|chr3:179235814-179235868,chr3,179235814,179235868,H1|chr3:32858541-32858637,chr3,32858541,32858637,0,146377273
H1|chr3:179245781-179245820,chr3,179245781,179245820,H1|chr3:132137780-132137849,chr3,132137780,132137849,0,47108001
H1|chr3:180306789-180306829,chr3,180306789,180306829,H1|chr3:13115628-13115738,chr3,13115628,13115738,0,167191161
H1|chr3:180324900-180324978,chr3,180324900,180324978,H1|chr3:32859105-32859177,chr3,32859105,32859177,0,147465795
H1|chr3:180751985-180752047,chr3,180751985,180752047,H1|chr3:187458527-187458581,chr3,187458527,187458581,0,6706542
H1|chr3:180955718-180955736,chr3,180955718,180955736,H1|chr3:109053733-109053798,chr3,109053733,109053798,0,71901985
H1|chr3:181063412-181063473,chr3,181063412,181063473,H1|chr3:136581528-136581616,chr3,136581528,136581616,0,44481884
H1|chr3:181283332-181283366,chr3,181283332,181283366,H1|chr3:32857195-32857311,chr3,32857195,32857311,0,148426137
H1|chr3:181298801-181298900,chr3,181298801,181298900,H1|chr3:109052036-109052079,chr3,109052036,109052079,0,72246765
H1|chr3:181618870-181618940,chr3,181618870,181618940,H1|chr3:32859297-32859331,chr3,32859297,32859331,0,148759573
H1|chr3:181775713-181775763,chr3,181775713,181775763,H1|chr3:32857591-32857662,chr3,32857591,32857662,0,148918122
H1|chr3:182339364-182339395,chr3,182339364,182339395,H1|chr3:18485587-18485702,chr3,18485587,18485702,0,163853777
H1|chr3:182644599-182644669,chr3,182644599,182644669,H1|chr3:39456260-39456332,chr3,39456260,39456332,0,143188339
H1|chr3:182932680-182932782,chr3,182932680,182932782,H1|chr3:185539893-185539924,chr3,185539893,185539924,0,2607213
H1|chr3:184316376-184316457,chr3,184316376,184316457,H1|chr3:186897232-186897296,chr3,186897232,186897296,0,2580856
H1|chr3:187076989-187077122,chr3,187076989,187077122,H1|chr3:69128454-69128474,chr3,69128454,69128474,0,117948535
H1|chr3:187344837-187344888,chr3,187344837,187344888,H1|chr3:48754359-48754448,chr3,48754359,48754448,0,138590478
H1|chr3:187439495-187439550,chr3,187439495,187439550,H1|chr3:109054648-109054798,chr3,109054648,109054798,0,78384847
H1|chr3:188208123-188208196,chr3,188208123,188208196,H1|chr3:71630987-71631070,chr3,71630987,71631070,0,116577136
H1|chr3:188571770-188571813,chr3,188571770,188571813,H1|chr3:9883826-9883907,chr3,9883826,9883907,0,178687944
H1|chr3:188703252-188703333,chr3,188703252,188703333,H1|chr3:32860692-32860729,chr3,32860692,32860729,0,155842560
H1|chr3:188999460-188999610,chr3,188999460,188999610,H1|chr3:195363784-195363934,chr3,195363784,195363934,0,6364324
H1|chr3:189479859-189479992,chr3,189479859,189479992,H1|chr3:69128454-69128474,chr3,69128454,69128474,0,120351405
H1|chr3:189570530-189570668,chr3,189570530,189570668,H1|chr3:39445029-39445087,chr3,39445029,39445087,0,150125501
H1|chr3:190149232-190149345,chr3,190149232,190149345,H1|chr3:39455638-39455663,chr3,39455638,39455663,0,150693594
H1|chr3:190191222-190191294,chr3,190191222,190191294,H1|chr3:44669705-44669818,chr3,44669705,44669818,0,145521517
H1|chr3:190514902-190514983,chr3,190514902,190514983,H1|chr3:172471099-172471143,chr3,172471099,172471143,0,18043803
H1|chr3:190999431-190999507,chr3,190999431,190999507,H1|chr3:179371602-179371633,chr3,179371602,179371633,0,11627829
H1|chr3:191087922-191088017,chr3,191087922,191088017,H1|chr3:33840763-33840827,chr3,33840763,33840827,0,157247159
H1|chr3:191284711-191284819,chr3,191284711,191284819,H1|chr3:33836089-33836127,chr3,33836089,33836127,0,157448622
H1|chr3:192004494-192004551,chr3,192004494,192004551,H1|chr3:186650187-186650232,chr3,186650187,186650232,0,5354307
H1|chr3:192139112-192139234,chr3,192139112,192139234,H1|chr3:32612841-32612901,chr3,32612841,32612901,0,159526271
H1|chr3:192189010-192189096,chr3,192189010,192189096,H1|chr3:32857791-32857823,chr3,32857791,32857823,0,159331219
H1|chr3:192502640-192502658,chr3,192502640,192502658,H1|chr3:32826979-32827042,chr3,32826979,32827042,0,159675661
H1|chr3:193389979-193390085,chr3,193389979,193390085,H1|chr3:39450367-39450474,chr3,39450367,39450474,0,153939612
H1|chr3:193648226-193648262,chr3,193648226,193648262,H1|chr3:186523853-186523937,chr3,186523853,186523937,0,7124373
H1|chr3:193651926-193652010,chr3,193651926,193652010,H1|chr3:185652691-185652744,chr3,185652691,185652744,0,7999235
H1|chr3:195538298-195538347,chr3,195538298,195538347,H1|chr3:48754359-48754448,chr3,48754359,48754448,0,146783939
H1|chr3:195998206-195998269,chr3,195998206,195998269,H1|chr3:135912712-135912778,chr3,135912712,135912778,0,60085494
H1|chr3:196007569-196007619,chr3,196007569,196007619,H1|chr3:113458999-113459064,chr3,113458999,113459064,0,82548570
H1|chr3:196205055-196205125,chr3,196205055,196205125,H1|chr3:135912712-135912778,chr3,135912712,135912778,0,60292343
H1|chr3:196426380-196426447,chr3,196426380,196426447,H1|chr3:150129913-150129968,chr3,150129913,150129968,0,46296467
H1|chr3:197425893-197425958,chr3,197425893,197425958,H1|chr3:32854776-32854910,chr3,32854776,32854910,0,164571117
H1|chr4:403190-403272,chr4,403190,403272,H1|chr4:90603915-90604065,chr4,90603915,90604065,0,90200725
H1|chr4:640974-641111,chr4,640974,641111,H1|chr4:130013916-130013955,chr4,130013916,130013955,0,129372942
H1|chr4:1080578-1080653,chr4,1080578,1080653,H1|chr4:671445-671518,chr4,671445,671518,0,409133
H1|chr4:2045866-2045886,chr4,2045866,2045886,H1|chr4:113736201-113736338,chr4,113736201,113736338,0,111690335
H1|chr4:2456735-2456789,chr4,2456735,2456789,H1|chr4:123751561-123751657,chr4,123751561,123751657,0,121294826
H1|chr4:2491763-2491786,chr4,2491763,2491786,H1|chr4:56410062-56410148,chr4,56410062,56410148,0,53918299
H1|chr4:3507054-3507164,chr4,3507054,3507164,H1|chr4:152021400-152021435,chr4,152021400,152021435,0,148514346
H1|chr4:4011308-4011433,chr4,4011308,4011433,H1|chr4:89374940-89375004,chr4,89374940,89375004,0,85363632
H1|chr4:4850786-4850845,chr4,4850786,4850845,H1|chr4:113737875-113737966,chr4,113737875,113737966,0,108887089
H1|chr4:5357183-5357258,chr4,5357183,5357258,H1|chr4:52709884-52709937,chr4,52709884,52709937,0,47352701
H1|chr4:6598420-6598470,chr4,6598420,6598470,H1|chr4:113632138-113632195,chr4,113632138,113632195,0,107033718
H1|chr4:6887441-6887549,chr4,6887441,6887549,H1|chr4:209152-209197,chr4,209152,209197,0,6678289
H1|chr4:7542211-7542247,chr4,7542211,7542247,H1|chr4:103681045-103681192,chr4,103681045,103681192,0,96138834
H1|chr4:7699222-7699362,chr4,7699222,7699362,H1|chr4:113629955-113630047,chr4,113629955,113630047,0,105930733
H1|chr4:7893534-7893593,chr4,7893534,7893593,H1|chr4:126141-126191,chr4,126141,126191,0,7767393
H1|chr4:8085278-8085354,chr4,8085278,8085354,H1|chr4:52709884-52709937,chr4,52709884,52709937,0,44624606
H1|chr4:8413875-8414016,chr4,8413875,8414016,H1|chr4:93225439-93225509,chr4,93225439,93225509,0,84811564
H1|chr4:8491318-8491402,chr4,8491318,8491402,H1|chr4:93224566-93224594,chr4,93224566,93224594,0,84733248
H1|chr4:9243721-9243811,chr4,9243721,9243811,H1|chr4:113632164-113632258,chr4,113632164,113632258,0,104388443
H1|chr4:9569444-9569527,chr4,9569444,9569527,H1|chr4:129649-129715,chr4,129649,129715,0,9439795
H1|chr4:9570681-9570731,chr4,9570681,9570731,H1|chr4:113630611-113630710,chr4,113630611,113630710,0,104059930
H1|chr4:9701754-9701784,chr4,9701754,9701784,H1|chr4:113631698-113631757,chr4,113631698,113631757,0,103929944
H1|chr4:9952114-9952154,chr4,9952114,9952154,H1|chr4:26361604-26361641,chr4,26361604,26361641,0,16409490
H1|chr4:11341624-11341713,chr4,11341624,11341713,H1|chr4:93199867-93199923,chr4,93199867,93199923,0,81858243
H1|chr4:12045746-12045854,chr4,12045746,12045854,H1|chr4:130013916-130013955,chr4,130013916,130013955,0,117968170
H1|chr4:12564901-12565000,chr4,12564901,12565000,H1|chr4:6269934-6269966,chr4,6269934,6269966,0,6294967
H1|chr4:12736024-12736083,chr4,12736024,12736083,H1|chr4:183371256-183371406,chr4,183371256,183371406,0,170635232
H1|chr4:12796451-12796563,chr4,12796451,12796563,H1|chr4:4857674-4857712,chr4,4857674,4857712,0,7938777
H1|chr4:13187008-13187098,chr4,13187008,13187098,H1|chr4:177117543-177117603,chr4,177117543,177117603,0,163930535
H1|chr4:13832899-13832984,chr4,13832899,13832984,H1|chr4:93224566-93224594,chr4,93224566,93224594,0,79391667
H1|chr4:14827830-14827912,chr4,14827830,14827912,H1|chr4:113736274-113736342,chr4,113736274,113736342,0,98908444
H1|chr4:14993091-14993111,chr4,14993091,14993111,H1|chr4:113736201-113736338,chr4,113736201,113736338,0,98743110
H1|chr4:15687546-15687668,chr4,15687546,15687668,H1|chr4:113736274-113736342,chr4,113736274,113736342,0,98048728
H1|chr4:16127085-16127211,chr4,16127085,16127211,H1|chr4:113736966-113737082,chr4,113736966,113737082,0,97609881
H1|chr4:16949274-16949352,chr4,16949274,16949352,H1|chr4:113632697-113632778,chr4,113632697,113632778,0,96683423
H1|chr4:17101895-17101981,chr4,17101895,17101981,H1|chr4:140097007-140097097,chr4,140097007,140097097,0,122995112
H1|chr4:18037794-18037873,chr4,18037794,18037873,H1|chr4:113630851-113630904,chr4,113630851,113630904,0,95593057
H1|chr4:18127783-18127895,chr4,18127783,18127895,H1|chr4:113738536-113738569,chr4,113738536,113738569,0,95610753
H1|chr4:19395646-19395696,chr4,19395646,19395696,H1|chr4:113632138-113632195,chr4,113632138,113632195,0,94236492
H1|chr4:19479946-19480038,chr4,19479946,19480038,H1|chr4:93202031-93202088,chr4,93202031,93202088,0,73722085
H1|chr4:19486003-19486077,chr4,19486003,19486077,H1|chr4:93198973-93199002,chr4,93198973,93199002,0,73712970
H1|chr4:19578820-19578912,chr4,19578820,19578912,H1|chr4:93202031-93202088,chr4,93202031,93202088,0,73623211
H1|chr4:19742076-19742167,chr4,19742076,19742167,H1|chr4:93225327-93225375,chr4,93225327,93225375,0,73483251
H1|chr4:20296176-20296214,chr4,20296176,20296214,H1|chr4:113738051-113738201,chr4,113738051,113738201,0,93441875
H1|chr4:20352971-20353040,chr4,20352971,20353040,H1|chr4:113736198-113736279,chr4,113736198,113736279,0,93383227
H1|chr4:20441714-20441816,chr4,20441714,20441816,H1|chr4:85502701-85502766,chr4,85502701,85502766,0,65060987
H1|chr4:21634548-21634630,chr4,21634548,21634630,H1|chr4:93224830-93224898,chr4,93224830,93224898,0,71590282
H1|chr4:21671905-21671968,chr4,21671905,21671968,H1|chr4:89373726-89373789,chr4,89373726,89373789,0,67701821
H1|chr4:22023233-22023289,chr4,22023233,22023289,H1|chr4:87514443-87514514,chr4,87514443,87514514,0,65491210
H1|chr4:22775165-22775283,chr4,22775165,22775283,H1|chr4:113632862-113632957,chr4,113632862,113632957,0,90857697
H1|chr4:22834613-22834711,chr4,22834613,22834711,H1|chr4:205447-205499,chr4,205447,205499,0,22629166
H1|chr4:22946632-22946655,chr4,22946632,22946655,H1|chr4:113632165-113632266,chr4,113632165,113632266,0,90685533
H1|chr4:23578391-23578490,chr4,23578391,23578490,H1|chr4:6269934-6269966,chr4,6269934,6269966,0,17308457
H1|chr4:24843186-24843292,chr4,24843186,24843292,H1|chr4:159644146-159644165,chr4,159644146,159644165,0,134800960
H1|chr4:27030887-27030916,chr4,27030887,27030916,H1|chr4:26363096-26363197,chr4,26363096,26363197,0,667791
H1|chr4:27939439-27939509,chr4,27939439,27939509,H1|chr4:113736316-113736373,chr4,113736316,113736373,0,85796877
H1|chr4:29102566-29102716,chr4,29102566,29102716,H1|chr4:4857674-4857712,chr4,4857674,4857712,0,24244892
H1|chr4:29453132-29453187,chr4,29453132,29453187,H1|chr4:113737871-113737966,chr4,113737871,113737966,0,84284739
H1|chr4:29467684-29467774,chr4,29467684,29467774,H1|chr4:177117543-177117603,chr4,177117543,177117603,0,147649859
H1|chr4:29635200-29635256,chr4,29635200,29635256,H1|chr4:113735345-113735394,chr4,113735345,113735394,0,84100145
H1|chr4:31125180-31125243,chr4,31125180,31125243,H1|chr4:89373726-89373789,chr4,89373726,89373789,0,58248546
H1|chr4:31274725-31274762,chr4,31274725,31274762,H1|chr4:146859980-146860064,chr4,146859980,146860064,0,115585255
H1|chr4:31542439-31542489,chr4,31542439,31542489,H1|chr4:100008007-100008088,chr4,100008007,100008088,0,68465568
H1|chr4:31706361-31706408,chr4,31706361,31706408,H1|chr4:331089-331155,chr4,331089,331155,0,31375272
H1|chr4:32213491-32213554,chr4,32213491,32213554,H1|chr4:113734459-113734546,chr4,113734459,113734546,0,81520968
H1|chr4:32283945-32284095,chr4,32283945,32284095,H1|chr4:4857674-4857712,chr4,4857674,4857712,0,27426271
H1|chr4:32392044-32392111,chr4,32392044,32392111,H1|chr4:78978127-78978277,chr4,78978127,78978277,0,46586083
H1|chr4:32563802-32563893,chr4,32563802,32563893,H1|chr4:113736198-113736279,chr4,113736198,113736279,0,81172396
H1|chr4:32781297-32781352,chr4,32781297,32781352,H1|chr4:113632862-113632957,chr4,113632862,113632957,0,80851565
H1|chr4:32924959-32925044,chr4,32924959,32925044,H1|chr4:93224830-93224898,chr4,93224830,93224898,0,60299871
H1|chr4:32961123-32961179,chr4,32961123,32961179,H1|chr4:113632164-113632258,chr4,113632164,113632258,0,80671041
H1|chr4:33212878-33212928,chr4,33212878,33212928,H1|chr4:100008007-100008088,chr4,100008007,100008088,0,66795129
H1|chr4:33446711-33446772,chr4,33446711,33446772,H1|chr4:93224993-93225093,chr4,93224993,93225093,0,59778282
H1|chr4:33451266-33451328,chr4,33451266,33451328,H1|chr4:89373725-89373789,chr4,89373725,89373789,0,55922459
H1|chr4:33500698-33500733,chr4,33500698,33500733,H1|chr4:103681045-103681192,chr4,103681045,103681192,0,70180347
H1|chr4:33507922-33507959,chr4,33507922,33507959,H1|chr4:93202800-93202888,chr4,93202800,93202888,0,59694878
H1|chr4:33882171-33882201,chr4,33882171,33882201,H1|chr4:26363096-26363197,chr4,26363096,26363197,0,7519075
H1|chr4:34570905-34570928,chr4,34570905,34570928,H1|chr4:56410062-56410148,chr4,56410062,56410148,0,21839157
H1|chr4:34778473-34778522,chr4,34778473,34778522,H1|chr4:113632138-113632195,chr4,113632138,113632195,0,78853665
H1|chr4:37505676-37505706,chr4,37505676,37505706,H1|chr4:53589308-53589396,chr4,53589308,53589396,0,16083632
H1|chr4:38390465-38390510,chr4,38390465,38390510,H1|chr4:113738089-113738170,chr4,113738089,113738170,0,75347624
H1|chr4:39544125-39544155,chr4,39544125,39544155,H1|chr4:6198558-6198631,chr4,6198558,6198631,0,33345567
H1|chr4:39746428-39746509,chr4,39746428,39746509,H1|chr4:16899107-16899159,chr4,16899107,16899159,0,22847321
H1|chr4:39880179-39880241,chr4,39880179,39880241,H1|chr4:93198973-93199002,chr4,93198973,93199002,0,53318794
H1|chr4:40436331-40436366,chr4,40436331,40436366,H1|chr4:120381148-120381277,chr4,120381148,120381277,0,79944817
H1|chr4:40769067-40769117,chr4,40769067,40769117,H1|chr4:188917431-188917537,chr4,188917431,188917537,0,148148364
H1|chr4:42238192-42238277,chr4,42238192,42238277,H1|chr4:93224830-93224898,chr4,93224830,93224898,0,50986638
H1|chr4:42974998-42975111,chr4,42974998,42975111,H1|chr4:93226926-93226960,chr4,93226926,93226960,0,50251928
H1|chr4:44116643-44116777,chr4,44116643,44116777,H1|chr4:113739075-113739105,chr4,113739075,113739105,0,69622432
H1|chr4:44958079-44958135,chr4,44958079,44958135,H1|chr4:87514443-87514514,chr4,87514443,87514514,0,42556364
H1|chr4:45127654-45127721,chr4,45127654,45127721,H1|chr4:123750669-123750698,chr4,123750669,123750698,0,78623015
H1|chr4:45137939-45138024,chr4,45137939,45138024,H1|chr4:93224566-93224594,chr4,93224566,93224594,0,48086627
H1|chr4:45310458-45310536,chr4,45310458,45310536,H1|chr4:93201049-93201121,chr4,93201049,93201121,0,47890591
H1|chr4:45527201-45527287,chr4,45527201,45527287,H1|chr4:140097007-140097097,chr4,140097007,140097097,0,94569806
H1|chr4:45572911-45572986,chr4,45572911,45572986,H1|chr4:671445-671518,chr4,671445,671518,0,44901466
H1|chr4:46523121-46523197,chr4,46523121,46523197,H1|chr4:153701700-153701774,chr4,153701700,153701774,0,107178579
H1|chr4:46857432-46857544,chr4,46857432,46857544,H1|chr4:154126276-154126302,chr4,154126276,154126302,0,107268844
H1|chr4:48570628-48570654,chr4,48570628,48570654,H1|chr4:113738015-113738152,chr4,113738015,113738152,0,65167387
H1|chr4:49728486-49728591,chr4,49728486,49728591,H1|chr4:209152-209197,chr4,209152,209197,0,49519334
H1|chr4:50436211-50436337,chr4,50436211,50436337,H1|chr4:113736966-113737082,chr4,113736966,113737082,0,63300755
H1|chr4:50771778-50771827,chr4,50771778,50771827,H1|chr4:93202686-93202779,chr4,93202686,93202779,0,42430908
H1|chr4:51202436-51202507,chr4,51202436,51202507,H1|chr4:93202709-93202785,chr4,93202709,93202785,0,42000273
H1|chr4:51793423-51793459,chr4,51793423,51793459,H1|chr4:103681045-103681192,chr4,103681045,103681192,0,51887622
H1|chr4:51925925-51925973,chr4,51925925,51925973,H1|chr4:93201335-93201373,chr4,93201335,93201373,0,41275410
H1|chr4:51986808-51986826,chr4,51986808,51986826,H1|chr4:6198499-6198631,chr4,6198499,6198631,0,45788309
H1|chr4:52117246-52117282,chr4,52117246,52117282,H1|chr4:153701700-153701774,chr4,153701700,153701774,0,101584454
H1|chr4:52903569-52903620,chr4,52903569,52903620,H1|chr4:113630611-113630710,chr4,113630611,113630710,0,60727042
H1|chr4:53140277-53140337,chr4,53140277,53140337,H1|chr4:128799661-128799751,chr4,128799661,128799751,0,75659384
H1|chr4:53187064-53187158,chr4,53187064,53187158,H1|chr4:56263589-56263614,chr4,56263589,56263614,0,3076525
H1|chr4:54193216-54193277,chr4,54193216,54193277,H1|chr4:78978127-78978277,chr4,78978127,78978277,0,24784911
H1|chr4:54472813-54472906,chr4,54472813,54472906,H1|chr4:2058172-2058204,chr4,2058172,2058204,0,52414641
H1|chr4:55137466-55137492,chr4,55137466,55137492,H1|chr4:113738015-113738152,chr4,113738015,113738152,0,58600549
H1|chr4:55501481-55501508,chr4,55501481,55501508,H1|chr4:85502701-85502757,chr4,85502701,85502757,0,30001220
H1|chr4:55646315-55646395,chr4,55646315,55646395,H1|chr4:53784-53851,chr4,53784,53851,0,55592531
H1|chr4:56214899-56215049,chr4,56214899,56215049,H1|chr4:93226929-93226960,chr4,93226929,93226960,0,37012030
H1|chr4:57360749-57360830,chr4,57360749,57360830,H1|chr4:90603915-90604065,chr4,90603915,90604065,0,33243166
H1|chr4:57575524-57575554,chr4,57575524,57575554,H1|chr4:113631698-113631757,chr4,113631698,113631757,0,56056174
H1|chr4:57797556-57797620,chr4,57797556,57797620,H1|chr4:113734459-113734546,chr4,113734459,113734546,0,55936903
H1|chr4:57980350-57980466,chr4,57980350,57980466,H1|chr4:205447-205499,chr4,205447,205499,0,57774903
H1|chr4:59523933-59524017,chr4,59523933,59524017,H1|chr4:125878-125902,chr4,125878,125902,0,59398055
H1|chr4:59545093-59545163,chr4,59545093,59545163,H1|chr4:93199867-93199947,chr4,93199867,93199947,0,33654774
H1|chr4:60002412-60002535,chr4,60002412,60002535,H1|chr4:129733806-129733827,chr4,129733806,129733827,0,69731394
H1|chr4:60821547-60821604,chr4,60821547,60821604,H1|chr4:113632680-113632773,chr4,113632680,113632773,0,52811133
H1|chr4:60878596-60878625,chr4,60878596,60878625,H1|chr4:85502701-85502822,chr4,85502701,85502822,0,24624105
H1|chr4:61923118-61923226,chr4,61923118,61923226,H1|chr4:209152-209197,chr4,209152,209197,0,61713966
H1|chr4:62366555-62366626,chr4,62366555,62366626,H1|chr4:93202709-93202785,chr4,93202709,93202785,0,30836154
H1|chr4:62842031-62842071,chr4,62842031,62842071,H1|chr4:146859829-146859877,chr4,146859829,146859877,0,84017798
H1|chr4:63597004-63597061,chr4,63597004,63597061,H1|chr4:56264232-56264311,chr4,56264232,56264311,0,7332772
H1|chr4:63752976-63753039,chr4,63752976,63753039,H1|chr4:113734459-113734546,chr4,113734459,113734546,0,49981483
H1|chr4:64049043-64049098,chr4,64049043,64049098,H1|chr4:113737871-113737966,chr4,113737871,113737966,0,49688828
H1|chr4:64235848-64235892,chr4,64235848,64235892,H1|chr4:188917431-188917537,chr4,188917431,188917537,0,124681583
H1|chr4:64503562-64503680,chr4,64503562,64503680,H1|chr4:113738232-113738257,chr4,113738232,113738257,0,49234670
H1|chr4:65364877-65364938,chr4,65364877,65364938,H1|chr4:18022769-18022919,chr4,18022769,18022919,0,47342108
H1|chr4:66017970-66018043,chr4,66017970,66018043,H1|chr4:16899115-16899159,chr4,16899115,16899159,0,49118855
H1|chr4:66021036-66021101,chr4,66021036,66021101,H1|chr4:123750669-123750698,chr4,123750669,123750698,0,57729633
H1|chr4:66418616-66418706,chr4,66418616,66418706,H1|chr4:87516410-87516470,chr4,87516410,87516470,0,21097794
H1|chr4:66785528-66785570,chr4,66785528,66785570,H1|chr4:205446-205583,chr4,205446,205583,0,66580082
H1|chr4:66806713-66806758,chr4,66806713,66806758,H1|chr4:113738089-113738170,chr4,113738089,113738170,0,46931376
H1|chr4:67905639-67905717,chr4,67905639,67905717,H1|chr4:159644146-159644165,chr4,159644146,159644165,0,91738507
H1|chr4:67966274-67966352,chr4,67966274,67966352,H1|chr4:113632697-113632778,chr4,113632697,113632778,0,45666423
H1|chr4:68899642-68899733,chr4,68899642,68899733,H1|chr4:113736198-113736279,chr4,113736198,113736279,0,44836556
H1|chr4:69020430-69020497,chr4,69020430,69020497,H1|chr4:4859048-4859092,chr4,4859048,4859092,0,64161382
H1|chr4:69166038-69166103,chr4,69166038,69166103,H1|chr4:40060278-40060310,chr4,40060278,40060310,0,29105760
H1|chr4:70009871-70010015,chr4,70009871,70010015,H1|chr4:113736947-113737020,chr4,113736947,113737020,0,43727076
H1|chr4:71815293-71815376,chr4,71815293,71815376,H1|chr4:129649-129715,chr4,129649,129715,0,71685644
H1|chr4:72812072-72812147,chr4,72812072,72812147,H1|chr4:52709884-52709937,chr4,52709884,52709937,0,20102188
H1|chr4:73067093-73067203,chr4,73067093,73067203,H1|chr4:152021400-152021435,chr4,152021400,152021435,0,78954307
H1|chr4:73271939-73272004,chr4,73271939,73272004,H1|chr4:123750669-123750698,chr4,123750669,123750698,0,50478730
H1|chr4:73780838-73780893,chr4,73780838,73780893,H1|chr4:113632862-113632957,chr4,113632862,113632957,0,39852024
H1|chr4:74063929-74064009,chr4,74063929,74064009,H1|chr4:53784-53851,chr4,53784,53851,0,74010145
H1|chr4:74619280-74619382,chr4,74619280,74619382,H1|chr4:113736999-113737043,chr4,113736999,113737043,0,39117719
H1|chr4:74846442-74846489,chr4,74846442,74846489,H1|chr4:331089-331155,chr4,331089,331155,0,74515353
H1|chr4:75044952-75045049,chr4,75044952,75045049,H1|chr4:100007792-100007826,chr4,100007792,100007826,0,24962840
H1|chr4:75413262-75413364,chr4,75413262,75413364,H1|chr4:113736999-113737043,chr4,113736999,113737043,0,38323737
H1|chr4:76083231-76083321,chr4,76083231,76083321,H1|chr4:113631661-113631710,chr4,113631661,113631710,0,37548430
H1|chr4:76151742-76151822,chr4,76151742,76151822,H1|chr4:93225439-93225509,chr4,93225439,93225509,0,17073697
H1|chr4:76562641-76562726,chr4,76562641,76562726,H1|chr4:85502701-85502766,chr4,85502701,85502766,0,8940060
H1|chr4:77113581-77113689,chr4,77113581,77113689,H1|chr4:85502701-85502722,chr4,85502701,85502722,0,8389120
H1|chr4:77349556-77349626,chr4,77349556,77349626,H1|chr4:113736316-113736373,chr4,113736316,113736373,0,36386760
H1|chr4:78337375-78337440,chr4,78337375,78337440,H1|chr4:40060278-40060310,chr4,40060278,40060310,0,38277097
H1|chr4:78354975-78355020,chr4,78354975,78355020,H1|chr4:332976-333016,chr4,332976,333016,0,78021999
H1|chr4:79079872-79079992,chr4,79079872,79079992,H1|chr4:56409066-56409093,chr4,56409066,56409093,0,22670806
H1|chr4:79086456-79086501,chr4,79086456,79086501,H1|chr4:113630615-113630689,chr4,113630615,113630689,0,34544159
H1|chr4:79692877-79693027,chr4,79692877,79693027,H1|chr4:93226929-93226960,chr4,93226929,93226960,0,13534052
H1|chr4:81799804-81799839,chr4,81799804,81799839,H1|chr4:120381148-120381277,chr4,120381148,120381277,0,38581344
H1|chr4:82643616-82643703,chr4,82643616,82643703,H1|chr4:129733685-129733827,chr4,129733685,129733827,0,47090069
H1|chr4:82822365-82822447,chr4,82822365,82822447,H1|chr4:93224830-93224898,chr4,93224830,93224898,0,10402465
H1|chr4:83154476-83154503,chr4,83154476,83154503,H1|chr4:53588775-53588798,chr4,53588775,53588798,0,29565701
H1|chr4:83952798-83952863,chr4,83952798,83952863,H1|chr4:123750669-123750698,chr4,123750669,123750698,0,39797871
H1|chr4:84456384-84456463,chr4,84456384,84456463,H1|chr4:113630851-113630904,chr4,113630851,113630904,0,29174467
H1|chr4:85451333-85451357,chr4,85451333,85451357,H1|chr4:56410062-56410148,chr4,56410062,56410148,0,29041271
H1|chr4:85491522-85491638,chr4,85491522,85491638,H1|chr4:675129-675274,chr4,675129,675274,0,84816393
H1|chr4:86191922-86192068,chr4,86191922,86192068,H1|chr4:93202031-93202088,chr4,93202031,93202088,0,7010109
H1|chr4:86374576-86374606,chr4,86374576,86374606,H1|chr4:26363096-26363197,chr4,26363096,26363197,0,60011480
H1|chr4:86501567-86501634,chr4,86501567,86501634,H1|chr4:78978127-78978277,chr4,78978127,78978277,0,7523440
H1|chr4:86803519-86803595,chr4,86803519,86803595,H1|chr4:52709884-52709937,chr4,52709884,52709937,0,34093635
H1|chr4:87491642-87491744,chr4,87491642,87491744,H1|chr4:85502701-85502766,chr4,85502701,85502766,0,1988941
H1|chr4:88825539-88825643,chr4,88825539,88825643,H1|chr4:2059362-2059387,chr4,2059362,2059387,0,86766177
H1|chr4:89040909-89040971,chr4,89040909,89040971,H1|chr4:93198973-93199002,chr4,93198973,93199002,0,4158064
H1|chr4:89180294-89180376,chr4,89180294,89180376,H1|chr4:113736274-113736342,chr4,113736274,113736342,0,24555980
H1|chr4:89566287-89566360,chr4,89566287,89566360,H1|chr4:16899115-16899159,chr4,16899115,16899159,0,72667172
H1|chr4:90728894-90728988,chr4,90728894,90728988,H1|chr4:56263589-56263614,chr4,56263589,56263614,0,34465305
H1|chr4:90872542-90872602,chr4,90872542,90872602,H1|chr4:128799661-128799751,chr4,128799661,128799751,0,37927119
H1|chr4:92872134-92872184,chr4,92872134,92872184,H1|chr4:113630611-113630710,chr4,113630611,113630710,0,20758477
H1|chr4:92934305-92934402,chr4,92934305,92934402,H1|chr4:129649-129715,chr4,129649,129715,0,92804656
H1|chr4:92955541-92955619,chr4,92955541,92955619,H1|chr4:93201142-93201169,chr4,93201142,93201169,0,245601
H1|chr4:94197201-94197309,chr4,94197201,94197309,H1|chr4:85502701-85502722,chr4,85502701,85502722,0,8694500
H1|chr4:94279525-94279669,chr4,94279525,94279669,H1|chr4:113736947-113737020,chr4,113736947,113737020,0,19457422
H1|chr4:94725732-94725750,chr4,94725732,94725750,H1|chr4:120381148-120381277,chr4,120381148,120381277,0,25655416
H1|chr4:95199413-95199467,chr4,95199413,95199467,H1|chr4:53729073-53729113,chr4,53729073,53729113,0,41470340
H1|chr4:95422812-95422873,chr4,95422812,95422873,H1|chr4:18022769-18022919,chr4,18022769,18022919,0,77400043
H1|chr4:95757767-95757832,chr4,95757767,95757832,H1|chr4:123750669-123750698,chr4,123750669,123750698,0,27992902
H1|chr4:95781352-95781394,chr4,95781352,95781394,H1|chr4:205446-205583,chr4,205446,205583,0,95575906
H1|chr4:95871749-95871826,chr4,95871749,95871826,H1|chr4:113736947-113737020,chr4,113736947,113737020,0,17865198
H1|chr4:96453728-96453755,chr4,96453728,96453755,H1|chr4:53588775-53588798,chr4,53588775,53588798,0,42864953
H1|chr4:96512246-96512321,chr4,96512246,96512321,H1|chr4:52709884-52709937,chr4,52709884,52709937,0,43802362
H1|chr4:96612338-96612385,chr4,96612338,96612385,H1|chr4:113632500-113632585,chr4,113632500,113632585,0,17020162
H1|chr4:97240298-97240367,chr4,97240298,97240367,H1|chr4:113632697-113632778,chr4,113632697,113632778,0,16392399
H1|chr4:99256354-99256460,chr4,99256354,99256460,H1|chr4:113737875-113737966,chr4,113737875,113737966,0,14481521
H1|chr4:99775312-99775371,chr4,99775312,99775371,H1|chr4:113737875-113737966,chr4,113737875,113737966,0,13962563
H1|chr4:100205902-100205966,chr4,100205902,100205966,H1|chr4:113734459-113734546,chr4,113734459,113734546,0,13528557
H1|chr4:100320880-100320916,chr4,100320880,100320916,H1|chr4:153701700-153701774,chr4,153701700,153701774,0,53380820
H1|chr4:101013431-101013488,chr4,101013431,101013488,H1|chr4:177117543-177117603,chr4,177117543,177117603,0,76104112
H1|chr4:103180561-103180674,chr4,103180561,103180674,H1|chr4:93226926-93226960,chr4,93226926,93226960,0,9953635
H1|chr4:103553295-103553350,chr4,103553295,103553350,H1|chr4:113630610-113630705,chr4,113630610,113630705,0,10077315
H1|chr4:103661454-103661494,chr4,103661454,103661494,H1|chr4:146859829-146859877,chr4,146859829,146859877,0,43198375
H1|chr4:103690731-103690805,chr4,103690731,103690805,H1|chr4:93198973-93199002,chr4,93198973,93199002,0,10491758
H1|chr4:104666849-104666938,chr4,104666849,104666938,H1|chr4:93199867-93199923,chr4,93199867,93199923,0,11466982
H1|chr4:105247367-105247442,chr4,105247367,105247442,H1|chr4:26362891-26362952,chr4,26362891,26362952,0,78884476
H1|chr4:106059116-106059191,chr4,106059116,106059191,H1|chr4:52709884-52709937,chr4,52709884,52709937,0,53349232
H1|chr4:106853011-106853123,chr4,106853011,106853123,H1|chr4:113630610-113630705,chr4,113630610,113630705,0,6777599
H1|chr4:107787917-107787956,chr4,107787917,107787956,H1|chr4:113632753-113632903,chr4,113632753,113632903,0,5844836
H1|chr4:108194559-108194648,chr4,108194559,108194648,H1|chr4:113630890-113630948,chr4,113630890,113630948,0,5436331
H1|chr4:109638700-109638756,chr4,109638700,109638756,H1|chr4:113735345-113735394,chr4,113735345,113735394,0,4096645
H1|chr4:110413278-110413327,chr4,110413278,110413327,H1|chr4:128797987-128798064,chr4,128797987,128798064,0,18384709
H1|chr4:111184090-111184209,chr4,111184090,111184209,H1|chr4:87516410-87516470,chr4,87516410,87516470,0,23667680
H1|chr4:111518286-111518361,chr4,111518286,111518361,H1|chr4:18022769-18022918,chr4,18022769,18022918,0,93495517
H1|chr4:111612569-111612637,chr4,111612569,111612637,H1|chr4:85502701-85502759,chr4,85502701,85502759,0,26109868
H1|chr4:112477593-112477668,chr4,112477593,112477668,H1|chr4:18022769-18022918,chr4,18022769,18022918,0,94454824
H1|chr4:112587165-112587312,chr4,112587165,112587312,H1|chr4:93201049-93201121,chr4,93201049,93201121,0,19386116
H1|chr4:113207765-113207815,chr4,113207765,113207815,H1|chr4:188917431-188917537,chr4,188917431,188917537,0,75709666
H1|chr4:114368246-114368362,chr4,114368246,114368362,H1|chr4:205447-205499,chr4,205447,205499,0,114162799
H1|chr4:115408221-115408296,chr4,115408221,115408296,H1|chr4:26362891-26362952,chr4,26362891,26362952,0,89045330
H1|chr4:115601546-115601591,chr4,115601546,115601591,H1|chr4:93224993-93225093,chr4,93224993,93225093,0,22376553
H1|chr4:116532458-116532477,chr4,116532458,116532477,H1|chr4:52711090-52711221,chr4,52711090,52711221,0,63821368
H1|chr4:117311774-117311841,chr4,117311774,117311841,H1|chr4:123750669-123750698,chr4,123750669,123750698,0,6438895
H1|chr4:117678680-117678800,chr4,117678680,117678800,H1|chr4:56409066-56409093,chr4,56409066,56409093,0,61269614
H1|chr4:117766803-117766862,chr4,117766803,117766862,H1|chr4:126141-126191,chr4,126141,126191,0,117640662
H1|chr4:118178800-118178849,chr4,118178800,118178849,H1|chr4:113632138-113632195,chr4,113632138,113632195,0,4546662
H1|chr4:119037031-119037115,chr4,119037031,119037115,H1|chr4:125878-125902,chr4,125878,125902,0,118911153
H1|chr4:119593977-119594022,chr4,119593977,119594022,H1|chr4:93224993-93225093,chr4,93224993,93225093,0,26368984
H1|chr4:121186592-121186648,chr4,121186592,121186648,H1|chr4:93225399-93225546,chr4,93225399,93225546,0,27961193
H1|chr4:121510065-121510155,chr4,121510065,121510155,H1|chr4:113632164-113632258,chr4,113632164,113632258,0,7877901
H1|chr4:121644015-121644152,chr4,121644015,121644152,H1|chr4:130013916-130013955,chr4,130013916,130013955,0,8369901
H1|chr4:122271552-122271575,chr4,122271552,122271575,H1|chr4:52711090-52711221,chr4,52711090,52711221,0,69560462
H1|chr4:122447530-122447584,chr4,122447530,122447584,H1|chr4:53729073-53729113,chr4,53729073,53729113,0,68718457
H1|chr4:124938352-124938470,chr4,124938352,124938470,H1|chr4:113632862-113632957,chr4,113632862,113632957,0,11305490
H1|chr4:125790521-125790584,chr4,125790521,125790584,H1|chr4:123751570-123751657,chr4,123751570,123751657,0,2038951
H1|chr4:126417795-126417929,chr4,126417795,126417929,H1|chr4:113739075-113739105,chr4,113739075,113739105,0,12678720
H1|chr4:126954720-126954832,chr4,126954720,126954832,H1|chr4:113738536-113738569,chr4,113738536,113738569,0,13216184
H1|chr4:129133115-129133146,chr4,129133115,129133146,H1|chr4:6268362-6268424,chr4,6268362,6268424,0,122864753
H1|chr4:130080609-130080721,chr4,130080609,130080721,H1|chr4:113737715-113737737,chr4,113737715,113737737,0,16342894
H1|chr4:130972104-130972171,chr4,130972104,130972171,H1|chr4:4859048-4859092,chr4,4859048,4859092,0,126113056
H1|chr4:131133743-131133800,chr4,131133743,131133800,H1|chr4:113632680-113632773,chr4,113632680,113632773,0,17501063
H1|chr4:131259851-131259958,chr4,131259851,131259958,H1|chr4:177117543-177117603,chr4,177117543,177117603,0,45857692
H1|chr4:131355218-131355257,chr4,131355218,131355257,H1|chr4:113632753-113632903,chr4,113632753,113632903,0,17722465
H1|chr4:131653223-131653301,chr4,131653223,131653301,H1|chr4:93201142-93201169,chr4,93201142,93201169,0,38452081
H1|chr4:131783697-131783810,chr4,131783697,131783810,H1|chr4:113738536-113738569,chr4,113738536,113738569,0,18045161
H1|chr4:132544306-132544360,chr4,132544306,132544360,H1|chr4:123751561-123751657,chr4,123751561,123751657,0,8792745
H1|chr4:132620476-132620582,chr4,132620476,132620582,H1|chr4:113737875-113737966,chr4,113737875,113737966,0,18882601
H1|chr4:132664179-132664270,chr4,132664179,132664270,H1|chr4:54232-54263,chr4,54232,54263,0,132609947
H1|chr4:132734624-132734668,chr4,132734624,132734668,H1|chr4:188917431-188917537,chr4,188917431,188917537,0,56182807
H1|chr4:132979361-132979445,chr4,132979361,132979445,H1|chr4:93224566-93224594,chr4,93224566,93224594,0,39754795
H1|chr4:134209426-134209506,chr4,134209426,134209506,H1|chr4:93225439-93225509,chr4,93225439,93225509,0,40983987
H1|chr4:134252873-134252924,chr4,134252873,134252924,H1|chr4:54232-54263,chr4,54232,54263,0,134198641
H1|chr4:134341212-134341309,chr4,134341212,134341309,H1|chr4:100007792-100007826,chr4,100007792,100007826,0,34333420
H1|chr4:134489482-134489605,chr4,134489482,134489605,H1|chr4:129733806-129733827,chr4,129733806,129733827,0,4755676
H1|chr4:135444040-135444153,chr4,135444040,135444153,H1|chr4:154126276-154126302,chr4,154126276,154126302,0,18682236
H1|chr4:135527781-135527850,chr4,135527781,135527850,H1|chr4:113736198-113736279,chr4,113736198,113736279,0,21791583
H1|chr4:136014422-136014478,chr4,136014422,136014478,H1|chr4:113632164-113632258,chr4,113632164,113632258,0,22382258
H1|chr4:137978915-137979000,chr4,137978915,137979000,H1|chr4:85502701-85502766,chr4,85502701,85502766,0,52476214
H1|chr4:138280398-138280438,chr4,138280398,138280438,H1|chr4:26361604-26361641,chr4,26361604,26361641,0,111918794
H1|chr4:138825198-138825289,chr4,138825198,138825289,H1|chr4:54232-54263,chr4,54232,54263,0,138770966
H1|chr4:139355761-139355851,chr4,139355761,139355851,H1|chr4:113631661-113631710,chr4,113631661,113631710,0,25724100
H1|chr4:139601773-139601830,chr4,139601773,139601830,H1|chr4:177117543-177117603,chr4,177117543,177117603,0,37515770
H1|chr4:140474648-140474756,chr4,140474648,140474756,H1|chr4:130013916-130013955,chr4,130013916,130013955,0,10460732
H1|chr4:140766543-140766621,chr4,140766543,140766621,H1|chr4:159644146-159644165,chr4,159644146,159644165,0,18877603
H1|chr4:140974381-140974410,chr4,140974381,140974410,H1|chr4:26363096-26363197,chr4,26363096,26363197,0,114611285
H1|chr4:141130018-141130088,chr4,141130018,141130088,H1|chr4:93199867-93199947,chr4,93199867,93199947,0,47930151
H1|chr4:141960819-141960916,chr4,141960819,141960916,H1|chr4:129649-129715,chr4,129649,129715,0,141831170
H1|chr4:142068942-142069011,chr4,142068942,142069011,H1|chr4:113632697-113632778,chr4,113632697,113632778,0,28436245
H1|chr4:143197610-143197659,chr4,143197610,143197659,H1|chr4:93202686-93202779,chr4,93202686,93202779,0,49994924
H1|chr4:144160654-144160767,chr4,144160654,144160767,H1|chr4:113738536-113738569,chr4,113738536,113738569,0,30422118
H1|chr4:144694652-144694750,chr4,144694652,144694750,H1|chr4:205447-205499,chr4,205447,205499,0,144489205
H1|chr4:145325820-145325932,chr4,145325820,145325932,H1|chr4:113630610-113630705,chr4,113630610,113630705,0,31695210
H1|chr4:146654512-146654550,chr4,146654512,146654550,H1|chr4:113738051-113738201,chr4,113738051,113738201,0,32916461
H1|chr4:146729023-146729135,chr4,146729023,146729135,H1|chr4:154126276-154126302,chr4,154126276,154126302,0,7397253
H1|chr4:146961585-146961608,chr4,146961585,146961608,H1|chr4:113632165-113632266,chr4,113632165,113632266,0,33329420
H1|chr4:147377575-147377665,chr4,147377575,147377665,H1|chr4:87516410-87516470,chr4,87516410,87516470,0,59861165
H1|chr4:147548617-147548736,chr4,147548617,147548736,H1|chr4:87516410-87516470,chr4,87516410,87516470,0,60032207
H1|chr4:148053058-148053173,chr4,148053058,148053173,H1|chr4:113739075-113739105,chr4,113739075,113739105,0,34313983
H1|chr4:148400119-148400208,chr4,148400119,148400208,H1|chr4:113630890-113630948,chr4,113630890,113630948,0,34769229
H1|chr4:148750655-148750704,chr4,148750655,148750704,H1|chr4:128797987-128798064,chr4,128797987,128798064,0,19952668
H1|chr4:149900391-149900418,chr4,149900391,149900418,H1|chr4:85502701-85502757,chr4,85502701,85502757,0,64397690
H1|chr4:150420656-150420715,chr4,150420656,150420715,H1|chr4:4856468-4856500,chr4,4856468,4856500,0,145564188
H1|chr4:150609131-150609222,chr4,150609131,150609222,H1|chr4:93225327-93225375,chr4,93225327,93225375,0,57383804
H1|chr4:151129360-151129383,chr4,151129360,151129383,H1|chr4:52711090-52711221,chr4,52711090,52711221,0,98418270
H1|chr4:151438076-151438121,chr4,151438076,151438121,H1|chr4:332976-333016,chr4,332976,333016,0,151105100
H1|chr4:152077081-152077140,chr4,152077081,152077140,H1|chr4:113631723-113631786,chr4,113631723,113631786,0,38445358
H1|chr4:152845946-152846093,chr4,152845946,152846093,H1|chr4:93201049-93201121,chr4,93201049,93201121,0,59644897
H1|chr4:154147901-154147964,chr4,154147901,154147964,H1|chr4:123751570-123751657,chr4,123751570,123751657,0,30396331
H1|chr4:154657560-154657621,chr4,154657560,154657621,H1|chr4:78978127-78978277,chr4,78978127,78978277,0,75679433
H1|chr4:155465432-155465578,chr4,155465432,155465578,H1|chr4:93202031-93202088,chr4,93202031,93202088,0,62263401
H1|chr4:157351507-157351566,chr4,157351507,157351566,H1|chr4:4856468-4856500,chr4,4856468,4856500,0,152495039
H1|chr4:157537821-157537908,chr4,157537821,157537908,H1|chr4:129733685-129733827,chr4,129733685,129733827,0,27804136
H1|chr4:158313825-158313880,chr4,158313825,158313880,H1|chr4:113630610-113630705,chr4,113630610,113630705,0,44683215
H1|chr4:158353201-158353263,chr4,158353201,158353263,H1|chr4:205447-205535,chr4,205447,205535,0,158147754
H1|chr4:158554324-158554385,chr4,158554324,158554385,H1|chr4:93224993-93225093,chr4,93224993,93225093,0,65329331
H1|chr4:158618812-158618929,chr4,158618812,158618929,H1|chr4:40060309-40060361,chr4,40060309,40060361,0,118558503
H1|chr4:159249010-159249028,chr4,159249010,159249028,H1|chr4:120381148-120381277,chr4,120381148,120381277,0,38867862
H1|chr4:159318723-159318768,chr4,159318723,159318768,H1|chr4:113630615-113630689,chr4,113630615,113630689,0,45688108
H1|chr4:159624725-159624865,chr4,159624725,159624865,H1|chr4:113629955-113630047,chr4,113629955,113630047,0,45994770
H1|chr4:159723136-159723178,chr4,159723136,159723178,H1|chr4:113630615-113630689,chr4,113630615,113630689,0,46092521
H1|chr4:160594679-160594716,chr4,160594679,160594716,H1|chr4:93202800-93202888,chr4,93202800,93202888,0,67391879
H1|chr4:161733877-161733928,chr4,161733877,161733928,H1|chr4:54232-54263,chr4,54232,54263,0,161679645
H1|chr4:164022386-164022503,chr4,164022386,164022503,H1|chr4:40060309-40060361,chr4,40060309,40060361,0,123962077
H1|chr4:164073857-164073887,chr4,164073857,164073887,H1|chr4:6198558-6198631,chr4,6198558,6198631,0,157875299
H1|chr4:164378503-164378608,chr4,164378503,164378608,H1|chr4:209152-209197,chr4,209152,209197,0,164169351
H1|chr4:164631105-164631167,chr4,164631105,164631167,H1|chr4:205447-205535,chr4,205447,205535,0,164425658
H1|chr4:164963235-164963341,chr4,164963235,164963341,H1|chr4:159644146-159644165,chr4,159644146,159644165,0,5319089
H1|chr4:166067453-166067531,chr4,166067453,166067531,H1|chr4:93201049-93201121,chr4,93201049,93201121,0,72866404
H1|chr4:166349674-166349733,chr4,166349674,166349733,H1|chr4:183371256-183371406,chr4,183371256,183371406,0,17021582
H1|chr4:166640007-166640084,chr4,166640007,166640084,H1|chr4:113736947-113737020,chr4,113736947,113737020,0,52903060
H1|chr4:167010117-167010233,chr4,167010117,167010233,H1|chr4:675129-675274,chr4,675129,675274,0,166334988
H1|chr4:167019264-167019321,chr4,167019264,167019321,H1|chr4:56264232-56264311,chr4,56264232,56264311,0,110755032
H1|chr4:167193099-167193150,chr4,167193099,167193150,H1|chr4:113630611-113630710,chr4,113630611,113630710,0,53562488
H1|chr4:169227300-169227418,chr4,169227300,169227418,H1|chr4:113738232-113738257,chr4,113738232,113738257,0,55489068
H1|chr4:169247477-169247584,chr4,169247477,169247584,H1|chr4:177117543-177117603,chr4,177117543,177117603,0,7870066
H1|chr4:169419523-169419619,chr4,169419523,169419619,H1|chr4:100007792-100007826,chr4,100007792,100007826,0,69411731
H1|chr4:170215773-170215832,chr4,170215773,170215832,H1|chr4:113631723-113631786,chr4,113631723,113631786,0,56584050
H1|chr4:170262861-170262890,chr4,170262861,170262890,H1|chr4:85502701-85502822,chr4,85502701,85502822,0,84760160
H1|chr4:171032043-171032152,chr4,171032043,171032152,H1|chr4:53726772-53726903,chr4,53726772,53726903,0,117305271
H1|chr4:173046647-173046794,chr4,173046647,173046794,H1|chr4:128799661-128799751,chr4,128799661,128799751,0,44246986
H1|chr4:173738907-173738938,chr4,173738907,173738938,H1|chr4:6268362-6268424,chr4,6268362,6268424,0,167470545
H1|chr4:174245289-174245401,chr4,174245289,174245401,H1|chr4:4857674-4857712,chr4,4857674,4857712,0,169387615
H1|chr4:176314592-176314611,chr4,176314592,176314611,H1|chr4:52711090-52711221,chr4,52711090,52711221,0,123603502
H1|chr4:176723598-176723640,chr4,176723598,176723640,H1|chr4:113630615-113630689,chr4,113630615,113630689,0,63092983
H1|chr4:178035319-178035466,chr4,178035319,178035466,H1|chr4:128799661-128799751,chr4,128799661,128799751,0,49235658
H1|chr4:179463536-179463648,chr4,179463536,179463648,H1|chr4:113737715-113737737,chr4,113737715,113737737,0,65725821
H1|chr4:179721717-179721773,chr4,179721717,179721773,H1|chr4:93225399-93225546,chr4,93225399,93225546,0,86496318
H1|chr4:180214152-180214228,chr4,180214152,180214228,H1|chr4:153701700-153701774,chr4,153701700,153701774,0,26512452
H1|chr4:180655921-180656043,chr4,180655921,180656043,H1|chr4:113736274-113736342,chr4,113736274,113736342,0,66919647
H1|chr4:180874145-180874226,chr4,180874145,180874226,H1|chr4:90603915-90604065,chr4,90603915,90604065,0,90270230
H1|chr4:181088990-181089097,chr4,181088990,181089097,H1|chr4:113630890-113630948,chr4,113630890,113630948,0,67458100
H1|chr4:182367350-182367475,chr4,182367350,182367475,H1|chr4:89374940-89375004,chr4,89374940,89375004,0,92992410
H1|chr4:182804261-182804376,chr4,182804261,182804376,H1|chr4:113739075-113739105,chr4,113739075,113739105,0,69065186
H1|chr4:183150148-183150172,chr4,183150148,183150172,H1|chr4:56410062-56410148,chr4,56410062,56410148,0,126740086
H1|chr4:183303931-183303993,chr4,183303931,183303993,H1|chr4:89373725-89373789,chr4,89373725,89373789,0,93930206
H1|chr4:183705035-183705142,chr4,183705035,183705142,H1|chr4:113630890-113630948,chr4,113630890,113630948,0,70074145
H1|chr4:183741902-183741949,chr4,183741902,183741949,H1|chr4:113632500-113632585,chr4,113632500,113632585,0,70109402
H1|chr4:183921354-183921422,chr4,183921354,183921422,H1|chr4:85502701-85502759,chr4,85502701,85502759,0,98418653
H1|chr4:184014668-184014686,chr4,184014668,184014686,H1|chr4:6198499-6198631,chr4,6198499,6198631,0,177816169
H1|chr4:184410354-184410436,chr4,184410354,184410436,H1|chr4:90603915-90604065,chr4,90603915,90604065,0,93806439
H1|chr4:184728945-184728993,chr4,184728945,184728993,H1|chr4:93201335-93201373,chr4,93201335,93201373,0,91527610
H1|chr4:185793119-185793212,chr4,185793119,185793212,H1|chr4:2058172-2058204,chr4,2058172,2058204,0,183734947
H1|chr4:186761340-186761436,chr4,186761340,186761436,H1|chr4:100007792-100007826,chr4,100007792,100007826,0,86753548
H1|chr4:187874477-187874514,chr4,187874477,187874514,H1|chr4:146859980-146860064,chr4,146859980,146860064,0,41014497
H1|chr4:188003618-188003731,chr4,188003618,188003731,H1|chr4:154126276-154126302,chr4,154126276,154126302,0,33877342
H1|chr4:188491533-188491563,chr4,188491533,188491563,H1|chr4:53589308-53589396,chr4,53589308,53589396,0,134902225
H1|chr4:188754483-188754587,chr4,188754483,188754587,H1|chr4:2059362-2059387,chr4,2059362,2059387,0,186695121
H1|chr4:189508330-189508411,chr4,189508330,189508411,H1|chr4:16899107-16899159,chr4,16899107,16899159,0,172609223
H1|chr4:190201950-190201985,chr4,190201950,190201985,H1|chr4:103681045-103681192,chr4,103681045,103681192,0,86520905
H1|chr4:190492315-190492424,chr4,190492315,190492424,H1|chr4:53726772-53726903,chr4,53726772,53726903,0,136765543
H1|chr4:190725796-190725937,chr4,190725796,190725937,H1|chr4:93225439-93225509,chr4,93225439,93225509,0,97500357
H1|chr5:290761-290789,chr5,290761,290789,H1|chr5:25442250-25442280,chr5,25442250,25442280,0,25151489
H1|chr5:924315-924436,chr5,924315,924436,H1|chr5:6377681-6377710,chr5,6377681,6377710,0,5453366
H1|chr5:1153252-1153353,chr5,1153252,1153353,H1|chr5:147249323-147249375,chr5,147249323,147249375,0,146096071
H1|chr5:1158837-1158917,chr5,1158837,1158917,H1|chr5:175627037-175627107,chr5,175627037,175627107,0,174468200
H1|chr5:1276533-1276683,chr5,1276533,1276683,H1|chr5:175627668-175627769,chr5,175627668,175627769,0,174351135
H1|chr5:1290955-1291038,chr5,1290955,1291038,H1|chr5:147250348-147250483,chr5,147250348,147250483,0,145959393
H1|chr5:1564891-1564972,chr5,1564891,1564972,H1|chr5:147248684-147248705,chr5,147248684,147248705,0,145683793
H1|chr5:1869110-1869159,chr5,1869110,1869159,H1|chr5:154100137-154100268,chr5,154100137,154100268,0,152231027
H1|chr5:1945790-1945879,chr5,1945790,1945879,H1|chr5:25441556-25441581,chr5,25441556,25441581,0,23495766
H1|chr5:2118561-2118711,chr5,2118561,2118711,H1|chr5:147251844-147251994,chr5,147251844,147251994,0,145133283
H1|chr5:2183625-2183774,chr5,2183625,2183774,H1|chr5:693682-693832,chr5,693682,693832,0,1489943
H1|chr5:2256526-2256614,chr5,2256526,2256614,H1|chr5:272383-272529,chr5,272383,272529,0,1984143
H1|chr5:2767784-2767837,chr5,2767784,2767837,H1|chr5:61604726-61604791,chr5,61604726,61604791,0,58836942
H1|chr5:2798172-2798277,chr5,2798172,2798277,H1|chr5:147248118-147248163,chr5,147248118,147248163,0,144449946
H1|chr5:3401729-3401762,chr5,3401729,3401762,H1|chr5:147252454-147252524,chr5,147252454,147252524,0,143850725
H1|chr5:3409171-3409239,chr5,3409171,3409239,H1|chr5:150828241-150828350,chr5,150828241,150828350,0,147419070
H1|chr5:3462612-3462762,chr5,3462612,3462762,H1|chr5:147249713-147249863,chr5,147249713,147249863,0,143787101
H1|chr5:3541150-3541225,chr5,3541150,3541225,H1|chr5:25443565-25443638,chr5,25443565,25443638,0,21902415
H1|chr5:3657080-3657163,chr5,3657080,3657163,H1|chr5:147252837-147252904,chr5,147252837,147252904,0,143595757
H1|chr5:3661374-3661404,chr5,3661374,3661404,H1|chr5:177591071-177591191,chr5,177591071,177591191,0,173929697
H1|chr5:3867898-3867978,chr5,3867898,3867978,H1|chr5:175222367-175222409,chr5,175222367,175222409,0,171354469
H1|chr5:3892517-3892609,chr5,3892517,3892609,H1|chr5:25441511-25441569,chr5,25441511,25441569,0,21548994
H1|chr5:3916557-3916601,chr5,3916557,3916601,H1|chr5:141256918-141256952,chr5,141256918,141256952,0,137340361
H1|chr5:3928216-3928281,chr5,3928216,3928281,H1|chr5:147252686-147252771,chr5,147252686,147252771,0,143324470
H1|chr5:3959247-3959275,chr5,3959247,3959275,H1|chr5:147249922-147250021,chr5,147249922,147250021,0,143290675
H1|chr5:6290114-6290206,chr5,6290114,6290206,H1|chr5:140703917-140703934,chr5,140703917,140703934,0,134413803
H1|chr5:6315347-6315422,chr5,6315347,6315422,H1|chr5:25443615-25443690,chr5,25443615,25443690,0,19128268
H1|chr5:6396241-6396291,chr5,6396241,6396291,H1|chr5:154089457-154089523,chr5,154089457,154089523,0,147693216
H1|chr5:6521919-6522011,chr5,6521919,6522011,H1|chr5:141703900-141703987,chr5,141703900,141703987,0,135181981
H1|chr5:6949518-6949547,chr5,6949518,6949547,H1|chr5:147246117-147246238,chr5,147246117,147246238,0,140296599
H1|chr5:7099321-7099470,chr5,7099321,7099470,H1|chr5:693682-693832,chr5,693682,693832,0,6405639
H1|chr5:7201365-7201387,chr5,7201365,7201387,H1|chr5:147252648-147252774,chr5,147252648,147252774,0,140051283
H1|chr5:7439596-7439645,chr5,7439596,7439645,H1|chr5:613266-613305,chr5,613266,613305,0,6826330
H1|chr5:8108089-8108239,chr5,8108089,8108239,H1|chr5:697444-697594,chr5,697444,697594,0,7410645
H1|chr5:8161803-8161872,chr5,8161803,8161872,H1|chr5:79552302-79552366,chr5,79552302,79552366,0,71390499
H1|chr5:8568731-8568817,chr5,8568731,8568817,H1|chr5:154100045-154100114,chr5,154100045,154100114,0,145531314
H1|chr5:8618579-8618678,chr5,8618579,8618678,H1|chr5:147251763-147251910,chr5,147251763,147251910,0,138633184
H1|chr5:8915303-8915448,chr5,8915303,8915448,H1|chr5:178287264-178287361,chr5,178287264,178287361,0,169371961
H1|chr5:9006299-9006390,chr5,9006299,9006390,H1|chr5:171438155-171438301,chr5,171438155,171438301,0,162431856
H1|chr5:9194029-9194075,chr5,9194029,9194075,H1|chr5:141735174-141735229,chr5,141735174,141735229,0,132541145
H1|chr5:9643249-9643274,chr5,9643249,9643274,H1|chr5:72411424-72411574,chr5,72411424,72411574,0,62768175
H1|chr5:9721061-9721099,chr5,9721061,9721099,H1|chr5:272203-272312,chr5,272203,272312,0,9448858
H1|chr5:9808522-9808557,chr5,9808522,9808557,H1|chr5:76787180-76787277,chr5,76787180,76787277,0,66978658
H1|chr5:10029456-10029507,chr5,10029456,10029507,H1|chr5:147252845-147252927,chr5,147252845,147252927,0,137223389
H1|chr5:10923325-10923441,chr5,10923325,10923441,H1|chr5:147247254-147247317,chr5,147247254,147247317,0,136323929
H1|chr5:10988375-10988435,chr5,10988375,10988435,H1|chr5:76504016-76504073,chr5,76504016,76504073,0,65515641
H1|chr5:11020886-11020969,chr5,11020886,11020969,H1|chr5:177591158-177591191,chr5,177591158,177591191,0,166570272
H1|chr5:11934264-11934296,chr5,11934264,11934296,H1|chr5:31529873-31529944,chr5,31529873,31529944,0,19595609
H1|chr5:12038336-12038397,chr5,12038336,12038397,H1|chr5:147252296-147252378,chr5,147252296,147252378,0,135213960
H1|chr5:12122897-12122954,chr5,12122897,12122954,H1|chr5:170815976-170816094,chr5,170815976,170816094,0,158693079
H1|chr5:12393342-12393392,chr5,12393342,12393392,H1|chr5:154136215-154136315,chr5,154136215,154136315,0,141742873
H1|chr5:12720774-12720856,chr5,12720774,12720856,H1|chr5:141705177-141705245,chr5,141705177,141705245,0,128984403
H1|chr5:12759880-12759972,chr5,12759880,12759972,H1|chr5:697716-697774,chr5,697716,697774,0,12062164
H1|chr5:12764688-12764813,chr5,12764688,12764813,H1|chr5:147246111-147246136,chr5,147246111,147246136,0,134481423
H1|chr5:12926675-12926718,chr5,12926675,12926718,H1|chr5:177663095-177663154,chr5,177663095,177663154,0,164736420
H1|chr5:12942981-12943026,chr5,12942981,12943026,H1|chr5:147249204-147249258,chr5,147249204,147249258,0,134306223
H1|chr5:13034246-13034299,chr5,13034246,13034299,H1|chr5:61604726-61604791,chr5,61604726,61604791,0,48570480
H1|chr5:13132247-13132342,chr5,13132247,13132342,H1|chr5:25441511-25441569,chr5,25441511,25441569,0,12309264
H1|chr5:13139630-13139676,chr5,13139630,13139676,H1|chr5:177591071-177591191,chr5,177591071,177591191,0,164451441
H1|chr5:13248459-13248483,chr5,13248459,13248483,H1|chr5:141258170-141258260,chr5,141258170,141258260,0,128009711
H1|chr5:13307020-13307165,chr5,13307020,13307165,H1|chr5:692751-692898,chr5,692751,692898,0,12614269
H1|chr5:13392411-13392442,chr5,13392411,13392442,H1|chr5:175631346-175631465,chr5,175631346,175631465,0,162238935
H1|chr5:14134658-14134696,chr5,14134658,14134696,H1|chr5:25444748-25444794,chr5,25444748,25444794,0,11310090
H1|chr5:14590384-14590412,chr5,14590384,14590412,H1|chr5:147249922-147250021,chr5,147249922,147250021,0,132659538
H1|chr5:14609868-14609970,chr5,14609868,14609970,H1|chr5:25444748-25444794,chr5,25444748,25444794,0,10834880
H1|chr5:14847572-14847604,chr5,14847572,14847604,H1|chr5:7393104-7393203,chr5,7393104,7393203,0,7454468
H1|chr5:14856482-14856503,chr5,14856482,14856503,H1|chr5:25441120-25441245,chr5,25441120,25441245,0,10584638
H1|chr5:14948251-14948307,chr5,14948251,14948307,H1|chr5:147256275-147256415,chr5,147256275,147256415,0,132308024
H1|chr5:15228436-15228580,chr5,15228436,15228580,H1|chr5:177627397-177627417,chr5,177627397,177627417,0,162398961
H1|chr5:15862480-15862556,chr5,15862480,15862556,H1|chr5:147251778-147251925,chr5,147251778,147251925,0,131389298
H1|chr5:16882600-16882632,chr5,16882600,16882632,H1|chr5:170815976-170816094,chr5,170815976,170816094,0,153933376
H1|chr5:17752059-17752148,chr5,17752059,17752148,H1|chr5:141734992-141735038,chr5,141734992,141735038,0,123982933
H1|chr5:17806481-17806511,chr5,17806481,17806511,H1|chr5:76504311-76504352,chr5,76504311,76504352,0,58697830
H1|chr5:18005220-18005325,chr5,18005220,18005325,H1|chr5:154091347-154091370,chr5,154091347,154091370,0,136086127
H1|chr5:18092796-18092846,chr5,18092796,18092846,H1|chr5:175221729-175221879,chr5,175221729,175221879,0,157128933
H1|chr5:18249611-18249652,chr5,18249611,18249652,H1|chr5:79554260-79554334,chr5,79554260,79554334,0,61304649
H1|chr5:18425780-18425801,chr5,18425780,18425801,H1|chr5:147252448-147252594,chr5,147252448,147252594,0,128826668
H1|chr5:18587283-18587350,chr5,18587283,18587350,H1|chr5:171883926-171883949,chr5,171883926,171883949,0,153296643
H1|chr5:18706463-18706543,chr5,18706463,18706543,H1|chr5:154088633-154088700,chr5,154088633,154088700,0,135382170
H1|chr5:18940046-18940124,chr5,18940046,18940124,H1|chr5:147246122-147246168,chr5,147246122,147246168,0,128306076
H1|chr5:18980514-18980553,chr5,18980514,18980553,H1|chr5:147251545-147251648,chr5,147251545,147251648,0,128271031
H1|chr5:19060510-19060585,chr5,19060510,19060585,H1|chr5:154091860-154091903,chr5,154091860,154091903,0,135031350
H1|chr5:19294266-19294353,chr5,19294266,19294353,H1|chr5:138631715-138631775,chr5,138631715,138631775,0,119337449
H1|chr5:19402135-19402208,chr5,19402135,19402208,H1|chr5:141700213-141700263,chr5,141700213,141700263,0,122298078
H1|chr5:19570380-19570414,chr5,19570380,19570414,H1|chr5:25444600-25444654,chr5,25444600,25444654,0,5874220
H1|chr5:19614085-19614115,chr5,19614085,19614115,H1|chr5:107007802-107007851,chr5,107007802,107007851,0,87393717
H1|chr5:19834603-19834642,chr5,19834603,19834642,H1|chr5:176740707-176740768,chr5,176740707,176740768,0,156906104
H1|chr5:19901959-19902095,chr5,19901959,19902095,H1|chr5:175627753-175627899,chr5,175627753,175627899,0,155725794
H1|chr5:19912375-19912419,chr5,19912375,19912419,H1|chr5:154091268-154091349,chr5,154091268,154091349,0,134178893
H1|chr5:20089293-20089318,chr5,20089293,20089318,H1|chr5:147251445-147251595,chr5,147251445,147251595,0,127162152
H1|chr5:20361521-20361665,chr5,20361521,20361665,H1|chr5:693735-693880,chr5,693735,693880,0,19667786
H1|chr5:20958345-20958369,chr5,20958345,20958369,H1|chr5:147252390-147252465,chr5,147252390,147252465,0,126294045
H1|chr5:21229624-21229719,chr5,21229624,21229719,H1|chr5:141705177-141705245,chr5,141705177,141705245,0,120475553
H1|chr5:21470171-21470248,chr5,21470171,21470248,H1|chr5:147248020-147248099,chr5,147248020,147248099,0,125777849
H1|chr5:21541395-21541468,chr5,21541395,21541468,H1|chr5:7395857-7395880,chr5,7395857,7395880,0,14145538
H1|chr5:22393780-22393803,chr5,22393780,22393803,H1|chr5:147245908-147246035,chr5,147245908,147246035,0,124852128
H1|chr5:22835312-22835462,chr5,22835312,22835462,H1|chr5:147248118-147248163,chr5,147248118,147248163,0,124412806
H1|chr5:22905542-22905568,chr5,22905542,22905568,H1|chr5:141258170-141258260,chr5,141258170,141258260,0,118352628
H1|chr5:23052840-23052870,chr5,23052840,23052870,H1|chr5:76504311-76504352,chr5,76504311,76504352,0,53451471
H1|chr5:23097949-23097977,chr5,23097949,23097977,H1|chr5:147251357-147251463,chr5,147251357,147251463,0,124153408
H1|chr5:23316667-23316754,chr5,23316667,23316754,H1|chr5:154098955-154098992,chr5,154098955,154098992,0,130782288
H1|chr5:23541516-23541597,chr5,23541516,23541597,H1|chr5:154136215-154136315,chr5,154136215,154136315,0,130594699
H1|chr5:23879848-23879992,chr5,23879848,23879992,H1|chr5:76787122-76787272,chr5,76787122,76787272,0,52907274
H1|chr5:24322349-24322420,chr5,24322349,24322420,H1|chr5:175628473-175628549,chr5,175628473,175628549,0,151306124
H1|chr5:24421025-24421169,chr5,24421025,24421169,H1|chr5:34658434-34658509,chr5,34658434,34658509,0,10237409
H1|chr5:24997281-24997372,chr5,24997281,24997372,H1|chr5:154088633-154088700,chr5,154088633,154088700,0,129091352
H1|chr5:25235390-25235485,chr5,25235390,25235485,H1|chr5:25441511-25441569,chr5,25441511,25441569,0,206121
H1|chr5:25591392-25591446,chr5,25591392,25591446,H1|chr5:147252988-147253058,chr5,147252988,147253058,0,121661596
H1|chr5:25650070-25650130,chr5,25650070,25650130,H1|chr5:697302-697372,chr5,697302,697372,0,24952768
H1|chr5:25659205-25659270,chr5,25659205,25659270,H1|chr5:141702495-141702567,chr5,141702495,141702567,0,116043290
H1|chr5:25968765-25968781,chr5,25968765,25968781,H1|chr5:147251597-147251728,chr5,147251597,147251728,0,121282832
H1|chr5:26537468-26537516,chr5,26537468,26537516,H1|chr5:57556-57655,chr5,57556,57655,0,26479912
H1|chr5:26562538-26562685,chr5,26562538,26562685,H1|chr5:141734992-141735038,chr5,141734992,141735038,0,115172454
H1|chr5:26583679-26583724,chr5,26583679,26583724,H1|chr5:147249877-147249923,chr5,147249877,147249923,0,120666198
H1|chr5:26746585-26746605,chr5,26746585,26746605,H1|chr5:141701844-141701994,chr5,141701844,141701994,0,114955259
H1|chr5:26795858-26795949,chr5,26795858,26795949,H1|chr5:697715-697774,chr5,697715,697774,0,26098143
H1|chr5:26853763-26853799,chr5,26853763,26853799,H1|chr5:176739542-176739627,chr5,176739542,176739627,0,149885779
H1|chr5:26858596-26858638,chr5,26858596,26858638,H1|chr5:140174351-140174459,chr5,140174351,140174459,0,113315755
H1|chr5:26956742-26956829,chr5,26956742,26956829,H1|chr5:147247254-147247317,chr5,147247254,147247317,0,120290512
H1|chr5:27062162-27062191,chr5,27062162,27062191,H1|chr5:147246117-147246238,chr5,147246117,147246238,0,120183955
H1|chr5:27213790-27213844,chr5,27213790,27213844,H1|chr5:147252691-147252785,chr5,147252691,147252785,0,120038901
H1|chr5:27547552-27547616,chr5,27547552,27547616,H1|chr5:147247832-147247899,chr5,147247832,147247899,0,119700280
H1|chr5:27951159-27951200,chr5,27951159,27951200,H1|chr5:79554260-79554334,chr5,79554260,79554334,0,51603101
H1|chr5:27984401-27984473,chr5,27984401,27984473,H1|chr5:175961392-175961446,chr5,175961392,175961446,0,147976991
H1|chr5:28140355-28140472,chr5,28140355,28140472,H1|chr5:56472359-56472408,chr5,56472359,56472408,0,28332004
H1|chr5:28305108-28305222,chr5,28305108,28305222,H1|chr5:25443602-25443638,chr5,25443602,25443638,0,2861506
H1|chr5:28472256-28472350,chr5,28472256,28472350,H1|chr5:154091398-154091510,chr5,154091398,154091510,0,125619142
H1|chr5:28520025-28520088,chr5,28520025,28520088,H1|chr5:141703900-141703987,chr5,141703900,141703987,0,113183875
H1|chr5:28640716-28640747,chr5,28640716,28640747,H1|chr5:7393104-7393203,chr5,7393104,7393203,0,21247612
H1|chr5:29148321-29148421,chr5,29148321,29148421,H1|chr5:141061008-141061040,chr5,141061008,141061040,0,111912687
H1|chr5:29228473-29228523,chr5,29228473,29228523,H1|chr5:154089457-154089523,chr5,154089457,154089523,0,124860984
H1|chr5:29412320-29412433,chr5,29412320,29412433,H1|chr5:696321-696419,chr5,696321,696419,0,28715999
H1|chr5:30745547-30745697,chr5,30745547,30745697,H1|chr5:272436-272586,chr5,272436,272586,0,30473111
H1|chr5:30947189-30947282,chr5,30947189,30947282,H1|chr5:7395320-7395386,chr5,7395320,7395386,0,23551869
H1|chr5:31028915-31029029,chr5,31028915,31029029,H1|chr5:176902254-176902301,chr5,176902254,176902301,0,145873339
H1|chr5:31149216-31149310,chr5,31149216,31149310,H1|chr5:154091860-154091903,chr5,154091860,154091903,0,122942644
H1|chr5:31253524-31253669,chr5,31253524,31253669,H1|chr5:697441-697591,chr5,697441,697591,0,30556083
H1|chr5:31882268-31882418,chr5,31882268,31882418,H1|chr5:147249713-147249863,chr5,147249713,147249863,0,115367445
H1|chr5:32271731-32271761,chr5,32271731,32271761,H1|chr5:107007802-107007851,chr5,107007802,107007851,0,74736071
H1|chr5:32665479-32665567,chr5,32665479,32665567,H1|chr5:177591103-177591191,chr5,177591103,177591191,0,144925624
H1|chr5:32855356-32855420,chr5,32855356,32855420,H1|chr5:154099526-154099585,chr5,154099526,154099585,0,121244170
H1|chr5:33412619-33412764,chr5,33412619,33412764,H1|chr5:693278-693428,chr5,693278,693428,0,32719341
H1|chr5:33705542-33705617,chr5,33705542,33705617,H1|chr5:154091860-154091903,chr5,154091860,154091903,0,120386318
H1|chr5:33831668-33831713,chr5,33831668,33831713,H1|chr5:171435172-171435248,chr5,171435172,171435248,0,137603504
H1|chr5:33901326-33901429,chr5,33901326,33901429,H1|chr5:147253526-147253573,chr5,147253526,147253573,0,113352200
H1|chr5:34105853-34105953,chr5,34105853,34105953,H1|chr5:141061008-141061040,chr5,141061008,141061040,0,106955155
H1|chr5:34504853-34504945,chr5,34504853,34504945,H1|chr5:140703917-140703934,chr5,140703917,140703934,0,106199064
H1|chr5:34541006-34541088,chr5,34541006,34541088,H1|chr5:147252464-147252610,chr5,147252464,147252610,0,112711458
H1|chr5:34779558-34779648,chr5,34779558,34779648,H1|chr5:147252464-147252559,chr5,147252464,147252559,0,112472906
H1|chr5:34806296-34806387,chr5,34806296,34806387,H1|chr5:154088896-154088952,chr5,154088896,154088952,0,119282600
H1|chr5:34887800-34887873,chr5,34887800,34887873,H1|chr5:141700213-141700263,chr5,141700213,141700263,0,106812413
H1|chr5:35055012-35055053,chr5,35055012,35055053,H1|chr5:141699970-141700023,chr5,141699970,141700023,0,106644958
H1|chr5:35209093-35209177,chr5,35209093,35209177,H1|chr5:7395320-7395386,chr5,7395320,7395386,0,27813773
H1|chr5:35423418-35423455,chr5,35423418,35423455,H1|chr5:147249787-147249896,chr5,147249787,147249896,0,111826369
H1|chr5:35735435-35735585,chr5,35735435,35735585,H1|chr5:176738057-176738109,chr5,176738057,176738109,0,141002622
H1|chr5:35785251-35785277,chr5,35785251,35785277,H1|chr5:147250130-147250280,chr5,147250130,147250280,0,111464879
H1|chr5:36027197-36027288,chr5,36027197,36027288,H1|chr5:154088896-154088952,chr5,154088896,154088952,0,118061699
H1|chr5:36148118-36148148,chr5,36148118,36148148,H1|chr5:177591071-177591191,chr5,177591071,177591191,0,141442953
H1|chr5:36321864-36321902,chr5,36321864,36321902,H1|chr5:176740707-176740736,chr5,176740707,176740736,0,140418843
H1|chr5:36334716-36334778,chr5,36334716,36334778,H1|chr5:72145050-72145116,chr5,72145050,72145116,0,35810334
H1|chr5:36746527-36746590,chr5,36746527,36746590,H1|chr5:147251574-147251657,chr5,147251574,147251657,0,110505047
H1|chr5:36914563-36914658,chr5,36914563,36914658,H1|chr5:69344437-69344556,chr5,69344437,69344556,0,32429874
H1|chr5:36914994-36915082,chr5,36914994,36915082,H1|chr5:272383-272529,chr5,272383,272529,0,36642611
H1|chr5:37205324-37205415,chr5,37205324,37205415,H1|chr5:74160926-74160965,chr5,74160926,74160965,0,36955602
H1|chr5:37250942-37251002,chr5,37250942,37251002,H1|chr5:72145050-72145116,chr5,72145050,72145116,0,34894108
H1|chr5:37269745-37269857,chr5,37269745,37269857,H1|chr5:147252632-147252670,chr5,147252632,147252670,0,109982887
H1|chr5:37376930-37376948,chr5,37376930,37376948,H1|chr5:141700556-141700668,chr5,141700556,141700668,0,104323626
H1|chr5:37408787-37408932,chr5,37408787,37408932,H1|chr5:693278-693428,chr5,693278,693428,0,36715509
H1|chr5:37553366-37553459,chr5,37553366,37553459,H1|chr5:7395320-7395386,chr5,7395320,7395386,0,30158046
H1|chr5:37604469-37604549,chr5,37604469,37604549,H1|chr5:154088633-154088700,chr5,154088633,154088700,0,116484164
H1|chr5:37725834-37725872,chr5,37725834,37725872,H1|chr5:177591097-177591191,chr5,177591097,177591191,0,139865263
H1|chr5:37829051-37829097,chr5,37829051,37829097,H1|chr5:107007596-107007670,chr5,107007596,107007670,0,69178545
H1|chr5:39662491-39662578,chr5,39662491,39662578,H1|chr5:154098955-154098992,chr5,154098955,154098992,0,114436464
H1|chr5:39700700-39700850,chr5,39700700,39700850,H1|chr5:141706916-141706957,chr5,141706916,141706957,0,102006216
H1|chr5:39869099-39869198,chr5,39869099,39869198,H1|chr5:692841-692921,chr5,692841,692921,0,39176258
H1|chr5:39998825-39998917,chr5,39998825,39998917,H1|chr5:697716-697774,chr5,697716,697774,0,39301109
H1|chr5:40118785-40118815,chr5,40118785,40118815,H1|chr5:107007596-107007670,chr5,107007596,107007670,0,66888811
H1|chr5:40210544-40210599,chr5,40210544,40210599,H1|chr5:171883926-171883951,chr5,171883926,171883951,0,131673382
H1|chr5:40384072-40384093,chr5,40384072,40384093,H1|chr5:147252448-147252594,chr5,147252448,147252594,0,106868376
H1|chr5:40455713-40455793,chr5,40455713,40455793,H1|chr5:115905868-115905909,chr5,115905868,115905909,0,75450155
H1|chr5:40595908-40595949,chr5,40595908,40595949,H1|chr5:16736242-16736335,chr5,16736242,16736335,0,23859666
H1|chr5:40989754-40989804,chr5,40989754,40989804,H1|chr5:175221729-175221879,chr5,175221729,175221879,0,134231975
H1|chr5:41041236-41041282,chr5,41041236,41041282,H1|chr5:154100137-154100268,chr5,154100137,154100268,0,113058901
H1|chr5:41063797-41063851,chr5,41063797,41063851,H1|chr5:115908525-115908593,chr5,115908525,115908593,0,74844728
H1|chr5:41742796-41742920,chr5,41742796,41742920,H1|chr5:107007596-107007670,chr5,107007596,107007670,0,65264800
H1|chr5:41953258-41953322,chr5,41953258,41953322,H1|chr5:139024795-139024855,chr5,139024795,139024855,0,97071537
H1|chr5:42422457-42422515,chr5,42422457,42422515,H1|chr5:115908525-115908593,chr5,115908525,115908593,0,73486068
H1|chr5:42651662-42651812,chr5,42651662,42651812,H1|chr5:697476-697621,chr5,697476,697621,0,41954186
H1|chr5:42681567-42681605,chr5,42681567,42681605,H1|chr5:25444748-25444794,chr5,25444748,25444794,0,17236819
H1|chr5:43450228-43450309,chr5,43450228,43450309,H1|chr5:147248684-147248705,chr5,147248684,147248705,0,103798456
H1|chr5:43678502-43678597,chr5,43678502,43678597,H1|chr5:154087532-154087578,chr5,154087532,154087578,0,110409030
H1|chr5:43833136-43833279,chr5,43833136,43833279,H1|chr5:154099526-154099585,chr5,154099526,154099585,0,110266390
H1|chr5:44035111-44035163,chr5,44035111,44035163,H1|chr5:141699968-141700023,chr5,141699968,141700023,0,97664857
H1|chr5:44113832-44113868,chr5,44113832,44113868,H1|chr5:147246048-147246159,chr5,147246048,147246159,0,103132216
H1|chr5:44489563-44489654,chr5,44489563,44489654,H1|chr5:147246117-147246238,chr5,147246117,147246238,0,102756554
H1|chr5:44627503-44627586,chr5,44627503,44627586,H1|chr5:55290-55314,chr5,55290,55314,0,44572213
H1|chr5:44816761-44816836,chr5,44816761,44816836,H1|chr5:25443873-25443948,chr5,25443873,25443948,0,19372888
H1|chr5:45035205-45035231,chr5,45035205,45035231,H1|chr5:141255464-141255546,chr5,141255464,141255546,0,96220259
H1|chr5:45174741-45174799,chr5,45174741,45174799,H1|chr5:147250720-147250857,chr5,147250720,147250857,0,102075979
H1|chr5:45190836-45190896,chr5,45190836,45190896,H1|chr5:697302-697372,chr5,697302,697372,0,44493534
H1|chr5:45964674-45964691,chr5,45964674,45964691,H1|chr5:141700556-141700668,chr5,141700556,141700668,0,95735882
H1|chr5:46113060-46113160,chr5,46113060,46113160,H1|chr5:69344437-69344556,chr5,69344437,69344556,0,23231377
H1|chr5:47080804-47080853,chr5,47080804,47080853,H1|chr5:176905994-176906053,chr5,176905994,176906053,0,129825190
H1|chr5:47123192-47123277,chr5,47123192,47123277,H1|chr5:147247929-147247994,chr5,147247929,147247994,0,100124737
H1|chr5:47129376-47129394,chr5,47129376,47129394,H1|chr5:146829777-146829897,chr5,146829777,146829897,0,99700401
H1|chr5:47159720-47159761,chr5,47159720,47159761,H1|chr5:141699970-141700023,chr5,141699970,141700023,0,94540250
H1|chr5:47321269-47321329,chr5,47321269,47321329,H1|chr5:175628990-175629140,chr5,175628990,175629140,0,128307721
H1|chr5:47385996-47386056,chr5,47385996,47386056,H1|chr5:175628990-175629140,chr5,175628990,175629140,0,128242994
H1|chr5:47517478-47517579,chr5,47517478,47517579,H1|chr5:56472359-56472408,chr5,56472359,56472408,0,8954881
H1|chr5:47645163-47645217,chr5,47645163,47645217,H1|chr5:115908525-115908593,chr5,115908525,115908593,0,68263362
H1|chr5:47891553-47891595,chr5,47891553,47891595,H1|chr5:140174351-140174459,chr5,140174351,140174459,0,92282798
H1|chr5:48205028-48205122,chr5,48205028,48205122,H1|chr5:175219554-175219679,chr5,175219554,175219679,0,127014526
H1|chr5:48284579-48284636,chr5,48284579,48284636,H1|chr5:171438337-171438460,chr5,171438337,171438460,0,123153758
H1|chr5:48322800-48322950,chr5,48322800,48322950,H1|chr5:175627761-175627813,chr5,175627761,175627813,0,127304961
H1|chr5:48449130-48449175,chr5,48449130,48449175,H1|chr5:171435172-171435248,chr5,171435172,171435248,0,122986042
H1|chr5:48695288-48695413,chr5,48695288,48695413,H1|chr5:272104-272230,chr5,272104,272230,0,48423184
H1|chr5:49182392-49182432,chr5,49182392,49182432,H1|chr5:150828241-150828351,chr5,150828241,150828351,0,101645849
H1|chr5:49455069-49455215,chr5,49455069,49455215,H1|chr5:118788512-118788569,chr5,118788512,118788569,0,69333443
H1|chr5:49461495-49461598,chr5,49461495,49461598,H1|chr5:177591159-177591191,chr5,177591159,177591191,0,128129664
H1|chr5:49718215-49718266,chr5,49718215,49718266,H1|chr5:25443512-25443567,chr5,25443512,25443567,0,24274703
H1|chr5:50014270-50014320,chr5,50014270,50014320,H1|chr5:25443632-25443710,chr5,25443632,25443710,0,24570638
H1|chr5:50366073-50366115,chr5,50366073,50366115,H1|chr5:147251508-147251616,chr5,147251508,147251616,0,96885435
H1|chr5:50899467-50899570,chr5,50899467,50899570,H1|chr5:141704189-141704207,chr5,141704189,141704207,0,90804722
H1|chr5:51022871-51023014,chr5,51022871,51023014,H1|chr5:175627755-175627905,chr5,175627755,175627905,0,124604884
H1|chr5:51253848-51253894,chr5,51253848,51253894,H1|chr5:107007596-107007670,chr5,107007596,107007670,0,55753748
H1|chr5:51580612-51580638,chr5,51580612,51580638,H1|chr5:693716-693837,chr5,693716,693837,0,50886896
H1|chr5:51584116-51584222,chr5,51584116,51584222,H1|chr5:25443459-25443503,chr5,25443459,25443503,0,26140657
H1|chr5:51878809-51878924,chr5,51878809,51878924,H1|chr5:147252990-147253025,chr5,147252990,147253025,0,95374181
H1|chr5:52540937-52541042,chr5,52540937,52541042,H1|chr5:154090441-154090459,chr5,154090441,154090459,0,101549504
H1|chr5:52866238-52866290,chr5,52866238,52866290,H1|chr5:141699968-141700023,chr5,141699968,141700023,0,88833730
H1|chr5:53091843-53091944,chr5,53091843,53091944,H1|chr5:147249323-147249375,chr5,147249323,147249375,0,94157480
H1|chr5:53249377-53249523,chr5,53249377,53249523,H1|chr5:141734992-141735038,chr5,141734992,141735038,0,88485615
H1|chr5:54016219-54016334,chr5,54016219,54016334,H1|chr5:139026451-139026531,chr5,139026451,139026531,0,85010232
H1|chr5:54188581-54188627,chr5,54188581,54188627,H1|chr5:154100137-154100268,chr5,154100137,154100268,0,99911556
H1|chr5:54267382-54267434,chr5,54267382,54267434,H1|chr5:6449548-6449565,chr5,6449548,6449565,0,47817834
H1|chr5:54348564-54348714,chr5,54348564,54348714,H1|chr5:272212-272362,chr5,272212,272362,0,54076352
H1|chr5:54365573-54365662,chr5,54365573,54365662,H1|chr5:74160926-74160965,chr5,74160926,74160965,0,19795353
H1|chr5:54701855-54701895,chr5,54701855,54701895,H1|chr5:694518-694570,chr5,694518,694570,0,54007337
H1|chr5:55239576-55239668,chr5,55239576,55239668,H1|chr5:141703900-141703987,chr5,141703900,141703987,0,86464324
H1|chr5:55442086-55442236,chr5,55442086,55442236,H1|chr5:697471-697621,chr5,697471,697621,0,54744615
H1|chr5:55754601-55754671,chr5,55754601,55754671,H1|chr5:139026451-139026531,chr5,139026451,139026531,0,83271850
H1|chr5:55895115-55895210,chr5,55895115,55895210,H1|chr5:141705177-141705245,chr5,141705177,141705245,0,85810062
H1|chr5:56492283-56492316,chr5,56492283,56492316,H1|chr5:147248450-147248600,chr5,147248450,147248600,0,90756167
H1|chr5:56853310-56853367,chr5,56853310,56853367,H1|chr5:170815976-170816094,chr5,170815976,170816094,0,113962666
H1|chr5:57167358-57167499,chr5,57167358,57167499,H1|chr5:147249922-147249953,chr5,147249922,147249953,0,90082564
H1|chr5:57611563-57611588,chr5,57611563,57611588,H1|chr5:147251445-147251595,chr5,147251445,147251595,0,89639882
H1|chr5:57777632-57777692,chr5,57777632,57777692,H1|chr5:175627734-175627789,chr5,175627734,175627789,0,117850102
H1|chr5:57840156-57840246,chr5,57840156,57840246,H1|chr5:176738057-176738109,chr5,176738057,176738109,0,118897901
H1|chr5:57915624-57915700,chr5,57915624,57915700,H1|chr5:147251612-147251754,chr5,147251612,147251754,0,89335988
H1|chr5:58661355-58661461,chr5,58661355,58661461,H1|chr5:147252837-147252904,chr5,147252837,147252904,0,88591482
H1|chr5:58763043-58763091,chr5,58763043,58763091,H1|chr5:57556-57655,chr5,57556,57655,0,58705487
H1|chr5:58785481-58785526,chr5,58785481,58785526,H1|chr5:154091974-154092056,chr5,154091974,154092056,0,95306493
H1|chr5:58953013-58953101,chr5,58953013,58953101,H1|chr5:177591096-177591191,chr5,177591096,177591191,0,118638083
H1|chr5:59041879-59041961,chr5,59041879,59041961,H1|chr5:141705177-141705245,chr5,141705177,141705245,0,82663298
H1|chr5:59213533-59213646,chr5,59213533,59213646,H1|chr5:696321-696419,chr5,696321,696419,0,58517212
H1|chr5:60178778-60178871,chr5,60178778,60178871,H1|chr5:697715-697774,chr5,697715,697774,0,59481063
H1|chr5:60268252-60268278,chr5,60268252,60268278,H1|chr5:693716-693837,chr5,693716,693837,0,59574536
H1|chr5:60384663-60384775,chr5,60384663,60384775,H1|chr5:696525-696645,chr5,696525,696645,0,59688138
H1|chr5:60560366-60560386,chr5,60560366,60560386,H1|chr5:141256781-141256802,chr5,141256781,141256802,0,80696415
H1|chr5:60674614-60674764,chr5,60674614,60674764,H1|chr5:175627946-175627983,chr5,175627946,175627983,0,114953332
H1|chr5:60767458-60767573,chr5,60767458,60767573,H1|chr5:147252990-147253025,chr5,147252990,147253025,0,86485532
H1|chr5:61189341-61189399,chr5,61189341,61189399,H1|chr5:175628458-175628550,chr5,175628458,175628550,0,114439117
H1|chr5:61421548-61421613,chr5,61421548,61421613,H1|chr5:147252686-147252771,chr5,147252686,147252771,0,85831138
H1|chr5:62339323-62339384,chr5,62339323,62339384,H1|chr5:147249323-147249375,chr5,147249323,147249375,0,84910000
H1|chr5:62737043-62737069,chr5,62737043,62737069,H1|chr5:175631346-175631465,chr5,175631346,175631465,0,112894303
H1|chr5:62890430-62890500,chr5,62890430,62890500,H1|chr5:34658434-34658509,chr5,34658434,34658509,0,28231996
H1|chr5:63105763-63105793,chr5,63105763,63105793,H1|chr5:147249922-147250021,chr5,147249922,147250021,0,84144159
H1|chr5:63179089-63179160,chr5,63179089,63179160,H1|chr5:25444515-25444550,chr5,25444515,25444550,0,37734574
H1|chr5:63287080-63287137,chr5,63287080,63287137,H1|chr5:25442144-25442237,chr5,25442144,25442237,0,37844936
H1|chr5:63360120-63360183,chr5,63360120,63360183,H1|chr5:147249761-147249871,chr5,147249761,147249871,0,83889641
H1|chr5:63376055-63376161,chr5,63376055,63376161,H1|chr5:25443459-25443503,chr5,25443459,25443503,0,37932596
H1|chr5:63386665-63386703,chr5,63386665,63386703,H1|chr5:177591061-177591191,chr5,177591061,177591191,0,114204396
H1|chr5:63505430-63505511,chr5,63505430,63505511,H1|chr5:154100045-154100114,chr5,154100045,154100114,0,90594615
H1|chr5:63810012-63810037,chr5,63810012,63810037,H1|chr5:147249959-147250019,chr5,147249959,147250019,0,83439947
H1|chr5:64298709-64298726,chr5,64298709,64298726,H1|chr5:147251856-147251989,chr5,147251856,147251989,0,82953147
H1|chr5:64621413-64621473,chr5,64621413,64621473,H1|chr5:76504016-76504073,chr5,76504016,76504073,0,11882603
H1|chr5:64904351-64904402,chr5,64904351,64904402,H1|chr5:147252845-147252927,chr5,147252845,147252927,0,82348494
H1|chr5:65358076-65358097,chr5,65358076,65358097,H1|chr5:147251543-147251645,chr5,147251543,147251645,0,81893467
H1|chr5:65550125-65550275,chr5,65550125,65550275,H1|chr5:147252990-147253025,chr5,147252990,147253025,0,81702865
H1|chr5:65941314-65941403,chr5,65941314,65941403,H1|chr5:74160926-74160965,chr5,74160926,74160965,0,8219612
H1|chr5:66202282-66202342,chr5,66202282,66202342,H1|chr5:147251574-147251664,chr5,147251574,147251664,0,81049292
H1|chr5:66415596-66415746,chr5,66415596,66415746,H1|chr5:175627658-175627804,chr5,175627658,175627804,0,109212062
H1|chr5:66756683-66756769,chr5,66756683,66756769,H1|chr5:154100045-154100114,chr5,154100045,154100114,0,87343362
H1|chr5:66806306-66806368,chr5,66806306,66806368,H1|chr5:177591069-177591197,chr5,177591069,177591197,0,110784763
H1|chr5:67129790-67129824,chr5,67129790,67129824,H1|chr5:25444600-25444654,chr5,25444600,25444654,0,41685190
H1|chr5:67602184-67602243,chr5,67602184,67602243,H1|chr5:147764165-147764188,chr5,147764165,147764188,0,80161981
H1|chr5:67655584-67655657,chr5,67655584,67655657,H1|chr5:7395857-7395880,chr5,7395857,7395880,0,60259727
H1|chr5:67812847-67812878,chr5,67812847,67812878,H1|chr5:175631346-175631465,chr5,175631346,175631465,0,107818499
H1|chr5:67834473-67834533,chr5,67834473,67834533,H1|chr5:175627734-175627789,chr5,175627734,175627789,0,107793261
H1|chr5:67916653-67916698,chr5,67916653,67916698,H1|chr5:147249204-147249258,chr5,147249204,147249258,0,79332551
H1|chr5:68089473-68089542,chr5,68089473,68089542,H1|chr5:147246831-147246861,chr5,147246831,147246861,0,79157358
H1|chr5:68408283-68408328,chr5,68408283,68408328,H1|chr5:154137447-154137551,chr5,154137447,154137551,0,85729164
H1|chr5:69089861-69089907,chr5,69089861,69089907,H1|chr5:171435172-171435248,chr5,171435172,171435248,0,102345311
H1|chr5:69267106-69267256,chr5,69267106,69267256,H1|chr5:141706916-141706957,chr5,141706916,141706957,0,72439810
H1|chr5:69316114-69316216,chr5,69316114,69316216,H1|chr5:147247758-147247829,chr5,147247758,147247829,0,77931644
H1|chr5:69362068-69362103,chr5,69362068,69362103,H1|chr5:147247351-147247458,chr5,147247351,147247458,0,77885283
H1|chr5:69529321-69529354,chr5,69529321,69529354,H1|chr5:147252454-147252524,chr5,147252454,147252524,0,77723133
H1|chr5:69784885-69784953,chr5,69784885,69784953,H1|chr5:25443404-25443488,chr5,25443404,25443488,0,44341481
H1|chr5:69831100-69831234,chr5,69831100,69831234,H1|chr5:147251545-147251648,chr5,147251545,147251648,0,77420445
H1|chr5:69839209-69839240,chr5,69839209,69839240,H1|chr5:7393104-7393203,chr5,7393104,7393203,0,62446105
H1|chr5:69926645-69926705,chr5,69926645,69926705,H1|chr5:72145050-72145116,chr5,72145050,72145116,0,2218405
H1|chr5:69967435-69967515,chr5,69967435,69967515,H1|chr5:175222367-175222409,chr5,175222367,175222409,0,105254932
H1|chr5:70126085-70126109,chr5,70126085,70126109,H1|chr5:141258170-141258260,chr5,141258170,141258260,0,71132085
H1|chr5:70171702-70171849,chr5,70171702,70171849,H1|chr5:693919-694066,chr5,693919,694066,0,69477783
H1|chr5:70797716-70797786,chr5,70797716,70797786,H1|chr5:147251446-147251487,chr5,147251446,147251487,0,76453730
H1|chr5:70918450-70918530,chr5,70918450,70918530,H1|chr5:115905868-115905909,chr5,115905868,115905909,0,44987418
H1|chr5:71947013-71947073,chr5,71947013,71947073,H1|chr5:147251574-147251664,chr5,147251574,147251664,0,75304561
H1|chr5:71991863-71991968,chr5,71991863,71991968,H1|chr5:177591141-177591191,chr5,177591141,177591191,0,105599278
H1|chr5:72203529-72203567,chr5,72203529,72203567,H1|chr5:177591097-177591191,chr5,177591097,177591191,0,105387568
H1|chr5:72307595-72307665,chr5,72307595,72307665,H1|chr5:147248294-147248335,chr5,147248294,147248335,0,74940699
H1|chr5:72393663-72393750,chr5,72393663,72393750,H1|chr5:138631715-138631775,chr5,138631715,138631775,0,66238052
H1|chr5:72606928-72607078,chr5,72606928,72607078,H1|chr5:175627946-175627983,chr5,175627946,175627983,0,103021018
H1|chr5:72676277-72676379,chr5,72676277,72676379,H1|chr5:141255464-141255546,chr5,141255464,141255546,0,68579187
H1|chr5:72722293-72722355,chr5,72722293,72722355,H1|chr5:147252611-147252693,chr5,147252611,147252693,0,74530318
H1|chr5:72774566-72774671,chr5,72774566,72774671,H1|chr5:154134201-154134241,chr5,154134201,154134241,0,81359635
H1|chr5:72797511-72797598,chr5,72797511,72797598,H1|chr5:175627757-175627902,chr5,175627757,175627902,0,102830246
H1|chr5:72845792-72845858,chr5,72845792,72845858,H1|chr5:175626627-175626678,chr5,175626627,175626678,0,102780835
H1|chr5:73304579-73304612,chr5,73304579,73304612,H1|chr5:147250776-147250900,chr5,147250776,147250900,0,73946197
H1|chr5:73354839-73354893,chr5,73354839,73354893,H1|chr5:147252988-147253058,chr5,147252988,147253058,0,73898149
H1|chr5:73382731-73382846,chr5,73382731,73382846,H1|chr5:139026451-139026531,chr5,139026451,139026531,0,65643720
H1|chr5:73997730-73997760,chr5,73997730,73997760,H1|chr5:154088604-154088699,chr5,154088604,154088699,0,80090874
H1|chr5:74081415-74081564,chr5,74081415,74081564,H1|chr5:175627719-175627823,chr5,175627719,175627823,0,101546304
H1|chr5:74236662-74236725,chr5,74236662,74236725,H1|chr5:147247832-147247900,chr5,147247832,147247900,0,73011170
H1|chr5:74544155-74544249,chr5,74544155,74544249,H1|chr5:176743211-176743267,chr5,176743211,176743267,0,102199056
H1|chr5:74566985-74567088,chr5,74566985,74567088,H1|chr5:141704189-141704207,chr5,141704189,141704207,0,67137204
H1|chr5:74761943-74762014,chr5,74761943,74762014,H1|chr5:147248020-147248099,chr5,147248020,147248099,0,72486077
H1|chr5:75150999-75151149,chr5,75150999,75151149,H1|chr5:175627668-175627769,chr5,175627668,175627769,0,100476669
H1|chr5:75398021-75398090,chr5,75398021,75398090,H1|chr5:79552302-79552366,chr5,79552302,79552366,0,4154281
H1|chr5:75879132-75879148,chr5,75879132,75879148,H1|chr5:147251597-147251728,chr5,147251597,147251728,0,71372465
H1|chr5:75903051-75903074,chr5,75903051,75903074,H1|chr5:177663779-177663892,chr5,177663779,177663892,0,101760728
H1|chr5:76189793-76189818,chr5,76189793,76189818,H1|chr5:147245790-147245864,chr5,147245790,147245864,0,71055997
H1|chr5:76939990-76940056,chr5,76939990,76940056,H1|chr5:147250372-147250497,chr5,147250372,147250497,0,70310382
H1|chr5:76947307-76947337,chr5,76947307,76947337,H1|chr5:147249922-147250021,chr5,147249922,147250021,0,70302615
H1|chr5:77033299-77033343,chr5,77033299,77033343,H1|chr5:154091268-154091349,chr5,154091268,154091349,0,77057969
H1|chr5:77661038-77661116,chr5,77661038,77661116,H1|chr5:147246122-147246168,chr5,147246122,147246168,0,69585084
H1|chr5:77710503-77710618,chr5,77710503,77710618,H1|chr5:154134201-154134307,chr5,154134201,154134307,0,76423698
H1|chr5:77721865-77721893,chr5,77721865,77721893,H1|chr5:154090040-154090138,chr5,154090040,154090138,0,76368175
H1|chr5:77788957-77789010,chr5,77788957,77789010,H1|chr5:56472636-56472763,chr5,56472636,56472763,0,21316321
H1|chr5:77800554-77800606,chr5,77800554,77800606,H1|chr5:6449548-6449565,chr5,6449548,6449565,0,71351006
H1|chr5:77911357-77911382,chr5,77911357,77911382,H1|chr5:147249959-147250019,chr5,147249959,147250019,0,69338602
H1|chr5:77949314-77949402,chr5,77949314,77949402,H1|chr5:177591103-177591191,chr5,177591103,177591191,0,99641789
H1|chr5:78101628-78101769,chr5,78101628,78101769,H1|chr5:147249922-147249953,chr5,147249922,147249953,0,69148294
H1|chr5:78157750-78157805,chr5,78157750,78157805,H1|chr5:693048-693166,chr5,693048,693166,0,77464702
H1|chr5:78204767-78204797,chr5,78204767,78204797,H1|chr5:147247947-147248044,chr5,147247947,147248044,0,69043180
H1|chr5:78329586-78329736,chr5,78329586,78329736,H1|chr5:147250990-147251090,chr5,147250990,147251090,0,68921404
H1|chr5:78391371-78391461,chr5,78391371,78391461,H1|chr5:79550716-79550769,chr5,79550716,79550769,0,1159345
H1|chr5:78809977-78810127,chr5,78809977,78810127,H1|chr5:76787138-76787272,chr5,76787138,76787272,0,2022839
H1|chr5:78908582-78908629,chr5,78908582,78908629,H1|chr5:141735174-141735229,chr5,141735174,141735229,0,62826592
H1|chr5:79147836-79147859,chr5,79147836,79147859,H1|chr5:147245908-147246035,chr5,147245908,147246035,0,68098072
H1|chr5:79170808-79170899,chr5,79170808,79170899,H1|chr5:171438155-171438301,chr5,171438155,171438301,0,92267347
H1|chr5:79275463-79275563,chr5,79275463,79275563,H1|chr5:69344437-69344556,chr5,69344437,69344556,0,9931026
H1|chr5:79300259-79300313,chr5,79300259,79300313,H1|chr5:141703223-141703319,chr5,141703223,141703319,0,62402964
H1|chr5:79370944-79371025,chr5,79370944,79371025,H1|chr5:154100045-154100114,chr5,154100045,154100114,0,74729101
H1|chr5:79411325-79411382,chr5,79411325,79411382,H1|chr5:154088183-154088278,chr5,154088183,154088278,0,74676858
H1|chr5:79440158-79440243,chr5,79440158,79440243,H1|chr5:697312-697372,chr5,697312,697372,0,78742846
H1|chr5:79545720-79545771,chr5,79545720,79545771,H1|chr5:25444256-25444339,chr5,25444256,25444339,0,54101464
H1|chr5:79598346-79598402,chr5,79598346,79598402,H1|chr5:170815976-170816094,chr5,170815976,170816094,0,91217630
H1|chr5:79744948-79745010,chr5,79744948,79745010,H1|chr5:177591069-177591197,chr5,177591069,177591197,0,97846121
H1|chr5:79827040-79827081,chr5,79827040,79827081,H1|chr5:176740489-176740587,chr5,176740489,176740587,0,96913449
H1|chr5:80060923-80061073,chr5,80060923,80061073,H1|chr5:175627761-175627813,chr5,175627761,175627813,0,95566838
H1|chr5:80285393-80285414,chr5,80285393,80285414,H1|chr5:147251543-147251645,chr5,147251543,147251645,0,66966150
H1|chr5:80322958-80323036,chr5,80322958,80323036,H1|chr5:146829883-146829938,chr5,146829883,146829938,0,66506925
H1|chr5:80383146-80383208,chr5,80383146,80383208,H1|chr5:147252611-147252693,chr5,147252611,147252693,0,66869465
H1|chr5:80499442-80499532,chr5,80499442,80499532,H1|chr5:140787299-140787359,chr5,140787299,140787359,0,60287857
H1|chr5:80782487-80782612,chr5,80782487,80782612,H1|chr5:272104-272230,chr5,272104,272230,0,80510383
H1|chr5:80835296-80835334,chr5,80835296,80835334,H1|chr5:177591061-177591191,chr5,177591061,177591191,0,96755765
H1|chr5:81093561-81093626,chr5,81093561,81093626,H1|chr5:94890201-94890233,chr5,94890201,94890233,0,13796640
H1|chr5:81669751-81669801,chr5,81669751,81669801,H1|chr5:154136215-154136315,chr5,154136215,154136315,0,72466464
H1|chr5:81681475-81681545,chr5,81681475,81681545,H1|chr5:34658434-34658509,chr5,34658434,34658509,0,47023041
H1|chr5:82078736-82078841,chr5,82078736,82078841,H1|chr5:154091347-154091370,chr5,154091347,154091370,0,72012611
H1|chr5:82434545-82434589,chr5,82434545,82434589,H1|chr5:147253396-147253466,chr5,147253396,147253466,0,64818851
H1|chr5:82600571-82600627,chr5,82600571,82600627,H1|chr5:147256275-147256415,chr5,147256275,147256415,0,64655704
H1|chr5:82772098-82772248,chr5,82772098,82772248,H1|chr5:697444-697594,chr5,697444,697594,0,82074654
H1|chr5:83116688-83116722,chr5,83116688,83116722,H1|chr5:696321-696419,chr5,696321,696419,0,82420367
H1|chr5:83235038-83235188,chr5,83235038,83235188,H1|chr5:147251844-147251994,chr5,147251844,147251994,0,64016806
H1|chr5:83434614-83434664,chr5,83434614,83434664,H1|chr5:147249892-147249926,chr5,147249892,147249926,0,63815278
H1|chr5:83590259-83590283,chr5,83590259,83590283,H1|chr5:147247789-147247935,chr5,147247789,147247935,0,63657530
H1|chr5:83602770-83602853,chr5,83602770,83602853,H1|chr5:147252837-147252904,chr5,147252837,147252904,0,63650067
H1|chr5:83696414-83696504,chr5,83696414,83696504,H1|chr5:27475222-27475306,chr5,27475222,27475306,0,56221192
H1|chr5:84027187-84027236,chr5,84027187,84027236,H1|chr5:154100137-154100268,chr5,154100137,154100268,0,70072950
H1|chr5:84046136-84046165,chr5,84046136,84046165,H1|chr5:613267-613305,chr5,613267,613305,0,83432869
H1|chr5:84052216-84052265,chr5,84052216,84052265,H1|chr5:176905994-176906053,chr5,176905994,176906053,0,92853778
H1|chr5:84282004-84282064,chr5,84282004,84282064,H1|chr5:138631519-138631624,chr5,138631519,138631624,0,54349515
H1|chr5:84583387-84583454,chr5,84583387,84583454,H1|chr5:171883926-171883949,chr5,171883926,171883949,0,87300539
H1|chr5:84837900-84837926,chr5,84837900,84837926,H1|chr5:69344437-69344556,chr5,69344437,69344556,0,15493463
H1|chr5:85084788-85084867,chr5,85084788,85084867,H1|chr5:147247758-147247829,chr5,147247758,147247829,0,62162970
H1|chr5:85148075-85148189,chr5,85148075,85148189,H1|chr5:147252632-147252670,chr5,147252632,147252670,0,62104557
H1|chr5:85452435-85452490,chr5,85452435,85452490,H1|chr5:693048-693166,chr5,693048,693166,0,84759387
H1|chr5:85711173-85711195,chr5,85711173,85711195,H1|chr5:147252648-147252774,chr5,147252648,147252774,0,61541475
H1|chr5:85711497-85711555,chr5,85711497,85711555,H1|chr5:177591103-177591191,chr5,177591103,177591191,0,91879606
H1|chr5:86246471-86246534,chr5,86246471,86246534,H1|chr5:171438171-171438301,chr5,171438171,171438301,0,85191700
H1|chr5:86675223-86675271,chr5,86675223,86675271,H1|chr5:147247238-147247294,chr5,147247238,147247294,0,60572015
H1|chr5:86696991-86697008,chr5,86696991,86697008,H1|chr5:107007767-107007910,chr5,107007767,107007910,0,20310776
H1|chr5:86709720-86709778,chr5,86709720,86709778,H1|chr5:115908525-115908593,chr5,115908525,115908593,0,29198805
H1|chr5:86796809-86796885,chr5,86796809,86796885,H1|chr5:147251612-147251754,chr5,147251612,147251754,0,60454803
H1|chr5:87034228-87034252,chr5,87034228,87034252,H1|chr5:147252390-147252465,chr5,147252390,147252465,0,60218162
H1|chr5:87345863-87345911,chr5,87345863,87345911,H1|chr5:147251304-147251406,chr5,147251304,147251406,0,59905441
H1|chr5:87508267-87508366,chr5,87508267,87508366,H1|chr5:147251763-147251910,chr5,147251763,147251910,0,59743496
H1|chr5:87709014-87709158,chr5,87709014,87709158,H1|chr5:177627397-177627417,chr5,177627397,177627417,0,89918383
H1|chr5:88073489-88073588,chr5,88073489,88073588,H1|chr5:140787299-140787359,chr5,140787299,140787359,0,52713810
H1|chr5:88132374-88132406,chr5,88132374,88132406,H1|chr5:31529873-31529944,chr5,31529873,31529944,0,56602501
H1|chr5:88509835-88509921,chr5,88509835,88509921,H1|chr5:147250040-147250063,chr5,147250040,147250063,0,58740205
H1|chr5:88738206-88738247,chr5,88738206,88738247,H1|chr5:124081199-124081273,chr5,124081199,124081273,0,35342993
H1|chr5:88897980-88898085,chr5,88897980,88898085,H1|chr5:154090441-154090459,chr5,154090441,154090459,0,65192461
H1|chr5:89078583-89078672,chr5,89078583,89078672,H1|chr5:141734992-141735038,chr5,141734992,141735038,0,52656409
H1|chr5:89401404-89401473,chr5,89401404,89401473,H1|chr5:147246173-147246254,chr5,147246173,147246254,0,57844769
H1|chr5:89637908-89637971,chr5,89637908,89637971,H1|chr5:141703900-141703987,chr5,141703900,141703987,0,52065992
H1|chr5:90311865-90312013,chr5,90311865,90312013,H1|chr5:25441511-25441569,chr5,25441511,25441569,0,64870354
H1|chr5:90516496-90516551,chr5,90516496,90516551,H1|chr5:177591096-177591191,chr5,177591096,177591191,0,87074600
H1|chr5:90700622-90700671,chr5,90700622,90700671,H1|chr5:613266-613305,chr5,613266,613305,0,90087356
H1|chr5:90863104-90863251,chr5,90863104,90863251,H1|chr5:175628380-175628529,chr5,175628380,175628529,0,84765276
H1|chr5:90922723-90922782,chr5,90922723,90922782,H1|chr5:147764165-147764188,chr5,147764165,147764188,0,56841442
H1|chr5:90935248-90935308,chr5,90935248,90935308,H1|chr5:138631519-138631624,chr5,138631519,138631624,0,47696271
H1|chr5:91090273-91090387,chr5,91090273,91090387,H1|chr5:25443602-25443638,chr5,25443602,25443638,0,65646671
H1|chr5:91407309-91407452,chr5,91407309,91407452,H1|chr5:154099526-154099585,chr5,154099526,154099585,0,62692217
H1|chr5:91534222-91534285,chr5,91534222,91534285,H1|chr5:171436153-171436214,chr5,171436153,171436214,0,79901931
H1|chr5:91734526-91734620,chr5,91734526,91734620,H1|chr5:175219554-175219679,chr5,175219554,175219679,0,83485028
H1|chr5:91808928-91808999,chr5,91808928,91808999,H1|chr5:175628473-175628549,chr5,175628473,175628549,0,83819545
H1|chr5:91845270-91845379,chr5,91845270,91845379,H1|chr5:141706916-141706957,chr5,141706916,141706957,0,49861646
H1|chr5:91850690-91850729,chr5,91850690,91850729,H1|chr5:140571336-140571390,chr5,140571336,140571390,0,48720646
H1|chr5:91850889-91851033,chr5,91850889,91851033,H1|chr5:76787122-76787272,chr5,76787122,76787272,0,15063767
H1|chr5:92051679-92051776,chr5,92051679,92051776,H1|chr5:177591141-177591191,chr5,177591141,177591191,0,85539462
H1|chr5:92334239-92334265,chr5,92334239,92334265,H1|chr5:69344437-69344556,chr5,69344437,69344556,0,22989802
H1|chr5:92420299-92420411,chr5,92420299,92420411,H1|chr5:696525-696645,chr5,696525,696645,0,91723774
H1|chr5:92606104-92606198,chr5,92606104,92606198,H1|chr5:176743211-176743267,chr5,176743211,176743267,0,84137107
H1|chr5:92806043-92806111,chr5,92806043,92806111,H1|chr5:141734320-141734380,chr5,141734320,141734380,0,48928277
H1|chr5:93564734-93564791,chr5,93564734,93564791,H1|chr5:171883926-171883951,chr5,171883926,171883951,0,78319192
H1|chr5:93804208-93804358,chr5,93804208,93804358,H1|chr5:697476-697621,chr5,697476,697621,0,93106732
H1|chr5:93806600-93806644,chr5,93806600,93806644,H1|chr5:154134201-154134307,chr5,154134201,154134307,0,60327601
H1|chr5:93847910-93847961,chr5,93847910,93847961,H1|chr5:175221729-175221879,chr5,175221729,175221879,0,81373819
H1|chr5:94114039-94114186,chr5,94114039,94114186,H1|chr5:141734992-141735038,chr5,141734992,141735038,0,47620953
H1|chr5:94293313-94293351,chr5,94293313,94293351,H1|chr5:272203-272312,chr5,272203,272312,0,94021110
H1|chr5:94360386-94360429,chr5,94360386,94360429,H1|chr5:177663095-177663154,chr5,177663095,177663154,0,83302709
H1|chr5:94380547-94380577,chr5,94380547,94380577,H1|chr5:154088604-154088699,chr5,154088604,154088699,0,59708057
H1|chr5:94578799-94578891,chr5,94578799,94578891,H1|chr5:25441511-25441569,chr5,25441511,25441569,0,69137288
H1|chr5:94717986-94718003,chr5,94717986,94718003,H1|chr5:147251856-147251989,chr5,147251856,147251989,0,52533870
H1|chr5:94872510-94872634,chr5,94872510,94872634,H1|chr5:6377681-6377710,chr5,6377681,6377710,0,88494829
H1|chr5:95021009-95021096,chr5,95021009,95021096,H1|chr5:175627755-175627905,chr5,175627755,175627905,0,80606746
H1|chr5:95202825-95202870,chr5,95202825,95202870,H1|chr5:147246417-147246504,chr5,147246417,147246504,0,52043592
H1|chr5:95352812-95352902,chr5,95352812,95352902,H1|chr5:176738057-176738109,chr5,176738057,176738109,0,81385245
H1|chr5:96005287-96005317,chr5,96005287,96005317,H1|chr5:147247947-147248044,chr5,147247947,147248044,0,51242660
H1|chr5:96520272-96520368,chr5,96520272,96520368,H1|chr5:147253526-147253573,chr5,147253526,147253573,0,50733254
H1|chr5:96528599-96528680,chr5,96528599,96528680,H1|chr5:147251856-147251989,chr5,147251856,147251989,0,50723257
H1|chr5:96831423-96831496,chr5,96831423,96831496,H1|chr5:56472516-56472567,chr5,56472516,56472567,0,40358907
H1|chr5:96838260-96838321,chr5,96838260,96838321,H1|chr5:179249277-179249412,chr5,179249277,179249412,0,82411017
H1|chr5:96874807-96874898,chr5,96874807,96874898,H1|chr5:147246117-147246238,chr5,147246117,147246238,0,50371310
H1|chr5:96946409-96946488,chr5,96946409,96946488,H1|chr5:147250945-147250972,chr5,147250945,147250972,0,50304536
H1|chr5:97155723-97155786,chr5,97155723,97155786,H1|chr5:147247832-147247900,chr5,147247832,147247900,0,50092109
H1|chr5:97202784-97202842,chr5,97202784,97202842,H1|chr5:175628458-175628550,chr5,175628458,175628550,0,78425674
H1|chr5:97445170-97445221,chr5,97445170,97445221,H1|chr5:25444256-25444339,chr5,25444256,25444339,0,72000914
H1|chr5:97497397-97497482,chr5,97497397,97497482,H1|chr5:141061008-141061040,chr5,141061008,141061040,0,43563611
H1|chr5:97683149-97683274,chr5,97683149,97683274,H1|chr5:141703223-141703319,chr5,141703223,141703319,0,44020074
H1|chr5:97762245-97762294,chr5,97762245,97762294,H1|chr5:154136446-154136521,chr5,154136446,154136521,0,56374201
H1|chr5:97810726-97810795,chr5,97810726,97810795,H1|chr5:147246831-147246861,chr5,147246831,147246861,0,49436105
H1|chr5:97901443-97901487,chr5,97901443,97901487,H1|chr5:141256918-141256952,chr5,141256918,141256952,0,43355475
H1|chr5:98051174-98051264,chr5,98051174,98051264,H1|chr5:147247929-147247994,chr5,147247929,147247994,0,49196755
H1|chr5:98129216-98129313,chr5,98129216,98129313,H1|chr5:79550716-79550769,chr5,79550716,79550769,0,18578500
H1|chr5:98197988-98198133,chr5,98197988,98198133,H1|chr5:178287264-178287361,chr5,178287264,178287361,0,80089276
H1|chr5:98244265-98244304,chr5,98244265,98244304,H1|chr5:140571336-140571390,chr5,140571336,140571390,0,42327071
H1|chr5:98638502-98638542,chr5,98638502,98638542,H1|chr5:150828241-150828351,chr5,150828241,150828351,0,52189739
H1|chr5:98985178-98985230,chr5,98985178,98985230,H1|chr5:147252464-147252559,chr5,147252464,147252559,0,48267286
H1|chr5:99014186-99014286,chr5,99014186,99014286,H1|chr5:177591141-177591191,chr5,177591141,177591191,0,78576955
H1|chr5:99599207-99599350,chr5,99599207,99599350,H1|chr5:147252686-147252771,chr5,147252686,147252771,0,47653479
H1|chr5:99789144-99789294,chr5,99789144,99789294,H1|chr5:175221740-175221831,chr5,175221740,175221831,0,75432596
H1|chr5:99814730-99814818,chr5,99814730,99814818,H1|chr5:177591096-177591191,chr5,177591096,177591191,0,77776366
H1|chr5:99867118-99867182,chr5,99867118,99867182,H1|chr5:139024795-139024855,chr5,139024795,139024855,0,39157677
H1|chr5:99916357-99916505,chr5,99916357,99916505,H1|chr5:25441511-25441569,chr5,25441511,25441569,0,74474846
H1|chr5:100094352-100094502,chr5,100094352,100094502,H1|chr5:272212-272362,chr5,272212,272362,0,99822140
H1|chr5:100096326-100096411,chr5,100096326,100096411,H1|chr5:147247929-147247994,chr5,147247929,147247994,0,47151603
H1|chr5:100202074-100202167,chr5,100202074,100202167,H1|chr5:140703917-140703934,chr5,140703917,140703934,0,40501843
H1|chr5:100283565-100283639,chr5,100283565,100283639,H1|chr5:7395857-7395880,chr5,7395857,7395880,0,92887708
H1|chr5:100336119-100336253,chr5,100336119,100336253,H1|chr5:147251545-147251648,chr5,147251545,147251648,0,46915426
H1|chr5:100713878-100713941,chr5,100713878,100713941,H1|chr5:147251574-147251657,chr5,147251574,147251657,0,46537696
H1|chr5:101131548-101131611,chr5,101131548,101131611,H1|chr5:171438171-171438301,chr5,171438171,171438301,0,70306623
H1|chr5:101150665-101150685,chr5,101150665,101150685,H1|chr5:141701844-141701994,chr5,141701844,141701994,0,40551179
H1|chr5:101300902-101301018,chr5,101300902,101301018,H1|chr5:6377681-6377710,chr5,6377681,6377710,0,94923221
H1|chr5:101813771-101813862,chr5,101813771,101813862,H1|chr5:154089208-154089285,chr5,154089208,154089285,0,52275437
H1|chr5:102008353-102008408,chr5,102008353,102008408,H1|chr5:171883926-171883951,chr5,171883926,171883951,0,69875573
H1|chr5:102118341-102118435,chr5,102118341,102118435,H1|chr5:27474625-27474660,chr5,27474625,27474660,0,74643716
H1|chr5:102362302-102362447,chr5,102362302,102362447,H1|chr5:692751-692898,chr5,692751,692898,0,101669551
H1|chr5:102549867-102549966,chr5,102549867,102549966,H1|chr5:140787299-140787359,chr5,140787299,140787359,0,38237432
H1|chr5:103254199-103254290,chr5,103254199,103254290,H1|chr5:154089208-154089285,chr5,154089208,154089285,0,50835009
H1|chr5:103445442-103445480,chr5,103445442,103445480,H1|chr5:25443192-25443221,chr5,25443192,25443221,0,78002250
H1|chr5:103573747-103573773,chr5,103573747,103573773,H1|chr5:147249959-147250019,chr5,147249959,147250019,0,43676212
H1|chr5:103642833-103642872,chr5,103642833,103642872,H1|chr5:154137447-154137551,chr5,154137447,154137551,0,50494614
H1|chr5:103724063-103724131,chr5,103724063,103724131,H1|chr5:150828241-150828350,chr5,150828241,150828350,0,47104178
H1|chr5:104625126-104625273,chr5,104625126,104625273,H1|chr5:175628380-175628529,chr5,175628380,175628529,0,71003254
H1|chr5:104678071-104678115,chr5,104678071,104678115,H1|chr5:147249866-147249916,chr5,147249866,147249916,0,42571795
H1|chr5:104992663-104992726,chr5,104992663,104992726,H1|chr5:27475222-27475306,chr5,27475222,27475306,0,77517441
H1|chr5:105020568-105020641,chr5,105020568,105020641,H1|chr5:154089208-154089285,chr5,154089208,154089285,0,49068640
H1|chr5:105089003-105089060,chr5,105089003,105089060,H1|chr5:154088183-154088278,chr5,154088183,154088278,0,48999180
H1|chr5:105154810-105154871,chr5,105154810,105154871,H1|chr5:179249277-179249412,chr5,179249277,179249412,0,74094467
H1|chr5:105255007-105255040,chr5,105255007,105255040,H1|chr5:147250776-147250900,chr5,147250776,147250900,0,41995769
H1|chr5:105476834-105476875,chr5,105476834,105476875,H1|chr5:16736242-16736335,chr5,16736242,16736335,0,88740592
H1|chr5:105607379-105607431,chr5,105607379,105607431,H1|chr5:7395857-7395880,chr5,7395857,7395880,0,98211522
H1|chr5:106160309-106160371,chr5,106160309,106160371,H1|chr5:72145050-72145116,chr5,72145050,72145116,0,34015259
H1|chr5:107041725-107041754,chr5,107041725,107041754,H1|chr5:613267-613305,chr5,613267,613305,0,106428458
H1|chr5:107209634-107209680,chr5,107209634,107209680,H1|chr5:177591071-177591191,chr5,177591071,177591191,0,70381437
H1|chr5:107365336-107365371,chr5,107365336,107365371,H1|chr5:147247351-147247458,chr5,147247351,147247458,0,39882015
H1|chr5:107553170-107553264,chr5,107553170,107553264,H1|chr5:27474625-27474660,chr5,27474625,27474660,0,80078545
H1|chr5:107573745-107573891,chr5,107573745,107573891,H1|chr5:118788512-118788569,chr5,118788512,118788569,0,11214767
H1|chr5:107616581-107616623,chr5,107616581,107616623,H1|chr5:6449548-6449565,chr5,6449548,6449565,0,101167033
H1|chr5:107727298-107727395,chr5,107727298,107727395,H1|chr5:177591141-177591191,chr5,177591141,177591191,0,69863843
H1|chr5:107842133-107842283,chr5,107842133,107842283,H1|chr5:694346-694382,chr5,694346,694382,0,107147787
H1|chr5:108053870-108053969,chr5,108053870,108053969,H1|chr5:692841-692921,chr5,692841,692921,0,107361029
H1|chr5:108182737-108182812,chr5,108182737,108182812,H1|chr5:147251446-147251487,chr5,147251446,147251487,0,39068709
H1|chr5:109003490-109003565,chr5,109003490,109003565,H1|chr5:25443565-25443638,chr5,25443565,25443638,0,83559925
H1|chr5:109194059-109194209,chr5,109194059,109194209,H1|chr5:147248118-147248163,chr5,147248118,147248163,0,38054059
H1|chr5:109790598-109790643,chr5,109790598,109790643,H1|chr5:147246417-147246504,chr5,147246417,147246504,0,37455819
H1|chr5:109840214-109840308,chr5,109840214,109840308,H1|chr5:154091860-154091903,chr5,154091860,154091903,0,44251646
H1|chr5:110310396-110310470,chr5,110310396,110310470,H1|chr5:7395857-7395880,chr5,7395857,7395880,0,102914539
H1|chr5:110330903-110330951,chr5,110330903,110330951,H1|chr5:147251304-147251406,chr5,147251304,147251406,0,36920401
H1|chr5:110375868-110375912,chr5,110375868,110375912,H1|chr5:54829466-54829520,chr5,54829466,54829520,0,55546402
H1|chr5:110487293-110487377,chr5,110487293,110487377,H1|chr5:175627665-175627813,chr5,175627665,175627813,0,65140372
H1|chr5:110584472-110584575,chr5,110584472,110584575,H1|chr5:177591159-177591191,chr5,177591159,177591191,0,67006687
H1|chr5:110666290-110666310,chr5,110666290,110666310,H1|chr5:141256781-141256802,chr5,141256781,141256802,0,30590491
H1|chr5:110831204-110831240,chr5,110831204,110831240,H1|chr5:147246048-147246159,chr5,147246048,147246159,0,36414844
H1|chr5:110837582-110837698,chr5,110837582,110837698,H1|chr5:147250704-147250854,chr5,147250704,147250854,0,36413122
H1|chr5:110894897-110894925,chr5,110894897,110894925,H1|chr5:147249292-147249378,chr5,147249292,147249378,0,36354395
H1|chr5:111449281-111449307,chr5,111449281,111449307,H1|chr5:147245790-147245864,chr5,147245790,147245864,0,35796509
H1|chr5:111504699-111504847,chr5,111504699,111504847,H1|chr5:147252211-147252361,chr5,147252211,147252361,0,35747512
H1|chr5:111664573-111664717,chr5,111664573,111664717,H1|chr5:693735-693880,chr5,693735,693880,0,110970838
H1|chr5:111978655-111978712,chr5,111978655,111978712,H1|chr5:25442144-25442237,chr5,25442144,25442237,0,86536511
H1|chr5:112408440-112408531,chr5,112408440,112408531,H1|chr5:25441120-25441245,chr5,25441120,25441245,0,86967320
H1|chr5:112579036-112579148,chr5,112579036,112579148,H1|chr5:147252632-147252670,chr5,147252632,147252670,0,34673596
H1|chr5:112861247-112861394,chr5,112861247,112861394,H1|chr5:693919-694066,chr5,693919,694066,0,112167328
H1|chr5:112981234-112981307,chr5,112981234,112981307,H1|chr5:56472516-56472567,chr5,56472516,56472567,0,56508718
H1|chr5:114235181-114235274,chr5,114235181,114235274,H1|chr5:140703917-140703934,chr5,140703917,140703934,0,26468736
H1|chr5:114635346-114635396,chr5,114635346,114635396,H1|chr5:147249892-147249926,chr5,147249892,147249926,0,32614546
H1|chr5:114834673-114834699,chr5,114834673,114834699,H1|chr5:147250130-147250280,chr5,147250130,147250280,0,32415457
H1|chr5:115054887-115054938,chr5,115054887,115054938,H1|chr5:25443512-25443567,chr5,25443512,25443567,0,89611375
H1|chr5:115115882-115115972,chr5,115115882,115115972,H1|chr5:140787299-140787359,chr5,140787299,140787359,0,25671417
H1|chr5:115162704-115162810,chr5,115162704,115162810,H1|chr5:147252837-147252904,chr5,147252837,147252904,0,32090133
H1|chr5:115210758-115210805,chr5,115210758,115210805,H1|chr5:146829777-146829897,chr5,146829777,146829897,0,31619019
H1|chr5:115325761-115325817,chr5,115325761,115325817,H1|chr5:25442186-25442238,chr5,25442186,25442238,0,89883575
H1|chr5:115408528-115408644,chr5,115408528,115408644,H1|chr5:147247254-147247317,chr5,147247254,147247317,0,31838726
H1|chr5:115658536-115658621,chr5,115658536,115658621,H1|chr5:697312-697372,chr5,697312,697372,0,114961224
H1|chr5:115754694-115754715,chr5,115754694,115754715,H1|chr5:25441120-25441245,chr5,25441120,25441245,0,90313574
H1|chr5:115767465-115767537,chr5,115767465,115767537,H1|chr5:175961392-175961446,chr5,175961392,175961446,0,60193927
H1|chr5:115807298-115807316,chr5,115807298,115807316,H1|chr5:146829777-146829897,chr5,146829777,146829897,0,31022479
H1|chr5:116232436-116232494,chr5,116232436,116232494,H1|chr5:147250720-147250857,chr5,147250720,147250857,0,31018284
H1|chr5:117074289-117074410,chr5,117074289,117074410,H1|chr5:6377681-6377710,chr5,6377681,6377710,0,110696608
H1|chr5:117297234-117297260,chr5,117297234,117297260,H1|chr5:141255464-141255546,chr5,141255464,141255546,0,23958230
H1|chr5:117487747-117487847,chr5,117487747,117487847,H1|chr5:177591141-177591191,chr5,177591141,177591191,0,60103394
H1|chr5:117633431-117633481,chr5,117633431,117633481,H1|chr5:25443632-25443710,chr5,25443632,25443710,0,92189799
H1|chr5:117747334-117747420,chr5,117747334,117747420,H1|chr5:102089032-102089100,chr5,102089032,102089100,0,15658302
H1|chr5:117984886-117984976,chr5,117984886,117984976,H1|chr5:147247929-147247994,chr5,147247929,147247994,0,29263043
H1|chr5:118103937-118104023,chr5,118103937,118104023,H1|chr5:102089032-102089100,chr5,102089032,102089100,0,16014905
H1|chr5:118191275-118191327,chr5,118191275,118191327,H1|chr5:7395857-7395880,chr5,7395857,7395880,0,110795418
H1|chr5:118462775-118462870,chr5,118462775,118462870,H1|chr5:697444-697594,chr5,697444,697594,0,117765331
H1|chr5:119319592-119319698,chr5,119319592,119319698,H1|chr5:177627397-177627417,chr5,177627397,177627417,0,58307805
H1|chr5:119330748-119330843,chr5,119330748,119330843,H1|chr5:69344437-69344556,chr5,69344437,69344556,0,49986311
H1|chr5:120113832-120113981,chr5,120113832,120113981,H1|chr5:175627719-175627823,chr5,175627719,175627823,0,55513887
H1|chr5:120522581-120522656,chr5,120522581,120522656,H1|chr5:25443873-25443948,chr5,25443873,25443948,0,95078708
H1|chr5:120706174-120706271,chr5,120706174,120706271,H1|chr5:79550716-79550769,chr5,79550716,79550769,0,41155458
H1|chr5:120734045-120734120,chr5,120734045,120734120,H1|chr5:25443615-25443690,chr5,25443615,25443690,0,95290430
H1|chr5:120792953-120793101,chr5,120792953,120793101,H1|chr5:697474-697624,chr5,697474,697624,0,120095479
H1|chr5:121050678-121050828,chr5,121050678,121050828,H1|chr5:175627658-175627804,chr5,175627658,175627804,0,54576980
H1|chr5:121487442-121487484,chr5,121487442,121487484,H1|chr5:6449548-6449565,chr5,6449548,6449565,0,115037894
H1|chr5:121731107-121731208,chr5,121731107,121731208,H1|chr5:56472359-56472408,chr5,56472359,56472408,0,65258748
H1|chr5:121938408-121938522,chr5,121938408,121938522,H1|chr5:147252632-147252670,chr5,147252632,147252670,0,25314224
H1|chr5:123135749-123135839,chr5,123135749,123135839,H1|chr5:25443634-25443691,chr5,25443634,25443691,0,97692115
H1|chr5:123732127-123732273,chr5,123732127,123732273,H1|chr5:141734992-141735038,chr5,141734992,141735038,0,18002865
H1|chr5:123984588-123984653,chr5,123984588,123984653,H1|chr5:147246758-147246886,chr5,147246758,147246886,0,23262170
H1|chr5:124565150-124565216,chr5,124565150,124565216,H1|chr5:175626627-175626678,chr5,175626627,175626678,0,51061477
H1|chr5:124636580-124636689,chr5,124636580,124636689,H1|chr5:141706916-141706957,chr5,141706916,141706957,0,17070336
H1|chr5:125182378-125182468,chr5,125182378,125182468,H1|chr5:27475222-27475306,chr5,27475222,27475306,0,97707156
H1|chr5:125198749-125198796,chr5,125198749,125198796,H1|chr5:141735174-141735229,chr5,141735174,141735229,0,16536425
H1|chr5:125723987-125724045,chr5,125723987,125724045,H1|chr5:177591103-177591191,chr5,177591103,177591191,0,51867116
H1|chr5:125727418-125727471,chr5,125727418,125727471,H1|chr5:56472636-56472763,chr5,56472636,56472763,0,69254782
H1|chr5:125908962-125909112,chr5,125908962,125909112,H1|chr5:138631715-138631775,chr5,138631715,138631775,0,12722753
H1|chr5:126020248-126020302,chr5,126020248,126020302,H1|chr5:141703223-141703319,chr5,141703223,141703319,0,15682975
H1|chr5:126131139-126131213,chr5,126131139,126131213,H1|chr5:697716-697774,chr5,697716,697774,0,125433423
H1|chr5:126211796-126211888,chr5,126211796,126211888,H1|chr5:118788512-118788569,chr5,118788512,118788569,0,7423284
H1|chr5:126281474-126281531,chr5,126281474,126281531,H1|chr5:171438337-171438460,chr5,171438337,171438460,0,45156863
H1|chr5:126294876-126294908,chr5,126294876,126294908,H1|chr5:170815976-170816094,chr5,170815976,170816094,0,44521100
H1|chr5:126422605-126422686,chr5,126422605,126422686,H1|chr5:154136215-154136315,chr5,154136215,154136315,0,27713610
H1|chr5:126455513-126455559,chr5,126455513,126455559,H1|chr5:141735174-141735229,chr5,141735174,141735229,0,15279661
H1|chr5:126774954-126775029,chr5,126774954,126775029,H1|chr5:34658434-34658509,chr5,34658434,34658509,0,92116520
H1|chr5:126784827-126784866,chr5,126784827,126784866,H1|chr5:147251545-147251648,chr5,147251545,147251648,0,20466718
H1|chr5:126820925-126820974,chr5,126820925,126820974,H1|chr5:154136446-154136521,chr5,154136446,154136521,0,27315521
H1|chr5:127101532-127101605,chr5,127101532,127101605,H1|chr5:154089208-154089285,chr5,154089208,154089285,0,26987676
H1|chr5:127253477-127253627,chr5,127253477,127253627,H1|chr5:154099675-154099755,chr5,154099675,154099755,0,26846198
H1|chr5:127408348-127408498,chr5,127408348,127408498,H1|chr5:176738057-176738109,chr5,176738057,176738109,0,49329709
H1|chr5:127742025-127742065,chr5,127742025,127742065,H1|chr5:175961392-175961446,chr5,175961392,175961446,0,48219367
H1|chr5:128190676-128190704,chr5,128190676,128190704,H1|chr5:147247947-147248044,chr5,147247947,147248044,0,19057271
H1|chr5:128355321-128355423,chr5,128355321,128355423,H1|chr5:25444748-25444794,chr5,25444748,25444794,0,102910573
H1|chr5:128936855-128936946,chr5,128936855,128936946,H1|chr5:74160926-74160965,chr5,74160926,74160965,0,54775929
H1|chr5:129001839-129001856,chr5,129001839,129001856,H1|chr5:141700556-141700668,chr5,141700556,141700668,0,12698717
H1|chr5:129283800-129283836,chr5,129283800,129283836,H1|chr5:176739542-176739627,chr5,176739542,176739627,0,47455742
H1|chr5:129332573-129332630,chr5,129332573,129332630,H1|chr5:697302-697372,chr5,697302,697372,0,128635271
H1|chr5:129460239-129460326,chr5,129460239,129460326,H1|chr5:175627757-175627902,chr5,175627757,175627902,0,46167518
H1|chr5:129513909-129513970,chr5,129513909,129513970,H1|chr5:147252296-147252378,chr5,147252296,147252378,0,17738387
H1|chr5:130233819-130233843,chr5,130233819,130233843,H1|chr5:176872823-176872917,chr5,176872823,176872917,0,46639004
H1|chr5:130361369-130361517,chr5,130361369,130361517,H1|chr5:697474-697624,chr5,697474,697624,0,129663895
H1|chr5:130799660-130799751,chr5,130799660,130799751,H1|chr5:697715-697774,chr5,697715,697774,0,130101945
H1|chr5:130847027-130847097,chr5,130847027,130847097,H1|chr5:147248294-147248335,chr5,147248294,147248335,0,16401267
H1|chr5:131685908-131685972,chr5,131685908,131685972,H1|chr5:16741139-16741189,chr5,16741139,16741189,0,114944769
H1|chr5:132690101-132690185,chr5,132690101,132690185,H1|chr5:7395320-7395386,chr5,7395320,7395386,0,125294781
H1|chr5:132856810-132856866,chr5,132856810,132856866,H1|chr5:25442186-25442238,chr5,25442186,25442238,0,107414624
H1|chr5:133222629-133222652,chr5,133222629,133222652,H1|chr5:141704272-141704396,chr5,141704272,141704396,0,8481643
H1|chr5:133262906-133262951,chr5,133262906,133262951,H1|chr5:147249877-147249923,chr5,147249877,147249923,0,13986971
H1|chr5:133358180-133358323,chr5,133358180,133358323,H1|chr5:175627755-175627905,chr5,175627755,175627905,0,42269575
H1|chr5:133516363-133516454,chr5,133516363,133516454,H1|chr5:154088633-154088700,chr5,154088633,154088700,0,20572270
H1|chr5:133567641-133567667,chr5,133567641,133567667,H1|chr5:141258170-141258260,chr5,141258170,141258260,0,7690529
H1|chr5:134237656-134237806,chr5,134237656,134237806,H1|chr5:154099675-154099755,chr5,154099675,154099755,0,19862019
H1|chr5:134428402-134428551,chr5,134428402,134428551,H1|chr5:175627663-175627797,chr5,175627663,175627797,0,41199261
H1|chr5:134928619-134928642,chr5,134928619,134928642,H1|chr5:177627843-177627979,chr5,177627843,177627979,0,42699224
H1|chr5:135031496-135031561,chr5,135031496,135031561,H1|chr5:94890201-94890233,chr5,94890201,94890233,0,40141295
H1|chr5:135428904-135428996,chr5,135428904,135428996,H1|chr5:118788512-118788569,chr5,118788512,118788569,0,16640392
H1|chr5:135536089-135536157,chr5,135536089,135536157,H1|chr5:175628458-175628550,chr5,175628458,175628550,0,40092369
H1|chr5:135638345-135638386,chr5,135638345,135638386,H1|chr5:147248686-147248773,chr5,147248686,147248773,0,11610341
H1|chr5:135663497-135663563,chr5,135663497,135663563,H1|chr5:147250372-147250497,chr5,147250372,147250497,0,11586875
H1|chr5:135965575-135965612,chr5,135965575,135965612,H1|chr5:147249787-147249896,chr5,147249787,147249896,0,11284212
H1|chr5:136169103-136169155,chr5,136169103,136169155,H1|chr5:147252464-147252559,chr5,147252464,147252559,0,11083361
H1|chr5:137067853-137067910,chr5,137067853,137067910,H1|chr5:697302-697372,chr5,697302,697372,0,136370551
H1|chr5:137193613-137193718,chr5,137193613,137193718,H1|chr5:154134201-154134241,chr5,154134201,154134241,0,16940588
H1|chr5:137236338-137236421,chr5,137236338,137236421,H1|chr5:177591158-177591191,chr5,177591158,177591191,0,40354820
H1|chr5:137331333-137331384,chr5,137331333,137331384,H1|chr5:147247351-147247458,chr5,147247351,147247458,0,9916018
H1|chr5:137386583-137386603,chr5,137386583,137386603,H1|chr5:177591061-177591191,chr5,177591061,177591191,0,40204478
H1|chr5:137431771-137431880,chr5,137431771,137431880,H1|chr5:141703115-141703155,chr5,141703115,141703155,0,4271344
H1|chr5:137649293-137649442,chr5,137649293,137649442,H1|chr5:175627663-175627797,chr5,175627663,175627797,0,37978370
H1|chr5:137840148-137840225,chr5,137840148,137840225,H1|chr5:147248020-147248099,chr5,147248020,147248099,0,9407872
H1|chr5:137904115-137904200,chr5,137904115,137904200,H1|chr5:102088843-102088905,chr5,102088843,102088905,0,35815272
H1|chr5:138146550-138146574,chr5,138146550,138146574,H1|chr5:176872823-176872917,chr5,176872823,176872917,0,38726273
H1|chr5:138203418-138203493,chr5,138203418,138203493,H1|chr5:34658434-34658509,chr5,34658434,34658509,0,103544984
H1|chr5:138249993-138250056,chr5,138249993,138250056,H1|chr5:147249761-147249871,chr5,147249761,147249871,0,8999768
H1|chr5:138449410-138449454,chr5,138449410,138449454,H1|chr5:54829466-54829520,chr5,54829466,54829520,0,83619944
H1|chr5:138865694-138865814,chr5,138865694,138865814,H1|chr5:140765328-140765358,chr5,140765328,140765358,0,1899634
H1|chr5:140685927-140685958,chr5,140685927,140685958,H1|chr5:147161087-147161122,chr5,147161087,147161122,0,6475160
H1|chr5:141275516-141275559,chr5,141275516,141275559,H1|chr5:154137461-154137551,chr5,154137461,154137551,0,12861945
H1|chr5:141339560-141339710,chr5,141339560,141339710,H1|chr5:147250990-147251090,chr5,147250990,147251090,0,5911430
H1|chr5:141342854-141342943,chr5,141342854,141342943,H1|chr5:25441556-25441581,chr5,25441556,25441581,0,115901298
H1|chr5:141885870-141885965,chr5,141885870,141885965,H1|chr5:697444-697594,chr5,697444,697594,0,141188426
H1|chr5:141917466-141917572,chr5,141917466,141917572,H1|chr5:177627397-177627417,chr5,177627397,177627417,0,35709931
H1|chr5:142063905-142063933,chr5,142063905,142063933,H1|chr5:147247947-147248044,chr5,147247947,147248044,0,5184042
H1|chr5:142539823-142539888,chr5,142539823,142539888,H1|chr5:147246758-147246886,chr5,147246758,147246886,0,4706935
H1|chr5:142609278-142609423,chr5,142609278,142609423,H1|chr5:697441-697591,chr5,697441,697591,0,141911837
H1|chr5:142949255-142949284,chr5,142949255,142949284,H1|chr5:147251357-147251463,chr5,147251357,147251463,0,4302102
H1|chr5:142972542-142972635,chr5,142972542,142972635,H1|chr5:697715-697774,chr5,697715,697774,0,142274827
H1|chr5:143263304-143263372,chr5,143263304,143263372,H1|chr5:25443404-25443488,chr5,25443404,25443488,0,117819900
H1|chr5:143354850-143354940,chr5,143354850,143354940,H1|chr5:147252464-147252559,chr5,147252464,147252559,0,3897614
H1|chr5:143424764-143424866,chr5,143424764,143424866,H1|chr5:141255464-141255546,chr5,141255464,141255546,0,2169300
H1|chr5:143480924-143480985,chr5,143480924,143480985,H1|chr5:147249323-147249375,chr5,147249323,147249375,0,3768399
H1|chr5:143671882-143671938,chr5,143671882,143671938,H1|chr5:170815976-170816094,chr5,170815976,170816094,0,27144094
H1|chr5:143696153-143696192,chr5,143696153,143696192,H1|chr5:176740707-176740768,chr5,176740707,176740768,0,33044554
H1|chr5:143946584-143946625,chr5,143946584,143946625,H1|chr5:147248686-147248773,chr5,147248686,147248773,0,3302102
H1|chr5:144138819-144138863,chr5,144138819,144138863,H1|chr5:115907171-115907195,chr5,115907171,115907195,0,28231648
H1|chr5:144487194-144487297,chr5,144487194,144487297,H1|chr5:176902254-176902301,chr5,176902254,176902301,0,32415060
H1|chr5:144870777-144870806,chr5,144870777,144870806,H1|chr5:150828241-150828350,chr5,150828241,150828350,0,5957464
H1|chr5:144919293-144919384,chr5,144919293,144919384,H1|chr5:25441120-25441245,chr5,25441120,25441245,0,119478173
H1|chr5:145065969-145066033,chr5,145065969,145066033,H1|chr5:147247832-147247899,chr5,147247832,147247899,0,2181863
H1|chr5:145105566-145105589,chr5,145105566,145105589,H1|chr5:147252648-147252774,chr5,147252648,147252774,0,2147082
H1|chr5:145214644-145214671,chr5,145214644,145214671,H1|chr5:69344437-69344556,chr5,69344437,69344556,0,75870207
H1|chr5:145558590-145558695,chr5,145558590,145558695,H1|chr5:177591141-177591191,chr5,177591141,177591191,0,32032551
H1|chr5:145651915-145652002,chr5,145651915,145652002,H1|chr5:175627755-175627905,chr5,175627755,175627905,0,29975840
H1|chr5:146127009-146127126,chr5,146127009,146127126,H1|chr5:56472359-56472408,chr5,56472359,56472408,0,89654650
H1|chr5:146241620-146241721,chr5,146241620,146241721,H1|chr5:147247623-147247680,chr5,147247623,147247680,0,1006003
H1|chr5:146644779-146644854,chr5,146644779,146644854,H1|chr5:147251446-147251487,chr5,147251446,147251487,0,606667
H1|chr5:147100528-147100572,chr5,147100528,147100572,H1|chr5:147253396-147253466,chr5,147253396,147253466,0,152868
H1|chr5:147350173-147350202,chr5,147350173,147350202,H1|chr5:25443369-25443405,chr5,25443369,25443405,0,121906804
H1|chr5:147358568-147358684,chr5,147358568,147358684,H1|chr5:147250704-147250854,chr5,147250704,147250854,0,107864
H1|chr5:147947687-147947837,chr5,147947687,147947837,H1|chr5:138631715-138631775,chr5,138631715,138631775,0,9315972
H1|chr5:147981282-147981310,chr5,147981282,147981310,H1|chr5:147249292-147249378,chr5,147249292,147249378,0,731990
H1|chr5:148522554-148522624,chr5,148522554,148522624,H1|chr5:139026451-139026531,chr5,139026451,139026531,0,9496103
H1|chr5:148857758-148857776,chr5,148857758,148857776,H1|chr5:141700556-141700668,chr5,141700556,141700668,0,7157202
H1|chr5:148873202-148873289,chr5,148873202,148873289,H1|chr5:147247254-147247317,chr5,147247254,147247317,0,1625948
H1|chr5:149039792-149039815,chr5,149039792,149039815,H1|chr5:147252648-147252774,chr5,147252648,147252774,0,1787144
H1|chr5:149415285-149415333,chr5,149415285,149415333,H1|chr5:147252988-147253058,chr5,147252988,147253058,0,2162297
H1|chr5:149514952-149515095,chr5,149514952,149515095,H1|chr5:147252686-147252771,chr5,147252686,147252771,0,2262266
H1|chr5:149537431-149537455,chr5,149537431,149537455,H1|chr5:147247789-147247935,chr5,147247789,147247935,0,2289642
H1|chr5:149553922-149553998,chr5,149553922,149553998,H1|chr5:147251778-147251925,chr5,147251778,147251925,0,2302144
H1|chr5:149964602-149964680,chr5,149964602,149964680,H1|chr5:146829883-146829938,chr5,146829883,146829938,0,3134719
H1|chr5:149993446-149993486,chr5,149993446,149993486,H1|chr5:175961392-175961446,chr5,175961392,175961446,0,25967946
H1|chr5:150056276-150056317,chr5,150056276,150056317,H1|chr5:176740489-176740587,chr5,176740489,176740587,0,26684213
H1|chr5:150917983-150918057,chr5,150917983,150918057,H1|chr5:697716-697774,chr5,697716,697774,0,150220267
H1|chr5:151266197-151266266,chr5,151266197,151266266,H1|chr5:147246173-147246254,chr5,147246173,147246254,0,4020024
H1|chr5:153331843-153331924,chr5,153331843,153331924,H1|chr5:147251856-147251989,chr5,147251856,147251989,0,6079987
H1|chr5:153540170-153540215,chr5,153540170,153540215,H1|chr5:154137447-154137551,chr5,154137447,154137551,0,597277
H1|chr5:153686028-153686114,chr5,153686028,153686114,H1|chr5:147250040-147250063,chr5,147250040,147250063,0,6435988
H1|chr5:153748728-153748754,chr5,153748728,153748754,H1|chr5:147245790-147245864,chr5,147245790,147245864,0,6502938
H1|chr5:154329920-154330007,chr5,154329920,154330007,H1|chr5:171438026-171438089,chr5,171438026,171438089,0,17108106
H1|chr5:154787885-154787956,chr5,154787885,154787956,H1|chr5:25444515-25444550,chr5,25444515,25444550,0,129343370
H1|chr5:155110581-155110731,chr5,155110581,155110731,H1|chr5:175221740-175221831,chr5,175221740,175221831,0,20111159
H1|chr5:155121572-155121601,chr5,155121572,155121601,H1|chr5:147251357-147251463,chr5,147251357,147251463,0,7870215
H1|chr5:155218745-155218860,chr5,155218745,155218860,H1|chr5:154134201-154134307,chr5,154134201,154134307,0,1084544
H1|chr5:155467337-155467413,chr5,155467337,155467413,H1|chr5:147252287-147252358,chr5,147252287,147252358,0,8215050
H1|chr5:155880605-155880719,chr5,155880605,155880719,H1|chr5:176902254-176902301,chr5,176902254,176902301,0,21021649
H1|chr5:156042944-156042992,chr5,156042944,156042992,H1|chr5:147252988-147253058,chr5,147252988,147253058,0,8789956
H1|chr5:156451738-156451831,chr5,156451738,156451831,H1|chr5:147247623-147247680,chr5,147247623,147247680,0,9204115
H1|chr5:156460434-156460519,chr5,156460434,156460519,H1|chr5:141061008-141061040,chr5,141061008,141061040,0,15399426
H1|chr5:156556880-156556913,chr5,156556880,156556913,H1|chr5:147248450-147248600,chr5,147248450,147248600,0,9308430
H1|chr5:156565002-156565028,chr5,156565002,156565028,H1|chr5:16737932-16737966,chr5,16737932,16737966,0,139827070
H1|chr5:156693964-156694114,chr5,156693964,156694114,H1|chr5:694346-694382,chr5,694346,694382,0,155999618
H1|chr5:156892343-156892366,chr5,156892343,156892366,H1|chr5:177627843-177627979,chr5,177627843,177627979,0,20735500
H1|chr5:156900802-156900952,chr5,156900802,156900952,H1|chr5:147252990-147253025,chr5,147252990,147253025,0,9647812
H1|chr5:157041713-157041837,chr5,157041713,157041837,H1|chr5:6377681-6377710,chr5,6377681,6377710,0,150664032
H1|chr5:157616092-157616187,chr5,157616092,157616187,H1|chr5:154087532-154087578,chr5,154087532,154087578,0,3528560
H1|chr5:158162656-158162724,chr5,158162656,158162724,H1|chr5:141734320-141734380,chr5,141734320,141734380,0,16428336
H1|chr5:158490958-158490986,chr5,158490958,158490986,H1|chr5:147251357-147251463,chr5,147251357,147251463,0,11239601
H1|chr5:158799456-158799485,chr5,158799456,158799485,H1|chr5:150828241-150828350,chr5,150828241,150828350,0,7971215
H1|chr5:158882410-158882475,chr5,158882410,158882475,H1|chr5:141702495-141702567,chr5,141702495,141702567,0,17179915
H1|chr5:158902294-158902410,chr5,158902294,158902410,H1|chr5:6377681-6377710,chr5,6377681,6377710,0,152524613
H1|chr5:159644210-159644235,chr5,159644210,159644235,H1|chr5:147245790-147245864,chr5,147245790,147245864,0,12398420
H1|chr5:159921012-159921095,chr5,159921012,159921095,H1|chr5:147250348-147250483,chr5,147250348,147250483,0,12670664
H1|chr5:160315942-160315965,chr5,160315942,160315965,H1|chr5:177663779-177663892,chr5,177663779,177663892,0,17347837
H1|chr5:160434749-160434778,chr5,160434749,160434778,H1|chr5:25443369-25443405,chr5,25443369,25443405,0,134991380
H1|chr5:160690594-160690742,chr5,160690594,160690742,H1|chr5:147252211-147252361,chr5,147252211,147252361,0,13438383
H1|chr5:160790626-160790664,chr5,160790626,160790664,H1|chr5:176740707-176740736,chr5,176740707,176740736,0,15950081
H1|chr5:161942314-161942377,chr5,161942314,161942377,H1|chr5:171436153-171436214,chr5,171436153,171436214,0,9493839
H1|chr5:161992508-161992549,chr5,161992508,161992549,H1|chr5:124081199-124081273,chr5,124081199,124081273,0,37911309
H1|chr5:162116922-162117072,chr5,162116922,162117072,H1|chr5:76787138-76787272,chr5,76787138,76787272,0,85329784
H1|chr5:162255685-162255740,chr5,162255685,162255740,H1|chr5:177591096-177591191,chr5,177591096,177591191,0,15335411
H1|chr5:162426300-162426401,chr5,162426300,162426401,H1|chr5:147247623-147247680,chr5,147247623,147247680,0,15178677
H1|chr5:162658480-162658524,chr5,162658480,162658524,H1|chr5:154134201-154134307,chr5,154134201,154134307,0,8524279
H1|chr5:162848269-162848337,chr5,162848269,162848337,H1|chr5:175628458-175628550,chr5,175628458,175628550,0,12780189
H1|chr5:163010635-163010665,chr5,163010635,163010665,H1|chr5:107007596-107007670,chr5,107007596,107007670,0,56003039
H1|chr5:163216827-163216910,chr5,163216827,163216910,H1|chr5:55290-55314,chr5,55290,55314,0,163161537
H1|chr5:163279537-163279600,chr5,163279537,163279600,H1|chr5:27475222-27475306,chr5,27475222,27475306,0,135804315
H1|chr5:163594526-163594631,chr5,163594526,163594631,H1|chr5:147248118-147248163,chr5,147248118,147248163,0,16346408
H1|chr5:163797164-163797184,chr5,163797164,163797184,H1|chr5:177591061-177591191,chr5,177591061,177591191,0,13793897
H1|chr5:163987974-163988053,chr5,163987974,163988053,H1|chr5:147250945-147250972,chr5,147250945,147250972,0,16737029
H1|chr5:164004598-164004688,chr5,164004598,164004688,H1|chr5:79550716-79550769,chr5,79550716,79550769,0,84453882
H1|chr5:164062712-164062738,chr5,164062712,164062738,H1|chr5:175631346-175631465,chr5,175631346,175631465,0,11568634
H1|chr5:164331733-164331817,chr5,164331733,164331817,H1|chr5:175627665-175627813,chr5,175627665,175627813,0,11295932
H1|chr5:164351287-164351321,chr5,164351287,164351321,H1|chr5:696321-696419,chr5,696321,696419,0,163654966
H1|chr5:164518085-164518120,chr5,164518085,164518120,H1|chr5:76787180-76787277,chr5,76787180,76787277,0,87730905
H1|chr5:164824553-164824593,chr5,164824553,164824593,H1|chr5:694518-694570,chr5,694518,694570,0,164130035
H1|chr5:164985896-164986046,chr5,164985896,164986046,H1|chr5:697471-697621,chr5,697471,697621,0,164288425
H1|chr5:165219408-165219533,chr5,165219408,165219533,H1|chr5:147246111-147246136,chr5,147246111,147246136,0,17973297
H1|chr5:165321401-165321449,chr5,165321401,165321449,H1|chr5:147247238-147247294,chr5,147247238,147247294,0,18074163
H1|chr5:165353668-165353792,chr5,165353668,165353792,H1|chr5:107007596-107007670,chr5,107007596,107007670,0,58346072
H1|chr5:165886244-165886346,chr5,165886244,165886346,H1|chr5:147247758-147247829,chr5,147247758,147247829,0,18638486
H1|chr5:166600690-166600741,chr5,166600690,166600741,H1|chr5:175221729-175221879,chr5,175221729,175221879,0,8621039
H1|chr5:167021895-167021923,chr5,167021895,167021923,H1|chr5:25442250-25442280,chr5,25442250,25442280,0,141579645
H1|chr5:167284380-167284444,chr5,167284380,167284444,H1|chr5:16741139-16741189,chr5,16741139,16741189,0,150543241
H1|chr5:168018001-168018024,chr5,168018001,168018024,H1|chr5:141704272-141704396,chr5,141704272,141704396,0,26313729
H1|chr5:168449425-168449489,chr5,168449425,168449489,H1|chr5:154099526-154099585,chr5,154099526,154099585,0,14349899
H1|chr5:168606008-168606034,chr5,168606008,168606034,H1|chr5:16737932-16737966,chr5,16737932,16737966,0,151868076
H1|chr5:168622653-168622710,chr5,168622653,168622710,H1|chr5:171883926-171883951,chr5,171883926,171883951,0,3261273
H1|chr5:169069081-169069160,chr5,169069081,169069160,H1|chr5:147247758-147247829,chr5,147247758,147247829,0,21821323
H1|chr5:169116926-169117046,chr5,169116926,169117046,H1|chr5:140765328-140765358,chr5,140765328,140765358,0,28351598
H1|chr5:169331264-169331333,chr5,169331264,169331333,H1|chr5:141734320-141734380,chr5,141734320,141734380,0,27596944
H1|chr5:169366738-169366785,chr5,169366738,169366785,H1|chr5:146829777-146829897,chr5,146829777,146829897,0,22536961
H1|chr5:170070430-170070526,chr5,170070430,170070526,H1|chr5:147253526-147253573,chr5,147253526,147253573,0,22816904
H1|chr5:170179262-170179387,chr5,170179262,170179387,H1|chr5:141703223-141703319,chr5,141703223,141703319,0,28476039
H1|chr5:170281493-170281573,chr5,170281493,170281573,H1|chr5:175627037-175627107,chr5,175627037,175627107,0,5345544
H1|chr5:170331579-170331633,chr5,170331579,170331633,H1|chr5:147252691-147252785,chr5,147252691,147252785,0,23078888
H1|chr5:170550797-170550824,chr5,170550797,170550824,H1|chr5:69344437-69344556,chr5,69344437,69344556,0,101206360
H1|chr5:170559815-170559857,chr5,170559815,170559857,H1|chr5:147251508-147251616,chr5,147251508,147251616,0,23308307
H1|chr5:170847505-170847655,chr5,170847505,170847655,H1|chr5:272436-272586,chr5,272436,272586,0,170575069
H1|chr5:170955097-170955166,chr5,170955097,170955166,H1|chr5:141734320-141734380,chr5,141734320,141734380,0,29220777
H1|chr5:171421484-171421522,chr5,171421484,171421522,H1|chr5:25443192-25443221,chr5,25443192,25443221,0,145978292
H1|chr5:172367718-172367746,chr5,172367718,172367746,H1|chr5:154090040-154090138,chr5,154090040,154090138,0,18277678
H1|chr5:172586700-172586745,chr5,172586700,172586745,H1|chr5:154091974-154092056,chr5,154091974,154092056,0,18494726
H1|chr5:173067855-173067872,chr5,173067855,173067872,H1|chr5:107007767-107007910,chr5,107007767,107007910,0,66060088
H1|chr5:173286009-173286040,chr5,173286009,173286040,H1|chr5:147161087-147161122,chr5,147161087,147161122,0,26124922
H1|chr5:173551898-173551974,chr5,173551898,173551974,H1|chr5:147252287-147252358,chr5,147252287,147252358,0,26299611
H1|chr5:173740252-173740388,chr5,173740252,173740388,H1|chr5:175627753-175627899,chr5,175627753,175627899,0,1887501
H1|chr5:175240199-175240250,chr5,175240199,175240250,H1|chr5:147247351-147247458,chr5,147247351,147247458,0,27992848
H1|chr5:175928173-175928217,chr5,175928173,175928217,H1|chr5:115907171-115907195,chr5,115907171,115907195,0,60021002
H1|chr5:176004086-176004157,chr5,176004086,176004157,H1|chr5:147248020-147248099,chr5,147248020,147248099,0,28756066
H1|chr5:176006639-176006709,chr5,176006639,176006709,H1|chr5:147251446-147251487,chr5,147251446,147251487,0,28755193
H1|chr5:176091553-176091640,chr5,176091553,176091640,H1|chr5:171438026-171438089,chr5,171438026,171438089,0,4653527
H1|chr5:176176119-176176228,chr5,176176119,176176228,H1|chr5:141703115-141703155,chr5,141703115,141703155,0,34473004
H1|chr5:176208740-176208834,chr5,176208740,176208834,H1|chr5:154091398-154091510,chr5,154091398,154091510,0,22117342
H1|chr5:176553074-176553113,chr5,176553074,176553113,H1|chr5:154137447-154137551,chr5,154137447,154137551,0,22415627
H1|chr5:176640085-176640129,chr5,176640085,176640129,H1|chr5:147249866-147249916,chr5,147249866,147249916,0,29390219
H1|chr5:177464252-177464334,chr5,177464252,177464334,H1|chr5:147252464-147252610,chr5,147252464,147252610,0,30211788
H1|chr5:178010295-178010439,chr5,178010295,178010439,H1|chr5:34658434-34658509,chr5,34658434,34658509,0,143351861
H1|chr5:178441316-178441348,chr5,178441316,178441348,H1|chr5:7393104-7393203,chr5,7393104,7393203,0,171048212
H1|chr5:178448235-178448325,chr5,178448235,178448325,H1|chr5:25443634-25443691,chr5,25443634,25443691,0,153004601
H1|chr5:178450354-178450457,chr5,178450354,178450457,H1|chr5:147253526-147253573,chr5,147253526,147253573,0,31196828
H1|chr5:178554990-178555015,chr5,178554990,178555015,H1|chr5:72411424-72411574,chr5,72411424,72411574,0,106143566
H1|chr5:178737350-178737396,chr5,178737350,178737396,H1|chr5:171435172-171435248,chr5,171435172,171435248,0,7302178
H1|chr5:179298071-179298174,chr5,179298071,179298174,H1|chr5:176902254-176902301,chr5,176902254,176902301,0,2395817
H1|chr5:179582813-179582856,chr5,179582813,179582856,H1|chr5:154137461-154137551,chr5,154137461,154137551,0,25445352
H1|chr5:179699079-179699164,chr5,179699079,179699164,H1|chr5:102088843-102088905,chr5,102088843,102088905,0,77610236
H1|chr5:180211011-180211104,chr5,180211011,180211104,H1|chr5:147247623-147247680,chr5,147247623,147247680,0,32963388
H1|chr5:180243249-180243275,chr5,180243249,180243275,H1|chr5:147249959-147250019,chr5,147249959,147250019,0,32993290
H1|chr6:359063-359138,chr6,359063,359138,H1|chr6:151716420-151716495,chr6,151716420,151716495,0,151357357
H1|chr6:666726-666805,chr6,666726,666805,H1|chr6:15246367-15246407,chr6,15246367,15246407,0,14579641
H1|chr6:1391197-1391220,chr6,1391197,1391220,H1|chr6:10560364-10560485,chr6,10560364,10560485,0,9169167
H1|chr6:1509382-1509444,chr6,1509382,1509444,H1|chr6:31135597-31135674,chr6,31135597,31135674,0,29626215
H1|chr6:1542677-1542731,chr6,1542677,1542731,H1|chr6:15246428-15246503,chr6,15246428,15246503,0,13703751
H1|chr6:1852771-1852840,chr6,1852771,1852840,H1|chr6:37011969-37012105,chr6,37011969,37012105,0,35159198
H1|chr6:1886107-1886171,chr6,1886107,1886171,H1|chr6:15249580-15249625,chr6,15249580,15249625,0,13363473
H1|chr6:1910395-1910484,chr6,1910395,1910484,H1|chr6:10583705-10583751,chr6,10583705,10583751,0,8673310
H1|chr6:2235603-2235664,chr6,2235603,2235664,H1|chr6:30293501-30293576,chr6,30293501,30293576,0,28057898
H1|chr6:3033294-3033367,chr6,3033294,3033367,H1|chr6:15247387-15247464,chr6,15247387,15247464,0,12214093
H1|chr6:3035078-3035171,chr6,3035078,3035171,H1|chr6:15246415-15246462,chr6,15246415,15246462,0,12211337
H1|chr6:3063252-3063328,chr6,3063252,3063328,H1|chr6:7312487-7312540,chr6,7312487,7312540,0,4249235
H1|chr6:3090153-3090212,chr6,3090153,3090212,H1|chr6:48041225-48041316,chr6,48041225,48041316,0,44951072
H1|chr6:3103943-3104028,chr6,3103943,3104028,H1|chr6:42745940-42745979,chr6,42745940,42745979,0,39641997
H1|chr6:3194294-3194364,chr6,3194294,3194364,H1|chr6:47447131-47447204,chr6,47447131,47447204,0,44252837
H1|chr6:3571138-3571171,chr6,3571138,3571171,H1|chr6:76459840-76459947,chr6,76459840,76459947,0,72888702
H1|chr6:3697726-3697767,chr6,3697726,3697767,H1|chr6:10583364-10583434,chr6,10583364,10583434,0,6885638
H1|chr6:4046336-4046389,chr6,4046336,4046389,H1|chr6:159238369-159238397,chr6,159238369,159238397,0,155192033
H1|chr6:4067726-4067750,chr6,4067726,4067750,H1|chr6:144601833-144601955,chr6,144601833,144601955,0,140534107
H1|chr6:4230225-4230277,chr6,4230225,4230277,H1|chr6:693236-693313,chr6,693236,693313,0,3536989
H1|chr6:4421385-4421521,chr6,4421385,4421521,H1|chr6:37139430-37139492,chr6,37139430,37139492,0,32718045
H1|chr6:4526719-4526841,chr6,4526719,4526841,H1|chr6:42750429-42750465,chr6,42750429,42750465,0,38223710
H1|chr6:4830782-4830842,chr6,4830782,4830842,H1|chr6:27861826-27861889,chr6,27861826,27861889,0,23031044
H1|chr6:5752779-5752827,chr6,5752779,5752827,H1|chr6:34393242-34393331,chr6,34393242,34393331,0,28640463
H1|chr6:5894826-5894884,chr6,5894826,5894884,H1|chr6:86351432-86351515,chr6,86351432,86351515,0,80456606
H1|chr6:6306292-6306415,chr6,6306292,6306415,H1|chr6:4774030-4774053,chr6,4774030,4774053,0,1532262
H1|chr6:6476161-6476296,chr6,6476161,6476296,H1|chr6:16129807-16129847,chr6,16129807,16129847,0,9653646
H1|chr6:6765503-6765584,chr6,6765503,6765584,H1|chr6:47447469-47447523,chr6,47447469,47447523,0,40681966
H1|chr6:6849763-6849804,chr6,6849763,6849804,H1|chr6:10583364-10583434,chr6,10583364,10583434,0,3733601
H1|chr6:6910237-6910318,chr6,6910237,6910318,H1|chr6:35437486-35437517,chr6,35437486,35437517,0,28527249
H1|chr6:6975344-6975447,chr6,6975344,6975447,H1|chr6:15249243-15249342,chr6,15249243,15249342,0,8273899
H1|chr6:7482897-7483000,chr6,7482897,7483000,H1|chr6:4774555-4774596,chr6,4774555,4774596,0,2708342
H1|chr6:7832551-7832604,chr6,7832551,7832604,H1|chr6:10560364-10560485,chr6,10560364,10560485,0,2727813
H1|chr6:7853164-7853279,chr6,7853164,7853279,H1|chr6:10583705-10583751,chr6,10583705,10583751,0,2730541
H1|chr6:7944687-7944729,chr6,7944687,7944729,H1|chr6:155053127-155053166,chr6,155053127,155053166,0,147108440
H1|chr6:8079753-8079882,chr6,8079753,8079882,H1|chr6:144605546-144605567,chr6,144605546,144605567,0,136525793
H1|chr6:8309588-8309668,chr6,8309588,8309668,H1|chr6:15247980-15248029,chr6,15247980,15248029,0,6938392
H1|chr6:9423963-9424047,chr6,9423963,9424047,H1|chr6:13616901-13616927,chr6,13616901,13616927,0,4192938
H1|chr6:9486243-9486269,chr6,9486243,9486269,H1|chr6:10587315-10587405,chr6,10587315,10587405,0,1101072
H1|chr6:9538199-9538282,chr6,9538199,9538282,H1|chr6:41042080-41042178,chr6,41042080,41042178,0,31503881
H1|chr6:9681818-9681914,chr6,9681818,9681914,H1|chr6:16131544-16131565,chr6,16131544,16131565,0,6449726
H1|chr6:9775734-9775845,chr6,9775734,9775845,H1|chr6:105403954-105403983,chr6,105403954,105403983,0,95628220
H1|chr6:10192146-10192169,chr6,10192146,10192169,H1|chr6:48036813-48036887,chr6,48036813,48036887,0,37844667
H1|chr6:10489935-10489969,chr6,10489935,10489969,H1|chr6:29596282-29596353,chr6,29596282,29596353,0,19106347
H1|chr6:11441762-11441834,chr6,11441762,11441834,H1|chr6:160212203-160212341,chr6,160212203,160212341,0,148770441
H1|chr6:11800825-11800913,chr6,11800825,11800913,H1|chr6:158702764-158702820,chr6,158702764,158702820,0,146901939
H1|chr6:11883348-11883442,chr6,11883348,11883442,H1|chr6:15246303-15246405,chr6,15246303,15246405,0,3362955
H1|chr6:11892977-11893053,chr6,11892977,11893053,H1|chr6:33240276-33240346,chr6,33240276,33240346,0,21347299
H1|chr6:11899841-11899905,chr6,11899841,11899905,H1|chr6:13815311-13815358,chr6,13815311,13815358,0,1915470
H1|chr6:11919148-11919239,chr6,11919148,11919239,H1|chr6:158700852-158700911,chr6,158700852,158700911,0,146781704
H1|chr6:12111045-12111075,chr6,12111045,12111075,H1|chr6:44216940-44217060,chr6,44216940,44217060,0,32105895
H1|chr6:12176075-12176133,chr6,12176075,12176133,H1|chr6:10583502-10583625,chr6,10583502,10583625,0,1592573
H1|chr6:12436657-12436797,chr6,12436657,12436797,H1|chr6:29596988-29597054,chr6,29596988,29597054,0,17160331
H1|chr6:12625557-12625593,chr6,12625557,12625593,H1|chr6:30583605-30583719,chr6,30583605,30583719,0,17958048
H1|chr6:12930262-12930368,chr6,12930262,12930368,H1|chr6:151714670-151714706,chr6,151714670,151714706,0,138784408
H1|chr6:12956291-12956380,chr6,12956291,12956380,H1|chr6:10583705-10583751,chr6,10583705,10583751,0,2372586
H1|chr6:13012743-13012777,chr6,13012743,13012777,H1|chr6:151716718-151716834,chr6,151716718,151716834,0,138703975
H1|chr6:13185821-13185886,chr6,13185821,13185886,H1|chr6:15246408-15246493,chr6,15246408,15246493,0,2060587
H1|chr6:13363573-13363627,chr6,13363573,13363627,H1|chr6:33242395-33242451,chr6,33242395,33242451,0,19878822
H1|chr6:13415940-13415974,chr6,13415940,13415974,H1|chr6:42751364-42751464,chr6,42751364,42751464,0,29335424
H1|chr6:13567361-13567415,chr6,13567361,13567415,H1|chr6:136870344-136870450,chr6,136870344,136870450,0,123302983
H1|chr6:13844971-13845016,chr6,13844971,13845016,H1|chr6:42847949-42847981,chr6,42847949,42847981,0,29002978
H1|chr6:13880464-13880612,chr6,13880464,13880612,H1|chr6:33760495-33760581,chr6,33760495,33760581,0,19880031
H1|chr6:14159360-14159453,chr6,14159360,14159453,H1|chr6:29594953-29594995,chr6,29594953,29594995,0,15435593
H1|chr6:14354745-14354779,chr6,14354745,14354779,H1|chr6:80250592-80250708,chr6,80250592,80250708,0,65895847
H1|chr6:14436266-14436332,chr6,14436266,14436332,H1|chr6:2841490-2841574,chr6,2841490,2841574,0,11594776
H1|chr6:14618637-14618737,chr6,14618637,14618737,H1|chr6:15246393-15246433,chr6,15246393,15246433,0,627756
H1|chr6:14706537-14706614,chr6,14706537,14706614,H1|chr6:13486790-13486813,chr6,13486790,13486813,0,1219747
H1|chr6:15004038-15004140,chr6,15004038,15004140,H1|chr6:24910259-24910303,chr6,24910259,24910303,0,9906221
H1|chr6:15115477-15115561,chr6,15115477,15115561,H1|chr6:30539418-30539477,chr6,30539418,30539477,0,15423941
H1|chr6:15256279-15256320,chr6,15256279,15256320,H1|chr6:136871317-136871467,chr6,136871317,136871467,0,121615038
H1|chr6:15475160-15475213,chr6,15475160,15475213,H1|chr6:33421400-33421550,chr6,33421400,33421550,0,17946240
H1|chr6:15502430-15502580,chr6,15502430,15502580,H1|chr6:44216940-44217060,chr6,44216940,44217060,0,28714510
H1|chr6:15512051-15512133,chr6,15512051,15512133,H1|chr6:157101380-157101514,chr6,157101380,157101514,0,141589329
H1|chr6:15899843-15899884,chr6,15899843,15899884,H1|chr6:151716718-151716834,chr6,151716718,151716834,0,135816875
H1|chr6:15976450-15976491,chr6,15976450,15976491,H1|chr6:44216524-44216607,chr6,44216524,44216607,0,28240074
H1|chr6:16110212-16110282,chr6,16110212,16110282,H1|chr6:10559234-10559313,chr6,10559234,10559313,0,5550978
H1|chr6:16147398-16147492,chr6,16147398,16147492,H1|chr6:693584-693640,chr6,693584,693640,0,15453814
H1|chr6:16167464-16167550,chr6,16167464,16167550,H1|chr6:36952408-36952472,chr6,36952408,36952472,0,20784944
H1|chr6:16424233-16424259,chr6,16424233,16424259,H1|chr6:10695717-10695858,chr6,10695717,10695858,0,5728516
H1|chr6:16494448-16494560,chr6,16494448,16494560,H1|chr6:33421442-33421550,chr6,33421442,33421550,0,16926994
H1|chr6:16590056-16590090,chr6,16590056,16590090,H1|chr6:29596282-29596353,chr6,29596282,29596353,0,13006226
H1|chr6:16763882-16763989,chr6,16763882,16763989,H1|chr6:16129807-16129847,chr6,16129807,16129847,0,634075
H1|chr6:16776230-16776325,chr6,16776230,16776325,H1|chr6:10558148-10558191,chr6,10558148,10558191,0,6218082
H1|chr6:17338790-17338858,chr6,17338790,17338858,H1|chr6:149070000-149070061,chr6,149070000,149070061,0,131731210
H1|chr6:17438216-17438250,chr6,17438216,17438250,H1|chr6:76459839-76459947,chr6,76459839,76459947,0,59021623
H1|chr6:18190804-18190866,chr6,18190804,18190866,H1|chr6:36563278-36563341,chr6,36563278,36563341,0,18372474
H1|chr6:18818715-18818755,chr6,18818715,18818755,H1|chr6:111199655-111199757,chr6,111199655,111199757,0,92380940
H1|chr6:18845572-18845702,chr6,18845572,18845702,H1|chr6:47446013-47446121,chr6,47446013,47446121,0,28600441
H1|chr6:18848817-18848868,chr6,18848817,18848868,H1|chr6:15249175-15249249,chr6,15249175,15249249,0,3599642
H1|chr6:19127278-19127321,chr6,19127278,19127321,H1|chr6:7312487-7312540,chr6,7312487,7312540,0,11814791
H1|chr6:19240928-19241011,chr6,19240928,19241011,H1|chr6:15246430-15246473,chr6,15246430,15246473,0,3994498
H1|chr6:19624876-19624916,chr6,19624876,19624916,H1|chr6:10583364-10583434,chr6,10583364,10583434,0,9041512
H1|chr6:19993371-19993393,chr6,19993371,19993393,H1|chr6:15246104-15246172,chr6,15246104,15246172,0,4747267
H1|chr6:20969745-20969804,chr6,20969745,20969804,H1|chr6:34201829-34201926,chr6,34201829,34201926,0,13232084
H1|chr6:21008347-21008408,chr6,21008347,21008408,H1|chr6:36563960-36564016,chr6,36563960,36564016,0,15555613
H1|chr6:21379703-21379721,chr6,21379703,21379721,H1|chr6:7140415-7140503,chr6,7140415,7140503,0,14239288
H1|chr6:21387521-21387631,chr6,21387521,21387631,H1|chr6:111199482-111199518,chr6,111199482,111199518,0,89811961
H1|chr6:21636471-21636548,chr6,21636471,21636548,H1|chr6:34206863-34206903,chr6,34206863,34206903,0,12570392
H1|chr6:21801895-21801946,chr6,21801895,21801946,H1|chr6:15246467-15246512,chr6,15246467,15246512,0,6555428
H1|chr6:22200100-22200128,chr6,22200100,22200128,H1|chr6:144605869-144605978,chr6,144605869,144605978,0,122405769
H1|chr6:22273408-22273486,chr6,22273408,22273486,H1|chr6:33401581-33401634,chr6,33401581,33401634,0,11128173
H1|chr6:22312295-22312313,chr6,22312295,22312313,H1|chr6:7140415-7140503,chr6,7140415,7140503,0,15171880
H1|chr6:22430830-22430893,chr6,22430830,22430893,H1|chr6:44192405-44192503,chr6,44192405,44192503,0,21761575
H1|chr6:22943084-22943139,chr6,22943084,22943139,H1|chr6:105402013-105402060,chr6,105402013,105402060,0,82458929
H1|chr6:23031913-23031945,chr6,23031913,23031945,H1|chr6:15246395-15246489,chr6,15246395,15246489,0,7785518
H1|chr6:23106770-23106818,chr6,23106770,23106818,H1|chr6:34393242-34393331,chr6,34393242,34393331,0,11286472
H1|chr6:23183534-23183608,chr6,23183534,23183608,H1|chr6:99872650-99872707,chr6,99872650,99872707,0,76689116
H1|chr6:23474526-23474583,chr6,23474526,23474583,H1|chr6:157803571-157803638,chr6,157803571,157803638,0,134329045
H1|chr6:23548267-23548308,chr6,23548267,23548308,H1|chr6:42747020-42747090,chr6,42747020,42747090,0,19198753
H1|chr6:23556540-23556625,chr6,23556540,23556625,H1|chr6:4773953-4774018,chr6,4773953,4774018,0,18782587
H1|chr6:25532062-25532120,chr6,25532062,25532120,H1|chr6:86351432-86351515,chr6,86351432,86351515,0,60819370
H1|chr6:25668063-25668083,chr6,25668063,25668083,H1|chr6:3260107-3260135,chr6,3260107,3260135,0,22407956
H1|chr6:25768818-25768860,chr6,25768818,25768860,H1|chr6:31794979-31795098,chr6,31794979,31795098,0,6026161
H1|chr6:25810671-25810776,chr6,25810671,25810776,H1|chr6:158703425-158703443,chr6,158703425,158703443,0,132892754
H1|chr6:26063835-26063911,chr6,26063835,26063911,H1|chr6:35226770-35226825,chr6,35226770,35226825,0,9162935
H1|chr6:26162204-26162248,chr6,26162204,26162248,H1|chr6:42747020-42747090,chr6,42747020,42747090,0,16584816
H1|chr6:26989708-26989790,chr6,26989708,26989790,H1|chr6:143771155-143771200,chr6,143771155,143771200,0,116781447
H1|chr6:27180113-27180184,chr6,27180113,27180184,H1|chr6:30584942-30585001,chr6,30584942,30585001,0,3404829
H1|chr6:27238921-27239014,chr6,27238921,27239014,H1|chr6:71996937-71997004,chr6,71996937,71997004,0,44758016
H1|chr6:27282347-27282398,chr6,27282347,27282398,H1|chr6:13617467-13617530,chr6,13617467,13617530,0,13664880
H1|chr6:27443513-27443550,chr6,27443513,27443550,H1|chr6:36563990-36564016,chr6,36563990,36564016,0,9120477
H1|chr6:27528418-27528457,chr6,27528418,27528457,H1|chr6:26195684-26195777,chr6,26195684,26195777,0,1332734
H1|chr6:27615062-27615154,chr6,27615062,27615154,H1|chr6:15246317-15246352,chr6,15246317,15246352,0,12368745
H1|chr6:27628760-27628792,chr6,27628760,27628792,H1|chr6:111200305-111200455,chr6,111200305,111200455,0,83571545
H1|chr6:27884763-27884805,chr6,27884763,27884805,H1|chr6:31794979-31795098,chr6,31794979,31795098,0,3910216
H1|chr6:27924403-27924438,chr6,27924403,27924438,H1|chr6:36953042-36953101,chr6,36953042,36953101,0,9028639
H1|chr6:28093401-28093436,chr6,28093401,28093436,H1|chr6:15246429-15246507,chr6,15246429,15246507,0,12846972
H1|chr6:28114494-28114587,chr6,28114494,28114587,H1|chr6:15246415-15246462,chr6,15246415,15246462,0,12868079
H1|chr6:28153946-28154027,chr6,28153946,28154027,H1|chr6:35437486-35437517,chr6,35437486,35437517,0,7283540
H1|chr6:28677076-28677128,chr6,28677076,28677128,H1|chr6:143771155-143771195,chr6,143771155,143771195,0,115094079
H1|chr6:28888221-28888282,chr6,28888221,28888282,H1|chr6:30293501-30293576,chr6,30293501,30293576,0,1405280
H1|chr6:28984551-28984609,chr6,28984551,28984609,H1|chr6:10583502-10583625,chr6,10583502,10583625,0,18401049
H1|chr6:29496059-29496166,chr6,29496059,29496166,H1|chr6:144605869-144605911,chr6,144605869,144605911,0,115109810
H1|chr6:29750296-29750382,chr6,29750296,29750382,H1|chr6:33242069-33242122,chr6,33242069,33242122,0,3491773
H1|chr6:30155036-30155095,chr6,30155036,30155095,H1|chr6:44189015-44189072,chr6,44189015,44189072,0,14033979
H1|chr6:30222418-30222458,chr6,30222418,30222458,H1|chr6:35437105-35437175,chr6,35437105,35437175,0,5214687
H1|chr6:30355313-30355372,chr6,30355313,30355372,H1|chr6:15246258-15246334,chr6,15246258,15246334,0,15109055
H1|chr6:30946308-30946389,chr6,30946308,30946389,H1|chr6:47447469-47447523,chr6,47447469,47447523,0,16501161
H1|chr6:31045439-31045498,chr6,31045439,31045498,H1|chr6:34201829-34201926,chr6,34201829,34201926,0,3156390
H1|chr6:31236565-31236641,chr6,31236565,31236641,H1|chr6:121758146-121758207,chr6,121758146,121758207,0,90521581
H1|chr6:31911203-31911276,chr6,31911203,31911276,H1|chr6:2841490-2841574,chr6,2841490,2841574,0,29069713
H1|chr6:32200115-32200159,chr6,32200115,32200159,H1|chr6:136870344-136870450,chr6,136870344,136870450,0,104670229
H1|chr6:32566803-32566878,chr6,32566803,32566878,H1|chr6:31794979-31795093,chr6,31794979,31795093,0,771824
H1|chr6:32659565-32659650,chr6,32659565,32659650,H1|chr6:4773953-4774018,chr6,4773953,4774018,0,27885612
H1|chr6:32756667-32756746,chr6,32756667,32756746,H1|chr6:108278139-108278161,chr6,108278139,108278161,0,75521472
H1|chr6:32779525-32779609,chr6,32779525,32779609,H1|chr6:29596988-29597054,chr6,29596988,29597054,0,3182537
H1|chr6:33067158-33067265,chr6,33067158,33067265,H1|chr6:144605869-144605911,chr6,144605869,144605911,0,111538711
H1|chr6:33289508-33289612,chr6,33289508,33289612,H1|chr6:33240819-33240840,chr6,33240819,33240840,0,48689
H1|chr6:33752974-33753012,chr6,33752974,33753012,H1|chr6:10587291-10587385,chr6,10587291,10587385,0,23165683
H1|chr6:34108840-34108892,chr6,34108840,34108892,H1|chr6:143771155-143771195,chr6,143771155,143771195,0,109662315
H1|chr6:34149620-34149716,chr6,34149620,34149716,H1|chr6:109110609-109110719,chr6,109110609,109110719,0,74960989
H1|chr6:34289482-34289540,chr6,34289482,34289540,H1|chr6:16132140-16132193,chr6,16132140,16132193,0,18157342
H1|chr6:34437536-34437562,chr6,34437536,34437562,H1|chr6:151717193-151717305,chr6,151717193,151717305,0,117279657
H1|chr6:34466185-34466265,chr6,34466185,34466265,H1|chr6:24911887-24911908,chr6,24911887,24911908,0,9554298
H1|chr6:34477354-34477395,chr6,34477354,34477395,H1|chr6:151713571-151713690,chr6,151713571,151713690,0,117236217
H1|chr6:34577892-34577951,chr6,34577892,34577951,H1|chr6:16132140-16132193,chr6,16132140,16132193,0,18445752
H1|chr6:34771217-34771331,chr6,34771217,34771331,H1|chr6:74366273-74366299,chr6,74366273,74366299,0,39595056
H1|chr6:34773045-34773078,chr6,34773045,34773078,H1|chr6:111200305-111200455,chr6,111200305,111200455,0,76427260
H1|chr6:34871328-34871456,chr6,34871328,34871456,H1|chr6:132274578-132274600,chr6,132274578,132274600,0,97403250
H1|chr6:34940227-34940259,chr6,34940227,34940259,H1|chr6:12752334-12752422,chr6,12752334,12752422,0,22187893
H1|chr6:35196446-35196498,chr6,35196446,35196498,H1|chr6:144605869-144605964,chr6,144605869,144605964,0,109409423
H1|chr6:35235010-35235073,chr6,35235010,35235073,H1|chr6:13815311-13815358,chr6,13815311,13815358,0,21419699
H1|chr6:35249182-35249255,chr6,35249182,35249255,H1|chr6:99872650-99872707,chr6,99872650,99872707,0,64623468
H1|chr6:35272565-35272591,chr6,35272565,35272591,H1|chr6:31504608-31504675,chr6,31504608,31504675,0,3767957
H1|chr6:35296933-35297054,chr6,35296933,35297054,H1|chr6:111199237-111199331,chr6,111199237,111199331,0,75902304
H1|chr6:35450326-35450390,chr6,35450326,35450390,H1|chr6:13815311-13815358,chr6,13815311,13815358,0,21635015
H1|chr6:35692610-35692734,chr6,35692610,35692734,H1|chr6:42751875-42751901,chr6,42751875,42751901,0,7059265
H1|chr6:35871804-35871853,chr6,35871804,35871853,H1|chr6:27860349-27860490,chr6,27860349,27860490,0,8011455
H1|chr6:36314618-36314671,chr6,36314618,36314671,H1|chr6:16128801-16128852,chr6,16128801,16128852,0,20185817
H1|chr6:36404577-36404614,chr6,36404577,36404614,H1|chr6:37011461-37011574,chr6,37011461,37011574,0,606884
H1|chr6:36673228-36673265,chr6,36673228,36673265,H1|chr6:15248003-15248055,chr6,15248003,15248055,0,21425225
H1|chr6:36696230-36696282,chr6,36696230,36696282,H1|chr6:693236-693313,chr6,693236,693313,0,36002994
H1|chr6:36832719-36832768,chr6,36832719,36832768,H1|chr6:27860349-27860490,chr6,27860349,27860490,0,8972370
H1|chr6:37533281-37533358,chr6,37533281,37533358,H1|chr6:33240276-33240346,chr6,33240276,33240346,0,4293005
H1|chr6:37557322-37557453,chr6,37557322,37557453,H1|chr6:15246408-15246493,chr6,15246408,15246493,0,22310914
H1|chr6:37567598-37567635,chr6,37567598,37567635,H1|chr6:37011461-37011574,chr6,37011461,37011574,0,556137
H1|chr6:37928160-37928243,chr6,37928160,37928243,H1|chr6:143771155-143771200,chr6,143771155,143771200,0,105842995
H1|chr6:37945668-37945804,chr6,37945668,37945804,H1|chr6:27805191-27805301,chr6,27805191,27805301,0,10140477
H1|chr6:38654631-38654665,chr6,38654631,38654665,H1|chr6:80250592-80250708,chr6,80250592,80250708,0,41595961
H1|chr6:38728621-38728661,chr6,38728621,38728661,H1|chr6:7141264-7141306,chr6,7141264,7141306,0,31587357
H1|chr6:39185194-39185272,chr6,39185194,39185272,H1|chr6:34206863-34206903,chr6,34206863,34206903,0,4978331
H1|chr6:39222966-39222997,chr6,39222966,39222997,H1|chr6:151713571-151713690,chr6,151713571,151713690,0,112490605
H1|chr6:39269557-39269663,chr6,39269557,39269663,H1|chr6:151714670-151714706,chr6,151714670,151714706,0,112445113
H1|chr6:39745801-39745892,chr6,39745801,39745892,H1|chr6:33241609-33241665,chr6,33241609,33241665,0,6504192
H1|chr6:39755668-39755699,chr6,39755668,39755699,H1|chr6:34200093-34200148,chr6,34200093,34200148,0,5555575
H1|chr6:39803201-39803249,chr6,39803201,39803249,H1|chr6:42847947-42847984,chr6,42847947,42847984,0,3044746
H1|chr6:39951998-39952081,chr6,39951998,39952081,H1|chr6:48037597-48037662,chr6,48037597,48037662,0,8085599
H1|chr6:40582667-40582720,chr6,40582667,40582720,H1|chr6:34201829-34201926,chr6,34201829,34201926,0,6380838
H1|chr6:40855364-40855488,chr6,40855364,40855488,H1|chr6:4774030-4774053,chr6,4774030,4774053,0,36081334
H1|chr6:41600787-41600878,chr6,41600787,41600878,H1|chr6:33241609-33241665,chr6,33241609,33241665,0,8359178
H1|chr6:41689819-41689921,chr6,41689819,41689921,H1|chr6:114662569-114662596,chr6,114662569,114662596,0,72972750
H1|chr6:42360094-42360129,chr6,42360094,42360129,H1|chr6:42751364-42751464,chr6,42751364,42751464,0,391270
H1|chr6:42377718-42377753,chr6,42377718,42377753,H1|chr6:15246129-15246190,chr6,15246129,15246190,0,27131589
H1|chr6:42591300-42591367,chr6,42591300,42591367,H1|chr6:31805468-31805535,chr6,31805468,31805535,0,10785832
H1|chr6:43326806-43326888,chr6,43326806,43326888,H1|chr6:41042080-41042178,chr6,41042080,41042178,0,2284726
H1|chr6:43878854-43878890,chr6,43878854,43878890,H1|chr6:29597112-29597187,chr6,29597112,29597187,0,14281742
H1|chr6:43971368-43971441,chr6,43971368,43971441,H1|chr6:2841490-2841574,chr6,2841490,2841574,0,41129878
H1|chr6:44027917-44027945,chr6,44027917,44027945,H1|chr6:10587315-10587405,chr6,10587315,10587405,0,33440602
H1|chr6:44459780-44459811,chr6,44459780,44459811,H1|chr6:31794979-31795098,chr6,31794979,31795098,0,12664801
H1|chr6:44518747-44518839,chr6,44518747,44518839,H1|chr6:15246424-15246479,chr6,15246424,15246479,0,29272323
H1|chr6:44663360-44663400,chr6,44663360,44663400,H1|chr6:111199655-111199757,chr6,111199655,111199757,0,66536295
H1|chr6:44677848-44677984,chr6,44677848,44677984,H1|chr6:37139430-37139492,chr6,37139430,37139492,0,7538418
H1|chr6:44762472-44762507,chr6,44762472,44762507,H1|chr6:15246429-15246507,chr6,15246429,15246507,0,29516043
H1|chr6:44920393-44920466,chr6,44920393,44920466,H1|chr6:15246313-15246345,chr6,15246313,15246345,0,29674080
H1|chr6:44937954-44938067,chr6,44937954,44938067,H1|chr6:144603599-144603628,chr6,144603599,144603628,0,99665645
H1|chr6:45180901-45180979,chr6,45180901,45180979,H1|chr6:33401581-33401634,chr6,33401581,33401634,0,11779320
H1|chr6:45373671-45373699,chr6,45373671,45373699,H1|chr6:10587315-10587405,chr6,10587315,10587405,0,34786356
H1|chr6:45433864-45433904,chr6,45433864,45433904,H1|chr6:27805191-27805301,chr6,27805191,27805301,0,17628673
H1|chr6:45674435-45674511,chr6,45674435,45674511,H1|chr6:35226770-35226825,chr6,35226770,35226825,0,10447665
H1|chr6:45680949-45681039,chr6,45680949,45681039,H1|chr6:10583504-10583557,chr6,10583504,10583557,0,35097445
H1|chr6:45976814-45976881,chr6,45976814,45976881,H1|chr6:2842770-2842834,chr6,2842770,2842834,0,43134044
H1|chr6:46075481-46075560,chr6,46075481,46075560,H1|chr6:2841435-2841574,chr6,2841435,2841574,0,43234046
H1|chr6:46384068-46384110,chr6,46384068,46384110,H1|chr6:90351733-90351811,chr6,90351733,90351811,0,43967665
H1|chr6:46391740-46391771,chr6,46391740,46391771,H1|chr6:34200093-34200148,chr6,34200093,34200148,0,12191647
H1|chr6:46545480-46545526,chr6,46545480,46545526,H1|chr6:35227078-35227118,chr6,35227078,35227118,0,11318402
H1|chr6:46622569-46622622,chr6,46622569,46622622,H1|chr6:33421400-33421550,chr6,33421400,33421550,0,13201169
H1|chr6:46881093-46881156,chr6,46881093,46881156,H1|chr6:13815311-13815358,chr6,13815311,13815358,0,33065782
H1|chr6:46908296-46908392,chr6,46908296,46908392,H1|chr6:33241609-33241665,chr6,33241609,33241665,0,13666687
H1|chr6:46949140-46949172,chr6,46949140,46949172,H1|chr6:111200305-111200455,chr6,111200305,111200455,0,64251165
H1|chr6:47477608-47477690,chr6,47477608,47477690,H1|chr6:111198358-111198426,chr6,111198358,111198426,0,63720750
H1|chr6:47535872-47535925,chr6,47535872,47535925,H1|chr6:15246295-15246350,chr6,15246295,15246350,0,32289577
H1|chr6:47608088-47608122,chr6,47608088,47608122,H1|chr6:132271675-132271787,chr6,132271675,132271787,0,84663587
H1|chr6:48055389-48055448,chr6,48055389,48055448,H1|chr6:44189015-44189072,chr6,44189015,44189072,0,3866374
H1|chr6:48483655-48483707,chr6,48483655,48483707,H1|chr6:41042080-41042178,chr6,41042080,41042178,0,7441575
H1|chr6:48538456-48538495,chr6,48538456,48538495,H1|chr6:30584863-30584969,chr6,30584863,30584969,0,17953593
H1|chr6:48556135-48556248,chr6,48556135,48556248,H1|chr6:2841499-2841574,chr6,2841499,2841574,0,45714636
H1|chr6:48648104-48648140,chr6,48648104,48648140,H1|chr6:15246462-15246491,chr6,15246462,15246491,0,33401642
H1|chr6:48723393-48723455,chr6,48723393,48723455,H1|chr6:30293501-30293576,chr6,30293501,30293576,0,18429892
H1|chr6:48904065-48904104,chr6,48904065,48904104,H1|chr6:44230827-44230882,chr6,44230827,44230882,0,4673238
H1|chr6:49218444-49218529,chr6,49218444,49218529,H1|chr6:30539418-30539477,chr6,30539418,30539477,0,18679026
H1|chr6:49549818-49549871,chr6,49549818,49549871,H1|chr6:15246295-15246350,chr6,15246295,15246350,0,34303523
H1|chr6:49644230-49644325,chr6,49644230,49644325,H1|chr6:15246303-15246405,chr6,15246303,15246405,0,34397927
H1|chr6:49662734-49662825,chr6,49662734,49662825,H1|chr6:15246424-15246479,chr6,15246424,15246479,0,34416310
H1|chr6:49801119-49801235,chr6,49801119,49801235,H1|chr6:159238369-159238397,chr6,159238369,159238397,0,109437250
H1|chr6:49964771-49964878,chr6,49964771,49964878,H1|chr6:16129807-16129847,chr6,16129807,16129847,0,33834964
H1|chr6:50247422-50247474,chr6,50247422,50247474,H1|chr6:13815511-13815567,chr6,13815511,13815567,0,36431911
H1|chr6:50592861-50592937,chr6,50592861,50592937,H1|chr6:7312487-7312540,chr6,7312487,7312540,0,43280374
H1|chr6:50674272-50674322,chr6,50674272,50674322,H1|chr6:158703703-158703807,chr6,158703703,158703807,0,108029431
H1|chr6:50806238-50806280,chr6,50806238,50806280,H1|chr6:158703703-158703807,chr6,158703703,158703807,0,107897465
H1|chr6:51359876-51359975,chr6,51359876,51359975,H1|chr6:15246463-15246510,chr6,15246463,15246510,0,36113413
H1|chr6:51630550-51630681,chr6,51630550,51630681,H1|chr6:111805719-111805816,chr6,111805719,111805816,0,60175169
H1|chr6:51732608-51732672,chr6,51732608,51732672,H1|chr6:15249580-15249625,chr6,15249580,15249625,0,36483028
H1|chr6:52120632-52120660,chr6,52120632,52120660,H1|chr6:144605869-144605978,chr6,144605869,144605978,0,92485237
H1|chr6:52672680-52672717,chr6,52672680,52672717,H1|chr6:15248003-15248055,chr6,15248003,15248055,0,37424677
H1|chr6:52738545-52738578,chr6,52738545,52738578,H1|chr6:144605869-144605986,chr6,144605869,144605986,0,91867324
H1|chr6:53182010-53182030,chr6,53182010,53182030,H1|chr6:3260107-3260135,chr6,3260107,3260135,0,49921903
H1|chr6:53224569-53224675,chr6,53224569,53224675,H1|chr6:26127193-26127237,chr6,26127193,26127237,0,27097376
H1|chr6:53396939-53397022,chr6,53396939,53397022,H1|chr6:15246430-15246473,chr6,15246430,15246473,0,38150509
H1|chr6:53407627-53407704,chr6,53407627,53407704,H1|chr6:15246458-15246498,chr6,15246458,15246498,0,38161169
H1|chr6:53711830-53711922,chr6,53711830,53711922,H1|chr6:71996967-71997004,chr6,71996967,71997004,0,18285137
H1|chr6:53712105-53712146,chr6,53712105,53712146,H1|chr6:136871317-136871467,chr6,136871317,136871467,0,83159212
H1|chr6:53732230-53732264,chr6,53732230,53732264,H1|chr6:76459839-76459947,chr6,76459839,76459947,0,22727609
H1|chr6:53819062-53819164,chr6,53819062,53819164,H1|chr6:114662569-114662596,chr6,114662569,114662596,0,60843507
H1|chr6:53891927-53892047,chr6,53891927,53892047,H1|chr6:10584035-10584065,chr6,10584035,10584065,0,43307892
H1|chr6:54088678-54088807,chr6,54088678,54088807,H1|chr6:29598177-29598198,chr6,29598177,29598198,0,24490501
H1|chr6:54116377-54116490,chr6,54116377,54116490,H1|chr6:2841499-2841574,chr6,2841499,2841574,0,51274878
H1|chr6:54171154-54171190,chr6,54171154,54171190,H1|chr6:29597112-29597187,chr6,29597112,29597187,0,24574042
H1|chr6:54247927-54248063,chr6,54247927,54248063,H1|chr6:27805191-27805301,chr6,27805191,27805301,0,26442736
H1|chr6:54401511-54401593,chr6,54401511,54401593,H1|chr6:42745940-42745979,chr6,42745940,42745979,0,11655571
H1|chr6:54521217-54521269,chr6,54521217,54521269,H1|chr6:111805719-111805816,chr6,111805719,111805816,0,57284502
H1|chr6:54551290-54551366,chr6,54551290,54551366,H1|chr6:33240276-33240346,chr6,33240276,33240346,0,21311014
H1|chr6:54565877-54565916,chr6,54565877,54565916,H1|chr6:26195684-26195777,chr6,26195684,26195777,0,28370193
H1|chr6:55052375-55052485,chr6,55052375,55052485,H1|chr6:111199482-111199518,chr6,111199482,111199518,0,56147107
H1|chr6:55052933-55053008,chr6,55052933,55053008,H1|chr6:111197743-111197788,chr6,111197743,111197788,0,56144810
H1|chr6:55719971-55720042,chr6,55719971,55720042,H1|chr6:30584942-30585001,chr6,30584942,30585001,0,25135029
H1|chr6:56000011-56000143,chr6,56000011,56000143,H1|chr6:15246327-15246347,chr6,15246327,15246347,0,40753684
H1|chr6:56626891-56626960,chr6,56626891,56626960,H1|chr6:2841499-2841574,chr6,2841499,2841574,0,53785392
H1|chr6:56846048-56846130,chr6,56846048,56846130,H1|chr6:10555877-10555917,chr6,10555877,10555917,0,46290171
H1|chr6:57021902-57021997,chr6,57021902,57021997,H1|chr6:48041225-48041316,chr6,48041225,48041316,0,8980677
H1|chr6:57274446-57274596,chr6,57274446,57274596,H1|chr6:132271718-132271740,chr6,132271718,132271740,0,74997272
H1|chr6:57383075-57383110,chr6,57383075,57383110,H1|chr6:694175-694290,chr6,694175,694290,0,56688900
H1|chr6:57513930-57514046,chr6,57513930,57514046,H1|chr6:159238369-159238397,chr6,159238369,159238397,0,101724439
H1|chr6:57969525-57969612,chr6,57969525,57969612,H1|chr6:31505255-31505302,chr6,31505255,31505302,0,26464270
H1|chr6:58390249-58390369,chr6,58390249,58390369,H1|chr6:10584035-10584065,chr6,10584035,10584065,0,47806214
H1|chr6:58526491-58526558,chr6,58526491,58526558,H1|chr6:15246301-15246441,chr6,15246301,15246441,0,43280190
H1|chr6:58855341-58855402,chr6,58855341,58855402,H1|chr6:132271675-132271787,chr6,132271675,132271787,0,73416334
H1|chr6:59510049-59510075,chr6,59510049,59510075,H1|chr6:132274398-132274465,chr6,132274398,132274465,0,72764349
H1|chr6:59561673-59561741,chr6,59561673,59561741,H1|chr6:696501-696606,chr6,696501,696606,0,58865172
H1|chr6:59759262-59759379,chr6,59759262,59759379,H1|chr6:27805191-27805301,chr6,27805191,27805301,0,31954071
H1|chr6:60039461-60039526,chr6,60039461,60039526,H1|chr6:37225803-37225888,chr6,37225803,37225888,0,22813658
H1|chr6:60661246-60661330,chr6,60661246,60661330,H1|chr6:29596988-29597054,chr6,29596988,29597054,0,31064258
H1|chr6:60783840-60783932,chr6,60783840,60783932,H1|chr6:15246317-15246352,chr6,15246317,15246352,0,45537523
H1|chr6:61284211-61284295,chr6,61284211,61284295,H1|chr6:16760142-16760208,chr6,16760142,16760208,0,44524069
H1|chr6:61848120-61848208,chr6,61848120,61848208,H1|chr6:33401753-33401800,chr6,33401753,33401800,0,28446367
H1|chr6:61982384-61982515,chr6,61982384,61982515,H1|chr6:111805719-111805816,chr6,111805719,111805816,0,49823335
H1|chr6:62106114-62106134,chr6,62106114,62106134,H1|chr6:13486790-13486813,chr6,13486790,13486813,0,48619324
H1|chr6:62394599-62394715,chr6,62394599,62394715,H1|chr6:48039636-48039710,chr6,48039636,48039710,0,14354963
H1|chr6:62519362-62519388,chr6,62519362,62519388,H1|chr6:151717193-151717305,chr6,151717193,151717305,0,89197831
H1|chr6:62953442-62953572,chr6,62953442,62953572,H1|chr6:47446013-47446121,chr6,47446013,47446121,0,15507429
H1|chr6:63339645-63339698,chr6,63339645,63339698,H1|chr6:159238369-159238397,chr6,159238369,159238397,0,95898724
H1|chr6:63351577-63351664,chr6,63351577,63351664,H1|chr6:144605869-144605924,chr6,144605869,144605924,0,81254292
H1|chr6:63368786-63368918,chr6,63368786,63368918,H1|chr6:2841556-2841574,chr6,2841556,2841574,0,60527230
H1|chr6:63519493-63519578,chr6,63519493,63519578,H1|chr6:30539418-30539477,chr6,30539418,30539477,0,32980075
H1|chr6:63523527-63523590,chr6,63523527,63523590,H1|chr6:44192405-44192503,chr6,44192405,44192503,0,19331122
H1|chr6:63894691-63894741,chr6,63894691,63894741,H1|chr6:15249175-15249249,chr6,15249175,15249249,0,48645516
H1|chr6:63956943-63957029,chr6,63956943,63957029,H1|chr6:132273607-132273667,chr6,132273607,132273667,0,68316664
H1|chr6:64162231-64162340,chr6,64162231,64162340,H1|chr6:10588050-10588197,chr6,10588050,10588197,0,53574181
H1|chr6:64222818-64222844,chr6,64222818,64222844,H1|chr6:33761397-33761506,chr6,33761397,33761506,0,30461421
H1|chr6:65104092-65104187,chr6,65104092,65104187,H1|chr6:10558148-10558191,chr6,10558148,10558191,0,54545944
H1|chr6:65237199-65237295,chr6,65237199,65237295,H1|chr6:15246465-15246510,chr6,15246465,15246510,0,49990734
H1|chr6:65254893-65254942,chr6,65254893,65254942,H1|chr6:7108554-7108661,chr6,7108554,7108661,0,58146339
H1|chr6:65292799-65292847,chr6,65292799,65292847,H1|chr6:42847947-42847984,chr6,42847947,42847984,0,22444852
H1|chr6:65408498-65408537,chr6,65408498,65408537,H1|chr6:694179-694290,chr6,694179,694290,0,64714319
H1|chr6:66099823-66099882,chr6,66099823,66099882,H1|chr6:48041225-48041316,chr6,48041225,48041316,0,18058598
H1|chr6:66348215-66348272,chr6,66348215,66348272,H1|chr6:30582131-30582201,chr6,30582131,30582201,0,35766084
H1|chr6:67246714-67246790,chr6,67246714,67246790,H1|chr6:48039636-48039710,chr6,48039636,48039710,0,19207078
H1|chr6:67389446-67389548,chr6,67389446,67389548,H1|chr6:144605900-144605938,chr6,144605900,144605938,0,77216454
H1|chr6:67395720-67395814,chr6,67395720,67395814,H1|chr6:15246303-15246405,chr6,15246303,15246405,0,52149417
H1|chr6:67585267-67585344,chr6,67585267,67585344,H1|chr6:13486790-13486813,chr6,13486790,13486813,0,54098477
H1|chr6:67641143-67641180,chr6,67641143,67641180,H1|chr6:36563990-36564016,chr6,36563990,36564016,0,31077153
H1|chr6:67668906-67668988,chr6,67668906,67668988,H1|chr6:157101380-157101514,chr6,157101380,157101514,0,89432474
H1|chr6:67810880-67811008,chr6,67810880,67811008,H1|chr6:15246378-15246400,chr6,15246378,15246400,0,52564502
H1|chr6:68280868-68280896,chr6,68280868,68280896,H1|chr6:144603691-144603765,chr6,144603691,144603765,0,76322823
H1|chr6:68676068-68676146,chr6,68676068,68676146,H1|chr6:34206863-34206903,chr6,34206863,34206903,0,34469205
H1|chr6:69057284-69057334,chr6,69057284,69057334,H1|chr6:139350500-139350645,chr6,139350500,139350645,0,70293216
H1|chr6:69095514-69095587,chr6,69095514,69095587,H1|chr6:111409608-111409659,chr6,111409608,111409659,0,42314094
H1|chr6:69104356-69104447,chr6,69104356,69104447,H1|chr6:158700852-158700911,chr6,158700852,158700911,0,89596496
H1|chr6:69116822-69116919,chr6,69116822,69116919,H1|chr6:144605869-144605922,chr6,144605869,144605922,0,75489047
H1|chr6:69176494-69176570,chr6,69176494,69176570,H1|chr6:2842219-2842293,chr6,2842219,2842293,0,66334275
H1|chr6:69339398-69339479,chr6,69339398,69339479,H1|chr6:24666287-24666323,chr6,24666287,24666323,0,44673111
H1|chr6:69537208-69537262,chr6,69537208,69537262,H1|chr6:33242395-33242451,chr6,33242395,33242451,0,36294813
H1|chr6:69742045-69742079,chr6,69742045,69742079,H1|chr6:132271675-132271787,chr6,132271675,132271787,0,62529630
H1|chr6:69848167-69848266,chr6,69848167,69848266,H1|chr6:15246345-15246394,chr6,15246345,15246394,0,54601822
H1|chr6:69866205-69866275,chr6,69866205,69866275,H1|chr6:111141472-111141552,chr6,111141472,111141552,0,41275267
H1|chr6:69872299-69872389,chr6,69872299,69872389,H1|chr6:16760452-16760535,chr6,16760452,16760535,0,53111847
H1|chr6:69891780-69891910,chr6,69891780,69891910,H1|chr6:15246327-15246347,chr6,15246327,15246347,0,54645453
H1|chr6:69940210-69940318,chr6,69940210,69940318,H1|chr6:4774555-4774596,chr6,4774555,4774596,0,65165655
H1|chr6:70077335-70077444,chr6,70077335,70077444,H1|chr6:144605605-144605646,chr6,144605605,144605646,0,74528270
H1|chr6:70762869-70762889,chr6,70762869,70762889,H1|chr6:10587291-10587385,chr6,10587291,10587385,0,60175578
H1|chr6:70929522-70929621,chr6,70929522,70929621,H1|chr6:15246345-15246394,chr6,15246345,15246394,0,55683177
H1|chr6:70994889-70995024,chr6,70994889,70995024,H1|chr6:16129807-16129847,chr6,16129807,16129847,0,54865082
H1|chr6:71121595-71121653,chr6,71121595,71121653,H1|chr6:44189015-44189073,chr6,44189015,44189073,0,26932580
H1|chr6:71152551-71152621,chr6,71152551,71152621,H1|chr6:10559234-10559313,chr6,10559234,10559313,0,60593317
H1|chr6:71715574-71715724,chr6,71715574,71715724,H1|chr6:144605869-144605922,chr6,144605869,144605922,0,72890295
H1|chr6:71787591-71787629,chr6,71787591,71787629,H1|chr6:28134083-28134144,chr6,28134083,28134144,0,43653508
H1|chr6:71953856-71953903,chr6,71953856,71953903,H1|chr6:10583441-10583526,chr6,10583441,10583526,0,61370415
H1|chr6:71972255-71972315,chr6,71972255,71972315,H1|chr6:27861826-27861889,chr6,27861826,27861889,0,44110429
H1|chr6:72073650-72073700,chr6,72073650,72073700,H1|chr6:15249175-15249249,chr6,15249175,15249249,0,56824475
H1|chr6:72457121-72457205,chr6,72457121,72457205,H1|chr6:151716420-151716486,chr6,151716420,151716486,0,79259299
H1|chr6:72703178-72703223,chr6,72703178,72703223,H1|chr6:696501-696606,chr6,696501,696606,0,72006677
H1|chr6:72837868-72837947,chr6,72837868,72837947,H1|chr6:2841435-2841574,chr6,2841435,2841574,0,69996433
H1|chr6:72888525-72888575,chr6,72888525,72888575,H1|chr6:10559202-10559263,chr6,10559202,10559263,0,62329323
H1|chr6:72965194-72965237,chr6,72965194,72965237,H1|chr6:7108554-7108661,chr6,7108554,7108661,0,65856640
H1|chr6:73512448-73512521,chr6,73512448,73512521,H1|chr6:15246313-15246345,chr6,15246313,15246345,0,58266135
H1|chr6:73583198-73583247,chr6,73583198,73583247,H1|chr6:80250608-80250708,chr6,80250608,80250708,0,6667410
H1|chr6:74167318-74167467,chr6,74167318,74167467,H1|chr6:16760142-16760208,chr6,16760142,16760208,0,57407176
H1|chr6:74179653-74179738,chr6,74179653,74179738,H1|chr6:13616901-13616927,chr6,13616901,13616927,0,60562752
H1|chr6:74507410-74507487,chr6,74507410,74507487,H1|chr6:34206863-34206903,chr6,34206863,34206903,0,40300547
H1|chr6:74701975-74702027,chr6,74701975,74702027,H1|chr6:41042080-41042178,chr6,41042080,41042178,0,33659895
H1|chr6:75339767-75339870,chr6,75339767,75339870,H1|chr6:4774555-4774596,chr6,4774555,4774596,0,70565212
H1|chr6:75593553-75593588,chr6,75593553,75593588,H1|chr6:36953042-36953101,chr6,36953042,36953101,0,38640511
H1|chr6:75648748-75648838,chr6,75648748,75648838,H1|chr6:30881322-30881382,chr6,30881322,30881382,0,44767426
H1|chr6:75804726-75804778,chr6,75804726,75804778,H1|chr6:144605869-144605964,chr6,144605869,144605964,0,68801143
H1|chr6:75845566-75845602,chr6,75845566,75845602,H1|chr6:15248003-15248055,chr6,15248003,15248055,0,60597563
H1|chr6:76278432-76278515,chr6,76278432,76278515,H1|chr6:2842219-2842293,chr6,2842219,2842293,0,73436213
H1|chr6:76629159-76629208,chr6,76629159,76629208,H1|chr6:80250608-80250708,chr6,80250608,80250708,0,3621449
H1|chr6:76675314-76675434,chr6,76675314,76675434,H1|chr6:155053136-155053166,chr6,155053136,155053166,0,78377822
H1|chr6:76814136-76814201,chr6,76814136,76814201,H1|chr6:15246408-15246497,chr6,15246408,15246497,0,61567728
H1|chr6:76979858-76979958,chr6,76979858,76979958,H1|chr6:144605900-144605938,chr6,144605900,144605938,0,67626042
H1|chr6:77212590-77212676,chr6,77212590,77212676,H1|chr6:31505255-31505302,chr6,31505255,31505302,0,45707335
H1|chr6:77291539-77291683,chr6,77291539,77291683,H1|chr6:47446013-47446121,chr6,47446013,47446121,0,29845526
H1|chr6:77296945-77296966,chr6,77296945,77296966,H1|chr6:16130405-16130503,chr6,16130405,16130503,0,61166540
H1|chr6:77498090-77498136,chr6,77498090,77498136,H1|chr6:15246366-15246470,chr6,15246366,15246470,0,62251724
H1|chr6:78212500-78212543,chr6,78212500,78212543,H1|chr6:7312487-7312540,chr6,7312487,7312540,0,70900013
H1|chr6:78460546-78460588,chr6,78460546,78460588,H1|chr6:29601496-29601604,chr6,29601496,29601604,0,48859050
H1|chr6:78532621-78532692,chr6,78532621,78532692,H1|chr6:111409608-111409659,chr6,111409608,111409659,0,32876987
H1|chr6:78562064-78562213,chr6,78562064,78562213,H1|chr6:48041226-48041347,chr6,48041226,48041347,0,30520838
H1|chr6:78780868-78780950,chr6,78780868,78780950,H1|chr6:24666287-24666323,chr6,24666287,24666323,0,54114581
H1|chr6:79067204-79067297,chr6,79067204,79067297,H1|chr6:29594953-29594995,chr6,29594953,29594995,0,49472251
H1|chr6:79297179-79297225,chr6,79297179,79297225,H1|chr6:34393242-34393331,chr6,34393242,34393331,0,44903937
H1|chr6:79664963-79665075,chr6,79664963,79665075,H1|chr6:33240206-33240244,chr6,33240206,33240244,0,46424757
H1|chr6:79675119-79675182,chr6,79675119,79675182,H1|chr6:15246356-15246403,chr6,15246356,15246403,0,64428763
H1|chr6:79689164-79689195,chr6,79689164,79689195,H1|chr6:31794979-31795098,chr6,31794979,31795098,0,47894185
H1|chr6:79740511-79740612,chr6,79740511,79740612,H1|chr6:4773953-4774018,chr6,4773953,4774018,0,74966558
H1|chr6:79901200-79901288,chr6,79901200,79901288,H1|chr6:158702764-158702820,chr6,158702764,158702820,0,78801564
H1|chr6:80031208-80031290,chr6,80031208,80031290,H1|chr6:41042080-41042178,chr6,41042080,41042178,0,38989128
H1|chr6:80189605-80189681,chr6,80189605,80189681,H1|chr6:47447469-47447523,chr6,47447469,47447523,0,32742136
H1|chr6:80508415-80508524,chr6,80508415,80508524,H1|chr6:5006561-5006602,chr6,5006561,5006602,0,75501854
H1|chr6:80584437-80584488,chr6,80584437,80584488,H1|chr6:13617467-13617530,chr6,13617467,13617530,0,66966970
H1|chr6:80709677-80709791,chr6,80709677,80709791,H1|chr6:74366273-74366299,chr6,74366273,74366299,0,6343404
H1|chr6:81320280-81320382,chr6,81320280,81320382,H1|chr6:144605900-144605938,chr6,144605900,144605938,0,63285620
H1|chr6:81427629-81427708,chr6,81427629,81427708,H1|chr6:15246462-15246491,chr6,15246462,15246491,0,66181167
H1|chr6:81841633-81841705,chr6,81841633,81841705,H1|chr6:26127193-26127237,chr6,26127193,26127237,0,55714440
H1|chr6:81900793-81900885,chr6,81900793,81900885,H1|chr6:90348328-90348355,chr6,90348328,90348355,0,8447535
H1|chr6:82417284-82417344,chr6,82417284,82417344,H1|chr6:36956354-36956444,chr6,36956354,36956444,0,45460930
H1|chr6:82657093-82657173,chr6,82657093,82657173,H1|chr6:15247980-15248029,chr6,15247980,15248029,0,67409113
H1|chr6:82915222-82915309,chr6,82915222,82915309,H1|chr6:144605869-144605924,chr6,144605869,144605924,0,61690647
H1|chr6:83700650-83700690,chr6,83700650,83700690,H1|chr6:13618731-13618832,chr6,13618731,13618832,0,70081919
H1|chr6:83773466-83773508,chr6,83773466,83773508,H1|chr6:47446013-47446121,chr6,47446013,47446121,0,36327453
H1|chr6:83890095-83890135,chr6,83890095,83890135,H1|chr6:27805191-27805301,chr6,27805191,27805301,0,56084904
H1|chr6:83937210-83937248,chr6,83937210,83937248,H1|chr6:28134083-28134144,chr6,28134083,28134144,0,55803127
H1|chr6:84110549-84110584,chr6,84110549,84110584,H1|chr6:29596282-29596353,chr6,29596282,29596353,0,54514267
H1|chr6:84480062-84480103,chr6,84480062,84480103,H1|chr6:12751178-12751264,chr6,12751178,12751264,0,71728884
H1|chr6:84609114-84609186,chr6,84609114,84609186,H1|chr6:48041309-48041458,chr6,48041309,48041458,0,36567805
H1|chr6:84699636-84699766,chr6,84699636,84699766,H1|chr6:15246327-15246347,chr6,15246327,15246347,0,69453309
H1|chr6:84737817-84737911,chr6,84737817,84737911,H1|chr6:111805756-111805792,chr6,111805756,111805792,0,27067939
H1|chr6:85330498-85330604,chr6,85330498,85330604,H1|chr6:111199482-111199518,chr6,111199482,111199518,0,25868984
H1|chr6:85334999-85335071,chr6,85334999,85335071,H1|chr6:15247387-15247464,chr6,15247387,15247464,0,70087612
H1|chr6:85387618-85387712,chr6,85387618,85387712,H1|chr6:693584-693640,chr6,693584,693640,0,84694034
H1|chr6:85390681-85390743,chr6,85390681,85390743,H1|chr6:31135597-31135674,chr6,31135597,31135674,0,54255084
H1|chr6:85402974-85403030,chr6,85402974,85403030,H1|chr6:44192610-44192700,chr6,44192610,44192700,0,41210364
H1|chr6:85584587-85584688,chr6,85584587,85584688,H1|chr6:4773953-4774018,chr6,4773953,4774018,0,80810634
H1|chr6:85927472-85927556,chr6,85927472,85927556,H1|chr6:30539418-30539477,chr6,30539418,30539477,0,55388054
H1|chr6:86247748-86247816,chr6,86247748,86247816,H1|chr6:149070000-149070061,chr6,149070000,149070061,0,62822252
H1|chr6:86390240-86390262,chr6,86390240,86390262,H1|chr6:33397267-33397340,chr6,33397267,33397340,0,52992973
H1|chr6:86427968-86428013,chr6,86427968,86428013,H1|chr6:151713058-151713129,chr6,151713058,151713129,0,65285090
H1|chr6:86690673-86690758,chr6,86690673,86690758,H1|chr6:42745940-42745979,chr6,42745940,42745979,0,43944733
H1|chr6:86691738-86691773,chr6,86691738,86691773,H1|chr6:42751364-42751464,chr6,42751364,42751464,0,43940374
H1|chr6:86898881-86898960,chr6,86898881,86898960,H1|chr6:15247980-15248029,chr6,15247980,15248029,0,71650901
H1|chr6:87294068-87294139,chr6,87294068,87294139,H1|chr6:111409608-111409659,chr6,111409608,111409659,0,24115540
H1|chr6:87975895-87975981,chr6,87975895,87975981,H1|chr6:132273607-132273667,chr6,132273607,132273667,0,44297712
H1|chr6:88525566-88525619,chr6,88525566,88525619,H1|chr6:34201829-34201926,chr6,34201829,34201926,0,54323737
H1|chr6:88821041-88821077,chr6,88821041,88821077,H1|chr6:15248003-15248055,chr6,15248003,15248055,0,73573038
H1|chr6:89001241-89001312,chr6,89001241,89001312,H1|chr6:30293700-30293762,chr6,30293700,30293762,0,58707541
H1|chr6:89541833-89541877,chr6,89541833,89541877,H1|chr6:136870344-136870450,chr6,136870344,136870450,0,47328511
H1|chr6:89550262-89550297,chr6,89550262,89550297,H1|chr6:29597112-29597187,chr6,29597112,29597187,0,59953150
H1|chr6:89584537-89584601,chr6,89584537,89584601,H1|chr6:29601496-29601604,chr6,29601496,29601604,0,59983041
H1|chr6:89886447-89886511,chr6,89886447,89886511,H1|chr6:33760495-33760581,chr6,33760495,33760581,0,56125952
H1|chr6:89917097-89917125,chr6,89917097,89917125,H1|chr6:99872373-99872399,chr6,99872373,99872399,0,9955276
H1|chr6:90219685-90219767,chr6,90219685,90219767,H1|chr6:24666287-24666323,chr6,24666287,24666323,0,65553398
H1|chr6:90581088-90581134,chr6,90581088,90581134,H1|chr6:34393242-34393331,chr6,34393242,34393331,0,56187846
H1|chr6:90616706-90616809,chr6,90616706,90616809,H1|chr6:15249243-15249342,chr6,15249243,15249342,0,75367463
H1|chr6:90910850-90910946,chr6,90910850,90910946,H1|chr6:33241609-33241665,chr6,33241609,33241665,0,57669241
H1|chr6:90950553-90950610,chr6,90950553,90950610,H1|chr6:15246360-15246414,chr6,15246360,15246414,0,75704193
H1|chr6:90965376-90965430,chr6,90965376,90965430,H1|chr6:15246467-15246512,chr6,15246467,15246512,0,75718909
H1|chr6:91135761-91135907,chr6,91135761,91135907,H1|chr6:42751875-42751901,chr6,42751875,42751901,0,48383886
H1|chr6:91463684-91463748,chr6,91463684,91463748,H1|chr6:694196-694290,chr6,694196,694290,0,90769488
H1|chr6:91606017-91606117,chr6,91606017,91606117,H1|chr6:15246393-15246433,chr6,15246393,15246433,0,76359624
H1|chr6:91709253-91709272,chr6,91709253,91709272,H1|chr6:7140415-7140503,chr6,7140415,7140503,0,84568838
H1|chr6:91934792-91934828,chr6,91934792,91934828,H1|chr6:31794979-31795093,chr6,31794979,31795093,0,60139813
H1|chr6:92054499-92054521,chr6,92054499,92054521,H1|chr6:15246378-15246451,chr6,15246378,15246451,0,76808121
H1|chr6:92358866-92358927,chr6,92358866,92358927,H1|chr6:26182237-26182326,chr6,26182237,26182326,0,66176629
H1|chr6:92573303-92573353,chr6,92573303,92573353,H1|chr6:158703703-158703807,chr6,158703703,158703807,0,66130400
H1|chr6:92654928-92654993,chr6,92654928,92654993,H1|chr6:37225803-37225888,chr6,37225803,37225888,0,55429125
H1|chr6:92716512-92716621,chr6,92716512,92716621,H1|chr6:10588050-10588197,chr6,10588050,10588197,0,82128462
H1|chr6:92835857-92835937,chr6,92835857,92835937,H1|chr6:24911887-24911908,chr6,24911887,24911908,0,67923970
H1|chr6:92978565-92978696,chr6,92978565,92978696,H1|chr6:15246408-15246493,chr6,15246408,15246493,0,77732157
H1|chr6:93228268-93228346,chr6,93228268,93228346,H1|chr6:132273597-132273667,chr6,132273597,132273667,0,39045329
H1|chr6:93263974-93263998,chr6,93263974,93263998,H1|chr6:29593442-29593592,chr6,29593442,29593592,0,63670532
H1|chr6:93354085-93354152,chr6,93354085,93354152,H1|chr6:31805468-31805535,chr6,31805468,31805535,0,61548617
H1|chr6:93960865-93960960,chr6,93960865,93960960,H1|chr6:16131544-16131565,chr6,16131544,16131565,0,77829321
H1|chr6:94142662-94142688,chr6,94142662,94142688,H1|chr6:31504608-31504675,chr6,31504608,31504675,0,62638054
H1|chr6:94303988-94304080,chr6,94303988,94304080,H1|chr6:15246424-15246479,chr6,15246424,15246479,0,79057564
H1|chr6:94351038-94351123,chr6,94351038,94351123,H1|chr6:37139430-37139492,chr6,37139430,37139492,0,57211608
H1|chr6:94520718-94520781,chr6,94520718,94520781,H1|chr6:693236-693313,chr6,693236,693313,0,93827482
H1|chr6:94753838-94753890,chr6,94753838,94753890,H1|chr6:44192405-44192503,chr6,44192405,44192503,0,50561433
H1|chr6:94951003-94951039,chr6,94951003,94951039,H1|chr6:33761107-33761157,chr6,33761107,33761157,0,61189896
H1|chr6:95396341-95396399,chr6,95396341,95396399,H1|chr6:16132140-16132193,chr6,16132140,16132193,0,79264201
H1|chr6:95699762-95699814,chr6,95699762,95699814,H1|chr6:44192405-44192503,chr6,44192405,44192503,0,51507357
H1|chr6:95809287-95809405,chr6,95809287,95809405,H1|chr6:144605869-144605901,chr6,144605869,144605901,0,48796582
H1|chr6:96248777-96248817,chr6,96248777,96248817,H1|chr6:13618731-13618832,chr6,13618731,13618832,0,82630046
H1|chr6:96780251-96780288,chr6,96780251,96780288,H1|chr6:86299924-86299995,chr6,86299924,86299995,0,10480327
H1|chr6:96905183-96905282,chr6,96905183,96905282,H1|chr6:15246463-15246510,chr6,15246463,15246510,0,81658720
H1|chr6:97486180-97486227,chr6,97486180,97486227,H1|chr6:10583441-10583526,chr6,10583441,10583526,0,86902739
H1|chr6:97585943-97586018,chr6,97585943,97586018,H1|chr6:71996937-71997004,chr6,71996937,71997004,0,25589006
H1|chr6:97680202-97680253,chr6,97680202,97680253,H1|chr6:8099446-8099493,chr6,8099446,8099493,0,89580756
H1|chr6:97791928-97791969,chr6,97791928,97791969,H1|chr6:151713571-151713690,chr6,151713571,151713690,0,53921643
H1|chr6:98747810-98747834,chr6,98747810,98747834,H1|chr6:144601833-144601955,chr6,144601833,144601955,0,45854023
H1|chr6:99001894-99002028,chr6,99001894,99002028,H1|chr6:15246378-15246400,chr6,15246378,15246400,0,83755516
H1|chr6:99242667-99242708,chr6,99242667,99242708,H1|chr6:12751178-12751264,chr6,12751178,12751264,0,86491489
H1|chr6:99313250-99313378,chr6,99313250,99313378,H1|chr6:132274578-132274600,chr6,132274578,132274600,0,32961328
H1|chr6:99315414-99315475,chr6,99315414,99315475,H1|chr6:26182237-26182326,chr6,26182237,26182326,0,73133177
H1|chr6:99600021-99600106,chr6,99600021,99600106,H1|chr6:13616901-13616927,chr6,13616901,13616927,0,85983120
H1|chr6:99753814-99753879,chr6,99753814,99753879,H1|chr6:15246408-15246493,chr6,15246408,15246493,0,84507406
H1|chr6:99968094-99968155,chr6,99968094,99968155,H1|chr6:132271675-132271787,chr6,132271675,132271787,0,32303581
H1|chr6:100021611-100021690,chr6,100021611,100021690,H1|chr6:15246367-15246407,chr6,15246367,15246407,0,84775244
H1|chr6:100637697-100637718,chr6,100637697,100637718,H1|chr6:16130405-16130503,chr6,16130405,16130503,0,84507292
H1|chr6:100724336-100724385,chr6,100724336,100724385,H1|chr6:7108554-7108661,chr6,7108554,7108661,0,93615782
H1|chr6:100896727-100896813,chr6,100896727,100896813,H1|chr6:86350740-86350772,chr6,86350740,86350772,0,14545987
H1|chr6:101018900-101018972,chr6,101018900,101018972,H1|chr6:26127193-26127237,chr6,26127193,26127237,0,74891707
H1|chr6:101083364-101083426,chr6,101083364,101083426,H1|chr6:30293501-30293576,chr6,30293501,30293576,0,70789863
H1|chr6:101129162-101129248,chr6,101129162,101129248,H1|chr6:86350740-86350772,chr6,86350740,86350772,0,14778422
H1|chr6:101482146-101482263,chr6,101482146,101482263,H1|chr6:27805191-27805301,chr6,27805191,27805301,0,73676955
H1|chr6:101506618-101506681,chr6,101506618,101506681,H1|chr6:693236-693313,chr6,693236,693313,0,100813382
H1|chr6:101636492-101636512,chr6,101636492,101636512,H1|chr6:10587291-10587385,chr6,10587291,10587385,0,91049201
H1|chr6:101695776-101695849,chr6,101695776,101695849,H1|chr6:111409608-111409659,chr6,111409608,111409659,0,9713832
H1|chr6:101824946-101825030,chr6,101824946,101825030,H1|chr6:13616901-13616927,chr6,13616901,13616927,0,88208045
H1|chr6:101875709-101875747,chr6,101875709,101875747,H1|chr6:86299924-86299995,chr6,86299924,86299995,0,15575785
H1|chr6:101903434-101903473,chr6,101903434,101903473,H1|chr6:109110609-109110719,chr6,109110609,109110719,0,7207175
H1|chr6:102119995-102120143,chr6,102119995,102120143,H1|chr6:33760495-33760581,chr6,33760495,33760581,0,68359500
H1|chr6:103015269-103015336,chr6,103015269,103015336,H1|chr6:15246301-15246441,chr6,15246301,15246441,0,87768968
H1|chr6:103045890-103046012,chr6,103045890,103046012,H1|chr6:42750429-42750465,chr6,42750429,42750465,0,60295461
H1|chr6:103438075-103438149,chr6,103438075,103438149,H1|chr6:144605869-144605986,chr6,144605869,144605986,0,41167794
H1|chr6:103635552-103635604,chr6,103635552,103635604,H1|chr6:13815511-13815567,chr6,13815511,13815567,0,89820041
H1|chr6:104319335-104319418,chr6,104319335,104319418,H1|chr6:151716420-151716486,chr6,151716420,151716486,0,47397085
H1|chr6:104539912-104539982,chr6,104539912,104539982,H1|chr6:111141472-111141552,chr6,111141472,111141552,0,6601560
H1|chr6:104657236-104657275,chr6,104657236,104657275,H1|chr6:160212203-160212341,chr6,160212203,160212341,0,55554967
H1|chr6:104711427-104711471,chr6,104711427,104711471,H1|chr6:42747020-42747090,chr6,42747020,42747090,0,61964407
H1|chr6:105255813-105255875,chr6,105255813,105255875,H1|chr6:144601887-144601975,chr6,144601887,144601975,0,39346074
H1|chr6:105494803-105494889,chr6,105494803,105494889,H1|chr6:8098562-8098655,chr6,8098562,8098655,0,97396241
H1|chr6:105526329-105526354,chr6,105526329,105526354,H1|chr6:33397267-33397340,chr6,33397267,33397340,0,72129062
H1|chr6:105612584-105612713,chr6,105612584,105612713,H1|chr6:29598177-29598198,chr6,29598177,29598198,0,76014407
H1|chr6:105677528-105677662,chr6,105677528,105677662,H1|chr6:15246378-15246400,chr6,15246378,15246400,0,90431150
H1|chr6:105842148-105842223,chr6,105842148,105842223,H1|chr6:111197743-111197788,chr6,111197743,111197788,0,5355595
H1|chr6:106094506-106094576,chr6,106094506,106094576,H1|chr6:15246482-15246512,chr6,15246482,15246512,0,90848024
H1|chr6:106095043-106095114,chr6,106095043,106095114,H1|chr6:30293700-30293762,chr6,30293700,30293762,0,75801343
H1|chr6:106351809-106351905,chr6,106351809,106351905,H1|chr6:31505699-31505752,chr6,31505699,31505752,0,74846110
H1|chr6:106547194-106547268,chr6,106547194,106547268,H1|chr6:42745960-42746029,chr6,42745960,42746029,0,63801234
H1|chr6:106555992-106556034,chr6,106555992,106556034,H1|chr6:90351733-90351811,chr6,90351733,90351811,0,16204259
H1|chr6:106857263-106857302,chr6,106857263,106857302,H1|chr6:30584863-30584969,chr6,30584863,30584969,0,76272400
H1|chr6:106880534-106880625,chr6,106880534,106880625,H1|chr6:158702764-158702820,chr6,158702764,158702820,0,51822230
H1|chr6:107209502-107209522,chr6,107209502,107209522,H1|chr6:15246387-15246405,chr6,15246387,15246405,0,91963115
H1|chr6:107263560-107263607,chr6,107263560,107263607,H1|chr6:80250592-80250708,chr6,80250592,80250708,0,27012968
H1|chr6:107604559-107604629,chr6,107604559,107604629,H1|chr6:47447131-47447204,chr6,47447131,47447204,0,60157428
H1|chr6:107814180-107814252,chr6,107814180,107814252,H1|chr6:15247387-15247464,chr6,15247387,15247464,0,92566793
H1|chr6:108267748-108267786,chr6,108267748,108267786,H1|chr6:86299924-86299995,chr6,86299924,86299995,0,21967824
H1|chr6:108386778-108386927,chr6,108386778,108386927,H1|chr6:48041226-48041347,chr6,48041226,48041347,0,60345552
H1|chr6:108562481-108562564,chr6,108562481,108562564,H1|chr6:2842219-2842293,chr6,2842219,2842293,0,105720262
H1|chr6:109367244-109367279,chr6,109367244,109367279,H1|chr6:29597112-29597187,chr6,29597112,29597187,0,79770132
H1|chr6:109561899-109561992,chr6,109561899,109561992,H1|chr6:71996937-71997004,chr6,71996937,71997004,0,37564962
H1|chr6:109573774-109573849,chr6,109573774,109573849,H1|chr6:30583252-30583308,chr6,30583252,30583308,0,78990522
H1|chr6:109678797-109678864,chr6,109678797,109678864,H1|chr6:2842770-2842834,chr6,2842770,2842834,0,106836027
H1|chr6:110033971-110034103,chr6,110033971,110034103,H1|chr6:15246327-15246347,chr6,15246327,15246347,0,94787644
H1|chr6:110362784-110362824,chr6,110362784,110362824,H1|chr6:10583364-10583434,chr6,10583364,10583434,0,99779420
H1|chr6:110379943-110379978,chr6,110379943,110379978,H1|chr6:99958757-99958792,chr6,99958757,99958792,0,10421186
H1|chr6:111128939-111128987,chr6,111128939,111128987,H1|chr6:99958757-99958792,chr6,99958757,99958792,0,11170182
H1|chr6:111382762-111382862,chr6,111382762,111382862,H1|chr6:144605900-144605938,chr6,144605900,144605938,0,33223138
H1|chr6:111503027-111503078,chr6,111503027,111503078,H1|chr6:15246467-15246512,chr6,15246467,15246512,0,96256560
H1|chr6:111569386-111569436,chr6,111569386,111569436,H1|chr6:10559202-10559263,chr6,10559202,10559263,0,101010184
H1|chr6:111582485-111582526,chr6,111582485,111582526,H1|chr6:151716718-151716834,chr6,151716718,151716834,0,40134233
H1|chr6:111805374-111805524,chr6,111805374,111805524,H1|chr6:132271718-132271740,chr6,132271718,132271740,0,20466344
H1|chr6:111888420-111888560,chr6,111888420,111888560,H1|chr6:29596988-29597054,chr6,29596988,29597054,0,82291432
H1|chr6:112147755-112147851,chr6,112147755,112147851,H1|chr6:15246465-15246510,chr6,15246465,15246510,0,96901290
H1|chr6:112403384-112403475,chr6,112403384,112403475,H1|chr6:10583504-10583557,chr6,10583504,10583557,0,101819880
H1|chr6:113057680-113057719,chr6,113057680,113057719,H1|chr6:694179-694290,chr6,694179,694290,0,112363501
H1|chr6:113059515-113059602,chr6,113059515,113059602,H1|chr6:31505255-31505302,chr6,31505255,31505302,0,81554260
H1|chr6:113075355-113075378,chr6,113075355,113075378,H1|chr6:48036813-48036887,chr6,48036813,48036887,0,65038542
H1|chr6:113813065-113813099,chr6,113813065,113813099,H1|chr6:151716718-151716834,chr6,151716718,151716834,0,37903653
H1|chr6:113914225-113914320,chr6,113914225,113914320,H1|chr6:48041225-48041316,chr6,48041225,48041316,0,65873000
H1|chr6:114660973-114661008,chr6,114660973,114661008,H1|chr6:694175-694290,chr6,694175,694290,0,113966798
H1|chr6:114732981-114733023,chr6,114732981,114733023,H1|chr6:155053127-155053166,chr6,155053127,155053166,0,40320146
H1|chr6:114763680-114763702,chr6,114763680,114763702,H1|chr6:33397267-33397340,chr6,33397267,33397340,0,81366413
H1|chr6:115191608-115191672,chr6,115191608,115191672,H1|chr6:29601496-29601604,chr6,29601496,29601604,0,85590112
H1|chr6:115224744-115224888,chr6,115224744,115224888,H1|chr6:47446013-47446121,chr6,47446013,47446121,0,67778731
H1|chr6:115251472-115251562,chr6,115251472,115251562,H1|chr6:10583504-10583557,chr6,10583504,10583557,0,104667968
H1|chr6:115468600-115468636,chr6,115468600,115468636,H1|chr6:30583605-30583719,chr6,30583605,30583719,0,84884995
H1|chr6:115688452-115688495,chr6,115688452,115688495,H1|chr6:7108554-7108661,chr6,7108554,7108661,0,108579898
H1|chr6:115814958-115815067,chr6,115814958,115815067,H1|chr6:144605605-144605646,chr6,144605605,144605646,0,28790647
H1|chr6:116566103-116566193,chr6,116566103,116566193,H1|chr6:158700852-158700911,chr6,158700852,158700911,0,42134749
H1|chr6:116567594-116567702,chr6,116567594,116567702,H1|chr6:4774555-4774596,chr6,4774555,4774596,0,111793039
H1|chr6:116645632-116645736,chr6,116645632,116645736,H1|chr6:33240819-33240840,chr6,33240819,33240840,0,83404813
H1|chr6:116767718-116767839,chr6,116767718,116767839,H1|chr6:111199237-111199331,chr6,111199237,111199331,0,5568481
H1|chr6:116887502-116887529,chr6,116887502,116887529,H1|chr6:31504608-31504675,chr6,31504608,31504675,0,85382894
H1|chr6:117042120-117042179,chr6,117042120,117042179,H1|chr6:15246258-15246334,chr6,15246258,15246334,0,101795862
H1|chr6:117111652-117111701,chr6,117111652,117111701,H1|chr6:10583441-10583526,chr6,10583441,10583526,0,106528211
H1|chr6:117277151-117277220,chr6,117277151,117277220,H1|chr6:2841499-2841574,chr6,2841499,2841574,0,114435652
H1|chr6:117385438-117385487,chr6,117385438,117385487,H1|chr6:10583441-10583526,chr6,10583441,10583526,0,106801997
H1|chr6:117721836-117721861,chr6,117721836,117721861,H1|chr6:33397267-33397340,chr6,33397267,33397340,0,84324569
H1|chr6:117886082-117886150,chr6,117886082,117886150,H1|chr6:696501-696606,chr6,696501,696606,0,117189581
H1|chr6:118149131-118149185,chr6,118149131,118149185,H1|chr6:15246370-15246421,chr6,15246370,15246421,0,102902761
H1|chr6:118541109-118541153,chr6,118541109,118541153,H1|chr6:37135488-37135594,chr6,37135488,37135594,0,81405621
H1|chr6:119007241-119007364,chr6,119007241,119007364,H1|chr6:144605869-144605891,chr6,144605869,144605891,0,25598628
H1|chr6:119048897-119048980,chr6,119048897,119048980,H1|chr6:143771155-143771200,chr6,143771155,143771200,0,24722258
H1|chr6:119240718-119240793,chr6,119240718,119240793,H1|chr6:31794979-31795093,chr6,31794979,31795093,0,87445739
H1|chr6:119323567-119323649,chr6,119323567,119323649,H1|chr6:111198358-111198426,chr6,111198358,111198426,0,8125209
H1|chr6:119759588-119759620,chr6,119759588,119759620,H1|chr6:15246395-15246489,chr6,15246395,15246489,0,104513193
H1|chr6:119801184-119801258,chr6,119801184,119801258,H1|chr6:42745960-42746029,chr6,42745960,42746029,0,77055224
H1|chr6:119895492-119895582,chr6,119895492,119895582,H1|chr6:16760452-16760535,chr6,16760452,16760535,0,103135040
H1|chr6:120379709-120379728,chr6,120379709,120379728,H1|chr6:7140415-7140503,chr6,7140415,7140503,0,113239294
H1|chr6:120639119-120639150,chr6,120639119,120639150,H1|chr6:151713571-151713690,chr6,151713571,151713690,0,31074452
H1|chr6:120805047-120805156,chr6,120805047,120805156,H1|chr6:5006561-5006602,chr6,5006561,5006602,0,115798486
H1|chr6:120838264-120838366,chr6,120838264,120838366,H1|chr6:24910259-24910303,chr6,24910259,24910303,0,95928005
H1|chr6:121028199-121028245,chr6,121028199,121028245,H1|chr6:35227078-35227118,chr6,35227078,35227118,0,85801121
H1|chr6:121664728-121664781,chr6,121664728,121664781,H1|chr6:16128801-16128852,chr6,16128801,16128852,0,105535927
H1|chr6:122853521-122853626,chr6,122853521,122853626,H1|chr6:158703425-158703443,chr6,158703425,158703443,0,35849904
H1|chr6:122999150-122999214,chr6,122999150,122999214,H1|chr6:694196-694290,chr6,694196,694290,0,122304954
H1|chr6:123148097-123148136,chr6,123148097,123148136,H1|chr6:86300167-86300233,chr6,86300167,86300233,0,36847930
H1|chr6:123473049-123473155,chr6,123473049,123473155,H1|chr6:111199482-111199518,chr6,111199482,111199518,0,12273567
H1|chr6:123479306-123479382,chr6,123479306,123479382,H1|chr6:42745960-42746029,chr6,42745960,42746029,0,80733346
H1|chr6:123524457-123524529,chr6,123524457,123524529,H1|chr6:16128801-16128855,chr6,16128801,16128855,0,107395656
H1|chr6:123581793-123581831,chr6,123581793,123581831,H1|chr6:10587291-10587385,chr6,10587291,10587385,0,112994502
H1|chr6:123608687-123608757,chr6,123608687,123608757,H1|chr6:15246482-15246512,chr6,15246482,15246512,0,108362205
H1|chr6:123670054-123670087,chr6,123670054,123670087,H1|chr6:144605869-144605986,chr6,144605869,144605986,0,20935815
H1|chr6:124127817-124127859,chr6,124127817,124127859,H1|chr6:158703703-158703807,chr6,158703703,158703807,0,34575886
H1|chr6:124285310-124285334,chr6,124285310,124285334,H1|chr6:29593442-29593592,chr6,29593442,29593592,0,94691868
H1|chr6:124815485-124815518,chr6,124815485,124815518,H1|chr6:111200305-111200455,chr6,111200305,111200455,0,13615180
H1|chr6:124969602-124969752,chr6,124969602,124969752,H1|chr6:44216940-44217060,chr6,44216940,44217060,0,80752662
H1|chr6:125149847-125149919,chr6,125149847,125149919,H1|chr6:160212203-160212341,chr6,160212203,160212341,0,35062356
H1|chr6:125272469-125272514,chr6,125272469,125272514,H1|chr6:42847949-42847981,chr6,42847949,42847981,0,82424520
H1|chr6:125467760-125467786,chr6,125467760,125467786,H1|chr6:33761397-33761506,chr6,33761397,33761506,0,91706363
H1|chr6:125866420-125866495,chr6,125866420,125866495,H1|chr6:151716420-151716495,chr6,151716420,151716495,0,25850000
H1|chr6:126098191-126098244,chr6,126098191,126098244,H1|chr6:10560364-10560485,chr6,10560364,10560485,0,115537827
H1|chr6:126104781-126104841,chr6,126104781,126104841,H1|chr6:24666287-24666323,chr6,24666287,24666323,0,101438494
H1|chr6:126510139-126510222,chr6,126510139,126510222,H1|chr6:41042080-41042178,chr6,41042080,41042178,0,85468059
H1|chr6:126545847-126545888,chr6,126545847,126545888,H1|chr6:44216524-44216607,chr6,44216524,44216607,0,82329323
H1|chr6:126587657-126587754,chr6,126587657,126587754,H1|chr6:144605869-144605922,chr6,144605869,144605922,0,18018212
H1|chr6:126849648-126849743,chr6,126849648,126849743,H1|chr6:15246303-15246405,chr6,15246303,15246405,0,111603345
H1|chr6:127742311-127742344,chr6,127742311,127742344,H1|chr6:76459840-76459947,chr6,76459840,76459947,0,51282471
H1|chr6:127841824-127841869,chr6,127841824,127841869,H1|chr6:40553566-40553680,chr6,40553566,40553680,0,87288258
H1|chr6:128089089-128089115,chr6,128089089,128089115,H1|chr6:10695717-10695858,chr6,10695717,10695858,0,117393372
H1|chr6:128124205-128124256,chr6,128124205,128124256,H1|chr6:8099446-8099493,chr6,8099446,8099493,0,120024759
H1|chr6:128195544-128195601,chr6,128195544,128195601,H1|chr6:31135597-31135674,chr6,31135597,31135674,0,97059947
H1|chr6:128269543-128269565,chr6,128269543,128269565,H1|chr6:15246378-15246451,chr6,15246378,15246451,0,113023165
H1|chr6:128331634-128331770,chr6,128331634,128331770,H1|chr6:144605869-144605901,chr6,144605869,144605901,0,16274235
H1|chr6:128760693-128760821,chr6,128760693,128760821,H1|chr6:15246378-15246400,chr6,15246378,15246400,0,113514315
H1|chr6:129082889-129082948,chr6,129082889,129082948,H1|chr6:16132140-16132193,chr6,16132140,16132193,0,112950749
H1|chr6:129185007-129185043,chr6,129185007,129185043,H1|chr6:44230827-44230882,chr6,44230827,44230882,0,84954180
H1|chr6:129213846-129213885,chr6,129213846,129213885,H1|chr6:44230827-44230882,chr6,44230827,44230882,0,84983019
H1|chr6:129265064-129265187,chr6,129265064,129265187,H1|chr6:144605869-144605891,chr6,144605869,144605891,0,15340805
H1|chr6:130374071-130374140,chr6,130374071,130374140,H1|chr6:37011969-37012105,chr6,37011969,37012105,0,93362102
H1|chr6:130533777-130533822,chr6,130533777,130533822,H1|chr6:696501-696606,chr6,696501,696606,0,129837276
H1|chr6:130852676-130852715,chr6,130852676,130852715,H1|chr6:109110609-109110719,chr6,109110609,109110719,0,21742067
H1|chr6:130882192-130882310,chr6,130882192,130882310,H1|chr6:144605869-144605901,chr6,144605869,144605901,0,13723677
H1|chr6:131117390-131117496,chr6,131117390,131117496,H1|chr6:26127193-26127237,chr6,26127193,26127237,0,104990197
H1|chr6:131216005-131216091,chr6,131216005,131216091,H1|chr6:33242069-33242122,chr6,33242069,33242122,0,97973936
H1|chr6:131371768-131371806,chr6,131371768,131371806,H1|chr6:144602297-144602378,chr6,144602297,144602378,0,13230529
H1|chr6:131702024-131702066,chr6,131702024,131702066,H1|chr6:29601496-29601604,chr6,29601496,29601604,0,102100528
H1|chr6:131744074-131744157,chr6,131744074,131744157,H1|chr6:48037597-48037662,chr6,48037597,48037662,0,83706477
H1|chr6:131972728-131972769,chr6,131972728,131972769,H1|chr6:42747020-42747090,chr6,42747020,42747090,0,89225708
H1|chr6:131996278-131996314,chr6,131996278,131996314,H1|chr6:31794979-31795093,chr6,31794979,31795093,0,100201299
H1|chr6:132103138-132103288,chr6,132103138,132103288,H1|chr6:144605869-144605922,chr6,144605869,144605922,0,12502731
H1|chr6:132158978-132159005,chr6,132158978,132159005,H1|chr6:31504608-31504675,chr6,31504608,31504675,0,100654370
H1|chr6:132369820-132369844,chr6,132369820,132369844,H1|chr6:29596303-29596415,chr6,29596303,29596415,0,102773517
H1|chr6:132466651-132466732,chr6,132466651,132466732,H1|chr6:26182237-26182326,chr6,26182237,26182326,0,106284414
H1|chr6:132550509-132550595,chr6,132550509,132550595,H1|chr6:8098562-8098655,chr6,8098562,8098655,0,124451947
H1|chr6:132933942-132934018,chr6,132933942,132934018,H1|chr6:48039636-48039710,chr6,48039636,48039710,0,84894306
H1|chr6:132964939-132965041,chr6,132964939,132965041,H1|chr6:693584-693640,chr6,693584,693640,0,132271355
H1|chr6:133160135-133160191,chr6,133160135,133160191,H1|chr6:43022453-43022525,chr6,43022453,43022525,0,90137682
H1|chr6:133361944-133362018,chr6,133361944,133362018,H1|chr6:144605869-144605986,chr6,144605869,144605986,0,11243925
H1|chr6:133535886-133535953,chr6,133535886,133535953,H1|chr6:16760452-16760535,chr6,16760452,16760535,0,116775434
H1|chr6:134353431-134353527,chr6,134353431,134353527,H1|chr6:16131544-16131565,chr6,16131544,16131565,0,118221887
H1|chr6:134452221-134452278,chr6,134452221,134452278,H1|chr6:157803571-157803638,chr6,157803571,157803638,0,23351350
H1|chr6:134737078-134737190,chr6,134737078,134737190,H1|chr6:33240206-33240244,chr6,33240206,33240244,0,101496872
H1|chr6:135014615-135014675,chr6,135014615,135014675,H1|chr6:24666287-24666323,chr6,24666287,24666323,0,110348328
H1|chr6:135369124-135369147,chr6,135369124,135369147,H1|chr6:10560364-10560485,chr6,10560364,10560485,0,124808760
H1|chr6:135943284-135943400,chr6,135943284,135943400,H1|chr6:48039636-48039710,chr6,48039636,48039710,0,87903648
H1|chr6:135997366-135997516,chr6,135997366,135997516,H1|chr6:2841556-2841574,chr6,2841556,2841574,0,133155810
H1|chr6:136590501-136590529,chr6,136590501,136590529,H1|chr6:99872373-99872399,chr6,99872373,99872399,0,36718128
H1|chr6:136732559-136732613,chr6,136732559,136732613,H1|chr6:15246370-15246421,chr6,15246370,15246421,0,121486189
H1|chr6:136780620-136780699,chr6,136780620,136780699,H1|chr6:15246462-15246491,chr6,15246462,15246491,0,121534158
H1|chr6:137345139-137345175,chr6,137345139,137345175,H1|chr6:33761107-33761157,chr6,33761107,33761157,0,103584032
H1|chr6:137547725-137547799,chr6,137547725,137547799,H1|chr6:99872650-99872707,chr6,99872650,99872707,0,37675075
H1|chr6:137564815-137564894,chr6,137564815,137564894,H1|chr6:15246367-15246407,chr6,15246367,15246407,0,122318448
H1|chr6:137662161-137662311,chr6,137662161,137662311,H1|chr6:2841556-2841574,chr6,2841556,2841574,0,134820605
H1|chr6:137813150-137813240,chr6,137813150,137813240,H1|chr6:158700852-158700911,chr6,158700852,158700911,0,20887702
H1|chr6:137929072-137929151,chr6,137929072,137929151,H1|chr6:108278139-108278161,chr6,108278139,108278161,0,29650933
H1|chr6:138496161-138496234,chr6,138496161,138496234,H1|chr6:99872650-99872707,chr6,99872650,99872707,0,38623511
H1|chr6:138533937-138534060,chr6,138533937,138534060,H1|chr6:4774030-4774053,chr6,4774030,4774053,0,133759907
H1|chr6:138594726-138594855,chr6,138594726,138594855,H1|chr6:144605546-144605567,chr6,144605546,144605567,0,6010820
H1|chr6:138657357-138657396,chr6,138657357,138657396,H1|chr6:86300167-86300233,chr6,86300167,86300233,0,52357190
H1|chr6:138852163-138852208,chr6,138852163,138852208,H1|chr6:40553566-40553680,chr6,40553566,40553680,0,98298597
H1|chr6:139013702-139013787,chr6,139013702,139013787,H1|chr6:37139430-37139492,chr6,37139430,37139492,0,101874272
H1|chr6:139028048-139028159,chr6,139028048,139028159,H1|chr6:105403954-105403983,chr6,105403954,105403983,0,33624094
H1|chr6:139232073-139232223,chr6,139232073,139232223,H1|chr6:24910259-24910303,chr6,24910259,24910303,0,114321814
H1|chr6:139854955-139855009,chr6,139854955,139855009,H1|chr6:15246428-15246503,chr6,15246428,15246503,0,124608527
H1|chr6:139986347-139986402,chr6,139986347,139986402,H1|chr6:105402013-105402060,chr6,105402013,105402060,0,34584334
H1|chr6:140541548-140541582,chr6,140541548,140541582,H1|chr6:42751364-42751464,chr6,42751364,42751464,0,97790184
H1|chr6:140630757-140630792,chr6,140630757,140630792,H1|chr6:694863-694941,chr6,694863,694941,0,139935894
H1|chr6:140693596-140693622,chr6,140693596,140693622,H1|chr6:132274398-132274465,chr6,132274398,132274465,0,8419198
H1|chr6:140770354-140770416,chr6,140770354,140770416,H1|chr6:36563278-36563341,chr6,36563278,36563341,0,104207076
H1|chr6:140916474-140916610,chr6,140916474,140916610,H1|chr6:144605869-144605901,chr6,144605869,144605901,0,3689395
H1|chr6:140936802-140936864,chr6,140936802,140936864,H1|chr6:144601887-144601975,chr6,144601887,144601975,0,3665085
H1|chr6:141334906-141334944,chr6,141334906,141334944,H1|chr6:144602297-144602378,chr6,144602297,144602378,0,3267391
H1|chr6:141579367-141579461,chr6,141579367,141579461,H1|chr6:111805756-111805792,chr6,111805756,111805792,0,29773611
H1|chr6:142843555-142843609,chr6,142843555,142843609,H1|chr6:15246467-15246512,chr6,15246467,15246512,0,127597088
H1|chr6:143074406-143074484,chr6,143074406,143074484,H1|chr6:132273597-132273667,chr6,132273597,132273667,0,10800809
H1|chr6:143094572-143094704,chr6,143094572,143094704,H1|chr6:2841556-2841574,chr6,2841556,2841574,0,140253016
H1|chr6:143558561-143558647,chr6,143558561,143558647,H1|chr6:36952408-36952472,chr6,36952408,36952472,0,106606153
H1|chr6:143993263-143993300,chr6,143993263,143993300,H1|chr6:86299924-86299995,chr6,86299924,86299995,0,57693339
H1|chr6:144741068-144741088,chr6,144741068,144741088,H1|chr6:13486790-13486813,chr6,13486790,13486813,0,131254278
H1|chr6:144748112-144748200,chr6,144748112,144748200,H1|chr6:37134889-37134940,chr6,37134889,37134940,0,107613223
H1|chr6:145059854-145059935,chr6,145059854,145059935,H1|chr6:24666287-24666323,chr6,24666287,24666323,0,120393567
H1|chr6:145156444-145156490,chr6,145156444,145156490,H1|chr6:15246366-15246470,chr6,15246366,15246470,0,129910078
H1|chr6:145420286-145420382,chr6,145420286,145420382,H1|chr6:109110609-109110719,chr6,109110609,109110719,0,36309677
H1|chr6:145451438-145451515,chr6,145451438,145451515,H1|chr6:15246458-15246498,chr6,15246458,15246498,0,130204980
H1|chr6:146280816-146280888,chr6,146280816,146280888,H1|chr6:48041309-48041458,chr6,48041309,48041458,0,98239507
H1|chr6:146460554-146460627,chr6,146460554,146460627,H1|chr6:15247387-15247464,chr6,15247387,15247464,0,131213167
H1|chr6:146585937-146586014,chr6,146585937,146586014,H1|chr6:33240276-33240346,chr6,33240276,33240346,0,113345661
H1|chr6:146916164-146916199,chr6,146916164,146916199,H1|chr6:99958757-99958792,chr6,99958757,99958792,0,46957407
H1|chr6:147135735-147135821,chr6,147135735,147135821,H1|chr6:31505255-31505302,chr6,31505255,31505302,0,115630480
H1|chr6:147628844-147628934,chr6,147628844,147628934,H1|chr6:30881322-30881382,chr6,30881322,30881382,0,116747522
H1|chr6:148021923-148021981,chr6,148021923,148021981,H1|chr6:44189015-44189073,chr6,44189015,44189073,0,103832908
H1|chr6:148273378-148273466,chr6,148273378,148273466,H1|chr6:37134889-37134940,chr6,37134889,37134940,0,111138489
H1|chr6:148519924-148519959,chr6,148519924,148519959,H1|chr6:15246129-15246190,chr6,15246129,15246190,0,133273795
H1|chr6:148696218-148696281,chr6,148696218,148696281,H1|chr6:15246356-15246403,chr6,15246356,15246403,0,133449862
H1|chr6:148773349-148773431,chr6,148773349,148773431,H1|chr6:143771155-143771200,chr6,143771155,143771200,0,5002194
H1|chr6:148842517-148842537,chr6,148842517,148842537,H1|chr6:15246387-15246405,chr6,15246387,15246405,0,133596130
H1|chr6:149271316-149271391,chr6,149271316,149271391,H1|chr6:71996937-71997004,chr6,71996937,71997004,0,77274379
H1|chr6:149285599-149285690,chr6,149285599,149285690,H1|chr6:10583504-10583557,chr6,10583504,10583557,0,138702095
H1|chr6:149305197-149305279,chr6,149305197,149305279,H1|chr6:10555877-10555917,chr6,10555877,10555917,0,138749320
H1|chr6:149554048-149554105,chr6,149554048,149554105,H1|chr6:31135597-31135674,chr6,31135597,31135674,0,118418451
H1|chr6:149605173-149605249,chr6,149605173,149605249,H1|chr6:47447469-47447523,chr6,47447469,47447523,0,102157704
H1|chr6:149885622-149885657,chr6,149885622,149885657,H1|chr6:694863-694941,chr6,694863,694941,0,149190759
H1|chr6:150365122-150365201,chr6,150365122,150365201,H1|chr6:15247980-15248029,chr6,15247980,15248029,0,135117142
H1|chr6:150398578-150398608,chr6,150398578,150398608,H1|chr6:44216940-44217060,chr6,44216940,44217060,0,106181638
H1|chr6:150689677-150689769,chr6,150689677,150689769,H1|chr6:71996967-71997004,chr6,71996967,71997004,0,78692710
H1|chr6:150787162-150787241,chr6,150787162,150787241,H1|chr6:15246367-15246407,chr6,15246367,15246407,0,135540795
H1|chr6:150904203-150904327,chr6,150904203,150904327,H1|chr6:42751875-42751901,chr6,42751875,42751901,0,108152328
H1|chr6:151055217-151055293,chr6,151055217,151055293,H1|chr6:42745960-42746029,chr6,42745960,42746029,0,108309257
H1|chr6:151168825-151168937,chr6,151168825,151168937,H1|chr6:33421442-33421550,chr6,33421442,33421550,0,117747383
H1|chr6:151237447-151237484,chr6,151237447,151237484,H1|chr6:28134083-28134144,chr6,28134083,28134144,0,123103364
H1|chr6:151371684-151371751,chr6,151371684,151371751,H1|chr6:16760452-16760535,chr6,16760452,16760535,0,134611232
H1|chr6:151384364-151384438,chr6,151384364,151384438,H1|chr6:15246430-15246482,chr6,15246430,15246482,0,136137934
H1|chr6:151753263-151753319,chr6,151753263,151753319,H1|chr6:694196-694290,chr6,694196,694290,0,151059067
H1|chr6:152180428-152180502,chr6,152180428,152180502,H1|chr6:15246430-15246482,chr6,15246430,15246482,0,136933998
H1|chr6:152443045-152443123,chr6,152443045,152443123,H1|chr6:111141467-111141539,chr6,111141467,111141539,0,41301578
H1|chr6:152798673-152798725,chr6,152798673,152798725,H1|chr6:111805719-111805816,chr6,111805719,111805816,0,40992954
H1|chr6:153015671-153015728,chr6,153015671,153015728,H1|chr6:30582131-30582201,chr6,30582131,30582201,0,122433540
H1|chr6:153043646-153043683,chr6,153043646,153043683,H1|chr6:28134083-28134144,chr6,28134083,28134144,0,124909563
H1|chr6:153202248-153202313,chr6,153202248,153202313,H1|chr6:15246408-15246497,chr6,15246408,15246497,0,137955840
H1|chr6:153283989-153284045,chr6,153283989,153284045,H1|chr6:44192610-44192700,chr6,44192610,44192700,0,109091379
H1|chr6:153297793-153297838,chr6,153297793,153297838,H1|chr6:151713058-151713129,chr6,151713058,151713129,0,1584735
H1|chr6:153738356-153738398,chr6,153738356,153738398,H1|chr6:47446013-47446121,chr6,47446013,47446121,0,106292343
H1|chr6:153760627-153760667,chr6,153760627,153760667,H1|chr6:35437105-35437175,chr6,35437105,35437175,0,118323522
H1|chr6:154242794-154242834,chr6,154242794,154242834,H1|chr6:7141264-7141306,chr6,7141264,7141306,0,147101530
H1|chr6:154899321-154899436,chr6,154899321,154899436,H1|chr6:10583705-10583751,chr6,10583705,10583751,0,144315616
H1|chr6:155244121-155244193,chr6,155244121,155244193,H1|chr6:16128801-16128855,chr6,16128801,16128855,0,139115320
H1|chr6:155337781-155337918,chr6,155337781,155337918,H1|chr6:33240206-33240244,chr6,33240206,33240244,0,122097575
H1|chr6:155852187-155852285,chr6,155852187,155852285,H1|chr6:16128801-16128853,chr6,16128801,16128853,0,139723386
H1|chr6:156046243-156046335,chr6,156046243,156046335,H1|chr6:90348328-90348355,chr6,90348328,90348355,0,65697915
H1|chr6:156070700-156070737,chr6,156070700,156070737,H1|chr6:15246420-15246503,chr6,15246420,15246503,0,140824280
H1|chr6:156525408-156525490,chr6,156525408,156525490,H1|chr6:42745940-42745979,chr6,42745940,42745979,0,113779468
H1|chr6:157424563-157424683,chr6,157424563,157424683,H1|chr6:155053136-155053166,chr6,155053136,155053166,0,2371427
H1|chr6:157855556-157855640,chr6,157855556,157855640,H1|chr6:16760142-16760208,chr6,16760142,16760208,0,141095414
H1|chr6:157860918-157860978,chr6,157860918,157860978,H1|chr6:36956354-36956444,chr6,36956354,36956444,0,120904564
H1|chr6:158138397-158138488,chr6,158138397,158138488,H1|chr6:158702764-158702820,chr6,158702764,158702820,0,564367
H1|chr6:158195210-158195246,chr6,158195210,158195246,H1|chr6:44230827-44230882,chr6,44230827,44230882,0,113964383
H1|chr6:158208562-158208637,chr6,158208562,158208637,H1|chr6:30583252-30583308,chr6,30583252,30583308,0,127625310
H1|chr6:158567303-158567360,chr6,158567303,158567360,H1|chr6:15246360-15246414,chr6,15246360,15246414,0,143320943
H1|chr6:158791440-158791496,chr6,158791440,158791496,H1|chr6:43022453-43022525,chr6,43022453,43022525,0,115768987
H1|chr6:158908381-158908428,chr6,158908381,158908428,H1|chr6:80250592-80250708,chr6,80250592,80250708,0,78657789
H1|chr6:159199829-159199931,chr6,159199829,159199931,H1|chr6:693584-693640,chr6,693584,693640,0,158506245
H1|chr6:159219525-159219649,chr6,159219525,159219649,H1|chr6:4774030-4774053,chr6,4774030,4774053,0,154445495
H1|chr6:159250827-159250976,chr6,159250827,159250976,H1|chr6:16760142-16760208,chr6,16760142,16760208,0,142490685
H1|chr6:159293559-159293642,chr6,159293559,159293642,H1|chr6:151716420-151716486,chr6,151716420,151716486,0,7577139
H1|chr6:159581120-159581164,chr6,159581120,159581164,H1|chr6:37135488-37135594,chr6,37135488,37135594,0,122445632
H1|chr6:160213757-160213853,chr6,160213757,160213853,H1|chr6:31505699-31505752,chr6,31505699,31505752,0,128708058
H1|chr6:160325628-160325723,chr6,160325628,160325723,H1|chr6:16131544-16131565,chr6,16131544,16131565,0,144194084
H1|chr6:160990981-160991057,chr6,160990981,160991057,H1|chr6:121758146-121758207,chr6,121758146,121758207,0,39232835
H1|chr6:161171825-161171913,chr6,161171825,161171913,H1|chr6:33401753-33401800,chr6,33401753,33401800,0,127770072
H1|chr6:161210890-161210946,chr6,161210890,161210946,H1|chr6:694196-694290,chr6,694196,694290,0,160516694
H1|chr6:161235161-161235212,chr6,161235161,161235212,H1|chr6:15249175-15249249,chr6,15249175,15249249,0,145985986
H1|chr6:162610832-162610913,chr6,162610832,162610913,H1|chr6:26182237-26182326,chr6,26182237,26182326,0,136428595
H1|chr6:162685064-162685112,chr6,162685064,162685112,H1|chr6:99958757-99958792,chr6,99958757,99958792,0,62726307
H1|chr6:163014215-163014313,chr6,163014215,163014313,H1|chr6:16128801-16128853,chr6,16128801,16128853,0,146885414
H1|chr6:163244259-163244298,chr6,163244259,163244298,H1|chr6:160212203-160212341,chr6,160212203,160212341,0,3032056
H1|chr6:163402785-163402876,chr6,163402785,163402876,H1|chr6:15246424-15246479,chr6,15246424,15246479,0,148156361
H1|chr6:163486749-163486771,chr6,163486749,163486771,H1|chr6:15246104-15246172,chr6,15246104,15246172,0,148240645
H1|chr6:163560243-163560267,chr6,163560243,163560267,H1|chr6:29596303-29596415,chr6,29596303,29596415,0,133963940
H1|chr6:163563228-163563294,chr6,163563228,163563294,H1|chr6:2841490-2841574,chr6,2841490,2841574,0,160721738
H1|chr6:163932445-163932558,chr6,163932445,163932558,H1|chr6:144603599-144603628,chr6,144603599,144603628,0,19328846
H1|chr6:164539737-164539787,chr6,164539737,164539787,H1|chr6:139350500-139350645,chr6,139350500,139350645,0,25189237
H1|chr6:164697238-164697301,chr6,164697238,164697301,H1|chr6:74366187-74366228,chr6,74366187,74366228,0,90331051
H1|chr6:164804580-164804617,chr6,164804580,164804617,H1|chr6:15246420-15246503,chr6,15246420,15246503,0,149558160
H1|chr6:164866987-164867048,chr6,164866987,164867048,H1|chr6:36563960-36564016,chr6,36563960,36564016,0,128303027
H1|chr6:165464600-165464678,chr6,165464600,165464678,H1|chr6:111141467-111141539,chr6,111141467,111141539,0,54323133
H1|chr6:166036471-166036617,chr6,166036471,166036617,H1|chr6:42751875-42751901,chr6,42751875,42751901,0,123284596
H1|chr6:166149852-166149887,chr6,166149852,166149887,H1|chr6:29596282-29596353,chr6,29596282,29596353,0,136553570
H1|chr6:166162977-166163041,chr6,166162977,166163041,H1|chr6:33760495-33760581,chr6,33760495,33760581,0,132402482
H1|chr6:166656985-166657039,chr6,166656985,166657039,H1|chr6:136870344-136870450,chr6,136870344,136870450,0,29786641
H1|chr6:167189034-167189138,chr6,167189034,167189138,H1|chr6:111805756-111805792,chr6,111805756,111805792,0,55383278
H1|chr6:167243666-167243770,chr6,167243666,167243770,H1|chr6:111805756-111805792,chr6,111805756,111805792,0,55437910
H1|chr6:167343150-167343226,chr6,167343150,167343226,H1|chr6:2842219-2842293,chr6,2842219,2842293,0,164500931
H1|chr6:167805270-167805354,chr6,167805270,167805354,H1|chr6:151716420-151716486,chr6,151716420,151716486,0,16088850
H1|chr6:167935116-167935266,chr6,167935116,167935266,H1|chr6:24910259-24910303,chr6,24910259,24910303,0,143024857
H1|chr6:168517748-168517811,chr6,168517748,168517811,H1|chr6:74366187-74366228,chr6,74366187,74366228,0,94151561
H1|chr6:168771867-168772004,chr6,168771867,168772004,H1|chr6:33240206-33240244,chr6,33240206,33240244,0,135531661
H1|chr6:170222218-170222254,chr6,170222218,170222254,H1|chr6:15246462-15246491,chr6,15246462,15246491,0,154975756
H1|chr6:170416931-170416957,chr6,170416931,170416957,H1|chr6:10587315-10587405,chr6,10587315,10587405,0,159829616
H1|chr6:170419159-170419187,chr6,170419159,170419187,H1|chr6:144603691-144603765,chr6,144603691,144603765,0,25815468
H1|chr6:170420394-170420426,chr6,170420394,170420426,H1|chr6:12752334-12752422,chr6,12752334,12752422,0,157668060
H1|chr7:74085-74204,chr7,74085,74204,H1|chr7:100449366-100449428,chr7,100449366,100449428,0,100375281
H1|chr7:544203-544229,chr7,544203,544229,H1|chr7:100270089-100270153,chr7,100270089,100270153,0,99725886
H1|chr7:648902-649012,chr7,648902,649012,H1|chr7:121782045-121782085,chr7,121782045,121782085,0,121133143
H1|chr7:792782-792827,chr7,792782,792827,H1|chr7:121775654-121775757,chr7,121775654,121775757,0,120982872
H1|chr7:1309368-1309414,chr7,1309368,1309414,H1|chr7:129590843-129590922,chr7,129590843,129590922,0,128281475
H1|chr7:1391677-1391769,chr7,1391677,1391769,H1|chr7:151215676-151215699,chr7,151215676,151215699,0,149823999
H1|chr7:1986151-1986213,chr7,1986151,1986213,H1|chr7:70599033-70599103,chr7,70599033,70599103,0,68612882
H1|chr7:2323633-2323715,chr7,2323633,2323715,H1|chr7:148848397-148848462,chr7,148848397,148848462,0,146524764
H1|chr7:2379288-2379329,chr7,2379288,2379329,H1|chr7:121781744-121781836,chr7,121781744,121781836,0,119402456
H1|chr7:2380575-2380623,chr7,2380575,2380623,H1|chr7:100134649-100134721,chr7,100134649,100134721,0,97754074
H1|chr7:2950226-2950376,chr7,2950226,2950376,H1|chr7:131237235-131237270,chr7,131237235,131237270,0,128287009
H1|chr7:3732920-3733007,chr7,3732920,3733007,H1|chr7:24324351-24324372,chr7,24324351,24324372,0,20591431
H1|chr7:4222337-4222360,chr7,4222337,4222360,H1|chr7:149471545-149471644,chr7,149471545,149471644,0,145249208
H1|chr7:4638328-4638438,chr7,4638328,4638438,H1|chr7:5598093-5598133,chr7,5598093,5598133,0,959765
H1|chr7:4796932-4797012,chr7,4796932,4797012,H1|chr7:100289518-100289551,chr7,100289518,100289551,0,95492586
H1|chr7:4879781-4879893,chr7,4879781,4879893,H1|chr7:138147983-138148054,chr7,138147983,138148054,0,133268202
H1|chr7:5052592-5052729,chr7,5052592,5052729,H1|chr7:43768164-43768219,chr7,43768164,43768219,0,38715572
H1|chr7:5123448-5123479,chr7,5123448,5123479,H1|chr7:121777379-121777498,chr7,121777379,121777498,0,116653931
H1|chr7:5709018-5709063,chr7,5709018,5709063,H1|chr7:129590930-129591016,chr7,129590930,129591016,0,123881912
H1|chr7:6012063-6012141,chr7,6012063,6012141,H1|chr7:23506773-23506910,chr7,23506773,23506910,0,17494710
H1|chr7:6035874-6035954,chr7,6035874,6035954,H1|chr7:121782533-121782568,chr7,121782533,121782568,0,115746659
H1|chr7:6363365-6363469,chr7,6363365,6363469,H1|chr7:100876901-100876941,chr7,100876901,100876941,0,94513536
H1|chr7:6414716-6414772,chr7,6414716,6414772,H1|chr7:23528338-23528397,chr7,23528338,23528397,0,17113622
H1|chr7:6590688-6590786,chr7,6590688,6590786,H1|chr7:121035703-121035734,chr7,121035703,121035734,0,114445015
H1|chr7:6672024-6672044,chr7,6672024,6672044,H1|chr7:148848377-148848462,chr7,148848377,148848462,0,142176353
H1|chr7:7511161-7511218,chr7,7511161,7511218,H1|chr7:73673114-73673207,chr7,73673114,73673207,0,66161953
H1|chr7:7700224-7700294,chr7,7700224,7700294,H1|chr7:121780398-121780523,chr7,121780398,121780523,0,114080174
H1|chr7:8327796-8327822,chr7,8327796,8327822,H1|chr7:91570756-91570858,chr7,91570756,91570858,0,83242960
H1|chr7:8915201-8915237,chr7,8915201,8915237,H1|chr7:142987278-142987320,chr7,142987278,142987320,0,134072077
H1|chr7:9263392-9263446,chr7,9263392,9263446,H1|chr7:74378462-74378499,chr7,74378462,74378499,0,65115070
H1|chr7:9399670-9399766,chr7,9399670,9399766,H1|chr7:50859380-50859412,chr7,50859380,50859412,0,41459710
H1|chr7:9699076-9699142,chr7,9699076,9699142,H1|chr7:100290832-100290882,chr7,100290832,100290882,0,90591756
H1|chr7:10280033-10280128,chr7,10280033,10280128,H1|chr7:121035703-121035734,chr7,121035703,121035734,0,110755670
H1|chr7:10538265-10538321,chr7,10538265,10538321,H1|chr7:23528338-23528397,chr7,23528338,23528397,0,12990073
H1|chr7:10620346-10620443,chr7,10620346,10620443,H1|chr7:121782045-121782084,chr7,121782045,121782084,0,111161699
H1|chr7:10966427-10966506,chr7,10966427,10966506,H1|chr7:138147983-138148054,chr7,138147983,138148054,0,127181556
H1|chr7:11309828-11309894,chr7,11309828,11309894,H1|chr7:93631846-93631925,chr7,93631846,93631925,0,82322018
H1|chr7:11728768-11728850,chr7,11728768,11728850,H1|chr7:121786935-121786978,chr7,121786935,121786978,0,110058167
H1|chr7:12013609-12013724,chr7,12013609,12013724,H1|chr7:131237235-131237270,chr7,131237235,131237270,0,119223626
H1|chr7:12200355-12200458,chr7,12200355,12200458,H1|chr7:23532517-23532576,chr7,23532517,23532576,0,11332162
H1|chr7:12318608-12318722,chr7,12318608,12318722,H1|chr7:50859380-50859412,chr7,50859380,50859412,0,38540772
H1|chr7:12575089-12575164,chr7,12575089,12575164,H1|chr7:121035958-121035998,chr7,121035958,121035998,0,108460869
H1|chr7:12672573-12672624,chr7,12672573,12672624,H1|chr7:156684786-156684841,chr7,156684786,156684841,0,144012213
H1|chr7:12691337-12691391,chr7,12691337,12691391,H1|chr7:102232325-102232419,chr7,102232325,102232419,0,89540988
H1|chr7:12810675-12810769,chr7,12810675,12810769,H1|chr7:35075861-35075905,chr7,35075861,35075905,0,22265186
H1|chr7:12887313-12887354,chr7,12887313,12887354,H1|chr7:121777830-121777911,chr7,121777830,121777911,0,108890517
H1|chr7:13204323-13204384,chr7,13204323,13204384,H1|chr7:121775421-121775475,chr7,121775421,121775475,0,108571098
H1|chr7:13747753-13747779,chr7,13747753,13747779,H1|chr7:91570756-91570858,chr7,91570756,91570858,0,77823003
H1|chr7:13837057-13837120,chr7,13837057,13837120,H1|chr7:2885680-2885766,chr7,2885680,2885766,0,10951377
H1|chr7:13907764-13907856,chr7,13907764,13907856,H1|chr7:148846059-148846096,chr7,148846059,148846096,0,134938295
H1|chr7:14196681-14196760,chr7,14196681,14196760,H1|chr7:138147983-138148054,chr7,138147983,138148054,0,123951302
H1|chr7:14547192-14547282,chr7,14547192,14547282,H1|chr7:131240224-131240246,chr7,131240224,131240246,0,116693032
H1|chr7:14554066-14554130,chr7,14554066,14554130,H1|chr7:2885680-2885766,chr7,2885680,2885766,0,11668386
H1|chr7:14984507-14984557,chr7,14984507,14984557,H1|chr7:101005884-101005947,chr7,101005884,101005947,0,86021377
H1|chr7:15870820-15870874,chr7,15870820,15870874,H1|chr7:24318914-24318982,chr7,24318914,24318982,0,8448094
H1|chr7:15946875-15946955,chr7,15946875,15946955,H1|chr7:100289518-100289551,chr7,100289518,100289551,0,84342643
H1|chr7:17169911-17169963,chr7,17169911,17169963,H1|chr7:121775654-121775752,chr7,121775654,121775752,0,104605743
H1|chr7:17205586-17205696,chr7,17205586,17205696,H1|chr7:24319059-24319101,chr7,24319059,24319101,0,7113473
H1|chr7:17849973-17850013,chr7,17849973,17850013,H1|chr7:150065220-150065252,chr7,150065220,150065252,0,132215247
H1|chr7:18317967-18318117,chr7,18317967,18318117,H1|chr7:131237235-131237270,chr7,131237235,131237270,0,112919268
H1|chr7:18379989-18380009,chr7,18379989,18380009,H1|chr7:149471545-149471644,chr7,149471545,149471644,0,131091556
H1|chr7:18535377-18535437,chr7,18535377,18535437,H1|chr7:23570662-23570752,chr7,23570662,23570752,0,5035285
H1|chr7:18845147-18845186,chr7,18845147,18845186,H1|chr7:128335726-128335759,chr7,128335726,128335759,0,109490579
H1|chr7:18985891-18985953,chr7,18985891,18985953,H1|chr7:1176752-1176807,chr7,1176752,1176807,0,17809139
H1|chr7:19335328-19335406,chr7,19335328,19335406,H1|chr7:73587505-73587586,chr7,73587505,73587586,0,54252177
H1|chr7:19908593-19908672,chr7,19908593,19908672,H1|chr7:65212607-65212648,chr7,65212607,65212648,0,45304014
H1|chr7:19995552-19995690,chr7,19995552,19995690,H1|chr7:102232272-102232420,chr7,102232272,102232420,0,82236720
H1|chr7:20232878-20232980,chr7,20232878,20232980,H1|chr7:70598810-70598835,chr7,70598810,70598835,0,50365932
H1|chr7:20541007-20541130,chr7,20541007,20541130,H1|chr7:26239702-26239754,chr7,26239702,26239754,0,5698695
H1|chr7:21339869-21339934,chr7,21339869,21339934,H1|chr7:102232346-102232496,chr7,102232346,102232496,0,80892477
H1|chr7:21705477-21705570,chr7,21705477,21705570,H1|chr7:151215677-151215699,chr7,151215677,151215699,0,129510200
H1|chr7:22372139-22372206,chr7,22372139,22372206,H1|chr7:100290832-100290882,chr7,100290832,100290882,0,77918693
H1|chr7:22679282-22679327,chr7,22679282,22679327,H1|chr7:23531581-23531710,chr7,23531581,23531710,0,852299
H1|chr7:23004497-23004541,chr7,23004497,23004541,H1|chr7:30176619-30176742,chr7,30176619,30176742,0,7172122
H1|chr7:23118802-23118880,chr7,23118802,23118880,H1|chr7:121781450-121781498,chr7,121781450,121781498,0,98662648
H1|chr7:23385328-23385426,chr7,23385328,23385426,H1|chr7:102233190-102233241,chr7,102233190,102233241,0,78847862
H1|chr7:23401638-23401695,chr7,23401638,23401695,H1|chr7:97737684-97737701,chr7,97737684,97737701,0,74336046
H1|chr7:23446829-23446862,chr7,23446829,23446862,H1|chr7:99755627-99755694,chr7,99755627,99755694,0,76308798
H1|chr7:24537036-24537054,chr7,24537036,24537054,H1|chr7:148848377-148848462,chr7,148848377,148848462,0,124311341
H1|chr7:24555488-24555508,chr7,24555488,24555508,H1|chr7:148848377-148848462,chr7,148848377,148848462,0,124292889
H1|chr7:24737553-24737641,chr7,24737553,24737641,H1|chr7:100449366-100449406,chr7,100449366,100449406,0,75711813
H1|chr7:24819342-24819391,chr7,24819342,24819391,H1|chr7:121777774-121777827,chr7,121777774,121777827,0,96958432
H1|chr7:25514231-25514332,chr7,25514231,25514332,H1|chr7:100290043-100290092,chr7,100290043,100290092,0,74775812
H1|chr7:25531386-25531422,chr7,25531386,25531422,H1|chr7:142987278-142987320,chr7,142987278,142987320,0,117455892
H1|chr7:26234683-26234768,chr7,26234683,26234768,H1|chr7:150815060-150815130,chr7,150815060,150815130,0,124580377
H1|chr7:26593081-26593143,chr7,26593081,26593143,H1|chr7:23526923-23526967,chr7,23526923,23526967,0,3066158
H1|chr7:26901164-26901257,chr7,26901164,26901257,H1|chr7:121781365-121781422,chr7,121781365,121781422,0,94880201
H1|chr7:27667926-27667991,chr7,27667926,27667991,H1|chr7:101931264-101931291,chr7,101931264,101931291,0,74263338
H1|chr7:27931328-27931391,chr7,27931328,27931391,H1|chr7:2885680-2885766,chr7,2885680,2885766,0,25045648
H1|chr7:28533531-28533576,chr7,28533531,28533576,H1|chr7:129590930-129591016,chr7,129590930,129591016,0,101057399
H1|chr7:28685560-28685690,chr7,28685560,28685690,H1|chr7:93629813-93629833,chr7,93629813,93629833,0,64944253
H1|chr7:29318024-29318043,chr7,29318024,29318043,H1|chr7:23533063-23533213,chr7,23533063,23533213,0,5784961
H1|chr7:29528050-29528098,chr7,29528050,29528098,H1|chr7:23526269-23526321,chr7,23526269,23526321,0,6001781
H1|chr7:29697272-29697328,chr7,29697272,29697328,H1|chr7:99822192-99822294,chr7,99822192,99822294,0,70124920
H1|chr7:29932195-29932293,chr7,29932195,29932293,H1|chr7:26239702-26239754,chr7,26239702,26239754,0,3692493
H1|chr7:30819026-30819129,chr7,30819026,30819129,H1|chr7:131237836-131237883,chr7,131237836,131237883,0,100418810
H1|chr7:31429927-31430019,chr7,31429927,31430019,H1|chr7:23527364-23527413,chr7,23527364,23527413,0,7902563
H1|chr7:32125523-32125608,chr7,32125523,32125608,H1|chr7:74378462-74378499,chr7,74378462,74378499,0,42252939
H1|chr7:32605144-32605183,chr7,32605144,32605183,H1|chr7:25165373-25165505,chr7,25165373,25165505,0,7439771
H1|chr7:33755516-33755610,chr7,33755516,33755610,H1|chr7:35075861-35075905,chr7,35075861,35075905,0,1320345
H1|chr7:34031734-34031809,chr7,34031734,34031809,H1|chr7:26237759-26237823,chr7,26237759,26237823,0,7793975
H1|chr7:34521924-34521981,chr7,34521924,34521981,H1|chr7:73673114-73673207,chr7,73673114,73673207,0,39151190
H1|chr7:34660924-34660977,chr7,34660924,34660977,H1|chr7:44838018-44838110,chr7,44838018,44838110,0,10177094
H1|chr7:35224537-35224687,chr7,35224537,35224687,H1|chr7:50859380-50859412,chr7,50859380,50859412,0,15634843
H1|chr7:35256306-35256338,chr7,35256306,35256338,H1|chr7:99755627-99755694,chr7,99755627,99755694,0,64499321
H1|chr7:35262596-35262692,chr7,35262596,35262692,H1|chr7:100290930-100291004,chr7,100290930,100291004,0,65028334
H1|chr7:35504112-35504234,chr7,35504112,35504234,H1|chr7:148791208-148791263,chr7,148791208,148791263,0,113287096
H1|chr7:35663165-35663247,chr7,35663165,35663247,H1|chr7:121782533-121782568,chr7,121782533,121782568,0,86119368
H1|chr7:35745862-35745898,chr7,35745862,35745898,H1|chr7:121783473-121783621,chr7,121783473,121783621,0,86037611
H1|chr7:35907750-35907810,chr7,35907750,35907810,H1|chr7:102232318-102232428,chr7,102232318,102232428,0,66324568
H1|chr7:36191678-36191807,chr7,36191678,36191807,H1|chr7:2885730-2885766,chr7,2885730,2885766,0,33305948
H1|chr7:36244126-36244178,chr7,36244126,36244178,H1|chr7:156684786-156684841,chr7,156684786,156684841,0,120440660
H1|chr7:36272641-36272734,chr7,36272641,36272734,H1|chr7:121781365-121781422,chr7,121781365,121781422,0,85508724
H1|chr7:37223661-37223811,chr7,37223661,37223811,H1|chr7:43768164-43768219,chr7,43768164,43768219,0,6544503
H1|chr7:37379398-37379548,chr7,37379398,37379548,H1|chr7:100134678-100134720,chr7,100134678,100134720,0,62755280
H1|chr7:37488437-37488587,chr7,37488437,37488587,H1|chr7:102233168-102233318,chr7,102233168,102233318,0,64744731
H1|chr7:37867591-37867681,chr7,37867591,37867681,H1|chr7:82071938-82071971,chr7,82071938,82071971,0,44204347
H1|chr7:38155264-38155339,chr7,38155264,38155339,H1|chr7:121035958-121035998,chr7,121035958,121035998,0,82880694
H1|chr7:38160375-38160525,chr7,38160375,38160525,H1|chr7:112091785-112091848,chr7,112091785,112091848,0,73931410
H1|chr7:38699467-38699514,chr7,38699467,38699514,H1|chr7:100857888-100857961,chr7,100857888,100857961,0,62158421
H1|chr7:38809505-38809615,chr7,38809505,38809615,H1|chr7:5598093-5598133,chr7,5598093,5598133,0,33211412
H1|chr7:39499586-39499646,chr7,39499586,39499646,H1|chr7:131238950-131239021,chr7,131238950,131239021,0,91739364
H1|chr7:39547930-39548036,chr7,39547930,39548036,H1|chr7:131240188-131240237,chr7,131240188,131240237,0,91692258
H1|chr7:39898522-39898611,chr7,39898522,39898611,H1|chr7:35075861-35075905,chr7,35075861,35075905,0,4822661
H1|chr7:40303294-40303333,chr7,40303294,40303333,H1|chr7:128335726-128335759,chr7,128335726,128335759,0,88032432
H1|chr7:40699169-40699261,chr7,40699169,40699261,H1|chr7:151215676-151215699,chr7,151215676,151215699,0,110516507
H1|chr7:41157579-41157631,chr7,41157579,41157631,H1|chr7:156684786-156684841,chr7,156684786,156684841,0,115527207
H1|chr7:41250262-41250360,chr7,41250262,41250360,H1|chr7:26239702-26239754,chr7,26239702,26239754,0,15010560
H1|chr7:41266677-41266711,chr7,41266677,41266711,H1|chr7:75927112-75927262,chr7,75927112,75927262,0,34660435
H1|chr7:41470703-41470754,chr7,41470703,41470754,H1|chr7:156684786-156684841,chr7,156684786,156684841,0,115214083
H1|chr7:42222388-42222436,chr7,42222388,42222436,H1|chr7:23526269-23526321,chr7,23526269,23526321,0,18696119
H1|chr7:43105308-43105378,chr7,43105308,43105378,H1|chr7:121780111-121780180,chr7,121780111,121780180,0,78674803
H1|chr7:43365107-43365210,chr7,43365107,43365210,H1|chr7:24321429-24321467,chr7,24321429,24321467,0,19043678
H1|chr7:43401819-43401924,chr7,43401819,43401924,H1|chr7:135243479-135243518,chr7,135243479,135243518,0,91841660
H1|chr7:43594049-43594098,chr7,43594049,43594098,H1|chr7:148848043-148848120,chr7,148848043,148848120,0,105253994
H1|chr7:43713227-43713338,chr7,43713227,43713338,H1|chr7:82071938-82071971,chr7,82071938,82071971,0,38358711
H1|chr7:43960614-43960713,chr7,43960614,43960713,H1|chr7:99041539-99041657,chr7,99041539,99041657,0,55080925
H1|chr7:44999464-44999510,chr7,44999464,44999510,H1|chr7:138147970-138148063,chr7,138147970,138148063,0,93148506
H1|chr7:45140870-45140951,chr7,45140870,45140951,H1|chr7:23528340-23528393,chr7,23528340,23528393,0,21612530
H1|chr7:45317585-45317687,chr7,45317585,45317687,H1|chr7:73673114-73673207,chr7,73673114,73673207,0,28355529
H1|chr7:45470946-45471096,chr7,45470946,45471096,H1|chr7:102232273-102232423,chr7,102232273,102232423,0,56761327
H1|chr7:45685651-45685774,chr7,45685651,45685774,H1|chr7:26239702-26239754,chr7,26239702,26239754,0,19445949
H1|chr7:47056929-47056970,chr7,47056929,47056970,H1|chr7:72396406-72396475,chr7,72396406,72396475,0,25339477
H1|chr7:47671803-47671844,chr7,47671803,47671844,H1|chr7:121781744-121781836,chr7,121781744,121781836,0,74109941
H1|chr7:47935564-47935646,chr7,47935564,47935646,H1|chr7:148848397-148848462,chr7,148848397,148848462,0,100912833
H1|chr7:48591353-48591451,chr7,48591353,48591451,H1|chr7:121035703-121035734,chr7,121035703,121035734,0,72444350
H1|chr7:49547167-49547209,chr7,49547167,49547209,H1|chr7:121777830-121777911,chr7,121777830,121777911,0,72230663
H1|chr7:49580341-49580420,chr7,49580341,49580420,H1|chr7:65212607-65212648,chr7,65212607,65212648,0,15632266
H1|chr7:49960245-49960339,chr7,49960245,49960339,H1|chr7:121783876-121783932,chr7,121783876,121783932,0,71823631
H1|chr7:50602523-50602617,chr7,50602523,50602617,H1|chr7:131237344-131237381,chr7,131237344,131237381,0,80634821
H1|chr7:51042295-51042375,chr7,51042295,51042375,H1|chr7:129590164-129590209,chr7,129590164,129590209,0,78547869
H1|chr7:51263378-51263459,chr7,51263378,51263459,H1|chr7:23528340-23528393,chr7,23528340,23528393,0,27735038
H1|chr7:52680457-52680501,chr7,52680457,52680501,H1|chr7:30176619-30176742,chr7,30176619,30176742,0,22503838
H1|chr7:52796274-52796306,chr7,52796274,52796306,H1|chr7:65212606-65212648,chr7,65212606,65212648,0,12416332
H1|chr7:52847000-52847039,chr7,52847000,52847039,H1|chr7:25165373-25165505,chr7,25165373,25165505,0,27681627
H1|chr7:53838241-53838281,chr7,53838241,53838281,H1|chr7:75927872-75927954,chr7,75927872,75927954,0,22089631
H1|chr7:54258588-54258676,chr7,54258588,54258676,H1|chr7:100449366-100449406,chr7,100449366,100449406,0,46190778
H1|chr7:54366059-54366150,chr7,54366059,54366150,H1|chr7:131237344-131237381,chr7,131237344,131237381,0,76871285
H1|chr7:54680325-54680412,chr7,54680325,54680412,H1|chr7:24324351-24324372,chr7,24324351,24324372,0,30355974
H1|chr7:56265619-56265697,chr7,56265619,56265697,H1|chr7:73587505-73587586,chr7,73587505,73587586,0,17321886
H1|chr7:56274589-56274688,chr7,56274589,56274688,H1|chr7:23569486-23569529,chr7,23569486,23569529,0,32705103
H1|chr7:56502636-56502684,chr7,56502636,56502684,H1|chr7:100857888-100857961,chr7,100857888,100857961,0,44355252
H1|chr7:56722134-56722191,chr7,56722134,56722191,H1|chr7:99765386-99765434,chr7,99765386,99765434,0,43043252
H1|chr7:57044317-57044338,chr7,57044317,57044338,H1|chr7:30173166-30173225,chr7,30173166,30173225,0,26871151
H1|chr7:57234497-57234561,chr7,57234497,57234561,H1|chr7:2885680-2885766,chr7,2885680,2885766,0,54348817
H1|chr7:57495916-57495981,chr7,57495916,57495981,H1|chr7:150815060-150815144,chr7,150815060,150815144,0,93319144
H1|chr7:58029424-58029466,chr7,58029424,58029466,H1|chr7:121777830-121777911,chr7,121777830,121777911,0,63748406
H1|chr7:58482349-58482429,chr7,58482349,58482429,H1|chr7:121782533-121782568,chr7,121782533,121782568,0,63300184
H1|chr7:58691100-58691210,chr7,58691100,58691210,H1|chr7:24322683-24322723,chr7,24322683,24322723,0,34368417
H1|chr7:59281450-59281535,chr7,59281450,59281535,H1|chr7:74378462-74378499,chr7,74378462,74378499,0,15097012
H1|chr7:59483545-59483646,chr7,59483545,59483646,H1|chr7:100290043-100290092,chr7,100290043,100290092,0,40806498
H1|chr7:59552976-59553021,chr7,59552976,59553021,H1|chr7:23531581-23531710,chr7,23531581,23531710,0,36021395
H1|chr7:60617403-60617435,chr7,60617403,60617435,H1|chr7:65212606-65212648,chr7,65212606,65212648,0,4595203
H1|chr7:60849277-60849349,chr7,60849277,60849349,H1|chr7:97737684-97737701,chr7,97737684,97737701,0,36888407
H1|chr7:61268405-61268461,chr7,61268405,61268461,H1|chr7:121036143-121036237,chr7,121036143,121036237,0,59767738
H1|chr7:62820485-62820595,chr7,62820485,62820595,H1|chr7:121782045-121782085,chr7,121782045,121782085,0,58961560
H1|chr7:63931887-63931936,chr7,63931887,63931936,H1|chr7:121777774-121777827,chr7,121777774,121777827,0,57845887
H1|chr7:64921774-64921844,chr7,64921774,64921844,H1|chr7:121776882-121776962,chr7,121776882,121776962,0,56855108
H1|chr7:65191799-65191891,chr7,65191799,65191891,H1|chr7:23527364-23527413,chr7,23527364,23527413,0,41664435
H1|chr7:65363124-65363183,chr7,65363124,65363183,H1|chr7:26239401-26239491,chr7,26239401,26239491,0,39123723
H1|chr7:65635455-65635605,chr7,65635455,65635605,H1|chr7:50859380-50859412,chr7,50859380,50859412,0,14776075
H1|chr7:66018757-66018793,chr7,66018757,66018793,H1|chr7:121783473-121783621,chr7,121783473,121783621,0,55764716
H1|chr7:66063875-66063974,chr7,66063875,66063974,H1|chr7:148848397-148848462,chr7,148848397,148848462,0,82784522
H1|chr7:66544028-66544099,chr7,66544028,66544099,H1|chr7:97737684-97737701,chr7,97737684,97737701,0,31193656
H1|chr7:66607080-66607175,chr7,66607080,66607175,H1|chr7:148846059-148846096,chr7,148846059,148846096,0,82238979
H1|chr7:67084291-67084372,chr7,67084291,67084372,H1|chr7:23570662-23570752,chr7,23570662,23570752,0,43513629
H1|chr7:67237356-67237434,chr7,67237356,67237434,H1|chr7:2885680-2885766,chr7,2885680,2885766,0,64351676
H1|chr7:68945199-68945270,chr7,68945199,68945270,H1|chr7:97737684-97737701,chr7,97737684,97737701,0,28792485
H1|chr7:68973848-68973910,chr7,68973848,68973910,H1|chr7:23526923-23526967,chr7,23526923,23526967,0,45446925
H1|chr7:69125747-69125765,chr7,69125747,69125765,H1|chr7:148848377-148848462,chr7,148848377,148848462,0,79722630
H1|chr7:69206168-69206195,chr7,69206168,69206195,H1|chr7:30176619-30176742,chr7,30176619,30176742,0,39029549
H1|chr7:69245032-69245126,chr7,69245032,69245126,H1|chr7:102233199-102233236,chr7,102233199,102233236,0,32988167
H1|chr7:69411600-69411703,chr7,69411600,69411703,H1|chr7:131237836-131237883,chr7,131237836,131237883,0,61826236
H1|chr7:69588721-69588833,chr7,69588721,69588833,H1|chr7:82071938-82071971,chr7,82071938,82071971,0,12483217
H1|chr7:69747806-69747835,chr7,69747806,69747835,H1|chr7:121775618-121775685,chr7,121775618,121775685,0,52027812
H1|chr7:69887442-69887524,chr7,69887442,69887524,H1|chr7:121786935-121786978,chr7,121786935,121786978,0,51899493
H1|chr7:70153716-70153819,chr7,70153716,70153819,H1|chr7:24321429-24321467,chr7,24321429,24321467,0,45832287
H1|chr7:71881179-71881213,chr7,71881179,71881213,H1|chr7:121782755-121782776,chr7,121782755,121782776,0,49901576
H1|chr7:72029494-72029554,chr7,72029494,72029554,H1|chr7:121773850-121773919,chr7,121773850,121773919,0,49744356
H1|chr7:72045968-72046118,chr7,72045968,72046118,H1|chr7:102232273-102232422,chr7,102232273,102232422,0,30186305
H1|chr7:72382122-72382172,chr7,72382122,72382172,H1|chr7:101005884-101005947,chr7,101005884,101005947,0,28623762
H1|chr7:72433230-72433291,chr7,72433230,72433291,H1|chr7:75828085-75828129,chr7,75828085,75828129,0,3394855
H1|chr7:72844665-72844698,chr7,72844665,72844698,H1|chr7:5636233-5636332,chr7,5636233,5636332,0,67208432
H1|chr7:72997358-72997428,chr7,72997358,72997428,H1|chr7:121780111-121780180,chr7,121780111,121780180,0,48782753
H1|chr7:73328907-73328979,chr7,73328907,73328979,H1|chr7:97737684-97737701,chr7,97737684,97737701,0,24408777
H1|chr7:73407074-73407152,chr7,73407074,73407152,H1|chr7:121781450-121781498,chr7,121781450,121781498,0,48374376
H1|chr7:73644858-73644909,chr7,73644858,73644909,H1|chr7:121783065-121783102,chr7,121783065,121783102,0,48138207
H1|chr7:74398430-74398580,chr7,74398430,74398580,H1|chr7:102232256-102232404,chr7,102232256,102232404,0,27833826
H1|chr7:74425197-74425262,chr7,74425197,74425262,H1|chr7:101931264-101931291,chr7,101931264,101931291,0,27506067
H1|chr7:74946448-74946536,chr7,74946448,74946536,H1|chr7:23527364-23527413,chr7,23527364,23527413,0,51419084
H1|chr7:75212011-75212093,chr7,75212011,75212093,H1|chr7:121782533-121782568,chr7,121782533,121782568,0,46570522
H1|chr7:75447474-75447571,chr7,75447474,75447571,H1|chr7:121782045-121782084,chr7,121782045,121782084,0,46334571
H1|chr7:75712069-75712132,chr7,75712069,75712132,H1|chr7:23507186-23507248,chr7,23507186,23507248,0,52204883
H1|chr7:75875083-75875167,chr7,75875083,75875167,H1|chr7:121782205-121782248,chr7,121782205,121782248,0,45907122
H1|chr7:76008079-76008160,chr7,76008079,76008160,H1|chr7:23570662-23570752,chr7,23570662,23570752,0,52437417
H1|chr7:76379645-76379739,chr7,76379645,76379739,H1|chr7:72396715-72396865,chr7,72396715,72396865,0,3982930
H1|chr7:76435996-76436053,chr7,76435996,76436053,H1|chr7:7224273-7224327,chr7,7224273,7224327,0,69211723
H1|chr7:76545174-76545255,chr7,76545174,76545255,H1|chr7:74073694-74073759,chr7,74073694,74073759,0,2471480
H1|chr7:76619260-76619292,chr7,76619260,76619292,H1|chr7:99755627-99755694,chr7,99755627,99755694,0,23136367
H1|chr7:76857991-76858090,chr7,76857991,76858090,H1|chr7:23569486-23569529,chr7,23569486,23569529,0,53288505
H1|chr7:77335059-77335099,chr7,77335059,77335099,H1|chr7:131238333-131238389,chr7,131238333,131238389,0,53903274
H1|chr7:77434042-77434192,chr7,77434042,77434192,H1|chr7:43768164-43768219,chr7,43768164,43768219,0,33665878
H1|chr7:77692041-77692100,chr7,77692041,77692100,H1|chr7:26239401-26239491,chr7,26239401,26239491,0,51452640
H1|chr7:77936852-77936902,chr7,77936852,77936902,H1|chr7:121781290-121781327,chr7,121781290,121781327,0,43844438
H1|chr7:78388005-78388128,chr7,78388005,78388128,H1|chr7:41744259-41744282,chr7,41744259,41744282,0,36643746
H1|chr7:78524665-78524771,chr7,78524665,78524771,H1|chr7:35075861-35075899,chr7,35075861,35075899,0,43448804
H1|chr7:79282753-79282903,chr7,79282753,79282903,H1|chr7:112091785-112091848,chr7,112091785,112091848,0,32809032
H1|chr7:80674089-80674167,chr7,80674089,80674167,H1|chr7:100270089-100270161,chr7,100270089,100270161,0,19596000
H1|chr7:81123672-81123697,chr7,81123672,81123697,H1|chr7:121781739-121781808,chr7,121781739,121781808,0,40658067
H1|chr7:81332548-81332627,chr7,81332548,81332627,H1|chr7:23526269-23526321,chr7,23526269,23526321,0,57806279
H1|chr7:81711131-81711188,chr7,81711131,81711188,H1|chr7:99765386-99765434,chr7,99765386,99765434,0,18054255
H1|chr7:81884390-81884475,chr7,81884390,81884475,H1|chr7:150815060-150815130,chr7,150815060,150815130,0,68930670
H1|chr7:83380882-83380907,chr7,83380882,83380907,H1|chr7:121781739-121781808,chr7,121781739,121781808,0,38400857
H1|chr7:83821105-83821185,chr7,83821105,83821185,H1|chr7:121781452-121781498,chr7,121781452,121781498,0,37960347
H1|chr7:84264256-84264403,chr7,84264256,84264403,H1|chr7:24322683-24322723,chr7,24322683,24322723,0,59941573
H1|chr7:84494696-84494734,chr7,84494696,84494734,H1|chr7:70598551-70598649,chr7,70598551,70598649,0,13896145
H1|chr7:85531883-85531917,chr7,85531883,85531917,H1|chr7:23531998-23532078,chr7,23531998,23532078,0,61999885
H1|chr7:86656351-86656421,chr7,86656351,86656421,H1|chr7:121776882-121776962,chr7,121776882,121776962,0,35120531
H1|chr7:87889515-87889575,chr7,87889515,87889575,H1|chr7:1176752-1176807,chr7,1176752,1176807,0,86712763
H1|chr7:88104772-88104811,chr7,88104772,88104811,H1|chr7:121783895-121784038,chr7,121783895,121784038,0,33679123
H1|chr7:88137133-88137211,chr7,88137133,88137211,H1|chr7:2885680-2885766,chr7,2885680,2885766,0,85251453
H1|chr7:88525088-88525148,chr7,88525088,88525148,H1|chr7:26239401-26239491,chr7,26239401,26239491,0,62285687
H1|chr7:88935126-88935236,chr7,88935126,88935236,H1|chr7:121776882-121776962,chr7,121776882,121776962,0,32841756
H1|chr7:89201299-89201402,chr7,89201299,89201402,H1|chr7:135243479-135243518,chr7,135243479,135243518,0,46042180
H1|chr7:90131009-90131087,chr7,90131009,90131087,H1|chr7:100270089-100270161,chr7,100270089,100270161,0,10139080
H1|chr7:90190287-90190335,chr7,90190287,90190335,H1|chr7:100134649-100134721,chr7,100134649,100134721,0,9944362
H1|chr7:90316289-90316349,chr7,90316289,90316349,H1|chr7:121773850-121773919,chr7,121773850,121773919,0,31457561
H1|chr7:90584476-90584549,chr7,90584476,90584549,H1|chr7:26237759-26237823,chr7,26237759,26237823,0,64346717
H1|chr7:90695674-90695803,chr7,90695674,90695803,H1|chr7:2885730-2885766,chr7,2885730,2885766,0,87809944
H1|chr7:91922755-91922851,chr7,91922755,91922851,H1|chr7:50859380-50859412,chr7,50859380,50859412,0,41063375
H1|chr7:92282356-92282416,chr7,92282356,92282416,H1|chr7:1176752-1176807,chr7,1176752,1176807,0,91105604
H1|chr7:92365370-92365491,chr7,92365370,92365491,H1|chr7:41744259-41744282,chr7,41744259,41744282,0,50621111
H1|chr7:92780552-92780644,chr7,92780552,92780644,H1|chr7:148846059-148846096,chr7,148846059,148846096,0,56065507
H1|chr7:92791569-92791681,chr7,92791569,92791681,H1|chr7:5598170-5598217,chr7,5598170,5598217,0,87193399
H1|chr7:93065748-93065898,chr7,93065748,93065898,H1|chr7:102232273-102232423,chr7,102232273,102232423,0,9166525
H1|chr7:93455306-93455427,chr7,93455306,93455427,H1|chr7:41744259-41744282,chr7,41744259,41744282,0,51711047
H1|chr7:94390100-94390145,chr7,94390100,94390145,H1|chr7:121775654-121775757,chr7,121775654,121775757,0,27385554
H1|chr7:94639524-94639578,chr7,94639524,94639578,H1|chr7:74378462-74378499,chr7,74378462,74378499,0,20261062
H1|chr7:95099875-95099970,chr7,95099875,95099970,H1|chr7:148846059-148846096,chr7,148846059,148846096,0,53746184
H1|chr7:95525577-95525617,chr7,95525577,95525617,H1|chr7:97599717-97599829,chr7,97599717,97599829,0,2074140
H1|chr7:95589574-95589630,chr7,95589574,95589630,H1|chr7:131240633-131240668,chr7,131240633,131240668,0,35651059
H1|chr7:95672037-95672129,chr7,95672037,95672129,H1|chr7:23506773-23506910,chr7,23506773,23506910,0,72165264
H1|chr7:95704275-95704296,chr7,95704275,95704296,H1|chr7:30173166-30173225,chr7,30173166,30173225,0,65531109
H1|chr7:95802785-95802887,chr7,95802785,95802887,H1|chr7:73673114-73673207,chr7,73673114,73673207,0,22129671
H1|chr7:96019932-96019991,chr7,96019932,96019991,H1|chr7:1176752-1176807,chr7,1176752,1176807,0,94843180
H1|chr7:96603590-96603681,chr7,96603590,96603681,H1|chr7:131237344-131237381,chr7,131237344,131237381,0,34633754
H1|chr7:96921571-96921665,chr7,96921571,96921665,H1|chr7:102233199-102233236,chr7,102233199,102233236,0,5311628
H1|chr7:97214952-97214985,chr7,97214952,97214985,H1|chr7:121775654-121775752,chr7,121775654,121775752,0,24560702
H1|chr7:97293155-97293228,chr7,97293155,97293228,H1|chr7:105171355-105171422,chr7,105171355,105171422,0,7878200
H1|chr7:97317242-97317391,chr7,97317242,97317391,H1|chr7:5598093-5598133,chr7,5598093,5598133,0,91719149
H1|chr7:97352544-97352658,chr7,97352544,97352658,H1|chr7:50859380-50859412,chr7,50859380,50859412,0,46493164
H1|chr7:97369313-97369331,chr7,97369313,97369331,H1|chr7:25165373-25165505,chr7,25165373,25165505,0,72203940
H1|chr7:97484507-97484547,chr7,97484507,97484547,H1|chr7:150065220-150065252,chr7,150065220,150065252,0,52580713
H1|chr7:99429113-99429181,chr7,99429113,99429181,H1|chr7:130133939-130134006,chr7,130133939,130134006,0,30704826
H1|chr7:99609996-99610081,chr7,99609996,99610081,H1|chr7:26239106-26239157,chr7,26239106,26239157,0,73370890
H1|chr7:100904974-100905073,chr7,100904974,100905073,H1|chr7:99041539-99041657,chr7,99041539,99041657,0,1863435
H1|chr7:100950231-100950294,chr7,100950231,100950294,H1|chr7:23507186-23507248,chr7,23507186,23507248,0,77443045
H1|chr7:100995382-100995484,chr7,100995382,100995484,H1|chr7:104653776-104653808,chr7,104653776,104653808,0,3658394
H1|chr7:101096563-101096617,chr7,101096563,101096617,H1|chr7:102232325-102232419,chr7,102232325,102232419,0,1135762
H1|chr7:101796734-101796812,chr7,101796734,101796812,H1|chr7:44838018-44838110,chr7,44838018,44838110,0,56958716
H1|chr7:101926469-101926510,chr7,101926469,101926510,H1|chr7:24796473-24796521,chr7,24796473,24796521,0,77129996
H1|chr7:102008581-102008621,chr7,102008581,102008621,H1|chr7:131238333-131238389,chr7,131238333,131238389,0,29229752
H1|chr7:102393599-102393636,chr7,102393599,102393636,H1|chr7:97599717-97599829,chr7,97599717,97599829,0,4793882
H1|chr7:102659514-102659661,chr7,102659514,102659661,H1|chr7:73584825-73584888,chr7,73584825,73584888,0,29074689
H1|chr7:102803688-102803715,chr7,102803688,102803715,H1|chr7:30176619-30176742,chr7,30176619,30176742,0,72627069
H1|chr7:102821679-102821739,chr7,102821679,102821739,H1|chr7:23507184-23507249,chr7,23507184,23507249,0,79314495
H1|chr7:102995323-102995379,chr7,102995323,102995379,H1|chr7:131240633-131240668,chr7,131240633,131240668,0,28245310
H1|chr7:103374671-103374713,chr7,103374671,103374713,H1|chr7:100899451-100899559,chr7,100899451,100899559,0,2475220
H1|chr7:103449524-103449562,chr7,103449524,103449562,H1|chr7:70598551-70598649,chr7,70598551,70598649,0,32850973
H1|chr7:104412916-104413002,chr7,104412916,104413002,H1|chr7:74378462-74378499,chr7,74378462,74378499,0,30034454
H1|chr7:105010446-105010514,chr7,105010446,105010514,H1|chr7:121782220-121782241,chr7,121782220,121782241,0,16771774
H1|chr7:105167225-105167293,chr7,105167225,105167293,H1|chr7:130133939-130134006,chr7,130133939,130134006,0,24966714
H1|chr7:105182943-105182992,chr7,105182943,105182992,H1|chr7:121777379-121777498,chr7,121777379,121777498,0,16594436
H1|chr7:105780000-105780137,chr7,105780000,105780137,H1|chr7:121783876-121783932,chr7,121783876,121783932,0,16003876
H1|chr7:106241058-106241136,chr7,106241058,106241136,H1|chr7:44838018-44838110,chr7,44838018,44838110,0,61403040
H1|chr7:106448365-106448398,chr7,106448365,106448398,H1|chr7:5636233-5636332,chr7,5636233,5636332,0,100812132
H1|chr7:106448685-106448756,chr7,106448685,106448756,H1|chr7:93631846-93631925,chr7,93631846,93631925,0,12816839
H1|chr7:106553919-106553986,chr7,106553919,106553986,H1|chr7:100290832-100290882,chr7,100290832,100290882,0,6263087
H1|chr7:106556260-106556352,chr7,106556260,106556352,H1|chr7:23506773-23506910,chr7,23506773,23506910,0,83049487
H1|chr7:106752066-106752141,chr7,106752066,106752141,H1|chr7:26237759-26237823,chr7,26237759,26237823,0,80514307
H1|chr7:106884177-106884288,chr7,106884177,106884288,H1|chr7:121776882-121776962,chr7,121776882,121776962,0,14892705
H1|chr7:107105716-107105765,chr7,107105716,107105765,H1|chr7:148848043-148848120,chr7,148848043,148848120,0,41742327
H1|chr7:107866241-107866282,chr7,107866241,107866282,H1|chr7:72396406-72396475,chr7,72396406,72396475,0,35469835
H1|chr7:108361828-108361877,chr7,108361828,108361877,H1|chr7:121777379-121777498,chr7,121777379,121777498,0,13415551
H1|chr7:108556831-108556906,chr7,108556831,108556906,H1|chr7:121781347-121781422,chr7,121781347,121781422,0,13224516
H1|chr7:108682204-108682299,chr7,108682204,108682299,H1|chr7:43768164-43768219,chr7,43768164,43768219,0,64914040
H1|chr7:108801293-108801334,chr7,108801293,108801334,H1|chr7:24796473-24796521,chr7,24796473,24796521,0,84004820
H1|chr7:109335379-109335400,chr7,109335379,109335400,H1|chr7:149471545-149471644,chr7,149471545,149471644,0,40136166
H1|chr7:109772728-109772839,chr7,109772728,109772839,H1|chr7:121776882-121776962,chr7,121776882,121776962,0,12004154
H1|chr7:110156757-110156868,chr7,110156757,110156868,H1|chr7:82071938-82071971,chr7,82071938,82071971,0,28084819
H1|chr7:110655678-110655739,chr7,110655678,110655739,H1|chr7:75828085-75828129,chr7,75828085,75828129,0,34827593
H1|chr7:110980723-110980794,chr7,110980723,110980794,H1|chr7:93631846-93631925,chr7,93631846,93631925,0,17348877
H1|chr7:111008036-111008126,chr7,111008036,111008126,H1|chr7:131240224-131240246,chr7,131240224,131240246,0,20232188
H1|chr7:111036043-111036112,chr7,111036043,111036112,H1|chr7:104652796-104652910,chr7,104652796,104652910,0,6383247
H1|chr7:111470878-111471028,chr7,111470878,111471028,H1|chr7:102232273-102232422,chr7,102232273,102232422,0,9238605
H1|chr7:111481751-111481898,chr7,111481751,111481898,H1|chr7:24322683-24322723,chr7,24322683,24322723,0,87159068
H1|chr7:111567222-111567282,chr7,111567222,111567282,H1|chr7:23570662-23570752,chr7,23570662,23570752,0,87996560
H1|chr7:112525792-112525895,chr7,112525792,112525895,H1|chr7:5598170-5598217,chr7,5598170,5598217,0,106927622
H1|chr7:113031024-113031064,chr7,113031024,113031064,H1|chr7:75927872-75927954,chr7,75927872,75927954,0,37103152
H1|chr7:113474985-113475095,chr7,113474985,113475095,H1|chr7:121776882-121776962,chr7,121776882,121776962,0,8301897
H1|chr7:113959526-113959656,chr7,113959526,113959656,H1|chr7:93629813-93629833,chr7,93629813,93629833,0,20329713
H1|chr7:114044576-114044642,chr7,114044576,114044642,H1|chr7:93631846-93631925,chr7,93631846,93631925,0,20412730
H1|chr7:114611996-114612145,chr7,114611996,114612145,H1|chr7:5598093-5598133,chr7,5598093,5598133,0,109013903
H1|chr7:115254235-115254292,chr7,115254235,115254292,H1|chr7:97737684-97737701,chr7,97737684,97737701,0,17516551
H1|chr7:115291874-115291976,chr7,115291874,115291976,H1|chr7:70598810-70598835,chr7,70598810,70598835,0,44693064
H1|chr7:115300029-115300068,chr7,115300029,115300068,H1|chr7:121783895-121784038,chr7,121783895,121784038,0,6483866
H1|chr7:115452610-115452676,chr7,115452610,115452676,H1|chr7:100290832-100290882,chr7,100290832,100290882,0,15161778
H1|chr7:115547069-115547145,chr7,115547069,115547145,H1|chr7:100290930-100291004,chr7,100290930,100291004,0,15256139
H1|chr7:116263097-116263208,chr7,116263097,116263208,H1|chr7:72396715-72396865,chr7,72396715,72396865,0,43866382
H1|chr7:116600205-116600324,chr7,116600205,116600324,H1|chr7:100449366-100449428,chr7,100449366,100449428,0,16150839
H1|chr7:116645706-116645818,chr7,116645706,116645818,H1|chr7:82071938-82071971,chr7,82071938,82071971,0,34573768
H1|chr7:117359813-117359936,chr7,117359813,117359936,H1|chr7:41744259-41744282,chr7,41744259,41744282,0,75615554
H1|chr7:117927269-117927354,chr7,117927269,117927354,H1|chr7:26239106-26239157,chr7,26239106,26239157,0,91688163
H1|chr7:118493933-118493983,chr7,118493933,118493983,H1|chr7:121781290-121781327,chr7,121781290,121781327,0,3287357
H1|chr7:118942198-118942291,chr7,118942198,118942291,H1|chr7:151215677-151215699,chr7,151215677,151215699,0,32273479
H1|chr7:119325080-119325121,chr7,119325080,119325121,H1|chr7:121777830-121777911,chr7,121777830,121777911,0,2452750
H1|chr7:120512520-120512630,chr7,120512520,120512630,H1|chr7:24319059-24319101,chr7,24319059,24319101,0,96193461
H1|chr7:120983700-120983746,chr7,120983700,120983746,H1|chr7:138147970-138148063,chr7,138147970,138148063,0,17164270
H1|chr7:121065114-121065143,chr7,121065114,121065143,H1|chr7:121775618-121775685,chr7,121775618,121775685,0,710504
H1|chr7:121592765-121592821,chr7,121592765,121592821,H1|chr7:23529304-23529448,chr7,23529304,23529448,0,98063461
H1|chr7:122046169-122046229,chr7,122046169,122046229,H1|chr7:131238950-131239021,chr7,131238950,131239021,0,9192781
H1|chr7:122568814-122568924,chr7,122568814,122568924,H1|chr7:2885730-2885766,chr7,2885730,2885766,0,119683084
H1|chr7:122590184-122590279,chr7,122590184,122590279,H1|chr7:43768164-43768219,chr7,43768164,43768219,0,78822020
H1|chr7:123025042-123025098,chr7,123025042,123025098,H1|chr7:121036143-121036237,chr7,121036143,121036237,0,1988899
H1|chr7:123121926-123121999,chr7,123121926,123121999,H1|chr7:26237759-26237823,chr7,26237759,26237823,0,96884167
H1|chr7:123291582-123291719,chr7,123291582,123291719,H1|chr7:43768164-43768219,chr7,43768164,43768219,0,79523418
H1|chr7:123617382-123617433,chr7,123617382,123617433,H1|chr7:121783065-121783102,chr7,121783065,121783102,0,1834317
H1|chr7:123780406-123780439,chr7,123780406,123780439,H1|chr7:99755627-99755694,chr7,99755627,99755694,0,24024779
H1|chr7:124124400-124124507,chr7,124124400,124124507,H1|chr7:131237836-131237883,chr7,131237836,131237883,0,7113436
H1|chr7:124194319-124194340,chr7,124194319,124194340,H1|chr7:149471545-149471644,chr7,149471545,149471644,0,25277226
H1|chr7:124558517-124558567,chr7,124558517,124558567,H1|chr7:70598873-70598971,chr7,70598873,70598971,0,53959644
H1|chr7:124871887-124872024,chr7,124871887,124872024,H1|chr7:121783876-121783932,chr7,121783876,121783932,0,3088011
H1|chr7:125005482-125005500,chr7,125005482,125005500,H1|chr7:25165373-25165505,chr7,25165373,25165505,0,99840109
H1|chr7:125251843-125251958,chr7,125251843,125251958,H1|chr7:131237235-131237270,chr7,131237235,131237270,0,5985392
H1|chr7:125904486-125904591,chr7,125904486,125904591,H1|chr7:135243479-135243518,chr7,135243479,135243518,0,9338993
H1|chr7:126137757-126137799,chr7,126137757,126137799,H1|chr7:100899451-100899559,chr7,100899451,100899559,0,25238306
H1|chr7:126520558-126520597,chr7,126520558,126520597,H1|chr7:150065219-150065287,chr7,150065219,150065287,0,23544661
H1|chr7:127790233-127790267,chr7,127790233,127790267,H1|chr7:75927112-75927262,chr7,75927112,75927262,0,51863121
H1|chr7:127901989-127902069,chr7,127901989,127902069,H1|chr7:121781452-121781498,chr7,121781452,121781498,0,6120537
H1|chr7:127974442-127974539,chr7,127974442,127974539,H1|chr7:23529129-23529257,chr7,23529129,23529257,0,104445313
H1|chr7:128358439-128358508,chr7,128358439,128358508,H1|chr7:104652796-104652910,chr7,104652796,104652910,0,23705643
H1|chr7:128812136-128812188,chr7,128812136,128812188,H1|chr7:121775654-121775752,chr7,121775654,121775752,0,7036482
H1|chr7:129461039-129461085,chr7,129461039,129461085,H1|chr7:129590843-129590922,chr7,129590843,129590922,0,129804
H1|chr7:129617101-129617157,chr7,129617101,129617157,H1|chr7:99822192-99822294,chr7,99822192,99822294,0,29794909
H1|chr7:129746393-129746515,chr7,129746393,129746515,H1|chr7:148791208-148791263,chr7,148791208,148791263,0,19044815
H1|chr7:129986567-129986590,chr7,129986567,129986590,H1|chr7:149471545-149471644,chr7,149471545,149471644,0,19484978
H1|chr7:130564137-130564217,chr7,130564137,130564217,H1|chr7:129590164-129590209,chr7,129590164,129590209,0,973973
H1|chr7:130570580-130570674,chr7,130570580,130570674,H1|chr7:131237344-131237381,chr7,131237344,131237381,0,666764
H1|chr7:130926956-130927046,chr7,130926956,130927046,H1|chr7:82071938-82071971,chr7,82071938,82071971,0,48855018
H1|chr7:131558717-131558805,chr7,131558717,131558805,H1|chr7:23527364-23527413,chr7,23527364,23527413,0,108031353
H1|chr7:131792952-131793013,chr7,131792952,131793013,H1|chr7:121775421-121775475,chr7,121775421,121775475,0,10017531
H1|chr7:131817582-131817692,chr7,131817582,131817692,H1|chr7:24322683-24322723,chr7,24322683,24322723,0,107494899
H1|chr7:131918485-131918561,chr7,131918485,131918561,H1|chr7:100290930-100291004,chr7,100290930,100291004,0,31627555
H1|chr7:131988900-131989011,chr7,131988900,131989011,H1|chr7:72396715-72396865,chr7,72396715,72396865,0,59592185
H1|chr7:132182218-132182317,chr7,132182218,132182317,H1|chr7:148848397-148848462,chr7,148848397,148848462,0,16666179
H1|chr7:132241629-132241725,chr7,132241629,132241725,H1|chr7:23526772-23526814,chr7,23526772,23526814,0,108714857
H1|chr7:132391617-132391656,chr7,132391617,132391656,H1|chr7:150065219-150065287,chr7,150065219,150065287,0,17673602
H1|chr7:132440530-132440578,chr7,132440530,132440578,H1|chr7:100857888-100857961,chr7,100857888,100857961,0,31582642
H1|chr7:132563641-132563707,chr7,132563641,132563707,H1|chr7:101931264-101931291,chr7,101931264,101931291,0,30632377
H1|chr7:133598128-133598224,chr7,133598128,133598224,H1|chr7:100290930-100291004,chr7,100290930,100291004,0,33307198
H1|chr7:135106112-135106222,chr7,135106112,135106222,H1|chr7:2885730-2885766,chr7,2885730,2885766,0,132220382
H1|chr7:135491809-135491947,chr7,135491809,135491947,H1|chr7:102232272-102232420,chr7,102232272,102232420,0,33259537
H1|chr7:135769108-135769206,chr7,135769108,135769206,H1|chr7:35075861-35075905,chr7,35075861,35075905,0,100693247
H1|chr7:135853168-135853233,chr7,135853168,135853233,H1|chr7:150815060-150815144,chr7,150815060,150815144,0,14961892
H1|chr7:136075481-136075519,chr7,136075481,136075519,H1|chr7:75828289-75828334,chr7,75828289,75828334,0,60247192
H1|chr7:136110227-136110264,chr7,136110227,136110264,H1|chr7:97599717-97599829,chr7,97599717,97599829,0,38510510
H1|chr7:137097257-137097291,chr7,137097257,137097291,H1|chr7:121782755-121782776,chr7,121782755,121782776,0,15314502
H1|chr7:137158087-137158181,chr7,137158087,137158181,H1|chr7:121783876-121783932,chr7,121783876,121783932,0,15374211
H1|chr7:137792652-137792728,chr7,137792652,137792728,H1|chr7:121035958-121035998,chr7,121035958,121035998,0,16756694
H1|chr7:138020337-138020487,chr7,138020337,138020487,H1|chr7:100134678-100134720,chr7,100134678,100134720,0,37885659
H1|chr7:138376865-138376971,chr7,138376865,138376971,H1|chr7:35075861-35075899,chr7,35075861,35075899,0,103301004
H1|chr7:138377308-138377412,chr7,138377308,138377412,H1|chr7:100876901-100876941,chr7,100876901,100876941,0,37500407
H1|chr7:138920003-138920115,chr7,138920003,138920115,H1|chr7:138147983-138148054,chr7,138147983,138148054,0,772020
H1|chr7:139468253-139468356,chr7,139468253,139468356,H1|chr7:5598170-5598217,chr7,5598170,5598217,0,133870083
H1|chr7:140733533-140733599,chr7,140733533,140733599,H1|chr7:101931264-101931291,chr7,101931264,101931291,0,38802269
H1|chr7:140976944-140977006,chr7,140976944,140977006,H1|chr7:70599033-70599103,chr7,70599033,70599103,0,70377911
H1|chr7:141274526-141274601,chr7,141274526,141274601,H1|chr7:121781347-121781422,chr7,121781347,121781422,0,19493179
H1|chr7:141959052-141959131,chr7,141959052,141959131,H1|chr7:23526269-23526321,chr7,23526269,23526321,0,118432783
H1|chr7:142585743-142585769,chr7,142585743,142585769,H1|chr7:100270089-100270153,chr7,100270089,100270153,0,42315654
H1|chr7:143011815-143011893,chr7,143011815,143011893,H1|chr7:23506773-23506910,chr7,23506773,23506910,0,119505042
H1|chr7:143201173-143201233,chr7,143201173,143201233,H1|chr7:26239401-26239491,chr7,26239401,26239491,0,116961772
H1|chr7:143650248-143650339,chr7,143650248,143650339,H1|chr7:23532517-23532576,chr7,23532517,23532576,0,120117731
H1|chr7:144019122-144019220,chr7,144019122,144019220,H1|chr7:35075861-35075905,chr7,35075861,35075905,0,108943261
H1|chr7:145122119-145122152,chr7,145122119,145122152,H1|chr7:121775654-121775752,chr7,121775654,121775752,0,23346465
H1|chr7:145395775-145395873,chr7,145395775,145395873,H1|chr7:102233190-102233241,chr7,102233190,102233241,0,43162585
H1|chr7:145410400-145410450,chr7,145410400,145410450,H1|chr7:70598873-70598971,chr7,70598873,70598971,0,74811527
H1|chr7:146112970-146113073,chr7,146112970,146113073,H1|chr7:23532517-23532576,chr7,23532517,23532576,0,122580453
H1|chr7:146747137-146747244,chr7,146747137,146747244,H1|chr7:131237836-131237883,chr7,131237836,131237883,0,15509301
H1|chr7:146797672-146797784,chr7,146797672,146797784,H1|chr7:5598170-5598217,chr7,5598170,5598217,0,141199502
H1|chr7:147344330-147344416,chr7,147344330,147344416,H1|chr7:74378462-74378499,chr7,74378462,74378499,0,72965868
H1|chr7:147452983-147453039,chr7,147452983,147453039,H1|chr7:23529304-23529448,chr7,23529304,23529448,0,123923679
H1|chr7:147948634-147948784,chr7,147948634,147948784,H1|chr7:102233168-102233318,chr7,102233168,102233318,0,45715466
H1|chr7:148201333-148201436,chr7,148201333,148201436,H1|chr7:135243479-135243518,chr7,135243479,135243518,0,12957854
H1|chr7:148549725-148549785,chr7,148549725,148549785,H1|chr7:23507184-23507249,chr7,23507184,23507249,0,125042541
H1|chr7:148700390-148700537,chr7,148700390,148700537,H1|chr7:73584825-73584888,chr7,73584825,73584888,0,75115565
H1|chr7:149519941-149520047,chr7,149519941,149520047,H1|chr7:131240188-131240237,chr7,131240188,131240237,0,18279753
H1|chr7:149651607-149651757,chr7,149651607,149651757,H1|chr7:102232256-102232404,chr7,102232256,102232404,0,47419351
H1|chr7:149714411-149714431,chr7,149714411,149714431,H1|chr7:149471545-149471644,chr7,149471545,149471644,0,242866
H1|chr7:149917740-149917887,chr7,149917740,149917887,H1|chr7:102232321-102232471,chr7,102232321,102232471,0,47685419
H1|chr7:150510542-150510607,chr7,150510542,150510607,H1|chr7:102232346-102232496,chr7,102232346,102232496,0,48278196
H1|chr7:151743767-151743840,chr7,151743767,151743840,H1|chr7:105171355-105171422,chr7,105171355,105171422,0,46572412
H1|chr7:151813530-151813568,chr7,151813530,151813568,H1|chr7:75828289-75828334,chr7,75828289,75828334,0,75985241
H1|chr7:151969894-151969988,chr7,151969894,151969988,H1|chr7:72396715-72396865,chr7,72396715,72396865,0,79573179
H1|chr7:152515536-152515598,chr7,152515536,152515598,H1|chr7:1176752-1176807,chr7,1176752,1176807,0,151338784
H1|chr7:152884230-152884287,chr7,152884230,152884287,H1|chr7:7224273-7224327,chr7,7224273,7224327,0,145659957
H1|chr7:153740736-153740776,chr7,153740736,153740776,H1|chr7:97599717-97599829,chr7,97599717,97599829,0,56141019
H1|chr7:153750240-153750324,chr7,153750240,153750324,H1|chr7:121782205-121782248,chr7,121782205,121782248,0,31968035
H1|chr7:153895571-153895631,chr7,153895571,153895631,H1|chr7:102232318-102232428,chr7,102232318,102232428,0,51663253
H1|chr7:154722744-154722839,chr7,154722744,154722839,H1|chr7:121035703-121035734,chr7,121035703,121035734,0,33687041
H1|chr7:154792022-154792098,chr7,154792022,154792098,H1|chr7:121035958-121035998,chr7,121035958,121035998,0,33756064
H1|chr7:154846669-154846700,chr7,154846669,154846700,H1|chr7:121777379-121777498,chr7,121777379,121777498,0,33069290
H1|chr7:155064852-155064999,chr7,155064852,155064999,H1|chr7:102232321-102232471,chr7,102232321,102232471,0,52832531
H1|chr7:155143188-155143258,chr7,155143188,155143258,H1|chr7:121780398-121780523,chr7,121780398,121780523,0,33362790
H1|chr7:155160832-155160879,chr7,155160832,155160879,H1|chr7:100857888-100857961,chr7,100857888,100857961,0,54302944
H1|chr7:155557744-155557841,chr7,155557744,155557841,H1|chr7:23529129-23529257,chr7,23529129,23529257,0,132028615
H1|chr7:155582451-155582540,chr7,155582451,155582540,H1|chr7:35075861-35075905,chr7,35075861,35075905,0,120506590
H1|chr7:155946735-155946754,chr7,155946735,155946754,H1|chr7:23533063-23533213,chr7,23533063,23533213,0,132413672
H1|chr7:156078518-156078571,chr7,156078518,156078571,H1|chr7:44838018-44838110,chr7,44838018,44838110,0,111240500
H1|chr7:156286959-156287050,chr7,156286959,156287050,H1|chr7:23532517-23532576,chr7,23532517,23532576,0,132754442
H1|chr7:156475793-156475874,chr7,156475793,156475874,H1|chr7:74073694-74073759,chr7,74073694,74073759,0,82402099
H1|chr7:156697890-156697958,chr7,156697890,156697958,H1|chr7:121782220-121782241,chr7,121782220,121782241,0,34915670
H1|chr7:157146983-157147085,chr7,157146983,157147085,H1|chr7:104653776-104653808,chr7,104653776,104653808,0,52493207
H1|chr7:157473265-157473361,chr7,157473265,157473361,H1|chr7:23526772-23526814,chr7,23526772,23526814,0,133946493
H1|chr7:158233255-158233309,chr7,158233255,158233309,H1|chr7:24318914-24318982,chr7,24318914,24318982,0,133914341
H1|chr7:158336046-158336105,chr7,158336046,158336105,H1|chr7:1176752-1176807,chr7,1176752,1176807,0,157159294
H1|chr7:158969007-158969041,chr7,158969007,158969041,H1|chr7:23531998-23532078,chr7,23531998,23532078,0,135437009
H1|chr8:43292-43320,chr8,43292,43320,H1|chr8:74658137-74658218,chr8,74658137,74658218,0,74614845
H1|chr8:508226-508259,chr8,508226,508259,H1|chr8:56792192-56792309,chr8,56792192,56792309,0,56283966
H1|chr8:611913-611987,chr8,611913,611987,H1|chr8:144674345-144674390,chr8,144674345,144674390,0,144062432
H1|chr8:673652-673756,chr8,673652,673756,H1|chr8:42394212-42394258,chr8,42394212,42394258,0,41720560
H1|chr8:960240-960299,chr8,960240,960299,H1|chr8:93109457-93109548,chr8,93109457,93109548,0,92149217
H1|chr8:1001485-1001527,chr8,1001485,1001527,H1|chr8:70988579-70988647,chr8,70988579,70988647,0,69987094
H1|chr8:1566401-1566425,chr8,1566401,1566425,H1|chr8:91655098-91655139,chr8,91655098,91655139,0,90088697
H1|chr8:2602908-2602938,chr8,2602908,2602938,H1|chr8:103426991-103427060,chr8,103426991,103427060,0,100824083
H1|chr8:3057790-3057845,chr8,3057790,3057845,H1|chr8:54933316-54933384,chr8,54933316,54933384,0,51875526
H1|chr8:3621621-3621671,chr8,3621621,3621671,H1|chr8:103423132-103423199,chr8,103423132,103423199,0,99801511
H1|chr8:3684283-3684338,chr8,3684283,3684338,H1|chr8:54933316-54933384,chr8,54933316,54933384,0,51249033
H1|chr8:4357935-4357986,chr8,4357935,4357986,H1|chr8:30243420-30243469,chr8,30243420,30243469,0,25885485
H1|chr8:4490103-4490173,chr8,4490103,4490173,H1|chr8:1768905-1768982,chr8,1768905,1768982,0,2721198
H1|chr8:4877403-4877495,chr8,4877403,4877495,H1|chr8:82541847-82541871,chr8,82541847,82541871,0,77664444
H1|chr8:5087977-5088077,chr8,5087977,5088077,H1|chr8:128749499-128749593,chr8,128749499,128749593,0,123661522
H1|chr8:5236316-5236390,chr8,5236316,5236390,H1|chr8:38321501-38321577,chr8,38321501,38321577,0,33085185
H1|chr8:5290485-5290580,chr8,5290485,5290580,H1|chr8:119121871-119121920,chr8,119121871,119121920,0,113831386
H1|chr8:5682851-5682897,chr8,5682851,5682897,H1|chr8:56986523-56986551,chr8,56986523,56986551,0,51303672
H1|chr8:5731703-5731805,chr8,5731703,5731805,H1|chr8:73921780-73921930,chr8,73921780,73921930,0,68190077
H1|chr8:5752531-5752555,chr8,5752531,5752555,H1|chr8:1773098-1773203,chr8,1773098,1773203,0,3979433
H1|chr8:5813475-5813519,chr8,5813475,5813519,H1|chr8:103872551-103872657,chr8,103872551,103872657,0,98059076
H1|chr8:5990239-5990304,chr8,5990239,5990304,H1|chr8:103427114-103427161,chr8,103427114,103427161,0,97436875
H1|chr8:6214477-6214555,chr8,6214477,6214555,H1|chr8:1772719-1772739,chr8,1772719,1772739,0,4441758
H1|chr8:6600842-6600911,chr8,6600842,6600911,H1|chr8:103429182-103429262,chr8,103429182,103429262,0,96828340
H1|chr8:6790971-6791023,chr8,6790971,6791023,H1|chr8:133788188-133788260,chr8,133788188,133788260,0,126997217
H1|chr8:6950479-6950604,chr8,6950479,6950604,H1|chr8:11057566-11057588,chr8,11057566,11057588,0,4107087
H1|chr8:7305719-7305867,chr8,7305719,7305867,H1|chr8:37919237-37919310,chr8,37919237,37919310,0,30613518
H1|chr8:7318647-7318726,chr8,7318647,7318726,H1|chr8:37755540-37755566,chr8,37755540,37755566,0,30436893
H1|chr8:7540407-7540429,chr8,7540407,7540429,H1|chr8:42396197-42396313,chr8,42396197,42396313,0,34855790
H1|chr8:7561082-7561171,chr8,7561082,7561171,H1|chr8:144415475-144415535,chr8,144415475,144415535,0,136854393
H1|chr8:7667200-7667257,chr8,7667200,7667257,H1|chr8:57126080-57126212,chr8,57126080,57126212,0,49458880
H1|chr8:7854262-7854366,chr8,7854262,7854366,H1|chr8:103873878-103873904,chr8,103873878,103873904,0,96019616
H1|chr8:8158599-8158661,chr8,8158599,8158661,H1|chr8:98657853-98657921,chr8,98657853,98657921,0,90499254
H1|chr8:8734876-8734939,chr8,8734876,8734939,H1|chr8:39760962-39761017,chr8,39760962,39761017,0,31026086
H1|chr8:8809534-8809615,chr8,8809534,8809615,H1|chr8:35094603-35094672,chr8,35094603,35094672,0,26285069
H1|chr8:9958482-9958567,chr8,9958482,9958567,H1|chr8:27636793-27636829,chr8,27636793,27636829,0,17678311
H1|chr8:10179005-10179121,chr8,10179005,10179121,H1|chr8:28749086-28749158,chr8,28749086,28749158,0,18570081
H1|chr8:10360221-10360367,chr8,10360221,10360367,H1|chr8:103423132-103423199,chr8,103423132,103423199,0,93062911
H1|chr8:10794055-10794079,chr8,10794055,10794079,H1|chr8:1773098-1773203,chr8,1773098,1773203,0,9020957
H1|chr8:11460871-11460957,chr8,11460871,11460957,H1|chr8:28749030-28749136,chr8,28749030,28749136,0,17288159
H1|chr8:11608537-11608611,chr8,11608537,11608611,H1|chr8:131028137-131028169,chr8,131028137,131028169,0,119419600
H1|chr8:11632260-11632410,chr8,11632260,11632410,H1|chr8:35094603-35094672,chr8,35094603,35094672,0,23462343
H1|chr8:12556830-12556861,chr8,12556830,12556861,H1|chr8:73924835-73924907,chr8,73924835,73924907,0,61368005
H1|chr8:12570009-12570132,chr8,12570009,12570132,H1|chr8:11057566-11057588,chr8,11057566,11057588,0,1512443
H1|chr8:13527328-13527356,chr8,13527328,13527356,H1|chr8:42357029-42357123,chr8,42357029,42357123,0,28829701
H1|chr8:13891877-13891944,chr8,13891877,13891944,H1|chr8:91656502-91656546,chr8,91656502,91656546,0,77764625
H1|chr8:14437348-14437426,chr8,14437348,14437426,H1|chr8:27629696-27629767,chr8,27629696,27629767,0,13192348
H1|chr8:14737158-14737216,chr8,14737158,14737216,H1|chr8:128747501-128747587,chr8,128747501,128747587,0,114010343
H1|chr8:14738620-14738719,chr8,14738620,14738719,H1|chr8:93113125-93113188,chr8,93113125,93113188,0,78374505
H1|chr8:15414547-15414584,chr8,15414547,15414584,H1|chr8:91657183-91657232,chr8,91657183,91657232,0,76242636
H1|chr8:15691176-15691258,chr8,15691176,15691258,H1|chr8:27636793-27636829,chr8,27636793,27636829,0,11945617
H1|chr8:16007135-16007172,chr8,16007135,16007172,H1|chr8:91657183-91657232,chr8,91657183,91657232,0,75650048
H1|chr8:16202049-16202114,chr8,16202049,16202114,H1|chr8:73923034-73923085,chr8,73923034,73923085,0,57720985
H1|chr8:16240699-16240742,chr8,16240699,16240742,H1|chr8:1767693-1767777,chr8,1767693,1767777,0,14473006
H1|chr8:16307739-16307789,chr8,16307739,16307789,H1|chr8:103423132-103423199,chr8,103423132,103423199,0,87115393
H1|chr8:17025729-17025876,chr8,17025729,17025876,H1|chr8:35093748-35093777,chr8,35093748,35093777,0,18068019
H1|chr8:17158157-17158236,chr8,17158157,17158236,H1|chr8:493948-493999,chr8,493948,493999,0,16664209
H1|chr8:17387903-17388053,chr8,17387903,17388053,H1|chr8:91655018-91655080,chr8,91655018,91655080,0,74267115
H1|chr8:17877677-17877727,chr8,17877677,17877727,H1|chr8:130951401-130951469,chr8,130951401,130951469,0,113073724
H1|chr8:18053126-18053274,chr8,18053126,18053274,H1|chr8:37919237-37919310,chr8,37919237,37919310,0,19866111
H1|chr8:18266135-18266181,chr8,18266135,18266181,H1|chr8:130951528-130951601,chr8,130951528,130951601,0,112685393
H1|chr8:18344433-18344466,chr8,18344433,18344466,H1|chr8:73924835-73924907,chr8,73924835,73924907,0,55580402
H1|chr8:19413618-19413714,chr8,19413618,19413714,H1|chr8:56789286-56789326,chr8,56789286,56789326,0,37375668
H1|chr8:19887166-19887190,chr8,19887166,19887190,H1|chr8:91655098-91655139,chr8,91655098,91655139,0,71767932
H1|chr8:21167078-21167185,chr8,21167078,21167185,H1|chr8:42013230-42013269,chr8,42013230,42013269,0,20846152
H1|chr8:21594927-21594979,chr8,21594927,21594979,H1|chr8:101732631-101732654,chr8,101732631,101732654,0,80137704
H1|chr8:21847456-21847537,chr8,21847456,21847537,H1|chr8:35094603-35094672,chr8,35094603,35094672,0,13247147
H1|chr8:22174116-22174266,chr8,22174116,22174266,H1|chr8:124290430-124290575,chr8,124290430,124290575,0,102116314
H1|chr8:22195884-22195978,chr8,22195884,22195978,H1|chr8:73923153-73923248,chr8,73923153,73923248,0,51727269
H1|chr8:22530916-22530966,chr8,22530916,22530966,H1|chr8:30243419-30243469,chr8,30243419,30243469,0,7712503
H1|chr8:23213765-23213860,chr8,23213765,23213860,H1|chr8:119121871-119121920,chr8,119121871,119121920,0,95908106
H1|chr8:23771554-23771626,chr8,23771554,23771626,H1|chr8:30247013-30247050,chr8,30247013,30247050,0,6475459
H1|chr8:23775584-23775642,chr8,23775584,23775642,H1|chr8:11056944-11057036,chr8,11056944,11057036,0,12718640
H1|chr8:23989618-23989650,chr8,23989618,23989650,H1|chr8:37919982-37920064,chr8,37919982,37920064,0,13930364
H1|chr8:24291021-24291098,chr8,24291021,24291098,H1|chr8:37755540-37755566,chr8,37755540,37755566,0,13464519
H1|chr8:24344376-24344486,chr8,24344376,24344486,H1|chr8:38324958-38325019,chr8,38324958,38325019,0,13980582
H1|chr8:24377269-24377313,chr8,24377269,24377313,H1|chr8:28749030-28749136,chr8,28749030,28749136,0,4371761
H1|chr8:24834710-24834777,chr8,24834710,24834777,H1|chr8:119121739-119121758,chr8,119121739,119121758,0,94287029
H1|chr8:24848446-24848495,chr8,24848446,24848495,H1|chr8:107283534-107283632,chr8,107283534,107283632,0,82435088
H1|chr8:24914826-24914901,chr8,24914826,24914901,H1|chr8:54936424-54936473,chr8,54936424,54936473,0,30021598
H1|chr8:24965004-24965042,chr8,24965004,24965042,H1|chr8:101166583-101166661,chr8,101166583,101166661,0,76201579
H1|chr8:25058305-25058426,chr8,25058305,25058426,H1|chr8:35093748-35093777,chr8,35093748,35093777,0,10035443
H1|chr8:25371356-25371427,chr8,25371356,25371427,H1|chr8:73924839-73924908,chr8,73924839,73924908,0,48553483
H1|chr8:25477590-25477633,chr8,25477590,25477633,H1|chr8:56792192-56792309,chr8,56792192,56792309,0,31314602
H1|chr8:25651961-25652108,chr8,25651961,25652108,H1|chr8:70987660-70987690,chr8,70987660,70987690,0,45335699
H1|chr8:25761229-25761311,chr8,25761229,25761311,H1|chr8:101168752-101168788,chr8,101168752,101168788,0,75407523
H1|chr8:26376843-26376869,chr8,26376843,26376869,H1|chr8:30245484-30245573,chr8,30245484,30245573,0,3868641
H1|chr8:26801190-26801297,chr8,26801190,26801297,H1|chr8:42013230-42013269,chr8,42013230,42013269,0,15212040
H1|chr8:27304827-27304911,chr8,27304827,27304911,H1|chr8:93113125-93113188,chr8,93113125,93113188,0,65808298
H1|chr8:27352695-27352758,chr8,27352695,27352758,H1|chr8:98657853-98657921,chr8,98657853,98657921,0,71305158
H1|chr8:27552546-27552621,chr8,27552546,27552621,H1|chr8:37755540-37755566,chr8,37755540,37755566,0,10202994
H1|chr8:27747010-27747043,chr8,27747010,27747043,H1|chr8:28560219-28560325,chr8,28560219,28560325,0,813209
H1|chr8:27820849-27820918,chr8,27820849,27820918,H1|chr8:145981975-145982056,chr8,145981975,145982056,0,118161126
H1|chr8:27848312-27848349,chr8,27848312,27848349,H1|chr8:144655916-144655947,chr8,144655916,144655947,0,116807604
H1|chr8:27920170-27920320,chr8,27920170,27920320,H1|chr8:103873965-103874002,chr8,103873965,103874002,0,75953795
H1|chr8:28130557-28130599,chr8,28130557,28130599,H1|chr8:42012917-42013047,chr8,42012917,42013047,0,13882360
H1|chr8:28275336-28275390,chr8,28275336,28275390,H1|chr8:11661825-11661861,chr8,11661825,11661861,0,16613511
H1|chr8:29185840-29185886,chr8,29185840,29185886,H1|chr8:130951406-130951472,chr8,130951406,130951472,0,101765566
H1|chr8:29400810-29400870,chr8,29400810,29400870,H1|chr8:73924750-73924886,chr8,73924750,73924886,0,44523940
H1|chr8:29600412-29600471,chr8,29600412,29600471,H1|chr8:115295989-115296080,chr8,115295989,115296080,0,85695577
H1|chr8:29619552-29619609,chr8,29619552,29619609,H1|chr8:57126080-57126212,chr8,57126080,57126212,0,27506528
H1|chr8:29848633-29848675,chr8,29848633,29848675,H1|chr8:103422930-103423068,chr8,103422930,103423068,0,73574297
H1|chr8:29870425-29870473,chr8,29870425,29870473,H1|chr8:1772648-1772739,chr8,1772648,1772739,0,28097777
H1|chr8:30600191-30600211,chr8,30600191,30600211,H1|chr8:37960377-37960507,chr8,37960377,37960507,0,7360186
H1|chr8:31039474-31039585,chr8,31039474,31039585,H1|chr8:30246917-30246935,chr8,30246917,30246935,0,792557
H1|chr8:31123665-31123726,chr8,31123665,31123726,H1|chr8:103872551-103872657,chr8,103872551,103872657,0,72748886
H1|chr8:31674400-31674437,chr8,31674400,31674437,H1|chr8:35093860-35093886,chr8,35093860,35093886,0,3419460
H1|chr8:31897395-31897515,chr8,31897395,31897515,H1|chr8:30247127-30247157,chr8,30247127,30247157,0,1650268
H1|chr8:33576866-33576908,chr8,33576866,33576908,H1|chr8:42012917-42013047,chr8,42012917,42013047,0,8436051
H1|chr8:33756551-33756617,chr8,33756551,33756617,H1|chr8:73923034-73923085,chr8,73923034,73923085,0,40166483
H1|chr8:34612925-34613002,chr8,34612925,34613002,H1|chr8:37755540-37755566,chr8,37755540,37755566,0,3142615
H1|chr8:34670953-34671019,chr8,34670953,34671019,H1|chr8:73923034-73923085,chr8,73923034,73923085,0,39252081
H1|chr8:34689943-34689987,chr8,34689943,34689987,H1|chr8:131027766-131027855,chr8,131027766,131027855,0,96337823
H1|chr8:34697931-34698081,chr8,34697931,34698081,H1|chr8:124290430-124290575,chr8,124290430,124290575,0,89592499
H1|chr8:35114656-35114726,chr8,35114656,35114726,H1|chr8:1768905-1768982,chr8,1768905,1768982,0,33345751
H1|chr8:35439776-35439858,chr8,35439776,35439858,H1|chr8:63162422-63162465,chr8,63162422,63162465,0,27722646
H1|chr8:35459205-35459289,chr8,35459205,35459289,H1|chr8:93113125-93113188,chr8,93113125,93113188,0,57653920
H1|chr8:35563202-35563281,chr8,35563202,35563281,H1|chr8:493948-493999,chr8,493948,493999,0,35069254
H1|chr8:36650362-36650383,chr8,36650362,36650383,H1|chr8:128751356-128751443,chr8,128751356,128751443,0,92100994
H1|chr8:36764267-36764311,chr8,36764267,36764311,H1|chr8:131027766-131027855,chr8,131027766,131027855,0,94263499
H1|chr8:36823539-36823629,chr8,36823539,36823629,H1|chr8:144415475-144415535,chr8,144415475,144415535,0,107591936
H1|chr8:37515468-37515493,chr8,37515468,37515493,H1|chr8:124086410-124086504,chr8,124086410,124086504,0,86570942
H1|chr8:37605137-37605223,chr8,37605137,37605223,H1|chr8:28749030-28749136,chr8,28749030,28749136,0,8856107
H1|chr8:38127381-38127497,chr8,38127381,38127497,H1|chr8:37958929-37958957,chr8,37958929,37958957,0,168452
H1|chr8:38469607-38469754,chr8,38469607,38469754,H1|chr8:35093748-35093777,chr8,35093748,35093777,0,3375859
H1|chr8:38577105-38577163,chr8,38577105,38577163,H1|chr8:115295989-115296080,chr8,115295989,115296080,0,76718884
H1|chr8:39409725-39409834,chr8,39409725,39409834,H1|chr8:128749847-128749885,chr8,128749847,128749885,0,89340122
H1|chr8:39417846-39417921,chr8,39417846,39417921,H1|chr8:37755540-37755566,chr8,37755540,37755566,0,1662306
H1|chr8:39574109-39574175,chr8,39574109,39574175,H1|chr8:54933968-54934041,chr8,54933968,54934041,0,15359859
H1|chr8:39596787-39596859,chr8,39596787,39596859,H1|chr8:30247013-30247050,chr8,30247013,30247050,0,9349774
H1|chr8:40399216-40399285,chr8,40399216,40399285,H1|chr8:103429182-103429262,chr8,103429182,103429262,0,63029966
H1|chr8:40661192-40661304,chr8,40661192,40661304,H1|chr8:103873965-103874002,chr8,103873965,103874002,0,63212773
H1|chr8:40957907-40958031,chr8,40957907,40958031,H1|chr8:30243430-30243456,chr8,30243430,30243456,0,10714477
H1|chr8:41065847-41065929,chr8,41065847,41065929,H1|chr8:63162422-63162465,chr8,63162422,63162465,0,22096575
H1|chr8:41206331-41206405,chr8,41206331,41206405,H1|chr8:38584074-38584109,chr8,38584074,38584109,0,2622257
H1|chr8:41296649-41296687,chr8,41296649,41296687,H1|chr8:101166583-101166661,chr8,101166583,101166661,0,59869934
H1|chr8:41399860-41399922,chr8,41399860,41399922,H1|chr8:98657853-98657921,chr8,98657853,98657921,0,57257993
H1|chr8:41451792-41451857,chr8,41451792,41451857,H1|chr8:103427114-103427161,chr8,103427114,103427161,0,61975322
H1|chr8:41819869-41819938,chr8,41819869,41819938,H1|chr8:91656502-91656546,chr8,91656502,91656546,0,49836633
H1|chr8:41959392-41959472,chr8,41959392,41959472,H1|chr8:56684831-56684912,chr8,56684831,56684912,0,14725439
H1|chr8:43114581-43114623,chr8,43114581,43114623,H1|chr8:103422580-103422625,chr8,103422580,103422625,0,60307999
H1|chr8:43265921-43266037,chr8,43265921,43266037,H1|chr8:107283519-107283549,chr8,107283519,107283549,0,64017598
H1|chr8:43328943-43329026,chr8,43328943,43329026,H1|chr8:101168752-101168788,chr8,101168752,101168788,0,57839809
H1|chr8:44238912-44238976,chr8,44238912,44238976,H1|chr8:1773132-1773218,chr8,1773132,1773218,0,42465780
H1|chr8:44277670-44277748,chr8,44277670,44277748,H1|chr8:145134306-145134329,chr8,145134306,145134329,0,100856636
H1|chr8:45129676-45129738,chr8,45129676,45129738,H1|chr8:35095785-35095830,chr8,35095785,35095830,0,10033891
H1|chr8:45156847-45156936,chr8,45156847,45156936,H1|chr8:146054256-146054279,chr8,146054256,146054279,0,100897409
H1|chr8:45653410-45653522,chr8,45653410,45653522,H1|chr8:70984880-70984918,chr8,70984880,70984918,0,25331470
H1|chr8:46528007-46528030,chr8,46528007,46528030,H1|chr8:110343767-110343821,chr8,110343767,110343821,0,63815760
H1|chr8:47174780-47174854,chr8,47174780,47174854,H1|chr8:144677138-144677214,chr8,144677138,144677214,0,97502358
H1|chr8:47216399-47216474,chr8,47216399,47216474,H1|chr8:54936424-54936473,chr8,54936424,54936473,0,7720025
H1|chr8:47953095-47953164,chr8,47953095,47953164,H1|chr8:56684831-56684912,chr8,56684831,56684912,0,8731736
H1|chr8:48062575-48062661,chr8,48062575,48062661,H1|chr8:38324958-38325019,chr8,38324958,38325019,0,9737617
H1|chr8:48445557-48445575,chr8,48445557,48445575,H1|chr8:11056961-11056991,chr8,11056961,11056991,0,37388596
H1|chr8:48567043-48567137,chr8,48567043,48567137,H1|chr8:493948-494095,chr8,493948,494095,0,48073095
H1|chr8:49775132-49775187,chr8,49775132,49775187,H1|chr8:35095787-35095847,chr8,35095787,35095847,0,14679345
H1|chr8:49840603-49840686,chr8,49840603,49840686,H1|chr8:30246397-30246456,chr8,30246397,30246456,0,19594206
H1|chr8:49942168-49942226,chr8,49942168,49942226,H1|chr8:128747501-128747587,chr8,128747501,128747587,0,78805333
H1|chr8:50573212-50573275,chr8,50573212,50573275,H1|chr8:39760962-39761017,chr8,39760962,39761017,0,10812250
H1|chr8:50871917-50871961,chr8,50871917,50871961,H1|chr8:119120716-119120809,chr8,119120716,119120809,0,68248799
H1|chr8:51147114-51147160,chr8,51147114,51147160,H1|chr8:130951528-130951601,chr8,130951528,130951601,0,79804414
H1|chr8:51570469-51570500,chr8,51570469,51570500,H1|chr8:11664458-11664508,chr8,11664458,11664508,0,39906011
H1|chr8:52083606-52083700,chr8,52083606,52083700,H1|chr8:119121871-119121920,chr8,119121871,119121920,0,67038265
H1|chr8:52136598-52136657,chr8,52136598,52136657,H1|chr8:493948-493999,chr8,493948,493999,0,51642650
H1|chr8:52186250-52186270,chr8,52186250,52186270,H1|chr8:493140-493267,chr8,493140,493267,0,51693110
H1|chr8:52266904-52266969,chr8,52266904,52266969,H1|chr8:54933968-54934041,chr8,54933968,54934041,0,2667064
H1|chr8:52668317-52668373,chr8,52668317,52668373,H1|chr8:101730696-101730790,chr8,101730696,101730790,0,49062379
H1|chr8:52851418-52851510,chr8,52851418,52851510,H1|chr8:82541847-82541871,chr8,82541847,82541871,0,29690429
H1|chr8:53094704-53094763,chr8,53094704,53094763,H1|chr8:115295989-115296080,chr8,115295989,115296080,0,62201285
H1|chr8:53378287-53378317,chr8,53378287,53378317,H1|chr8:91656888-91656963,chr8,91656888,91656963,0,38278601
H1|chr8:53766570-53766720,chr8,53766570,53766720,H1|chr8:103873965-103874002,chr8,103873965,103874002,0,50107395
H1|chr8:54080761-54080790,chr8,54080761,54080790,H1|chr8:30242942-30243061,chr8,30242942,30243061,0,23837819
H1|chr8:54299515-54299535,chr8,54299515,54299535,H1|chr8:30243357-30243450,chr8,30243357,30243450,0,24056158
H1|chr8:54651022-54651084,chr8,54651022,54651084,H1|chr8:57122476-57122560,chr8,57122476,57122560,0,2471454
H1|chr8:54777490-54777594,chr8,54777490,54777594,H1|chr8:42394212-42394258,chr8,42394212,42394258,0,12383278
H1|chr8:54858612-54858702,chr8,54858612,54858702,H1|chr8:91656977-91657023,chr8,91656977,91657023,0,36798365
H1|chr8:55012586-55012675,chr8,55012586,55012675,H1|chr8:82541847-82541871,chr8,82541847,82541871,0,27529261
H1|chr8:55249604-55249631,chr8,55249604,55249631,H1|chr8:11664458-11664508,chr8,11664458,11664508,0,43585146
H1|chr8:55590132-55590243,chr8,55590132,55590243,H1|chr8:30246917-30246935,chr8,30246917,30246935,0,25343215
H1|chr8:55891325-55891427,chr8,55891325,55891427,H1|chr8:73921780-73921930,chr8,73921780,73921930,0,18030455
H1|chr8:56031498-56031534,chr8,56031498,56031534,H1|chr8:70988579-70988647,chr8,70988579,70988647,0,14957081
H1|chr8:56902423-56902536,chr8,56902423,56902536,H1|chr8:103873965-103874002,chr8,103873965,103874002,0,46971542
H1|chr8:56921832-56921901,chr8,56921832,56921901,H1|chr8:91656502-91656546,chr8,91656502,91656546,0,34734670
H1|chr8:56927393-56927543,chr8,56927393,56927543,H1|chr8:91655018-91655080,chr8,91655018,91655080,0,34727625
H1|chr8:57723586-57723704,chr8,57723586,57723704,H1|chr8:495479-495495,chr8,495479,495495,0,57228107
H1|chr8:57835280-57835331,chr8,57835280,57835331,H1|chr8:30243420-30243469,chr8,30243420,30243469,0,27591860
H1|chr8:58581477-58581520,chr8,58581477,58581520,H1|chr8:54937763-54937853,chr8,54937763,54937853,0,3643714
H1|chr8:59085592-59085628,chr8,59085592,59085628,H1|chr8:11661825-11661861,chr8,11661825,11661861,0,47423767
H1|chr8:59689258-59689287,chr8,59689258,59689287,H1|chr8:74658137-74658218,chr8,74658137,74658218,0,14968879
H1|chr8:59752687-59752747,chr8,59752687,59752747,H1|chr8:73924351-73924437,chr8,73924351,73924437,0,14171664
H1|chr8:59785525-59785569,chr8,59785525,59785569,H1|chr8:28560222-28560325,chr8,28560222,28560325,0,31225303
H1|chr8:59804380-59804500,chr8,59804380,59804500,H1|chr8:70987660-70987690,chr8,70987660,70987690,0,11183280
H1|chr8:59839936-59840042,chr8,59839936,59840042,H1|chr8:42013230-42013269,chr8,42013230,42013269,0,17826706
H1|chr8:59887339-59887486,chr8,59887339,59887486,H1|chr8:30243430-30243456,chr8,30243430,30243456,0,29643909
H1|chr8:60094928-60094954,chr8,60094928,60094954,H1|chr8:91656888-91656963,chr8,91656888,91656963,0,31561960
H1|chr8:60523150-60523172,chr8,60523150,60523172,H1|chr8:42396197-42396313,chr8,42396197,42396313,0,18126953
H1|chr8:60645345-60645423,chr8,60645345,60645423,H1|chr8:27629696-27629767,chr8,27629696,27629767,0,33015649
H1|chr8:61246885-61246913,chr8,61246885,61246913,H1|chr8:74658137-74658218,chr8,74658137,74658218,0,13411252
H1|chr8:61388949-61389072,chr8,61388949,61389072,H1|chr8:500698-500725,chr8,500698,500725,0,60888251
H1|chr8:61487794-61487887,chr8,61487794,61487887,H1|chr8:93109457-93109548,chr8,93109457,93109548,0,31621663
H1|chr8:61790871-61790920,chr8,61790871,61790920,H1|chr8:107283534-107283632,chr8,107283534,107283632,0,45492663
H1|chr8:61809128-61809203,chr8,61809128,61809203,H1|chr8:144677075-144677214,chr8,144677075,144677214,0,82867947
H1|chr8:62488244-62488322,chr8,62488244,62488322,H1|chr8:145134306-145134329,chr8,145134306,145134329,0,82646062
H1|chr8:62584768-62584789,chr8,62584768,62584789,H1|chr8:128751356-128751443,chr8,128751356,128751443,0,66166588
H1|chr8:62660775-62660805,chr8,62660775,62660805,H1|chr8:103426991-103427060,chr8,103426991,103427060,0,40766216
H1|chr8:62809900-62809925,chr8,62809900,62809925,H1|chr8:42396197-42396298,chr8,42396197,42396298,0,20413703
H1|chr8:63012538-63012622,chr8,63012538,63012622,H1|chr8:145980268-145980334,chr8,145980268,145980334,0,82967730
H1|chr8:63344919-63344970,chr8,63344919,63344970,H1|chr8:1769452-1769515,chr8,1769452,1769515,0,61575467
H1|chr8:63498145-63498191,chr8,63498145,63498191,H1|chr8:130951406-130951472,chr8,130951406,130951472,0,67453261
H1|chr8:63563728-63563822,chr8,63563728,63563822,H1|chr8:73923153-73923248,chr8,73923153,73923248,0,10359425
H1|chr8:63899164-63899219,chr8,63899164,63899219,H1|chr8:73923153-73923248,chr8,73923153,73923248,0,10023989
H1|chr8:64173177-64173322,chr8,64173177,64173322,H1|chr8:103873878-103873904,chr8,103873878,103873904,0,39700701
H1|chr8:64476151-64476247,chr8,64476151,64476247,H1|chr8:38321524-38321578,chr8,38321524,38321578,0,26154627
H1|chr8:64826303-64826392,chr8,64826303,64826392,H1|chr8:146054256-146054279,chr8,146054256,146054279,0,81227953
H1|chr8:65177724-65177756,chr8,65177724,65177756,H1|chr8:37919982-37920064,chr8,37919982,37920064,0,27257742
H1|chr8:65429432-65429465,chr8,65429432,65429465,H1|chr8:28560219-28560325,chr8,28560219,28560325,0,36869213
H1|chr8:65550472-65550524,chr8,65550472,65550524,H1|chr8:101732631-101732654,chr8,101732631,101732654,0,36182159
H1|chr8:66021877-66022002,chr8,66021877,66022002,H1|chr8:38585113-38585145,chr8,38585113,38585145,0,27436764
H1|chr8:66100049-66100096,chr8,66100049,66100096,H1|chr8:101961728-101961796,chr8,101961728,101961796,0,35861679
H1|chr8:66644815-66644868,chr8,66644815,66644868,H1|chr8:73923153-73923248,chr8,73923153,73923248,0,7278338
H1|chr8:67064564-67064684,chr8,67064564,67064684,H1|chr8:37887193-37887227,chr8,37887193,37887227,0,29177371
H1|chr8:67568217-67568367,chr8,67568217,67568367,H1|chr8:124290430-124290575,chr8,124290430,124290575,0,56722213
H1|chr8:67752137-67752166,chr8,67752137,67752166,H1|chr8:74658137-74658218,chr8,74658137,74658218,0,6906000
H1|chr8:68185036-68185082,chr8,68185036,68185082,H1|chr8:119120716-119120809,chr8,119120716,119120809,0,50935680
H1|chr8:68223915-68223941,chr8,68223915,68223941,H1|chr8:124086410-124086504,chr8,124086410,124086504,0,55862495
H1|chr8:69397049-69397078,chr8,69397049,69397078,H1|chr8:30242942-30243061,chr8,30242942,30243061,0,39154107
H1|chr8:70276215-70276299,chr8,70276215,70276299,H1|chr8:73924839-73924908,chr8,73924839,73924908,0,3648624
H1|chr8:70381040-70381147,chr8,70381040,70381147,H1|chr8:124087012-124087042,chr8,124087012,124087042,0,53705972
H1|chr8:70600105-70600201,chr8,70600105,70600201,H1|chr8:38321524-38321578,chr8,38321524,38321578,0,32278581
H1|chr8:70702155-70702271,chr8,70702155,70702271,H1|chr8:37887193-37887227,chr8,37887193,37887227,0,32814962
H1|chr8:70789765-70789791,chr8,70789765,70789791,H1|chr8:30245484-30245573,chr8,30245484,30245573,0,40544281
H1|chr8:70854860-70854903,chr8,70854860,70854903,H1|chr8:54937763-54937853,chr8,54937763,54937853,0,15917097
H1|chr8:71145282-71145356,chr8,71145282,71145356,H1|chr8:144674345-144674390,chr8,144674345,144674390,0,73529063
H1|chr8:71593668-71593739,chr8,71593668,71593739,H1|chr8:144655916-144655947,chr8,144655916,144655947,0,73062248
H1|chr8:71960632-71960722,chr8,71960632,71960722,H1|chr8:82541847-82541871,chr8,82541847,82541871,0,10581215
H1|chr8:71968695-71968747,chr8,71968695,71968747,H1|chr8:37960377-37960507,chr8,37960377,37960507,0,34008318
H1|chr8:72255811-72255927,chr8,72255811,72255927,H1|chr8:70984880-70984918,chr8,70984880,70984918,0,1270931
H1|chr8:73245197-73245265,chr8,73245197,73245265,H1|chr8:54933680-54933734,chr8,54933680,54933734,0,18311517
H1|chr8:73253913-73253993,chr8,73253913,73253993,H1|chr8:56684831-56684912,chr8,56684831,56684912,0,16569082
H1|chr8:73312811-73312927,chr8,73312811,73312927,H1|chr8:70984880-70984918,chr8,70984880,70984918,0,2327931
H1|chr8:74182074-74182127,chr8,74182074,74182127,H1|chr8:73923153-73923248,chr8,73923153,73923248,0,258921
H1|chr8:74209712-74209798,chr8,74209712,74209798,H1|chr8:38324958-38325019,chr8,38324958,38325019,0,35884754
H1|chr8:74318981-74319118,chr8,74318981,74319118,H1|chr8:124290430-124290575,chr8,124290430,124290575,0,49971449
H1|chr8:74655007-74655048,chr8,74655007,74655048,H1|chr8:73923692-73923790,chr8,73923692,73923790,0,731315
H1|chr8:74805791-74805835,chr8,74805791,74805835,H1|chr8:145575550-145575660,chr8,145575550,145575660,0,70769759
H1|chr8:74857686-74857736,chr8,74857686,74857736,H1|chr8:103874271-103874336,chr8,103874271,103874336,0,29016585
H1|chr8:75208343-75208455,chr8,75208343,75208455,H1|chr8:103873965-103874002,chr8,103873965,103874002,0,28665622
H1|chr8:75675108-75675198,chr8,75675108,75675198,H1|chr8:144415475-144415535,chr8,144415475,144415535,0,68740367
H1|chr8:75764107-75764133,chr8,75764107,75764133,H1|chr8:91656888-91656963,chr8,91656888,91656963,0,15892781
H1|chr8:75781715-75781765,chr8,75781715,75781765,H1|chr8:124086417-124086494,chr8,124086417,124086494,0,48304702
H1|chr8:76317457-76317535,chr8,76317457,76317535,H1|chr8:39760962-39761017,chr8,39760962,39761017,0,36556495
H1|chr8:76596033-76596180,chr8,76596033,76596180,H1|chr8:42394212-42394258,chr8,42394212,42394258,0,34201821
H1|chr8:76736294-76736372,chr8,76736294,76736372,H1|chr8:28749086-28749158,chr8,28749086,28749158,0,47987208
H1|chr8:77726622-77726670,chr8,77726622,77726670,H1|chr8:91657243-91657393,chr8,91657243,91657393,0,13930621
H1|chr8:78116867-78116903,chr8,78116867,78116903,H1|chr8:101166583-101166661,chr8,101166583,101166661,0,23049716
H1|chr8:78185278-78185353,chr8,78185278,78185353,H1|chr8:144677075-144677214,chr8,144677075,144677214,0,66491797
H1|chr8:78831273-78831336,chr8,78831273,78831336,H1|chr8:35095785-35095830,chr8,35095785,35095830,0,43735488
H1|chr8:79068032-79068067,chr8,79068032,79068067,H1|chr8:11661824-11661861,chr8,11661824,11661861,0,67406208
H1|chr8:79235481-79235509,chr8,79235481,79235509,H1|chr8:494639-494658,chr8,494639,494658,0,78740842
H1|chr8:79279280-79279356,chr8,79279280,79279356,H1|chr8:141519002-141519076,chr8,141519002,141519076,0,62239722
H1|chr8:79437699-79437753,chr8,79437699,79437753,H1|chr8:11661825-11661861,chr8,11661825,11661861,0,67775874
H1|chr8:79561720-79561827,chr8,79561720,79561827,H1|chr8:124087012-124087042,chr8,124087012,124087042,0,44525292
H1|chr8:79565848-79565960,chr8,79565848,79565960,H1|chr8:70984880-70984918,chr8,70984880,70984918,0,8580968
H1|chr8:79954044-79954064,chr8,79954044,79954064,H1|chr8:37960377-37960507,chr8,37960377,37960507,0,41993667
H1|chr8:80148847-80148943,chr8,80148847,80148943,H1|chr8:56789286-56789326,chr8,56789286,56789326,0,23359561
H1|chr8:80159308-80159387,chr8,80159308,80159387,H1|chr8:37755540-37755566,chr8,37755540,37755566,0,42403768
H1|chr8:80585604-80585671,chr8,80585604,80585671,H1|chr8:1773180-1773212,chr8,1773180,1773212,0,78812424
H1|chr8:80618530-80618623,chr8,80618530,80618623,H1|chr8:63162422-63162465,chr8,63162422,63162465,0,17456108
H1|chr8:80779917-80780029,chr8,80779917,80780029,H1|chr8:30246917-30246935,chr8,30246917,30246935,0,50533000
H1|chr8:81073130-81073209,chr8,81073130,81073209,H1|chr8:27629696-27629767,chr8,27629696,27629767,0,53443434
H1|chr8:81090107-81090223,chr8,81090107,81090223,H1|chr8:28749086-28749158,chr8,28749086,28749158,0,52341021
H1|chr8:81265458-81265546,chr8,81265458,81265546,H1|chr8:37883551-37883606,chr8,37883551,37883606,0,43381907
H1|chr8:81806899-81806935,chr8,81806899,81806935,H1|chr8:101166583-101166661,chr8,101166583,101166661,0,19359684
H1|chr8:81895437-81895543,chr8,81895437,81895543,H1|chr8:42013230-42013269,chr8,42013230,42013269,0,39882207
H1|chr8:82063975-82064038,chr8,82063975,82064038,H1|chr8:91656977-91657023,chr8,91656977,91657023,0,9593002
H1|chr8:83016502-83016570,chr8,83016502,83016570,H1|chr8:494544-494583,chr8,494544,494583,0,82521958
H1|chr8:83037178-83037261,chr8,83037178,83037261,H1|chr8:101168752-101168788,chr8,101168752,101168788,0,18131574
H1|chr8:83069636-83069700,chr8,83069636,83069700,H1|chr8:57122476-57122560,chr8,57122476,57122560,0,25947160
H1|chr8:83392313-83392382,chr8,83392313,83392382,H1|chr8:56684831-56684912,chr8,56684831,56684912,0,26707482
H1|chr8:83950117-83950159,chr8,83950117,83950159,H1|chr8:70988579-70988647,chr8,70988579,70988647,0,12961538
H1|chr8:84226894-84226984,chr8,84226894,84226984,H1|chr8:11661825-11661861,chr8,11661825,11661861,0,72565069
H1|chr8:84414753-84414843,chr8,84414753,84414843,H1|chr8:91656977-91657023,chr8,91656977,91657023,0,7242224
H1|chr8:84657740-84657784,chr8,84657740,84657784,H1|chr8:28749030-28749136,chr8,28749030,28749136,0,55908710
H1|chr8:84747859-84747934,chr8,84747859,84747934,H1|chr8:73924351-73924437,chr8,73924351,73924437,0,10823508
H1|chr8:85292209-85292294,chr8,85292209,85292294,H1|chr8:91655018-91655080,chr8,91655018,91655080,0,6362809
H1|chr8:85605781-85605875,chr8,85605781,85605875,H1|chr8:119121871-119121920,chr8,119121871,119121920,0,33516090
H1|chr8:86049015-86049078,chr8,86049015,86049078,H1|chr8:141650158-141650245,chr8,141650158,141650245,0,55601143
H1|chr8:86129530-86129680,chr8,86129530,86129680,H1|chr8:35094603-35094672,chr8,35094603,35094672,0,51034927
H1|chr8:86890046-86890154,chr8,86890046,86890154,H1|chr8:124087012-124087042,chr8,124087012,124087042,0,37196966
H1|chr8:87177071-87177208,chr8,87177071,87177208,H1|chr8:124290430-124290575,chr8,124290430,124290575,0,37113359
H1|chr8:87206517-87206577,chr8,87206517,87206577,H1|chr8:73924351-73924437,chr8,73924351,73924437,0,13282166
H1|chr8:87475776-87475807,chr8,87475776,87475807,H1|chr8:73924835-73924907,chr8,73924835,73924907,0,13550941
H1|chr8:87691136-87691260,chr8,87691136,87691260,H1|chr8:30243430-30243456,chr8,30243430,30243456,0,57447706
H1|chr8:87955595-87955653,chr8,87955595,87955653,H1|chr8:11056944-11057036,chr8,11056944,11057036,0,76898651
H1|chr8:87970493-87970638,chr8,87970493,87970638,H1|chr8:35093860-35093886,chr8,35093860,35093886,0,52876633
H1|chr8:88175226-88175346,chr8,88175226,88175346,H1|chr8:495479-495495,chr8,495479,495495,0,87679747
H1|chr8:88256788-88256898,chr8,88256788,88256898,H1|chr8:70986457-70986550,chr8,70986457,70986550,0,17270331
H1|chr8:88630515-88630631,chr8,88630515,88630631,H1|chr8:37887193-37887227,chr8,37887193,37887227,0,50743322
H1|chr8:88837326-88837414,chr8,88837326,88837414,H1|chr8:37883551-37883606,chr8,37883551,37883606,0,50953775
H1|chr8:88920681-88920748,chr8,88920681,88920748,H1|chr8:11056944-11057036,chr8,11056944,11057036,0,77863737
H1|chr8:90184498-90184618,chr8,90184498,90184618,H1|chr8:70987660-70987690,chr8,70987660,70987690,0,19196838
H1|chr8:90288064-90288141,chr8,90288064,90288141,H1|chr8:39760962-39761017,chr8,39760962,39761017,0,50527102
H1|chr8:90308937-90309030,chr8,90308937,90309030,H1|chr8:63162422-63162465,chr8,63162422,63162465,0,27146515
H1|chr8:90326116-90326197,chr8,90326116,90326197,H1|chr8:124290445-124290575,chr8,124290445,124290575,0,33964329
H1|chr8:90751074-90751119,chr8,90751074,90751119,H1|chr8:70986523-70986557,chr8,70986523,70986557,0,19764551
H1|chr8:90872217-90872257,chr8,90872217,90872257,H1|chr8:145575550-145575660,chr8,145575550,145575660,0,54703333
H1|chr8:90891879-90891923,chr8,90891879,90891923,H1|chr8:103872551-103872657,chr8,103872551,103872657,0,12980672
H1|chr8:91134556-91134625,chr8,91134556,91134625,H1|chr8:145981975-145982056,chr8,145981975,145982056,0,54847419
H1|chr8:91136992-91137078,chr8,91136992,91137078,H1|chr8:145980268-145980334,chr8,145980268,145980334,0,54843276
H1|chr8:91199771-91199845,chr8,91199771,91199845,H1|chr8:131028137-131028169,chr8,131028137,131028169,0,39828366
H1|chr8:91300550-91300577,chr8,91300550,91300577,H1|chr8:11664458-11664508,chr8,11664458,11664508,0,79636092
H1|chr8:91330766-91330808,chr8,91330766,91330808,H1|chr8:73923692-73923790,chr8,73923692,73923790,0,17407074
H1|chr8:91915334-91915425,chr8,91915334,91915425,H1|chr8:1768905-1768982,chr8,1768905,1768982,0,90146429
H1|chr8:92079504-92079522,chr8,92079504,92079522,H1|chr8:11056961-11056991,chr8,11056961,11056991,0,81022543
H1|chr8:92104001-92104092,chr8,92104001,92104092,H1|chr8:1768905-1768982,chr8,1768905,1768982,0,90335096
H1|chr8:92402927-92403077,chr8,92402927,92403077,H1|chr8:124290430-124290566,chr8,124290430,124290566,0,31887503
H1|chr8:92578345-92578413,chr8,92578345,92578413,H1|chr8:54933680-54933734,chr8,54933680,54933734,0,37644665
H1|chr8:92683522-92683645,chr8,92683522,92683645,H1|chr8:500698-500725,chr8,500698,500725,0,92182824
H1|chr8:92875169-92875236,chr8,92875169,92875236,H1|chr8:1773180-1773212,chr8,1773180,1773212,0,91101989
H1|chr8:93336747-93336791,chr8,93336747,93336791,H1|chr8:119120716-119120809,chr8,119120716,119120809,0,25783969
H1|chr8:93875048-93875115,chr8,93875048,93875115,H1|chr8:11056944-11057036,chr8,11056944,11057036,0,82818104
H1|chr8:95012168-95012199,chr8,95012168,95012199,H1|chr8:11664458-11664508,chr8,11664458,11664508,0,83347710
H1|chr8:95098630-95098686,chr8,95098630,95098686,H1|chr8:128747501-128747587,chr8,128747501,128747587,0,33648871
H1|chr8:95588354-95588402,chr8,95588354,95588402,H1|chr8:11057715-11057761,chr8,11057715,11057761,0,84530639
H1|chr8:95605545-95605608,chr8,95605545,95605608,H1|chr8:91656977-91657023,chr8,91656977,91657023,0,3948568
H1|chr8:95668853-95668896,chr8,95668853,95668896,H1|chr8:1767693-1767777,chr8,1767693,1767777,0,93901160
H1|chr8:95917102-95917168,chr8,95917102,95917168,H1|chr8:128746649-128746773,chr8,128746649,128746773,0,32829547
H1|chr8:96090357-96090470,chr8,96090357,96090470,H1|chr8:103873965-103874002,chr8,103873965,103874002,0,7783608
H1|chr8:96144965-96145059,chr8,96144965,96145059,H1|chr8:493948-494095,chr8,493948,494095,0,95651017
H1|chr8:96643730-96643793,chr8,96643730,96643793,H1|chr8:35095785-35095830,chr8,35095785,35095830,0,61547945
H1|chr8:96785872-96785934,chr8,96785872,96785934,H1|chr8:35095785-35095830,chr8,35095785,35095830,0,61690087
H1|chr8:96961043-96961163,chr8,96961043,96961163,H1|chr8:37887193-37887227,chr8,37887193,37887227,0,59073850
H1|chr8:97208788-97208824,chr8,97208788,97208824,H1|chr8:11661825-11661861,chr8,11661825,11661861,0,85546963
H1|chr8:97266275-97266373,chr8,97266275,97266373,H1|chr8:91657183-91657232,chr8,91657183,91657232,0,5609092
H1|chr8:97422825-97422896,chr8,97422825,97422896,H1|chr8:141518959-141519079,chr8,141518959,141519079,0,44096134
H1|chr8:97879739-97879800,chr8,97879739,97879800,H1|chr8:103872551-103872657,chr8,103872551,103872657,0,5992812
H1|chr8:98155291-98155339,chr8,98155291,98155339,H1|chr8:1772648-1772739,chr8,1772648,1772739,0,96382643
H1|chr8:98665916-98666066,chr8,98665916,98666066,H1|chr8:124290430-124290566,chr8,124290430,124290566,0,25624514
H1|chr8:98891843-98891925,chr8,98891843,98891925,H1|chr8:27636793-27636829,chr8,27636793,27636829,0,71255050
H1|chr8:99321390-99321489,chr8,99321390,99321489,H1|chr8:93113125-93113188,chr8,93113125,93113188,0,6208265
H1|chr8:99669206-99669233,chr8,99669206,99669233,H1|chr8:42357028-42357123,chr8,42357028,42357123,0,57312178
H1|chr8:99940996-99941060,chr8,99940996,99941060,H1|chr8:57122476-57122560,chr8,57122476,57122560,0,42818520
H1|chr8:100156193-100156277,chr8,100156193,100156277,H1|chr8:145980268-145980334,chr8,145980268,145980334,0,45824075
H1|chr8:100992068-100992218,chr8,100992068,100992218,H1|chr8:30247127-30247157,chr8,30247127,30247157,0,70744941
H1|chr8:101161123-101161159,chr8,101161123,101161159,H1|chr8:70988579-70988647,chr8,70988579,70988647,0,30172544
H1|chr8:101190272-101190349,chr8,101190272,101190349,H1|chr8:39760962-39761017,chr8,39760962,39761017,0,61429310
H1|chr8:101801500-101801609,chr8,101801500,101801609,H1|chr8:128749847-128749885,chr8,128749847,128749885,0,26948347
H1|chr8:101860177-101860245,chr8,101860177,101860245,H1|chr8:494544-494583,chr8,494544,494583,0,101365633
H1|chr8:102067289-102067439,chr8,102067289,102067439,H1|chr8:124290430-124290575,chr8,124290430,124290575,0,22223141
H1|chr8:102504721-102504784,chr8,102504721,102504784,H1|chr8:141650158-141650245,chr8,141650158,141650245,0,39145437
H1|chr8:102591618-102591699,chr8,102591618,102591699,H1|chr8:124290445-124290575,chr8,124290445,124290575,0,21698827
H1|chr8:102642004-102642082,chr8,102642004,102642082,H1|chr8:28749086-28749158,chr8,28749086,28749158,0,73892918
H1|chr8:102879051-102879078,chr8,102879051,102879078,H1|chr8:42357028-42357123,chr8,42357028,42357123,0,60522023
H1|chr8:103382182-103382248,chr8,103382182,103382248,H1|chr8:54933968-54934041,chr8,54933968,54934041,0,48448214
H1|chr8:103589012-103589071,chr8,103589012,103589071,H1|chr8:93109457-93109548,chr8,93109457,93109548,0,10479555
H1|chr8:103788751-103788802,chr8,103788751,103788802,H1|chr8:1769452-1769515,chr8,1769452,1769515,0,102019299
H1|chr8:103976836-103976900,chr8,103976836,103976900,H1|chr8:1773132-1773218,chr8,1773132,1773218,0,102203704
H1|chr8:104025432-104025492,chr8,104025432,104025492,H1|chr8:73924750-73924886,chr8,73924750,73924886,0,30100682
H1|chr8:104096612-104096638,chr8,104096612,104096638,H1|chr8:124086410-124086504,chr8,124086410,124086504,0,19989798
H1|chr8:104139084-104139148,chr8,104139084,104139148,H1|chr8:73923853-73923892,chr8,73923853,73923892,0,30215231
H1|chr8:104343781-104343879,chr8,104343781,104343879,H1|chr8:91657183-91657232,chr8,91657183,91657232,0,12686598
H1|chr8:104372200-104372276,chr8,104372200,104372276,H1|chr8:131028137-131028169,chr8,131028137,131028169,0,26655937
H1|chr8:104700323-104700441,chr8,104700323,104700441,H1|chr8:495479-495495,chr8,495479,495495,0,104204844
H1|chr8:104736367-104736460,chr8,104736367,104736460,H1|chr8:93109457-93109548,chr8,93109457,93109548,0,11626910
H1|chr8:105651230-105651355,chr8,105651230,105651355,H1|chr8:38585113-38585145,chr8,38585113,38585145,0,67066117
H1|chr8:105945249-105945308,chr8,105945249,105945308,H1|chr8:493948-493999,chr8,493948,493999,0,105451301
H1|chr8:106304895-106304941,chr8,106304895,106304941,H1|chr8:145575550-145575660,chr8,145575550,145575660,0,39270655
H1|chr8:107339276-107339358,chr8,107339276,107339358,H1|chr8:101168752-101168788,chr8,101168752,101168788,0,6170524
H1|chr8:107572402-107572435,chr8,107572402,107572435,H1|chr8:73924835-73924907,chr8,73924835,73924907,0,33647567
H1|chr8:108333569-108333597,chr8,108333569,108333597,H1|chr8:42357029-42357123,chr8,42357029,42357123,0,65976540
H1|chr8:108487111-108487223,chr8,108487111,108487223,H1|chr8:141650158-141650245,chr8,141650158,141650245,0,33163047
H1|chr8:108614760-108614795,chr8,108614760,108614795,H1|chr8:11661824-11661861,chr8,11661824,11661861,0,96952936
H1|chr8:108660688-108660755,chr8,108660688,108660755,H1|chr8:91656502-91656546,chr8,91656502,91656546,0,17004186
H1|chr8:109044275-109044340,chr8,109044275,109044340,H1|chr8:73923034-73923085,chr8,73923034,73923085,0,35121241
H1|chr8:109572566-109572637,chr8,109572566,109572637,H1|chr8:144655916-144655947,chr8,144655916,144655947,0,35083350
H1|chr8:109760163-109760275,chr8,109760163,109760275,H1|chr8:30246917-30246935,chr8,30246917,30246935,0,79513246
H1|chr8:111122847-111122880,chr8,111122847,111122880,H1|chr8:56792192-56792309,chr8,56792192,56792309,0,54330655
H1|chr8:111267263-111267379,chr8,111267263,111267379,H1|chr8:37958929-37958957,chr8,37958929,37958957,0,73308334
H1|chr8:111424408-111424555,chr8,111424408,111424555,H1|chr8:42394212-42394258,chr8,42394212,42394258,0,69030196
H1|chr8:111481458-111481533,chr8,111481458,111481533,H1|chr8:73924351-73924437,chr8,73924351,73924437,0,37557107
H1|chr8:112588233-112588296,chr8,112588233,112588296,H1|chr8:11057575-11057597,chr8,11057575,11057597,0,101530658
H1|chr8:112937985-112938027,chr8,112937985,112938027,H1|chr8:103422580-103422625,chr8,103422580,103422625,0,9515405
H1|chr8:113734685-113734770,chr8,113734685,113734770,H1|chr8:27636793-27636829,chr8,27636793,27636829,0,86097892
H1|chr8:114055686-114055737,chr8,114055686,114055737,H1|chr8:133788188-133788259,chr8,133788188,133788259,0,19732502
H1|chr8:114612975-114613122,chr8,114612975,114613122,H1|chr8:70987660-70987690,chr8,70987660,70987690,0,43625315
H1|chr8:115206193-115206245,chr8,115206193,115206245,H1|chr8:133788188-133788260,chr8,133788188,133788260,0,18581995
H1|chr8:115472304-115472449,chr8,115472304,115472449,H1|chr8:35093860-35093886,chr8,35093860,35093886,0,80378444
H1|chr8:116550513-116550577,chr8,116550513,116550577,H1|chr8:73923853-73923892,chr8,73923853,73923892,0,42626660
H1|chr8:117127306-117127377,chr8,117127306,117127377,H1|chr8:73924839-73924908,chr8,73924839,73924908,0,43202467
H1|chr8:117247079-117247124,chr8,117247079,117247124,H1|chr8:70986523-70986557,chr8,70986523,70986557,0,46260556
H1|chr8:117302762-117302912,chr8,117302762,117302912,H1|chr8:103429182-103429262,chr8,103429182,103429262,0,13873580
H1|chr8:117408821-117408899,chr8,117408821,117408899,H1|chr8:39760962-39761017,chr8,39760962,39761017,0,77647859
H1|chr8:117471800-117471876,chr8,117471800,117471876,H1|chr8:141519002-141519076,chr8,141519002,141519076,0,24047202
H1|chr8:117794822-117794912,chr8,117794822,117794912,H1|chr8:11661825-11661861,chr8,11661825,11661861,0,106132997
H1|chr8:117945301-117945359,chr8,117945301,117945359,H1|chr8:115295989-115296080,chr8,115295989,115296080,0,2649312
H1|chr8:117974320-117974366,chr8,117974320,117974366,H1|chr8:56986523-56986551,chr8,56986523,56986551,0,60987797
H1|chr8:118149956-118150072,chr8,118149956,118150072,H1|chr8:107283519-107283549,chr8,107283519,107283549,0,10866437
H1|chr8:118569137-118569179,chr8,118569137,118569179,H1|chr8:73923692-73923790,chr8,73923692,73923790,0,44645445
H1|chr8:118612088-118612113,chr8,118612088,118612113,H1|chr8:42396197-42396298,chr8,42396197,42396298,0,76215891
H1|chr8:118628915-118629025,chr8,118628915,118629025,H1|chr8:38324958-38325019,chr8,38324958,38325019,0,80303957
H1|chr8:118761662-118761774,chr8,118761662,118761774,H1|chr8:493164-493279,chr8,493164,493279,0,118268498
H1|chr8:118903982-118904079,chr8,118903982,118904079,H1|chr8:57126845-57126878,chr8,57126845,57126878,0,61777137
H1|chr8:118949064-118949164,chr8,118949064,118949164,H1|chr8:128749499-128749593,chr8,128749499,128749593,0,9800435
H1|chr8:119110820-119110876,chr8,119110820,119110876,H1|chr8:128747501-128747587,chr8,128747501,128747587,0,9636681
H1|chr8:119226822-119226907,chr8,119226822,119226907,H1|chr8:91655018-91655080,chr8,91655018,91655080,0,27571804
H1|chr8:119790133-119790211,chr8,119790133,119790211,H1|chr8:1772719-1772739,chr8,1772719,1772739,0,118017414
H1|chr8:120294170-120294233,chr8,120294170,120294233,H1|chr8:98657853-98657921,chr8,98657853,98657921,0,21636317
H1|chr8:120614190-120614273,chr8,120614190,120614273,H1|chr8:30246397-30246456,chr8,30246397,30246456,0,90367793
H1|chr8:121375693-121375721,chr8,121375693,121375721,H1|chr8:494639-494658,chr8,494639,494658,0,120881054
H1|chr8:121691454-121691477,chr8,121691454,121691477,H1|chr8:110343767-110343821,chr8,110343767,110343821,0,11347687
H1|chr8:121699766-121699916,chr8,121699766,121699916,H1|chr8:103429182-103429262,chr8,103429182,103429262,0,18270584
H1|chr8:121714006-121714056,chr8,121714006,121714056,H1|chr8:124086417-124086494,chr8,124086417,124086494,0,2372411
H1|chr8:121735764-121735812,chr8,121735764,121735812,H1|chr8:91657301-91657329,chr8,91657301,91657329,0,30078463
H1|chr8:121851586-121851636,chr8,121851586,121851636,H1|chr8:130951401-130951469,chr8,130951401,130951469,0,9099815
H1|chr8:121861807-121861855,chr8,121861807,121861855,H1|chr8:11057715-11057761,chr8,11057715,11057761,0,110804092
H1|chr8:122010930-122010972,chr8,122010930,122010972,H1|chr8:103422930-103423068,chr8,103422930,103423068,0,18588000
H1|chr8:122218285-122218359,chr8,122218285,122218359,H1|chr8:38584074-38584109,chr8,38584074,38584109,0,83634211
H1|chr8:122545594-122545673,chr8,122545594,122545673,H1|chr8:27629696-27629767,chr8,27629696,27629767,0,94915898
H1|chr8:123066445-123066531,chr8,123066445,123066531,H1|chr8:145980268-145980334,chr8,145980268,145980334,0,22913823
H1|chr8:124090910-124090965,chr8,124090910,124090965,H1|chr8:73923153-73923248,chr8,73923153,73923248,0,50167757
H1|chr8:124580757-124580777,chr8,124580757,124580777,H1|chr8:493140-493267,chr8,493140,493267,0,124087617
H1|chr8:124791386-124791460,chr8,124791386,124791460,H1|chr8:144677138-144677214,chr8,144677138,144677214,0,19885752
H1|chr8:125687946-125688064,chr8,125687946,125688064,H1|chr8:128749847-128749885,chr8,128749847,128749885,0,3061901
H1|chr8:125716573-125716621,chr8,125716573,125716621,H1|chr8:91657301-91657329,chr8,91657301,91657329,0,34059272
H1|chr8:125867401-125867440,chr8,125867401,125867440,H1|chr8:28560222-28560325,chr8,28560222,28560325,0,97307179
H1|chr8:126172179-126172229,chr8,126172179,126172229,H1|chr8:103874271-103874336,chr8,103874271,103874336,0,22297908
H1|chr8:126658976-126659084,chr8,126658976,126659084,H1|chr8:124087012-124087042,chr8,124087012,124087042,0,2571964
H1|chr8:127597249-127597284,chr8,127597249,127597284,H1|chr8:493164-493279,chr8,493164,493279,0,127104085
H1|chr8:128141179-128141291,chr8,128141179,128141291,H1|chr8:141650158-141650245,chr8,141650158,141650245,0,13508979
H1|chr8:128842442-128842477,chr8,128842442,128842477,H1|chr8:493164-493279,chr8,493164,493279,0,128349278
H1|chr8:128859772-128859822,chr8,128859772,128859822,H1|chr8:30243419-30243469,chr8,30243419,30243469,0,98616353
H1|chr8:128901575-128901720,chr8,128901575,128901720,H1|chr8:103873878-103873904,chr8,103873878,103873904,0,25027697
H1|chr8:129142203-129142251,chr8,129142203,129142251,H1|chr8:91657243-91657393,chr8,91657243,91657393,0,37484960
H1|chr8:129320829-129320872,chr8,129320829,129320872,H1|chr8:56792192-56792309,chr8,56792192,56792309,0,72528637
H1|chr8:129433006-129433072,chr8,129433006,129433072,H1|chr8:128746649-128746773,chr8,128746649,128746773,0,686357
H1|chr8:129799252-129799298,chr8,129799252,129799298,H1|chr8:119120716-119120809,chr8,119120716,119120809,0,10678536
H1|chr8:130139708-130139745,chr8,130139708,130139745,H1|chr8:144655916-144655947,chr8,144655916,144655947,0,14516208
H1|chr8:130742671-130742783,chr8,130742671,130742783,H1|chr8:493164-493279,chr8,493164,493279,0,130249507
H1|chr8:131768299-131768345,chr8,131768299,131768345,H1|chr8:145575550-145575660,chr8,145575550,145575660,0,13807251
H1|chr8:131816922-131816942,chr8,131816922,131816942,H1|chr8:30243357-30243450,chr8,30243357,30243450,0,101573565
H1|chr8:131849751-131849894,chr8,131849751,131849894,H1|chr8:493164-493279,chr8,493164,493279,0,131356587
H1|chr8:132268989-132269107,chr8,132268989,132269107,H1|chr8:128749847-128749885,chr8,128749847,128749885,0,3519142
H1|chr8:132501458-132501497,chr8,132501458,132501497,H1|chr8:28560222-28560325,chr8,28560222,28560325,0,103941236
H1|chr8:132903448-132903537,chr8,132903448,132903537,H1|chr8:1773132-1773218,chr8,1773132,1773218,0,131130316
H1|chr8:133879185-133879331,chr8,133879185,133879331,H1|chr8:103423132-103423199,chr8,103423132,103423199,0,30456053
H1|chr8:134071326-134071382,chr8,134071326,134071382,H1|chr8:101730696-101730790,chr8,101730696,101730790,0,32340630
H1|chr8:134308188-134308331,chr8,134308188,134308331,H1|chr8:493164-493279,chr8,493164,493279,0,133815024
H1|chr8:135565873-135565993,chr8,135565873,135565993,H1|chr8:495479-495495,chr8,495479,495495,0,135070394
H1|chr8:135699832-135699922,chr8,135699832,135699922,H1|chr8:82541847-82541871,chr8,82541847,82541871,0,53157985
H1|chr8:136150387-136150534,chr8,136150387,136150534,H1|chr8:30243430-30243456,chr8,30243430,30243456,0,105906957
H1|chr8:136348720-136348785,chr8,136348720,136348785,H1|chr8:54933968-54934041,chr8,54933968,54934041,0,81414752
H1|chr8:136380763-136380818,chr8,136380763,136380818,H1|chr8:35095787-35095847,chr8,35095787,35095847,0,101284976
H1|chr8:137573235-137573324,chr8,137573235,137573324,H1|chr8:103874897-103874929,chr8,103874897,103874929,0,33698338
H1|chr8:137713376-137713450,chr8,137713376,137713450,H1|chr8:38321501-38321577,chr8,38321501,38321577,0,99391875
H1|chr8:138240305-138240368,chr8,138240305,138240368,H1|chr8:11057575-11057597,chr8,11057575,11057597,0,127182730
H1|chr8:138280207-138280296,chr8,138280207,138280296,H1|chr8:103874897-103874929,chr8,103874897,103874929,0,34405310
H1|chr8:138509321-138509346,chr8,138509321,138509346,H1|chr8:124086410-124086504,chr8,124086410,124086504,0,14422911
H1|chr8:138854275-138854335,chr8,138854275,138854335,H1|chr8:103422580-103422625,chr8,103422580,103422625,0,35431695
H1|chr8:139195812-139195864,chr8,139195812,139195864,H1|chr8:37960377-37960507,chr8,37960377,37960507,0,101235435
H1|chr8:140947162-140947199,chr8,140947162,140947199,H1|chr8:35093860-35093886,chr8,35093860,35093886,0,105853302
H1|chr8:140949894-140949991,chr8,140949894,140949991,H1|chr8:57126845-57126878,chr8,57126845,57126878,0,83823049
H1|chr8:141248724-141248768,chr8,141248724,141248768,H1|chr8:28560222-28560325,chr8,28560222,28560325,0,112688502
H1|chr8:141328953-141329103,chr8,141328953,141329103,H1|chr8:30247127-30247157,chr8,30247127,30247157,0,111081826
H1|chr8:141393888-141393932,chr8,141393888,141393932,H1|chr8:145575550-145575660,chr8,145575550,145575660,0,4181662
H1|chr8:141434899-141435020,chr8,141434899,141435020,H1|chr8:35093748-35093777,chr8,35093748,35093777,0,106341151
H1|chr8:141476813-141476860,chr8,141476813,141476860,H1|chr8:101961728-101961796,chr8,101961728,101961796,0,39515085
H1|chr8:141624423-141624483,chr8,141624423,141624483,H1|chr8:103422580-103422625,chr8,103422580,103422625,0,38201843
H1|chr8:142141262-142141338,chr8,142141262,142141338,H1|chr8:131028137-131028169,chr8,131028137,131028169,0,11113125
H1|chr8:142202773-142202803,chr8,142202773,142202803,H1|chr8:91656888-91656963,chr8,91656888,91656963,0,50545885
H1|chr8:142556303-142556423,chr8,142556303,142556423,H1|chr8:30247127-30247157,chr8,30247127,30247157,0,112309176
H1|chr8:142627247-142627336,chr8,142627247,142627336,H1|chr8:1773132-1773218,chr8,1773132,1773218,0,140854115
H1|chr8:142903110-142903181,chr8,142903110,142903181,H1|chr8:141518959-141519079,chr8,141518959,141519079,0,1384151
H1|chr8:142962649-142962716,chr8,142962649,142962716,H1|chr8:119121739-119121758,chr8,119121739,119121758,0,23840910
H1|chr8:143219314-143219403,chr8,143219314,143219403,H1|chr8:82541847-82541871,chr8,82541847,82541871,0,60677467
H1|chr8:143988228-143988317,chr8,143988228,143988317,H1|chr8:144415475-144415535,chr8,144415475,144415535,0,427247
H1|chr8:144167402-144167442,chr8,144167402,144167442,H1|chr8:145575550-145575660,chr8,145575550,145575660,0,1408148
H1|chr8:144526799-144526850,chr8,144526799,144526850,H1|chr8:133788188-133788259,chr8,133788188,133788259,0,10738611
H1|chr8:144801033-144801095,chr8,144801033,144801095,H1|chr8:57122476-57122560,chr8,57122476,57122560,0,87678557
H1|chr8:144831835-144831945,chr8,144831835,144831945,H1|chr8:70986457-70986550,chr8,70986457,70986550,0,73845378
H1|chr8:145040804-145040929,chr8,145040804,145040929,H1|chr8:11057566-11057588,chr8,11057566,11057588,0,133983238
H1|chr8:145072195-145072318,chr8,145072195,145072318,H1|chr8:11057566-11057588,chr8,11057566,11057588,0,134014629
H1|chr8:145205024-145205065,chr8,145205024,145205065,H1|chr8:73923692-73923790,chr8,73923692,73923790,0,71281332
H1|chr8:145930310-145930414,chr8,145930310,145930414,H1|chr8:103873878-103873904,chr8,103873878,103873904,0,42056432
H1|chr8:146062460-146062544,chr8,146062460,146062544,H1|chr8:73924839-73924908,chr8,73924839,73924908,0,72137621
H1|chr9:47135-47195,chr9,47135,47195,H1|chr9:130690833-130690866,chr9,130690833,130690866,0,130643698
H1|chr9:79096-79211,chr9,79096,79211,H1|chr9:80646964-80646983,chr9,80646964,80646983,0,80567868
H1|chr9:1253686-1253729,chr9,1253686,1253729,H1|chr9:33524848-33524997,chr9,33524848,33524997,0,32271162
H1|chr9:1915255-1915318,chr9,1915255,1915318,H1|chr9:119450336-119450426,chr9,119450336,119450426,0,117535081
H1|chr9:2038278-2038306,chr9,2038278,2038306,H1|chr9:108004339-108004440,chr9,108004339,108004440,0,105966061
H1|chr9:2103745-2103895,chr9,2103745,2103895,H1|chr9:96112952-96113102,chr9,96112952,96113102,0,94009207
H1|chr9:2276126-2276247,chr9,2276126,2276247,H1|chr9:96111420-96111471,chr9,96111420,96111471,0,93835294
H1|chr9:3111591-3111684,chr9,3111591,3111684,H1|chr9:136282302-136282357,chr9,136282302,136282357,0,133170711
H1|chr9:4036656-4036680,chr9,4036656,4036680,H1|chr9:134269236-134269287,chr9,134269236,134269287,0,130232580
H1|chr9:4143732-4143814,chr9,4143732,4143814,H1|chr9:33523718-33523766,chr9,33523718,33523766,0,29379986
H1|chr9:4210201-4210350,chr9,4210201,4210350,H1|chr9:33524885-33525031,chr9,33524885,33525031,0,29314684
H1|chr9:4403695-4403737,chr9,4403695,4403737,H1|chr9:96113181-96113288,chr9,96113181,96113288,0,91709486
H1|chr9:4698369-4698413,chr9,4698369,4698413,H1|chr9:134268118-134268265,chr9,134268118,134268265,0,129569749
H1|chr9:4970465-4970615,chr9,4970465,4970615,H1|chr9:96112978-96113124,chr9,96112978,96113124,0,91142513
H1|chr9:5304254-5304404,chr9,5304254,5304404,H1|chr9:96112959-96113106,chr9,96112959,96113106,0,90808705
H1|chr9:5693805-5693864,chr9,5693805,5693864,H1|chr9:135819333-135819371,chr9,135819333,135819371,0,130125528
H1|chr9:5705389-5705476,chr9,5705389,5705476,H1|chr9:131444676-131444739,chr9,131444676,131444739,0,125739287
H1|chr9:5740710-5740837,chr9,5740710,5740837,H1|chr9:139441663-139441692,chr9,139441663,139441692,0,133700953
H1|chr9:6441231-6441350,chr9,6441231,6441350,H1|chr9:96113086-96113111,chr9,96113086,96113111,0,89671855
H1|chr9:6732429-6732579,chr9,6732429,6732579,H1|chr9:33525101-33525240,chr9,33525101,33525240,0,26792672
H1|chr9:6795181-6795210,chr9,6795181,6795210,H1|chr9:109624679-109624799,chr9,109624679,109624799,0,102829498
H1|chr9:8306089-8306131,chr9,8306089,8306131,H1|chr9:96113181-96113288,chr9,96113181,96113288,0,87807092
H1|chr9:8505534-8505682,chr9,8505534,8505682,H1|chr9:134271985-134272122,chr9,134271985,134272122,0,125766451
H1|chr9:8993363-8993393,chr9,8993363,8993393,H1|chr9:134376092-134376204,chr9,134376092,134376204,0,125382729
H1|chr9:9205709-9205760,chr9,9205709,9205760,H1|chr9:96113181-96113288,chr9,96113181,96113288,0,86907472
H1|chr9:9226503-9226649,chr9,9226503,9226649,H1|chr9:96113081-96113114,chr9,96113081,96113114,0,86886578
H1|chr9:9681868-9681890,chr9,9681868,9681890,H1|chr9:86431735-86431816,chr9,86431735,86431816,0,76749867
H1|chr9:10103501-10103650,chr9,10103501,10103650,H1|chr9:33524885-33525031,chr9,33524885,33525031,0,23421384
H1|chr9:10278967-10279044,chr9,10278967,10279044,H1|chr9:101558007-101558041,chr9,101558007,101558041,0,91279040
H1|chr9:10298130-10298252,chr9,10298130,10298252,H1|chr9:131592575-131592604,chr9,131592575,131592604,0,121294445
H1|chr9:10714813-10714963,chr9,10714813,10714963,H1|chr9:33524880-33525028,chr9,33524880,33525028,0,22810067
H1|chr9:11487960-11488106,chr9,11487960,11488106,H1|chr9:33524900-33525040,chr9,33524900,33525040,0,22036940
H1|chr9:11657371-11657521,chr9,11657371,11657521,H1|chr9:96112957-96113107,chr9,96112957,96113107,0,84455586
H1|chr9:11826804-11826851,chr9,11826804,11826851,H1|chr9:33524216-33524294,chr9,33524216,33524294,0,21697412
H1|chr9:11921054-11921173,chr9,11921054,11921173,H1|chr9:96113086-96113111,chr9,96113086,96113111,0,84192032
H1|chr9:12251710-12251771,chr9,12251710,12251771,H1|chr9:33524311-33524341,chr9,33524311,33524341,0,21272601
H1|chr9:12254922-12254997,chr9,12254922,12254997,H1|chr9:33523711-33523760,chr9,33523711,33523760,0,21268789
H1|chr9:12401262-12401290,chr9,12401262,12401290,H1|chr9:33524833-33524979,chr9,33524833,33524979,0,21123571
H1|chr9:12806307-12806348,chr9,12806307,12806348,H1|chr9:96111244-96111332,chr9,96111244,96111332,0,83304937
H1|chr9:12848717-12848740,chr9,12848717,12848740,H1|chr9:96111071-96111196,chr9,96111071,96111196,0,83262354
H1|chr9:12958269-12958289,chr9,12958269,12958289,H1|chr9:86431735-86431816,chr9,86431735,86431816,0,73473466
H1|chr9:13100234-13100384,chr9,13100234,13100384,H1|chr9:96112978-96113124,chr9,96112978,96113124,0,83012744
H1|chr9:13593181-13593222,chr9,13593181,13593222,H1|chr9:109623909-109623975,chr9,109623909,109623975,0,96030728
H1|chr9:13668988-13669073,chr9,13668988,13669073,H1|chr9:71737682-71737712,chr9,71737682,71737712,0,58068694
H1|chr9:13921965-13922115,chr9,13921965,13922115,H1|chr9:96111559-96111703,chr9,96111559,96111703,0,82189594
H1|chr9:14394880-14395027,chr9,14394880,14395027,H1|chr9:96112957-96113107,chr9,96112957,96113107,0,81718077
H1|chr9:14418873-14419023,chr9,14418873,14419023,H1|chr9:33525075-33525225,chr9,33525075,33525225,0,19106202
H1|chr9:15757884-15757952,chr9,15757884,15757952,H1|chr9:23821108-23821216,chr9,23821108,23821216,0,8063224
H1|chr9:16052383-16052531,chr9,16052383,16052531,H1|chr9:96112963-96113113,chr9,96112963,96113113,0,80060580
H1|chr9:16332760-16332895,chr9,16332760,16332895,H1|chr9:33524842-33524992,chr9,33524842,33524992,0,17192082
H1|chr9:16644641-16644734,chr9,16644641,16644734,H1|chr9:134272126-134272276,chr9,134272126,134272276,0,117627485
H1|chr9:17188319-17188434,chr9,17188319,17188434,H1|chr9:101558007-101558042,chr9,101558007,101558042,0,84369688
H1|chr9:17800834-17800868,chr9,17800834,17800868,H1|chr9:109625172-109625273,chr9,109625172,109625273,0,91824338
H1|chr9:17949276-17949422,chr9,17949276,17949422,H1|chr9:33524900-33525040,chr9,33524900,33525040,0,15575624
H1|chr9:18160627-18160692,chr9,18160627,18160692,H1|chr9:135460201-135460265,chr9,135460201,135460265,0,117299574
H1|chr9:18962083-18962225,chr9,18962083,18962225,H1|chr9:96111072-96111129,chr9,96111072,96111129,0,77148989
H1|chr9:19443685-19443835,chr9,19443685,19443835,H1|chr9:96112952-96113102,chr9,96112952,96113102,0,76669267
H1|chr9:19461069-19461219,chr9,19461069,19461219,H1|chr9:33524900-33525047,chr9,33524900,33525047,0,14063831
H1|chr9:19845915-19846063,chr9,19845915,19846063,H1|chr9:96112957-96113107,chr9,96112957,96113107,0,76267042
H1|chr9:20844071-20844218,chr9,20844071,20844218,H1|chr9:96112976-96113126,chr9,96112976,96113126,0,75268905
H1|chr9:20989814-20989964,chr9,20989814,20989964,H1|chr9:33525050-33525195,chr9,33525050,33525195,0,12535236
H1|chr9:22938188-22938229,chr9,22938188,22938229,H1|chr9:96111244-96111332,chr9,96111244,96111332,0,73173056
H1|chr9:22976716-22976866,chr9,22976716,22976866,H1|chr9:33524847-33524997,chr9,33524847,33524997,0,10548131
H1|chr9:23046956-23047076,chr9,23046956,23047076,H1|chr9:134271008-134271038,chr9,134271008,134271038,0,111224052
H1|chr9:23122168-23122238,chr9,23122168,23122238,H1|chr9:32572578-32572676,chr9,32572578,32572676,0,9450410
H1|chr9:23562336-23562426,chr9,23562336,23562426,H1|chr9:96113047-96113107,chr9,96113047,96113107,0,72550711
H1|chr9:23948687-23948723,chr9,23948687,23948723,H1|chr9:38490003-38490128,chr9,38490003,38490128,0,14541316
H1|chr9:24348719-24348799,chr9,24348719,24348799,H1|chr9:130701775-130701840,chr9,130701775,130701840,0,106353056
H1|chr9:24680508-24680560,chr9,24680508,24680560,H1|chr9:130743759-130743822,chr9,130743759,130743822,0,106063251
H1|chr9:24773044-24773168,chr9,24773044,24773168,H1|chr9:134267275-134267425,chr9,134267275,134267425,0,109494231
H1|chr9:24970992-24971142,chr9,24970992,24971142,H1|chr9:96112972-96113122,chr9,96112972,96113122,0,71141980
H1|chr9:24987296-24987445,chr9,24987296,24987445,H1|chr9:68410780-68410928,chr9,68410780,68410928,0,43423484
H1|chr9:25438511-25438621,chr9,25438511,25438621,H1|chr9:33524881-33524967,chr9,33524881,33524967,0,8086370
H1|chr9:25558274-25558350,chr9,25558274,25558350,H1|chr9:33525068-33525218,chr9,33525068,33525218,0,7966794
H1|chr9:25657996-25658146,chr9,25657996,25658146,H1|chr9:33524880-33525029,chr9,33524880,33525029,0,7866884
H1|chr9:25704648-25704731,chr9,25704648,25704731,H1|chr9:135456147-135456214,chr9,135456147,135456214,0,109751499
H1|chr9:26715104-26715254,chr9,26715104,26715254,H1|chr9:96112983-96113128,chr9,96112983,96113128,0,69397879
H1|chr9:26907744-26907869,chr9,26907744,26907869,H1|chr9:131592575-131592604,chr9,131592575,131592604,0,104684831
H1|chr9:27072108-27072258,chr9,27072108,27072258,H1|chr9:33524866-33525016,chr9,33524866,33525016,0,6452758
H1|chr9:27938488-27938539,chr9,27938488,27938539,H1|chr9:117377668-117377763,chr9,117377668,117377763,0,89439180
H1|chr9:27942333-27942384,chr9,27942333,27942384,H1|chr9:33523719-33523815,chr9,33523719,33523815,0,5581386
H1|chr9:28152056-28152204,chr9,28152056,28152204,H1|chr9:96112963-96113113,chr9,96112963,96113113,0,67960907
H1|chr9:28174565-28174581,chr9,28174565,28174581,H1|chr9:68411205-68411353,chr9,68411205,68411353,0,40236640
H1|chr9:28897867-28897953,chr9,28897867,28897953,H1|chr9:125695938-125696047,chr9,125695938,125696047,0,96798071
H1|chr9:29127945-29127994,chr9,29127945,29127994,H1|chr9:96929927-96930020,chr9,96929927,96930020,0,67801982
H1|chr9:29242761-29242851,chr9,29242761,29242851,H1|chr9:33679705-33679855,chr9,33679705,33679855,0,4436944
H1|chr9:29448242-29448389,chr9,29448242,29448389,H1|chr9:33524900-33525050,chr9,33524900,33525050,0,4076658
H1|chr9:29490375-29490522,chr9,29490375,29490522,H1|chr9:96112957-96113107,chr9,96112957,96113107,0,66622582
H1|chr9:29503412-29503432,chr9,29503412,29503432,H1|chr9:86431735-86431816,chr9,86431735,86431816,0,56928323
H1|chr9:29710300-29710445,chr9,29710300,29710445,H1|chr9:33524858-33525006,chr9,33524858,33525006,0,3814558
H1|chr9:29861942-29862022,chr9,29861942,29862022,H1|chr9:33525163-33525207,chr9,33525163,33525207,0,3663221
H1|chr9:29872685-29872800,chr9,29872685,29872800,H1|chr9:101558007-101558042,chr9,101558007,101558042,0,71685322
H1|chr9:29911498-29911648,chr9,29911498,29911648,H1|chr9:33525075-33525225,chr9,33525075,33525225,0,3613577
H1|chr9:30107672-30107822,chr9,30107672,30107822,H1|chr9:96112955-96113105,chr9,96112955,96113105,0,66005283
H1|chr9:30620502-30620650,chr9,30620502,30620650,H1|chr9:96112955-96113105,chr9,96112955,96113105,0,65492453
H1|chr9:30995702-30995816,chr9,30995702,30995816,H1|chr9:133321554-133321589,chr9,133321554,133321589,0,102325852
H1|chr9:31051477-31051535,chr9,31051477,31051535,H1|chr9:130690831-130690865,chr9,130690831,130690865,0,99639354
H1|chr9:31093296-31093391,chr9,31093296,31093391,H1|chr9:33525051-33525201,chr9,33525051,33525201,0,2431755
H1|chr9:31746020-31746170,chr9,31746020,31746170,H1|chr9:96112994-96113126,chr9,96112994,96113126,0,64366974
H1|chr9:31831691-31831759,chr9,31831691,31831759,H1|chr9:139440857-139440921,chr9,139440857,139440921,0,107609166
H1|chr9:32022911-32022963,chr9,32022911,32022963,H1|chr9:130743759-130743822,chr9,130743759,130743822,0,98720848
H1|chr9:32126507-32126616,chr9,32126507,32126616,H1|chr9:130701982-130702005,chr9,130701982,130702005,0,98575475
H1|chr9:33605172-33605199,chr9,33605172,33605199,H1|chr9:123341523-123341622,chr9,123341523,123341622,0,89736351
H1|chr9:33637483-33637534,chr9,33637483,33637534,H1|chr9:96113181-96113288,chr9,96113181,96113288,0,62475698
H1|chr9:33650275-33650297,chr9,33650275,33650297,H1|chr9:86431735-86431816,chr9,86431735,86431816,0,52781460
H1|chr9:34031385-34031535,chr9,34031385,34031535,H1|chr9:96112957-96113107,chr9,96112957,96113107,0,62081572
H1|chr9:34037268-34037415,chr9,34037268,34037415,H1|chr9:96112976-96113126,chr9,96112976,96113126,0,62075708
H1|chr9:34545113-34545196,chr9,34545113,34545196,H1|chr9:134375590-134375611,chr9,134375590,134375611,0,99830477
H1|chr9:34568653-34568803,chr9,34568653,34568803,H1|chr9:33524880-33525028,chr9,33524880,33525028,0,1043773
H1|chr9:34658695-34658830,chr9,34658695,34658830,H1|chr9:33524874-33525018,chr9,33524874,33525018,0,1133821
H1|chr9:35647857-35648007,chr9,35647857,35648007,H1|chr9:134271985-134272122,chr9,134271985,134272122,0,98624128
H1|chr9:36286682-36286726,chr9,36286682,36286726,H1|chr9:96110411-96110517,chr9,96110411,96110517,0,59823729
H1|chr9:36850859-36850875,chr9,36850859,36850875,H1|chr9:68411205-68411353,chr9,68411205,68411353,0,31560346
H1|chr9:36955312-36955450,chr9,36955312,36955450,H1|chr9:33524839-33524989,chr9,33524839,33524989,0,3430473
H1|chr9:37172564-37172700,chr9,37172564,37172700,H1|chr9:101558007-101558038,chr9,101558007,101558038,0,64385443
H1|chr9:37613287-37613383,chr9,37613287,37613383,H1|chr9:137003794-137003812,chr9,137003794,137003812,0,99390507
H1|chr9:37791259-37791317,chr9,37791259,37791317,H1|chr9:130690831-130690865,chr9,130690831,130690865,0,92899572
H1|chr9:37929261-37929411,chr9,37929261,37929411,H1|chr9:96112955-96113105,chr9,96112955,96113105,0,58183694
H1|chr9:38804432-38804529,chr9,38804432,38804529,H1|chr9:33523730-33523759,chr9,33523730,33523759,0,5280702
H1|chr9:38814238-38814388,chr9,38814238,38814388,H1|chr9:96112957-96113107,chr9,96112957,96113107,0,57298719
H1|chr9:38868102-38868132,chr9,38868102,38868132,H1|chr9:134376092-134376204,chr9,134376092,134376204,0,95507990
H1|chr9:39251177-39251221,chr9,39251177,39251221,H1|chr9:109625033-109625074,chr9,109625033,109625074,0,70373856
H1|chr9:39291956-39291988,chr9,39291956,39291988,H1|chr9:96111041-96111170,chr9,96111041,96111170,0,56819085
H1|chr9:39727209-39727277,chr9,39727209,39727277,H1|chr9:123341542-123341622,chr9,123341542,123341622,0,83614333
H1|chr9:40250510-40250659,chr9,40250510,40250659,H1|chr9:96113045-96113132,chr9,96113045,96113132,0,55862535
H1|chr9:40531487-40531507,chr9,40531487,40531507,H1|chr9:96112656-96112786,chr9,96112656,96112786,0,55581169
H1|chr9:40573726-40573834,chr9,40573726,40573834,H1|chr9:130701982-130702005,chr9,130701982,130702005,0,90128256
H1|chr9:40587499-40587589,chr9,40587499,40587589,H1|chr9:33023952-33024060,chr9,33023952,33024060,0,7563547
H1|chr9:41190822-41190972,chr9,41190822,41190972,H1|chr9:131444676-131444739,chr9,131444676,131444739,0,90253854
H1|chr9:41685421-41685571,chr9,41685421,41685571,H1|chr9:33524880-33525029,chr9,33524880,33525029,0,8160541
H1|chr9:41870698-41870759,chr9,41870698,41870759,H1|chr9:96110801-96110877,chr9,96110801,96110877,0,54240103
H1|chr9:42152325-42152475,chr9,42152325,42152475,H1|chr9:96112972-96113121,chr9,96112972,96113121,0,53960647
H1|chr9:42405786-42405932,chr9,42405786,42405932,H1|chr9:96112960-96113110,chr9,96112960,96113110,0,53707174
H1|chr9:42406098-42406248,chr9,42406098,42406248,H1|chr9:33524880-33525029,chr9,33524880,33525029,0,8881218
H1|chr9:43033187-43033331,chr9,43033187,43033331,H1|chr9:96112960-96113110,chr9,96112960,96113110,0,53079773
H1|chr9:43050525-43050612,chr9,43050525,43050612,H1|chr9:131444676-131444739,chr9,131444676,131444739,0,88394151
H1|chr9:43172992-43173063,chr9,43172992,43173063,H1|chr9:140178886-140178965,chr9,140178886,140178965,0,97005894
H1|chr9:43290922-43290986,chr9,43290922,43290986,H1|chr9:23821108-23821216,chr9,23821108,23821216,0,19469814
H1|chr9:43344899-43344981,chr9,43344899,43344981,H1|chr9:96112978-96113125,chr9,96112978,96113125,0,52768079
H1|chr9:43765294-43765327,chr9,43765294,43765327,H1|chr9:71737682-71737712,chr9,71737682,71737712,0,27972388
H1|chr9:44018857-44019004,chr9,44018857,44019004,H1|chr9:33524900-33525050,chr9,33524900,33525050,0,10493957
H1|chr9:44846876-44846961,chr9,44846876,44846961,H1|chr9:71737682-71737712,chr9,71737682,71737712,0,26890806
H1|chr9:44884685-44884802,chr9,44884685,44884802,H1|chr9:80646964-80646983,chr9,80646964,80646983,0,35762279
H1|chr9:44973177-44973327,chr9,44973177,44973327,H1|chr9:33524858-33525006,chr9,33524858,33525006,0,11448319
H1|chr9:45197097-45197247,chr9,45197097,45197247,H1|chr9:33525050-33525195,chr9,33525050,33525195,0,11672047
H1|chr9:45248348-45248377,chr9,45248348,45248377,H1|chr9:134376092-134376204,chr9,134376092,134376204,0,89127744
H1|chr9:45409330-45409480,chr9,45409330,45409480,H1|chr9:96112994-96113126,chr9,96112994,96113126,0,50703664
H1|chr9:45449280-45449430,chr9,45449280,45449430,H1|chr9:33524880-33525028,chr9,33524880,33525028,0,11924400
H1|chr9:45831367-45831517,chr9,45831367,45831517,H1|chr9:96112959-96113106,chr9,96112959,96113106,0,50281592
H1|chr9:46888432-46888473,chr9,46888432,46888473,H1|chr9:109623909-109623975,chr9,109623909,109623975,0,62735477
H1|chr9:47376251-47376325,chr9,47376251,47376325,H1|chr9:96112978-96113125,chr9,96112978,96113125,0,48736727
H1|chr9:47619854-47619943,chr9,47619854,47619943,H1|chr9:96111420-96111471,chr9,96111420,96111471,0,48491566
H1|chr9:48052323-48052395,chr9,48052323,48052395,H1|chr9:139440383-139440461,chr9,139440383,139440461,0,91388060
H1|chr9:48386562-48386671,chr9,48386562,48386671,H1|chr9:130701982-130702005,chr9,130701982,130702005,0,82315420
H1|chr9:49082619-49082656,chr9,49082619,49082656,H1|chr9:140489768-140489841,chr9,140489768,140489841,0,91407149
H1|chr9:49515736-49515886,chr9,49515736,49515886,H1|chr9:33525037-33525187,chr9,33525037,33525187,0,15990699
H1|chr9:50132441-50132499,chr9,50132441,50132499,H1|chr9:117377668-117377763,chr9,117377668,117377763,0,67245227
H1|chr9:50386535-50386577,chr9,50386535,50386577,H1|chr9:23821108-23821216,chr9,23821108,23821216,0,26565427
H1|chr9:50750044-50750130,chr9,50750044,50750130,H1|chr9:125695938-125696047,chr9,125695938,125696047,0,74945894
H1|chr9:50839114-50839264,chr9,50839114,50839264,H1|chr9:96112978-96113124,chr9,96112978,96113124,0,45273864
H1|chr9:50942154-50942198,chr9,50942154,50942198,H1|chr9:134268118-134268265,chr9,134268118,134268265,0,83325964
H1|chr9:53318412-53318477,chr9,53318412,53318477,H1|chr9:140178887-140178972,chr9,140178887,140178972,0,86860475
H1|chr9:53378993-53379054,chr9,53378993,53379054,H1|chr9:96110801-96110877,chr9,96110801,96110877,0,42731808
H1|chr9:53492423-53492479,chr9,53492423,53492479,H1|chr9:35601025-35601098,chr9,35601025,35601098,0,17891398
H1|chr9:53583767-53583895,chr9,53583767,53583895,H1|chr9:109625043-109625076,chr9,109625043,109625076,0,56041276
H1|chr9:53647811-53647926,chr9,53647811,53647926,H1|chr9:80646964-80646983,chr9,80646964,80646983,0,26999153
H1|chr9:53741649-53741737,chr9,53741649,53741737,H1|chr9:33525116-33525148,chr9,33525116,33525148,0,20216533
H1|chr9:53912803-53912866,chr9,53912803,53912866,H1|chr9:119450336-119450426,chr9,119450336,119450426,0,65537533
H1|chr9:53932249-53932282,chr9,53932249,53932282,H1|chr9:71737682-71737712,chr9,71737682,71737712,0,17805433
H1|chr9:54245091-54245241,chr9,54245091,54245241,H1|chr9:96112978-96113124,chr9,96112978,96113124,0,41867887
H1|chr9:54875549-54875586,chr9,54875549,54875586,H1|chr9:140489768-140489841,chr9,140489768,140489841,0,85614219
H1|chr9:54923617-54923767,chr9,54923617,54923767,H1|chr9:33524847-33524997,chr9,33524847,33524997,0,21398770
H1|chr9:55519938-55520087,chr9,55519938,55520087,H1|chr9:33524868-33525018,chr9,33524868,33525018,0,21995070
H1|chr9:56371850-56371966,chr9,56371850,56371966,H1|chr9:133972844-133972878,chr9,133972844,133972878,0,77600994
H1|chr9:56585158-56585308,chr9,56585158,56585308,H1|chr9:80646964-80646983,chr9,80646964,80646983,0,24061806
H1|chr9:56635708-56635787,chr9,56635708,56635787,H1|chr9:84301095-84301142,chr9,84301095,84301142,0,27665387
H1|chr9:56753708-56753765,chr9,56753708,56753765,H1|chr9:109622214-109622307,chr9,109622214,109622307,0,52868506
H1|chr9:56841812-56841903,chr9,56841812,56841903,H1|chr9:33525060-33525210,chr9,33525060,33525210,0,23316752
H1|chr9:57050341-57050377,chr9,57050341,57050377,H1|chr9:38490003-38490128,chr9,38490003,38490128,0,18560338
H1|chr9:57751459-57751555,chr9,57751459,57751555,H1|chr9:137003794-137003812,chr9,137003794,137003812,0,79252335
H1|chr9:58042103-58042250,chr9,58042103,58042250,H1|chr9:96112957-96113107,chr9,96112957,96113107,0,38070854
H1|chr9:58130989-58131136,chr9,58130989,58131136,H1|chr9:33524900-33525050,chr9,33524900,33525050,0,24606089
H1|chr9:58597748-58597872,chr9,58597748,58597872,H1|chr9:134271008-134271038,chr9,134271008,134271038,0,75673260
H1|chr9:58953677-58953827,chr9,58953677,58953827,H1|chr9:96112976-96113126,chr9,96112976,96113126,0,37159299
H1|chr9:59277226-59277374,chr9,59277226,59277374,H1|chr9:96113035-96113126,chr9,96113035,96113126,0,36835809
H1|chr9:60012348-60012392,chr9,60012348,60012392,H1|chr9:109625033-109625074,chr9,109625033,109625074,0,49612685
H1|chr9:60101435-60101585,chr9,60101435,60101585,H1|chr9:134271985-134272122,chr9,134271985,134272122,0,74170550
H1|chr9:60722135-60722203,chr9,60722135,60722203,H1|chr9:96111558-96111640,chr9,96111558,96111640,0,35389423
H1|chr9:61074453-61074525,chr9,61074453,61074525,H1|chr9:139440383-139440461,chr9,139440383,139440461,0,78365930
H1|chr9:61531336-61531486,chr9,61531336,61531486,H1|chr9:33524866-33525016,chr9,33524866,33525016,0,28006470
H1|chr9:61655190-61655336,chr9,61655190,61655336,H1|chr9:96113081-96113114,chr9,96113081,96113114,0,34457891
H1|chr9:61668873-61668916,chr9,61668873,61668916,H1|chr9:96930730-96930808,chr9,96930730,96930808,0,35261857
H1|chr9:62564303-62564452,chr9,62564303,62564452,H1|chr9:133320688-133320769,chr9,133320688,133320769,0,70756385
H1|chr9:62637599-62637689,chr9,62637599,62637689,H1|chr9:33023952-33024060,chr9,33023952,33024060,0,29613647
H1|chr9:63915548-63915672,chr9,63915548,63915672,H1|chr9:134271008-134271038,chr9,134271008,134271038,0,70355460
H1|chr9:63942883-63943033,chr9,63942883,63943033,H1|chr9:33524892-33525041,chr9,33524892,33525041,0,30417991
H1|chr9:64115198-64115239,chr9,64115198,64115239,H1|chr9:96112246-96112396,chr9,96112246,96112396,0,31997048
H1|chr9:64309138-64309174,chr9,64309138,64309174,H1|chr9:38490003-38490128,chr9,38490003,38490128,0,25819135
H1|chr9:64354969-64355012,chr9,64354969,64355012,H1|chr9:109623444-109623526,chr9,109623444,109623526,0,45268475
H1|chr9:64790417-64790538,chr9,64790417,64790538,H1|chr9:96111420-96111471,chr9,96111420,96111471,0,31321003
H1|chr9:65409975-65410016,chr9,65409975,65410016,H1|chr9:96112246-96112396,chr9,96112246,96112396,0,30702271
H1|chr9:65424169-65424257,chr9,65424169,65424257,H1|chr9:134268064-134268126,chr9,134268064,134268126,0,68843895
H1|chr9:65488932-65489009,chr9,65488932,65489009,H1|chr9:101558007-101558041,chr9,101558007,101558041,0,36069075
H1|chr9:65821442-65821482,chr9,65821442,65821482,H1|chr9:132804558-132804662,chr9,132804558,132804662,0,66983116
H1|chr9:65927391-65927513,chr9,65927391,65927513,H1|chr9:33524892-33524935,chr9,33524892,33524935,0,32402499
H1|chr9:65939006-65939049,chr9,65939006,65939049,H1|chr9:33524848-33524997,chr9,33524848,33524997,0,32414158
H1|chr9:65977618-65977768,chr9,65977618,65977768,H1|chr9:96112983-96113128,chr9,96112983,96113128,0,30135365
H1|chr9:66534014-66534130,chr9,66534014,66534130,H1|chr9:68411578-68411637,chr9,68411578,68411637,0,1877564
H1|chr9:66768317-66768401,chr9,66768317,66768401,H1|chr9:116860722-116860839,chr9,116860722,116860839,0,50092405
H1|chr9:67388298-67388448,chr9,67388298,67388448,H1|chr9:96112963-96113113,chr9,96112963,96113113,0,28724665
H1|chr9:67738504-67738639,chr9,67738504,67738639,H1|chr9:33524874-33525018,chr9,33524874,33525018,0,34213630
H1|chr9:67845303-67845377,chr9,67845303,67845377,H1|chr9:96112978-96113125,chr9,96112978,96113125,0,28267675
H1|chr9:67872333-67872478,chr9,67872333,67872478,H1|chr9:96112955-96113105,chr9,96112955,96113105,0,28240622
H1|chr9:68882946-68883096,chr9,68882946,68883096,H1|chr9:96112972-96113121,chr9,96112972,96113121,0,27230026
H1|chr9:68986333-68986483,chr9,68986333,68986483,H1|chr9:33525101-33525240,chr9,33525101,33525240,0,35461232
H1|chr9:69556430-69556457,chr9,69556430,69556457,H1|chr9:123341523-123341622,chr9,123341523,123341622,0,53785093
H1|chr9:69662914-69663052,chr9,69662914,69663052,H1|chr9:33524839-33524989,chr9,33524839,33524989,0,36138075
H1|chr9:69685041-69685166,chr9,69685041,69685166,H1|chr9:131592575-131592604,chr9,131592575,131592604,0,61907534
H1|chr9:69907534-69907673,chr9,69907534,69907673,H1|chr9:33525084-33525234,chr9,33525084,33525234,0,36382450
H1|chr9:70121410-70121560,chr9,70121410,70121560,H1|chr9:96112983-96113129,chr9,96112983,96113129,0,25991573
H1|chr9:70164808-70164953,chr9,70164808,70164953,H1|chr9:96112955-96113105,chr9,96112955,96113105,0,25948147
H1|chr9:70349971-70350046,chr9,70349971,70350046,H1|chr9:33523711-33523760,chr9,33523711,33523760,0,36826260
H1|chr9:71050773-71050841,chr9,71050773,71050841,H1|chr9:96111558-96111640,chr9,96111558,96111640,0,25060785
H1|chr9:71072615-71072761,chr9,71072615,71072761,H1|chr9:33525073-33525223,chr9,33525073,33525223,0,37547542
H1|chr9:71564415-71564474,chr9,71564415,71564474,H1|chr9:135819333-135819371,chr9,135819333,135819371,0,64254918
H1|chr9:71822311-71822427,chr9,71822311,71822427,H1|chr9:68411578-68411637,chr9,68411578,68411637,0,3410733
H1|chr9:72421287-72421307,chr9,72421287,72421307,H1|chr9:96112656-96112786,chr9,96112656,96112786,0,23691369
H1|chr9:73554027-73554107,chr9,73554027,73554107,H1|chr9:33525101-33525240,chr9,33525101,33525240,0,40028926
H1|chr9:73749517-73749665,chr9,73749517,73749665,H1|chr9:133320688-133320814,chr9,133320688,133320814,0,59571171
H1|chr9:73886865-73887015,chr9,73886865,73887015,H1|chr9:96112955-96113105,chr9,96112955,96113105,0,22226090
H1|chr9:73887433-73887480,chr9,73887433,73887480,H1|chr9:33524216-33524294,chr9,33524216,33524294,0,40363217
H1|chr9:74002283-74002323,chr9,74002283,74002323,H1|chr9:109623909-109623975,chr9,109623909,109623975,0,35621626
H1|chr9:74076257-74076348,chr9,74076257,74076348,H1|chr9:33525060-33525210,chr9,33525060,33525210,0,40551197
H1|chr9:74095061-74095188,chr9,74095061,74095188,H1|chr9:139441663-139441692,chr9,139441663,139441692,0,65346602
H1|chr9:74152547-74152598,chr9,74152547,74152598,H1|chr9:139440857-139440921,chr9,139440857,139440921,0,65288310
H1|chr9:74347385-74347414,chr9,74347385,74347414,H1|chr9:134376092-134376204,chr9,134376092,134376204,0,60028707
H1|chr9:74466624-74466770,chr9,74466624,74466770,H1|chr9:33525101-33525240,chr9,33525101,33525240,0,40941523
H1|chr9:74684154-74684293,chr9,74684154,74684293,H1|chr9:33525084-33525234,chr9,33525084,33525234,0,41159070
H1|chr9:74754157-74754206,chr9,74754157,74754206,H1|chr9:96929927-96930020,chr9,96929927,96930020,0,22175770
H1|chr9:75636442-75636504,chr9,75636442,75636504,H1|chr9:33523696-33523742,chr9,33523696,33523742,0,42112746
H1|chr9:75841257-75841407,chr9,75841257,75841407,H1|chr9:96112972-96113122,chr9,96112972,96113122,0,20271715
H1|chr9:76062486-76062636,chr9,76062486,76062636,H1|chr9:96112955-96113105,chr9,96112955,96113105,0,20050469
H1|chr9:76808142-76808243,chr9,76808142,76808243,H1|chr9:96112966-96113107,chr9,96112966,96113107,0,19304824
H1|chr9:76817740-76817820,chr9,76817740,76817820,H1|chr9:130701775-130701840,chr9,130701775,130701840,0,53884035
H1|chr9:77578329-77578478,chr9,77578329,77578478,H1|chr9:33524858-33525006,chr9,33524858,33525006,0,44053471
H1|chr9:77882107-77882254,chr9,77882107,77882254,H1|chr9:96112957-96113107,chr9,96112957,96113107,0,18230850
H1|chr9:78050477-78050534,chr9,78050477,78050534,H1|chr9:109622214-109622307,chr9,109622214,109622307,0,31571737
H1|chr9:78356134-78356214,chr9,78356134,78356214,H1|chr9:33525163-33525207,chr9,33525163,33525207,0,44830971
H1|chr9:78533578-78533727,chr9,78533578,78533727,H1|chr9:96113045-96113132,chr9,96113045,96113132,0,17579467
H1|chr9:78813630-78813780,chr9,78813630,78813780,H1|chr9:33525100-33525225,chr9,33525100,33525225,0,45288530
H1|chr9:79181623-79181769,chr9,79181623,79181769,H1|chr9:33525101-33525240,chr9,33525101,33525240,0,45656522
H1|chr9:79234801-79234951,chr9,79234801,79234951,H1|chr9:96112982-96113132,chr9,96112982,96113132,0,16878181
H1|chr9:79947146-79947294,chr9,79947146,79947294,H1|chr9:33523892-33523943,chr9,33523892,33523943,0,46423254
H1|chr9:80838285-80838435,chr9,80838285,80838435,H1|chr9:96111559-96111703,chr9,96111559,96111703,0,15273274
H1|chr9:80923213-80923363,chr9,80923213,80923363,H1|chr9:96112969-96113119,chr9,96112969,96113119,0,15189756
H1|chr9:80968230-80968259,chr9,80968230,80968259,H1|chr9:108004339-108004440,chr9,108004339,108004440,0,27036109
H1|chr9:81435936-81435959,chr9,81435936,81435959,H1|chr9:72374041-72374191,chr9,72374041,72374191,0,9061895
H1|chr9:81538577-81538727,chr9,81538577,81538727,H1|chr9:96110113-96110195,chr9,96110113,96110195,0,14571536
H1|chr9:81957693-81957754,chr9,81957693,81957754,H1|chr9:135819333-135819371,chr9,135819333,135819371,0,53861640
H1|chr9:82138913-82139063,chr9,82138913,82139063,H1|chr9:96112977-96113127,chr9,96112977,96113127,0,13974064
H1|chr9:82159566-82159708,chr9,82159566,82159708,H1|chr9:96112959-96113106,chr9,96112959,96113106,0,13953393
H1|chr9:82392525-82392553,chr9,82392525,82392553,H1|chr9:33524833-33524979,chr9,33524833,33524979,0,48867692
H1|chr9:82612488-82612535,chr9,82612488,82612535,H1|chr9:134265896-134265964,chr9,134265896,134265964,0,51653408
H1|chr9:82818780-82818875,chr9,82818780,82818875,H1|chr9:33525051-33525201,chr9,33525051,33525201,0,49293729
H1|chr9:82950647-82950698,chr9,82950647,82950698,H1|chr9:117377668-117377763,chr9,117377668,117377763,0,34427021
H1|chr9:83062912-83063062,chr9,83062912,83063062,H1|chr9:96112983-96113129,chr9,96112983,96113129,0,13050071
H1|chr9:83389615-83389763,chr9,83389615,83389763,H1|chr9:96112962-96113111,chr9,96112962,96113111,0,12723347
H1|chr9:83533650-83533684,chr9,83533650,83533684,H1|chr9:109625172-109625273,chr9,109625172,109625273,0,26091522
H1|chr9:83602893-83603043,chr9,83602893,83603043,H1|chr9:96112978-96113116,chr9,96112978,96113116,0,12510085
H1|chr9:84559689-84559839,chr9,84559689,84559839,H1|chr9:96112969-96113119,chr9,96112969,96113119,0,11553280
H1|chr9:85316412-85316562,chr9,85316412,85316562,H1|chr9:96113077-96113135,chr9,96113077,96113135,0,10796665
H1|chr9:85959734-85959798,chr9,85959734,85959798,H1|chr9:23821108-23821216,chr9,23821108,23821216,0,62138626
H1|chr9:85959918-85959998,chr9,85959918,85959998,H1|chr9:33525101-33525240,chr9,33525101,33525240,0,52434817
H1|chr9:86122580-86122673,chr9,86122580,86122673,H1|chr9:136282302-136282357,chr9,136282302,136282357,0,50159722
H1|chr9:86715514-86715575,chr9,86715514,86715575,H1|chr9:135819333-135819371,chr9,135819333,135819371,0,49103819
H1|chr9:86836855-86837005,chr9,86836855,86837005,H1|chr9:33525037-33525187,chr9,33525037,33525187,0,53311818
H1|chr9:86904399-86904510,chr9,86904399,86904510,H1|chr9:96110994-96111081,chr9,96110994,96111081,0,9206595
H1|chr9:87064352-87064395,chr9,87064352,87064395,H1|chr9:96113181-96113288,chr9,96113181,96113288,0,9048829
H1|chr9:87128242-87128392,chr9,87128242,87128392,H1|chr9:96112976-96113126,chr9,96112976,96113126,0,8984734
H1|chr9:87288255-87288323,chr9,87288255,87288323,H1|chr9:139440857-139440921,chr9,139440857,139440921,0,52152602
H1|chr9:87374103-87374193,chr9,87374103,87374193,H1|chr9:96113047-96113107,chr9,96113047,96113107,0,8738944
H1|chr9:88035201-88035261,chr9,88035201,88035261,H1|chr9:130690833-130690866,chr9,130690833,130690866,0,42655632
H1|chr9:88230284-88230399,chr9,88230284,88230399,H1|chr9:33525141-33525264,chr9,33525141,33525264,0,54705143
H1|chr9:88576617-88576741,chr9,88576617,88576741,H1|chr9:134267275-134267425,chr9,134267275,134267425,0,45690658
H1|chr9:89592079-89592227,chr9,89592079,89592227,H1|chr9:96112957-96113107,chr9,96112957,96113107,0,6520878
H1|chr9:90345911-90346060,chr9,90345911,90346060,H1|chr9:133320688-133320769,chr9,133320688,133320769,0,42974777
H1|chr9:90724255-90724374,chr9,90724255,90724374,H1|chr9:135456147-135456214,chr9,135456147,135456214,0,44731892
H1|chr9:91480050-91480199,chr9,91480050,91480199,H1|chr9:33524868-33525018,chr9,33524868,33525018,0,57955182
H1|chr9:91524217-91524240,chr9,91524217,91524240,H1|chr9:72374041-72374191,chr9,72374041,72374191,0,19150176
H1|chr9:91998064-91998100,chr9,91998064,91998100,H1|chr9:140499288-140499409,chr9,140499288,140499409,0,48501224
H1|chr9:92005882-92005998,chr9,92005882,92005998,H1|chr9:133972844-133972878,chr9,133972844,133972878,0,41966962
H1|chr9:93597730-93597818,chr9,93597730,93597818,H1|chr9:134268064-134268126,chr9,134268064,134268126,0,40670334
H1|chr9:94188233-94188280,chr9,94188233,94188280,H1|chr9:134265896-134265964,chr9,134265896,134265964,0,40077663
H1|chr9:94463736-94463847,chr9,94463736,94463847,H1|chr9:96110994-96111081,chr9,96110994,96111081,0,1647258
H1|chr9:95295343-95295379,chr9,95295343,95295379,H1|chr9:140499288-140499409,chr9,140499288,140499409,0,45203945
H1|chr9:95467333-95467362,chr9,95467333,95467362,H1|chr9:109624679-109624799,chr9,109624679,109624799,0,14157346
H1|chr9:95844700-95844797,chr9,95844700,95844797,H1|chr9:33523730-33523759,chr9,33523730,33523759,0,62320970
H1|chr9:96301434-96301477,chr9,96301434,96301477,H1|chr9:96930730-96930808,chr9,96930730,96930808,0,629296
H1|chr9:96489285-96489435,chr9,96489285,96489435,H1|chr9:33524900-33525047,chr9,33524900,33525047,0,62964385
H1|chr9:96627646-96627796,chr9,96627646,96627796,H1|chr9:33525100-33525225,chr9,33525100,33525225,0,63102546
H1|chr9:97075607-97075674,chr9,97075607,97075674,H1|chr9:140489446-140489509,chr9,140489446,140489509,0,43413839
H1|chr9:97327435-97327585,chr9,97327435,97327585,H1|chr9:131444676-131444739,chr9,131444676,131444739,0,34117241
H1|chr9:97362709-97362859,chr9,97362709,97362859,H1|chr9:96112969-96113119,chr9,96112969,96113119,0,1249740
H1|chr9:97399088-97399230,chr9,97399088,97399230,H1|chr9:96112959-96113106,chr9,96112959,96113106,0,1286129
H1|chr9:97430067-97430217,chr9,97430067,97430217,H1|chr9:96112963-96113113,chr9,96112963,96113113,0,1317104
H1|chr9:97703496-97703617,chr9,97703496,97703617,H1|chr9:131592575-131592604,chr9,131592575,131592604,0,33889079
H1|chr9:97707885-97708035,chr9,97707885,97708035,H1|chr9:96112980-96113123,chr9,96112980,96113123,0,1594905
H1|chr9:98456299-98456449,chr9,98456299,98456449,H1|chr9:33524892-33525041,chr9,33524892,33525041,0,64931407
H1|chr9:99242690-99242730,chr9,99242690,99242730,H1|chr9:132804558-132804662,chr9,132804558,132804662,0,33561868
H1|chr9:99592911-99592940,chr9,99592911,99592940,H1|chr9:108004339-108004440,chr9,108004339,108004440,0,8411428
H1|chr9:99811630-99811780,chr9,99811630,99811780,H1|chr9:96112978-96113124,chr9,96112978,96113124,0,3698652
H1|chr9:100704379-100704526,chr9,100704379,100704526,H1|chr9:33524900-33525050,chr9,33524900,33525050,0,67179479
H1|chr9:101427012-101427148,chr9,101427012,101427148,H1|chr9:101558007-101558038,chr9,101558007,101558038,0,130995
H1|chr9:101977499-101977589,chr9,101977499,101977589,H1|chr9:33679705-33679855,chr9,33679705,33679855,0,68297794
H1|chr9:102874460-102874590,chr9,102874460,102874590,H1|chr9:96113031-96113111,chr9,96113031,96113111,0,6761429
H1|chr9:103044403-103044549,chr9,103044403,103044549,H1|chr9:33525073-33525223,chr9,33525073,33525223,0,69519330
H1|chr9:103347475-103347596,chr9,103347475,103347596,H1|chr9:139441663-139441692,chr9,139441663,139441692,0,36094188
H1|chr9:103524499-103524634,chr9,103524499,103524634,H1|chr9:33524842-33524992,chr9,33524842,33524992,0,69999657
H1|chr9:103932308-103932331,chr9,103932308,103932331,H1|chr9:96111071-96111196,chr9,96111071,96111196,0,7821237
H1|chr9:105097755-105097905,chr9,105097755,105097905,H1|chr9:96112969-96113119,chr9,96112969,96113119,0,8984786
H1|chr9:105493549-105493573,chr9,105493549,105493573,H1|chr9:134269236-134269287,chr9,134269236,134269287,0,28775687
H1|chr9:105511805-105511881,chr9,105511805,105511881,H1|chr9:33525068-33525218,chr9,33525068,33525218,0,71986737
H1|chr9:105688435-105688585,chr9,105688435,105688585,H1|chr9:96110113-96110195,chr9,96110113,96110195,0,9578322
H1|chr9:106731147-106731235,chr9,106731147,106731235,H1|chr9:33525116-33525148,chr9,33525116,33525148,0,73206031
H1|chr9:107019254-107019305,chr9,107019254,107019305,H1|chr9:33523719-33523815,chr9,33523719,33523815,0,73495535
H1|chr9:107556731-107556851,chr9,107556731,107556851,H1|chr9:133321554-133321589,chr9,133321554,133321589,0,25764823
H1|chr9:107624427-107624575,chr9,107624427,107624575,H1|chr9:33523892-33523943,chr9,33523892,33523943,0,74100535
H1|chr9:107823604-107823754,chr9,107823604,107823754,H1|chr9:96112957-96113107,chr9,96112957,96113107,0,11710647
H1|chr9:107975642-107975792,chr9,107975642,107975792,H1|chr9:33524880-33525029,chr9,33524880,33525029,0,74450762
H1|chr9:108081339-108081489,chr9,108081339,108081489,H1|chr9:96112976-96113126,chr9,96112976,96113126,0,11968363
H1|chr9:108266120-108266208,chr9,108266120,108266208,H1|chr9:33523706-33523768,chr9,33523706,33523768,0,74742414
H1|chr9:108287609-108287649,chr9,108287609,108287649,H1|chr9:96111244-96111332,chr9,96111244,96111332,0,12176365
H1|chr9:108701664-108701784,chr9,108701664,108701784,H1|chr9:133321554-133321589,chr9,133321554,133321589,0,24619890
H1|chr9:108715630-108715780,chr9,108715630,108715780,H1|chr9:96113077-96113135,chr9,96113077,96113135,0,12602553
H1|chr9:108769069-108769190,chr9,108769069,108769190,H1|chr9:131592575-131592604,chr9,131592575,131592604,0,22823506
H1|chr9:109342849-109342995,chr9,109342849,109342995,H1|chr9:33524900-33525050,chr9,33524900,33525050,0,75817949
H1|chr9:109713149-109713220,chr9,109713149,109713220,H1|chr9:140178886-140178965,chr9,140178886,140178965,0,30465737
H1|chr9:109849348-109849416,chr9,109849348,109849416,H1|chr9:23821108-23821216,chr9,23821108,23821216,0,86028240
H1|chr9:109907072-109907219,chr9,109907072,109907219,H1|chr9:96112983-96113129,chr9,96112983,96113129,0,13794089
H1|chr9:109932546-109932629,chr9,109932546,109932629,H1|chr9:134375590-134375611,chr9,134375590,134375611,0,24443044
H1|chr9:110002541-110002577,chr9,110002541,110002577,H1|chr9:96111468-96111582,chr9,96111468,96111582,0,13891073
H1|chr9:110113106-110113168,chr9,110113106,110113168,H1|chr9:33523696-33523742,chr9,33523696,33523742,0,76589410
H1|chr9:110647491-110647575,chr9,110647491,110647575,H1|chr9:116860722-116860839,chr9,116860722,116860839,0,6213231
H1|chr9:111182656-111182770,chr9,111182656,111182770,H1|chr9:133321554-133321589,chr9,133321554,133321589,0,22138898
H1|chr9:112302110-112302229,chr9,112302110,112302229,H1|chr9:135456147-135456214,chr9,135456147,135456214,0,23154037
H1|chr9:112480417-112480566,chr9,112480417,112480566,H1|chr9:68410780-68410928,chr9,68410780,68410928,0,44069637
H1|chr9:113318233-113318355,chr9,113318233,113318355,H1|chr9:131592575-131592604,chr9,131592575,131592604,0,18274342
H1|chr9:113319609-113319759,chr9,113319609,113319759,H1|chr9:96112957-96113107,chr9,96112957,96113107,0,17206652
H1|chr9:113458847-113458886,chr9,113458847,113458886,H1|chr9:131446534-131446622,chr9,131446534,131446622,0,17987687
H1|chr9:113476492-113476553,chr9,113476492,113476553,H1|chr9:140179865-140179954,chr9,140179865,140179954,0,26703373
H1|chr9:114005774-114005924,chr9,114005774,114005924,H1|chr9:96112957-96113107,chr9,96112957,96113107,0,17892817
H1|chr9:114419309-114419456,chr9,114419309,114419456,H1|chr9:96112983-96113129,chr9,96112983,96113129,0,18306326
H1|chr9:114437647-114437703,chr9,114437647,114437703,H1|chr9:35601025-35601098,chr9,35601025,35601098,0,78836622
H1|chr9:114759797-114759898,chr9,114759797,114759898,H1|chr9:96112966-96113107,chr9,96112966,96113107,0,18646831
H1|chr9:114928402-114928442,chr9,114928402,114928442,H1|chr9:109623909-109623975,chr9,109623909,109623975,0,5304493
H1|chr9:115044507-115044572,chr9,115044507,115044572,H1|chr9:140178887-140178972,chr9,140178887,140178972,0,25134380
H1|chr9:115445665-115445726,chr9,115445665,115445726,H1|chr9:33524311-33524341,chr9,33524311,33524341,0,81921354
H1|chr9:115650016-115650166,chr9,115650016,115650166,H1|chr9:96112976-96113126,chr9,96112976,96113126,0,19537040
H1|chr9:115657161-115657311,chr9,115657161,115657311,H1|chr9:33524858-33525006,chr9,33524858,33525006,0,82132303
H1|chr9:116204725-116204764,chr9,116204725,116204764,H1|chr9:131446534-131446622,chr9,131446534,131446622,0,15241809
H1|chr9:116652910-116653058,chr9,116652910,116653058,H1|chr9:96113035-96113126,chr9,96113035,96113126,0,20539875
H1|chr9:116848940-116848998,chr9,116848940,116848998,H1|chr9:117377668-117377763,chr9,117377668,117377763,0,528728
H1|chr9:117075757-117075907,chr9,117075757,117075907,H1|chr9:33524858-33525006,chr9,33524858,33525006,0,83550899
H1|chr9:117348743-117348889,chr9,117348743,117348889,H1|chr9:96112960-96113110,chr9,96112960,96113110,0,21235783
H1|chr9:118451576-118451620,chr9,118451576,118451620,H1|chr9:96110411-96110517,chr9,96110411,96110517,0,22341165
H1|chr9:119015653-119015754,chr9,119015653,119015754,H1|chr9:139440383-139440461,chr9,139440383,139440461,0,20424730
H1|chr9:119065065-119065213,chr9,119065065,119065213,H1|chr9:96112962-96113111,chr9,96112962,96113111,0,22952103
H1|chr9:119667219-119667255,chr9,119667219,119667255,H1|chr9:38490003-38490128,chr9,38490003,38490128,0,81177216
H1|chr9:119680073-119680109,chr9,119680073,119680109,H1|chr9:96111468-96111582,chr9,96111468,96111582,0,23568605
H1|chr9:119752805-119752955,chr9,119752805,119752955,H1|chr9:96112977-96113127,chr9,96112977,96113127,0,23639828
H1|chr9:120992174-120992324,chr9,120992174,120992324,H1|chr9:96112978-96113124,chr9,96112978,96113124,0,24879196
H1|chr9:121285074-121285139,chr9,121285074,121285139,H1|chr9:135460201-135460265,chr9,135460201,135460265,0,14175127
H1|chr9:121407995-121408145,chr9,121407995,121408145,H1|chr9:96112978-96113124,chr9,96112978,96113124,0,25295017
H1|chr9:121758276-121758365,chr9,121758276,121758365,H1|chr9:96111420-96111471,chr9,96111420,96111471,0,25646856
H1|chr9:122335529-122335651,chr9,122335529,122335651,H1|chr9:33524892-33524935,chr9,33524892,33524935,0,88810637
H1|chr9:122502118-122502251,chr9,122502118,122502251,H1|chr9:96112978-96113124,chr9,96112978,96113124,0,26389140
H1|chr9:122570101-122570155,chr9,122570101,122570155,H1|chr9:109622214-109622307,chr9,109622214,109622307,0,12947887
H1|chr9:123961706-123961734,chr9,123961706,123961734,H1|chr9:108004339-108004440,chr9,108004339,108004440,0,15957367
H1|chr9:124284988-124285109,chr9,124284988,124285109,H1|chr9:139441663-139441692,chr9,139441663,139441692,0,15156675
H1|chr9:124431819-124431858,chr9,124431819,124431858,H1|chr9:132804558-132804662,chr9,132804558,132804662,0,8372739
H1|chr9:124502007-124502157,chr9,124502007,124502157,H1|chr9:96112978-96113124,chr9,96112978,96113124,0,28389029
H1|chr9:124849780-124849897,chr9,124849780,124849897,H1|chr9:109625043-109625076,chr9,109625043,109625076,0,15224737
H1|chr9:124969144-124969226,chr9,124969144,124969226,H1|chr9:96112978-96113125,chr9,96112978,96113125,0,28856166
H1|chr9:125390000-125390061,chr9,125390000,125390061,H1|chr9:140179865-140179954,chr9,140179865,140179954,0,14789865
H1|chr9:125590368-125590461,chr9,125590368,125590461,H1|chr9:134272126-134272276,chr9,134272126,134272276,0,8681758
H1|chr9:125642093-125642150,chr9,125642093,125642150,H1|chr9:134269153-134269212,chr9,134269153,134269212,0,8627060
H1|chr9:125796330-125796409,chr9,125796330,125796409,H1|chr9:84301095-84301142,chr9,84301095,84301142,0,41495235
H1|chr9:126669652-126669802,chr9,126669652,126669802,H1|chr9:96112963-96113113,chr9,96112963,96113113,0,30556689
H1|chr9:126927747-126927867,chr9,126927747,126927867,H1|chr9:134271008-134271038,chr9,134271008,134271038,0,7343261
H1|chr9:126947792-126947925,chr9,126947792,126947925,H1|chr9:96112978-96113124,chr9,96112978,96113124,0,30834814
H1|chr9:127081769-127081919,chr9,127081769,127081919,H1|chr9:33524900-33525050,chr9,33524900,33525050,0,93556869
H1|chr9:127140367-127140517,chr9,127140367,127140517,H1|chr9:33524880-33525028,chr9,33524880,33525028,0,93615487
H1|chr9:127711966-127712017,chr9,127711966,127712017,H1|chr9:139440857-139440921,chr9,139440857,139440921,0,11728891
H1|chr9:128252399-128252549,chr9,128252399,128252549,H1|chr9:33524900-33525050,chr9,33524900,33525050,0,94727499
H1|chr9:129064536-129064686,chr9,129064536,129064686,H1|chr9:96112982-96113132,chr9,96112982,96113132,0,32951554
H1|chr9:129090725-129090757,chr9,129090725,129090757,H1|chr9:96111041-96111170,chr9,96111041,96111170,0,32979684
H1|chr9:129234548-129234658,chr9,129234548,129234658,H1|chr9:33524881-33524967,chr9,33524881,33524967,0,95709667
H1|chr9:129995970-129996098,chr9,129995970,129996098,H1|chr9:109625043-109625076,chr9,109625043,109625076,0,20370927
H1|chr9:130175992-130176142,chr9,130175992,130176142,H1|chr9:33524858-33525006,chr9,33524858,33525006,0,96651134
H1|chr9:130919638-130919721,chr9,130919638,130919721,H1|chr9:135456147-135456214,chr9,135456147,135456214,0,4536509
H1|chr9:131157467-131157617,chr9,131157467,131157617,H1|chr9:96112963-96113113,chr9,96112963,96113113,0,35044504
H1|chr9:131389865-131389922,chr9,131389865,131389922,H1|chr9:134269153-134269212,chr9,134269153,134269212,0,2879288
H1|chr9:132357844-132357945,chr9,132357844,132357945,H1|chr9:139440383-139440461,chr9,139440383,139440461,0,7082539
H1|chr9:132719462-132719577,chr9,132719462,132719577,H1|chr9:33525141-33525264,chr9,33525141,33525264,0,99194321
H1|chr9:133078805-133078955,chr9,133078805,133078955,H1|chr9:96112957-96113107,chr9,96112957,96113107,0,36965848
H1|chr9:133222864-133223013,chr9,133222864,133223013,H1|chr9:33524858-33525006,chr9,33524858,33525006,0,99698006
H1|chr9:133635959-133636067,chr9,133635959,133636067,H1|chr9:130701982-130702005,chr9,130701982,130702005,0,2933977
H1|chr9:133767431-133767548,chr9,133767431,133767548,H1|chr9:109625043-109625076,chr9,109625043,109625076,0,24142388
H1|chr9:133942284-133942327,chr9,133942284,133942327,H1|chr9:109623444-109623526,chr9,109623444,109623526,0,24318840
H1|chr9:133985674-133985714,chr9,133985674,133985714,H1|chr9:96111244-96111332,chr9,96111244,96111332,0,37874430
H1|chr9:134605712-134605862,chr9,134605712,134605862,H1|chr9:96112970-96113120,chr9,96112970,96113120,0,38492742
H1|chr9:134869980-134870130,chr9,134869980,134870130,H1|chr9:96112980-96113123,chr9,96112980,96113123,0,38757000
H1|chr9:135025339-135025487,chr9,135025339,135025487,H1|chr9:133320688-133320814,chr9,133320688,133320814,0,1704651
H1|chr9:135282575-135282663,chr9,135282575,135282663,H1|chr9:33523706-33523768,chr9,33523706,33523768,0,101758869
H1|chr9:135547250-135547292,chr9,135547250,135547292,H1|chr9:23821108-23821216,chr9,23821108,23821216,0,111726142
H1|chr9:135797265-135797335,chr9,135797265,135797335,H1|chr9:32572578-32572676,chr9,32572578,32572676,0,103224687
H1|chr9:136108064-136108214,chr9,136108064,136108214,H1|chr9:96112957-96113107,chr9,96112957,96113107,0,39995107
H1|chr9:136155948-136155991,chr9,136155948,136155991,H1|chr9:96113181-96113288,chr9,96113181,96113288,0,40042767
H1|chr9:136728399-136728453,chr9,136728399,136728453,H1|chr9:109622214-109622307,chr9,109622214,109622307,0,27106185
H1|chr9:136911128-136911196,chr9,136911128,136911196,H1|chr9:123341542-123341622,chr9,123341542,123341622,0,13569586
H1|chr9:137118039-137118189,chr9,137118039,137118189,H1|chr9:96112970-96113120,chr9,96112970,96113120,0,41005069
H1|chr9:137646038-137646184,chr9,137646038,137646184,H1|chr9:33524900-33525050,chr9,33524900,33525050,0,104121138
H1|chr9:137675969-137676114,chr9,137675969,137676114,H1|chr9:33524858-33525006,chr9,33524858,33525006,0,104151111
H1|chr9:138517859-138517898,chr9,138517859,138517898,H1|chr9:132804558-132804662,chr9,132804558,132804662,0,5713301
H1|chr9:138585980-138586128,chr9,138585980,138586128,H1|chr9:134271985-134272122,chr9,134271985,134272122,0,4313995
H1|chr9:138601831-138601913,chr9,138601831,138601913,H1|chr9:33523718-33523766,chr9,33523718,33523766,0,105078113
H1|chr9:138746405-138746555,chr9,138746405,138746555,H1|chr9:96112978-96113116,chr9,96112978,96113116,0,42633427
H1|chr9:139477010-139477127,chr9,139477010,139477127,H1|chr9:80646964-80646983,chr9,80646964,80646983,0,58830046
H1|chr9:139481177-139481244,chr9,139481177,139481244,H1|chr9:140489446-140489509,chr9,140489446,140489509,0,1008269
H1|chr9:139555928-139556076,chr9,139555928,139556076,H1|chr9:96112955-96113105,chr9,96112955,96113105,0,43442973
H1|chr9:139933720-139933850,chr9,139933720,139933850,H1|chr9:96113031-96113111,chr9,96113031,96113111,0,43820689
H1|chr9:140323212-140323354,chr9,140323212,140323354,H1|chr9:96111072-96111129,chr9,96111072,96111129,0,44212140
H1|chr9:140822295-140822445,chr9,140822295,140822445,H1|chr9:80646964-80646983,chr9,80646964,80646983,0,60175331
H1|chr9:141011831-141011975,chr9,141011831,141011975,H1|chr9:96112960-96113110,chr9,96112960,96113110,0,44898871
H1|chr10:646038-646125,chr10,646038,646125,H1|chr10:126843627-126843664,chr10,126843627,126843664,0,126197589
H1|chr10:966607-966694,chr10,966607,966694,H1|chr10:126843105-126843141,chr10,126843105,126843141,0,125876498
H1|chr10:1560770-1560850,chr10,1560770,1560850,H1|chr10:89625074-89625096,chr10,89625074,89625096,0,88064304
H1|chr10:1823094-1823202,chr10,1823094,1823202,H1|chr10:69834509-69834551,chr10,69834509,69834551,0,68011415
H1|chr10:2433917-2434016,chr10,2433917,2434016,H1|chr10:69834509-69834551,chr10,69834509,69834551,0,67400592
H1|chr10:3851747-3851794,chr10,3851747,3851794,H1|chr10:93558943-93559029,chr10,93558943,93559029,0,89707196
H1|chr10:4000205-4000285,chr10,4000205,4000285,H1|chr10:125750702-125750761,chr10,125750702,125750761,0,121750497
H1|chr10:4033589-4033637,chr10,4033589,4033637,H1|chr10:69834791-69834853,chr10,69834791,69834853,0,65801202
H1|chr10:4065776-4065845,chr10,4065776,4065845,H1|chr10:83636494-83636573,chr10,83636494,83636573,0,79570718
H1|chr10:4295270-4295316,chr10,4295270,4295316,H1|chr10:65027599-65027668,chr10,65027599,65027668,0,60732329
H1|chr10:5062570-5062681,chr10,5062570,5062681,H1|chr10:93558759-93558798,chr10,93558759,93558798,0,88496189
H1|chr10:5636902-5636946,chr10,5636902,5636946,H1|chr10:123732855-123732942,chr10,123732855,123732942,0,118095953
H1|chr10:5889540-5889568,chr10,5889540,5889568,H1|chr10:23384884-23384986,chr10,23384884,23384986,0,17495344
H1|chr10:7201834-7201852,chr10,7201834,7201852,H1|chr10:33240530-33240559,chr10,33240530,33240559,0,26038696
H1|chr10:8560167-8560244,chr10,8560167,8560244,H1|chr10:99207455-99207602,chr10,99207455,99207602,0,90647288
H1|chr10:8592430-8592529,chr10,8592430,8592529,H1|chr10:13384491-13384562,chr10,13384491,13384562,0,4792061
H1|chr10:9890540-9890619,chr10,9890540,9890619,H1|chr10:126846171-126846235,chr10,126846171,126846235,0,116955631
H1|chr10:10617046-10617119,chr10,10617046,10617119,H1|chr10:69647516-69647606,chr10,69647516,69647606,0,59030470
H1|chr10:11525722-11525815,chr10,11525722,11525815,H1|chr10:977582-977629,chr10,977582,977629,0,10548140
H1|chr10:12137819-12137922,chr10,12137819,12137922,H1|chr10:83636057-83636104,chr10,83636057,83636104,0,71498238
H1|chr10:13587864-13587957,chr10,13587864,13587957,H1|chr10:69834506-69834537,chr10,69834506,69834537,0,56246642
H1|chr10:13715489-13715567,chr10,13715489,13715567,H1|chr10:126842753-126842821,chr10,126842753,126842821,0,113127264
H1|chr10:13912004-13912041,chr10,13912004,13912041,H1|chr10:88518244-88518275,chr10,88518244,88518275,0,74606240
H1|chr10:13926289-13926313,chr10,13926289,13926313,H1|chr10:65276392-65276503,chr10,65276392,65276503,0,51350103
H1|chr10:13944946-13945037,chr10,13944946,13945037,H1|chr10:65280475-65280534,chr10,65280475,65280534,0,51335529
H1|chr10:14227435-14227546,chr10,14227435,14227546,H1|chr10:123355037-123355117,chr10,123355037,123355117,0,109127602
H1|chr10:14321011-14321089,chr10,14321011,14321089,H1|chr10:88519034-88519075,chr10,88519034,88519075,0,74198023
H1|chr10:14460793-14460837,chr10,14460793,14460837,H1|chr10:82217143-82217267,chr10,82217143,82217267,0,67756350
H1|chr10:14683912-14683950,chr10,14683912,14683950,H1|chr10:125746375-125746487,chr10,125746375,125746487,0,111062463
H1|chr10:14738697-14738767,chr10,14738697,14738767,H1|chr10:126843870-126843912,chr10,126843870,126843912,0,112105173
H1|chr10:15049059-15049141,chr10,15049059,15049141,H1|chr10:133999301-133999321,chr10,133999301,133999321,0,118950242
H1|chr10:15723086-15723132,chr10,15723086,15723132,H1|chr10:123732855-123732942,chr10,123732855,123732942,0,108009769
H1|chr10:15868855-15868907,chr10,15868855,15868907,H1|chr10:104158593-104158679,chr10,104158593,104158679,0,88289738
H1|chr10:16480523-16480575,chr10,16480523,16480575,H1|chr10:75760188-75760234,chr10,75760188,75760234,0,59279665
H1|chr10:16577664-16577704,chr10,16577664,16577704,H1|chr10:126844113-126844182,chr10,126844113,126844182,0,110266449
H1|chr10:17353638-17353709,chr10,17353638,17353709,H1|chr10:65224691-65224770,chr10,65224691,65224770,0,47871053
H1|chr10:17714012-17714053,chr10,17714012,17714053,H1|chr10:69647450-69647583,chr10,69647450,69647583,0,51933438
H1|chr10:17801271-17801318,chr10,17801271,17801318,H1|chr10:65280372-65280469,chr10,65280372,65280469,0,47479101
H1|chr10:18207274-18207387,chr10,18207274,18207387,H1|chr10:128589101-128589127,chr10,128589101,128589127,0,110381827
H1|chr10:18342153-18342224,chr10,18342153,18342224,H1|chr10:65224691-65224770,chr10,65224691,65224770,0,46882538
H1|chr10:18622236-18622315,chr10,18622236,18622315,H1|chr10:13384491-13384562,chr10,13384491,13384562,0,5237745
H1|chr10:18739669-18739746,chr10,18739669,18739746,H1|chr10:99472747-99472820,chr10,99472747,99472820,0,80733078
H1|chr10:18912530-18912559,chr10,18912530,18912559,H1|chr10:65278451-65278547,chr10,65278451,65278547,0,46365921
H1|chr10:19376099-19376194,chr10,19376099,19376194,H1|chr10:128590319-128590341,chr10,128590319,128590341,0,109214220
H1|chr10:19407118-19407182,chr10,19407118,19407182,H1|chr10:114714842-114714910,chr10,114714842,114714910,0,95307724
H1|chr10:19561120-19561232,chr10,19561120,19561232,H1|chr10:123355037-123355117,chr10,123355037,123355117,0,103793917
H1|chr10:19915742-19915781,chr10,19915742,19915781,H1|chr10:116525966-116526003,chr10,116525966,116526003,0,96610224
H1|chr10:20179039-20179086,chr10,20179039,20179086,H1|chr10:93558943-93559029,chr10,93558943,93559029,0,73379904
H1|chr10:21504614-21504650,chr10,21504614,21504650,H1|chr10:128594932-128594980,chr10,128594932,128594980,0,107090318
H1|chr10:21576759-21576810,chr10,21576759,21576810,H1|chr10:79398643-79398762,chr10,79398643,79398762,0,57821884
H1|chr10:21951690-21951773,chr10,21951690,21951773,H1|chr10:65280834-65280897,chr10,65280834,65280897,0,43329144
H1|chr10:22119196-22119219,chr10,22119196,22119219,H1|chr10:43930869-43930948,chr10,43930869,43930948,0,21811673
H1|chr10:22378771-22378879,chr10,22378771,22378879,H1|chr10:69834509-69834551,chr10,69834509,69834551,0,47455738
H1|chr10:22592738-22592827,chr10,22592738,22592827,H1|chr10:65278202-65278263,chr10,65278202,65278263,0,42685464
H1|chr10:24158268-24158331,chr10,24158268,24158331,H1|chr10:33240531-33240559,chr10,33240531,33240559,0,9082263
H1|chr10:24388885-24388968,chr10,24388885,24388968,H1|chr10:65280834-65280897,chr10,65280834,65280897,0,40891949
H1|chr10:24957472-24957511,chr10,24957472,24957511,H1|chr10:65226445-65226504,chr10,65226445,65226504,0,40268973
H1|chr10:25570089-25570157,chr10,25570089,25570157,H1|chr10:65026231-65026274,chr10,65026231,65026274,0,39456142
H1|chr10:25666105-25666169,chr10,25666105,25666169,H1|chr10:18689453-18689489,chr10,18689453,18689489,0,6976652
H1|chr10:26762058-26762087,chr10,26762058,26762087,H1|chr10:123686853-123686929,chr10,123686853,123686929,0,96924795
H1|chr10:26794130-26794183,chr10,26794130,26794183,H1|chr10:126844447-126844544,chr10,126844447,126844544,0,100050317
H1|chr10:27207120-27207180,chr10,27207120,27207180,H1|chr10:114645673-114645763,chr10,114645673,114645763,0,87438553
H1|chr10:28107782-28107871,chr10,28107782,28107871,H1|chr10:126844447-126844544,chr10,126844447,126844544,0,98736665
H1|chr10:28225854-28225879,chr10,28225854,28225879,H1|chr10:65279077-65279171,chr10,65279077,65279171,0,37053223
H1|chr10:28335268-28335354,chr10,28335268,28335354,H1|chr10:114706843-114706883,chr10,114706843,114706883,0,86371575
H1|chr10:29328903-29328933,chr10,29328903,29328933,H1|chr10:23384884-23384986,chr10,23384884,23384986,0,5944019
H1|chr10:29419811-29419834,chr10,29419811,29419834,H1|chr10:43930869-43930948,chr10,43930869,43930948,0,14511058
H1|chr10:29824841-29824890,chr10,29824841,29824890,H1|chr10:65277791-65277853,chr10,65277791,65277853,0,35452950
H1|chr10:30509004-30509038,chr10,30509004,30509038,H1|chr10:65278328-65278357,chr10,65278328,65278357,0,34769324
H1|chr10:30975244-30975272,chr10,30975244,30975272,H1|chr10:79401100-79401138,chr10,79401100,79401138,0,48425856
H1|chr10:30987908-30987971,chr10,30987908,30987971,H1|chr10:33240531-33240559,chr10,33240531,33240559,0,2252623
H1|chr10:31141817-31141929,chr10,31141817,31141929,H1|chr10:126843958-126843990,chr10,126843958,126843990,0,95702141
H1|chr10:32274122-32274221,chr10,32274122,32274221,H1|chr10:13384491-13384562,chr10,13384491,13384562,0,18889631
H1|chr10:32503020-32503084,chr10,32503020,32503084,H1|chr10:114714842-114714910,chr10,114714842,114714910,0,82211822
H1|chr10:33122683-33122723,chr10,33122683,33122723,H1|chr10:126844113-126844182,chr10,126844113,126844182,0,93721430
H1|chr10:33263627-33263682,chr10,33263627,33263682,H1|chr10:65279074-65279169,chr10,65279074,65279169,0,32015447
H1|chr10:34143760-34143840,chr10,34143760,34143840,H1|chr10:125750702-125750761,chr10,125750702,125750761,0,91606942
H1|chr10:34546135-34546170,chr10,34546135,34546170,H1|chr10:65277281-65277413,chr10,65277281,65277413,0,30731146
H1|chr10:34644559-34644588,chr10,34644559,34644588,H1|chr10:114707065-114707198,chr10,114707065,114707198,0,80062506
H1|chr10:34909733-34909762,chr10,34909733,34909762,H1|chr10:123686853-123686929,chr10,123686853,123686929,0,88777120
H1|chr10:35638828-35638881,chr10,35638828,35638881,H1|chr10:126844447-126844544,chr10,126844447,126844544,0,91205619
H1|chr10:36343893-36343915,chr10,36343893,36343915,H1|chr10:99472996-99473050,chr10,99472996,99473050,0,63129103
H1|chr10:36474069-36474090,chr10,36474069,36474090,H1|chr10:114707758-114707879,chr10,114707758,114707879,0,78233689
H1|chr10:36650360-36650470,chr10,36650360,36650470,H1|chr10:116525966-116526003,chr10,116525966,116526003,0,79875606
H1|chr10:36714847-36714942,chr10,36714847,36714942,H1|chr10:58119988-58120010,chr10,58119988,58120010,0,21405141
H1|chr10:36914758-36914807,chr10,36914758,36914807,H1|chr10:69647516-69647606,chr10,69647516,69647606,0,32732758
H1|chr10:37081822-37081864,chr10,37081822,37081864,H1|chr10:114709033-114709104,chr10,114709033,114709104,0,77627211
H1|chr10:37451167-37451202,chr10,37451167,37451202,H1|chr10:65277281-65277413,chr10,65277281,65277413,0,27826114
H1|chr10:37537209-37537296,chr10,37537209,37537296,H1|chr10:126845206-126845266,chr10,126845206,126845266,0,89307997
H1|chr10:38162816-38162905,chr10,38162816,38162905,H1|chr10:32221499-32221560,chr10,32221499,32221560,0,5941317
H1|chr10:39017449-39017536,chr10,39017449,39017536,H1|chr10:75764683-75764707,chr10,75764683,75764707,0,36747234
H1|chr10:39174187-39174276,chr10,39174187,39174276,H1|chr10:33240091-33240117,chr10,33240091,33240117,0,5934096
H1|chr10:39183009-39183035,chr10,39183009,39183035,H1|chr10:126844645-126844701,chr10,126844645,126844701,0,87661636
H1|chr10:39560135-39560189,chr10,39560135,39560189,H1|chr10:65279372-65279512,chr10,65279372,65279512,0,25719237
H1|chr10:39788382-39788460,chr10,39788382,39788460,H1|chr10:126846171-126846235,chr10,126846171,126846235,0,87057789
H1|chr10:39925633-39925720,chr10,39925633,39925720,H1|chr10:126845206-126845266,chr10,126845206,126845266,0,86919573
H1|chr10:40065650-40065686,chr10,40065650,40065686,H1|chr10:103893300-103893347,chr10,103893300,103893347,0,63827650
H1|chr10:40423552-40423597,chr10,40423552,40423597,H1|chr10:93558943-93559029,chr10,93558943,93559029,0,53135391
H1|chr10:40525012-40525094,chr10,40525012,40525094,H1|chr10:83636494-83636573,chr10,83636494,83636573,0,43111482
H1|chr10:41004519-41004648,chr10,41004519,41004648,H1|chr10:44881310-44881331,chr10,44881310,44881331,0,3876791
H1|chr10:41383230-41383287,chr10,41383230,41383287,H1|chr10:65278995-65279058,chr10,65278995,65279058,0,23895765
H1|chr10:41757656-41757708,chr10,41757656,41757708,H1|chr10:75760188-75760234,chr10,75760188,75760234,0,34002532
H1|chr10:42239977-42240034,chr10,42239977,42240034,H1|chr10:65278995-65279058,chr10,65278995,65279058,0,23039018
H1|chr10:42287262-42287353,chr10,42287262,42287353,H1|chr10:75759444-75759503,chr10,75759444,75759503,0,33472182
H1|chr10:42770586-42770709,chr10,42770586,42770709,H1|chr10:71208172-71208189,chr10,71208172,71208189,0,28437586
H1|chr10:42923692-42923753,chr10,42923692,42923753,H1|chr10:126843118-126843187,chr10,126843118,126843187,0,83919426
H1|chr10:43089249-43089298,chr10,43089249,43089298,H1|chr10:65277791-65277853,chr10,65277791,65277853,0,22188542
H1|chr10:43176405-43176533,chr10,43176405,43176533,H1|chr10:44881310-44881331,chr10,44881310,44881331,0,1704905
H1|chr10:43925839-43925871,chr10,43925839,43925871,H1|chr10:114715608-114715685,chr10,114715608,114715685,0,70789769
H1|chr10:45349103-45349173,chr10,45349103,45349173,H1|chr10:123355037-123355117,chr10,123355037,123355117,0,78005934
H1|chr10:45568993-45569041,chr10,45568993,45569041,H1|chr10:123732855-123732942,chr10,123732855,123732942,0,78163862
H1|chr10:45779516-45779603,chr10,45779516,45779603,H1|chr10:75764683-75764707,chr10,75764683,75764707,0,29985167
H1|chr10:46219818-46219885,chr10,46219818,46219885,H1|chr10:32216219-32216253,chr10,32216219,32216253,0,14003599
H1|chr10:46232938-46232994,chr10,46232938,46232994,H1|chr10:126843807-126843841,chr10,126843807,126843841,0,80610869
H1|chr10:46374941-46375084,chr10,46374941,46375084,H1|chr10:65280834-65280897,chr10,65280834,65280897,0,18905893
H1|chr10:46433476-46433547,chr10,46433476,46433547,H1|chr10:114709370-114709394,chr10,114709370,114709394,0,68275894
H1|chr10:46666075-46666170,chr10,46666075,46666170,H1|chr10:977582-977629,chr10,977582,977629,0,45688493
H1|chr10:47012819-47012904,chr10,47012819,47012904,H1|chr10:116521429-116521494,chr10,116521429,116521494,0,69508610
H1|chr10:47130174-47130215,chr10,47130174,47130215,H1|chr10:65278708-65278761,chr10,65278708,65278761,0,18148534
H1|chr10:47228209-47228253,chr10,47228209,47228253,H1|chr10:82217143-82217267,chr10,82217143,82217267,0,34988934
H1|chr10:47778019-47778167,chr10,47778019,47778167,H1|chr10:126846175-126846213,chr10,126846175,126846213,0,79068156
H1|chr10:48032096-48032130,chr10,48032096,48032130,H1|chr10:114708956-114709058,chr10,114708956,114709058,0,66676860
H1|chr10:48826801-48826862,chr10,48826801,48826862,H1|chr10:126843118-126843187,chr10,126843118,126843187,0,78016317
H1|chr10:49053529-49053574,chr10,49053529,49053574,H1|chr10:88517194-88517290,chr10,88517194,88517290,0,39463665
H1|chr10:49430655-49430677,chr10,49430655,49430677,H1|chr10:69649858-69649949,chr10,69649858,69649949,0,20219203
H1|chr10:50410766-50410830,chr10,50410766,50410830,H1|chr10:18689453-18689489,chr10,18689453,18689489,0,31721313
H1|chr10:50844221-50844281,chr10,50844221,50844281,H1|chr10:114645673-114645763,chr10,114645673,114645763,0,63801452
H1|chr10:50888851-50888936,chr10,50888851,50888936,H1|chr10:75633860-75633915,chr10,75633860,75633915,0,24745009
H1|chr10:50969971-50970058,chr10,50969971,50970058,H1|chr10:126843627-126843664,chr10,126843627,126843664,0,75873656
H1|chr10:51830577-51830605,chr10,51830577,51830605,H1|chr10:23384884-23384986,chr10,23384884,23384986,0,28445693
H1|chr10:52031657-52031693,chr10,52031657,52031693,H1|chr10:128594932-128594980,chr10,128594932,128594980,0,76563275
H1|chr10:53113525-53113620,chr10,53113525,53113620,H1|chr10:977582-977629,chr10,977582,977629,0,52135943
H1|chr10:53983109-53983182,chr10,53983109,53983182,H1|chr10:65279074-65279169,chr10,65279074,65279169,0,11295965
H1|chr10:56099289-56099439,chr10,56099289,56099439,H1|chr10:65280475-65280534,chr10,65280475,65280534,0,9181186
H1|chr10:56843937-56844053,chr10,56843937,56844053,H1|chr10:32221499-32221560,chr10,32221499,32221560,0,24622438
H1|chr10:57169554-57169631,chr10,57169554,57169631,H1|chr10:99207455-99207602,chr10,99207455,99207602,0,42037901
H1|chr10:57371670-57371695,chr10,57371670,57371695,H1|chr10:65279077-65279171,chr10,65279077,65279171,0,7907407
H1|chr10:57571960-57572051,chr10,57571960,57572051,H1|chr10:75759444-75759503,chr10,75759444,75759503,0,18187484
H1|chr10:57731204-57731271,chr10,57731204,57731271,H1|chr10:65278209-65278282,chr10,65278209,65278282,0,7547005
H1|chr10:58376593-58376613,chr10,58376593,58376613,H1|chr10:65278451-65278547,chr10,65278451,65278547,0,6901858
H1|chr10:58445774-58445853,chr10,58445774,58445853,H1|chr10:126846171-126846235,chr10,126846171,126846235,0,68400397
H1|chr10:58597186-58597280,chr10,58597186,58597280,H1|chr10:58119988-58120010,chr10,58119988,58120010,0,477198
H1|chr10:59889555-59889656,chr10,59889555,59889656,H1|chr10:126846175-126846213,chr10,126846175,126846213,0,66956620
H1|chr10:60110038-60110139,chr10,60110038,60110139,H1|chr10:126846175-126846213,chr10,126846175,126846213,0,66736137
H1|chr10:60158379-60158418,chr10,60158379,60158418,H1|chr10:65226445-65226504,chr10,65226445,65226504,0,5068066
H1|chr10:60745914-60746008,chr10,60745914,60746008,H1|chr10:58119988-58120010,chr10,58119988,58120010,0,2625926
H1|chr10:61778621-61778676,chr10,61778621,61778676,H1|chr10:126843807-126843841,chr10,126843807,126843841,0,65065186
H1|chr10:61944100-61944154,chr10,61944100,61944154,H1|chr10:111768562-111768625,chr10,111768562,111768625,0,49824462
H1|chr10:62128927-62128968,chr10,62128927,62128968,H1|chr10:126844113-126844182,chr10,126844113,126844182,0,64715186
H1|chr10:62299791-62299829,chr10,62299791,62299829,H1|chr10:125746375-125746487,chr10,125746375,125746487,0,63446584
H1|chr10:62804049-62804085,chr10,62804049,62804085,H1|chr10:69647434-69647548,chr10,69647434,69647548,0,6843385
H1|chr10:63391581-63391640,chr10,63391581,63391640,H1|chr10:977582-977629,chr10,977582,977629,0,62413999
H1|chr10:63800768-63800850,chr10,63800768,63800850,H1|chr10:133999301-133999321,chr10,133999301,133999321,0,70198533
H1|chr10:63954595-63954638,chr10,63954595,63954638,H1|chr10:69647434-69647548,chr10,69647434,69647548,0,5692839
H1|chr10:64210183-64210274,chr10,64210183,64210274,H1|chr10:33240091-33240117,chr10,33240091,33240117,0,30970092
H1|chr10:64252267-64252323,chr10,64252267,64252323,H1|chr10:126843807-126843841,chr10,126843807,126843841,0,62591540
H1|chr10:67145973-67146043,chr10,67145973,67146043,H1|chr10:126843870-126843912,chr10,126843870,126843912,0,59697897
H1|chr10:67466999-67467041,chr10,67466999,67467041,H1|chr10:13388774-13388794,chr10,13388774,13388794,0,54078225
H1|chr10:67668818-67668900,chr10,67668818,67668900,H1|chr10:65224691-65224770,chr10,65224691,65224770,0,2444127
H1|chr10:68400918-68400953,chr10,68400918,68400953,H1|chr10:114707758-114707879,chr10,114707758,114707879,0,46306840
H1|chr10:68503867-68504017,chr10,68503867,68504017,H1|chr10:65280475-65280534,chr10,65280475,65280534,0,3223392
H1|chr10:68594514-68594624,chr10,68594514,68594624,H1|chr10:116525966-116526003,chr10,116525966,116526003,0,47931452
H1|chr10:68652421-68652534,chr10,68652421,68652534,H1|chr10:128589101-128589127,chr10,128589101,128589127,0,59936680
H1|chr10:69229199-69229245,chr10,69229199,69229245,H1|chr10:123732855-123732942,chr10,123732855,123732942,0,54503656
H1|chr10:69687154-69687205,chr10,69687154,69687205,H1|chr10:65276469-65276568,chr10,65276469,65276568,0,4410685
H1|chr10:69837558-69837603,chr10,69837558,69837603,H1|chr10:88517194-88517290,chr10,88517194,88517290,0,18679636
H1|chr10:70075490-70075543,chr10,70075490,70075543,H1|chr10:104158593-104158679,chr10,104158593,104158679,0,34083103
H1|chr10:70349853-70349879,chr10,70349853,70349879,H1|chr10:82217143-82217267,chr10,82217143,82217267,0,11867290
H1|chr10:70392848-70392872,chr10,70392848,70392872,H1|chr10:58119988-58120010,chr10,58119988,58120010,0,12272860
H1|chr10:70611916-70612038,chr10,70611916,70612038,H1|chr10:126845206-126845266,chr10,126845206,126845266,0,56233290
H1|chr10:71449829-71449894,chr10,71449829,71449894,H1|chr10:126843118-126843187,chr10,126843118,126843187,0,55393289
H1|chr10:71835847-71835917,chr10,71835847,71835917,H1|chr10:114709370-114709394,chr10,114709370,114709394,0,42873523
H1|chr10:72027374-72027413,chr10,72027374,72027413,H1|chr10:116525966-116526003,chr10,116525966,116526003,0,44498592
H1|chr10:72191997-72192125,chr10,72191997,72192125,H1|chr10:44881310-44881331,chr10,44881310,44881331,0,27310687
H1|chr10:72268254-72268383,chr10,72268254,72268383,H1|chr10:44881310-44881331,chr10,44881310,44881331,0,27386944
H1|chr10:72321326-72321378,chr10,72321326,72321378,H1|chr10:104158593-104158679,chr10,104158593,104158679,0,31837267
H1|chr10:72637659-72637758,chr10,72637659,72637758,H1|chr10:69834509-69834551,chr10,69834509,69834551,0,2803150
H1|chr10:72840541-72840592,chr10,72840541,72840592,H1|chr10:79398643-79398762,chr10,79398643,79398762,0,6558102
H1|chr10:74091753-74091781,chr10,74091753,74091781,H1|chr10:79401100-79401138,chr10,79401100,79401138,0,5309347
H1|chr10:74265557-74265579,chr10,74265557,74265579,H1|chr10:27445396-27445530,chr10,27445396,27445530,0,46820161
H1|chr10:74570193-74570271,chr10,74570193,74570271,H1|chr10:88519034-88519075,chr10,88519034,88519075,0,13948841
H1|chr10:75101135-75101217,chr10,75101135,75101217,H1|chr10:65224691-65224770,chr10,65224691,65224770,0,9876444
H1|chr10:75404312-75404367,chr10,75404312,75404367,H1|chr10:65279074-65279169,chr10,65279074,65279169,0,10125238
H1|chr10:75738403-75738488,chr10,75738403,75738488,H1|chr10:116521429-116521494,chr10,116521429,116521494,0,40783026
H1|chr10:75825903-75825954,chr10,75825903,75825954,H1|chr10:65276469-65276568,chr10,65276469,65276568,0,10549434
H1|chr10:76261248-76261298,chr10,76261248,76261298,H1|chr10:99470513-99470663,chr10,99470513,99470663,0,23209265
H1|chr10:76370919-76371010,chr10,76370919,76371010,H1|chr10:65280475-65280534,chr10,65280475,65280534,0,11090444
H1|chr10:76980717-76980808,chr10,76980717,76980808,H1|chr10:75759444-75759503,chr10,75759444,75759503,0,1221273
H1|chr10:77175079-77175126,chr10,77175079,77175126,H1|chr10:65280372-65280469,chr10,65280372,65280469,0,11894707
H1|chr10:77530225-77530347,chr10,77530225,77530347,H1|chr10:126845206-126845266,chr10,126845206,126845266,0,49314981
H1|chr10:77702084-77702129,chr10,77702084,77702129,H1|chr10:93558943-93559029,chr10,93558943,93559029,0,15856859
H1|chr10:78050997-78051038,chr10,78050997,78051038,H1|chr10:126844113-126844182,chr10,126844113,126844182,0,48793116
H1|chr10:78095971-78096005,chr10,78095971,78096005,H1|chr10:114708956-114709058,chr10,114708956,114709058,0,36612985
H1|chr10:78448512-78448553,chr10,78448512,78448553,H1|chr10:69647450-69647583,chr10,69647450,69647583,0,8801062
H1|chr10:79150188-79150222,chr10,79150188,79150222,H1|chr10:65278328-65278357,chr10,65278328,65278357,0,13871860
H1|chr10:79393594-79393612,chr10,79393594,79393612,H1|chr10:33240530-33240559,chr10,33240530,33240559,0,46153064
H1|chr10:79528342-79528369,chr10,79528342,79528369,H1|chr10:123686754-123686812,chr10,123686754,123686812,0,44158412
H1|chr10:80319554-80319649,chr10,80319554,80319649,H1|chr10:128590319-128590341,chr10,128590319,128590341,0,48270765
H1|chr10:80378235-80378328,chr10,80378235,80378328,H1|chr10:977582-977629,chr10,977582,977629,0,79400653
H1|chr10:80895702-80895722,chr10,80895702,80895722,H1|chr10:65278451-65278547,chr10,65278451,65278547,0,15617251
H1|chr10:81688711-81688802,chr10,81688711,81688802,H1|chr10:33240091-33240117,chr10,33240091,33240117,0,48448620
H1|chr10:82197198-82197309,chr10,82197198,82197309,H1|chr10:123355037-123355117,chr10,123355037,123355117,0,41157839
H1|chr10:82524869-82524923,chr10,82524869,82524923,H1|chr10:111768562-111768625,chr10,111768562,111768625,0,29243693
H1|chr10:83475083-83475181,chr10,83475083,83475181,H1|chr10:75763559-75763597,chr10,75763559,75763597,0,7711524
H1|chr10:85295828-85295874,chr10,85295828,85295874,H1|chr10:65027599-65027668,chr10,65027599,65027668,0,20268229
H1|chr10:85815325-85815349,chr10,85815325,85815349,H1|chr10:58119988-58120010,chr10,58119988,58120010,0,27695337
H1|chr10:85914358-85914448,chr10,85914358,85914448,H1|chr10:116521429-116521494,chr10,116521429,116521494,0,30607071
H1|chr10:86845005-86845048,chr10,86845005,86845048,H1|chr10:69647434-69647548,chr10,69647434,69647548,0,17197571
H1|chr10:87021992-87022032,chr10,87021992,87022032,H1|chr10:111768694-111768798,chr10,111768694,111768798,0,24746702
H1|chr10:87134486-87134555,chr10,87134486,87134555,H1|chr10:83636494-83636573,chr10,83636494,83636573,0,3497992
H1|chr10:87251159-87251199,chr10,87251159,87251199,H1|chr10:111768694-111768798,chr10,111768694,111768798,0,24517535
H1|chr10:87332508-87332606,chr10,87332508,87332606,H1|chr10:75763559-75763597,chr10,75763559,75763597,0,11568949
H1|chr10:88537653-88537680,chr10,88537653,88537680,H1|chr10:123686754-123686812,chr10,123686754,123686812,0,35149101
H1|chr10:88792016-88792097,chr10,88792016,88792097,H1|chr10:89625074-89625096,chr10,89625074,89625096,0,833058
H1|chr10:89351837-89351919,chr10,89351837,89351919,H1|chr10:83636494-83636573,chr10,83636494,83636573,0,5715343
H1|chr10:89404780-89404821,chr10,89404780,89404821,H1|chr10:65278708-65278761,chr10,65278708,65278761,0,24126072
H1|chr10:89944122-89944148,chr10,89944122,89944148,H1|chr10:69834509-69834551,chr10,69834509,69834551,0,20109613
H1|chr10:90681159-90681180,chr10,90681159,90681180,H1|chr10:114707758-114707879,chr10,114707758,114707879,0,24026599
H1|chr10:91246245-91246274,chr10,91246245,91246274,H1|chr10:114707065-114707198,chr10,114707065,114707198,0,23460820
H1|chr10:92055801-92055909,chr10,92055801,92055909,H1|chr10:83636057-83636104,chr10,83636057,83636104,0,8419744
H1|chr10:92221314-92221382,chr10,92221314,92221382,H1|chr10:65026231-65026274,chr10,65026231,65026274,0,27195083
H1|chr10:92244200-92244226,chr10,92244200,92244226,H1|chr10:126844645-126844701,chr10,126844645,126844701,0,34600445
H1|chr10:92753273-92753305,chr10,92753273,92753305,H1|chr10:114715608-114715685,chr10,114715608,114715685,0,21962335
H1|chr10:92995376-92995405,chr10,92995376,92995405,H1|chr10:65278451-65278547,chr10,65278451,65278547,0,27716925
H1|chr10:93804971-93805019,chr10,93804971,93805019,H1|chr10:123732855-123732942,chr10,123732855,123732942,0,29927884
H1|chr10:93940104-93940169,chr10,93940104,93940169,H1|chr10:126843118-126843187,chr10,126843118,126843187,0,32903014
H1|chr10:94622522-94622611,chr10,94622522,94622611,H1|chr10:126844447-126844544,chr10,126844447,126844544,0,32221925
H1|chr10:94852112-94852205,chr10,94852112,94852205,H1|chr10:128590319-128590341,chr10,128590319,128590341,0,33738207
H1|chr10:95149461-95149534,chr10,95149461,95149534,H1|chr10:65279074-65279169,chr10,65279074,65279169,0,29870387
H1|chr10:95340451-95340554,chr10,95340451,95340554,H1|chr10:83636057-83636104,chr10,83636057,83636104,0,11704394
H1|chr10:95399904-95399995,chr10,95399904,95399995,H1|chr10:75759444-75759503,chr10,75759444,75759503,0,19640460
H1|chr10:95671951-95671977,chr10,95671951,95671977,H1|chr10:69834509-69834551,chr10,69834509,69834551,0,25837442
H1|chr10:95907931-95908021,chr10,95907931,95908021,H1|chr10:116521429-116521494,chr10,116521429,116521494,0,20613498
H1|chr10:96123011-96123095,chr10,96123011,96123095,H1|chr10:65279527-65279568,chr10,65279527,65279568,0,30843484
H1|chr10:96288809-96288862,chr10,96288809,96288862,H1|chr10:75760188-75760234,chr10,75760188,75760234,0,20528621
H1|chr10:97149470-97149531,chr10,97149470,97149531,H1|chr10:82212257-82212312,chr10,82212257,82212312,0,14937213
H1|chr10:98017968-98018039,chr10,98017968,98018039,H1|chr10:114709370-114709394,chr10,114709370,114709394,0,16691402
H1|chr10:98484185-98484252,chr10,98484185,98484252,H1|chr10:32216219-32216253,chr10,32216219,32216253,0,66267966
H1|chr10:99175098-99175157,chr10,99175098,99175157,H1|chr10:977582-977629,chr10,977582,977629,0,98197516
H1|chr10:99376162-99376285,chr10,99376162,99376285,H1|chr10:71208172-71208189,chr10,71208172,71208189,0,28167990
H1|chr10:99577199-99577342,chr10,99577199,99577342,H1|chr10:65280834-65280897,chr10,65280834,65280897,0,34296365
H1|chr10:99708924-99708955,chr10,99708924,99708955,H1|chr10:79398643-79398762,chr10,79398643,79398762,0,20310281
H1|chr10:100298488-100298529,chr10,100298488,100298529,H1|chr10:114709033-114709104,chr10,114709033,114709104,0,14410545
H1|chr10:101223678-101223773,chr10,101223678,101223773,H1|chr10:58119988-58120010,chr10,58119988,58120010,0,43103690
H1|chr10:104110079-104110110,chr10,104110079,104110110,H1|chr10:79398643-79398762,chr10,79398643,79398762,0,24711436
H1|chr10:104213580-104213615,chr10,104213580,104213615,H1|chr10:114707758-114707879,chr10,114707758,114707879,0,10494178
H1|chr10:104367903-104367925,chr10,104367903,104367925,H1|chr10:27445396-27445530,chr10,27445396,27445530,0,76922507
H1|chr10:104521098-104521152,chr10,104521098,104521152,H1|chr10:65280372-65280469,chr10,65280372,65280469,0,39240726
H1|chr10:105172535-105172621,chr10,105172535,105172621,H1|chr10:114706843-114706883,chr10,114706843,114706883,0,9534308
H1|chr10:105372037-105372121,chr10,105372037,105372121,H1|chr10:65279527-65279568,chr10,65279527,65279568,0,40092510
H1|chr10:105594280-105594332,chr10,105594280,105594332,H1|chr10:111768562-111768625,chr10,111768562,111768625,0,6174282
H1|chr10:106658277-106658388,chr10,106658277,106658388,H1|chr10:93558759-93558798,chr10,93558759,93558798,0,13099518
H1|chr10:106861490-106861531,chr10,106861490,106861531,H1|chr10:114709033-114709104,chr10,114709033,114709104,0,7847543
H1|chr10:106979791-106979939,chr10,106979791,106979939,H1|chr10:126846175-126846213,chr10,126846175,126846213,0,19866384
H1|chr10:107074285-107074333,chr10,107074285,107074333,H1|chr10:69834791-69834853,chr10,69834791,69834853,0,37239494
H1|chr10:107375257-107375307,chr10,107375257,107375307,H1|chr10:99470513-99470663,chr10,99470513,99470663,0,7904744
H1|chr10:107380830-107380899,chr10,107380830,107380899,H1|chr10:126843870-126843912,chr10,126843870,126843912,0,19463040
H1|chr10:108153152-108153176,chr10,108153152,108153176,H1|chr10:65276392-65276503,chr10,65276392,65276503,0,42876760
H1|chr10:108473470-108473547,chr10,108473470,108473547,H1|chr10:99472747-99472820,chr10,99472747,99472820,0,9000723
H1|chr10:109244684-109244800,chr10,109244684,109244800,H1|chr10:32221499-32221560,chr10,32221499,32221560,0,77023185
H1|chr10:109285397-109285417,chr10,109285397,109285417,H1|chr10:69649858-69649949,chr10,69649858,69649949,0,39635539
H1|chr10:109581042-109581062,chr10,109581042,109581062,H1|chr10:69649858-69649949,chr10,69649858,69649949,0,39931184
H1|chr10:109882688-109882800,chr10,109882688,109882800,H1|chr10:123355037-123355117,chr10,123355037,123355117,0,13472349
H1|chr10:110915534-110915576,chr10,110915534,110915576,H1|chr10:114644992-114645064,chr10,114644992,114645064,0,3729458
H1|chr10:111650317-111650402,chr10,111650317,111650402,H1|chr10:75633860-75633915,chr10,75633860,75633915,0,36016457
H1|chr10:111886189-111886268,chr10,111886189,111886268,H1|chr10:13384491-13384562,chr10,13384491,13384562,0,98501698
H1|chr10:111917006-111917028,chr10,111917006,111917028,H1|chr10:69649858-69649949,chr10,69649858,69649949,0,42267148
H1|chr10:112105388-112105444,chr10,112105388,112105444,H1|chr10:123354985-123355010,chr10,123354985,123355010,0,11249597
H1|chr10:113503488-113503524,chr10,113503488,113503524,H1|chr10:103893300-103893347,chr10,103893300,103893347,0,9610188
H1|chr10:114126107-114126185,chr10,114126107,114126185,H1|chr10:126846171-126846235,chr10,126846171,126846235,0,12720064
H1|chr10:114543792-114543834,chr10,114543792,114543834,H1|chr10:114644992-114645064,chr10,114644992,114645064,0,101200
H1|chr10:115098873-115098942,chr10,115098873,115098942,H1|chr10:126843870-126843912,chr10,126843870,126843912,0,11744997
H1|chr10:116216066-116216153,chr10,116216066,116216153,H1|chr10:126843105-126843141,chr10,126843105,126843141,0,10627039
H1|chr10:116615809-116615890,chr10,116615809,116615890,H1|chr10:89625074-89625096,chr10,89625074,89625096,0,26990735
H1|chr10:116752319-116752371,chr10,116752319,116752371,H1|chr10:111768562-111768625,chr10,111768562,111768625,0,4983757
H1|chr10:118891340-118891377,chr10,118891340,118891377,H1|chr10:88518244-88518275,chr10,88518244,88518275,0,30373096
H1|chr10:118960222-118960272,chr10,118960222,118960272,H1|chr10:65280014-65280045,chr10,65280014,65280045,0,53680208
H1|chr10:118998938-118999027,chr10,118998938,118999027,H1|chr10:32221499-32221560,chr10,32221499,32221560,0,86777439
H1|chr10:119064056-119064134,chr10,119064056,119064134,H1|chr10:126842753-126842821,chr10,126842753,126842821,0,7778697
H1|chr10:119493546-119493643,chr10,119493546,119493643,H1|chr10:75763559-75763597,chr10,75763559,75763597,0,43729987
H1|chr10:120307438-120307480,chr10,120307438,120307480,H1|chr10:13388774-13388794,chr10,13388774,13388794,0,106918664
H1|chr10:120363069-120363123,chr10,120363069,120363123,H1|chr10:65280372-65280469,chr10,65280372,65280469,0,55082697
H1|chr10:120848426-120848506,chr10,120848426,120848506,H1|chr10:89625074-89625096,chr10,89625074,89625096,0,31223352
H1|chr10:121111773-121111862,chr10,121111773,121111862,H1|chr10:33240091-33240117,chr10,33240091,33240117,0,87871682
H1|chr10:121784479-121784572,chr10,121784479,121784572,H1|chr10:69834506-69834537,chr10,69834506,69834537,0,51949973
H1|chr10:121799252-121799358,chr10,121799252,121799358,H1|chr10:79399951-79400101,chr10,79399951,79400101,0,42399301
H1|chr10:122144745-122144818,chr10,122144745,122144818,H1|chr10:69647516-69647606,chr10,69647516,69647606,0,52497229
H1|chr10:122258251-122258344,chr10,122258251,122258344,H1|chr10:128590319-128590341,chr10,128590319,128590341,0,6332068
H1|chr10:122807931-122808043,chr10,122807931,122808043,H1|chr10:126843958-126843990,chr10,126843958,126843990,0,4036027
H1|chr10:122848646-122848690,chr10,122848646,122848690,H1|chr10:123732855-123732942,chr10,123732855,123732942,0,884209
H1|chr10:123156048-123156156,chr10,123156048,123156156,H1|chr10:126842753-126842821,chr10,126842753,126842821,0,3686705
H1|chr10:123237660-123237715,chr10,123237660,123237715,H1|chr10:126843807-126843841,chr10,126843807,126843841,0,3606147
H1|chr10:123368153-123368222,chr10,123368153,123368222,H1|chr10:65026231-65026274,chr10,65026231,65026274,0,58341922
H1|chr10:123802086-123802139,chr10,123802086,123802139,H1|chr10:104158593-104158679,chr10,104158593,104158679,0,19643493
H1|chr10:123977765-123977862,chr10,123977765,123977862,H1|chr10:75763559-75763597,chr10,75763559,75763597,0,48214206
H1|chr10:124332963-124333071,chr10,124332963,124333071,H1|chr10:83636057-83636104,chr10,83636057,83636104,0,40696906
H1|chr10:124407088-124407149,chr10,124407088,124407149,H1|chr10:82212257-82212312,chr10,82212257,82212312,0,42194831
H1|chr10:124421849-124421955,chr10,124421849,124421955,H1|chr10:79399951-79400101,chr10,79399951,79400101,0,45021898
H1|chr10:125827109-125827151,chr10,125827109,125827151,H1|chr10:114709033-114709104,chr10,114709033,114709104,0,11118076
H1|chr10:126229276-126229329,chr10,126229276,126229329,H1|chr10:116526123-116526197,chr10,116526123,116526197,0,9703153
H1|chr10:126692144-126692174,chr10,126692144,126692174,H1|chr10:23384884-23384986,chr10,23384884,23384986,0,103307260
H1|chr10:128011354-128011410,chr10,128011354,128011410,H1|chr10:123354985-123355010,chr10,123354985,123355010,0,4656369
H1|chr10:128224842-128224891,chr10,128224842,128224891,H1|chr10:69647516-69647606,chr10,69647516,69647606,0,58577326
H1|chr10:128436535-128436585,chr10,128436535,128436585,H1|chr10:65280014-65280045,chr10,65280014,65280045,0,63156521
H1|chr10:129128736-129128789,chr10,129128736,129128789,H1|chr10:116526123-116526197,chr10,116526123,116526197,0,12602613
H1|chr10:129447440-129447476,chr10,129447440,129447476,H1|chr10:69647434-69647548,chr10,69647434,69647548,0,59800006
H1|chr10:129754136-129754220,chr10,129754136,129754220,H1|chr10:123355949-123356001,chr10,123355949,123356001,0,6398187
H1|chr10:131418612-131418665,chr10,131418612,131418665,H1|chr10:75760188-75760234,chr10,75760188,75760234,0,55658424
H1|chr10:131482943-131483010,chr10,131482943,131483010,H1|chr10:65278209-65278282,chr10,65278209,65278282,0,66204734
H1|chr10:132184099-132184188,chr10,132184099,132184188,H1|chr10:65278202-65278263,chr10,65278202,65278263,0,66905897
H1|chr10:132441086-132441112,chr10,132441086,132441112,H1|chr10:82217143-82217267,chr10,82217143,82217267,0,50223943
H1|chr10:133222809-133222878,chr10,133222809,133222878,H1|chr10:65026231-65026274,chr10,65026231,65026274,0,68196578
H1|chr10:133567962-133568070,chr10,133567962,133568070,H1|chr10:126842753-126842821,chr10,126842753,126842821,0,6725209
H1|chr10:134323648-134323702,chr10,134323648,134323702,H1|chr10:65279372-65279512,chr10,65279372,65279512,0,69044276
H1|chr10:134476039-134476109,chr10,134476039,134476109,H1|chr10:123355037-123355117,chr10,123355037,123355117,0,11121002
H1|chr10:134478927-134478949,chr10,134478927,134478949,H1|chr10:99472996-99473050,chr10,99472996,99473050,0,35005931
H1|chr10:134783579-134783663,chr10,134783579,134783663,H1|chr10:123355949-123356001,chr10,123355949,123356001,0,11427630
H1|chr10:134789443-134789513,chr10,134789443,134789513,H1|chr10:114709370-114709394,chr10,114709370,114709394,0,20080073
H1|chr11:272296-272415,chr11,272296,272415,H1|chr11:126225336-126225367,chr11,126225336,126225367,0,125953040
H1|chr11:711931-712024,chr11,711931,712024,H1|chr11:63449764-63449793,chr11,63449764,63449793,0,62737833
H1|chr11:1044389-1044436,chr11,1044389,1044436,H1|chr11:205779-205826,chr11,205779,205826,0,838610
H1|chr11:1094776-1094883,chr11,1094776,1094883,H1|chr11:57298952-57298993,chr11,57298952,57298993,0,56204176
H1|chr11:1317633-1317661,chr11,1317633,1317661,H1|chr11:57529709-57529806,chr11,57529709,57529806,0,56212076
H1|chr11:1511360-1511476,chr11,1511360,1511476,H1|chr11:93478175-93478208,chr11,93478175,93478208,0,91966815
H1|chr11:1904788-1904859,chr11,1904788,1904859,H1|chr11:117103773-117103852,chr11,117103773,117103852,0,115198985
H1|chr11:1970772-1970804,chr11,1970772,1970804,H1|chr11:2399972-2400089,chr11,2399972,2400089,0,429200
H1|chr11:2557848-2557898,chr11,2557848,2557898,H1|chr11:67887458-67887507,chr11,67887458,67887507,0,65329610
H1|chr11:3262520-3262570,chr11,3262520,3262570,H1|chr11:67887458-67887507,chr11,67887458,67887507,0,64624938
H1|chr11:3356586-3356667,chr11,3356586,3356667,H1|chr11:67235764-67235809,chr11,67235764,67235809,0,63879178
H1|chr11:3515895-3515995,chr11,3515895,3515995,H1|chr11:18611470-18611520,chr11,18611470,18611520,0,15095575
H1|chr11:3733145-3733295,chr11,3733145,3733295,H1|chr11:134142414-134142448,chr11,134142414,134142448,0,130409269
H1|chr11:3861012-3861081,chr11,3861012,3861081,H1|chr11:57530738-57530808,chr11,57530738,57530808,0,53669726
H1|chr11:4029317-4029388,chr11,4029317,4029388,H1|chr11:61722118-61722196,chr11,61722118,61722196,0,57692801
H1|chr11:4065994-4066022,chr11,4065994,4066022,H1|chr11:57529709-57529806,chr11,57529709,57529806,0,53463715
H1|chr11:5013648-5013699,chr11,5013648,5013699,H1|chr11:63377743-63377806,chr11,63377743,63377806,0,58364095
H1|chr11:5509002-5509081,chr11,5509002,5509081,H1|chr11:134140689-134140754,chr11,134140689,134140754,0,128631687
H1|chr11:5525058-5525134,chr11,5525058,5525134,H1|chr11:67184462-67184536,chr11,67184462,67184536,0,61659404
H1|chr11:5743161-5743217,chr11,5743161,5743217,H1|chr11:841448-841542,chr11,841448,841542,0,4901713
H1|chr11:5766718-5766813,chr11,5766718,5766813,H1|chr11:27655301-27655355,chr11,27655301,27655355,0,21888583
H1|chr11:5914435-5914526,chr11,5914435,5914526,H1|chr11:57298952-57298993,chr11,57298952,57298993,0,51384517
H1|chr11:5979851-5979882,chr11,5979851,5979882,H1|chr11:62436359-62436392,chr11,62436359,62436392,0,56456508
H1|chr11:6251054-6251136,chr11,6251054,6251136,H1|chr11:17034150-17034216,chr11,17034150,17034216,0,10783096
H1|chr11:6564444-6564525,chr11,6564444,6564525,H1|chr11:205779-205826,chr11,205779,205826,0,6358665
H1|chr11:6780611-6780631,chr11,6780611,6780631,H1|chr11:63379327-63379476,chr11,63379327,63379476,0,56598716
H1|chr11:7168166-7168252,chr11,7168166,7168252,H1|chr11:63579109-63579172,chr11,63579109,63579172,0,56410943
H1|chr11:7277245-7277277,chr11,7277245,7277277,H1|chr11:27655390-27655498,chr11,27655390,27655498,0,20378145
H1|chr11:7683975-7683995,chr11,7683975,7683995,H1|chr11:63379327-63379476,chr11,63379327,63379476,0,55695352
H1|chr11:7729134-7729250,chr11,7729134,7729250,H1|chr11:134142414-134142448,chr11,134142414,134142448,0,126413280
H1|chr11:7946464-7946509,chr11,7946464,7946509,H1|chr11:73308092-73308150,chr11,73308092,73308150,0,65361628
H1|chr11:7965218-7965290,chr11,7965218,7965290,H1|chr11:61722118-61722196,chr11,61722118,61722196,0,53756900
H1|chr11:8277948-8277988,chr11,8277948,8277988,H1|chr11:14362801-14362868,chr11,14362801,14362868,0,6084853
H1|chr11:8290615-8290730,chr11,8290615,8290730,H1|chr11:748702-748823,chr11,748702,748823,0,7541913
H1|chr11:8465908-8466024,chr11,8465908,8466024,H1|chr11:134142414-134142448,chr11,134142414,134142448,0,125676506
H1|chr11:8498190-8498237,chr11,8498190,8498237,H1|chr11:748042-748144,chr11,748042,748144,0,7750148
H1|chr11:8672279-8672366,chr11,8672279,8672366,H1|chr11:67184462-67184536,chr11,67184462,67184536,0,58512183
H1|chr11:8851801-8851908,chr11,8851801,8851908,H1|chr11:63607319-63607362,chr11,63607319,63607362,0,54755518
H1|chr11:9896190-9896241,chr11,9896190,9896241,H1|chr11:63377743-63377806,chr11,63377743,63377806,0,53481553
H1|chr11:9933217-9933341,chr11,9933217,9933341,H1|chr11:67196237-67196331,chr11,67196237,67196331,0,57263020
H1|chr11:10072270-10072388,chr11,10072270,10072388,H1|chr11:65630249-65630308,chr11,65630249,65630308,0,55557979
H1|chr11:10092536-10092576,chr11,10092536,10092576,H1|chr11:34123187-34123218,chr11,34123187,34123218,0,24030651
H1|chr11:10265502-10265619,chr11,10265502,10265619,H1|chr11:47292776-47292798,chr11,47292776,47292798,0,37027274
H1|chr11:11477071-11477165,chr11,11477071,11477165,H1|chr11:314629-314647,chr11,314629,314647,0,11162442
H1|chr11:11749137-11749192,chr11,11749137,11749192,H1|chr11:11641714-11641809,chr11,11641714,11641809,0,107423
H1|chr11:11850984-11851091,chr11,11850984,11851091,H1|chr11:57298952-57298993,chr11,57298952,57298993,0,45447968
H1|chr11:12111362-12111384,chr11,12111362,12111384,H1|chr11:126221924-126222052,chr11,126221924,126222052,0,114110562
H1|chr11:12424420-12424496,chr11,12424420,12424496,H1|chr11:11641721-11641809,chr11,11641721,11641809,0,782699
H1|chr11:12433506-12433553,chr11,12433506,12433553,H1|chr11:18611470-18611520,chr11,18611470,18611520,0,6177964
H1|chr11:12700125-12700206,chr11,12700125,12700206,H1|chr11:67235764-67235809,chr11,67235764,67235809,0,54535639
H1|chr11:12779839-12779869,chr11,12779839,12779869,H1|chr11:67799922-67800040,chr11,67799922,67800040,0,55020083
H1|chr11:13209033-13209061,chr11,13209033,13209061,H1|chr11:65317814-65317887,chr11,65317814,65317887,0,52108781
H1|chr11:13592557-13592614,chr11,13592557,13592614,H1|chr11:67482324-67482416,chr11,67482324,67482416,0,53889767
H1|chr11:13622722-13622775,chr11,13622722,13622775,H1|chr11:30347958-30348011,chr11,30347958,30348011,0,16725236
H1|chr11:13704900-13705009,chr11,13704900,13705009,H1|chr11:47236852-47236893,chr11,47236852,47236893,0,33531952
H1|chr11:13856273-13856313,chr11,13856273,13856313,H1|chr11:34123187-34123218,chr11,34123187,34123218,0,20266914
H1|chr11:14003605-14003675,chr11,14003605,14003675,H1|chr11:57530738-57530808,chr11,57530738,57530808,0,43527133
H1|chr11:14395442-14395504,chr11,14395442,14395504,H1|chr11:63615129-63615169,chr11,63615129,63615169,0,49219687
H1|chr11:14622608-14622664,chr11,14622608,14622664,H1|chr11:841448-841542,chr11,841448,841542,0,13781160
H1|chr11:15527442-15527520,chr11,15527442,15527520,H1|chr11:805814-805855,chr11,805814,805855,0,14721628
H1|chr11:15614582-15614629,chr11,15614582,15614629,H1|chr11:18611470-18611520,chr11,18611470,18611520,0,2996888
H1|chr11:15938147-15938233,chr11,15938147,15938233,H1|chr11:16761854-16761918,chr11,16761854,16761918,0,823707
H1|chr11:15976061-15976156,chr11,15976061,15976156,H1|chr11:314629-314647,chr11,314629,314647,0,15661432
H1|chr11:16130951-16131081,chr11,16130951,16131081,H1|chr11:126225336-126225367,chr11,126225336,126225367,0,110094385
H1|chr11:16217225-16217301,chr11,16217225,16217301,H1|chr11:11641721-11641809,chr11,11641721,11641809,0,4575504
H1|chr11:16231388-16231432,chr11,16231388,16231432,H1|chr11:95657564-95657637,chr11,95657564,95657637,0,79426176
H1|chr11:16384755-16384813,chr11,16384755,16384813,H1|chr11:129871391-129871481,chr11,129871391,129871481,0,113486636
H1|chr11:16470619-16470661,chr11,16470619,16470661,H1|chr11:14362801-14362868,chr11,14362801,14362868,0,2107818
H1|chr11:17322479-17322609,chr11,17322479,17322609,H1|chr11:126225336-126225367,chr11,126225336,126225367,0,108902857
H1|chr11:17327792-17327813,chr11,17327792,17327813,H1|chr11:57529709-57529806,chr11,57529709,57529806,0,40201917
H1|chr11:17524080-17524158,chr11,17524080,17524158,H1|chr11:291259-291293,chr11,291259,291293,0,17232821
H1|chr11:18116887-18116925,chr11,18116887,18116925,H1|chr11:66188266-66188416,chr11,66188266,66188416,0,48071379
H1|chr11:18213625-18213668,chr11,18213625,18213668,H1|chr11:27655240-27655310,chr11,27655240,27655310,0,9441615
H1|chr11:19423535-19423571,chr11,19423535,19423571,H1|chr11:73586672-73586736,chr11,73586672,73586736,0,54163137
H1|chr11:19575835-19575860,chr11,19575835,19575860,H1|chr11:64887542-64887689,chr11,64887542,64887689,0,45311707
H1|chr11:20193304-20193372,chr11,20193304,20193372,H1|chr11:66188262-66188316,chr11,66188262,66188316,0,45994958
H1|chr11:20348290-20348408,chr11,20348290,20348408,H1|chr11:65630249-65630308,chr11,65630249,65630308,0,45281959
H1|chr11:20576102-20576154,chr11,20576102,20576154,H1|chr11:291414-291511,chr11,291414,291511,0,20284688
H1|chr11:20726909-20726928,chr11,20726909,20726928,H1|chr11:66187595-66187726,chr11,66187595,66187726,0,45460686
H1|chr11:20829907-20829950,chr11,20829907,20829950,H1|chr11:47238946-47238972,chr11,47238946,47238972,0,26409039
H1|chr11:21186371-21186403,chr11,21186371,21186403,H1|chr11:27655201-27655268,chr11,27655201,27655268,0,6468830
H1|chr11:21288033-21288054,chr11,21288033,21288054,H1|chr11:57529709-57529806,chr11,57529709,57529806,0,36241676
H1|chr11:21626831-21626936,chr11,21626831,21626936,H1|chr11:22647577-22647622,chr11,22647577,22647622,0,1020746
H1|chr11:22055959-22056007,chr11,22055959,22056007,H1|chr11:748042-748144,chr11,748042,748144,0,21307917
H1|chr11:22109580-22109642,chr11,22109580,22109642,H1|chr11:17032775-17032824,chr11,17032775,17032824,0,5076805
H1|chr11:22180874-22180971,chr11,22180874,22180971,H1|chr11:43703297-43703339,chr11,43703297,43703339,0,21522423
H1|chr11:23142250-23142350,chr11,23142250,23142350,H1|chr11:67210361-67210497,chr11,67210361,67210497,0,44068111
H1|chr11:23148395-23148441,chr11,23148395,23148441,H1|chr11:27654750-27654830,chr11,27654750,27654830,0,4506355
H1|chr11:23634064-23634104,chr11,23634064,23634104,H1|chr11:27654776-27654830,chr11,27654776,27654830,0,4020712
H1|chr11:24151586-24151614,chr11,24151586,24151614,H1|chr11:67799921-67800040,chr11,67799921,67800040,0,43648335
H1|chr11:24183175-24183216,chr11,24183175,24183216,H1|chr11:27653944-27654035,chr11,27653944,27654035,0,3470769
H1|chr11:24228431-24228468,chr11,24228431,24228468,H1|chr11:47293654-47293748,chr11,47293654,47293748,0,23065223
H1|chr11:24470263-24470351,chr11,24470263,24470351,H1|chr11:129874921-129874982,chr11,129874921,129874982,0,105404658
H1|chr11:25190287-25190412,chr11,25190287,25190412,H1|chr11:46369463-46369485,chr11,46369463,46369485,0,21179176
H1|chr11:25922432-25922550,chr11,25922432,25922550,H1|chr11:74205380-74205401,chr11,74205380,74205401,0,48282948
H1|chr11:26430534-26430552,chr11,26430534,26430552,H1|chr11:77182686-77182816,chr11,77182686,77182816,0,50752152
H1|chr11:26449151-26449198,chr11,26449151,26449198,H1|chr11:291414-291511,chr11,291414,291511,0,26157737
H1|chr11:26473841-26473910,chr11,26473841,26473910,H1|chr11:120208117-120208172,chr11,120208117,120208172,0,93734276
H1|chr11:26736271-26736365,chr11,26736271,26736365,H1|chr11:63744528-63744618,chr11,63744528,63744618,0,37008257
H1|chr11:27240065-27240090,chr11,27240065,27240090,H1|chr11:62431973-62432117,chr11,62431973,62432117,0,35191908
H1|chr11:28425154-28425242,chr11,28425154,28425242,H1|chr11:63579109-63579172,chr11,63579109,63579172,0,35153955
H1|chr11:28543241-28543314,chr11,28543241,28543314,H1|chr11:2399972-2400089,chr11,2399972,2400089,0,26143269
H1|chr11:28583254-28583345,chr11,28583254,28583345,H1|chr11:57298952-57298993,chr11,57298952,57298993,0,28715698
H1|chr11:28821395-28821470,chr11,28821395,28821470,H1|chr11:129874921-129874996,chr11,129874921,129874996,0,101053526
H1|chr11:29032864-29033000,chr11,29032864,29033000,H1|chr11:67482539-67482641,chr11,67482539,67482641,0,38449675
H1|chr11:29499254-29499401,chr11,29499254,29499401,H1|chr11:47236852-47236893,chr11,47236852,47236893,0,17737598
H1|chr11:30126451-30126529,chr11,30126451,30126529,H1|chr11:58825336-58825409,chr11,58825336,58825409,0,28698885
H1|chr11:30523698-30523720,chr11,30523698,30523720,H1|chr11:126221924-126222052,chr11,126221924,126222052,0,95698226
H1|chr11:30767578-30767678,chr11,30767578,30767678,H1|chr11:65430270-65430289,chr11,65430270,65430289,0,34662692
H1|chr11:31361574-31361671,chr11,31361574,31361671,H1|chr11:43703297-43703339,chr11,43703297,43703339,0,12341723
H1|chr11:31676734-31676806,chr11,31676734,31676806,H1|chr11:14362892-14362969,chr11,14362892,14362969,0,17313842
H1|chr11:32427211-32427262,chr11,32427211,32427262,H1|chr11:33181296-33181385,chr11,33181296,33181385,0,754085
H1|chr11:32701148-32701186,chr11,32701148,32701186,H1|chr11:66188266-66188416,chr11,66188266,66188416,0,33487118
H1|chr11:32780876-32780938,chr11,32780876,32780938,H1|chr11:126225387-126225442,chr11,126225387,126225442,0,93444511
H1|chr11:33224152-33224220,chr11,33224152,33224220,H1|chr11:17031896-17031972,chr11,17031896,17031972,0,16192256
H1|chr11:33535035-33535095,chr11,33535035,33535095,H1|chr11:16760626-16760661,chr11,16760626,16760661,0,16774409
H1|chr11:33582698-33582804,chr11,33582698,33582804,H1|chr11:46369463-46369485,chr11,46369463,46369485,0,12786765
H1|chr11:33633130-33633228,chr11,33633130,33633228,H1|chr11:117103774-117103853,chr11,117103774,117103853,0,83470644
H1|chr11:34398947-34399040,chr11,34398947,34399040,H1|chr11:63449764-63449793,chr11,63449764,63449793,0,29050817
H1|chr11:34553202-34553321,chr11,34553202,34553321,H1|chr11:102962074-102962094,chr11,102962074,102962094,0,68408872
H1|chr11:34583334-34583373,chr11,34583334,34583373,H1|chr11:47195858-47195934,chr11,47195858,47195934,0,12612524
H1|chr11:34634168-34634234,chr11,34634168,34634234,H1|chr11:12699443-12699527,chr11,12699443,12699527,0,21934725
H1|chr11:34746761-34746817,chr11,34746761,34746817,H1|chr11:64951815-64951901,chr11,64951815,64951901,0,30205054
H1|chr11:34890167-34890287,chr11,34890167,34890287,H1|chr11:93478175-93478208,chr11,93478175,93478208,0,58588008
H1|chr11:35927620-35927698,chr11,35927620,35927698,H1|chr11:58825336-58825409,chr11,58825336,58825409,0,22897716
H1|chr11:36296072-36296135,chr11,36296072,36296135,H1|chr11:3012971-3013031,chr11,3012971,3013031,0,33283101
H1|chr11:36567477-36567552,chr11,36567477,36567552,H1|chr11:73308092-73308150,chr11,73308092,73308150,0,36740615
H1|chr11:37411435-37411479,chr11,37411435,37411479,H1|chr11:67799921-67800040,chr11,67799921,67800040,0,30388486
H1|chr11:37454161-37454311,chr11,37454161,37454311,H1|chr11:7698010-7698066,chr11,7698010,7698066,0,29756151
H1|chr11:38023994-38024055,chr11,38023994,38024055,H1|chr11:77529980-77530035,chr11,77529980,77530035,0,39505986
H1|chr11:38097450-38097524,chr11,38097450,38097524,H1|chr11:10744150-10744216,chr11,10744150,10744216,0,27353300
H1|chr11:38166092-38166151,chr11,38166092,38166151,H1|chr11:64881837-64881896,chr11,64881837,64881896,0,26715745
H1|chr11:38183679-38183755,chr11,38183679,38183755,H1|chr11:33181214-33181315,chr11,33181214,33181315,0,5002465
H1|chr11:38216607-38216637,chr11,38216607,38216637,H1|chr11:33280248-33280367,chr11,33280248,33280367,0,4936359
H1|chr11:38295711-38295758,chr11,38295711,38295758,H1|chr11:291414-291511,chr11,291414,291511,0,38004297
H1|chr11:38350354-38350400,chr11,38350354,38350400,H1|chr11:27654750-27654830,chr11,27654750,27654830,0,10695604
H1|chr11:38971498-38971568,chr11,38971498,38971568,H1|chr11:12699443-12699527,chr11,12699443,12699527,0,26272055
H1|chr11:39237156-39237188,chr11,39237156,39237188,H1|chr11:2399972-2400089,chr11,2399972,2400089,0,36837184
H1|chr11:39754892-39755018,chr11,39754892,39755018,H1|chr11:14362892-14362969,chr11,14362892,14362969,0,25392000
H1|chr11:39986007-39986065,chr11,39986007,39986065,H1|chr11:129871391-129871481,chr11,129871391,129871481,0,89885384
H1|chr11:40040879-40040971,chr11,40040879,40040971,H1|chr11:65430270-65430289,chr11,65430270,65430289,0,25389391
H1|chr11:40750864-40750908,chr11,40750864,40750908,H1|chr11:67799921-67800040,chr11,67799921,67800040,0,27049057
H1|chr11:41095244-41095299,chr11,41095244,41095299,H1|chr11:11641714-11641809,chr11,11641714,11641809,0,29453530
H1|chr11:41104527-41104674,chr11,41104527,41104674,H1|chr11:66187337-66187361,chr11,66187337,66187361,0,25082810
H1|chr11:41145956-41145983,chr11,41145956,41145983,H1|chr11:64011345-64011495,chr11,64011345,64011495,0,22865389
H1|chr11:41978362-41978441,chr11,41978362,41978441,H1|chr11:14360298-14360366,chr11,14360298,14360366,0,27618064
H1|chr11:42489361-42489461,chr11,42489361,42489461,H1|chr11:43703297-43703339,chr11,43703297,43703339,0,1213936
H1|chr11:43503991-43504095,chr11,43503991,43504095,H1|chr11:22647577-22647622,chr11,22647577,22647622,0,20856414
H1|chr11:44343911-44344056,chr11,44343911,44344056,H1|chr11:46369463-46369485,chr11,46369463,46369485,0,2025552
H1|chr11:44734970-44735041,chr11,44734970,44735041,H1|chr11:17032647-17032726,chr11,17032647,17032726,0,27702323
H1|chr11:46431572-46431626,chr11,46431572,46431626,H1|chr11:94275700-94275807,chr11,94275700,94275807,0,47844128
H1|chr11:46527259-46527289,chr11,46527259,46527289,H1|chr11:67799922-67800040,chr11,67799922,67800040,0,21272663
H1|chr11:46771418-46771474,chr11,46771418,46771474,H1|chr11:63380691-63380841,chr11,63380691,63380841,0,16609273
H1|chr11:46879705-46879783,chr11,46879705,46879783,H1|chr11:61733600-61733744,chr11,61733600,61733744,0,14853895
H1|chr11:47209045-47209074,chr11,47209045,47209074,H1|chr11:748702-748823,chr11,748702,748823,0,46460343
H1|chr11:47239223-47239331,chr11,47239223,47239331,H1|chr11:841448-841542,chr11,841448,841542,0,46397775
H1|chr11:47291316-47291358,chr11,47291316,47291358,H1|chr11:27654776-27654830,chr11,27654776,27654830,0,19636540
H1|chr11:48507364-48507433,chr11,48507364,48507433,H1|chr11:120208117-120208172,chr11,120208117,120208172,0,71700753
H1|chr11:48754538-48754650,chr11,48754538,48754650,H1|chr11:14362681-14362702,chr11,14362681,14362702,0,34391857
H1|chr11:48792230-48792297,chr11,48792230,48792297,H1|chr11:117103773-117103852,chr11,117103773,117103852,0,68311543
H1|chr11:48828179-48828231,chr11,48828179,48828231,H1|chr11:57090670-57090725,chr11,57090670,57090725,0,8262491
H1|chr11:48862039-48862129,chr11,48862039,48862129,H1|chr11:61132214-61132285,chr11,61132214,61132285,0,12270175
H1|chr11:48931330-48931426,chr11,48931330,48931426,H1|chr11:27655301-27655355,chr11,27655301,27655355,0,21276029
H1|chr11:49009013-49009052,chr11,49009013,49009052,H1|chr11:58827162-58827219,chr11,58827162,58827219,0,9818149
H1|chr11:49103977-49104012,chr11,49103977,49104012,H1|chr11:27655390-27655498,chr11,27655390,27655498,0,21448587
H1|chr11:49275868-49275936,chr11,49275868,49275936,H1|chr11:66188262-66188316,chr11,66188262,66188316,0,16912394
H1|chr11:49602718-49602769,chr11,49602718,49602769,H1|chr11:67481867-67481979,chr11,67481867,67481979,0,17879149
H1|chr11:49608966-49609009,chr11,49608966,49609009,H1|chr11:67887060-67887210,chr11,67887060,67887210,0,18278094
H1|chr11:50231841-50231939,chr11,50231841,50231939,H1|chr11:12697823-12697869,chr11,12697823,12697869,0,37534018
H1|chr11:50260216-50260290,chr11,50260216,50260290,H1|chr11:33181241-33181317,chr11,33181241,33181317,0,17078975
H1|chr11:50348631-50348723,chr11,50348631,50348723,H1|chr11:118888282-118888340,chr11,118888282,118888340,0,68539651
H1|chr11:50663456-50663561,chr11,50663456,50663561,H1|chr11:57298952-57298993,chr11,57298952,57298993,0,6635496
H1|chr11:50715786-50715847,chr11,50715786,50715847,H1|chr11:16760626-16760661,chr11,16760626,16760661,0,33955160
H1|chr11:51371729-51371866,chr11,51371729,51371866,H1|chr11:119078325-119078418,chr11,119078325,119078418,0,67706596
H1|chr11:51570214-51570292,chr11,51570214,51570292,H1|chr11:805814-805855,chr11,805814,805855,0,50764400
H1|chr11:51781939-51782039,chr11,51781939,51782039,H1|chr11:18611470-18611520,chr11,18611470,18611520,0,33170469
H1|chr11:51817211-51817268,chr11,51817211,51817268,H1|chr11:64951815-64951901,chr11,64951815,64951901,0,13134604
H1|chr11:51967559-51967595,chr11,51967559,51967595,H1|chr11:77182686-77182816,chr11,77182686,77182816,0,25215127
H1|chr11:51976570-51976657,chr11,51976570,51976657,H1|chr11:27654623-27654676,chr11,27654623,27654676,0,24321947
H1|chr11:52479746-52479805,chr11,52479746,52479805,H1|chr11:119077886-119077967,chr11,119077886,119077967,0,66598140
H1|chr11:52754553-52754615,chr11,52754553,52754615,H1|chr11:77529980-77530035,chr11,77529980,77530035,0,24775427
H1|chr11:52829713-52829767,chr11,52829713,52829767,H1|chr11:67887186-67887281,chr11,67887186,67887281,0,15057473
H1|chr11:52948452-52948484,chr11,52948452,52948484,H1|chr11:62436359-62436500,chr11,62436359,62436500,0,9487907
H1|chr11:53136769-53136819,chr11,53136769,53136819,H1|chr11:33181296-33181385,chr11,33181296,33181385,0,19955473
H1|chr11:53453185-53453261,chr11,53453185,53453261,H1|chr11:120204553-120204615,chr11,120204553,120204615,0,66751368
H1|chr11:53530511-53530585,chr11,53530511,53530585,H1|chr11:33181241-33181317,chr11,33181241,33181317,0,20349270
H1|chr11:53536331-53536456,chr11,53536331,53536456,H1|chr11:47292776-47292798,chr11,47292776,47292798,0,6243555
H1|chr11:53855241-53855302,chr11,53855241,53855302,H1|chr11:16761854-16761918,chr11,16761854,16761918,0,37093387
H1|chr11:53951061-53951120,chr11,53951061,53951120,H1|chr11:119077886-119077967,chr11,119077886,119077967,0,65126825
H1|chr11:54147347-54147402,chr11,54147347,54147402,H1|chr11:68042717-68042771,chr11,68042717,68042771,0,13895370
H1|chr11:54408749-54408828,chr11,54408749,54408828,H1|chr11:134140689-134140754,chr11,134140689,134140754,0,79731940
H1|chr11:54459812-54459874,chr11,54459812,54459874,H1|chr11:77529980-77530035,chr11,77529980,77530035,0,23070168
H1|chr11:55345680-55345750,chr11,55345680,55345750,H1|chr11:12699443-12699527,chr11,12699443,12699527,0,42646237
H1|chr11:55595062-55595138,chr11,55595062,55595138,H1|chr11:120204553-120204615,chr11,120204553,120204615,0,64609491
H1|chr11:55607931-55608002,chr11,55607931,55608002,H1|chr11:67351729-67351753,chr11,67351729,67351753,0,11743798
H1|chr11:55998559-55998621,chr11,55998559,55998621,H1|chr11:17032775-17032824,chr11,17032775,17032824,0,38965784
H1|chr11:56140881-56140968,chr11,56140881,56140968,H1|chr11:17031896-17031971,chr11,17031896,17031971,0,39108985
H1|chr11:56878650-56878765,chr11,56878650,56878765,H1|chr11:748702-748823,chr11,748702,748823,0,56129948
H1|chr11:57001954-57002005,chr11,57001954,57002005,H1|chr11:33181296-33181385,chr11,33181296,33181385,0,23820658
H1|chr11:58153326-58153397,chr11,58153326,58153397,H1|chr11:17032647-17032726,chr11,17032647,17032726,0,41120679
H1|chr11:59283822-59283858,chr11,59283822,59283858,H1|chr11:77182686-77182816,chr11,77182686,77182816,0,17898864
H1|chr11:59454126-59454196,chr11,59454126,59454196,H1|chr11:57530738-57530808,chr11,57530738,57530808,0,1923388
H1|chr11:59767855-59767922,chr11,59767855,59767922,H1|chr11:117103773-117103852,chr11,117103773,117103852,0,57335918
H1|chr11:59933736-59933773,chr11,59933736,59933773,H1|chr11:65317810-65317882,chr11,65317810,65317882,0,5384074
H1|chr11:61237768-61237844,chr11,61237768,61237844,H1|chr11:67184462-67184536,chr11,67184462,67184536,0,5946694
H1|chr11:61512322-61512362,chr11,61512322,61512362,H1|chr11:14362801-14362868,chr11,14362801,14362868,0,47149521
H1|chr11:61736408-61736495,chr11,61736408,61736495,H1|chr11:27654623-27654676,chr11,27654623,27654676,0,34081785
H1|chr11:61768561-61768633,chr11,61768561,61768633,H1|chr11:14362892-14362969,chr11,14362892,14362969,0,47405669
H1|chr11:61980208-61980308,chr11,61980208,61980308,H1|chr11:67210361-67210497,chr11,67210361,67210497,0,5230153
H1|chr11:62387059-62387127,chr11,62387059,62387127,H1|chr11:14362567-14362620,chr11,14362567,14362620,0,48024492
H1|chr11:62747418-62747478,chr11,62747418,62747478,H1|chr11:46140783-46140826,chr11,46140783,46140826,0,16606635
H1|chr11:63121835-63121874,chr11,63121835,63121874,H1|chr11:47195858-47195934,chr11,47195858,47195934,0,15925977
H1|chr11:63175257-63175352,chr11,63175257,63175352,H1|chr11:27655301-27655355,chr11,27655301,27655355,0,35519956
H1|chr11:63608601-63608696,chr11,63608601,63608696,H1|chr11:314629-314647,chr11,314629,314647,0,63293972
H1|chr11:63841955-63842049,chr11,63841955,63842049,H1|chr11:7698010-7698066,chr11,7698010,7698066,0,56143945
H1|chr11:64389481-64389585,chr11,64389481,64389585,H1|chr11:22647577-22647622,chr11,22647577,22647622,0,41741904
H1|chr11:64400990-64401067,chr11,64400990,64401067,H1|chr11:44971962-44972033,chr11,44971962,44972033,0,19429028
H1|chr11:64401065-64401130,chr11,64401065,64401130,H1|chr11:36310553-36310656,chr11,36310553,36310656,0,28090512
H1|chr11:66072303-66072412,chr11,66072303,66072412,H1|chr11:47236852-47236893,chr11,47236852,47236893,0,18835451
H1|chr11:66150305-66150365,chr11,66150305,66150365,H1|chr11:16760626-16760661,chr11,16760626,16760661,0,49389679
H1|chr11:67929052-67929168,chr11,67929052,67929168,H1|chr11:93478175-93478208,chr11,93478175,93478208,0,25549123
H1|chr11:68082534-68082609,chr11,68082534,68082609,H1|chr11:129874921-129874996,chr11,129874921,129874996,0,61792387
H1|chr11:68387770-68387818,chr11,68387770,68387818,H1|chr11:748042-748144,chr11,748042,748144,0,67639728
H1|chr11:69124450-69124530,chr11,69124450,69124530,H1|chr11:73308092-73308150,chr11,73308092,73308150,0,4183642
H1|chr11:69382292-69382332,chr11,69382292,69382332,H1|chr11:27654776-27654830,chr11,27654776,27654830,0,41727516
H1|chr11:69396746-69396795,chr11,69396746,69396795,H1|chr11:126221336-126221401,chr11,126221336,126221401,0,56824590
H1|chr11:69728576-69728629,chr11,69728576,69728629,H1|chr11:44972753-44972810,chr11,44972753,44972810,0,24755823
H1|chr11:70214001-70214037,chr11,70214001,70214037,H1|chr11:57093018-57093099,chr11,57093018,57093099,0,13120983
H1|chr11:70674382-70674499,chr11,70674382,70674499,H1|chr11:47292776-47292798,chr11,47292776,47292798,0,23381606
H1|chr11:70725412-70725450,chr11,70725412,70725450,H1|chr11:67481867-67481979,chr11,67481867,67481979,0,3243545
H1|chr11:70897000-70897028,chr11,70897000,70897028,H1|chr11:68518246-68518293,chr11,68518246,68518293,0,2378754
H1|chr11:71483790-71483842,chr11,71483790,71483842,H1|chr11:63377743-63377806,chr11,63377743,63377806,0,8106047
H1|chr11:71681622-71681649,chr11,71681622,71681649,H1|chr11:64011345-64011495,chr11,64011345,64011495,0,7670277
H1|chr11:72084966-72085047,chr11,72084966,72085047,H1|chr11:63580426-63580470,chr11,63580426,63580470,0,8504540
H1|chr11:72434511-72434617,chr11,72434511,72434617,H1|chr11:46369463-46369485,chr11,46369463,46369485,0,26065048
H1|chr11:74202067-74202109,chr11,74202067,74202109,H1|chr11:27654776-27654830,chr11,27654776,27654830,0,46547291
H1|chr11:74217342-74217383,chr11,74217342,74217383,H1|chr11:27654680-27654789,chr11,27654680,27654789,0,46562662
H1|chr11:74360418-74360567,chr11,74360418,74360567,H1|chr11:7698010-7698066,chr11,7698010,7698066,0,66662408
H1|chr11:74567072-74567187,chr11,74567072,74567187,H1|chr11:18611470-18611520,chr11,18611470,18611520,0,55955602
H1|chr11:74653116-74653216,chr11,74653116,74653216,H1|chr11:93969066-93969113,chr11,93969066,93969113,0,19315950
H1|chr11:74988802-74988942,chr11,74988802,74988942,H1|chr11:118888282-118888340,chr11,118888282,118888340,0,43899480
H1|chr11:75057807-75057869,chr11,75057807,75057869,H1|chr11:63615129-63615169,chr11,63615129,63615169,0,11442678
H1|chr11:75306446-75306542,chr11,75306446,75306542,H1|chr11:12697823-12697869,chr11,12697823,12697869,0,62608623
H1|chr11:75564450-75564543,chr11,75564450,75564543,H1|chr11:118888291-118888340,chr11,118888291,118888340,0,43323841
H1|chr11:75849834-75849934,chr11,75849834,75849934,H1|chr11:65430270-65430289,chr11,65430270,65430289,0,10419564
H1|chr11:76210610-76210629,chr11,76210610,76210629,H1|chr11:66187595-66187726,chr11,66187595,66187726,0,10023015
H1|chr11:76226632-76226737,chr11,76226632,76226737,H1|chr11:57298952-57298993,chr11,57298952,57298993,0,18927680
H1|chr11:76337304-76337392,chr11,76337304,76337392,H1|chr11:27655210-27655272,chr11,27655210,27655272,0,48682094
H1|chr11:76574973-76575091,chr11,76574973,76575091,H1|chr11:74205380-74205401,chr11,74205380,74205401,0,2369593
H1|chr11:77070975-77071016,chr11,77070975,77071016,H1|chr11:286467-286552,chr11,286467,286552,0,76784508
H1|chr11:77419454-77419505,chr11,77419454,77419505,H1|chr11:67481867-67481979,chr11,67481867,67481979,0,9937587
H1|chr11:77599202-77599237,chr11,77599202,77599237,H1|chr11:27655390-27655498,chr11,27655390,27655498,0,49943812
H1|chr11:77888187-77888236,chr11,77888187,77888236,H1|chr11:33181214-33181315,chr11,33181214,33181315,0,44706973
H1|chr11:77944959-77945071,chr11,77944959,77945071,H1|chr11:14362681-14362702,chr11,14362681,14362702,0,63582278
H1|chr11:79505482-79505561,chr11,79505482,79505561,H1|chr11:61132214-61132285,chr11,61132214,61132285,0,18373268
H1|chr11:79743890-79744013,chr11,79743890,79744013,H1|chr11:126224620-126224691,chr11,126224620,126224691,0,46480730
H1|chr11:80221933-80221997,chr11,80221933,80221997,H1|chr11:63449824-63449937,chr11,63449824,63449937,0,16772109
H1|chr11:80638987-80639015,chr11,80638987,80639015,H1|chr11:65317814-65317887,chr11,65317814,65317887,0,15321173
H1|chr11:80640967-80640992,chr11,80640967,80640992,H1|chr11:62431973-62432117,chr11,62431973,62432117,0,18208994
H1|chr11:80862120-80862180,chr11,80862120,80862180,H1|chr11:17032775-17032824,chr11,17032775,17032824,0,63829345
H1|chr11:81030236-81030283,chr11,81030236,81030283,H1|chr11:748042-748144,chr11,748042,748144,0,80282194
H1|chr11:81205457-81205584,chr11,81205457,81205584,H1|chr11:47292776-47292798,chr11,47292776,47292798,0,33912681
H1|chr11:81230779-81230855,chr11,81230779,81230855,H1|chr11:33181214-33181315,chr11,33181214,33181315,0,48049565
H1|chr11:81320230-81320328,chr11,81320230,81320328,H1|chr11:12697823-12697869,chr11,12697823,12697869,0,68622407
H1|chr11:81387412-81387466,chr11,81387412,81387466,H1|chr11:94275700-94275807,chr11,94275700,94275807,0,12888288
H1|chr11:81512415-81512447,chr11,81512415,81512447,H1|chr11:27655201-27655268,chr11,27655201,27655268,0,53857214
H1|chr11:81547721-81547866,chr11,81547721,81547866,H1|chr11:46369463-46369485,chr11,46369463,46369485,0,35178258
H1|chr11:81619080-81619115,chr11,81619080,81619115,H1|chr11:57093018-57093099,chr11,57093018,57093099,0,24526062
H1|chr11:81789746-81789781,chr11,81789746,81789781,H1|chr11:57093018-57093099,chr11,57093018,57093099,0,24696728
H1|chr11:81951882-81951994,chr11,81951882,81951994,H1|chr11:47238946-47238972,chr11,47238946,47238972,0,34712936
H1|chr11:82139747-82139804,chr11,82139747,82139804,H1|chr11:67482324-67482416,chr11,67482324,67482416,0,14657423
H1|chr11:82177678-82177739,chr11,82177678,82177739,H1|chr11:16761854-16761918,chr11,16761854,16761918,0,65415824
H1|chr11:83187923-83187966,chr11,83187923,83187966,H1|chr11:47238946-47238972,chr11,47238946,47238972,0,35948977
H1|chr11:83859194-83859300,chr11,83859194,83859300,H1|chr11:14360298-14360339,chr11,14360298,14360339,0,69498896
H1|chr11:84466385-84466477,chr11,84466385,84466477,H1|chr11:63735178-63735222,chr11,63735178,63735222,0,20731207
H1|chr11:84627926-84628073,chr11,84627926,84628073,H1|chr11:47236852-47236893,chr11,47236852,47236893,0,37391074
H1|chr11:84662774-84662924,chr11,84662774,84662924,H1|chr11:7698010-7698066,chr11,7698010,7698066,0,76964764
H1|chr11:84812587-84812669,chr11,84812587,84812669,H1|chr11:17034150-17034216,chr11,17034150,17034216,0,67778437
H1|chr11:84901489-84901583,chr11,84901489,84901583,H1|chr11:314629-314647,chr11,314629,314647,0,84586860
H1|chr11:85103233-85103345,chr11,85103233,85103345,H1|chr11:47238946-47238972,chr11,47238946,47238972,0,37864287
H1|chr11:85780369-85780438,chr11,85780369,85780438,H1|chr11:27654551-27654615,chr11,27654551,27654615,0,58125818
H1|chr11:86989424-86989520,chr11,86989424,86989520,H1|chr11:12697823-12697869,chr11,12697823,12697869,0,74291601
H1|chr11:87100359-87100453,chr11,87100359,87100453,H1|chr11:7698010-7698066,chr11,7698010,7698066,0,79402349
H1|chr11:87362832-87362918,chr11,87362832,87362918,H1|chr11:63579109-63579172,chr11,63579109,63579172,0,23783723
H1|chr11:87519012-87519077,chr11,87519012,87519077,H1|chr11:36310553-36310656,chr11,36310553,36310656,0,51208459
H1|chr11:87908902-87908963,chr11,87908902,87908963,H1|chr11:77529980-77530035,chr11,77529980,77530035,0,10378922
H1|chr11:88060156-88060233,chr11,88060156,88060233,H1|chr11:58825336-58825409,chr11,58825336,58825409,0,29234820
H1|chr11:88410413-88410468,chr11,88410413,88410468,H1|chr11:77530350-77530414,chr11,77530350,77530414,0,10880063
H1|chr11:88423345-88423450,chr11,88423345,88423450,H1|chr11:36313467-36313498,chr11,36313467,36313498,0,52109878
H1|chr11:88637010-88637089,chr11,88637010,88637089,H1|chr11:126224620-126224691,chr11,126224620,126224691,0,37587610
H1|chr11:89632600-89632632,chr11,89632600,89632632,H1|chr11:27655390-27655498,chr11,27655390,27655498,0,61977210
H1|chr11:90142464-90142503,chr11,90142464,90142503,H1|chr11:63577908-63578044,chr11,63577908,63578044,0,26564556
H1|chr11:90574241-90574318,chr11,90574241,90574318,H1|chr11:44971962-44972033,chr11,44971962,44972033,0,45602279
H1|chr11:90754945-90755082,chr11,90754945,90755082,H1|chr11:119078325-119078418,chr11,119078325,119078418,0,28323380
H1|chr11:90832205-90832324,chr11,90832205,90832324,H1|chr11:102962074-102962094,chr11,102962074,102962094,0,12129869
H1|chr11:91382017-91382042,chr11,91382017,91382042,H1|chr11:64887542-64887689,chr11,64887542,64887689,0,26494475
H1|chr11:91947880-91947955,chr11,91947880,91947955,H1|chr11:44971962-44972033,chr11,44971962,44972033,0,46975918
H1|chr11:92530802-92530831,chr11,92530802,92530831,H1|chr11:66187595-66187726,chr11,66187595,66187726,0,26343207
H1|chr11:92841052-92841126,chr11,92841052,92841126,H1|chr11:10744150-10744216,chr11,10744150,10744216,0,82096902
H1|chr11:92940393-92940457,chr11,92940393,92940457,H1|chr11:63449824-63449937,chr11,63449824,63449937,0,29490569
H1|chr11:93317863-93318003,chr11,93317863,93318003,H1|chr11:118888282-118888340,chr11,118888282,118888340,0,25570419
H1|chr11:93735287-93735400,chr11,93735287,93735400,H1|chr11:14362681-14362702,chr11,14362681,14362702,0,79372606
H1|chr11:93813746-93813824,chr11,93813746,93813824,H1|chr11:61733600-61733744,chr11,61733600,61733744,0,32080146
H1|chr11:93981429-93981472,chr11,93981429,93981472,H1|chr11:67887060-67887210,chr11,67887060,67887210,0,26094369
H1|chr11:94200887-94200978,chr11,94200887,94200978,H1|chr11:65630249-65630308,chr11,65630249,65630308,0,28570638
H1|chr11:94407998-94408109,chr11,94407998,94408109,H1|chr11:27655210-27655272,chr11,27655210,27655272,0,66752788
H1|chr11:94695170-94695272,chr11,94695170,94695272,H1|chr11:17031283-17031328,chr11,17031283,17031328,0,77663887
H1|chr11:94708039-94708166,chr11,94708039,94708166,H1|chr11:47292776-47292798,chr11,47292776,47292798,0,47415263
H1|chr11:94955661-94955767,chr11,94955661,94955767,H1|chr11:27654623-27654676,chr11,27654623,27654676,0,67301038
H1|chr11:95248633-95248669,chr11,95248633,95248669,H1|chr11:73586672-73586736,chr11,73586672,73586736,0,21661961
H1|chr11:95368592-95368652,chr11,95368592,95368652,H1|chr11:126221166-126221217,chr11,126221166,126221217,0,30852574
H1|chr11:95725415-95725463,chr11,95725415,95725463,H1|chr11:47195858-47195934,chr11,47195858,47195934,0,48529557
H1|chr11:95734616-95734671,chr11,95734616,95734671,H1|chr11:126221924-126222052,chr11,126221924,126222052,0,30487308
H1|chr11:96731127-96731181,chr11,96731127,96731181,H1|chr11:67887186-67887281,chr11,67887186,67887281,0,28843941
H1|chr11:97026458-97026573,chr11,97026458,97026573,H1|chr11:18611470-18611520,chr11,18611470,18611520,0,78414988
H1|chr11:97687077-97687114,chr11,97687077,97687114,H1|chr11:65317810-65317882,chr11,65317810,65317882,0,32369267
H1|chr11:97914607-97914678,chr11,97914607,97914678,H1|chr11:67351729-67351753,chr11,67351729,67351753,0,30562878
H1|chr11:98419639-98419671,chr11,98419639,98419671,H1|chr11:17031896-17031971,chr11,17031896,17031971,0,81387743
H1|chr11:98655044-98655112,chr11,98655044,98655112,H1|chr11:17031896-17031972,chr11,17031896,17031972,0,81623148
H1|chr11:99019649-99019720,chr11,99019649,99019720,H1|chr11:61722118-61722196,chr11,61722118,61722196,0,37297531
H1|chr11:99199277-99199334,chr11,99199277,99199334,H1|chr11:67887060-67887210,chr11,67887060,67887210,0,31312217
H1|chr11:99268653-99268710,chr11,99268653,99268710,H1|chr11:67887060-67887210,chr11,67887060,67887210,0,31381593
H1|chr11:99329429-99329490,chr11,99329429,99329490,H1|chr11:16760626-16760661,chr11,16760626,16760661,0,82568803
H1|chr11:99489621-99489681,chr11,99489621,99489681,H1|chr11:17032775-17032824,chr11,17032775,17032824,0,82456846
H1|chr11:99499868-99499897,chr11,99499868,99499897,H1|chr11:748702-748823,chr11,748702,748823,0,98751166
H1|chr11:99779884-99779939,chr11,99779884,99779939,H1|chr11:126221924-126222052,chr11,126221924,126222052,0,26442040
H1|chr11:100047962-100048050,chr11,100047962,100048050,H1|chr11:129874921-129874982,chr11,129874921,129874982,0,29826959
H1|chr11:100158853-100158945,chr11,100158853,100158945,H1|chr11:118888282-118888340,chr11,118888282,118888340,0,18729429
H1|chr11:100216525-100216606,chr11,100216525,100216606,H1|chr11:205779-205826,chr11,205779,205826,0,100010746
H1|chr11:100232213-100232282,chr11,100232213,100232282,H1|chr11:57530738-57530808,chr11,57530738,57530808,0,42701475
H1|chr11:100580518-100580589,chr11,100580518,100580589,H1|chr11:117103773-117103852,chr11,117103773,117103852,0,16523255
H1|chr11:100797121-100797176,chr11,100797121,100797176,H1|chr11:68042717-68042771,chr11,68042717,68042771,0,32754404
H1|chr11:100986153-100986193,chr11,100986153,100986193,H1|chr11:33280248-33280367,chr11,33280248,33280367,0,67705905
H1|chr11:101716394-101716469,chr11,101716394,101716469,H1|chr11:73308092-73308150,chr11,73308092,73308150,0,28408302
H1|chr11:101816054-101816152,chr11,101816054,101816152,H1|chr11:117103774-117103853,chr11,117103774,117103853,0,15287720
H1|chr11:101837431-101837473,chr11,101837431,101837473,H1|chr11:14362801-14362868,chr11,14362801,14362868,0,87474630
H1|chr11:101855209-101855302,chr11,101855209,101855302,H1|chr11:118888291-118888340,chr11,118888291,118888340,0,17033082
H1|chr11:102063641-102063714,chr11,102063641,102063714,H1|chr11:2399972-2400089,chr11,2399972,2400089,0,99663669
H1|chr11:102192309-102192431,chr11,102192309,102192431,H1|chr11:58869637-58869785,chr11,58869637,58869785,0,43322672
H1|chr11:102251368-102251409,chr11,102251368,102251409,H1|chr11:286467-286552,chr11,286467,286552,0,101964901
H1|chr11:102524959-102525015,chr11,102524959,102525015,H1|chr11:64951815-64951901,chr11,64951815,64951901,0,37573144
H1|chr11:103333810-103333873,chr11,103333810,103333873,H1|chr11:126225336-126225383,chr11,126225336,126225383,0,22891526
H1|chr11:104421996-104422090,chr11,104421996,104422090,H1|chr11:63607435-63607491,chr11,63607435,63607491,0,40814561
H1|chr11:104997083-104997146,chr11,104997083,104997146,H1|chr11:3012971-3013031,chr11,3012971,3013031,0,101984112
H1|chr11:105314752-105314804,chr11,105314752,105314804,H1|chr11:291414-291511,chr11,291414,291511,0,105023338
H1|chr11:105316288-105316331,chr11,105316288,105316331,H1|chr11:27655240-27655310,chr11,27655240,27655310,0,77661048
H1|chr11:105730896-105730926,chr11,105730896,105730926,H1|chr11:33280248-33280367,chr11,33280248,33280367,0,72450648
H1|chr11:105849145-105849241,chr11,105849145,105849241,H1|chr11:58869637-58869691,chr11,58869637,58869691,0,46979508
H1|chr11:105992886-105992974,chr11,105992886,105992974,H1|chr11:27655210-27655272,chr11,27655210,27655272,0,78337676
H1|chr11:106020707-106020775,chr11,106020707,106020775,H1|chr11:14362567-14362620,chr11,14362567,14362620,0,91658140
H1|chr11:106273781-106273875,chr11,106273781,106273875,H1|chr11:63607435-63607491,chr11,63607435,63607491,0,42666346
H1|chr11:106671084-106671149,chr11,106671084,106671149,H1|chr11:61734402-61734425,chr11,61734402,61734425,0,44936682
H1|chr11:106748698-106748779,chr11,106748698,106748779,H1|chr11:10744150-10744216,chr11,10744150,10744216,0,96004548
H1|chr11:107211409-107211441,chr11,107211409,107211441,H1|chr11:62436359-62436500,chr11,62436359,62436500,0,44775050
H1|chr11:107350624-107350703,chr11,107350624,107350703,H1|chr11:61132214-61132285,chr11,61132214,61132285,0,46218410
H1|chr11:109448809-109448934,chr11,109448809,109448934,H1|chr11:46369463-46369485,chr11,46369463,46369485,0,63079346
H1|chr11:109536603-109536675,chr11,109536603,109536675,H1|chr11:63615129-63615169,chr11,63615129,63615169,0,45921474
H1|chr11:109655111-109655134,chr11,109655111,109655134,H1|chr11:34125995-34126064,chr11,34125995,34126064,0,75529116
H1|chr11:109920248-109920337,chr11,109920248,109920337,H1|chr11:17032647-17032726,chr11,17032647,17032726,0,92887601
H1|chr11:109975460-109975541,chr11,109975460,109975541,H1|chr11:63580426-63580470,chr11,63580426,63580470,0,46395034
H1|chr11:109992880-109992917,chr11,109992880,109992917,H1|chr11:47293654-47293748,chr11,47293654,47293748,0,62699226
H1|chr11:110248754-110248876,chr11,110248754,110248876,H1|chr11:58869637-58869785,chr11,58869637,58869785,0,51379117
H1|chr11:110436027-110436077,chr11,110436027,110436077,H1|chr11:67235764-67235809,chr11,67235764,67235809,0,43200263
H1|chr11:110477704-110477812,chr11,110477704,110477812,H1|chr11:841448-841542,chr11,841448,841542,0,109636256
H1|chr11:111052585-111052721,chr11,111052585,111052721,H1|chr11:67482539-67482641,chr11,67482539,67482641,0,43570046
H1|chr11:111073358-111073411,chr11,111073358,111073411,H1|chr11:30347958-30348011,chr11,30347958,30348011,0,80725400
H1|chr11:111309221-111309249,chr11,111309221,111309249,H1|chr11:68518246-68518293,chr11,68518246,68518293,0,42790975
H1|chr11:111400663-111400712,chr11,111400663,111400712,H1|chr11:126221336-126221401,chr11,126221336,126221401,0,14820673
H1|chr11:112403997-112404057,chr11,112403997,112404057,H1|chr11:126221166-126221217,chr11,126221166,126221217,0,13817169
H1|chr11:112523647-112523726,chr11,112523647,112523726,H1|chr11:14360298-14360366,chr11,14360298,14360366,0,98163349
H1|chr11:112698815-112698884,chr11,112698815,112698884,H1|chr11:27654551-27654615,chr11,27654551,27654615,0,85044264
H1|chr11:112949294-112949392,chr11,112949294,112949392,H1|chr11:63607435-63607491,chr11,63607435,63607491,0,49341859
H1|chr11:113093785-113093866,chr11,113093785,113093866,H1|chr11:10744150-10744216,chr11,10744150,10744216,0,102349635
H1|chr11:113593050-113593125,chr11,113593050,113593125,H1|chr11:44971962-44972033,chr11,44971962,44972033,0,68621088
H1|chr11:113765992-113766086,chr11,113765992,113766086,H1|chr11:63744528-63744618,chr11,63744528,63744618,0,50021464
H1|chr11:114117262-114117373,chr11,114117262,114117373,H1|chr11:27655210-27655272,chr11,27655210,27655272,0,86462052
H1|chr11:114168998-114169070,chr11,114168998,114169070,H1|chr11:63615129-63615169,chr11,63615129,63615169,0,50553869
H1|chr11:114319685-114319775,chr11,114319685,114319775,H1|chr11:61132214-61132285,chr11,61132214,61132285,0,53187471
H1|chr11:114356311-114356391,chr11,114356311,114356391,H1|chr11:73308092-73308150,chr11,73308092,73308150,0,41048219
H1|chr11:114651029-114651129,chr11,114651029,114651129,H1|chr11:93969066-93969113,chr11,93969066,93969113,0,20681963
H1|chr11:114786713-114786789,chr11,114786713,114786789,H1|chr11:73308092-73308150,chr11,73308092,73308150,0,41478621
H1|chr11:114814191-114814279,chr11,114814191,114814279,H1|chr11:63579109-63579172,chr11,63579109,63579172,0,51235082
H1|chr11:115046177-115046208,chr11,115046177,115046208,H1|chr11:62436359-62436392,chr11,62436359,62436392,0,52609818
H1|chr11:115215527-115215567,chr11,115215527,115215567,H1|chr11:33280248-33280367,chr11,33280248,33280367,0,81935279
H1|chr11:115330916-115330979,chr11,115330916,115330979,H1|chr11:126225336-126225383,chr11,126225336,126225383,0,10894420
H1|chr11:115457156-115457211,chr11,115457156,115457211,H1|chr11:27655648-27655723,chr11,27655648,27655723,0,87801508
H1|chr11:116347737-116347861,chr11,116347737,116347861,H1|chr11:67196237-67196331,chr11,67196237,67196331,0,49151500
H1|chr11:116528564-116528655,chr11,116528564,116528655,H1|chr11:65630249-65630308,chr11,65630249,65630308,0,50898315
H1|chr11:116648650-116648756,chr11,116648650,116648756,H1|chr11:27654623-27654676,chr11,27654623,27654676,0,88994027
H1|chr11:116907866-116907960,chr11,116907866,116907960,H1|chr11:27654680-27654789,chr11,27654680,27654789,0,89253186
H1|chr11:117616755-117616784,chr11,117616755,117616784,H1|chr11:66187595-66187726,chr11,66187595,66187726,0,51429160
H1|chr11:117886918-117887005,chr11,117886918,117887005,H1|chr11:67184462-67184536,chr11,67184462,67184536,0,50702456
H1|chr11:118775126-118775273,chr11,118775126,118775273,H1|chr11:66187337-66187361,chr11,66187337,66187361,0,52587789
H1|chr11:118902017-118902067,chr11,118902017,118902067,H1|chr11:67235764-67235809,chr11,67235764,67235809,0,51666253
H1|chr11:118966577-118966673,chr11,118966577,118966673,H1|chr11:58869637-58869691,chr11,58869637,58869691,0,60096940
H1|chr11:119061721-119061780,chr11,119061721,119061780,H1|chr11:64881837-64881896,chr11,64881837,64881896,0,54179884
H1|chr11:119347127-119347250,chr11,119347127,119347250,H1|chr11:126224620-126224691,chr11,126224620,126224691,0,6877493
H1|chr11:119455483-119455559,chr11,119455483,119455559,H1|chr11:73308092-73308150,chr11,73308092,73308150,0,46147391
H1|chr11:119521543-119521581,chr11,119521543,119521581,H1|chr11:67481867-67481979,chr11,67481867,67481979,0,52039676
H1|chr11:119657884-119657937,chr11,119657884,119657937,H1|chr11:44972753-44972810,chr11,44972753,44972810,0,74685131
H1|chr11:119739602-119739707,chr11,119739602,119739707,H1|chr11:36313467-36313498,chr11,36313467,36313498,0,83426135
H1|chr11:121418126-121418212,chr11,121418126,121418212,H1|chr11:16761854-16761918,chr11,16761854,16761918,0,104656272
H1|chr11:121491615-121491692,chr11,121491615,121491692,H1|chr11:58825336-58825409,chr11,58825336,58825409,0,62666279
H1|chr11:121945448-121945497,chr11,121945448,121945497,H1|chr11:33181214-33181315,chr11,33181214,33181315,0,88764234
H1|chr11:122259148-122259187,chr11,122259148,122259187,H1|chr11:63577908-63578044,chr11,63577908,63578044,0,58681240
H1|chr11:122474409-122474503,chr11,122474409,122474503,H1|chr11:27654680-27654789,chr11,27654680,27654789,0,94819729
H1|chr11:122554213-122554256,chr11,122554213,122554256,H1|chr11:94275700-94275807,chr11,94275700,94275807,0,28278513
H1|chr11:122593483-122593511,chr11,122593483,122593511,H1|chr11:67799921-67800040,chr11,67799921,67800040,0,54793562
H1|chr11:122876643-122876769,chr11,122876643,122876769,H1|chr11:14362892-14362969,chr11,14362892,14362969,0,108513751
H1|chr11:123095733-123095785,chr11,123095733,123095785,H1|chr11:57090670-57090725,chr11,57090670,57090725,0,66005063
H1|chr11:123170239-123170389,chr11,123170239,123170389,H1|chr11:134142414-134142448,chr11,134142414,134142448,0,10972175
H1|chr11:123607048-123607100,chr11,123607048,123607100,H1|chr11:63377743-63377806,chr11,63377743,63377806,0,60229305
H1|chr11:123784085-123784126,chr11,123784085,123784126,H1|chr11:27654680-27654789,chr11,27654680,27654789,0,96129405
H1|chr11:123863642-123863762,chr11,123863642,123863762,H1|chr11:93478175-93478208,chr11,93478175,93478208,0,30385467
H1|chr11:124105027-124105122,chr11,124105027,124105122,H1|chr11:58870683-58870717,chr11,58870683,58870717,0,65234344
H1|chr11:124481130-124481222,chr11,124481130,124481222,H1|chr11:63735178-63735222,chr11,63735178,63735222,0,60745952
H1|chr11:124606357-124606407,chr11,124606357,124606407,H1|chr11:33181296-33181385,chr11,33181296,33181385,0,91425061
H1|chr11:124905453-124905548,chr11,124905453,124905548,H1|chr11:58870683-58870717,chr11,58870683,58870717,0,66034770
H1|chr11:125091843-125091939,chr11,125091843,125091939,H1|chr11:27655301-27655355,chr11,27655301,27655355,0,97436542
H1|chr11:125284275-125284381,chr11,125284275,125284381,H1|chr11:14360298-14360339,chr11,14360298,14360339,0,110923977
H1|chr11:125312827-125312899,chr11,125312827,125312899,H1|chr11:61722118-61722196,chr11,61722118,61722196,0,63590709
H1|chr11:125711930-125711969,chr11,125711930,125711969,H1|chr11:58827162-58827219,chr11,58827162,58827219,0,66884768
H1|chr11:126010136-126010241,chr11,126010136,126010241,H1|chr11:22647577-22647622,chr11,22647577,22647622,0,103362559
H1|chr11:126794067-126794167,chr11,126794067,126794167,H1|chr11:43703297-43703339,chr11,43703297,43703339,0,83090770
H1|chr11:127071162-127071251,chr11,127071162,127071251,H1|chr11:17032647-17032726,chr11,17032647,17032726,0,110038515
H1|chr11:127270306-127270329,chr11,127270306,127270329,H1|chr11:34125995-34126064,chr11,34125995,34126064,0,93144311
H1|chr11:127923076-127923152,chr11,127923076,127923152,H1|chr11:134140689-134140754,chr11,134140689,134140754,0,6217613
H1|chr11:128114741-128114798,chr11,128114741,128114798,H1|chr11:64951815-64951901,chr11,64951815,64951901,0,63162926
H1|chr11:128378252-128378284,chr11,128378252,128378284,H1|chr11:17031896-17031971,chr11,17031896,17031971,0,111346356
H1|chr11:128397787-128397834,chr11,128397787,128397834,H1|chr11:205779-205826,chr11,205779,205826,0,128192008
H1|chr11:128559211-128559259,chr11,128559211,128559259,H1|chr11:47195858-47195934,chr11,47195858,47195934,0,81363353
H1|chr11:128879212-128879253,chr11,128879212,128879253,H1|chr11:27653944-27654035,chr11,27653944,27654035,0,101225268
H1|chr11:128962737-128962799,chr11,128962737,128962799,H1|chr11:126225387-126225442,chr11,126225387,126225442,0,2737350
H1|chr11:129509295-129509373,chr11,129509295,129509373,H1|chr11:291259-291293,chr11,291259,291293,0,129218036
H1|chr11:129934201-129934267,chr11,129934201,129934267,H1|chr11:12699443-12699527,chr11,12699443,12699527,0,117234758
H1|chr11:130208747-130208869,chr11,130208747,130208869,H1|chr11:66187337-66187361,chr11,66187337,66187361,0,64021410
H1|chr11:130266071-130266169,chr11,130266071,130266169,H1|chr11:63607435-63607491,chr11,63607435,63607491,0,66658636
H1|chr11:130272062-130272117,chr11,130272062,130272117,H1|chr11:27655648-27655723,chr11,27655648,27655723,0,102616414
H1|chr11:130624783-130624862,chr11,130624783,130624862,H1|chr11:126224620-126224691,chr11,126224620,126224691,0,4400163
H1|chr11:130634286-130634411,chr11,130634286,130634411,H1|chr11:47292776-47292798,chr11,47292776,47292798,0,83341510
H1|chr11:130786201-130786219,chr11,130786201,130786219,H1|chr11:77182686-77182816,chr11,77182686,77182816,0,53603515
H1|chr11:131236104-131236169,chr11,131236104,131236169,H1|chr11:61734402-61734425,chr11,61734402,61734425,0,69501702
H1|chr11:131699336-131699372,chr11,131699336,131699372,H1|chr11:57093018-57093099,chr11,57093018,57093099,0,74606318
H1|chr11:131983675-131983735,chr11,131983675,131983735,H1|chr11:46140783-46140826,chr11,46140783,46140826,0,85842892
H1|chr11:132050868-132050987,chr11,132050868,132050987,H1|chr11:126225336-126225367,chr11,126225336,126225367,0,5825532
H1|chr11:132138377-132138433,chr11,132138377,132138433,H1|chr11:63380691-63380841,chr11,63380691,63380841,0,68757686
H1|chr11:132733052-132733097,chr11,132733052,132733097,H1|chr11:73308092-73308150,chr11,73308092,73308150,0,59424960
H1|chr11:132875002-132875115,chr11,132875002,132875115,H1|chr11:14362681-14362702,chr11,14362681,14362702,0,118512321
H1|chr11:133230659-133230746,chr11,133230659,133230746,H1|chr11:17031896-17031971,chr11,17031896,17031971,0,116198763
H1|chr11:133423133-133423235,chr11,133423133,133423235,H1|chr11:17031283-17031328,chr11,17031283,17031328,0,116391850
H1|chr11:133448140-133448289,chr11,133448140,133448289,H1|chr11:7698010-7698066,chr11,7698010,7698066,0,125750130
H1|chr11:133677466-133677588,chr11,133677466,133677588,H1|chr11:66187337-66187361,chr11,66187337,66187361,0,67490129
H1|chr11:133793952-133793995,chr11,133793952,133793995,H1|chr11:94275700-94275807,chr11,94275700,94275807,0,39518252
H1|chr11:133796859-133796903,chr11,133796859,133796903,H1|chr11:95657564-95657637,chr11,95657564,95657637,0,38139295
H1|chr11:134008285-134008392,chr11,134008285,134008392,H1|chr11:63607319-63607362,chr11,63607319,63607362,0,70400966
H1|chr11:134123789-134123844,chr11,134123789,134123844,H1|chr11:77530350-77530414,chr11,77530350,77530414,0,56593439
H1|chr11:134522944-134523036,chr11,134522944,134523036,H1|chr11:65430270-65430289,chr11,65430270,65430289,0,69092674
H1|chr11:134601164-134601240,chr11,134601164,134601240,H1|chr11:134140689-134140754,chr11,134140689,134140754,0,460475
H1|chr12:195997-196049,chr12,195997,196049,H1|chr12:49582042-49582093,chr12,49582042,49582093,0,49386045
H1|chr12:1014632-1014686,chr12,1014632,1014686,H1|chr12:8186539-8186598,chr12,8186539,8186598,0,7171907
H1|chr12:1148138-1148199,chr12,1148138,1148199,H1|chr12:120962230-120962318,chr12,120962230,120962318,0,119814092
H1|chr12:1179281-1179370,chr12,1179281,1179370,H1|chr12:8164571-8164632,chr12,8164571,8164632,0,6985290
H1|chr12:1974548-1974611,chr12,1974548,1974611,H1|chr12:120962238-120962324,chr12,120962238,120962324,0,118987690
H1|chr12:2289598-2289621,chr12,2289598,2289621,H1|chr12:57499727-57499764,chr12,57499727,57499764,0,55210129
H1|chr12:3234277-3234322,chr12,3234277,3234322,H1|chr12:31476525-31476628,chr12,31476525,31476628,0,28242248
H1|chr12:3250148-3250233,chr12,3250148,3250233,H1|chr12:8046182-8046247,chr12,8046182,8046247,0,4796034
H1|chr12:3304308-3304422,chr12,3304308,3304422,H1|chr12:9061616-9061652,chr12,9061616,9061652,0,5757308
H1|chr12:3445376-3445446,chr12,3445376,3445446,H1|chr12:19593855-19593907,chr12,19593855,19593907,0,16148479
H1|chr12:3654936-3654978,chr12,3654936,3654978,H1|chr12:9063290-9063378,chr12,9063290,9063378,0,5408354
H1|chr12:3781275-3781370,chr12,3781275,3781370,H1|chr12:46660819-46660865,chr12,46660819,46660865,0,42879544
H1|chr12:4317222-4317284,chr12,4317222,4317284,H1|chr12:56511218-56511294,chr12,56511218,56511294,0,52193996
H1|chr12:4374746-4374832,chr12,4374746,4374832,H1|chr12:51628926-51628996,chr12,51628926,51628996,0,47254180
H1|chr12:4392000-4392021,chr12,4392000,4392021,H1|chr12:6719813-6719942,chr12,6719813,6719942,0,2327813
H1|chr12:4506280-4506344,chr12,4506280,4506344,H1|chr12:120633668-120633743,chr12,120633668,120633743,0,116127388
H1|chr12:4552597-4552628,chr12,4552597,4552628,H1|chr12:7034250-7034344,chr12,7034250,7034344,0,2481653
H1|chr12:4982066-4982162,chr12,4982066,4982162,H1|chr12:8046182-8046247,chr12,8046182,8046247,0,3064116
H1|chr12:5551505-5551566,chr12,5551505,5551566,H1|chr12:7941318-7941397,chr12,7941318,7941397,0,2389813
H1|chr12:5943320-5943371,chr12,5943320,5943371,H1|chr12:6719813-6719942,chr12,6719813,6719942,0,776493
H1|chr12:6538585-6538623,chr12,6538585,6538623,H1|chr12:54655272-54655384,chr12,54655272,54655384,0,48116687
H1|chr12:7039064-7039128,chr12,7039064,7039128,H1|chr12:120633668-120633743,chr12,120633668,120633743,0,113594604
H1|chr12:7264808-7264871,chr12,7264808,7264871,H1|chr12:56511219-56511294,chr12,56511219,56511294,0,49246411
H1|chr12:7488086-7488108,chr12,7488086,7488108,H1|chr12:57474571-57474627,chr12,57474571,57474627,0,49986485
H1|chr12:7566586-7566621,chr12,7566586,7566621,H1|chr12:56132017-56132119,chr12,56132017,56132119,0,48565431
H1|chr12:7824499-7824568,chr12,7824499,7824568,H1|chr12:54655314-54655384,chr12,54655314,54655384,0,46830815
H1|chr12:7832766-7832857,chr12,7832766,7832857,H1|chr12:53401592-53401651,chr12,53401592,53401651,0,45568826
H1|chr12:8744247-8744284,chr12,8744247,8744284,H1|chr12:95947006-95947100,chr12,95947006,95947100,0,87202759
H1|chr12:9167639-9167681,chr12,9167639,9167681,H1|chr12:95946141-95946195,chr12,95946141,95946195,0,86778502
H1|chr12:9995789-9995939,chr12,9995789,9995939,H1|chr12:80084874-80084895,chr12,80084874,80084895,0,70089085
H1|chr12:10136722-10136840,chr12,10136722,10136840,H1|chr12:5352422-5352454,chr12,5352422,5352454,0,4784300
H1|chr12:11043672-11043778,chr12,11043672,11043778,H1|chr12:110721038-110721097,chr12,110721038,110721097,0,99677366
H1|chr12:12241066-12241193,chr12,12241066,12241193,H1|chr12:56402366-56402386,chr12,56402366,56402386,0,44161300
H1|chr12:13586096-13586129,chr12,13586096,13586129,H1|chr12:5353118-5353182,chr12,5353118,5353182,0,8232978
H1|chr12:14157223-14157254,chr12,14157223,14157254,H1|chr12:65005841-65005960,chr12,65005841,65005960,0,50848618
H1|chr12:14913624-14913682,chr12,14913624,14913682,H1|chr12:120633593-120633661,chr12,120633593,120633661,0,105719969
H1|chr12:15490327-15490378,chr12,15490327,15490378,H1|chr12:110718279-110718339,chr12,110718279,110718339,0,95227952
H1|chr12:15780494-15780556,chr12,15780494,15780556,H1|chr12:53847338-53847420,chr12,53847338,53847420,0,38066844
H1|chr12:15995267-15995381,chr12,15995267,15995381,H1|chr12:5351172-5351215,chr12,5351172,5351215,0,10644095
H1|chr12:16132821-16132885,chr12,16132821,16132885,H1|chr12:32114376-32114396,chr12,32114376,32114396,0,15981555
H1|chr12:16470925-16470973,chr12,16470925,16470973,H1|chr12:4385827-4385929,chr12,4385827,4385929,0,12085098
H1|chr12:17282398-17282446,chr12,17282398,17282446,H1|chr12:110718279-110718339,chr12,110718279,110718339,0,93435881
H1|chr12:17793090-17793149,chr12,17793090,17793149,H1|chr12:80082727-80082815,chr12,80082727,80082815,0,62289637
H1|chr12:17931365-17931402,chr12,17931365,17931402,H1|chr12:8046167-8046256,chr12,8046167,8046256,0,9885198
H1|chr12:19171701-19171787,chr12,19171701,19171787,H1|chr12:5352588-5352619,chr12,5352588,5352619,0,13819113
H1|chr12:19560896-19560917,chr12,19560896,19560917,H1|chr12:5351172-5351215,chr12,5351172,5351215,0,14209724
H1|chr12:19856090-19856150,chr12,19856090,19856150,H1|chr12:5351008-5351155,chr12,5351008,5351155,0,14505082
H1|chr12:22500418-22500456,chr12,22500418,22500456,H1|chr12:54655272-54655384,chr12,54655272,54655384,0,32154854
H1|chr12:23363282-23363354,chr12,23363282,23363354,H1|chr12:19593855-19593907,chr12,19593855,19593907,0,3769427
H1|chr12:23620907-23620948,chr12,23620907,23620948,H1|chr12:62998571-62998647,chr12,62998571,62998647,0,39377664
H1|chr12:23733777-23733927,chr12,23733777,23733927,H1|chr12:9061564-9061618,chr12,9061564,9061618,0,14672213
H1|chr12:23797085-23797213,chr12,23797085,23797213,H1|chr12:9061616-9061652,chr12,9061616,9061652,0,14735469
H1|chr12:24113067-24113210,chr12,24113067,24113210,H1|chr12:57116194-57116299,chr12,57116194,57116299,0,33003127
H1|chr12:24210918-24210936,chr12,24210918,24210936,H1|chr12:57636442-57636532,chr12,57636442,57636532,0,33425524
H1|chr12:24585829-24585969,chr12,24585829,24585969,H1|chr12:5351186-5351222,chr12,5351186,5351222,0,19234643
H1|chr12:25523770-25523917,chr12,25523770,25523917,H1|chr12:8166498-8166534,chr12,8166498,8166534,0,17357272
H1|chr12:25711715-25711750,chr12,25711715,25711750,H1|chr12:6716822-6716871,chr12,6716822,6716871,0,18994893
H1|chr12:28756924-28756966,chr12,28756924,28756966,H1|chr12:9063290-9063378,chr12,9063290,9063378,0,19693634
H1|chr12:29522013-29522075,chr12,29522013,29522075,H1|chr12:120962785-120962847,chr12,120962785,120962847,0,91440772
H1|chr12:30064012-30064067,chr12,30064012,30064067,H1|chr12:120633280-120633340,chr12,120633280,120633340,0,90569268
H1|chr12:30308184-30308253,chr12,30308184,30308253,H1|chr12:54655314-54655384,chr12,54655314,54655384,0,24347130
H1|chr12:30663750-30663816,chr12,30663750,30663816,H1|chr12:120633668-120633743,chr12,120633668,120633743,0,89969918
H1|chr12:30696354-30696456,chr12,30696354,30696456,H1|chr12:52208754-52208773,chr12,52208754,52208773,0,21512400
H1|chr12:30765364-30765445,chr12,30765364,30765445,H1|chr12:53847338-53847420,chr12,53847338,53847420,0,23081974
H1|chr12:31062498-31062582,chr12,31062498,31062582,H1|chr12:62998640-62998669,chr12,62998640,62998669,0,31936142
H1|chr12:31181531-31181577,chr12,31181531,31181577,H1|chr12:6813601-6813741,chr12,6813601,6813741,0,24367930
H1|chr12:31924803-31924901,chr12,31924803,31924901,H1|chr12:56140101-56140134,chr12,56140101,56140134,0,24215298
H1|chr12:32057032-32057086,chr12,32057032,32057086,H1|chr12:5351238-5351334,chr12,5351238,5351334,0,26705794
H1|chr12:33564714-33564798,chr12,33564714,33564798,H1|chr12:62998640-62998669,chr12,62998640,62998669,0,29433926
H1|chr12:33831932-33831973,chr12,33831932,33831973,H1|chr12:64800557-64800615,chr12,64800557,64800615,0,30968625
H1|chr12:34626228-34626267,chr12,34626228,34626267,H1|chr12:62998571-62998647,chr12,62998571,62998647,0,28372343
H1|chr12:35761134-35761187,chr12,35761134,35761187,H1|chr12:46660325-46660353,chr12,46660325,46660353,0,10899191
H1|chr12:35862524-35862662,chr12,35862524,35862662,H1|chr12:31475882-31475980,chr12,31475882,31475980,0,4386642
H1|chr12:36552123-36552144,chr12,36552123,36552144,H1|chr12:5351172-5351215,chr12,5351172,5351215,0,31200951
H1|chr12:36600776-36600882,chr12,36600776,36600882,H1|chr12:110721038-110721097,chr12,110721038,110721097,0,74120262
H1|chr12:37566755-37566853,chr12,37566755,37566853,H1|chr12:9062131-9062281,chr12,9062131,9062281,0,28504624
H1|chr12:38976986-38977114,chr12,38976986,38977114,H1|chr12:9061575-9061597,chr12,9061575,9061597,0,29915411
H1|chr12:40317553-40317600,chr12,40317553,40317600,H1|chr12:31476525-31476628,chr12,31476525,31476628,0,8841028
H1|chr12:40341649-40341697,chr12,40341649,40341697,H1|chr12:110718279-110718339,chr12,110718279,110718339,0,70376630
H1|chr12:41604760-41604902,chr12,41604760,41604902,H1|chr12:5349668-5349818,chr12,5349668,5349818,0,36255092
H1|chr12:41809805-41809896,chr12,41809805,41809896,H1|chr12:52207353-52207391,chr12,52207353,52207391,0,10397548
H1|chr12:42004506-42004617,chr12,42004506,42004617,H1|chr12:19595870-19595966,chr12,19595870,19595966,0,22408636
H1|chr12:42292898-42292939,chr12,42292898,42292939,H1|chr12:7943550-7943670,chr12,7943550,7943670,0,34349348
H1|chr12:43104768-43104835,chr12,43104768,43104835,H1|chr12:5350995-5351078,chr12,5350995,5351078,0,37753773
H1|chr12:43306089-43306124,chr12,43306089,43306124,H1|chr12:56132017-56132119,chr12,56132017,56132119,0,12825928
H1|chr12:43353873-43353968,chr12,43353873,43353968,H1|chr12:129311681-129311725,chr12,129311681,129311725,0,85957808
H1|chr12:43678100-43678154,chr12,43678100,43678154,H1|chr12:56139935-56140047,chr12,56139935,56140047,0,12461835
H1|chr12:44028839-44028919,chr12,44028839,44028919,H1|chr12:51628926-51628996,chr12,51628926,51628996,0,7600087
H1|chr12:44566899-44567046,chr12,44566899,44567046,H1|chr12:8166498-8166534,chr12,8166498,8166534,0,36400401
H1|chr12:44608387-44608509,chr12,44608387,44608509,H1|chr12:53401592-53401651,chr12,53401592,53401651,0,8793205
H1|chr12:45046839-45046880,chr12,45046839,45046880,H1|chr12:62998571-62998647,chr12,62998571,62998647,0,17951732
H1|chr12:45219193-45219325,chr12,45219193,45219325,H1|chr12:6772109-6772127,chr12,6772109,6772127,0,38447084
H1|chr12:45578886-45578928,chr12,45578886,45578928,H1|chr12:95946141-95946195,chr12,95946141,95946195,0,50367255
H1|chr12:46064559-46064639,chr12,46064559,46064639,H1|chr12:51628926-51628996,chr12,51628926,51628996,0,5564367
H1|chr12:46281243-46281296,chr12,46281243,46281296,H1|chr12:46660325-46660353,chr12,46660325,46660353,0,379082
H1|chr12:46480647-46480729,chr12,46480647,46480729,H1|chr12:53847785-53847853,chr12,53847785,53847853,0,7367138
H1|chr12:46674252-46674297,chr12,46674252,46674297,H1|chr12:57116194-57116299,chr12,57116194,57116299,0,10441942
H1|chr12:46986572-46986649,chr12,46986572,46986649,H1|chr12:53847785-53847853,chr12,53847785,53847853,0,6861213
H1|chr12:47093756-47093812,chr12,47093756,47093812,H1|chr12:56139935-56140047,chr12,56139935,56140047,0,9046179
H1|chr12:47266754-47266804,chr12,47266754,47266804,H1|chr12:65005841-65005958,chr12,65005841,65005958,0,17739087
H1|chr12:47496334-47496455,chr12,47496334,47496455,H1|chr12:53401592-53401651,chr12,53401592,53401651,0,5905258
H1|chr12:48910773-48910804,chr12,48910773,48910804,H1|chr12:65005841-65005960,chr12,65005841,65005960,0,16095068
H1|chr12:49208788-49208836,chr12,49208788,49208836,H1|chr12:4385827-4385929,chr12,4385827,4385929,0,44822961
H1|chr12:49547299-49547383,chr12,49547299,49547383,H1|chr12:5351186-5351222,chr12,5351186,5351222,0,44196113
H1|chr12:50216133-50216214,chr12,50216133,50216214,H1|chr12:53847338-53847420,chr12,53847338,53847420,0,3631205
H1|chr12:50223420-50223532,chr12,50223420,50223532,H1|chr12:50560277-50560341,chr12,50560277,50560341,0,336857
H1|chr12:50480198-50480237,chr12,50480198,50480237,H1|chr12:62998571-62998647,chr12,62998571,62998647,0,12518373
H1|chr12:51228683-51228762,chr12,51228683,51228762,H1|chr12:56136967-56137017,chr12,56136967,56137017,0,4908284
H1|chr12:51236217-51236276,chr12,51236217,51236276,H1|chr12:80082727-80082815,chr12,80082727,80082815,0,28846510
H1|chr12:51958779-51958859,chr12,51958779,51958859,H1|chr12:76430192-76430262,chr12,76430192,76430262,0,24471413
H1|chr12:52028503-52028569,chr12,52028503,52028569,H1|chr12:120633668-120633743,chr12,120633668,120633743,0,68605165
H1|chr12:52163463-52163541,chr12,52163463,52163541,H1|chr12:56136967-56137017,chr12,56136967,56137017,0,3973504
H1|chr12:52872334-52872359,chr12,52872334,52872359,H1|chr12:9062126-9062222,chr12,9062126,9062222,0,43810208
H1|chr12:52962898-52962972,chr12,52962898,52962972,H1|chr12:5351125-5351200,chr12,5351125,5351200,0,47611773
H1|chr12:53465165-53465242,chr12,53465165,53465242,H1|chr12:19594572-19594640,chr12,19594572,19594640,0,33870593
H1|chr12:54876645-54876686,chr12,54876645,54876686,H1|chr12:4383726-4383800,chr12,4383726,4383800,0,50492919
H1|chr12:55006246-55006352,chr12,55006246,55006352,H1|chr12:9062511-9062545,chr12,9062511,9062545,0,45943735
H1|chr12:55066435-55066549,chr12,55066435,55066549,H1|chr12:5351172-5351215,chr12,5351172,5351215,0,49715263
H1|chr12:55700146-55700204,chr12,55700146,55700204,H1|chr12:5351238-5351330,chr12,5351238,5351330,0,50348908
H1|chr12:56603986-56604040,chr12,56603986,56604040,H1|chr12:19595870-19595966,chr12,19595870,19595966,0,37008116
H1|chr12:56606598-56606635,chr12,56606598,56606635,H1|chr12:95947006-95947100,chr12,95947006,95947100,0,39340408
H1|chr12:57771964-57772001,chr12,57771964,57772001,H1|chr12:54655272-54655384,chr12,54655272,54655384,0,3116692
H1|chr12:58407740-58407889,chr12,58407740,58407889,H1|chr12:80082727-80082815,chr12,80082727,80082815,0,21674987
H1|chr12:58802594-58802734,chr12,58802594,58802734,H1|chr12:5351186-5351222,chr12,5351186,5351222,0,53451408
H1|chr12:59802852-59802929,chr12,59802852,59802929,H1|chr12:19594572-19594640,chr12,19594572,19594640,0,40208280
H1|chr12:59854134-59854229,chr12,59854134,59854229,H1|chr12:53847300-53847352,chr12,53847300,53847352,0,6006834
H1|chr12:60073442-60073492,chr12,60073442,60073492,H1|chr12:120933034-120933062,chr12,120933034,120933062,0,60859592
H1|chr12:60396322-60396367,chr12,60396322,60396367,H1|chr12:95947006-95947100,chr12,95947006,95947100,0,35550684
H1|chr12:60451432-60451478,chr12,60451432,60451478,H1|chr12:5349542-5349622,chr12,5349542,5349622,0,55101890
H1|chr12:60728858-60728934,chr12,60728858,60728934,H1|chr12:5351551-5351625,chr12,5351551,5351625,0,55377307
H1|chr12:61331008-61331090,chr12,61331008,61331090,H1|chr12:95947041-95947136,chr12,95947041,95947136,0,34616033
H1|chr12:61333408-61333490,chr12,61333408,61333490,H1|chr12:53847785-53847853,chr12,53847785,53847853,0,7485623
H1|chr12:61488019-61488082,chr12,61488019,61488082,H1|chr12:56511219-56511294,chr12,56511219,56511294,0,4976800
H1|chr12:61553240-61553326,chr12,61553240,61553326,H1|chr12:51628926-51628996,chr12,51628926,51628996,0,9924314
H1|chr12:62092451-62092553,chr12,62092451,62092553,H1|chr12:52208754-52208773,chr12,52208754,52208773,0,9883697
H1|chr12:62982143-62982234,chr12,62982143,62982234,H1|chr12:53401592-53401651,chr12,53401592,53401651,0,9580551
H1|chr12:63044266-63044312,chr12,63044266,63044312,H1|chr12:6813601-6813741,chr12,6813601,6813741,0,56230665
H1|chr12:63099642-63099679,chr12,63099642,63099679,H1|chr12:54655272-54655384,chr12,54655272,54655384,0,8444370
H1|chr12:64382019-64382066,chr12,64382019,64382066,H1|chr12:95946141-95946195,chr12,95946141,95946195,0,31564122
H1|chr12:64619448-64619493,chr12,64619448,64619493,H1|chr12:31476525-31476628,chr12,31476525,31476628,0,33142923
H1|chr12:64904247-64904323,chr12,64904247,64904323,H1|chr12:70761292-70761344,chr12,70761292,70761344,0,5857045
H1|chr12:65420813-65420897,chr12,65420813,65420897,H1|chr12:5351186-5351222,chr12,5351186,5351222,0,60069627
H1|chr12:66436667-66436702,chr12,66436667,66436702,H1|chr12:56139935-56140047,chr12,56139935,56140047,0,10296732
H1|chr12:66631072-66631172,chr12,66631072,66631172,H1|chr12:9061632-9061699,chr12,9061632,9061699,0,57569440
H1|chr12:67046696-67046795,chr12,67046696,67046795,H1|chr12:120556632-120556683,chr12,120556632,120556683,0,53509936
H1|chr12:67365857-67365934,chr12,67365857,67365934,H1|chr12:53847785-53847853,chr12,53847785,53847853,0,13518072
H1|chr12:67523298-67523348,chr12,67523298,67523348,H1|chr12:120933034-120933062,chr12,120933034,120933062,0,53409736
H1|chr12:67663274-67663396,chr12,67663274,67663396,H1|chr12:53401592-53401651,chr12,53401592,53401651,0,14261682
H1|chr12:67943958-67943976,chr12,67943958,67943976,H1|chr12:57636442-57636532,chr12,57636442,57636532,0,10307516
H1|chr12:68296157-68296199,chr12,68296157,68296199,H1|chr12:46660325-46660353,chr12,46660325,46660353,0,21635832
H1|chr12:68628539-68628628,chr12,68628539,68628628,H1|chr12:8164571-8164632,chr12,8164571,8164632,0,60463968
H1|chr12:68829268-68829327,chr12,68829268,68829327,H1|chr12:5352773-5352831,chr12,5352773,5352831,0,63476495
H1|chr12:69074864-69074954,chr12,69074864,69074954,H1|chr12:110721038-110721097,chr12,110721038,110721097,0,41646174
H1|chr12:69285171-69285270,chr12,69285171,69285270,H1|chr12:57115524-57115588,chr12,57115524,57115588,0,12169647
H1|chr12:69305004-69305083,chr12,69305004,69305083,H1|chr12:56136967-56137017,chr12,56136967,56137017,0,13168037
H1|chr12:69410528-69410551,chr12,69410528,69410551,H1|chr12:8398948-8398994,chr12,8398948,8398994,0,61011580
H1|chr12:70267328-70267422,chr12,70267328,70267422,H1|chr12:46660819-46660865,chr12,46660819,46660865,0,23606509
H1|chr12:70830960-70831032,chr12,70830960,70831032,H1|chr12:19593855-19593907,chr12,19593855,19593907,0,51237105
H1|chr12:71442833-71442855,chr12,71442833,71442855,H1|chr12:57474571-57474627,chr12,57474571,57474627,0,13968262
H1|chr12:71763238-71763359,chr12,71763238,71763359,H1|chr12:53401592-53401651,chr12,53401592,53401651,0,18361646
H1|chr12:72856492-72856543,chr12,72856492,72856543,H1|chr12:6719813-6719942,chr12,6719813,6719942,0,66136679
H1|chr12:73550853-73550904,chr12,73550853,73550904,H1|chr12:110718279-110718339,chr12,110718279,110718339,0,37167426
H1|chr12:74475785-74475841,chr12,74475785,74475841,H1|chr12:56139935-56140047,chr12,56139935,56140047,0,18335850
H1|chr12:74876098-74876191,chr12,74876098,74876191,H1|chr12:7052063-7052120,chr12,7052063,7052120,0,67824035
H1|chr12:74962335-74962430,chr12,74962335,74962430,H1|chr12:53847300-53847352,chr12,53847300,53847352,0,21115035
H1|chr12:75306767-75306837,chr12,75306767,75306837,H1|chr12:85304710-85304773,chr12,85304710,85304773,0,9997943
H1|chr12:76140719-76140778,chr12,76140719,76140778,H1|chr12:57635805-57635857,chr12,57635805,57635857,0,18504914
H1|chr12:76345255-76345313,chr12,76345255,76345313,H1|chr12:120633593-120633661,chr12,120633593,120633661,0,44288338
H1|chr12:76688205-76688242,chr12,76688205,76688242,H1|chr12:46660015-46660099,chr12,46660015,46660099,0,30028190
H1|chr12:77542642-77542720,chr12,77542642,77542720,H1|chr12:56136967-56137017,chr12,56136967,56137017,0,21405675
H1|chr12:78463125-78463213,chr12,78463125,78463213,H1|chr12:76477316-76477364,chr12,76477316,76477364,0,1985809
H1|chr12:78708528-78708628,chr12,78708528,78708628,H1|chr12:9061632-9061699,chr12,9061632,9061699,0,69646896
H1|chr12:79261497-79261549,chr12,79261497,79261549,H1|chr12:31475882-31475980,chr12,31475882,31475980,0,47785615
H1|chr12:79267900-79267960,chr12,79267900,79267960,H1|chr12:5351008-5351155,chr12,5351008,5351155,0,73916892
H1|chr12:79719671-79719725,chr12,79719671,79719725,H1|chr12:56139935-56140047,chr12,56139935,56140047,0,23579736
H1|chr12:79747759-79747788,chr12,79747759,79747788,H1|chr12:8046182-8046256,chr12,8046182,8046256,0,71701577
H1|chr12:79859365-79859444,chr12,79859365,79859444,H1|chr12:19594575-19594640,chr12,19594575,19594640,0,60264790
H1|chr12:80126531-80126589,chr12,80126531,80126589,H1|chr12:120962228-120962320,chr12,120962228,120962320,0,40835697
H1|chr12:80323099-80323141,chr12,80323099,80323141,H1|chr12:46660325-46660353,chr12,46660325,46660353,0,33662774
H1|chr12:80817517-80817554,chr12,80817517,80817554,H1|chr12:46660015-46660099,chr12,46660015,46660099,0,34157502
H1|chr12:80980327-80980422,chr12,80980327,80980422,H1|chr12:46660819-46660865,chr12,46660819,46660865,0,34319508
H1|chr12:81936847-81936899,chr12,81936847,81936899,H1|chr12:31475882-31475980,chr12,31475882,31475980,0,50460965
H1|chr12:81971823-81971925,chr12,81971823,81971925,H1|chr12:6718531-6718558,chr12,6718531,6718558,0,75253292
H1|chr12:82328175-82328221,chr12,82328175,82328221,H1|chr12:5349542-5349622,chr12,5349542,5349622,0,76978633
H1|chr12:82626339-82626380,chr12,82626339,82626380,H1|chr12:9061842-9061941,chr12,9061842,9061941,0,73564497
H1|chr12:83022528-83022678,chr12,83022528,83022678,H1|chr12:80084874-80084895,chr12,80084874,80084895,0,2937654
H1|chr12:83814311-83814346,chr12,83814311,83814346,H1|chr12:56139935-56140047,chr12,56139935,56140047,0,27674376
H1|chr12:85347066-85347116,chr12,85347066,85347116,H1|chr12:65005841-65005958,chr12,65005841,65005958,0,20341225
H1|chr12:85410870-85410963,chr12,85410870,85410963,H1|chr12:7052063-7052120,chr12,7052063,7052120,0,78358807
H1|chr12:85481234-85481308,chr12,85481234,85481308,H1|chr12:5351125-5351200,chr12,5351125,5351200,0,80130109
H1|chr12:86373499-86373561,chr12,86373499,86373561,H1|chr12:53847338-53847420,chr12,53847338,53847420,0,32526161
H1|chr12:86857178-86857237,chr12,86857178,86857237,H1|chr12:4385827-4385929,chr12,4385827,4385929,0,82471351
H1|chr12:86954135-86954189,chr12,86954135,86954189,H1|chr12:19595870-19595966,chr12,19595870,19595966,0,67358265
H1|chr12:87301621-87301770,chr12,87301621,87301770,H1|chr12:80082727-80082815,chr12,80082727,80082815,0,7218894
H1|chr12:88104284-88104382,chr12,88104284,88104382,H1|chr12:56140101-56140134,chr12,56140101,56140134,0,31964183
H1|chr12:88540785-88540839,chr12,88540785,88540839,H1|chr12:8186539-8186598,chr12,8186539,8186598,0,80354246
H1|chr12:88792442-88792569,chr12,88792442,88792569,H1|chr12:56402366-56402386,chr12,56402366,56402386,0,32390076
H1|chr12:88846478-88846562,chr12,88846478,88846562,H1|chr12:98990541-98990566,chr12,98990541,98990566,0,10144063
H1|chr12:88987143-88987205,chr12,88987143,88987205,H1|chr12:56511218-56511294,chr12,56511218,56511294,0,32475925
H1|chr12:89194247-89194330,chr12,89194247,89194330,H1|chr12:9061632-9061699,chr12,9061632,9061699,0,80132615
H1|chr12:90464276-90464343,chr12,90464276,90464343,H1|chr12:5350995-5351078,chr12,5350995,5351078,0,85113281
H1|chr12:91047546-91047605,chr12,91047546,91047605,H1|chr12:4385827-4385929,chr12,4385827,4385929,0,86661719
H1|chr12:91543108-91543190,chr12,91543108,91543190,H1|chr12:50560277-50560341,chr12,50560277,50560341,0,40982831
H1|chr12:91732865-91732979,chr12,91732865,91732979,H1|chr12:9061616-9061652,chr12,9061616,9061652,0,82671249
H1|chr12:92722586-92722730,chr12,92722586,92722730,H1|chr12:7052063-7052120,chr12,7052063,7052120,0,85670523
H1|chr12:93106580-93106618,chr12,93106580,93106618,H1|chr12:8398948-8398994,chr12,8398948,8398994,0,84707632
H1|chr12:93331314-93331428,chr12,93331314,93331428,H1|chr12:56140101-56140148,chr12,56140101,56140148,0,37191213
H1|chr12:93529509-93529599,chr12,93529509,93529599,H1|chr12:64799114-64799197,chr12,64799114,64799197,0,28730395
H1|chr12:93868294-93868370,chr12,93868294,93868370,H1|chr12:5351551-5351625,chr12,5351551,5351625,0,88516743
H1|chr12:94415369-94415432,chr12,94415369,94415432,H1|chr12:120962238-120962324,chr12,120962238,120962324,0,26546869
H1|chr12:94439537-94439623,chr12,94439537,94439623,H1|chr12:6718560-6718590,chr12,6718560,6718590,0,87720977
H1|chr12:94791800-94791944,chr12,94791800,94791944,H1|chr12:7052063-7052120,chr12,7052063,7052120,0,87739737
H1|chr12:95130538-95130603,chr12,95130538,95130603,H1|chr12:7941318-7941397,chr12,7941318,7941397,0,87189220
H1|chr12:95893951-95894009,chr12,95893951,95894009,H1|chr12:120962228-120962320,chr12,120962228,120962320,0,25068277
H1|chr12:96286006-96286028,chr12,96286006,96286028,H1|chr12:95946602-95946749,chr12,95946602,95946749,0,339404
H1|chr12:97134240-97134368,chr12,97134240,97134368,H1|chr12:9061616-9061652,chr12,9061616,9061652,0,88072624
H1|chr12:97205255-97205387,chr12,97205255,97205387,H1|chr12:6772109-6772127,chr12,6772109,6772127,0,90433146
H1|chr12:98826207-98826277,chr12,98826207,98826277,H1|chr12:19593855-19593907,chr12,19593855,19593907,0,79232352
H1|chr12:99109023-99109134,chr12,99109023,99109134,H1|chr12:19595870-19595966,chr12,19595870,19595966,0,79513153
H1|chr12:99719052-99719140,chr12,99719052,99719140,H1|chr12:76477316-76477364,chr12,76477316,76477364,0,23241736
H1|chr12:100271932-100272082,chr12,100271932,100272082,H1|chr12:9061564-9061618,chr12,9061564,9061618,0,91210368
H1|chr12:101179539-101179630,chr12,101179539,101179630,H1|chr12:52207353-52207391,chr12,52207353,52207391,0,48972186
H1|chr12:101358841-101358866,chr12,101358841,101358866,H1|chr12:9062126-9062222,chr12,9062126,9062222,0,92296715
H1|chr12:101512976-101513088,chr12,101512976,101513088,H1|chr12:5350995-5351078,chr12,5350995,5351078,0,96161981
H1|chr12:101573171-101573268,chr12,101573171,101573268,H1|chr12:5351549-5351587,chr12,5351549,5351587,0,96221622
H1|chr12:102887248-102887289,chr12,102887248,102887289,H1|chr12:64800557-64800615,chr12,64800557,64800615,0,38086691
H1|chr12:102968313-102968403,chr12,102968313,102968403,H1|chr12:110721038-110721097,chr12,110721038,110721097,0,7752725
H1|chr12:103277663-103277725,chr12,103277663,103277725,H1|chr12:120962785-120962847,chr12,120962785,120962847,0,17685122
H1|chr12:103336248-103336362,chr12,103336248,103336362,H1|chr12:8166498-8166534,chr12,8166498,8166534,0,95169750
H1|chr12:103454730-103454827,chr12,103454730,103454827,H1|chr12:5351549-5351587,chr12,5351549,5351587,0,98103181
H1|chr12:103466335-103466477,chr12,103466335,103466477,H1|chr12:5349668-5349818,chr12,5349668,5349818,0,98116667
H1|chr12:103618985-103619064,chr12,103618985,103619064,H1|chr12:19594575-19594640,chr12,19594575,19594640,0,84024410
H1|chr12:104207510-104207543,chr12,104207510,104207543,H1|chr12:5353118-5353182,chr12,5353118,5353182,0,98854392
H1|chr12:104763124-104763220,chr12,104763124,104763220,H1|chr12:8164571-8164632,chr12,8164571,8164632,0,96598553
H1|chr12:104830582-104830668,chr12,104830582,104830668,H1|chr12:6718560-6718590,chr12,6718560,6718590,0,98112022
H1|chr12:105011508-105011589,chr12,105011508,105011589,H1|chr12:52211217-52211276,chr12,52211217,52211276,0,52800291
H1|chr12:105011711-105011823,chr12,105011711,105011823,H1|chr12:50560277-50560341,chr12,50560277,50560341,0,54451434
H1|chr12:105346834-105346879,chr12,105346834,105346879,H1|chr12:57116194-57116299,chr12,57116194,57116299,0,48230640
H1|chr12:105594583-105594614,chr12,105594583,105594614,H1|chr12:7034250-7034344,chr12,7034250,7034344,0,98560333
H1|chr12:106724969-106725059,chr12,106724969,106725059,H1|chr12:64799114-64799197,chr12,64799114,64799197,0,41925855
H1|chr12:106770643-106770750,chr12,106770643,106770750,H1|chr12:9062511-9062545,chr12,9062511,9062545,0,97708132
H1|chr12:107455901-107455965,chr12,107455901,107455965,H1|chr12:32114376-32114396,chr12,32114376,32114396,0,75341525
H1|chr12:107962057-107962153,chr12,107962057,107962153,H1|chr12:8046182-8046247,chr12,8046182,8046247,0,99915875
H1|chr12:108062259-108062361,chr12,108062259,108062361,H1|chr12:6718531-6718558,chr12,6718531,6718558,0,101343728
H1|chr12:108101681-108101779,chr12,108101681,108101779,H1|chr12:9062131-9062281,chr12,9062131,9062281,0,99039550
H1|chr12:108241347-108241368,chr12,108241347,108241368,H1|chr12:6719813-6719942,chr12,6719813,6719942,0,101521534
H1|chr12:109030563-109030608,chr12,109030563,109030608,H1|chr12:95947006-95947100,chr12,95947006,95947100,0,13083557
H1|chr12:109105693-109105789,chr12,109105693,109105789,H1|chr12:8164571-8164632,chr12,8164571,8164632,0,100941122
H1|chr12:109498163-109498221,chr12,109498163,109498221,H1|chr12:5351238-5351330,chr12,5351238,5351330,0,104146925
H1|chr12:109782058-109782112,chr12,109782058,109782112,H1|chr12:5351238-5351334,chr12,5351238,5351334,0,104430820
H1|chr12:110631283-110631377,chr12,110631283,110631377,H1|chr12:46660819-46660865,chr12,46660819,46660865,0,63970464
H1|chr12:110898339-110898376,chr12,110898339,110898376,H1|chr12:8046167-8046256,chr12,8046167,8046256,0,102852172
H1|chr12:110962336-110962397,chr12,110962336,110962397,H1|chr12:7941318-7941397,chr12,7941318,7941397,0,103021018
H1|chr12:111495563-111495691,chr12,111495563,111495691,H1|chr12:9061575-9061597,chr12,9061575,9061597,0,102433988
H1|chr12:111585555-111585626,chr12,111585555,111585626,H1|chr12:85304710-85304773,chr12,85304710,85304773,0,26280845
H1|chr12:111833478-111833549,chr12,111833478,111833549,H1|chr12:85304710-85304773,chr12,85304710,85304773,0,26528768
H1|chr12:111922881-111923007,chr12,111922881,111923007,H1|chr12:56402365-56402386,chr12,56402365,56402386,0,55520516
H1|chr12:112778211-112778291,chr12,112778211,112778291,H1|chr12:76430192-76430262,chr12,76430192,76430262,0,36348019
H1|chr12:113466734-113466833,chr12,113466734,113466833,H1|chr12:57115524-57115588,chr12,57115524,57115588,0,56351210
H1|chr12:113667810-113667869,chr12,113667810,113667869,H1|chr12:57635805-57635857,chr12,57635805,57635857,0,56032005
H1|chr12:115694825-115694939,chr12,115694825,115694939,H1|chr12:8166498-8166534,chr12,8166498,8166534,0,107528327
H1|chr12:116936411-116936434,chr12,116936411,116936434,H1|chr12:57499727-57499764,chr12,57499727,57499764,0,59436684
H1|chr12:117141073-117141120,chr12,117141073,117141120,H1|chr12:31476525-31476628,chr12,31476525,31476628,0,85664548
H1|chr12:118769179-118769201,chr12,118769179,118769201,H1|chr12:95946602-95946749,chr12,95946602,95946749,0,22822577
H1|chr12:118857713-118857768,chr12,118857713,118857768,H1|chr12:120633280-120633340,chr12,120633280,120633340,0,1775567
H1|chr12:120272931-120273030,chr12,120272931,120273030,H1|chr12:120556632-120556683,chr12,120556632,120556683,0,283701
H1|chr12:121290872-121290913,chr12,121290872,121290913,H1|chr12:4383726-4383800,chr12,4383726,4383800,0,116907146
H1|chr12:121727337-121727419,chr12,121727337,121727419,H1|chr12:95947041-95947136,chr12,95947041,95947136,0,25780296
H1|chr12:121860095-121860180,chr12,121860095,121860180,H1|chr12:8046182-8046247,chr12,8046182,8046247,0,113813913
H1|chr12:122339428-122339469,chr12,122339428,122339469,H1|chr12:7943550-7943670,chr12,7943550,7943670,0,114395878
H1|chr12:122711032-122711138,chr12,122711032,122711138,H1|chr12:9062511-9062545,chr12,9062511,9062545,0,113648521
H1|chr12:123071333-123071415,chr12,123071333,123071415,H1|chr12:50560277-50560341,chr12,50560277,50560341,0,72511056
H1|chr12:123504069-123504152,chr12,123504069,123504152,H1|chr12:9061632-9061699,chr12,9061632,9061699,0,114442437
H1|chr12:124692891-124692967,chr12,124692891,124692967,H1|chr12:70761292-70761344,chr12,70761292,70761344,0,53931599
H1|chr12:124909760-124909846,chr12,124909760,124909846,H1|chr12:5352588-5352619,chr12,5352588,5352619,0,119557172
H1|chr12:125809875-125809993,chr12,125809875,125809993,H1|chr12:5352422-5352454,chr12,5352422,5352454,0,120457453
H1|chr12:125878627-125878650,chr12,125878627,125878650,H1|chr12:8398948-8398994,chr12,8398948,8398994,0,117479679
H1|chr12:126200318-126200399,chr12,126200318,126200399,H1|chr12:52211217-52211276,chr12,52211217,52211276,0,73989101
H1|chr12:126697951-126697986,chr12,126697951,126697986,H1|chr12:6716822-6716871,chr12,6716822,6716871,0,119981129
H1|chr12:126950821-126950933,chr12,126950821,126950933,H1|chr12:5350995-5351078,chr12,5350995,5351078,0,121599826
H1|chr12:127513386-127513447,chr12,127513386,127513447,H1|chr12:120962230-120962318,chr12,120962230,120962318,0,6551156
H1|chr12:127630035-127630082,chr12,127630035,127630082,H1|chr12:95946141-95946195,chr12,95946141,95946195,0,31683894
H1|chr12:127949196-127949276,chr12,127949196,127949276,H1|chr12:52211217-52211276,chr12,52211217,52211276,0,75737979
H1|chr12:128445933-128446028,chr12,128445933,128446028,H1|chr12:129311681-129311725,chr12,129311681,129311725,0,865748
H1|chr12:128770138-128770264,chr12,128770138,128770264,H1|chr12:56402365-56402386,chr12,56402365,56402386,0,72367773
H1|chr12:129375906-129376020,chr12,129375906,129376020,H1|chr12:56140101-56140148,chr12,56140101,56140148,0,73235805
H1|chr12:129817488-129817553,chr12,129817488,129817553,H1|chr12:7941318-7941397,chr12,7941318,7941397,0,121876170
H1|chr12:129897744-129897887,chr12,129897744,129897887,H1|chr12:57116194-57116299,chr12,57116194,57116299,0,72781550
H1|chr12:130683713-130683797,chr12,130683713,130683797,H1|chr12:98990541-98990566,chr12,98990541,98990566,0,31693172
H1|chr12:130800883-130800963,chr12,130800883,130800963,H1|chr12:52211217-52211276,chr12,52211217,52211276,0,78589666
H1|chr12:130979721-130979820,chr12,130979721,130979820,H1|chr12:79939566-79939592,chr12,79939566,79939592,0,51040155
H1|chr12:131079771-131079823,chr12,131079771,131079823,H1|chr12:49582042-49582093,chr12,49582042,49582093,0,81497729
H1|chr12:131309224-131309253,chr12,131309224,131309253,H1|chr12:8046182-8046256,chr12,8046182,8046256,0,123263042
H1|chr12:131876297-131876367,chr12,131876297,131876367,H1|chr12:85304710-85304773,chr12,85304710,85304773,0,46571587
H1|chr12:132274084-132274183,chr12,132274084,132274183,H1|chr12:79939566-79939592,chr12,79939566,79939592,0,52334518
H1|chr12:132351602-132351640,chr12,132351602,132351640,H1|chr12:8398948-8398994,chr12,8398948,8398994,0,123952654
H1|chr12:133337625-133337732,chr12,133337625,133337732,H1|chr12:9062511-9062545,chr12,9062511,9062545,0,124275114
H1|chr12:133431235-133431373,chr12,133431235,133431373,H1|chr12:31475882-31475980,chr12,31475882,31475980,0,101955353
H1|chr12:133501267-133501326,chr12,133501267,133501326,H1|chr12:5352773-5352831,chr12,5352773,5352831,0,128148494
H1|chr12:133774963-133775004,chr12,133774963,133775004,H1|chr12:9061842-9061941,chr12,9061842,9061941,0,124713121
H1|chr13:3897981-3898034,chr13,3897981,3898034,H1|chr13:51799022-51799069,chr13,51799022,51799069,0,47901041
H1|chr13:5034398-5034435,chr13,5034398,5034435,H1|chr13:98631356-98631422,chr13,98631356,98631422,0,93596958
H1|chr13:5314954-5315085,chr13,5314954,5315085,H1|chr13:51751012-51751037,chr13,51751012,51751037,0,46436058
H1|chr13:7136162-7136310,chr13,7136162,7136310,H1|chr13:25876130-25876206,chr13,25876130,25876206,0,18739968
H1|chr13:7366075-7366146,chr13,7366075,7366146,H1|chr13:114995537-114995616,chr13,114995537,114995616,0,107629462
H1|chr13:7887279-7887337,chr13,7887279,7887337,H1|chr13:51798990-51799044,chr13,51798990,51799044,0,43911711
H1|chr13:9883376-9883440,chr13,9883376,9883440,H1|chr13:51750896-51750976,chr13,51750896,51750976,0,41867520
H1|chr13:10117504-10117653,chr13,10117504,10117653,H1|chr13:25878247-25878343,chr13,25878247,25878343,0,15760743
H1|chr13:13007889-13007995,chr13,13007889,13007995,H1|chr13:42534123-42534167,chr13,42534123,42534167,0,29526234
H1|chr13:14663927-14664034,chr13,14663927,14664034,H1|chr13:95360427-95360460,chr13,95360427,95360460,0,80696500
H1|chr13:15240900-15241025,chr13,15240900,15241025,H1|chr13:51751012-51751037,chr13,51751012,51751037,0,36510112
H1|chr13:15259673-15259705,chr13,15259673,15259705,H1|chr13:28676462-28676574,chr13,28676462,28676574,0,13416789
H1|chr13:16978861-16978910,chr13,16978861,16978910,H1|chr13:41363344-41363436,chr13,41363344,41363436,0,24384483
H1|chr13:18127350-18127419,chr13,18127350,18127419,H1|chr13:52160060-52160114,chr13,52160060,52160114,0,34032710
H1|chr13:19932012-19932111,chr13,19932012,19932111,H1|chr13:107187632-107187664,chr13,107187632,107187664,0,87255620
H1|chr13:21815853-21815911,chr13,21815853,21815911,H1|chr13:24007607-24007741,chr13,24007607,24007741,0,2191754
H1|chr13:22209136-22209218,chr13,22209136,22209218,H1|chr13:60740792-60740842,chr13,60740792,60740842,0,38531656
H1|chr13:24553236-24553278,chr13,24553236,24553278,H1|chr13:42620143-42620253,chr13,42620143,42620253,0,18066907
H1|chr13:25138496-25138646,chr13,25138496,25138646,H1|chr13:51751195-51751287,chr13,51751195,51751287,0,26612699
H1|chr13:25588983-25589025,chr13,25588983,25589025,H1|chr13:98631356-98631422,chr13,98631356,98631422,0,73042373
H1|chr13:27032194-27032289,chr13,27032194,27032289,H1|chr13:93878983-93879011,chr13,93878983,93879011,0,66846789
H1|chr13:27893266-27893373,chr13,27893266,27893373,H1|chr13:98630729-98630753,chr13,98630729,98630753,0,70737463
H1|chr13:28508912-28509037,chr13,28508912,28509037,H1|chr13:98630729-98630753,chr13,98630729,98630753,0,70121817
H1|chr13:28513884-28513926,chr13,28513884,28513926,H1|chr13:45916942-45917049,chr13,45916942,45917049,0,17403058
H1|chr13:33746813-33746907,chr13,33746813,33746907,H1|chr13:37579032-37579088,chr13,37579032,37579088,0,3832219
H1|chr13:34374769-34374811,chr13,34374769,34374811,H1|chr13:45916942-45917049,chr13,45916942,45917049,0,11542173
H1|chr13:35528710-35528744,chr13,35528710,35528744,H1|chr13:50514859-50514879,chr13,50514859,50514879,0,14986149
H1|chr13:35617248-35617307,chr13,35617248,35617307,H1|chr13:51750896-51750976,chr13,51750896,51750976,0,16133648
H1|chr13:35820062-35820143,chr13,35820062,35820143,H1|chr13:73355585-73355654,chr13,73355585,73355654,0,37535523
H1|chr13:35973844-35973883,chr13,35973844,35973883,H1|chr13:114995473-114995544,chr13,114995473,114995544,0,79021629
H1|chr13:36530949-36530985,chr13,36530949,36530985,H1|chr13:30168526-30168676,chr13,30168526,30168676,0,6362423
H1|chr13:38457590-38457648,chr13,38457590,38457648,H1|chr13:24007607-24007741,chr13,24007607,24007741,0,14449983
H1|chr13:39397945-39398045,chr13,39397945,39398045,H1|chr13:60740792-60740842,chr13,60740792,60740842,0,21342847
H1|chr13:39729861-39729883,chr13,39729861,39729883,H1|chr13:47127885-47127952,chr13,47127885,47127952,0,7398024
H1|chr13:40549715-40549782,chr13,40549715,40549782,H1|chr13:50515125-50515237,chr13,50515125,50515237,0,9965410
H1|chr13:40918151-40918198,chr13,40918151,40918198,H1|chr13:107187924-107187992,chr13,107187924,107187992,0,66269773
H1|chr13:41668025-41668119,chr13,41668025,41668119,H1|chr13:37579032-37579088,chr13,37579032,37579088,0,4088993
H1|chr13:43793792-43793870,chr13,43793792,43793870,H1|chr13:51797502-51797538,chr13,51797502,51797538,0,8003710
H1|chr13:44258145-44258178,chr13,44258145,44258178,H1|chr13:42620143-42620253,chr13,42620143,42620253,0,1638002
H1|chr13:46067443-46067544,chr13,46067443,46067544,H1|chr13:30168915-30168946,chr13,30168915,30168946,0,15898528
H1|chr13:46285046-46285152,chr13,46285046,46285152,H1|chr13:42534123-42534167,chr13,42534123,42534167,0,3750923
H1|chr13:47432523-47432630,chr13,47432523,47432630,H1|chr13:60740792-60740842,chr13,60740792,60740842,0,13308269
H1|chr13:47562627-47562776,chr13,47562627,47562776,H1|chr13:25878247-25878343,chr13,25878247,25878343,0,21684380
H1|chr13:49551160-49551273,chr13,49551160,49551273,H1|chr13:42619409-42619460,chr13,42619409,42619460,0,6931751
H1|chr13:49704094-49704216,chr13,49704094,49704216,H1|chr13:73355585-73355654,chr13,73355585,73355654,0,23651491
H1|chr13:52170691-52170738,chr13,52170691,52170738,H1|chr13:107187924-107187992,chr13,107187924,107187992,0,55017233
H1|chr13:52480270-52480420,chr13,52480270,52480420,H1|chr13:37579032-37579088,chr13,37579032,37579088,0,14901238
H1|chr13:52590885-52590925,chr13,52590885,52590925,H1|chr13:114995473-114995544,chr13,114995473,114995544,0,62404588
H1|chr13:53383596-53383673,chr13,53383596,53383673,H1|chr13:51797502-51797538,chr13,51797502,51797538,0,1586094
H1|chr13:53643213-53643245,chr13,53643213,53643245,H1|chr13:28676462-28676574,chr13,28676462,28676574,0,24966751
H1|chr13:54031912-54032006,chr13,54031912,54032006,H1|chr13:93878983-93879011,chr13,93878983,93879011,0,39847071
H1|chr13:54684008-54684047,chr13,54684008,54684047,H1|chr13:114995473-114995544,chr13,114995473,114995544,0,60311465
H1|chr13:56574570-56574599,chr13,56574570,56574599,H1|chr13:52159427-52159535,chr13,52159427,52159535,0,4415143
H1|chr13:57590925-57590958,chr13,57590925,57590958,H1|chr13:42620143-42620253,chr13,42620143,42620253,0,14970782
H1|chr13:58346802-58346909,chr13,58346802,58346909,H1|chr13:60740792-60740842,chr13,60740792,60740842,0,2393990
H1|chr13:61073872-61073949,chr13,61073872,61073949,H1|chr13:51797502-51797538,chr13,51797502,51797538,0,9276370
H1|chr13:61678115-61678192,chr13,61678115,61678192,H1|chr13:73355585-73355654,chr13,73355585,73355654,0,11677470
H1|chr13:62277998-62278042,chr13,62277998,62278042,H1|chr13:37579296-37579331,chr13,37579296,37579331,0,24698702
H1|chr13:63361832-63361910,chr13,63361832,63361910,H1|chr13:51797502-51797538,chr13,51797502,51797538,0,11564330
H1|chr13:64836163-64836218,chr13,64836163,64836218,H1|chr13:41363344-41363436,chr13,41363344,41363436,0,23472819
H1|chr13:65545751-65545858,chr13,65545751,65545858,H1|chr13:95360427-95360460,chr13,95360427,95360460,0,29814676
H1|chr13:67593092-67593200,chr13,67593092,67593200,H1|chr13:95360427-95360460,chr13,95360427,95360460,0,27767335
H1|chr13:69490237-69490362,chr13,69490237,69490362,H1|chr13:51751012-51751037,chr13,51751012,51751037,0,17739225
H1|chr13:69607790-69607824,chr13,69607790,69607824,H1|chr13:50514859-50514879,chr13,50514859,50514879,0,19092931
H1|chr13:69918410-69918487,chr13,69918410,69918487,H1|chr13:73355585-73355654,chr13,73355585,73355654,0,3437175
H1|chr13:70315749-70315899,chr13,70315749,70315899,H1|chr13:51751195-51751287,chr13,51751195,51751287,0,18564554
H1|chr13:71229676-71229718,chr13,71229676,71229718,H1|chr13:42620143-42620253,chr13,42620143,42620253,0,28609533
H1|chr13:71571169-71571207,chr13,71571169,71571207,H1|chr13:50515125-50515237,chr13,50515125,50515237,0,21056044
H1|chr13:72535281-72535375,chr13,72535281,72535375,H1|chr13:93878983-93879011,chr13,93878983,93879011,0,21343702
H1|chr13:74846038-74846160,chr13,74846038,74846160,H1|chr13:73355585-73355654,chr13,73355585,73355654,0,1490453
H1|chr13:78711506-78711631,chr13,78711506,78711631,H1|chr13:98630729-98630753,chr13,98630729,98630753,0,19919223
H1|chr13:78884657-78884710,chr13,78884657,78884710,H1|chr13:51799022-51799069,chr13,51799022,51799069,0,27085635
H1|chr13:81179336-81179378,chr13,81179336,81179378,H1|chr13:98631356-98631422,chr13,98631356,98631422,0,17452020
H1|chr13:81486617-81486731,chr13,81486617,81486731,H1|chr13:51751108-51751141,chr13,51751108,51751141,0,29735509
H1|chr13:83400777-83400813,chr13,83400777,83400813,H1|chr13:30168526-30168676,chr13,30168526,30168676,0,53232251
H1|chr13:84065032-84065054,chr13,84065032,84065054,H1|chr13:47127885-47127952,chr13,47127885,47127952,0,36937147
H1|chr13:84586111-84586212,chr13,84586111,84586212,H1|chr13:30168915-30168946,chr13,30168915,30168946,0,54417196
H1|chr13:84790973-84791031,chr13,84790973,84791031,H1|chr13:51798990-51799044,chr13,51798990,51799044,0,32991983
H1|chr13:85472218-85472349,chr13,85472218,85472349,H1|chr13:51751012-51751037,chr13,51751012,51751037,0,33721206
H1|chr13:85618793-85618867,chr13,85618793,85618867,H1|chr13:25876130-25876206,chr13,25876130,25876206,0,59742663
H1|chr13:85772280-85772375,chr13,85772280,85772375,H1|chr13:93878983-93879011,chr13,93878983,93879011,0,8106703
H1|chr13:86470576-86470700,chr13,86470576,86470700,H1|chr13:98630729-98630753,chr13,98630729,98630753,0,12160153
H1|chr13:89187172-89187320,chr13,89187172,89187320,H1|chr13:25876130-25876206,chr13,25876130,25876206,0,63311042
H1|chr13:89275933-89276000,chr13,89275933,89276000,H1|chr13:50515125-50515237,chr13,50515125,50515237,0,38760808
H1|chr13:89405149-89405218,chr13,89405149,89405218,H1|chr13:52160060-52160114,chr13,52160060,52160114,0,37245089
H1|chr13:89731660-89731704,chr13,89731660,89731704,H1|chr13:37579296-37579331,chr13,37579296,37579331,0,52152364
H1|chr13:90317133-90317240,chr13,90317133,90317240,H1|chr13:98630729-98630753,chr13,98630729,98630753,0,8313596
H1|chr13:90622246-90622286,chr13,90622246,90622286,H1|chr13:114995473-114995544,chr13,114995473,114995544,0,24373227
H1|chr13:92063478-92063591,chr13,92063478,92063591,H1|chr13:42619409-42619460,chr13,42619409,42619460,0,49444069
H1|chr13:94043474-94043598,chr13,94043474,94043598,H1|chr13:98630729-98630753,chr13,98630729,98630753,0,4587255
H1|chr13:94853667-94853741,chr13,94853667,94853741,H1|chr13:25876130-25876206,chr13,25876130,25876206,0,68977537
H1|chr13:96008581-96008662,chr13,96008581,96008662,H1|chr13:73355585-73355654,chr13,73355585,73355654,0,22652996
H1|chr13:96664626-96664664,chr13,96664626,96664664,H1|chr13:50515125-50515237,chr13,50515125,50515237,0,46149501
H1|chr13:96928982-96929031,chr13,96928982,96929031,H1|chr13:41363344-41363436,chr13,41363344,41363436,0,55565638
H1|chr13:97111809-97111838,chr13,97111809,97111838,H1|chr13:52159427-52159535,chr13,52159427,52159535,0,44952382
H1|chr13:97965494-97965594,chr13,97965494,97965594,H1|chr13:60740792-60740842,chr13,60740792,60740842,0,37224702
H1|chr13:101861728-101861787,chr13,101861728,101861787,H1|chr13:51750896-51750976,chr13,51750896,51750976,0,50110832
H1|chr13:103502885-103502949,chr13,103502885,103502949,H1|chr13:51750896-51750976,chr13,51750896,51750976,0,51751989
H1|chr13:104408603-104408702,chr13,104408603,104408702,H1|chr13:107187632-107187664,chr13,107187632,107187664,0,2779029
H1|chr13:108727760-108727868,chr13,108727760,108727868,H1|chr13:95360427-95360460,chr13,95360427,95360460,0,13367333
H1|chr13:109337161-109337232,chr13,109337161,109337232,H1|chr13:114995537-114995616,chr13,114995537,114995616,0,5658376
H1|chr13:110113340-110113395,chr13,110113340,110113395,H1|chr13:41363344-41363436,chr13,41363344,41363436,0,68749996
H1|chr13:110203165-110203247,chr13,110203165,110203247,H1|chr13:60740792-60740842,chr13,60740792,60740842,0,49462373
H1|chr13:110969114-110969151,chr13,110969114,110969151,H1|chr13:98631356-98631422,chr13,98631356,98631422,0,12337758
H1|chr13:113693160-113693274,chr13,113693160,113693274,H1|chr13:51751108-51751141,chr13,51751108,51751141,0,61942052
H1|chr13:114875876-114876026,chr13,114875876,114876026,H1|chr13:37579032-37579088,chr13,37579032,37579088,0,77296844
H1|chr14:221475-221621,chr14,221475,221621,H1|chr14:38674454-38674497,chr14,38674454,38674497,0,38452979
H1|chr14:223778-223900,chr14,223778,223900,H1|chr14:38672238-38672263,chr14,38672238,38672263,0,38448460
H1|chr14:424252-424281,chr14,424252,424281,H1|chr14:38672239-38672313,chr14,38672239,38672313,0,38247987
H1|chr14:658297-658392,chr14,658297,658392,H1|chr14:38672434-38672469,chr14,38672434,38672469,0,38014137
H1|chr14:746319-746386,chr14,746319,746386,H1|chr14:99737890-99737988,chr14,99737890,99737988,0,98991571
H1|chr14:893988-894023,chr14,893988,894023,H1|chr14:105329446-105329541,chr14,105329446,105329541,0,104435458
H1|chr14:939468-939500,chr14,939468,939500,H1|chr14:38675199-38675307,chr14,38675199,38675307,0,37735731
H1|chr14:1038267-1038379,chr14,1038267,1038379,H1|chr14:100068853-100068905,chr14,100068853,100068905,0,99030586
H1|chr14:1204038-1204107,chr14,1204038,1204107,H1|chr14:38673102-38673220,chr14,38673102,38673220,0,37469064
H1|chr14:1439946-1440051,chr14,1439946,1440051,H1|chr14:35342722-35342767,chr14,35342722,35342767,0,33902776
H1|chr14:1551349-1551466,chr14,1551349,1551466,H1|chr14:105329104-105329253,chr14,105329104,105329253,0,103777755
H1|chr14:1770167-1770317,chr14,1770167,1770317,H1|chr14:38675116-38675147,chr14,38675116,38675147,0,36904949
H1|chr14:1879926-1880000,chr14,1879926,1880000,H1|chr14:105301079-105301127,chr14,105301079,105301127,0,103421153
H1|chr14:1967410-1967454,chr14,1967410,1967454,H1|chr14:105307012-105307069,chr14,105307012,105307069,0,103339602
H1|chr14:2135384-2135419,chr14,2135384,2135419,H1|chr14:38676924-38676971,chr14,38676924,38676971,0,36541540
H1|chr14:2173261-2173341,chr14,2173261,2173341,H1|chr14:38674749-38674783,chr14,38674749,38674783,0,36501488
H1|chr14:2435898-2435915,chr14,2435898,2435915,H1|chr14:90424188-90424282,chr14,90424188,90424282,0,87988290
H1|chr14:3016756-3016791,chr14,3016756,3016791,H1|chr14:105329446-105329541,chr14,105329446,105329541,0,102312690
H1|chr14:3384962-3384996,chr14,3384962,3384996,H1|chr14:38675199-38675307,chr14,38675199,38675307,0,35290237
H1|chr14:3412731-3412783,chr14,3412731,3412783,H1|chr14:105327862-105327946,chr14,105327862,105327946,0,101915131
H1|chr14:3903484-3903553,chr14,3903484,3903553,H1|chr14:99737883-99737963,chr14,99737883,99737963,0,95834399
H1|chr14:4025754-4025825,chr14,4025754,4025825,H1|chr14:105326690-105326751,chr14,105326690,105326751,0,101300936
H1|chr14:4376017-4376069,chr14,4376017,4376069,H1|chr14:105327862-105327946,chr14,105327862,105327946,0,100951845
H1|chr14:4404171-4404231,chr14,4404171,4404231,H1|chr14:105329726-105329790,chr14,105329726,105329790,0,100925555
H1|chr14:4624783-4624901,chr14,4624783,4624901,H1|chr14:38674335-38674365,chr14,38674335,38674365,0,34049552
H1|chr14:4868518-4868594,chr14,4868518,4868594,H1|chr14:71788826-71788884,chr14,71788826,71788884,0,66920308
H1|chr14:5568409-5568497,chr14,5568409,5568497,H1|chr14:105326841-105326884,chr14,105326841,105326884,0,99758432
H1|chr14:6717712-6717760,chr14,6717712,6717760,H1|chr14:23450343-23450445,chr14,23450343,23450445,0,16732631
H1|chr14:6770459-6770501,chr14,6770459,6770501,H1|chr14:23450342-23450445,chr14,23450342,23450445,0,16679883
H1|chr14:6935999-6936110,chr14,6935999,6936110,H1|chr14:38673111-38673156,chr14,38673111,38673156,0,31737112
H1|chr14:7059439-7059575,chr14,7059439,7059575,H1|chr14:105307081-105307187,chr14,105307081,105307187,0,98247642
H1|chr14:7149291-7149347,chr14,7149291,7149347,H1|chr14:24042483-24042577,chr14,24042483,24042577,0,16893192
H1|chr14:7285313-7285340,chr14,7285313,7285340,H1|chr14:59934682-59934783,chr14,59934682,59934783,0,52649369
H1|chr14:7453111-7453232,chr14,7453111,7453232,H1|chr14:38673202-38673234,chr14,38673202,38673234,0,31220091
H1|chr14:7589012-7589113,chr14,7589012,7589113,H1|chr14:100703625-100703654,chr14,100703625,100703654,0,93114613
H1|chr14:7606729-7606830,chr14,7606729,7606830,H1|chr14:38673911-38673958,chr14,38673911,38673958,0,31067182
H1|chr14:7880679-7880714,chr14,7880679,7880714,H1|chr14:70825230-70825336,chr14,70825230,70825336,0,62944551
H1|chr14:8193784-8193900,chr14,8193784,8193900,H1|chr14:91723180-91723272,chr14,91723180,91723272,0,83529396
H1|chr14:8384123-8384191,chr14,8384123,8384191,H1|chr14:38676823-38676922,chr14,38676823,38676922,0,30292700
H1|chr14:8435690-8435796,chr14,8435690,8435796,H1|chr14:105330224-105330260,chr14,105330224,105330260,0,96894534
H1|chr14:8895736-8895800,chr14,8895736,8895800,H1|chr14:38673040-38673092,chr14,38673040,38673092,0,29777304
H1|chr14:9098519-9098562,chr14,9098519,9098562,H1|chr14:105327073-105327100,chr14,105327073,105327100,0,96228554
H1|chr14:9284165-9284227,chr14,9284165,9284227,H1|chr14:38674190-38674258,chr14,38674190,38674258,0,29390025
H1|chr14:10073937-10074012,chr14,10073937,10074012,H1|chr14:105331122-105331158,chr14,105331122,105331158,0,95257185
H1|chr14:10680033-10680104,chr14,10680033,10680104,H1|chr14:64108093-64108157,chr14,64108093,64108157,0,53428060
H1|chr14:10773832-10773914,chr14,10773832,10773914,H1|chr14:38674560-38674581,chr14,38674560,38674581,0,27900728
H1|chr14:10950024-10950108,chr14,10950024,10950108,H1|chr14:38677936-38677957,chr14,38677936,38677957,0,27727912
H1|chr14:11489505-11489587,chr14,11489505,11489587,H1|chr14:105327422-105327478,chr14,105327422,105327478,0,93837917
H1|chr14:11560864-11560976,chr14,11560864,11560976,H1|chr14:38673213-38673251,chr14,38673213,38673251,0,27112349
H1|chr14:11617763-11617885,chr14,11617763,11617885,H1|chr14:105329908-105329984,chr14,105329908,105329984,0,93712145
H1|chr14:11641163-11641229,chr14,11641163,11641229,H1|chr14:38673469-38673504,chr14,38673469,38673504,0,27032306
H1|chr14:11796410-11796452,chr14,11796410,11796452,H1|chr14:23450342-23450445,chr14,23450342,23450445,0,11653932
H1|chr14:11977870-11977950,chr14,11977870,11977950,H1|chr14:38674749-38674783,chr14,38674749,38674783,0,26696879
H1|chr14:12305926-12306005,chr14,12305926,12306005,H1|chr14:38677565-38677604,chr14,38677565,38677604,0,26371639
H1|chr14:12462257-12462328,chr14,12462257,12462328,H1|chr14:64108093-64108157,chr14,64108093,64108157,0,51645836
H1|chr14:12500496-12500517,chr14,12500496,12500517,H1|chr14:38672656-38672785,chr14,38672656,38672785,0,26172160
H1|chr14:13616861-13616896,chr14,13616861,13616896,H1|chr14:38675993-38676104,chr14,38675993,38676104,0,25059132
H1|chr14:13833556-13833588,chr14,13833556,13833588,H1|chr14:93579975-93580019,chr14,93579975,93580019,0,79746419
H1|chr14:14194577-14194672,chr14,14194577,14194672,H1|chr14:38672434-38672469,chr14,38672434,38672469,0,24477857
H1|chr14:14263173-14263285,chr14,14263173,14263285,H1|chr14:38673213-38673251,chr14,38673213,38673251,0,24410040
H1|chr14:14452978-14453061,chr14,14452978,14453061,H1|chr14:38673164-38673206,chr14,38673164,38673206,0,24220186
H1|chr14:14883674-14883782,chr14,14883674,14883782,H1|chr14:62230101-62230197,chr14,62230101,62230197,0,47346427
H1|chr14:15111275-15111357,chr14,15111275,15111357,H1|chr14:38674560-38674581,chr14,38674560,38674581,0,23563285
H1|chr14:15312063-15312164,chr14,15312063,15312164,H1|chr14:38673911-38673958,chr14,38673911,38673958,0,23361848
H1|chr14:15403344-15403366,chr14,15403344,15403366,H1|chr14:105328859-105328918,chr14,105328859,105328918,0,89925515
H1|chr14:15443356-15443467,chr14,15443356,15443467,H1|chr14:38673111-38673156,chr14,38673111,38673156,0,23229755
H1|chr14:15576023-15576113,chr14,15576023,15576113,H1|chr14:38673484-38673540,chr14,38673484,38673540,0,23097461
H1|chr14:15800505-15800603,chr14,15800505,15800603,H1|chr14:100068853-100068905,chr14,100068853,100068905,0,84268348
H1|chr14:15853133-15853173,chr14,15853133,15853173,H1|chr14:38675133-38675283,chr14,38675133,38675283,0,22822000
H1|chr14:15909550-15909609,chr14,15909550,15909609,H1|chr14:38674415-38674501,chr14,38674415,38674501,0,22764865
H1|chr14:16846388-16846428,chr14,16846388,16846428,H1|chr14:70825230-70825336,chr14,70825230,70825336,0,53978842
H1|chr14:17157970-17158087,chr14,17157970,17158087,H1|chr14:105329104-105329253,chr14,105329104,105329253,0,88171134
H1|chr14:17341645-17341708,chr14,17341645,17341708,H1|chr14:38674190-38674258,chr14,38674190,38674258,0,21332545
H1|chr14:17559595-17559640,chr14,17559595,17559640,H1|chr14:38674335-38674380,chr14,38674335,38674380,0,21114740
H1|chr14:17734417-17734491,chr14,17734417,17734491,H1|chr14:38672699-38672745,chr14,38672699,38672745,0,20938282
H1|chr14:18042073-18042135,chr14,18042073,18042135,H1|chr14:38674190-38674258,chr14,38674190,38674258,0,20632117
H1|chr14:18082811-18082916,chr14,18082811,18082916,H1|chr14:38674923-38674949,chr14,38674923,38674949,0,20592112
H1|chr14:18131941-18132077,chr14,18131941,18132077,H1|chr14:38674943-38675017,chr14,38674943,38675017,0,20543002
H1|chr14:18489536-18489643,chr14,18489536,18489643,H1|chr14:38674454-38674497,chr14,38674454,38674497,0,20184918
H1|chr14:19083838-19083908,chr14,19083838,19083908,H1|chr14:105329919-105329961,chr14,105329919,105329961,0,86246081
H1|chr14:19085026-19085174,chr14,19085026,19085174,H1|chr14:105327590-105327633,chr14,105327590,105327633,0,86242564
H1|chr14:19235546-19235696,chr14,19235546,19235696,H1|chr14:38675993-38676104,chr14,38675993,38676104,0,19440447
H1|chr14:19278079-19278184,chr14,19278079,19278184,H1|chr14:105326690-105326751,chr14,105326690,105326751,0,86048611
H1|chr14:19650412-19650462,chr14,19650412,19650462,H1|chr14:105329813-105329868,chr14,105329813,105329868,0,85679401
H1|chr14:19694979-19694995,chr14,19694979,19694995,H1|chr14:38672264-38672307,chr14,38672264,38672307,0,18977285
H1|chr14:19955796-19955880,chr14,19955796,19955880,H1|chr14:91975251-91975307,chr14,91975251,91975307,0,72019455
H1|chr14:20184259-20184278,chr14,20184259,20184278,H1|chr14:105329513-105329571,chr14,105329513,105329571,0,85145254
H1|chr14:20286947-20287062,chr14,20286947,20287062,H1|chr14:105328862-105328954,chr14,105328862,105328954,0,85041915
H1|chr14:20568606-20568686,chr14,20568606,20568686,H1|chr14:105330135-105330184,chr14,105330135,105330184,0,84761529
H1|chr14:20584131-20584156,chr14,20584131,20584156,H1|chr14:105326890-105326921,chr14,105326890,105326921,0,84742759
H1|chr14:20728373-20728393,chr14,20728373,20728393,H1|chr14:38672370-38672490,chr14,38672370,38672490,0,17943997
H1|chr14:20943816-20943876,chr14,20943816,20943876,H1|chr14:105329726-105329790,chr14,105329726,105329790,0,84385910
H1|chr14:21702056-21702091,chr14,21702056,21702091,H1|chr14:38676924-38676971,chr14,38676924,38676971,0,16974868
H1|chr14:21805894-21806024,chr14,21805894,21806024,H1|chr14:35342722-35342767,chr14,35342722,35342767,0,13536828
H1|chr14:22123794-22123867,chr14,22123794,22123867,H1|chr14:38672699-38672745,chr14,38672699,38672745,0,16548905
H1|chr14:22273727-22273762,chr14,22273727,22273762,H1|chr14:62232132-62232244,chr14,62232132,62232244,0,39958405
H1|chr14:22340095-22340124,chr14,22340095,22340124,H1|chr14:24044454-24044543,chr14,24044454,24044543,0,1704359
H1|chr14:22599965-22600088,chr14,22599965,22600088,H1|chr14:105330983-105331010,chr14,105330983,105331010,0,82731018
H1|chr14:22672762-22672902,chr14,22672762,22672902,H1|chr14:38673847-38673980,chr14,38673847,38673980,0,16001085
H1|chr14:22861336-22861416,chr14,22861336,22861416,H1|chr14:30396121-30396191,chr14,30396121,30396191,0,7534785
H1|chr14:22935062-22935116,chr14,22935062,22935116,H1|chr14:105327862-105327946,chr14,105327862,105327946,0,82392800
H1|chr14:23303703-23303752,chr14,23303703,23303752,H1|chr14:105328859-105328918,chr14,105328859,105328918,0,82025156
H1|chr14:23399540-23399613,chr14,23399540,23399613,H1|chr14:105331122-105331158,chr14,105331122,105331158,0,81931582
H1|chr14:23748944-23749019,chr14,23748944,23749019,H1|chr14:99737888-99737955,chr14,99737888,99737955,0,75988944
H1|chr14:24318343-24318493,chr14,24318343,24318493,H1|chr14:105328680-105328723,chr14,105328680,105328723,0,81010337
H1|chr14:24514746-24514854,chr14,24514746,24514854,H1|chr14:105300200-105300229,chr14,105300200,105300229,0,80785454
H1|chr14:24771390-24771540,chr14,24771390,24771540,H1|chr14:99737959-99738099,chr14,99737959,99738099,0,74966569
H1|chr14:24778266-24778355,chr14,24778266,24778355,H1|chr14:105329211-105329288,chr14,105329211,105329288,0,80550945
H1|chr14:26938208-26938284,chr14,26938208,26938284,H1|chr14:38673915-38673986,chr14,38673915,38673986,0,11735707
H1|chr14:27225303-27225355,chr14,27225303,27225355,H1|chr14:99737890-99737988,chr14,99737890,99737988,0,72512587
H1|chr14:27389101-27389136,chr14,27389101,27389136,H1|chr14:62232132-62232244,chr14,62232132,62232244,0,34843031
H1|chr14:27402872-27403008,chr14,27402872,27403008,H1|chr14:105307081-105307187,chr14,105307081,105307187,0,77904209
H1|chr14:27731074-27731160,chr14,27731074,27731160,H1|chr14:105329886-105329929,chr14,105329886,105329929,0,77598812
H1|chr14:28354716-28354838,chr14,28354716,28354838,H1|chr14:38676995-38677023,chr14,38676995,38677023,0,10322279
H1|chr14:28609354-28609488,chr14,28609354,28609488,H1|chr14:105330983-105331010,chr14,105330983,105331010,0,76721629
H1|chr14:28717928-28718001,chr14,28717928,28718001,H1|chr14:59933974-59934026,chr14,59933974,59934026,0,31216046
H1|chr14:28806626-28806742,chr14,28806626,28806742,H1|chr14:38674335-38674365,chr14,38674335,38674365,0,9867709
H1|chr14:29028101-29028169,chr14,29028101,29028169,H1|chr14:38673102-38673220,chr14,38673102,38673220,0,9645001
H1|chr14:29072088-29072174,chr14,29072088,29072174,H1|chr14:38674560-38674577,chr14,38674560,38674577,0,9602472
H1|chr14:29365454-29365494,chr14,29365454,29365494,H1|chr14:38675133-38675283,chr14,38675133,38675283,0,9309679
H1|chr14:29730673-29730751,chr14,29730673,29730751,H1|chr14:21734857-21734921,chr14,21734857,21734921,0,7995816
H1|chr14:29775400-29775442,chr14,29775400,29775442,H1|chr14:38674759-38674839,chr14,38674759,38674839,0,8899359
H1|chr14:30100874-30100974,chr14,30100874,30100974,H1|chr14:105328916-105328966,chr14,105328916,105328966,0,75228042
H1|chr14:30162215-30162241,chr14,30162215,30162241,H1|chr14:59934682-59934783,chr14,59934682,59934783,0,29772467
H1|chr14:30503123-30503224,chr14,30503123,30503224,H1|chr14:38674533-38674564,chr14,38674533,38674564,0,8171410
H1|chr14:30682353-30682462,chr14,30682353,30682462,H1|chr14:99735926-99735957,chr14,99735926,99735957,0,69053573
H1|chr14:31176456-31176477,chr14,31176456,31176477,H1|chr14:38672656-38672785,chr14,38672656,38672785,0,7496200
H1|chr14:31718902-31718973,chr14,31718902,31718973,H1|chr14:23449763-23449909,chr14,23449763,23449909,0,8269139
H1|chr14:32171341-32171414,chr14,32171341,32171414,H1|chr14:59933974-59934026,chr14,59933974,59934026,0,27762633
H1|chr14:32370218-32370278,chr14,32370218,32370278,H1|chr14:38674527-38674614,chr14,38674527,38674614,0,6304309
H1|chr14:32493463-32493532,chr14,32493463,32493532,H1|chr14:99737883-99737963,chr14,99737883,99737963,0,67244420
H1|chr14:32523311-32523368,chr14,32523311,32523368,H1|chr14:103060748-103060803,chr14,103060748,103060803,0,70537437
H1|chr14:32775430-32775508,chr14,32775430,32775508,H1|chr14:21734857-21734921,chr14,21734857,21734921,0,11040573
H1|chr14:33244638-33244711,chr14,33244638,33244711,H1|chr14:105326637-105326681,chr14,105326637,105326681,0,72081999
H1|chr14:33572657-33572738,chr14,33572657,33572738,H1|chr14:91975151-91975220,chr14,91975151,91975220,0,58402494
H1|chr14:33997873-33997899,chr14,33997873,33997899,H1|chr14:105329615-105329661,chr14,105329615,105329661,0,71331742
H1|chr14:34044812-34044892,chr14,34044812,34044892,H1|chr14:105330135-105330184,chr14,105330135,105330184,0,71285323
H1|chr14:34141300-34141345,chr14,34141300,34141345,H1|chr14:105329229-105329315,chr14,105329229,105329315,0,71187929
H1|chr14:34158249-34158315,chr14,34158249,34158315,H1|chr14:38674533-38674642,chr14,38674533,38674642,0,4516284
H1|chr14:35557772-35557873,chr14,35557772,35557873,H1|chr14:38674759-38674839,chr14,38674759,38674839,0,3116987
H1|chr14:35943201-35943288,chr14,35943201,35943288,H1|chr14:105326690-105326751,chr14,105326690,105326751,0,69383489
H1|chr14:36054853-36054993,chr14,36054853,36054993,H1|chr14:38673847-38673980,chr14,38673847,38673980,0,2618994
H1|chr14:36668181-36668282,chr14,36668181,36668282,H1|chr14:38674533-38674564,chr14,38674533,38674564,0,2006352
H1|chr14:36705600-36705750,chr14,36705600,36705750,H1|chr14:38675116-38675147,chr14,38675116,38675147,0,1969516
H1|chr14:36995300-36995405,chr14,36995300,36995405,H1|chr14:74356674-74356795,chr14,74356674,74356795,0,37361374
H1|chr14:37319686-37319800,chr14,37319686,37319800,H1|chr14:105306174-105306309,chr14,105306174,105306309,0,67986488
H1|chr14:38128751-38128768,chr14,38128751,38128768,H1|chr14:90424188-90424282,chr14,90424188,90424282,0,52295437
H1|chr14:38241402-38241550,chr14,38241402,38241550,H1|chr14:105327590-105327633,chr14,105327590,105327633,0,67086188
H1|chr14:38318925-38318960,chr14,38318925,38318960,H1|chr14:38675993-38676104,chr14,38675993,38676104,0,357068
H1|chr14:38767470-38767578,chr14,38767470,38767578,H1|chr14:38676289-38676331,chr14,38676289,38676331,0,91181
H1|chr14:38772817-38772897,chr14,38772817,38772897,H1|chr14:30396121-30396191,chr14,30396121,30396191,0,8376696
H1|chr14:39723454-39723513,chr14,39723454,39723513,H1|chr14:105330492-105330573,chr14,105330492,105330573,0,65607038
H1|chr14:39743304-39743454,chr14,39743304,39743454,H1|chr14:105328680-105328723,chr14,105328680,105328723,0,65585376
H1|chr14:39816795-39816903,chr14,39816795,39816903,H1|chr14:62230101-62230197,chr14,62230101,62230197,0,22413306
H1|chr14:39915268-39915318,chr14,39915268,39915318,H1|chr14:105329813-105329868,chr14,105329813,105329868,0,65414545
H1|chr14:39936953-39937002,chr14,39936953,39937002,H1|chr14:23450343-23450445,chr14,23450343,23450445,0,16486610
H1|chr14:40008677-40008769,chr14,40008677,40008769,H1|chr14:105329361-105329419,chr14,105329361,105329419,0,65320684
H1|chr14:40307728-40307802,chr14,40307728,40307802,H1|chr14:105329908-105329984,chr14,105329908,105329984,0,65022180
H1|chr14:40336934-40336994,chr14,40336934,40336994,H1|chr14:38675981-38676067,chr14,38675981,38676067,0,1660953
H1|chr14:40767172-40767193,chr14,40767172,40767193,H1|chr14:105328859-105328918,chr14,105328859,105328918,0,64561687
H1|chr14:40951234-40951266,chr14,40951234,40951266,H1|chr14:93579975-93580019,chr14,93579975,93580019,0,52628741
H1|chr14:41152915-41153037,chr14,41152915,41153037,H1|chr14:38676995-38677023,chr14,38676995,38677023,0,2475920
H1|chr14:41286203-41286245,chr14,41286203,41286245,H1|chr14:38674759-38674839,chr14,38674759,38674839,0,2611444
H1|chr14:41409287-41409309,chr14,41409287,41409309,H1|chr14:105328859-105328918,chr14,105328859,105328918,0,63919572
H1|chr14:41455253-41455384,chr14,41455253,41455384,H1|chr14:38676995-38677023,chr14,38676995,38677023,0,2778258
H1|chr14:41566748-41566854,chr14,41566748,41566854,H1|chr14:99735926-99735957,chr14,99735926,99735957,0,58169178
H1|chr14:42124505-42124605,chr14,42124505,42124605,H1|chr14:105328916-105328966,chr14,105328916,105328966,0,63204411
H1|chr14:42356953-42357012,chr14,42356953,42357012,H1|chr14:38674415-38674501,chr14,38674415,38674501,0,3682538
H1|chr14:42542373-42542463,chr14,42542373,42542463,H1|chr14:38673484-38673540,chr14,38673484,38673540,0,3868889
H1|chr14:42827072-42827148,chr14,42827072,42827148,H1|chr14:38673183-38673211,chr14,38673183,38673211,0,4153889
H1|chr14:43337025-43337099,chr14,43337025,43337099,H1|chr14:105329908-105329984,chr14,105329908,105329984,0,61992883
H1|chr14:44119321-44119407,chr14,44119321,44119407,H1|chr14:105329886-105329929,chr14,105329886,105329929,0,61210565
H1|chr14:44440299-44440365,chr14,44440299,44440365,H1|chr14:99737883-99737963,chr14,99737883,99737963,0,55297584
H1|chr14:44449394-44449429,chr14,44449394,44449429,H1|chr14:70825230-70825336,chr14,70825230,70825336,0,26375836
H1|chr14:44775718-44775807,chr14,44775718,44775807,H1|chr14:105329211-105329288,chr14,105329211,105329288,0,60553493
H1|chr14:44869287-44869371,chr14,44869287,44869371,H1|chr14:91975251-91975307,chr14,91975251,91975307,0,47105964
H1|chr14:45195714-45195789,chr14,45195714,45195789,H1|chr14:99737882-99737963,chr14,99737882,99737963,0,54542168
H1|chr14:45386797-45386831,chr14,45386797,45386831,H1|chr14:65011983-65012112,chr14,65011983,65012112,0,19625186
H1|chr14:45506657-45506714,chr14,45506657,45506714,H1|chr14:105330754-105330889,chr14,105330754,105330889,0,59824097
H1|chr14:45715206-45715304,chr14,45715206,45715304,H1|chr14:105328916-105328966,chr14,105328916,105328966,0,59613710
H1|chr14:45968677-45968722,chr14,45968677,45968722,H1|chr14:105329229-105329315,chr14,105329229,105329315,0,59360552
H1|chr14:45999247-45999290,chr14,45999247,45999290,H1|chr14:105327073-105327100,chr14,105327073,105327100,0,59327826
H1|chr14:46241479-46241600,chr14,46241479,46241600,H1|chr14:105329361-105329419,chr14,105329361,105329419,0,59087882
H1|chr14:46555295-46555354,chr14,46555295,46555354,H1|chr14:38675127-38675205,chr14,38675127,38675205,0,7880168
H1|chr14:46957635-46957693,chr14,46957635,46957693,H1|chr14:91975320-91975399,chr14,91975320,91975399,0,45017685
H1|chr14:47016597-47016623,chr14,47016597,47016623,H1|chr14:105329615-105329661,chr14,105329615,105329661,0,58313018
H1|chr14:47108491-47108596,chr14,47108491,47108596,H1|chr14:38673111-38673156,chr14,38673111,38673156,0,8435380
H1|chr14:47279898-47280004,chr14,47279898,47280004,H1|chr14:99735926-99735957,chr14,99735926,99735957,0,52456028
H1|chr14:47632812-47632853,chr14,47632812,47632853,H1|chr14:38673960-38674096,chr14,38673960,38674096,0,8958852
H1|chr14:47912297-47912418,chr14,47912297,47912418,H1|chr14:105329361-105329419,chr14,105329361,105329419,0,57417064
H1|chr14:47956385-47956469,chr14,47956385,47956469,H1|chr14:38673163-38673206,chr14,38673163,38673206,0,9283222
H1|chr14:48515468-48515509,chr14,48515468,48515509,H1|chr14:38673960-38674096,chr14,38673960,38674096,0,9841508
H1|chr14:48732176-48732283,chr14,48732176,48732283,H1|chr14:105328680-105328723,chr14,105328680,105328723,0,56596504
H1|chr14:48739246-48739306,chr14,48739246,48739306,H1|chr14:38674527-38674614,chr14,38674527,38674614,0,10064719
H1|chr14:49107295-49107355,chr14,49107295,49107355,H1|chr14:105327070-105327126,chr14,105327070,105327126,0,56219775
H1|chr14:49514966-49514992,chr14,49514966,49514992,H1|chr14:59934682-59934783,chr14,59934682,59934783,0,10419716
H1|chr14:49740619-49740734,chr14,49740619,49740734,H1|chr14:38675116-38675147,chr14,38675116,38675147,0,11065503
H1|chr14:49757590-49757648,chr14,49757590,49757648,H1|chr14:91723180-91723272,chr14,91723180,91723272,0,41965590
H1|chr14:49845317-49845352,chr14,49845317,49845352,H1|chr14:105329669-105329784,chr14,105329669,105329784,0,55484352
H1|chr14:50378588-50378656,chr14,50378588,50378656,H1|chr14:38676823-38676922,chr14,38676823,38676922,0,11701765
H1|chr14:51425821-51425878,chr14,51425821,51425878,H1|chr14:38676267-38676331,chr14,38676267,38676331,0,12749554
H1|chr14:51542288-51542403,chr14,51542288,51542403,H1|chr14:38675116-38675147,chr14,38675116,38675147,0,12867172
H1|chr14:51624621-51624727,chr14,51624621,51624727,H1|chr14:105330224-105330260,chr14,105330224,105330260,0,53705603
H1|chr14:52289910-52290031,chr14,52289910,52290031,H1|chr14:38673213-38673251,chr14,38673213,38673251,0,13616697
H1|chr14:52501731-52501790,chr14,52501731,52501790,H1|chr14:105306166-105306257,chr14,105306166,105306257,0,52804435
H1|chr14:52517553-52517639,chr14,52517553,52517639,H1|chr14:38674560-38674577,chr14,38674560,38674577,0,13842993
H1|chr14:52780159-52780187,chr14,52780159,52780187,H1|chr14:38673159-38673212,chr14,38673159,38673212,0,14107000
H1|chr14:52922644-52922749,chr14,52922644,52922749,H1|chr14:38673111-38673156,chr14,38673111,38673156,0,14249533
H1|chr14:53292459-53292505,chr14,53292459,53292505,H1|chr14:105307012-105307069,chr14,105307012,105307069,0,52014553
H1|chr14:53339185-53339261,chr14,53339185,53339261,H1|chr14:38673915-38673986,chr14,38673915,38673986,0,14665270
H1|chr14:53344843-53344951,chr14,53344843,53344951,H1|chr14:38676289-38676331,chr14,38676289,38676331,0,14668554
H1|chr14:53758361-53758482,chr14,53758361,53758482,H1|chr14:38673213-38673251,chr14,38673213,38673251,0,15085148
H1|chr14:53841975-53842080,chr14,53841975,53842080,H1|chr14:38674923-38674949,chr14,38674923,38674949,0,15167052
H1|chr14:54001616-54001679,chr14,54001616,54001679,H1|chr14:38674190-38674258,chr14,38674190,38674258,0,15327426
H1|chr14:54584069-54584190,chr14,54584069,54584190,H1|chr14:100703625-100703654,chr14,100703625,100703654,0,46119556
H1|chr14:55003554-55003666,chr14,55003554,55003666,H1|chr14:100068853-100068905,chr14,100068853,100068905,0,45065299
H1|chr14:55711073-55711146,chr14,55711073,55711146,H1|chr14:105329211-105329288,chr14,105329211,105329288,0,49618138
H1|chr14:55861483-55861592,chr14,55861483,55861592,H1|chr14:91975151-91975220,chr14,91975151,91975220,0,36113668
H1|chr14:55958663-55958743,chr14,55958663,55958743,H1|chr14:24016946-24016986,chr14,24016946,24016986,0,31941717
H1|chr14:56109481-56109553,chr14,56109481,56109553,H1|chr14:64108093-64108157,chr14,64108093,64108157,0,7998612
H1|chr14:56511807-56511865,chr14,56511807,56511865,H1|chr14:105328862-105328954,chr14,105328862,105328954,0,48817055
H1|chr14:56767778-56767906,chr14,56767778,56767906,H1|chr14:35342722-35342767,chr14,35342722,35342767,0,21425056
H1|chr14:56833302-56833370,chr14,56833302,56833370,H1|chr14:38673102-38673220,chr14,38673102,38673220,0,18160200
H1|chr14:56899750-56899851,chr14,56899750,56899851,H1|chr14:100703625-100703654,chr14,100703625,100703654,0,43803875
H1|chr14:57107832-57107962,chr14,57107832,57107962,H1|chr14:35342722-35342767,chr14,35342722,35342767,0,21765110
H1|chr14:57195753-57195839,chr14,57195753,57195839,H1|chr14:38672669-38672704,chr14,38672669,38672704,0,18523084
H1|chr14:57599910-57599993,chr14,57599910,57599993,H1|chr14:91975251-91975307,chr14,91975251,91975307,0,34375341
H1|chr14:57705869-57705926,chr14,57705869,57705926,H1|chr14:38676267-38676331,chr14,38676267,38676331,0,19029602
H1|chr14:57987430-57987576,chr14,57987430,57987576,H1|chr14:38674454-38674497,chr14,38674454,38674497,0,19312976
H1|chr14:58057919-58058037,chr14,58057919,58058037,H1|chr14:38673202-38673234,chr14,38673202,38673234,0,19384717
H1|chr14:58603469-58603585,chr14,58603469,58603585,H1|chr14:38675127-38675205,chr14,38675127,38675205,0,19928342
H1|chr14:58808480-58808513,chr14,58808480,58808513,H1|chr14:105326890-105326921,chr14,105326890,105326921,0,46518410
H1|chr14:59119094-59119163,chr14,59119094,59119163,H1|chr14:51709727-51709760,chr14,51709727,51709760,0,7409367
H1|chr14:59451941-59452014,chr14,59451941,59452014,H1|chr14:38674415-38674501,chr14,38674415,38674501,0,20777526
H1|chr14:59818405-59818467,chr14,59818405,59818467,H1|chr14:105330492-105330573,chr14,105330492,105330573,0,45512087
H1|chr14:59828710-59828770,chr14,59828710,59828770,H1|chr14:38675981-38676067,chr14,38675981,38676067,0,21152729
H1|chr14:59934998-59935107,chr14,59934998,59935107,H1|chr14:91975151-91975220,chr14,91975151,91975220,0,32040153
H1|chr14:60437623-60437676,chr14,60437623,60437676,H1|chr14:74356377-74356434,chr14,74356377,74356434,0,13918754
H1|chr14:60466165-60466250,chr14,60466165,60466250,H1|chr14:38672656-38672785,chr14,38672656,38672785,0,21793509
H1|chr14:60553696-60553754,chr14,60553696,60553754,H1|chr14:91723180-91723272,chr14,91723180,91723272,0,31169484
H1|chr14:60881471-60881492,chr14,60881471,60881492,H1|chr14:105328859-105328918,chr14,105328859,105328918,0,44447388
H1|chr14:61107998-61108074,chr14,61107998,61108074,H1|chr14:38673966-38674038,chr14,38673966,38674038,0,22434032
H1|chr14:61496121-61496155,chr14,61496121,61496155,H1|chr14:38676948-38677036,chr14,38676948,38677036,0,22819173
H1|chr14:61520543-61520658,chr14,61520543,61520658,H1|chr14:105328862-105328954,chr14,105328862,105328954,0,43808319
H1|chr14:61819778-61819851,chr14,61819778,61819851,H1|chr14:38674415-38674501,chr14,38674415,38674501,0,23145363
H1|chr14:62404504-62404555,chr14,62404504,62404555,H1|chr14:38676823-38676922,chr14,38676823,38676922,0,23727681
H1|chr14:62414531-62414580,chr14,62414531,62414580,H1|chr14:105328859-105328918,chr14,105328859,105328918,0,42914328
H1|chr14:62708637-62708742,chr14,62708637,62708742,H1|chr14:105326690-105326751,chr14,105326690,105326751,0,42618053
H1|chr14:63212651-63212670,chr14,63212651,63212670,H1|chr14:105329513-105329571,chr14,105329513,105329571,0,42116862
H1|chr14:63583186-63583271,chr14,63583186,63583271,H1|chr14:38672656-38672785,chr14,38672656,38672785,0,24910530
H1|chr14:63684941-63685007,chr14,63684941,63685007,H1|chr14:56586549-56586632,chr14,56586549,56586632,0,7098392
H1|chr14:63803229-63803337,chr14,63803229,63803337,H1|chr14:105300200-105300229,chr14,105300200,105300229,0,41496971
H1|chr14:64109313-64109380,chr14,64109313,64109380,H1|chr14:99737890-99737988,chr14,99737890,99737988,0,35628577
H1|chr14:64259986-64260073,chr14,64259986,64260073,H1|chr14:105326690-105326751,chr14,105326690,105326751,0,41066704
H1|chr14:64398641-64398758,chr14,64398641,64398758,H1|chr14:91723180-91723272,chr14,91723180,91723272,0,27324539
H1|chr14:64655410-64655467,chr14,64655410,64655467,H1|chr14:103060748-103060803,chr14,103060748,103060803,0,38405338
H1|chr14:64749113-64749190,chr14,64749113,64749190,H1|chr14:21734857-21734921,chr14,21734857,21734921,0,43014256
H1|chr14:65376919-65376990,chr14,65376919,65376990,H1|chr14:23449763-23449909,chr14,23449763,23449909,0,41927156
H1|chr14:65406617-65406690,chr14,65406617,65406690,H1|chr14:105326637-105326681,chr14,105326637,105326681,0,39920020
H1|chr14:65674844-65674908,chr14,65674844,65674908,H1|chr14:105328859-105328917,chr14,105328859,105328917,0,39654015
H1|chr14:65733701-65733817,chr14,65733701,65733817,H1|chr14:38675127-38675205,chr14,38675127,38675205,0,27058574
H1|chr14:66519200-66519254,chr14,66519200,66519254,H1|chr14:62230101-62230197,chr14,62230101,62230197,0,4289099
H1|chr14:67269232-67269359,chr14,67269232,67269359,H1|chr14:99737890-99737979,chr14,99737890,99737979,0,32468658
H1|chr14:67385939-67386010,chr14,67385939,67386010,H1|chr14:105326690-105326751,chr14,105326690,105326751,0,37940751
H1|chr14:68348580-68348639,chr14,68348580,68348639,H1|chr14:105330492-105330573,chr14,105330492,105330573,0,36981912
H1|chr14:68474465-68474539,chr14,68474465,68474539,H1|chr14:38672699-38672745,chr14,38672699,38672745,0,29801766
H1|chr14:68679089-68679151,chr14,68679089,68679151,H1|chr14:38672294-38672318,chr14,38672294,38672318,0,30006795
H1|chr14:69486162-69486279,chr14,69486162,69486279,H1|chr14:91723180-91723272,chr14,91723180,91723272,0,22237018
H1|chr14:70163493-70163624,chr14,70163493,70163624,H1|chr14:38676995-38677023,chr14,38676995,38677023,0,31486498
H1|chr14:70195516-70195611,chr14,70195516,70195611,H1|chr14:20800335-20800370,chr14,20800335,20800370,0,49395181
H1|chr14:70514241-70514261,chr14,70514241,70514261,H1|chr14:38672370-38672490,chr14,38672370,38672490,0,31841871
H1|chr14:71386206-71386282,chr14,71386206,71386282,H1|chr14:71788826-71788884,chr14,71788826,71788884,0,402620
H1|chr14:71590465-71590527,chr14,71590465,71590527,H1|chr14:38672294-38672318,chr14,38672294,38672318,0,32918171
H1|chr14:71639505-71639591,chr14,71639505,71639591,H1|chr14:38672669-38672704,chr14,38672669,38672704,0,32966836
H1|chr14:71654325-71654377,chr14,71654325,71654377,H1|chr14:99737890-99737988,chr14,99737890,99737988,0,28083565
H1|chr14:71989992-71990067,chr14,71989992,71990067,H1|chr14:99737882-99737963,chr14,99737882,99737963,0,27747890
H1|chr14:72128976-72129097,chr14,72128976,72129097,H1|chr14:38673202-38673234,chr14,38673202,38673234,0,33455774
H1|chr14:72176154-72176259,chr14,72176154,72176259,H1|chr14:35342722-35342767,chr14,35342722,35342767,0,36833432
H1|chr14:72310528-72310646,chr14,72310528,72310646,H1|chr14:38673202-38673234,chr14,38673202,38673234,0,33637326
H1|chr14:72499234-72499316,chr14,72499234,72499316,H1|chr14:105327422-105327478,chr14,105327422,105327478,0,32828188
H1|chr14:72523105-72523158,chr14,72523105,72523158,H1|chr14:74356377-74356434,chr14,74356377,74356434,0,1833272
H1|chr14:72546975-72547041,chr14,72546975,72547041,H1|chr14:38674533-38674642,chr14,38674533,38674642,0,33872442
H1|chr14:73066619-73066659,chr14,73066619,73066659,H1|chr14:70825230-70825336,chr14,70825230,70825336,0,2241389
H1|chr14:73081267-73081328,chr14,73081267,73081328,H1|chr14:99737890-99737979,chr14,99737890,99737979,0,26656623
H1|chr14:73400415-73400536,chr14,73400415,73400536,H1|chr14:100703625-100703654,chr14,100703625,100703654,0,27303210
H1|chr14:73470203-73470353,chr14,73470203,73470353,H1|chr14:99737959-99738099,chr14,99737959,99738099,0,26267756
H1|chr14:74078000-74078028,chr14,74078000,74078028,H1|chr14:38673159-38673212,chr14,38673159,38673212,0,35404841
H1|chr14:74099000-74099098,chr14,74099000,74099098,H1|chr14:100068853-100068905,chr14,100068853,100068905,0,25969853
H1|chr14:74323447-74323527,chr14,74323447,74323527,H1|chr14:71788826-71788884,chr14,71788826,71788884,0,2534621
H1|chr14:74465506-74465563,chr14,74465506,74465563,H1|chr14:105330754-105330889,chr14,105330754,105330889,0,30865248
H1|chr14:74785716-74785852,chr14,74785716,74785852,H1|chr14:38674943-38675017,chr14,38674943,38675017,0,36110773
H1|chr14:75184606-75184669,chr14,75184606,75184669,H1|chr14:38675419-38675506,chr14,38675419,38675506,0,36509187
H1|chr14:75992128-75992162,chr14,75992128,75992162,H1|chr14:65011983-65012112,chr14,65011983,65012112,0,10980145
H1|chr14:76098456-76098540,chr14,76098456,76098540,H1|chr14:38673163-38673206,chr14,38673163,38673206,0,37425293
H1|chr14:76921437-76921513,chr14,76921437,76921513,H1|chr14:38674943-38675017,chr14,38674943,38675017,0,38246494
H1|chr14:77145215-77145299,chr14,77145215,77145299,H1|chr14:38672656-38672781,chr14,38672656,38672781,0,38472559
H1|chr14:77874375-77874473,chr14,77874375,77874473,H1|chr14:105328916-105328966,chr14,105328916,105328966,0,27454541
H1|chr14:78205189-78205241,chr14,78205189,78205241,H1|chr14:38673687-38673785,chr14,38673687,38673785,0,39531502
H1|chr14:78516801-78516890,chr14,78516801,78516890,H1|chr14:38676715-38676737,chr14,38676715,38676737,0,39840086
H1|chr14:78537106-78537155,chr14,78537106,78537155,H1|chr14:23450343-23450445,chr14,23450343,23450445,0,55086763
H1|chr14:78564720-78564842,chr14,78564720,78564842,H1|chr14:105329908-105329984,chr14,105329908,105329984,0,26765188
H1|chr14:78827393-78827477,chr14,78827393,78827477,H1|chr14:38677936-38677957,chr14,38677936,38677957,0,40149457
H1|chr14:80628361-80628430,chr14,80628361,80628430,H1|chr14:51709727-51709760,chr14,51709727,51709760,0,28918634
H1|chr14:80783383-80783412,chr14,80783383,80783412,H1|chr14:38673159-38673212,chr14,38673159,38673212,0,42110224
H1|chr14:80944243-80944361,chr14,80944243,80944361,H1|chr14:38674335-38674365,chr14,38674335,38674365,0,42269908
H1|chr14:81531111-81531156,chr14,81531111,81531156,H1|chr14:38674335-38674380,chr14,38674335,38674380,0,42856776
H1|chr14:81627757-81627839,chr14,81627757,81627839,H1|chr14:38677488-38677542,chr14,38677488,38677542,0,42950269
H1|chr14:82055303-82055376,chr14,82055303,82055376,H1|chr14:38672699-38672745,chr14,38672699,38672745,0,43382604
H1|chr14:82152917-82152992,chr14,82152917,82152992,H1|chr14:105331122-105331158,chr14,105331122,105331158,0,23178205
H1|chr14:82185040-82185100,chr14,82185040,82185100,H1|chr14:105327070-105327126,chr14,105327070,105327126,0,23142030
H1|chr14:82408348-82408422,chr14,82408348,82408422,H1|chr14:105327422-105327478,chr14,105327422,105327478,0,22919074
H1|chr14:82975270-82975420,chr14,82975270,82975420,H1|chr14:38675993-38676104,chr14,38675993,38676104,0,44299277
H1|chr14:83083948-83084028,chr14,83083948,83084028,H1|chr14:24016946-24016986,chr14,24016946,24016986,0,59067002
H1|chr14:83188212-83188293,chr14,83188212,83188293,H1|chr14:91975151-91975220,chr14,91975151,91975220,0,8786939
H1|chr14:83817317-83817446,chr14,83817317,83817446,H1|chr14:74356674-74356796,chr14,74356674,74356796,0,9460643
H1|chr14:84106736-84106809,chr14,84106736,84106809,H1|chr14:105331122-105331158,chr14,105331122,105331158,0,21224386
H1|chr14:84253464-84253537,chr14,84253464,84253537,H1|chr14:105329211-105329288,chr14,105329211,105329288,0,21075747
H1|chr14:84261484-84261536,chr14,84261484,84261536,H1|chr14:38673291-38673327,chr14,38673291,38673327,0,45588193
H1|chr14:84263487-84263571,chr14,84263487,84263571,H1|chr14:38672656-38672781,chr14,38672656,38672781,0,45590831
H1|chr14:84542838-84542886,chr14,84542838,84542886,H1|chr14:23450343-23450445,chr14,23450343,23450445,0,61092495
H1|chr14:85216555-85216618,chr14,85216555,85216618,H1|chr14:38675419-38675506,chr14,38675419,38675506,0,46541136
H1|chr14:85687072-85687152,chr14,85687072,85687152,H1|chr14:71788826-71788884,chr14,71788826,71788884,0,13898246
H1|chr14:86007925-86007957,chr14,86007925,86007957,H1|chr14:105329513-105329567,chr14,105329513,105329567,0,19321588
H1|chr14:86344398-86344464,chr14,86344398,86344464,H1|chr14:99737883-99737963,chr14,99737883,99737963,0,13393485
H1|chr14:86741123-86741171,chr14,86741123,86741171,H1|chr14:105330048-105330132,chr14,105330048,105330132,0,18588925
H1|chr14:87012145-87012215,chr14,87012145,87012215,H1|chr14:105329919-105329961,chr14,105329919,105329961,0,18317774
H1|chr14:87080894-87080973,chr14,87080894,87080973,H1|chr14:38677565-38677604,chr14,38677565,38677604,0,48403329
H1|chr14:87131781-87131813,chr14,87131781,87131813,H1|chr14:38675199-38675307,chr14,38675199,38675307,0,48456582
H1|chr14:87318243-87318297,chr14,87318243,87318297,H1|chr14:62230101-62230197,chr14,62230101,62230197,0,25088142
H1|chr14:87742496-87742568,chr14,87742496,87742568,H1|chr14:64108093-64108157,chr14,64108093,64108157,0,23634403
H1|chr14:87834609-87834692,chr14,87834609,87834692,H1|chr14:91975251-91975307,chr14,91975251,91975307,0,4140642
H1|chr14:88465243-88465295,chr14,88465243,88465295,H1|chr14:38673291-38673327,chr14,38673291,38673327,0,49791952
H1|chr14:88716984-88717058,chr14,88716984,88717058,H1|chr14:105301079-105301127,chr14,105301079,105301127,0,16584095
H1|chr14:89182332-89182446,chr14,89182332,89182446,H1|chr14:105306174-105306309,chr14,105306174,105306309,0,16123842
H1|chr14:89309586-89309722,chr14,89309586,89309722,H1|chr14:100703625-100703654,chr14,100703625,100703654,0,11394039
H1|chr14:89710726-89710770,chr14,89710726,89710770,H1|chr14:105307012-105307069,chr14,105307012,105307069,0,15596286
H1|chr14:90030965-90031039,chr14,90030965,90031039,H1|chr14:99737888-99737956,chr14,99737888,99737956,0,9706923
H1|chr14:90158470-90158504,chr14,90158470,90158504,H1|chr14:38675199-38675307,chr14,38675199,38675307,0,51483271
H1|chr14:90473452-90473516,chr14,90473452,90473516,H1|chr14:38673040-38673092,chr14,38673040,38673092,0,51800412
H1|chr14:90656582-90656677,chr14,90656582,90656677,H1|chr14:20800335-20800370,chr14,20800335,20800370,0,69856247
H1|chr14:90660035-90660127,chr14,90660035,90660127,H1|chr14:105329361-105329419,chr14,105329361,105329419,0,14669326
H1|chr14:90671543-90671673,chr14,90671543,90671673,H1|chr14:105331047-105331135,chr14,105331047,105331135,0,14659504
H1|chr14:90855949-90856015,chr14,90855949,90856015,H1|chr14:56586549-56586632,chr14,56586549,56586632,0,34269400
H1|chr14:91133320-91133366,chr14,91133320,91133366,H1|chr14:38672284-38672415,chr14,38672284,38672415,0,52461036
H1|chr14:91709810-91709856,chr14,91709810,91709856,H1|chr14:105307012-105307069,chr14,105307012,105307069,0,13597202
H1|chr14:92086945-92087067,chr14,92086945,92087067,H1|chr14:38672238-38672263,chr14,38672238,38672263,0,53414707
H1|chr14:92733831-92733931,chr14,92733831,92733931,H1|chr14:38673484-38673540,chr14,38673484,38673540,0,54060347
H1|chr14:94174758-94174793,chr14,94174758,94174793,H1|chr14:105329669-105329784,chr14,105329669,105329784,0,11154911
H1|chr14:94204450-94204514,chr14,94204450,94204514,H1|chr14:105328859-105328917,chr14,105328859,105328917,0,11124409
H1|chr14:94452893-94452994,chr14,94452893,94452994,H1|chr14:38674759-38674839,chr14,38674759,38674839,0,55778134
H1|chr14:94500720-94500820,chr14,94500720,94500820,H1|chr14:38673484-38673540,chr14,38673484,38673540,0,55827236
H1|chr14:94743735-94743810,chr14,94743735,94743810,H1|chr14:99737888-99737955,chr14,99737888,99737955,0,4994153
H1|chr14:94899483-94899610,chr14,94899483,94899610,H1|chr14:99737890-99737979,chr14,99737890,99737979,0,4838407
H1|chr14:94904373-94904442,chr14,94904373,94904442,H1|chr14:38673102-38673220,chr14,38673102,38673220,0,56231271
H1|chr14:94952850-94952959,chr14,94952850,94952959,H1|chr14:99735926-99735957,chr14,99735926,99735957,0,4783076
H1|chr14:95042455-95042503,chr14,95042455,95042503,H1|chr14:105330048-105330132,chr14,105330048,105330132,0,10287593
H1|chr14:95443432-95443490,chr14,95443432,95443490,H1|chr14:91975320-91975399,chr14,91975320,91975399,0,3468112
H1|chr14:95681523-95681615,chr14,95681523,95681615,H1|chr14:24042483-24042577,chr14,24042483,24042577,0,71639040
H1|chr14:95688709-95688786,chr14,95688709,95688786,H1|chr14:21734857-21734921,chr14,21734857,21734921,0,73953852
H1|chr14:96526744-96526769,chr14,96526744,96526769,H1|chr14:105326890-105326921,chr14,105326890,105326921,0,8800146
H1|chr14:96548704-96548770,chr14,96548704,96548770,H1|chr14:38673469-38673504,chr14,38673469,38673504,0,57875235
H1|chr14:96639858-96639934,chr14,96639858,96639934,H1|chr14:38673183-38673211,chr14,38673183,38673211,0,57966675
H1|chr14:96779576-96779635,chr14,96779576,96779635,H1|chr14:105306166-105306257,chr14,105306166,105306257,0,8526590
H1|chr14:96820077-96820111,chr14,96820077,96820111,H1|chr14:38676948-38677036,chr14,38676948,38677036,0,58143129
H1|chr14:96939821-96939850,chr14,96939821,96939850,H1|chr14:38672239-38672313,chr14,38672239,38672313,0,58267582
H1|chr14:97131278-97131352,chr14,97131278,97131352,H1|chr14:105327422-105327478,chr14,105327422,105327478,0,8196144
H1|chr14:97377550-97377609,chr14,97377550,97377609,H1|chr14:38675127-38675205,chr14,38675127,38675205,0,58702423
H1|chr14:97708309-97708432,chr14,97708309,97708432,H1|chr14:105330983-105331010,chr14,105330983,105331010,0,7622674
H1|chr14:97988650-97988779,chr14,97988650,97988779,H1|chr14:74356674-74356796,chr14,74356674,74356796,0,23631976
H1|chr14:98030918-98030964,chr14,98030918,98030964,H1|chr14:38672284-38672415,chr14,38672284,38672415,0,59358634
H1|chr14:98072391-98072452,chr14,98072391,98072452,H1|chr14:99737890-99737979,chr14,99737890,99737979,0,1665499
H1|chr14:98304799-98304857,chr14,98304799,98304857,H1|chr14:105328862-105328954,chr14,105328862,105328954,0,7024063
H1|chr14:98690542-98690658,chr14,98690542,98690658,H1|chr14:91723180-91723272,chr14,91723180,91723272,0,6967362
H1|chr14:99005825-99005932,chr14,99005825,99005932,H1|chr14:38674454-38674497,chr14,38674454,38674497,0,60331371
H1|chr14:99025480-99025534,chr14,99025480,99025534,H1|chr14:105327862-105327946,chr14,105327862,105327946,0,6302382
H1|chr14:99265706-99265738,chr14,99265706,99265738,H1|chr14:105329513-105329567,chr14,105329513,105329567,0,6063807
H1|chr14:99991292-99991372,chr14,99991292,99991372,H1|chr14:105330981-105331015,chr14,105330981,105331015,0,5339689
H1|chr14:100018930-100019006,chr14,100018930,100019006,H1|chr14:38674943-38675017,chr14,38674943,38675017,0,61343987
H1|chr14:100659911-100659993,chr14,100659911,100659993,H1|chr14:38677488-38677542,chr14,38677488,38677542,0,61982423
H1|chr14:100884991-100885067,chr14,100884991,100885067,H1|chr14:38673966-38674038,chr14,38673966,38674038,0,62211025
H1|chr14:101295706-101295735,chr14,101295706,101295735,H1|chr14:38673159-38673212,chr14,38673159,38673212,0,62622547
H1|chr14:101937073-101937201,chr14,101937073,101937201,H1|chr14:35342722-35342767,chr14,35342722,35342767,0,66594351
H1|chr14:102144468-102144602,chr14,102144468,102144602,H1|chr14:105330983-105331010,chr14,105330983,105331010,0,3186515
H1|chr14:103121740-103121810,chr14,103121740,103121810,H1|chr14:105326963-105326983,chr14,105326963,105326983,0,2205223
H1|chr14:103232566-103232640,chr14,103232566,103232640,H1|chr14:99737888-99737956,chr14,99737888,99737956,0,3494678
H1|chr14:103233167-103233183,chr14,103233167,103233183,H1|chr14:38672264-38672307,chr14,38672264,38672307,0,64560903
H1|chr14:103508862-103508891,chr14,103508862,103508891,H1|chr14:24044454-24044543,chr14,24044454,24044543,0,79464408
H1|chr14:103579984-103580011,chr14,103579984,103580011,H1|chr14:59934682-59934783,chr14,59934682,59934783,0,43645302
H1|chr14:103598340-103598396,chr14,103598340,103598396,H1|chr14:24042483-24042577,chr14,24042483,24042577,0,79555857
H1|chr14:103928795-103928878,chr14,103928795,103928878,H1|chr14:38673164-38673206,chr14,38673164,38673206,0,65255631
H1|chr14:104064890-104064997,chr14,104064890,104064997,H1|chr14:105328680-105328723,chr14,105328680,105328723,0,1263790
H1|chr14:104173635-104173724,chr14,104173635,104173724,H1|chr14:38676715-38676737,chr14,38676715,38676737,0,65496920
H1|chr14:104638983-104639063,chr14,104638983,104639063,H1|chr14:105330981-105331015,chr14,105330981,105331015,0,691998
H1|chr14:105559701-105559771,chr14,105559701,105559771,H1|chr14:105326963-105326983,chr14,105326963,105326983,0,232738
H1|chr14:105922598-105922703,chr14,105922598,105922703,H1|chr14:74356674-74356795,chr14,74356674,74356795,0,31565924
H1|chr14:106131293-106131423,chr14,106131293,106131423,H1|chr14:105331047-105331135,chr14,105331047,105331135,0,800246
H1|chr14:106300194-106300330,chr14,106300194,106300330,H1|chr14:100703625-100703654,chr14,100703625,100703654,0,5596569
H1|chr14:106325145-106325233,chr14,106325145,106325233,H1|chr14:105326841-105326884,chr14,105326841,105326884,0,998304
H1|chr14:106589983-106590016,chr14,106589983,106590016,H1|chr14:105326890-105326921,chr14,105326890,105326921,0,1263093
H1|chr14:106631547-106631599,chr14,106631547,106631599,H1|chr14:38673687-38673785,chr14,38673687,38673785,0,67957860
H1|chr14:106688260-106688376,chr14,106688260,106688376,H1|chr14:38674335-38674365,chr14,38674335,38674365,0,68013925
H1|chr14:107126232-107126294,chr14,107126232,107126294,H1|chr14:105330492-105330573,chr14,105330492,105330573,0,1795740
H1|chr14:107220183-107220275,chr14,107220183,107220275,H1|chr14:24042483-24042577,chr14,24042483,24042577,0,83177700
H1|chr14:107322249-107322300,chr14,107322249,107322300,H1|chr14:38676823-38676922,chr14,38676823,38676922,0,68645426
H1|chr15:102505-102583,chr15,102505,102583,H1|chr15:99191843-99191893,chr15,99191843,99191893,0,99089338
H1|chr15:240632-240682,chr15,240632,240682,H1|chr15:68116415-68116467,chr15,68116415,68116467,0,67875783
H1|chr15:1985157-1985307,chr15,1985157,1985307,H1|chr15:78631437-78631471,chr15,78631437,78631471,0,76646280
H1|chr15:3051765-3051818,chr15,3051765,3051818,H1|chr15:63342904-63342998,chr15,63342904,63342998,0,60291139
H1|chr15:3237694-3237810,chr15,3237694,3237810,H1|chr15:78631437-78631471,chr15,78631437,78631471,0,75393743
H1|chr15:3480844-3480911,chr15,3480844,3480911,H1|chr15:53085415-53085494,chr15,53085415,53085494,0,49604571
H1|chr15:3598441-3598591,chr15,3598441,3598591,H1|chr15:28566950-28567077,chr15,28566950,28567077,0,24968509
H1|chr15:3689944-3690056,chr15,3689944,3690056,H1|chr15:25687757-25687795,chr15,25687757,25687795,0,21997813
H1|chr15:3743052-3743082,chr15,3743052,3743082,H1|chr15:99191854-99191870,chr15,99191854,99191870,0,95448802
H1|chr15:4586865-4586931,chr15,4586865,4586931,H1|chr15:65130584-65130667,chr15,65130584,65130667,0,60543719
H1|chr15:4671484-4671591,chr15,4671484,4671591,H1|chr15:68110216-68110282,chr15,68110216,68110282,0,63438732
H1|chr15:5667501-5667560,chr15,5667501,5667560,H1|chr15:53085880-53085971,chr15,53085880,53085971,0,47418379
H1|chr15:6046325-6046386,chr15,6046325,6046386,H1|chr15:93613375-93613435,chr15,93613375,93613435,0,87567050
H1|chr15:6548757-6548887,chr15,6548757,6548887,H1|chr15:64994218-64994353,chr15,64994218,64994353,0,58445461
H1|chr15:6796978-6797049,chr15,6796978,6797049,H1|chr15:70386282-70386311,chr15,70386282,70386311,0,63589304
H1|chr15:7173421-7173496,chr15,7173421,7173496,H1|chr15:63342904-63342998,chr15,63342904,63342998,0,56169483
H1|chr15:7270881-7270956,chr15,7270881,7270956,H1|chr15:99191843-99191893,chr15,99191843,99191893,0,91920962
H1|chr15:7780938-7781019,chr15,7780938,7781019,H1|chr15:65713341-65713379,chr15,65713341,65713379,0,57932403
H1|chr15:7961607-7961646,chr15,7961607,7961646,H1|chr15:64995122-64995237,chr15,64995122,64995237,0,57033515
H1|chr15:8413565-8413652,chr15,8413565,8413652,H1|chr15:78438981-78439028,chr15,78438981,78439028,0,70025416
H1|chr15:8747749-8747829,chr15,8747749,8747829,H1|chr15:93614880-93614904,chr15,93614880,93614904,0,84867131
H1|chr15:8849098-8849205,chr15,8849098,8849205,H1|chr15:41244541-41244617,chr15,41244541,41244617,0,32395443
H1|chr15:9593490-9593522,chr15,9593490,9593522,H1|chr15:64995122-64995237,chr15,64995122,64995237,0,55401632
H1|chr15:10491838-10491864,chr15,10491838,10491864,H1|chr15:53082280-53082385,chr15,53082280,53082385,0,42590442
H1|chr15:11073482-11073552,chr15,11073482,11073552,H1|chr15:70386282-70386311,chr15,70386282,70386311,0,59312800
H1|chr15:11688784-11688862,chr15,11688784,11688862,H1|chr15:53085415-53085494,chr15,53085415,53085494,0,41396631
H1|chr15:11828466-11828510,chr15,11828466,11828510,H1|chr15:64995903-64996009,chr15,64995903,64996009,0,53167437
H1|chr15:11934659-11934703,chr15,11934659,11934703,H1|chr15:64995903-64996009,chr15,64995903,64996009,0,53061244
H1|chr15:11970743-11970834,chr15,11970743,11970834,H1|chr15:65130927-65130952,chr15,65130927,65130952,0,53160184
H1|chr15:12285347-12285385,chr15,12285347,12285385,H1|chr15:69109909-69109936,chr15,69109909,69109936,0,56824562
H1|chr15:12325791-12325829,chr15,12325791,12325829,H1|chr15:63336433-63336528,chr15,63336433,63336528,0,51010642
H1|chr15:12364696-12364790,chr15,12364696,12364790,H1|chr15:59226453-59226536,chr15,59226453,59226536,0,46861757
H1|chr15:12470644-12470733,chr15,12470644,12470733,H1|chr15:65130927-65130952,chr15,65130927,65130952,0,52660283
H1|chr15:12609618-12609768,chr15,12609618,12609768,H1|chr15:28566878-28567028,chr15,28566878,28567028,0,15957260
H1|chr15:12655359-12655417,chr15,12655359,12655417,H1|chr15:64994550-64994568,chr15,64994550,64994568,0,52339191
H1|chr15:12821531-12821629,chr15,12821531,12821629,H1|chr15:65131163-65131215,chr15,65131163,65131215,0,52309632
H1|chr15:12864621-12864699,chr15,12864621,12864699,H1|chr15:99191843-99191893,chr15,99191843,99191893,0,86327222
H1|chr15:12867843-12867884,chr15,12867843,12867884,H1|chr15:64995568-64995718,chr15,64995568,64995718,0,52127725
H1|chr15:12873432-12873465,chr15,12873432,12873465,H1|chr15:93612814-93612928,chr15,93612814,93612928,0,80739382
H1|chr15:13228819-13228904,chr15,13228819,13228904,H1|chr15:78438981-78439028,chr15,78438981,78439028,0,65210162
H1|chr15:13387434-13387473,chr15,13387434,13387473,H1|chr15:64993636-64993741,chr15,64993636,64993741,0,51606202
H1|chr15:13453256-13453372,chr15,13453256,13453372,H1|chr15:78631437-78631471,chr15,78631437,78631471,0,65178181
H1|chr15:13597705-13597795,chr15,13597705,13597795,H1|chr15:53086262-53086320,chr15,53086262,53086320,0,39488557
H1|chr15:15282502-15282583,chr15,15282502,15282583,H1|chr15:89160331-89160381,chr15,89160331,89160381,0,73877829
H1|chr15:15361823-15361973,chr15,15361823,15361973,H1|chr15:74392546-74392568,chr15,74392546,74392568,0,59030723
H1|chr15:15585181-15585245,chr15,15585181,15585245,H1|chr15:63341705-63341821,chr15,63341705,63341821,0,47756524
H1|chr15:15793119-15793158,chr15,15793119,15793158,H1|chr15:78630829-78630878,chr15,78630829,78630878,0,62837710
H1|chr15:15873296-15873342,chr15,15873296,15873342,H1|chr15:65130455-65130558,chr15,65130455,65130558,0,49257159
H1|chr15:15887455-15887527,chr15,15887455,15887527,H1|chr15:65131016-65131092,chr15,65131016,65131092,0,49243561
H1|chr15:16259254-16259311,chr15,16259254,16259311,H1|chr15:89160331-89160381,chr15,89160331,89160381,0,72901077
H1|chr15:16686577-16686627,chr15,16686577,16686627,H1|chr15:40074484-40074535,chr15,40074484,40074535,0,23387907
H1|chr15:16757625-16757650,chr15,16757625,16757650,H1|chr15:99191889-99191984,chr15,99191889,99191984,0,82434264
H1|chr15:17285626-17285711,chr15,17285626,17285711,H1|chr15:78438981-78439028,chr15,78438981,78439028,0,61153355
H1|chr15:17465065-17465138,chr15,17465065,17465138,H1|chr15:99191845-99191884,chr15,99191845,99191884,0,81726780
H1|chr15:17541166-17541239,chr15,17541166,17541239,H1|chr15:99191845-99191884,chr15,99191845,99191884,0,81650679
H1|chr15:18598355-18598445,chr15,18598355,18598445,H1|chr15:65130927-65130952,chr15,65130927,65130952,0,46532572
H1|chr15:18807898-18807936,chr15,18807898,18807936,H1|chr15:63336433-63336528,chr15,63336433,63336528,0,44528535
H1|chr15:18919264-18919308,chr15,18919264,18919308,H1|chr15:64995632-64995707,chr15,64995632,64995707,0,46076368
H1|chr15:19178899-19178927,chr15,19178899,19178927,H1|chr15:65132263-65132330,chr15,65132263,65132330,0,45953364
H1|chr15:19204837-19204936,chr15,19204837,19204936,H1|chr15:89160331-89160381,chr15,89160331,89160381,0,69955494
H1|chr15:19651749-19651810,chr15,19651749,19651810,H1|chr15:93615313-93615355,chr15,93615313,93615355,0,73963564
H1|chr15:19856950-19857099,chr15,19856950,19857099,H1|chr15:28566822-28566944,chr15,28566822,28566944,0,8709872
H1|chr15:20715034-20715100,chr15,20715034,20715100,H1|chr15:65130584-65130667,chr15,65130584,65130667,0,44415550
H1|chr15:21223396-21223470,chr15,21223396,21223470,H1|chr15:63336427-63336469,chr15,63336427,63336469,0,42113031
H1|chr15:21601518-21601562,chr15,21601518,21601562,H1|chr15:89440295-89440364,chr15,89440295,89440364,0,67838777
H1|chr15:21733640-21733673,chr15,21733640,21733673,H1|chr15:65071401-65071458,chr15,65071401,65071458,0,43337761
H1|chr15:21815129-21815201,chr15,21815129,21815201,H1|chr15:64994719-64994797,chr15,64994719,64994797,0,43179590
H1|chr15:23668393-23668453,chr15,23668393,23668453,H1|chr15:64992699-64992731,chr15,64992699,64992731,0,41324306
H1|chr15:23678554-23678611,chr15,23678554,23678611,H1|chr15:63337013-63337086,chr15,63337013,63337086,0,39658459
H1|chr15:23686292-23686351,chr15,23686292,23686351,H1|chr15:53085880-53085971,chr15,53085880,53085971,0,29399588
H1|chr15:24007256-24007352,chr15,24007256,24007352,H1|chr15:99191781-99191841,chr15,99191781,99191841,0,75184525
H1|chr15:24090132-24090282,chr15,24090132,24090282,H1|chr15:74392546-74392568,chr15,74392546,74392568,0,50302414
H1|chr15:24111521-24111671,chr15,24111521,24111671,H1|chr15:28566878-28567028,chr15,28566878,28567028,0,4455357
H1|chr15:24529826-24529881,chr15,24529826,24529881,H1|chr15:91498795-91498883,chr15,91498795,91498883,0,66968969
H1|chr15:24613703-24613763,chr15,24613703,24613763,H1|chr15:64992699-64992731,chr15,64992699,64992731,0,40378996
H1|chr15:24701747-24701799,chr15,24701747,24701799,H1|chr15:53087079-53087125,chr15,53087079,53087125,0,28385332
H1|chr15:24731558-24731602,chr15,24731558,24731602,H1|chr15:77713817-77713850,chr15,77713817,77713850,0,52982259
H1|chr15:25003092-25003179,chr15,25003092,25003179,H1|chr15:78438981-78439028,chr15,78438981,78439028,0,53435889
H1|chr15:25344596-25344741,chr15,25344596,25344741,H1|chr15:64993636-64993741,chr15,64993636,64993741,0,39649040
H1|chr15:26171618-26171768,chr15,26171618,26171768,H1|chr15:28566669-28566816,chr15,28566669,28566816,0,2395051
H1|chr15:26181172-26181248,chr15,26181172,26181248,H1|chr15:93612814-93612928,chr15,93612814,93612928,0,67431642
H1|chr15:26214542-26214600,chr15,26214542,26214600,H1|chr15:64994550-64994568,chr15,64994550,64994568,0,38780008
H1|chr15:26273003-26273103,chr15,26273003,26273103,H1|chr15:30113130-30113220,chr15,30113130,30113220,0,3840127
H1|chr15:26647537-26647564,chr15,26647537,26647564,H1|chr15:99191889-99191984,chr15,99191889,99191984,0,72544352
H1|chr15:27478576-27478617,chr15,27478576,27478617,H1|chr15:64993342-64993437,chr15,64993342,64993437,0,37514766
H1|chr15:27515028-27515139,chr15,27515028,27515139,H1|chr15:93614933-93614957,chr15,93614933,93614957,0,66099905
H1|chr15:27607746-27607824,chr15,27607746,27607824,H1|chr15:53085415-53085494,chr15,53085415,53085494,0,25477669
H1|chr15:27797443-27797533,chr15,27797443,27797533,H1|chr15:99191781-99191841,chr15,99191781,99191841,0,71394338
H1|chr15:27837403-27837455,chr15,27837403,27837455,H1|chr15:89441552-89441611,chr15,89441552,89441611,0,61604149
H1|chr15:28199087-28199176,chr15,28199087,28199176,H1|chr15:65122295-65122392,chr15,65122295,65122392,0,36923208
H1|chr15:28368559-28368605,chr15,28368559,28368605,H1|chr15:65130455-65130558,chr15,65130455,65130558,0,36761896
H1|chr15:28667889-28667933,chr15,28667889,28667933,H1|chr15:77713817-77713850,chr15,77713817,77713850,0,49045928
H1|chr15:28943749-28943833,chr15,28943749,28943833,H1|chr15:68110216-68110282,chr15,68110216,68110282,0,39166467
H1|chr15:29122321-29122353,chr15,29122321,29122353,H1|chr15:101790426-101790503,chr15,101790426,101790503,0,72668105
H1|chr15:29282251-29282269,chr15,29282251,29282269,H1|chr15:78627781-78627890,chr15,78627781,78627890,0,49345530
H1|chr15:30105389-30105458,chr15,30105389,30105458,H1|chr15:41244541-41244617,chr15,41244541,41244617,0,11139152
H1|chr15:30184244-30184282,chr15,30184244,30184282,H1|chr15:85294483-85294557,chr15,85294483,85294557,0,55110239
H1|chr15:30228201-30228234,chr15,30228201,30228234,H1|chr15:93612814-93612928,chr15,93612814,93612928,0,63384613
H1|chr15:30603856-30604006,chr15,30603856,30604006,H1|chr15:85294483-85294557,chr15,85294483,85294557,0,54690627
H1|chr15:30826423-30826517,chr15,30826423,30826517,H1|chr15:59226453-59226536,chr15,59226453,59226536,0,28400030
H1|chr15:31145883-31145908,chr15,31145883,31145908,H1|chr15:99191889-99191984,chr15,99191889,99191984,0,68046006
H1|chr15:31351251-31351281,chr15,31351251,31351281,H1|chr15:99191854-99191870,chr15,99191854,99191870,0,67840603
H1|chr15:31471348-31471367,chr15,31471348,31471367,H1|chr15:65132595-65132726,chr15,65132595,65132726,0,33661247
H1|chr15:31647160-31647226,chr15,31647160,31647226,H1|chr15:64992893-64992966,chr15,64992893,64992966,0,33345733
H1|chr15:31735595-31735635,chr15,31735595,31735635,H1|chr15:64993342-64993437,chr15,64993342,64993437,0,33257747
H1|chr15:31943313-31943357,chr15,31943313,31943357,H1|chr15:89440295-89440364,chr15,89440295,89440364,0,57496982
H1|chr15:32229884-32229937,chr15,32229884,32229937,H1|chr15:63342904-63342998,chr15,63342904,63342998,0,31113020
H1|chr15:32505608-32505643,chr15,32505608,32505643,H1|chr15:93427205-93427314,chr15,93427205,93427314,0,60921597
H1|chr15:32909662-32909709,chr15,32909662,32909709,H1|chr15:53084024-53084127,chr15,53084024,53084127,0,20174362
H1|chr15:33193749-33193899,chr15,33193749,33193899,H1|chr15:28566666-28566691,chr15,28566666,28566691,0,4627083
H1|chr15:33293986-33294131,chr15,33293986,33294131,H1|chr15:64993636-64993741,chr15,64993636,64993741,0,31699650
H1|chr15:33530614-33530705,chr15,33530614,33530705,H1|chr15:67359896-67359928,chr15,67359896,67359928,0,33829282
H1|chr15:34209297-34209327,chr15,34209297,34209327,H1|chr15:40074485-40074535,chr15,40074485,40074535,0,5865188
H1|chr15:34276174-34276324,chr15,34276174,34276324,H1|chr15:28566669-28566816,chr15,28566669,28566816,0,5709505
H1|chr15:34320880-34320935,chr15,34320880,34320935,H1|chr15:25202011-25202058,chr15,25202011,25202058,0,9118869
H1|chr15:35153730-35153799,chr15,35153730,35153799,H1|chr15:93427205-93427273,chr15,93427205,93427273,0,58273475
H1|chr15:35200919-35200995,chr15,35200919,35200995,H1|chr15:68107906-68107944,chr15,68107906,68107944,0,32906987
H1|chr15:35927965-35928019,chr15,35927965,35928019,H1|chr15:65130455-65130558,chr15,65130455,65130558,0,29202490
H1|chr15:36430061-36430122,chr15,36430061,36430122,H1|chr15:65130584-65130667,chr15,65130584,65130667,0,28700523
H1|chr15:36603784-36603817,chr15,36603784,36603817,H1|chr15:65071401-65071458,chr15,65071401,65071458,0,28467617
H1|chr15:36827028-36827112,chr15,36827028,36827112,H1|chr15:68110216-68110282,chr15,68110216,68110282,0,31283188
H1|chr15:36949555-36949592,chr15,36949555,36949592,H1|chr15:25684312-25684462,chr15,25684312,25684462,0,11265243
H1|chr15:37036598-37036613,chr15,37036598,37036613,H1|chr15:93611855-93611984,chr15,93611855,93611984,0,56575257
H1|chr15:37224951-37225009,chr15,37224951,37225009,H1|chr15:53076121-53076195,chr15,53076121,53076195,0,15851170
H1|chr15:37379466-37379616,chr15,37379466,37379616,H1|chr15:28566666-28566691,chr15,28566666,28566691,0,8812800
H1|chr15:37584334-37584373,chr15,37584334,37584373,H1|chr15:68107906-68107944,chr15,68107906,68107944,0,30523572
H1|chr15:38266966-38267023,chr15,38266966,38267023,H1|chr15:63337013-63337086,chr15,63337013,63337086,0,25070047
H1|chr15:39089547-39089599,chr15,39089547,39089599,H1|chr15:53087079-53087125,chr15,53087079,53087125,0,13997532
H1|chr15:41224837-41224867,chr15,41224837,41224867,H1|chr15:89165602-89165735,chr15,89165602,89165735,0,47940765
H1|chr15:41371868-41371927,chr15,41371868,41371927,H1|chr15:65131163-65131215,chr15,65131163,65131215,0,23759295
H1|chr15:41710253-41710291,chr15,41710253,41710291,H1|chr15:41625209-41625321,chr15,41625209,41625321,0,85044
H1|chr15:41989737-41989769,chr15,41989737,41989769,H1|chr15:65132263-65132330,chr15,65132263,65132330,0,23142526
H1|chr15:42788883-42788933,chr15,42788883,42788933,H1|chr15:40074485-40074535,chr15,40074485,40074535,0,2714398
H1|chr15:42971411-42971448,chr15,42971411,42971448,H1|chr15:25684312-25684462,chr15,25684312,25684462,0,17287099
H1|chr15:43441422-43441488,chr15,43441422,43441488,H1|chr15:64992893-64992966,chr15,64992893,64992966,0,21551471
H1|chr15:43671416-43671435,chr15,43671416,43671435,H1|chr15:65132595-65132726,chr15,65132595,65132726,0,21461179
H1|chr15:45196481-45196525,chr15,45196481,45196525,H1|chr15:64995632-64995707,chr15,64995632,64995707,0,19799151
H1|chr15:45249875-45249936,chr15,45249875,45249936,H1|chr15:93615313-93615355,chr15,93615313,93615355,0,48365438
H1|chr15:45395474-45395559,chr15,45395474,45395559,H1|chr15:34634460-34634525,chr15,34634460,34634525,0,10761014
H1|chr15:45603232-45603309,chr15,45603232,45603309,H1|chr15:89441540-89441603,chr15,89441540,89441603,0,43838308
H1|chr15:46010541-46010627,chr15,46010541,46010627,H1|chr15:67359896-67359928,chr15,67359896,67359928,0,21349355
H1|chr15:46070974-46071025,chr15,46070974,46071025,H1|chr15:53087079-53087125,chr15,53087079,53087125,0,7016105
H1|chr15:46428832-46428875,chr15,46428832,46428875,H1|chr15:41053028-41053135,chr15,41053028,41053135,0,5375804
H1|chr15:46458865-46458903,chr15,46458865,46458903,H1|chr15:85294483-85294557,chr15,85294483,85294557,0,38835618
H1|chr15:46683413-46683488,chr15,46683413,46683488,H1|chr15:89441540-89441603,chr15,89441540,89441603,0,42758127
H1|chr15:46689801-46689924,chr15,46689801,46689924,H1|chr15:93427250-93427274,chr15,93427250,93427274,0,46737449
H1|chr15:47176458-47176547,chr15,47176458,47176547,H1|chr15:65122295-65122392,chr15,65122295,65122392,0,17945837
H1|chr15:47315493-47315545,chr15,47315493,47315545,H1|chr15:89441552-89441611,chr15,89441552,89441611,0,42126059
H1|chr15:47367151-47367181,chr15,47367151,47367181,H1|chr15:89165602-89165735,chr15,89165602,89165735,0,41798451
H1|chr15:47414791-47414848,chr15,47414791,47414848,H1|chr15:89160331-89160381,chr15,89160331,89160381,0,41745540
H1|chr15:48095654-48095765,chr15,48095654,48095765,H1|chr15:93614933-93614957,chr15,93614933,93614957,0,45519279
H1|chr15:48131958-48131992,chr15,48131958,48131992,H1|chr15:63341705-63341821,chr15,63341705,63341821,0,15209747
H1|chr15:48844107-48844127,chr15,48844107,48844127,H1|chr15:25687832-25687919,chr15,25687832,25687919,0,23156275
H1|chr15:48972651-48972720,chr15,48972651,48972720,H1|chr15:89161319-89161400,chr15,89161319,89161400,0,40188668
H1|chr15:48992928-48992998,chr15,48992928,48992998,H1|chr15:100106844-100106890,chr15,100106844,100106890,0,51113916
H1|chr15:49855936-49855962,chr15,49855936,49855962,H1|chr15:53082280-53082385,chr15,53082280,53082385,0,3226344
H1|chr15:49942816-49942890,chr15,49942816,49942890,H1|chr15:63336427-63336469,chr15,63336427,63336469,0,13393611
H1|chr15:50014775-50014865,chr15,50014775,50014865,H1|chr15:65130927-65130952,chr15,65130927,65130952,0,15116152
H1|chr15:50196176-50196198,chr15,50196176,50196198,H1|chr15:99192035-99192124,chr15,99192035,99192124,0,48995859
H1|chr15:50489854-50489906,chr15,50489854,50489906,H1|chr15:99191454-99191526,chr15,99191454,99191526,0,48701600
H1|chr15:50522647-50522722,chr15,50522647,50522722,H1|chr15:63342904-63342998,chr15,63342904,63342998,0,12820257
H1|chr15:50618679-50618737,chr15,50618679,50618737,H1|chr15:63337013-63337086,chr15,63337013,63337086,0,12718334
H1|chr15:50694595-50694649,chr15,50694595,50694649,H1|chr15:65130455-65130558,chr15,65130455,65130558,0,14435860
H1|chr15:50735129-50735198,chr15,50735129,50735198,H1|chr15:41244541-41244617,chr15,41244541,41244617,0,9490588
H1|chr15:50736543-50736613,chr15,50736543,50736613,H1|chr15:41244537-41244617,chr15,41244537,41244617,0,9492006
H1|chr15:50916289-50916317,chr15,50916289,50916317,H1|chr15:65122246-65122382,chr15,65122246,65122382,0,14205957
H1|chr15:51140516-51140665,chr15,51140516,51140665,H1|chr15:28566824-28566974,chr15,28566824,28566974,0,22573692
H1|chr15:51297524-51297562,chr15,51297524,51297562,H1|chr15:34634867-34634979,chr15,34634867,34634979,0,16662657
H1|chr15:51361707-51361784,chr15,51361707,51361784,H1|chr15:64994991-64995064,chr15,64994991,64995064,0,13633284
H1|chr15:51460571-51460605,chr15,51460571,51460605,H1|chr15:65129205-65129299,chr15,65129205,65129299,0,13668634
H1|chr15:51570807-51570884,chr15,51570807,51570884,H1|chr15:65713341-65713379,chr15,65713341,65713379,0,14142534
H1|chr15:52029557-52029652,chr15,52029557,52029652,H1|chr15:53085880-53085971,chr15,53085880,53085971,0,1056323
H1|chr15:53171031-53171066,chr15,53171031,53171066,H1|chr15:93427205-93427314,chr15,93427205,93427314,0,40256174
H1|chr15:53231709-53231769,chr15,53231709,53231769,H1|chr15:30113130-30113220,chr15,30113130,30113220,0,23118579
H1|chr15:53405906-53406056,chr15,53405906,53406056,H1|chr15:28566896-28567046,chr15,28566896,28567046,0,24839010
H1|chr15:53415957-53415987,chr15,53415957,53415987,H1|chr15:40074485-40074535,chr15,40074485,40074535,0,13341472
H1|chr15:53469235-53469285,chr15,53469235,53469285,H1|chr15:68116415-68116467,chr15,68116415,68116467,0,14647180
H1|chr15:53571862-53571882,chr15,53571862,53571882,H1|chr15:25687832-25687919,chr15,25687832,25687919,0,27884030
H1|chr15:53675308-53675372,chr15,53675308,53675372,H1|chr15:93615313-93615355,chr15,93615313,93615355,0,39940005
H1|chr15:53794875-53794933,chr15,53794875,53794933,H1|chr15:63337013-63337086,chr15,63337013,63337086,0,9542138
H1|chr15:53851912-53851984,chr15,53851912,53851984,H1|chr15:64994719-64994797,chr15,64994719,64994797,0,11142807
H1|chr15:54220067-54220106,chr15,54220067,54220106,H1|chr15:78630829-78630878,chr15,78630829,78630878,0,24410762
H1|chr15:54698377-54698442,chr15,54698377,54698442,H1|chr15:53084024-53084127,chr15,53084024,53084127,0,1614353
H1|chr15:55098460-55098563,chr15,55098460,55098563,H1|chr15:65070203-65070258,chr15,65070203,65070258,0,9971743
H1|chr15:55442175-55442271,chr15,55442175,55442271,H1|chr15:99191781-99191841,chr15,99191781,99191841,0,43749606
H1|chr15:55600676-55600699,chr15,55600676,55600699,H1|chr15:53083414-53083494,chr15,53083414,53083494,0,2517262
H1|chr15:56286180-56286223,chr15,56286180,56286223,H1|chr15:53073458-53073535,chr15,53073458,53073535,0,3212722
H1|chr15:56473139-56473213,chr15,56473139,56473213,H1|chr15:99191845-99191884,chr15,99191845,99191884,0,42718706
H1|chr15:56564421-56564479,chr15,56564421,56564479,H1|chr15:53076121-53076195,chr15,53076121,53076195,0,3488300
H1|chr15:56678584-56678654,chr15,56678584,56678654,H1|chr15:100106844-100106890,chr15,100106844,100106890,0,43428260
H1|chr15:56781090-56781117,chr15,56781090,56781117,H1|chr15:69109909-69109938,chr15,69109909,69109938,0,12328819
H1|chr15:56853852-56853947,chr15,56853852,56853947,H1|chr15:53085880-53085971,chr15,53085880,53085971,0,3767972
H1|chr15:57052706-57052753,chr15,57052706,57052753,H1|chr15:53084024-53084127,chr15,53084024,53084127,0,3968682
H1|chr15:57266547-57266589,chr15,57266547,57266589,H1|chr15:41053028-41053135,chr15,41053028,41053135,0,16213519
H1|chr15:57420490-57420518,chr15,57420490,57420518,H1|chr15:65122246-65122382,chr15,65122246,65122382,0,7701756
H1|chr15:57542062-57542153,chr15,57542062,57542153,H1|chr15:67359896-67359928,chr15,67359896,67359928,0,9817834
H1|chr15:57556361-57556468,chr15,57556361,57556468,H1|chr15:68110216-68110282,chr15,68110216,68110282,0,10553855
H1|chr15:57817544-57817625,chr15,57817544,57817625,H1|chr15:65713341-65713379,chr15,65713341,65713379,0,7895797
H1|chr15:58883973-58884048,chr15,58883973,58884048,H1|chr15:99191843-99191893,chr15,99191843,99191893,0,40307870
H1|chr15:59151348-59151382,chr15,59151348,59151382,H1|chr15:101790426-101790503,chr15,101790426,101790503,0,42639078
H1|chr15:59410112-59410144,chr15,59410112,59410144,H1|chr15:65132263-65132330,chr15,65132263,65132330,0,5722151
H1|chr15:59523147-59523270,chr15,59523147,59523270,H1|chr15:93427250-93427274,chr15,93427250,93427274,0,33904103
H1|chr15:60292933-60292965,chr15,60292933,60292965,H1|chr15:64995122-64995237,chr15,64995122,64995237,0,4702189
H1|chr15:60518136-60518226,chr15,60518136,60518226,H1|chr15:65070203-65070258,chr15,65070203,65070258,0,4552067
H1|chr15:60834030-60834120,chr15,60834030,60834120,H1|chr15:99191781-99191841,chr15,99191781,99191841,0,38357751
H1|chr15:60853393-60853444,chr15,60853393,60853444,H1|chr15:53087079-53087125,chr15,53087079,53087125,0,7766314
H1|chr15:61566589-61566627,chr15,61566589,61566627,H1|chr15:69109909-69109936,chr15,69109909,69109936,0,7543320
H1|chr15:61857549-61857576,chr15,61857549,61857576,H1|chr15:69109909-69109938,chr15,69109909,69109938,0,7252360
H1|chr15:61972306-61972338,chr15,61972306,61972338,H1|chr15:101790426-101790503,chr15,101790426,101790503,0,39818120
H1|chr15:62263800-62263869,chr15,62263800,62263869,H1|chr15:53082829-53082962,chr15,53082829,53082962,0,9180971
H1|chr15:62682622-62682772,chr15,62682622,62682772,H1|chr15:28566865-28566936,chr15,28566865,28566936,0,34115757
H1|chr15:62926977-62927011,chr15,62926977,62927011,H1|chr15:101790426-101790503,chr15,101790426,101790503,0,38863449
H1|chr15:62933649-62933683,chr15,62933649,62933683,H1|chr15:63341705-63341821,chr15,63341705,63341821,0,408056
H1|chr15:63623315-63623379,chr15,63623315,63623379,H1|chr15:63341705-63341821,chr15,63341705,63341821,0,281610
H1|chr15:63630070-63630110,chr15,63630070,63630110,H1|chr15:65132595-65132726,chr15,65132595,65132726,0,1502525
H1|chr15:63651967-63652039,chr15,63651967,63652039,H1|chr15:65131016-65131092,chr15,65131016,65131092,0,1479049
H1|chr15:64320819-64320894,chr15,64320819,64320894,H1|chr15:89441540-89441603,chr15,89441540,89441603,0,25120721
H1|chr15:64470553-64470643,chr15,64470553,64470643,H1|chr15:67359896-67359928,chr15,67359896,67359928,0,2889343
H1|chr15:65418305-65418345,chr15,65418305,65418345,H1|chr15:65132595-65132726,chr15,65132595,65132726,0,285710
H1|chr15:66168239-66168279,chr15,66168239,66168279,H1|chr15:64993342-64993437,chr15,64993342,64993437,0,1174897
H1|chr15:66298090-66298175,chr15,66298090,66298175,H1|chr15:34634460-34634525,chr15,34634460,34634525,0,31663630
H1|chr15:66353323-66353390,chr15,66353323,66353390,H1|chr15:59226453-59226536,chr15,59226453,59226536,0,7126870
H1|chr15:66850665-66850693,chr15,66850665,66850693,H1|chr15:65132263-65132330,chr15,65132263,65132330,0,1718402
H1|chr15:66867764-66867788,chr15,66867764,66867788,H1|chr15:85294483-85294557,chr15,85294483,85294557,0,18426719
H1|chr15:67154568-67154599,chr15,67154568,67154599,H1|chr15:68522617-68522658,chr15,68522617,68522658,0,1368049
H1|chr15:67170679-67170804,chr15,67170679,67170804,H1|chr15:25687563-25687626,chr15,25687563,25687626,0,41483116
H1|chr15:67267277-67267384,chr15,67267277,67267384,H1|chr15:41244541-41244617,chr15,41244541,41244617,0,26022736
H1|chr15:67323658-67323770,chr15,67323658,67323770,H1|chr15:25687757-25687795,chr15,25687757,25687795,0,41635901
H1|chr15:67769655-67769804,chr15,67769655,67769804,H1|chr15:74392546-74392623,chr15,74392546,74392623,0,6622891
H1|chr15:67872161-67872223,chr15,67872161,67872223,H1|chr15:93611855-93611984,chr15,93611855,93611984,0,25739694
H1|chr15:68149202-68149352,chr15,68149202,68149352,H1|chr15:25687757-25687795,chr15,25687757,25687795,0,42461445
H1|chr15:68437223-68437275,chr15,68437223,68437275,H1|chr15:65122295-65122392,chr15,65122295,65122392,0,3314928
H1|chr15:68533010-68533100,chr15,68533010,68533100,H1|chr15:65070203-65070258,chr15,65070203,65070258,0,3462807
H1|chr15:68580777-68580926,chr15,68580777,68580926,H1|chr15:28566822-28566944,chr15,28566822,28566944,0,40013955
H1|chr15:69285745-69285895,chr15,69285745,69285895,H1|chr15:25687757-25687795,chr15,25687757,25687795,0,43597988
H1|chr15:69654393-69654444,chr15,69654393,69654444,H1|chr15:40702234-40702357,chr15,40702234,40702357,0,28952159
H1|chr15:69654899-69654940,chr15,69654899,69654940,H1|chr15:64993342-64993437,chr15,64993342,64993437,0,4661557
H1|chr15:70379597-70379646,chr15,70379597,70379646,H1|chr15:63344666-63344815,chr15,63344666,63344815,0,7034931
H1|chr15:70869750-70869827,chr15,70869750,70869827,H1|chr15:65713341-65713379,chr15,65713341,65713379,0,5156409
H1|chr15:71170501-71170565,chr15,71170501,71170565,H1|chr15:93615313-93615355,chr15,93615313,93615355,0,22444812
H1|chr15:71216280-71216383,chr15,71216280,71216383,H1|chr15:65070203-65070258,chr15,65070203,65070258,0,6146077
H1|chr15:71216474-71216545,chr15,71216474,71216545,H1|chr15:100106844-100106890,chr15,100106844,100106890,0,28890370
H1|chr15:71882674-71882733,chr15,71882674,71882733,H1|chr15:65131163-65131215,chr15,65131163,65131215,0,6751511
H1|chr15:72452387-72452448,chr15,72452387,72452448,H1|chr15:65130584-65130667,chr15,65130584,65130667,0,7321803
H1|chr15:72763577-72763658,chr15,72763577,72763658,H1|chr15:93614880-93614904,chr15,93614880,93614904,0,20851303
H1|chr15:73348742-73348828,chr15,73348742,73348828,H1|chr15:53086262-53086320,chr15,53086262,53086320,0,20262480
H1|chr15:73669624-73669646,chr15,73669624,73669646,H1|chr15:99192035-99192124,chr15,99192035,99192124,0,25522411
H1|chr15:74930897-74930978,chr15,74930897,74930978,H1|chr15:89160331-89160381,chr15,89160331,89160381,0,14229434
H1|chr15:74952862-74952917,chr15,74952862,74952917,H1|chr15:91498795-91498883,chr15,91498795,91498883,0,16545933
H1|chr15:75782402-75782437,chr15,75782402,75782437,H1|chr15:99191860-99192005,chr15,99191860,99192005,0,23409458
H1|chr15:77306564-77306654,chr15,77306564,77306654,H1|chr15:67359896-67359928,chr15,67359896,67359928,0,9946668
H1|chr15:77458331-77458372,chr15,77458331,77458372,H1|chr15:64995568-64995718,chr15,64995568,64995718,0,12462763
H1|chr15:77481167-77481210,chr15,77481167,77481210,H1|chr15:53073458-53073535,chr15,53073458,53073535,0,24407709
H1|chr15:77593575-77593681,chr15,77593575,77593681,H1|chr15:65131759-65131783,chr15,65131759,65131783,0,12461816
H1|chr15:77675113-77675193,chr15,77675113,77675193,H1|chr15:93614880-93614904,chr15,93614880,93614904,0,15939767
H1|chr15:77704078-77704155,chr15,77704078,77704155,H1|chr15:89441540-89441603,chr15,89441540,89441603,0,11737462
H1|chr15:78196855-78197005,chr15,78196855,78197005,H1|chr15:28566865-28566936,chr15,28566865,28566936,0,49629990
H1|chr15:78629251-78629401,chr15,78629251,78629401,H1|chr15:85294483-85294557,chr15,85294483,85294557,0,6665232
H1|chr15:78784752-78784818,chr15,78784752,78784818,H1|chr15:65119495-65119645,chr15,65119495,65119645,0,13665257
H1|chr15:78838507-78838574,chr15,78838507,78838574,H1|chr15:59226453-59226536,chr15,59226453,59226536,0,19612054
H1|chr15:78840284-78840326,chr15,78840284,78840326,H1|chr15:41053028-41053135,chr15,41053028,41053135,0,37787256
H1|chr15:78871562-78871586,chr15,78871562,78871586,H1|chr15:85294483-85294557,chr15,85294483,85294557,0,6422921
H1|chr15:79574072-79574158,chr15,79574072,79574158,H1|chr15:67359896-67359928,chr15,67359896,67359928,0,12214176
H1|chr15:79921380-79921395,chr15,79921380,79921395,H1|chr15:93611855-93611984,chr15,93611855,93611984,0,13690475
H1|chr15:80371882-80371971,chr15,80371882,80371971,H1|chr15:65130927-65130952,chr15,65130927,65130952,0,15240955
H1|chr15:80921363-80921430,chr15,80921363,80921430,H1|chr15:53085415-53085494,chr15,53085415,53085494,0,27835948
H1|chr15:80977454-80977505,chr15,80977454,80977505,H1|chr15:40702234-40702357,chr15,40702234,40702357,0,40275220
H1|chr15:81429782-81429831,chr15,81429782,81429831,H1|chr15:63344666-63344815,chr15,63344666,63344815,0,18085116
H1|chr15:81714686-81714772,chr15,81714686,81714772,H1|chr15:53086262-53086320,chr15,53086262,53086320,0,28628424
H1|chr15:82396545-82396694,chr15,82396545,82396694,H1|chr15:74392546-74392562,chr15,74392546,74392562,0,8003999
H1|chr15:82559365-82559431,chr15,82559365,82559431,H1|chr15:65119495-65119645,chr15,65119495,65119645,0,17439870
H1|chr15:82967668-82967817,chr15,82967668,82967817,H1|chr15:74392546-74392623,chr15,74392546,74392623,0,8575122
H1|chr15:83053489-83053516,chr15,83053489,83053516,H1|chr15:99191889-99191984,chr15,99191889,99191984,0,16138400
H1|chr15:83159074-83159126,chr15,83159074,83159126,H1|chr15:99191454-99191526,chr15,99191454,99191526,0,16032380
H1|chr15:83195889-83195932,chr15,83195889,83195932,H1|chr15:41053028-41053135,chr15,41053028,41053135,0,42142861
H1|chr15:83433822-83433972,chr15,83433822,83433972,H1|chr15:28566950-28567077,chr15,28566950,28567077,0,54866872
H1|chr15:83456237-83456276,chr15,83456237,83456276,H1|chr15:68107906-68107944,chr15,68107906,68107944,0,15348331
H1|chr15:83678646-83678673,chr15,83678646,83678673,H1|chr15:89441345-89441461,chr15,89441345,89441461,0,5762699
H1|chr15:84263076-84263157,chr15,84263076,84263157,H1|chr15:65130916-65130948,chr15,65130916,65130948,0,19132160
H1|chr15:84337569-84337660,chr15,84337569,84337660,H1|chr15:65130927-65130952,chr15,65130927,65130952,0,19206642
H1|chr15:84731679-84731727,chr15,84731679,84731727,H1|chr15:65131706-65131744,chr15,65131706,65131744,0,19599973
H1|chr15:85652984-85653007,chr15,85652984,85653007,H1|chr15:89166644-89166719,chr15,89166644,89166719,0,3513660
H1|chr15:85870781-85870887,chr15,85870781,85870887,H1|chr15:65131759-65131783,chr15,65131759,65131783,0,20739022
H1|chr15:86036501-86036626,chr15,86036501,86036626,H1|chr15:25687563-25687626,chr15,25687563,25687626,0,60348938
H1|chr15:86294216-86294295,chr15,86294216,86294295,H1|chr15:89161319-89161400,chr15,89161319,89161400,0,2867103
H1|chr15:86350437-86350502,chr15,86350437,86350502,H1|chr15:53084024-53084127,chr15,53084024,53084127,0,33266413
H1|chr15:86375322-86375392,chr15,86375322,86375392,H1|chr15:70386282-70386311,chr15,70386282,70386311,0,15989040
H1|chr15:86616089-86616219,chr15,86616089,86616219,H1|chr15:64994218-64994353,chr15,64994218,64994353,0,21621871
H1|chr15:86982222-86982282,chr15,86982222,86982282,H1|chr15:30113130-30113220,chr15,30113130,30113220,0,56869092
H1|chr15:88133682-88133705,chr15,88133682,88133705,H1|chr15:53083414-53083494,chr15,53083414,53083494,0,35050268
H1|chr15:88633342-88633423,chr15,88633342,88633423,H1|chr15:65130916-65130948,chr15,65130916,65130948,0,23502426
H1|chr15:88635567-88635638,chr15,88635567,88635638,H1|chr15:100106844-100106890,chr15,100106844,100106890,0,11471277
H1|chr15:88873974-88874050,chr15,88873974,88874050,H1|chr15:68107906-68107944,chr15,68107906,68107944,0,20766068
H1|chr15:89499675-89499775,chr15,89499675,89499775,H1|chr15:30113130-30113220,chr15,30113130,30113220,0,59386545
H1|chr15:89665416-89665439,chr15,89665416,89665439,H1|chr15:89166644-89166719,chr15,89166644,89166719,0,498772
H1|chr15:90143039-90143116,chr15,90143039,90143116,H1|chr15:64994991-64995064,chr15,64994991,64995064,0,25148048
H1|chr15:90731394-90731455,chr15,90731394,90731455,H1|chr15:93613375-93613435,chr15,93613375,93613435,0,2881981
H1|chr15:90834525-90834612,chr15,90834525,90834612,H1|chr15:25687563-25687626,chr15,25687563,25687626,0,65146962
H1|chr15:91894516-91894564,chr15,91894516,91894564,H1|chr15:65131706-65131744,chr15,65131706,65131744,0,26762810
H1|chr15:91949572-91949622,chr15,91949572,91949622,H1|chr15:40074484-40074535,chr15,40074484,40074535,0,51875088
H1|chr15:92881506-92881582,chr15,92881506,92881582,H1|chr15:93612814-93612928,chr15,93612814,93612928,0,731308
H1|chr15:92934354-92934441,chr15,92934354,92934441,H1|chr15:25687563-25687626,chr15,25687563,25687626,0,67246791
H1|chr15:92948197-92948231,chr15,92948197,92948231,H1|chr15:65129205-65129299,chr15,65129205,65129299,0,27818992
H1|chr15:92994483-92994581,chr15,92994483,92994581,H1|chr15:65131163-65131215,chr15,65131163,65131215,0,27863320
H1|chr15:93205285-93205355,chr15,93205285,93205355,H1|chr15:41244537-41244617,chr15,41244537,41244617,0,51960748
H1|chr15:94144908-94144947,chr15,94144908,94144947,H1|chr15:64995122-64995237,chr15,64995122,64995237,0,29149786
H1|chr15:94514639-94514689,chr15,94514639,94514689,H1|chr15:40074485-40074535,chr15,40074485,40074535,0,54440154
H1|chr15:95640957-95641038,chr15,95640957,95641038,H1|chr15:93614880-93614904,chr15,93614880,93614904,0,2026077
H1|chr15:95832289-95832351,chr15,95832289,95832351,H1|chr15:93611855-93611984,chr15,93611855,93611984,0,2220434
H1|chr15:96138215-96138365,chr15,96138215,96138365,H1|chr15:78631437-78631471,chr15,78631437,78631471,0,17506778
H1|chr15:96237939-96238010,chr15,96237939,96238010,H1|chr15:70386282-70386311,chr15,70386282,70386311,0,25851657
H1|chr15:96907465-96907504,chr15,96907465,96907504,H1|chr15:64993636-64993741,chr15,64993636,64993741,0,31913829
H1|chr15:97197312-97197411,chr15,97197312,97197411,H1|chr15:89160331-89160381,chr15,89160331,89160381,0,8036981
H1|chr15:97227607-97227686,chr15,97227607,97227686,H1|chr15:89161319-89161400,chr15,89161319,89161400,0,8066288
H1|chr15:97232251-97232400,chr15,97232251,97232400,H1|chr15:28566824-28566974,chr15,28566824,28566974,0,68665427
H1|chr15:97497986-97498038,chr15,97497986,97498038,H1|chr15:65122295-65122392,chr15,65122295,65122392,0,32375691
H1|chr15:97817446-97817477,chr15,97817446,97817477,H1|chr15:68522617-68522658,chr15,68522617,68522658,0,29294829
H1|chr15:98412163-98412232,chr15,98412163,98412232,H1|chr15:89161319-89161400,chr15,89161319,89161400,0,9250844
H1|chr15:98633200-98633227,chr15,98633200,98633227,H1|chr15:89441345-89441461,chr15,89441345,89441461,0,9191855
H1|chr15:98721852-98722002,chr15,98721852,98722002,H1|chr15:28566896-28567046,chr15,28566896,28567046,0,70154956
H1|chr15:98858932-98859001,chr15,98858932,98859001,H1|chr15:93427205-93427273,chr15,93427205,93427273,0,5431727
H1|chr15:99308675-99308713,chr15,99308675,99308713,H1|chr15:34634867-34634979,chr15,34634867,34634979,0,64673808
H1|chr15:99780176-99780211,chr15,99780176,99780211,H1|chr15:99191860-99192005,chr15,99191860,99192005,0,588316
H1|chr15:100375917-100375972,chr15,100375917,100375972,H1|chr15:25202011-25202058,chr15,25202011,25202058,0,75173906
H1|chr15:100381280-100381429,chr15,100381280,100381429,H1|chr15:74392546-74392562,chr15,74392546,74392562,0,25988734
H1|chr15:100720534-100720572,chr15,100720534,100720572,H1|chr15:41625209-41625321,chr15,41625209,41625321,0,59095325
H1|chr15:100995256-100995325,chr15,100995256,100995325,H1|chr15:53082829-53082962,chr15,53082829,53082962,0,47912427
H1|chr15:101663900-101663918,chr15,101663900,101663918,H1|chr15:78627781-78627890,chr15,78627781,78627890,0,23036119
H1|chr15:102229965-102230039,chr15,102229965,102230039,H1|chr15:99191845-99191884,chr15,99191845,99191884,0,3038120
H1|chr15:102322292-102322382,chr15,102322292,102322382,H1|chr15:53086262-53086320,chr15,53086262,53086320,0,49236030
H1|chr16:5215-5311,chr16,5215,5311,H1|chr16:88867827-88867862,chr16,88867827,88867862,0,88862612
H1|chr16:253731-253798,chr16,253731,253798,H1|chr16:85642004-85642043,chr16,85642004,85642043,0,85388273
H1|chr16:254953-255074,chr16,254953,255074,H1|chr16:85640492-85640542,chr16,85640492,85640542,0,85385539
H1|chr16:317270-317420,chr16,317270,317420,H1|chr16:9055783-9055816,chr16,9055783,9055816,0,8738513
H1|chr16:506227-506284,chr16,506227,506284,H1|chr16:9769469-9769545,chr16,9769469,9769545,0,9263242
H1|chr16:549012-549148,chr16,549012,549148,H1|chr16:791407-791428,chr16,791407,791428,0,242395
H1|chr16:651298-651425,chr16,651298,651425,H1|chr16:89270709-89270757,chr16,89270709,89270757,0,88619411
H1|chr16:657671-657722,chr16,657671,657722,H1|chr16:89284321-89284384,chr16,89284321,89284384,0,88626650
H1|chr16:912772-912822,chr16,912772,912822,H1|chr16:3092276-3092369,chr16,3092276,3092369,0,2179504
H1|chr16:913619-913650,chr16,913619,913650,H1|chr16:9774303-9774422,chr16,9774303,9774422,0,8860684
H1|chr16:1083020-1083091,chr16,1083020,1083091,H1|chr16:90088131-90088160,chr16,90088131,90088160,0,89005111
H1|chr16:1292926-1293042,chr16,1292926,1293042,H1|chr16:2179585-2179720,chr16,2179585,2179720,0,886659
H1|chr16:1359377-1359401,chr16,1359377,1359401,H1|chr16:4324372-4324426,chr16,4324372,4324426,0,2964995
H1|chr16:1391670-1391782,chr16,1391670,1391782,H1|chr16:58663074-58663110,chr16,58663074,58663110,0,57271404
H1|chr16:1470498-1470636,chr16,1470498,1470636,H1|chr16:18937861-18937990,chr16,18937861,18937990,0,17467363
H1|chr16:1538779-1538887,chr16,1538779,1538887,H1|chr16:9774036-9774127,chr16,9774036,9774127,0,8235257
H1|chr16:1650229-1650379,chr16,1650229,1650379,H1|chr16:18937922-18937978,chr16,18937922,18937978,0,17287693
H1|chr16:1712422-1712539,chr16,1712422,1712539,H1|chr16:23606457-23606489,chr16,23606457,23606489,0,21894035
H1|chr16:1713303-1713389,chr16,1713303,1713389,H1|chr16:84731056-84731120,chr16,84731056,84731120,0,83017753
H1|chr16:2011923-2012016,chr16,2011923,2012016,H1|chr16:89628853-89628889,chr16,89628853,89628889,0,87616930
H1|chr16:2066118-2066135,chr16,2066118,2066135,H1|chr16:3011383-3011520,chr16,3011383,3011520,0,945265
H1|chr16:2125165-2125196,chr16,2125165,2125196,H1|chr16:87899446-87899592,chr16,87899446,87899592,0,85774281
H1|chr16:2283627-2283658,chr16,2283627,2283658,H1|chr16:89285021-89285140,chr16,89285021,89285140,0,87001394
H1|chr16:2460660-2460678,chr16,2460660,2460678,H1|chr16:70559260-70559410,chr16,70559260,70559410,0,68098600
H1|chr16:2608989-2609102,chr16,2608989,2609102,H1|chr16:277677-277711,chr16,277677,277711,0,2331312
H1|chr16:2740250-2740331,chr16,2740250,2740331,H1|chr16:70561853-70561922,chr16,70561853,70561922,0,67821603
H1|chr16:2927862-2927961,chr16,2927862,2927961,H1|chr16:85644379-85644395,chr16,85644379,85644395,0,82716517
H1|chr16:3322462-3322551,chr16,3322462,3322551,H1|chr16:18937922-18937983,chr16,18937922,18937983,0,15615460
H1|chr16:3376182-3376216,chr16,3376182,3376216,H1|chr16:89781197-89781347,chr16,89781197,89781347,0,86405015
H1|chr16:3546640-3546749,chr16,3546640,3546749,H1|chr16:3356478-3356594,chr16,3356478,3356594,0,190162
H1|chr16:3558162-3558241,chr16,3558162,3558241,H1|chr16:84729828-84729856,chr16,84729828,84729856,0,81171666
H1|chr16:3870636-3870695,chr16,3870636,3870695,H1|chr16:11759670-11759727,chr16,11759670,11759727,0,7889034
H1|chr16:3916466-3916547,chr16,3916466,3916547,H1|chr16:1355098-1355167,chr16,1355098,1355167,0,2561368
H1|chr16:4020892-4021041,chr16,4020892,4021041,H1|chr16:18937922-18937988,chr16,18937922,18937988,0,14917030
H1|chr16:4143852-4143983,chr16,4143852,4143983,H1|chr16:85642804-85642884,chr16,85642804,85642884,0,81498952
H1|chr16:4170529-4170611,chr16,4170529,4170611,H1|chr16:88491214-88491280,chr16,88491214,88491280,0,84320685
H1|chr16:4184216-4184366,chr16,4184216,4184366,H1|chr16:9772181-9772299,chr16,9772181,9772299,0,5587965
H1|chr16:4254082-4254123,chr16,4254082,4254123,H1|chr16:89781171-89781279,chr16,89781171,89781279,0,85527089
H1|chr16:4257453-4257523,chr16,4257453,4257523,H1|chr16:48643495-48643560,chr16,48643495,48643560,0,44386042
H1|chr16:4386319-4386357,chr16,4386319,4386357,H1|chr16:85643378-85643421,chr16,85643378,85643421,0,81257059
H1|chr16:4487241-4487306,chr16,4487241,4487306,H1|chr16:9057330-9057361,chr16,9057330,9057361,0,4570089
H1|chr16:4596673-4596714,chr16,4596673,4596714,H1|chr16:87899143-87899287,chr16,87899143,87899287,0,83302470
H1|chr16:4634419-4634505,chr16,4634419,4634505,H1|chr16:9769579-9769643,chr16,9769579,9769643,0,5135160
H1|chr16:4899174-4899209,chr16,4899174,4899209,H1|chr16:14727639-14727683,chr16,14727639,14727683,0,9828465
H1|chr16:5277877-5277942,chr16,5277877,5277942,H1|chr16:89886407-89886518,chr16,89886407,89886518,0,84608530
H1|chr16:5376911-5377004,chr16,5376911,5377004,H1|chr16:31465883-31465940,chr16,31465883,31465940,0,26088972
H1|chr16:5489781-5489808,chr16,5489781,5489808,H1|chr16:31467472-31467622,chr16,31467472,31467622,0,25977691
H1|chr16:5587707-5587789,chr16,5587707,5587789,H1|chr16:67967239-67967282,chr16,67967239,67967282,0,62379532
H1|chr16:5675762-5675794,chr16,5675762,5675794,H1|chr16:85642667-85642770,chr16,85642667,85642770,0,79966905
H1|chr16:5745117-5745191,chr16,5745117,5745191,H1|chr16:56717553-56717608,chr16,56717553,56717608,0,50972436
H1|chr16:5824094-5824140,chr16,5824094,5824140,H1|chr16:31713415-31713486,chr16,31713415,31713486,0,25889321
H1|chr16:5857596-5857701,chr16,5857596,5857701,H1|chr16:18937861-18938001,chr16,18937861,18938001,0,13080265
H1|chr16:5932807-5932863,chr16,5932807,5932863,H1|chr16:2179530-2179613,chr16,2179530,2179613,0,3753277
H1|chr16:5963182-5963221,chr16,5963182,5963221,H1|chr16:9773048-9773147,chr16,9773048,9773147,0,3809866
H1|chr16:6169305-6169376,chr16,6169305,6169376,H1|chr16:48643495-48643560,chr16,48643495,48643560,0,42474190
H1|chr16:6226620-6226719,chr16,6226620,6226719,H1|chr16:88867827-88867862,chr16,88867827,88867862,0,82641207
H1|chr16:6420577-6420727,chr16,6420577,6420727,H1|chr16:89779669-89779721,chr16,89779669,89779721,0,83359092
H1|chr16:6473692-6473709,chr16,6473692,6473709,H1|chr16:3146950-3147069,chr16,3146950,3147069,0,3326742
H1|chr16:6490908-6490950,chr16,6490908,6490950,H1|chr16:89781171-89781279,chr16,89781171,89781279,0,83290263
H1|chr16:6610458-6610516,chr16,6610458,6610516,H1|chr16:31467207-31467339,chr16,31467207,31467339,0,24856749
H1|chr16:6613097-6613181,chr16,6613097,6613181,H1|chr16:3084473-3084539,chr16,3084473,3084539,0,3528624
H1|chr16:6720247-6720397,chr16,6720247,6720397,H1|chr16:87899079-87899229,chr16,87899079,87899229,0,81178832
H1|chr16:6855797-6855947,chr16,6855797,6855947,H1|chr16:3449191-3449268,chr16,3449191,3449268,0,3406606
H1|chr16:7281358-7281445,chr16,7281358,7281445,H1|chr16:9769534-9769591,chr16,9769534,9769591,0,2488176
H1|chr16:7487507-7487657,chr16,7487507,7487657,H1|chr16:87899087-87899234,chr16,87899087,87899234,0,80411580
H1|chr16:7541156-7541236,chr16,7541156,7541236,H1|chr16:68878235-68878302,chr16,68878235,68878302,0,61337079
H1|chr16:7593193-7593281,chr16,7593193,7593281,H1|chr16:18937900-18938014,chr16,18937900,18938014,0,11344707
H1|chr16:7633173-7633199,chr16,7633173,7633199,H1|chr16:9775661-9775725,chr16,9775661,9775725,0,2142488
H1|chr16:7680524-7680588,chr16,7680524,7680588,H1|chr16:9768427-9768525,chr16,9768427,9768525,0,2087903
H1|chr16:8010931-8011062,chr16,8010931,8011062,H1|chr16:1757271-1757290,chr16,1757271,1757290,0,6253660
H1|chr16:8102628-8102680,chr16,8102628,8102680,H1|chr16:68776073-68776109,chr16,68776073,68776109,0,60673445
H1|chr16:8395590-8395691,chr16,8395590,8395691,H1|chr16:68679845-68679887,chr16,68679845,68679887,0,60284255
H1|chr16:8534504-8534654,chr16,8534504,8534654,H1|chr16:9769552-9769620,chr16,9769552,9769620,0,1235048
H1|chr16:8555524-8555556,chr16,8555524,8555556,H1|chr16:9772806-9772869,chr16,9772806,9772869,0,1217282
H1|chr16:8786116-8786147,chr16,8786116,8786147,H1|chr16:9774303-9774422,chr16,9774303,9774422,0,988187
H1|chr16:8963153-8963240,chr16,8963153,8963240,H1|chr16:9769534-9769591,chr16,9769534,9769591,0,806381
H1|chr16:9063663-9063727,chr16,9063663,9063727,H1|chr16:9768427-9768525,chr16,9768427,9768525,0,704764
H1|chr16:9067388-9067538,chr16,9067388,9067538,H1|chr16:1757271-1757290,chr16,1757271,1757290,0,7310117
H1|chr16:9222086-9222114,chr16,9222086,9222114,H1|chr16:791546-791622,chr16,791546,791622,0,8430540
H1|chr16:9254782-9254852,chr16,9254782,9254852,H1|chr16:2733066-2733131,chr16,2733066,2733131,0,6521716
H1|chr16:9292361-9292511,chr16,9292361,9292511,H1|chr16:87899046-87899196,chr16,87899046,87899196,0,78606685
H1|chr16:9377822-9377883,chr16,9377822,9377883,H1|chr16:25273836-25273874,chr16,25273836,25273874,0,15896014
H1|chr16:9437416-9437456,chr16,9437416,9437456,H1|chr16:85645514-85645601,chr16,85645514,85645601,0,76208098
H1|chr16:9663676-9663711,chr16,9663676,9663711,H1|chr16:85642440-85642496,chr16,85642440,85642496,0,75978764
H1|chr16:9855961-9855998,chr16,9855961,9855998,H1|chr16:31464819-31464912,chr16,31464819,31464912,0,21608858
H1|chr16:9865668-9865717,chr16,9865668,9865717,H1|chr16:4900256-4900321,chr16,4900256,4900321,0,4965412
H1|chr16:10057998-10058069,chr16,10057998,10058069,H1|chr16:84734340-84734384,chr16,84734340,84734384,0,74676342
H1|chr16:10134280-10134349,chr16,10134280,10134349,H1|chr16:3072408-3072484,chr16,3072408,3072484,0,7061872
H1|chr16:10146204-10146354,chr16,10146204,10146354,H1|chr16:88870774-88870799,chr16,88870774,88870799,0,78724570
H1|chr16:10213714-10213825,chr16,10213714,10213825,H1|chr16:31467511-31467622,chr16,31467511,31467622,0,21253797
H1|chr16:10245929-10246029,chr16,10245929,10246029,H1|chr16:85644379-85644395,chr16,85644379,85644395,0,75398450
H1|chr16:10247005-10247145,chr16,10247005,10247145,H1|chr16:67968904-67969024,chr16,67968904,67969024,0,57721899
H1|chr16:10334133-10334280,chr16,10334133,10334280,H1|chr16:15187570-15187720,chr16,15187570,15187720,0,4853437
H1|chr16:10336925-10336999,chr16,10336925,10336999,H1|chr16:18937946-18938025,chr16,18937946,18938025,0,8601021
H1|chr16:10767372-10767465,chr16,10767372,10767465,H1|chr16:31465883-31465940,chr16,31465883,31465940,0,20698511
H1|chr16:10787526-10787625,chr16,10787526,10787625,H1|chr16:88867824-88867862,chr16,88867824,88867862,0,78080298
H1|chr16:10941968-10942006,chr16,10941968,10942006,H1|chr16:3013378-3013442,chr16,3013378,3013442,0,7928590
H1|chr16:10977004-10977064,chr16,10977004,10977064,H1|chr16:3175050-3175097,chr16,3175050,3175097,0,7801954
H1|chr16:11076646-11076680,chr16,11076646,11076680,H1|chr16:8956577-8956674,chr16,8956577,8956674,0,2120069
H1|chr16:11115582-11115732,chr16,11115582,11115732,H1|chr16:9771916-9771956,chr16,9771916,9771956,0,1343666
H1|chr16:11131224-11131306,chr16,11131224,11131306,H1|chr16:89779669-89779721,chr16,89779669,89779721,0,78648445
H1|chr16:11260924-11261074,chr16,11260924,11261074,H1|chr16:87899047-87899194,chr16,87899047,87899194,0,76638123
H1|chr16:11398577-11398673,chr16,11398577,11398673,H1|chr16:19730380-19730484,chr16,19730380,19730484,0,8331803
H1|chr16:11550969-11551024,chr16,11550969,11551024,H1|chr16:85640482-85640574,chr16,85640482,85640574,0,74089513
H1|chr16:11659920-11659963,chr16,11659920,11659963,H1|chr16:788787-788881,chr16,788787,788881,0,10871133
H1|chr16:11688961-11688987,chr16,11688961,11688987,H1|chr16:67968904-67969024,chr16,67968904,67969024,0,56279943
H1|chr16:11753774-11753840,chr16,11753774,11753840,H1|chr16:9774407-9774446,chr16,9774407,9774446,0,1979367
H1|chr16:11762969-11763027,chr16,11762969,11763027,H1|chr16:31467207-31467339,chr16,31467207,31467339,0,19704238
H1|chr16:11814167-11814193,chr16,11814167,11814193,H1|chr16:794586-794710,chr16,794586,794710,0,11019581
H1|chr16:11943914-11943964,chr16,11943914,11943964,H1|chr16:3092276-3092369,chr16,3092276,3092369,0,8851638
H1|chr16:11963790-11963870,chr16,11963790,11963870,H1|chr16:68878235-68878302,chr16,68878235,68878302,0,56914445
H1|chr16:12055600-12055664,chr16,12055600,12055664,H1|chr16:84734486-84734548,chr16,84734486,84734548,0,72678886
H1|chr16:12137220-12137301,chr16,12137220,12137301,H1|chr16:31126890-31126942,chr16,31126890,31126942,0,18989670
H1|chr16:12301345-12301390,chr16,12301345,12301390,H1|chr16:4321699-4321787,chr16,4321699,4321787,0,7979646
H1|chr16:12368960-12369085,chr16,12368960,12369085,H1|chr16:87899717-87899843,chr16,87899717,87899843,0,75530757
H1|chr16:12406064-12406163,chr16,12406064,12406163,H1|chr16:85644379-85644395,chr16,85644379,85644395,0,73238315
H1|chr16:12478698-12478786,chr16,12478698,12478786,H1|chr16:85642737-85642800,chr16,85642737,85642800,0,73164039
H1|chr16:12504909-12504994,chr16,12504909,12504994,H1|chr16:89786676-89786712,chr16,89786676,89786712,0,77281767
H1|chr16:12894827-12894899,chr16,12894827,12894899,H1|chr16:48637648-48637721,chr16,48637648,48637721,0,35742821
H1|chr16:13062142-13062215,chr16,13062142,13062215,H1|chr16:85644730-85644807,chr16,85644730,85644807,0,72582588
H1|chr16:13100717-13100764,chr16,13100717,13100764,H1|chr16:31467541-31467691,chr16,31467541,31467691,0,18366824
H1|chr16:13152867-13152995,chr16,13152867,13152995,H1|chr16:9775607-9775661,chr16,9775607,9775661,0,3377260
H1|chr16:13634202-13634282,chr16,13634202,13634282,H1|chr16:56717553-56717608,chr16,56717553,56717608,0,43083351
H1|chr16:13666753-13666866,chr16,13666753,13666866,H1|chr16:9775235-9775285,chr16,9775235,9775285,0,3891518
H1|chr16:13703964-13704048,chr16,13703964,13704048,H1|chr16:89284913-89285019,chr16,89284913,89285019,0,75580949
H1|chr16:13716748-13716807,chr16,13716748,13716807,H1|chr16:88728875-88728963,chr16,88728875,88728963,0,75012127
H1|chr16:13943211-13943295,chr16,13943211,13943295,H1|chr16:3083623-3083687,chr16,3083623,3083687,0,10859588
H1|chr16:14154251-14154322,chr16,14154251,14154322,H1|chr16:67971048-67971108,chr16,67971048,67971108,0,53816797
H1|chr16:14236826-14236976,chr16,14236826,14236976,H1|chr16:31467501-31467631,chr16,31467501,31467631,0,17230675
H1|chr16:14306022-14306081,chr16,14306022,14306081,H1|chr16:88728875-88728963,chr16,88728875,88728963,0,74422853
H1|chr16:14344464-14344506,chr16,14344464,14344506,H1|chr16:8961775-8961919,chr16,8961775,8961919,0,5382689
H1|chr16:14465599-14465691,chr16,14465599,14465691,H1|chr16:88491214-88491280,chr16,88491214,88491280,0,74025615
H1|chr16:14531229-14531351,chr16,14531229,14531351,H1|chr16:88491214-88491273,chr16,88491214,88491273,0,73959985
H1|chr16:14556793-14556833,chr16,14556793,14556833,H1|chr16:67228423-67228461,chr16,67228423,67228461,0,52671630
H1|chr16:14586858-14586938,chr16,14586858,14586938,H1|chr16:690416-690531,chr16,690416,690531,0,13896442
H1|chr16:14787248-14787303,chr16,14787248,14787303,H1|chr16:285620-285727,chr16,285620,285727,0,14501628
H1|chr16:14854488-14854615,chr16,14854488,14854615,H1|chr16:4396071-4396094,chr16,4396071,4396094,0,10458417
H1|chr16:14928460-14928573,chr16,14928460,14928573,H1|chr16:89272075-89272112,chr16,89272075,89272112,0,74343615
H1|chr16:14990965-14991032,chr16,14990965,14991032,H1|chr16:68772531-68772607,chr16,68772531,68772607,0,53781566
H1|chr16:15018981-15019005,chr16,15018981,15019005,H1|chr16:58662800-58662921,chr16,58662800,58662921,0,43643819
H1|chr16:15166556-15166622,chr16,15166556,15166622,H1|chr16:9768701-9768759,chr16,9768701,9768759,0,5397855
H1|chr16:15286659-15286758,chr16,15286659,15286758,H1|chr16:88867824-88867862,chr16,88867824,88867862,0,73581165
H1|chr16:15395040-15395146,chr16,15395040,15395146,H1|chr16:25117081-25117118,chr16,25117081,25117118,0,9722041
H1|chr16:15395191-15395223,chr16,15395191,15395223,H1|chr16:9772181-9772299,chr16,9772181,9772299,0,5623010
H1|chr16:15624411-15624460,chr16,15624411,15624460,H1|chr16:2178832-2178904,chr16,2178832,2178904,0,13445579
H1|chr16:15718522-15718602,chr16,15718522,15718602,H1|chr16:31467477-31467582,chr16,31467477,31467582,0,15748955
H1|chr16:15725321-15725471,chr16,15725321,15725471,H1|chr16:9769552-9769620,chr16,9769552,9769620,0,5955769
H1|chr16:15727430-15727482,chr16,15727430,15727482,H1|chr16:2182857-2182922,chr16,2182857,2182922,0,13544573
H1|chr16:15913136-15913169,chr16,15913136,15913169,H1|chr16:85644775-85644807,chr16,85644775,85644807,0,69731639
H1|chr16:15939321-15939402,chr16,15939321,15939402,H1|chr16:85641849-85641989,chr16,85641849,85641989,0,69702528
H1|chr16:16283115-16283185,chr16,16283115,16283185,H1|chr16:48643495-48643560,chr16,48643495,48643560,0,32360380
H1|chr16:16444701-16444842,chr16,16444701,16444842,H1|chr16:67968904-67969024,chr16,67968904,67969024,0,51524203
H1|chr16:16493384-16493505,chr16,16493384,16493505,H1|chr16:85640492-85640542,chr16,85640492,85640542,0,69147108
H1|chr16:16532845-16532968,chr16,16532845,16532968,H1|chr16:31467029-31467062,chr16,31467029,31467062,0,14934184
H1|chr16:16603192-16603285,chr16,16603192,16603285,H1|chr16:9770171-9770214,chr16,9770171,9770214,0,6833021
H1|chr16:16652888-16652968,chr16,16652888,16652968,H1|chr16:9772051-9772162,chr16,9772051,9772162,0,6880837
H1|chr16:16688117-16688189,chr16,16688117,16688189,H1|chr16:2182659-2182709,chr16,2182659,2182709,0,14505458
H1|chr16:16738516-16738600,chr16,16738516,16738600,H1|chr16:3073657-3073720,chr16,3073657,3073720,0,13664859
H1|chr16:17196943-17197054,chr16,17196943,17197054,H1|chr16:3013685-3013716,chr16,3013685,3013716,0,14183258
H1|chr16:17220460-17220570,chr16,17220460,17220570,H1|chr16:9774036-9774127,chr16,9774036,9774127,0,7446424
H1|chr16:17256439-17256577,chr16,17256439,17256577,H1|chr16:18937861-18937974,chr16,18937861,18937974,0,1681422
H1|chr16:17336780-17336817,chr16,17336780,17336817,H1|chr16:9058500-9058526,chr16,9058500,9058526,0,8278280
H1|chr16:17432135-17432234,chr16,17432135,17432234,H1|chr16:74699759-74699784,chr16,74699759,74699784,0,57267624
H1|chr16:17621719-17621780,chr16,17621719,17621780,H1|chr16:25120399-25120453,chr16,25120399,25120453,0,7498680
H1|chr16:17705106-17705176,chr16,17705106,17705176,H1|chr16:85641456-85641534,chr16,85641456,85641534,0,67936350
H1|chr16:18092388-18092471,chr16,18092388,18092471,H1|chr16:9768494-9768558,chr16,9768494,9768558,0,8323894
H1|chr16:18101160-18101232,chr16,18101160,18101232,H1|chr16:793208-793283,chr16,793208,793283,0,17307952
H1|chr16:18426535-18426660,chr16,18426535,18426660,H1|chr16:85647575-85647605,chr16,85647575,85647605,0,67221040
H1|chr16:18488694-18488778,chr16,18488694,18488778,H1|chr16:31466043-31466109,chr16,31466043,31466109,0,12977349
H1|chr16:18561627-18561721,chr16,18561627,18561721,H1|chr16:85642917-85643028,chr16,85642917,85643028,0,67081290
H1|chr16:18700595-18700628,chr16,18700595,18700628,H1|chr16:4520530-4520580,chr16,4520530,4520580,0,14180065
H1|chr16:18757170-18757201,chr16,18757170,18757201,H1|chr16:9770108-9770185,chr16,9770108,9770185,0,8987062
H1|chr16:18881788-18881905,chr16,18881788,18881905,H1|chr16:9055783-9055816,chr16,9055783,9055816,0,9826005
H1|chr16:19155381-19155531,chr16,19155381,19155531,H1|chr16:87899037-87899185,chr16,87899037,87899185,0,68743656
H1|chr16:19368745-19368837,chr16,19368745,19368837,H1|chr16:3062267-3062313,chr16,3062267,3062313,0,16306478
H1|chr16:19465790-19465841,chr16,19465790,19465841,H1|chr16:31465010-31465039,chr16,31465010,31465039,0,11999220
H1|chr16:20028307-20028400,chr16,20028307,20028400,H1|chr16:89270852-89270907,chr16,89270852,89270907,0,69242545
H1|chr16:20080090-20080144,chr16,20080090,20080144,H1|chr16:31467556-31467647,chr16,31467556,31467647,0,11387466
H1|chr16:20090606-20090640,chr16,20090606,20090640,H1|chr16:8956577-8956674,chr16,8956577,8956674,0,11134029
H1|chr16:20226963-20227010,chr16,20226963,20227010,H1|chr16:23520325-23520409,chr16,23520325,23520409,0,3293362
H1|chr16:20451244-20451328,chr16,20451244,20451328,H1|chr16:3083623-3083687,chr16,3083623,3083687,0,17367621
H1|chr16:20491156-20491190,chr16,20491156,20491190,H1|chr16:31467477-31467582,chr16,31467477,31467582,0,10976321
H1|chr16:20506783-20506888,chr16,20506783,20506888,H1|chr16:3083476-3083510,chr16,3083476,3083510,0,17423307
H1|chr16:20547847-20547927,chr16,20547847,20547927,H1|chr16:31467477-31467582,chr16,31467477,31467582,0,10919630
H1|chr16:20783303-20783366,chr16,20783303,20783366,H1|chr16:9769317-9769367,chr16,9769317,9769367,0,11013986
H1|chr16:20970378-20970466,chr16,20970378,20970466,H1|chr16:85642737-85642800,chr16,85642737,85642800,0,64672359
H1|chr16:20999235-20999321,chr16,20999235,20999321,H1|chr16:31465014-31465040,chr16,31465014,31465040,0,10465779
H1|chr16:21084054-21084202,chr16,21084054,21084202,H1|chr16:85648383-85648418,chr16,85648383,85648418,0,64564329
H1|chr16:21109481-21109523,chr16,21109481,21109523,H1|chr16:14726925-14727033,chr16,14726925,14727033,0,6382556
H1|chr16:21138716-21138752,chr16,21138716,21138752,H1|chr16:31467965-31468020,chr16,31467965,31468020,0,10329249
H1|chr16:21217521-21217633,chr16,21217521,21217633,H1|chr16:58663074-58663110,chr16,58663074,58663110,0,37445553
H1|chr16:21259025-21259120,chr16,21259025,21259120,H1|chr16:89782798-89782845,chr16,89782798,89782845,0,68523773
H1|chr16:21324016-21324049,chr16,21324016,21324049,H1|chr16:4520530-4520580,chr16,4520530,4520580,0,16803486
H1|chr16:21493355-21493387,chr16,21493355,21493387,H1|chr16:85642667-85642770,chr16,85642667,85642770,0,64149312
H1|chr16:21543913-21544061,chr16,21543913,21544061,H1|chr16:18937861-18937990,chr16,18937861,18937990,0,2606052
H1|chr16:21566845-21566926,chr16,21566845,21566926,H1|chr16:89284321-89284384,chr16,89284321,89284384,0,67717476
H1|chr16:21639343-21639374,chr16,21639343,21639374,H1|chr16:23604006-23604156,chr16,23604006,23604156,0,1964663
H1|chr16:21799905-21799949,chr16,21799905,21799949,H1|chr16:4321699-4321787,chr16,4321699,4321787,0,17478206
H1|chr16:21897666-21897768,chr16,21897666,21897768,H1|chr16:85640924-85640943,chr16,85640924,85640943,0,63743258
H1|chr16:21911557-21911596,chr16,21911557,21911596,H1|chr16:85642917-85643028,chr16,85642917,85643028,0,63731360
H1|chr16:22009974-22010045,chr16,22009974,22010045,H1|chr16:67971048-67971108,chr16,67971048,67971108,0,45961074
H1|chr16:22040637-22040766,chr16,22040637,22040766,H1|chr16:58663074-58663110,chr16,58663074,58663110,0,36622437
H1|chr16:22203188-22203272,chr16,22203188,22203272,H1|chr16:89285398-89285437,chr16,89285398,89285437,0,67082210
H1|chr16:22353493-22353515,chr16,22353493,22353515,H1|chr16:69365950-69366057,chr16,69365950,69366057,0,47012457
H1|chr16:22484064-22484103,chr16,22484064,22484103,H1|chr16:3035319-3035356,chr16,3035319,3035356,0,19448745
H1|chr16:22556397-22556441,chr16,22556397,22556441,H1|chr16:788787-788881,chr16,788787,788881,0,21767610
H1|chr16:22559493-22559640,chr16,22559493,22559640,H1|chr16:1355098-1355167,chr16,1355098,1355167,0,21204395
H1|chr16:22653485-22653552,chr16,22653485,22653552,H1|chr16:3031531-3031579,chr16,3031531,3031579,0,19621954
H1|chr16:22763463-22763607,chr16,22763463,22763607,H1|chr16:87899050-87899200,chr16,87899050,87899200,0,65135587
H1|chr16:22776503-22776535,chr16,22776503,22776535,H1|chr16:9772806-9772869,chr16,9772806,9772869,0,13003697
H1|chr16:23139524-23139598,chr16,23139524,23139598,H1|chr16:1355100-1355166,chr16,1355100,1355166,0,21784424
H1|chr16:23165138-23165233,chr16,23165138,23165233,H1|chr16:89270709-89270757,chr16,89270709,89270757,0,66105571
H1|chr16:23165488-23165539,chr16,23165488,23165539,H1|chr16:2288981-2289080,chr16,2288981,2289080,0,20876507
H1|chr16:23277195-23277279,chr16,23277195,23277279,H1|chr16:3073657-3073720,chr16,3073657,3073720,0,20203538
H1|chr16:23554569-23554605,chr16,23554569,23554605,H1|chr16:31467965-31468020,chr16,31467965,31468020,0,7913396
H1|chr16:23561492-23561575,chr16,23561492,23561575,H1|chr16:84730939-84731003,chr16,84730939,84731003,0,61169447
H1|chr16:23607130-23607235,chr16,23607130,23607235,H1|chr16:18937861-18938001,chr16,18937861,18938001,0,4669269
H1|chr16:23784059-23784092,chr16,23784059,23784092,H1|chr16:85644775-85644807,chr16,85644775,85644807,0,61860716
H1|chr16:23795064-23795082,chr16,23795064,23795082,H1|chr16:31467207-31467339,chr16,31467207,31467339,0,7672143
H1|chr16:23896749-23896782,chr16,23896749,23896782,H1|chr16:8958162-8958291,chr16,8958162,8958291,0,14938587
H1|chr16:24042982-24043099,chr16,24042982,24043099,H1|chr16:9055783-9055816,chr16,9055783,9055816,0,14987199
H1|chr16:24052067-24052212,chr16,24052067,24052212,H1|chr16:85646134-85646208,chr16,85646134,85646208,0,61594067
H1|chr16:24218531-24218604,chr16,24218531,24218604,H1|chr16:3449191-3449268,chr16,3449191,3449268,0,20769340
H1|chr16:24267239-24267354,chr16,24267239,24267354,H1|chr16:2183080-2183120,chr16,2183080,2183120,0,22084159
H1|chr16:24314515-24314588,chr16,24314515,24314588,H1|chr16:31467493-31467566,chr16,31467493,31467566,0,7152978
H1|chr16:24334692-24334756,chr16,24334692,24334756,H1|chr16:19724238-19724307,chr16,19724238,19724307,0,4610454
H1|chr16:24680885-24681035,chr16,24680885,24681035,H1|chr16:87902223-87902373,chr16,87902223,87902373,0,63221338
H1|chr16:24847605-24847654,chr16,24847605,24847654,H1|chr16:2178832-2178904,chr16,2178832,2178904,0,22668773
H1|chr16:24949350-24949495,chr16,24949350,24949495,H1|chr16:85646134-85646208,chr16,85646134,85646208,0,60696784
H1|chr16:25053497-25053564,chr16,25053497,25053564,H1|chr16:68772531-68772607,chr16,68772531,68772607,0,43719034
H1|chr16:25055532-25055555,chr16,25055532,25055555,H1|chr16:31467554-31467704,chr16,31467554,31467704,0,6412022
H1|chr16:25164852-25164894,chr16,25164852,25164894,H1|chr16:89781171-89781279,chr16,89781171,89781279,0,64616319
H1|chr16:25187182-25187230,chr16,25187182,25187230,H1|chr16:8960236-8960324,chr16,8960236,8960324,0,16226946
H1|chr16:25214912-25214975,chr16,25214912,25214975,H1|chr16:9769317-9769367,chr16,9769317,9769367,0,15445595
H1|chr16:25448582-25448609,chr16,25448582,25448609,H1|chr16:31467472-31467622,chr16,31467472,31467622,0,6018890
H1|chr16:25467296-25467382,chr16,25467296,25467382,H1|chr16:84731056-84731120,chr16,84731056,84731120,0,59263760
H1|chr16:25483311-25483332,chr16,25483311,25483332,H1|chr16:4324446-4324596,chr16,4324446,4324596,0,21158865
H1|chr16:25706186-25706229,chr16,25706186,25706229,H1|chr16:57516105-57516243,chr16,57516105,57516243,0,31809919
H1|chr16:25941759-25941837,chr16,25941759,25941837,H1|chr16:18937922-18937988,chr16,18937922,18937988,0,7003837
H1|chr16:26290367-26290498,chr16,26290367,26290498,H1|chr16:85642804-85642884,chr16,85642804,85642884,0,59352437
H1|chr16:26306444-26306516,chr16,26306444,26306516,H1|chr16:85640453-85640531,chr16,85640453,85640531,0,59334009
H1|chr16:26468139-26468171,chr16,26468139,26468171,H1|chr16:87899170-87899287,chr16,87899170,87899287,0,61431031
H1|chr16:26478782-26478932,chr16,26478782,26478932,H1|chr16:9055783-9055816,chr16,9055783,9055816,0,17422999
H1|chr16:26745081-26745178,chr16,26745081,26745178,H1|chr16:68679845-68679887,chr16,68679845,68679887,0,41934764
H1|chr16:26796879-26796921,chr16,26796879,26796921,H1|chr16:794586-794710,chr16,794586,794710,0,26002293
H1|chr16:26826126-26826180,chr16,26826126,26826180,H1|chr16:31467556-31467647,chr16,31467556,31467647,0,4641430
H1|chr16:26858967-26859047,chr16,26858967,26859047,H1|chr16:84734340-84734384,chr16,84734340,84734384,0,57875373
H1|chr16:26901839-26901933,chr16,26901839,26901933,H1|chr16:18937922-18937978,chr16,18937922,18937978,0,7963917
H1|chr16:26979447-26979519,chr16,26979447,26979519,H1|chr16:31465892-31465917,chr16,31465892,31465917,0,4486445
H1|chr16:27096185-27096227,chr16,27096185,27096227,H1|chr16:14726925-14727033,chr16,14726925,14727033,0,12369260
H1|chr16:27150976-27151102,chr16,27150976,27151102,H1|chr16:89270709-89270757,chr16,89270709,89270757,0,62119733
H1|chr16:27231982-27232132,chr16,27231982,27232132,H1|chr16:87899046-87899196,chr16,87899046,87899196,0,60667064
H1|chr16:27282424-27282503,chr16,27282424,27282503,H1|chr16:84729828-84729856,chr16,84729828,84729856,0,57447404
H1|chr16:27336796-27336840,chr16,27336796,27336840,H1|chr16:788787-788881,chr16,788787,788881,0,26548009
H1|chr16:27401367-27401406,chr16,27401367,27401406,H1|chr16:9772051-9772162,chr16,9772051,9772162,0,17629316
H1|chr16:27426644-27426689,chr16,27426644,27426689,H1|chr16:31713414-31713455,chr16,31713414,31713455,0,4286770
H1|chr16:27505237-27505305,chr16,27505237,27505305,H1|chr16:75018565-75018596,chr16,75018565,75018596,0,47513328
H1|chr16:27534309-27534351,chr16,27534309,27534351,H1|chr16:9772577-9772642,chr16,9772577,9772642,0,17761732
H1|chr16:27818335-27818375,chr16,27818335,27818375,H1|chr16:67228423-67228461,chr16,67228423,67228461,0,39410088
H1|chr16:27956978-27957128,chr16,27956978,27957128,H1|chr16:4326380-4326433,chr16,4326380,4326433,0,23630598
H1|chr16:28403260-28403360,chr16,28403260,28403360,H1|chr16:9058500-9058526,chr16,9058500,9058526,0,19344760
H1|chr16:28427512-28427595,chr16,28427512,28427595,H1|chr16:31466116-31466183,chr16,31466116,31466183,0,3038604
H1|chr16:28576810-28576855,chr16,28576810,28576855,H1|chr16:8960236-8960324,chr16,8960236,8960324,0,19616574
H1|chr16:28634294-28634318,chr16,28634294,28634318,H1|chr16:67972359-67972444,chr16,67972359,67972444,0,39338065
H1|chr16:28953602-28953682,chr16,28953602,28953682,H1|chr16:85640908-85640929,chr16,85640908,85640929,0,56687306
H1|chr16:29154269-29154300,chr16,29154269,29154300,H1|chr16:9770108-9770185,chr16,9770108,9770185,0,19384161
H1|chr16:29164664-29164755,chr16,29164664,29164755,H1|chr16:85640453-85640531,chr16,85640453,85640531,0,56475789
H1|chr16:29172703-29172750,chr16,29172703,29172750,H1|chr16:67966644-67966747,chr16,67966644,67966747,0,38793941
H1|chr16:29194265-29194352,chr16,29194265,29194352,H1|chr16:31467657-31467720,chr16,31467657,31467720,0,2273392
H1|chr16:29218809-29218872,chr16,29218809,29218872,H1|chr16:56717613-56717695,chr16,56717613,56717695,0,27498804
H1|chr16:29236041-29236179,chr16,29236041,29236179,H1|chr16:18937861-18937990,chr16,18937861,18937990,0,10298180
H1|chr16:29514578-29514718,chr16,29514578,29514718,H1|chr16:2014046-2014147,chr16,2014046,2014147,0,27500532
H1|chr16:29540702-29540757,chr16,29540702,29540757,H1|chr16:85640482-85640574,chr16,85640482,85640574,0,56099780
H1|chr16:29653946-29654057,chr16,29653946,29654057,H1|chr16:2182997-2183120,chr16,2182997,2183120,0,27470949
H1|chr16:29840979-29841063,chr16,29840979,29841063,H1|chr16:18937922-18937976,chr16,18937922,18937976,0,10903057
H1|chr16:29857622-29857650,chr16,29857622,29857650,H1|chr16:75497675-75497742,chr16,75497675,75497742,0,45640053
H1|chr16:29872333-29872422,chr16,29872333,29872422,H1|chr16:11759786-11759816,chr16,11759786,11759816,0,18112547
H1|chr16:29963234-29963281,chr16,29963234,29963281,H1|chr16:23520325-23520409,chr16,23520325,23520409,0,6442909
H1|chr16:29986981-29987087,chr16,29986981,29987087,H1|chr16:2183054-2183108,chr16,2183054,2183108,0,27803927
H1|chr16:30120480-30120575,chr16,30120480,30120575,H1|chr16:85644410-85644462,chr16,85644410,85644462,0,55523930
H1|chr16:30281086-30281159,chr16,30281086,30281159,H1|chr16:85640908-85640985,chr16,85640908,85640985,0,55359822
H1|chr16:30310350-30310399,chr16,30310350,30310399,H1|chr16:90088131-90088160,chr16,90088131,90088160,0,59777781
H1|chr16:30461680-30461713,chr16,30461680,30461713,H1|chr16:87899170-87899287,chr16,87899170,87899287,0,57437490
H1|chr16:30507696-30507790,chr16,30507696,30507790,H1|chr16:4326380-4326433,chr16,4326380,4326433,0,26181316
H1|chr16:30520257-30520386,chr16,30520257,30520386,H1|chr16:791407-791428,chr16,791407,791428,0,29728850
H1|chr16:30596160-30596301,chr16,30596160,30596301,H1|chr16:2014046-2014147,chr16,2014046,2014147,0,28582114
H1|chr16:30644051-30644084,chr16,30644051,30644084,H1|chr16:8958162-8958291,chr16,8958162,8958291,0,21685889
H1|chr16:30664788-30664888,chr16,30664788,30664888,H1|chr16:58663074-58663111,chr16,58663074,58663111,0,27998286
H1|chr16:30803776-30803825,chr16,30803776,30803825,H1|chr16:90088131-90088160,chr16,90088131,90088160,0,59284355
H1|chr16:30986115-30986235,chr16,30986115,30986235,H1|chr16:9769579-9769605,chr16,9769579,9769605,0,21216536
H1|chr16:31025551-31025623,chr16,31025551,31025623,H1|chr16:85645661-85645692,chr16,85645661,85645692,0,54620110
H1|chr16:31028705-31028747,chr16,31028705,31028747,H1|chr16:444607-444679,chr16,444607,444679,0,30584098
H1|chr16:31053528-31053554,chr16,31053528,31053554,H1|chr16:9775661-9775725,chr16,9775661,9775725,0,21277867
H1|chr16:31375938-31376005,chr16,31375938,31376005,H1|chr16:3031531-3031579,chr16,3031531,3031579,0,28344407
H1|chr16:31423495-31423532,chr16,31423495,31423532,H1|chr16:56659135-56659248,chr16,56659135,56659248,0,25235640
H1|chr16:31487887-31488037,chr16,31487887,31488037,H1|chr16:87899079-87899229,chr16,87899079,87899229,0,56411192
H1|chr16:31636345-31636450,chr16,31636345,31636450,H1|chr16:85641671-85641707,chr16,85641671,85641707,0,54005326
H1|chr16:31664413-31664554,chr16,31664413,31664554,H1|chr16:3073657-3073720,chr16,3073657,3073720,0,28590756
H1|chr16:31682769-31682844,chr16,31682769,31682844,H1|chr16:85645661-85645692,chr16,85645661,85645692,0,53962892
H1|chr16:31738158-31738207,chr16,31738158,31738207,H1|chr16:4900256-4900321,chr16,4900256,4900321,0,26837902
H1|chr16:31758862-31758906,chr16,31758862,31758906,H1|chr16:87900238-87900344,chr16,87900238,87900344,0,56141376
H1|chr16:31846323-31846473,chr16,31846323,31846473,H1|chr16:9772181-9772299,chr16,9772181,9772299,0,22074142
H1|chr16:31860432-31860513,chr16,31860432,31860513,H1|chr16:18937922-18937988,chr16,18937922,18937988,0,12922510
H1|chr16:31918550-31918645,chr16,31918550,31918645,H1|chr16:89270852-89270907,chr16,89270852,89270907,0,57352302
H1|chr16:32027779-32027861,chr16,32027779,32027861,H1|chr16:67967239-67967282,chr16,67967239,67967282,0,35939460
H1|chr16:32149146-32149247,chr16,32149146,32149247,H1|chr16:89268397-89268439,chr16,89268397,89268439,0,57119251
H1|chr16:32236130-32236180,chr16,32236130,32236180,H1|chr16:84402467-84402542,chr16,84402467,84402542,0,52166337
H1|chr16:32242726-32242759,chr16,32242726,32242759,H1|chr16:84402467-84402540,chr16,84402467,84402540,0,52159741
H1|chr16:32334533-32334589,chr16,32334533,32334589,H1|chr16:3032654-3032782,chr16,3032654,3032782,0,29301879
H1|chr16:32406522-32406574,chr16,32406522,32406574,H1|chr16:89780779-89780877,chr16,89780779,89780877,0,57374257
H1|chr16:32532008-32532075,chr16,32532008,32532075,H1|chr16:85642004-85642043,chr16,85642004,85642043,0,53109996
H1|chr16:32544981-32545055,chr16,32544981,32545055,H1|chr16:1355100-1355166,chr16,1355100,1355166,0,31189881
H1|chr16:32945781-32945861,chr16,32945781,32945861,H1|chr16:9772051-9772162,chr16,9772051,9772162,0,23173730
H1|chr16:33144298-33144332,chr16,33144298,33144332,H1|chr16:89781197-89781347,chr16,89781197,89781347,0,56636899
H1|chr16:33244245-33244331,chr16,33244245,33244331,H1|chr16:25270624-25270701,chr16,25270624,25270701,0,7973621
H1|chr16:33252560-33252607,chr16,33252560,33252607,H1|chr16:67966644-67966747,chr16,67966644,67966747,0,34714084
H1|chr16:33264845-33264898,chr16,33264845,33264898,H1|chr16:89780779-89780877,chr16,89780779,89780877,0,56515934
H1|chr16:33361137-33361235,chr16,33361137,33361235,H1|chr16:68774150-68774234,chr16,68774150,68774234,0,35413013
H1|chr16:33497492-33497575,chr16,33497492,33497575,H1|chr16:9768494-9768558,chr16,9768494,9768558,0,23728998
H1|chr16:33554307-33554349,chr16,33554307,33554349,H1|chr16:444607-444679,chr16,444607,444679,0,33109700
H1|chr16:33702583-33702710,chr16,33702583,33702710,H1|chr16:56717613-56717695,chr16,56717613,56717695,0,23015030
H1|chr16:33709761-33709798,chr16,33709761,33709798,H1|chr16:3013378-3013442,chr16,3013378,3013442,0,30696383
H1|chr16:33746206-33746292,chr16,33746206,33746292,H1|chr16:3083623-3083687,chr16,3083623,3083687,0,30662583
H1|chr16:33762934-33763021,chr16,33762934,33763021,H1|chr16:18937922-18937982,chr16,18937922,18937982,0,14825012
H1|chr16:33770164-33770194,chr16,33770164,33770194,H1|chr16:9769834-9769982,chr16,9769834,9769982,0,24000330
H1|chr16:33824214-33824309,chr16,33824214,33824309,H1|chr16:85644410-85644462,chr16,85644410,85644462,0,51820196
H1|chr16:33935227-33935319,chr16,33935227,33935319,H1|chr16:88491214-88491280,chr16,88491214,88491280,0,54555987
H1|chr16:33965595-33965661,chr16,33965595,33965661,H1|chr16:9768701-9768759,chr16,9768701,9768759,0,24196894
H1|chr16:33975205-33975354,chr16,33975205,33975354,H1|chr16:87899090-87899234,chr16,87899090,87899234,0,53923885
H1|chr16:34004830-34004929,chr16,34004830,34004929,H1|chr16:18937922-18937973,chr16,18937922,18937973,0,15066908
H1|chr16:34088826-34088870,chr16,34088826,34088870,H1|chr16:444607-444659,chr16,444607,444659,0,33644219
H1|chr16:34142890-34143040,chr16,34142890,34143040,H1|chr16:2180497-2180624,chr16,2180497,2180624,0,31962393
H1|chr16:34274311-34274461,chr16,34274311,34274461,H1|chr16:3449191-3449268,chr16,3449191,3449268,0,30825120
H1|chr16:34442652-34442723,chr16,34442652,34442723,H1|chr16:24736822-24736876,chr16,24736822,24736876,0,9705830
H1|chr16:34451544-34451591,chr16,34451544,34451591,H1|chr16:9773048-9773147,chr16,9773048,9773147,0,24678496
H1|chr16:34678360-34678456,chr16,34678360,34678456,H1|chr16:9775607-9775661,chr16,9775607,9775661,0,24902753
H1|chr16:34772918-34773068,chr16,34772918,34773068,H1|chr16:56461910-56461950,chr16,56461910,56461950,0,21688992
H1|chr16:34782422-34782469,chr16,34782422,34782469,H1|chr16:3155396-3155471,chr16,3155396,3155471,0,31627026
H1|chr16:34878825-34878860,chr16,34878825,34878860,H1|chr16:9773472-9773613,chr16,9773472,9773613,0,25105353
H1|chr16:34898462-34898552,chr16,34898462,34898552,H1|chr16:11759786-11759816,chr16,11759786,11759816,0,23138676
H1|chr16:34981723-34981787,chr16,34981723,34981787,H1|chr16:25270819-25270958,chr16,25270819,25270958,0,9710904
H1|chr16:35403309-35403337,chr16,35403309,35403337,H1|chr16:791546-791622,chr16,791546,791622,0,34611763
H1|chr16:35484025-35484096,chr16,35484025,35484096,H1|chr16:68772531-68772607,chr16,68772531,68772607,0,33288506
H1|chr16:35553661-35553788,chr16,35553661,35553788,H1|chr16:4396071-4396094,chr16,4396071,4396094,0,31157590
H1|chr16:35573177-35573266,chr16,35573177,35573266,H1|chr16:3154736-3154771,chr16,3154736,3154771,0,32418441
H1|chr16:35741730-35741819,chr16,35741730,35741819,H1|chr16:3154736-3154771,chr16,3154736,3154771,0,32586994
H1|chr16:35799578-35799628,chr16,35799578,35799628,H1|chr16:84402467-84402542,chr16,84402467,84402542,0,48602889
H1|chr16:35906623-35906750,chr16,35906623,35906750,H1|chr16:87900158-87900285,chr16,87900158,87900285,0,51993535
H1|chr16:35908017-35908082,chr16,35908017,35908082,H1|chr16:9057330-9057361,chr16,9057330,9057361,0,26850687
H1|chr16:35994612-35994703,chr16,35994612,35994703,H1|chr16:9773984-9774043,chr16,9773984,9774043,0,26220628
H1|chr16:36020168-36020214,chr16,36020168,36020214,H1|chr16:19730380-19730484,chr16,19730380,19730484,0,16289788
H1|chr16:36090581-36090727,chr16,36090581,36090727,H1|chr16:18937922-18937978,chr16,18937922,18937978,0,17152659
H1|chr16:36157697-36157837,chr16,36157697,36157837,H1|chr16:31467657-31467720,chr16,31467657,31467720,0,4690040
H1|chr16:36202701-36202796,chr16,36202701,36202796,H1|chr16:18937922-18937976,chr16,18937922,18937976,0,17264779
H1|chr16:36218293-36218364,chr16,36218293,36218364,H1|chr16:24736822-24736876,chr16,24736822,24736876,0,11481471
H1|chr16:36234278-36234323,chr16,36234278,36234323,H1|chr16:89780394-89780485,chr16,89780394,89780485,0,53546116
H1|chr16:36367825-36367858,chr16,36367825,36367858,H1|chr16:4324142-4324201,chr16,4324142,4324201,0,32043683
H1|chr16:36577123-36577197,chr16,36577123,36577197,H1|chr16:18937946-18938025,chr16,18937946,18938025,0,17639177
H1|chr16:36610749-36610786,chr16,36610749,36610786,H1|chr16:56659135-56659248,chr16,56659135,56659248,0,20048386
H1|chr16:36748393-36748474,chr16,36748393,36748474,H1|chr16:85640908-85640929,chr16,85640908,85640929,0,48892515
H1|chr16:36976261-36976278,chr16,36976261,36976278,H1|chr16:3146950-3147069,chr16,3146950,3147069,0,33829311
H1|chr16:37383142-37383238,chr16,37383142,37383238,H1|chr16:18937922-18937976,chr16,18937922,18937976,0,18445220
H1|chr16:37413443-37413572,chr16,37413443,37413572,H1|chr16:58663074-58663110,chr16,58663074,58663110,0,21249631
H1|chr16:37490666-37490816,chr16,37490666,37490816,H1|chr16:87902229-87902374,chr16,87902229,87902374,0,50411563
H1|chr16:37557209-37557268,chr16,37557209,37557268,H1|chr16:11759670-11759727,chr16,11759670,11759727,0,25797539
H1|chr16:37642154-37642187,chr16,37642154,37642187,H1|chr16:31467511-31467622,chr16,31467511,31467622,0,6174643
H1|chr16:37694986-37695080,chr16,37694986,37695080,H1|chr16:85647652-85647750,chr16,85647652,85647750,0,47952666
H1|chr16:37763569-37763634,chr16,37763569,37763634,H1|chr16:25273834-25273875,chr16,25273834,25273875,0,12489735
H1|chr16:37847667-37847758,chr16,37847667,37847758,H1|chr16:3144972-3145082,chr16,3144972,3145082,0,34702695
H1|chr16:37960250-37960283,chr16,37960250,37960283,H1|chr16:84402467-84402540,chr16,84402467,84402540,0,46442217
H1|chr16:37989224-37989336,chr16,37989224,37989336,H1|chr16:23606457-23606489,chr16,23606457,23606489,0,14382767
H1|chr16:38008594-38008744,chr16,38008594,38008744,H1|chr16:56461910-56461950,chr16,56461910,56461950,0,18453316
H1|chr16:38032338-38032479,chr16,38032338,38032479,H1|chr16:3073657-3073720,chr16,3073657,3073720,0,34958681
H1|chr16:38099079-38099149,chr16,38099079,38099149,H1|chr16:85641456-85641534,chr16,85641456,85641534,0,47542377
H1|chr16:38261603-38261684,chr16,38261603,38261684,H1|chr16:85640908-85640929,chr16,85640908,85640929,0,47379305
H1|chr16:38321546-38321627,chr16,38321546,38321627,H1|chr16:89628517-89628540,chr16,89628517,89628540,0,51306971
H1|chr16:38446759-38446837,chr16,38446759,38446837,H1|chr16:18937922-18937975,chr16,18937922,18937975,0,19508837
H1|chr16:38693573-38693672,chr16,38693573,38693672,H1|chr16:9774303-9774422,chr16,9774303,9774422,0,28919270
H1|chr16:38842405-38842499,chr16,38842405,38842499,H1|chr16:18937922-18937978,chr16,18937922,18937978,0,19904483
H1|chr16:39116716-39116760,chr16,39116716,39116760,H1|chr16:444607-444659,chr16,444607,444659,0,38672109
H1|chr16:39119455-39119512,chr16,39119455,39119512,H1|chr16:75498043-75498193,chr16,75498043,75498193,0,36378588
H1|chr16:39371331-39371412,chr16,39371331,39371412,H1|chr16:89781171-89781279,chr16,89781171,89781279,0,50409840
H1|chr16:39530498-39530544,chr16,39530498,39530544,H1|chr16:3155396-3155471,chr16,3155396,3155471,0,36375102
H1|chr16:39673531-39673661,chr16,39673531,39673661,H1|chr16:3013685-3013716,chr16,3013685,3013716,0,36659846
H1|chr16:39682568-39682629,chr16,39682568,39682629,H1|chr16:25273836-25273874,chr16,25273836,25273874,0,14408732
H1|chr16:39736250-39736319,chr16,39736250,39736319,H1|chr16:3072408-3072484,chr16,3072408,3072484,0,36663842
H1|chr16:40006193-40006293,chr16,40006193,40006293,H1|chr16:85640492-85640542,chr16,85640492,85640542,0,45634299
H1|chr16:40012417-40012495,chr16,40012417,40012495,H1|chr16:3186642-3186720,chr16,3186642,3186720,0,36825775
H1|chr16:40280699-40280810,chr16,40280699,40280810,H1|chr16:2182997-2183120,chr16,2182997,2183120,0,38097702
H1|chr16:40343873-40343990,chr16,40343873,40343990,H1|chr16:31467029-31467062,chr16,31467029,31467062,0,8876844
H1|chr16:40406579-40406691,chr16,40406579,40406691,H1|chr16:84730939-84731003,chr16,84730939,84731003,0,44324360
H1|chr16:40555456-40555549,chr16,40555456,40555549,H1|chr16:89628853-89628889,chr16,89628853,89628889,0,49073397
H1|chr16:40886500-40886646,chr16,40886500,40886646,H1|chr16:15187570-15187720,chr16,15187570,15187720,0,25698930
H1|chr16:40919052-40919104,chr16,40919052,40919104,H1|chr16:68776073-68776109,chr16,68776073,68776109,0,27857021
H1|chr16:41041004-41041088,chr16,41041004,41041088,H1|chr16:18937922-18937976,chr16,18937922,18937976,0,22103082
H1|chr16:41278806-41278952,chr16,41278806,41278952,H1|chr16:87899058-87899205,chr16,87899058,87899205,0,46620252
H1|chr16:41333866-41333965,chr16,41333866,41333965,H1|chr16:85647338-85647376,chr16,85647338,85647376,0,44313472
H1|chr16:41342744-41342795,chr16,41342744,41342795,H1|chr16:85641906-85641968,chr16,85641906,85641968,0,44299162
H1|chr16:41498563-41498633,chr16,41498563,41498633,H1|chr16:2733066-2733131,chr16,2733066,2733131,0,38765497
H1|chr16:41504586-41504736,chr16,41504586,41504736,H1|chr16:31467501-31467631,chr16,31467501,31467631,0,10037085
H1|chr16:41569354-41569375,chr16,41569354,41569375,H1|chr16:4324446-4324596,chr16,4324446,4324596,0,37244908
H1|chr16:41588820-41588968,chr16,41588820,41588968,H1|chr16:85644730-85644807,chr16,85644730,85644807,0,44055910
H1|chr16:41712104-41712199,chr16,41712104,41712199,H1|chr16:24739719-24739770,chr16,24739719,24739770,0,16972385
H1|chr16:41844682-41844776,chr16,41844682,41844776,H1|chr16:9771889-9771945,chr16,9771889,9771945,0,32072793
H1|chr16:41929179-41929203,chr16,41929179,41929203,H1|chr16:67972359-67972444,chr16,67972359,67972444,0,26043180
H1|chr16:41937324-41937417,chr16,41937324,41937417,H1|chr16:3084482-3084539,chr16,3084482,3084539,0,38852842
H1|chr16:41950773-41950829,chr16,41950773,41950829,H1|chr16:3032654-3032782,chr16,3032654,3032782,0,38918119
H1|chr16:42119715-42119740,chr16,42119715,42119740,H1|chr16:25271063-25271187,chr16,25271063,25271187,0,16848652
H1|chr16:42221167-42221278,chr16,42221167,42221278,H1|chr16:31467511-31467622,chr16,31467511,31467622,0,10753656
H1|chr16:42393190-42393240,chr16,42393190,42393240,H1|chr16:89284321-89284384,chr16,89284321,89284384,0,46891131
H1|chr16:42488699-42488731,chr16,42488699,42488731,H1|chr16:9772181-9772299,chr16,9772181,9772299,0,32716518
H1|chr16:42690273-42690363,chr16,42690273,42690363,H1|chr16:85644765-85644812,chr16,85644765,85644812,0,42954492
H1|chr16:42771153-42771195,chr16,42771153,42771195,H1|chr16:14727639-14727683,chr16,14727639,14727683,0,28043514
H1|chr16:42821684-42821831,chr16,42821684,42821831,H1|chr16:15187570-15187720,chr16,15187570,15187720,0,27634114
H1|chr16:42913166-42913221,chr16,42913166,42913221,H1|chr16:3066913-3067054,chr16,3066913,3067054,0,39846253
H1|chr16:43016845-43016897,chr16,43016845,43016897,H1|chr16:2182857-2182922,chr16,2182857,2182922,0,40833988
H1|chr16:43180826-43180966,chr16,43180826,43180966,H1|chr16:2014046-2014147,chr16,2014046,2014147,0,41166780
H1|chr16:43196017-43196078,chr16,43196017,43196078,H1|chr16:25120399-25120453,chr16,25120399,25120453,0,18075618
H1|chr16:43348096-43348162,chr16,43348096,43348162,H1|chr16:68774150-68774234,chr16,68774150,68774234,0,25426054
H1|chr16:43434480-43434564,chr16,43434480,43434564,H1|chr16:31466043-31466109,chr16,31466043,31466109,0,11968437
H1|chr16:43437547-43437628,chr16,43437547,43437628,H1|chr16:85641849-85641989,chr16,85641849,85641989,0,42204302
H1|chr16:43738370-43738440,chr16,43738370,43738440,H1|chr16:85642804-85642884,chr16,85642804,85642884,0,41904434
H1|chr16:43961249-43961329,chr16,43961249,43961329,H1|chr16:84734340-84734384,chr16,84734340,84734384,0,40773091
H1|chr16:44120833-44120951,chr16,44120833,44120951,H1|chr16:2179148-2179181,chr16,2179148,2179181,0,41941685
H1|chr16:44222427-44222533,chr16,44222427,44222533,H1|chr16:2183054-2183108,chr16,2183054,2183108,0,42039373
H1|chr16:44430775-44430808,chr16,44430775,44430808,H1|chr16:4324142-4324201,chr16,4324142,4324201,0,40106633
H1|chr16:44438445-44438589,chr16,44438445,44438589,H1|chr16:2179508-2179547,chr16,2179508,2179547,0,42258937
H1|chr16:44552137-44552210,chr16,44552137,44552210,H1|chr16:31467493-31467566,chr16,31467493,31467566,0,13084644
H1|chr16:44630089-44630234,chr16,44630089,44630234,H1|chr16:18937922-18937973,chr16,18937922,18937973,0,25692167
H1|chr16:44824969-44825034,chr16,44824969,44825034,H1|chr16:89886407-89886518,chr16,89886407,89886518,0,45061438
H1|chr16:44827619-44827713,chr16,44827619,44827713,H1|chr16:4326380-4326433,chr16,4326380,4326433,0,40501239
H1|chr16:44850555-44850627,chr16,44850555,44850627,H1|chr16:85645661-85645692,chr16,85645661,85645692,0,40795106
H1|chr16:45034567-45034631,chr16,45034567,45034631,H1|chr16:25270819-25270958,chr16,25270819,25270958,0,19763748
H1|chr16:45071462-45071499,chr16,45071462,45071499,H1|chr16:9774447-9774538,chr16,9774447,9774538,0,35297015
H1|chr16:45278582-45278677,chr16,45278582,45278677,H1|chr16:89270852-89270907,chr16,89270852,89270907,0,43992270
H1|chr16:45379244-45379286,chr16,45379244,45379286,H1|chr16:794586-794710,chr16,794586,794710,0,44584658
H1|chr16:45446130-45446164,chr16,45446130,45446164,H1|chr16:31465346-31465426,chr16,31465346,31465426,0,13980784
H1|chr16:45449471-45449517,chr16,45449471,45449517,H1|chr16:87898988-87899089,chr16,87898988,87899089,0,42449517
H1|chr16:45615430-45615521,chr16,45615430,45615521,H1|chr16:9773984-9774043,chr16,9773984,9774043,0,35841446
H1|chr16:45649207-45649283,chr16,45649207,45649283,H1|chr16:89781194-89781242,chr16,89781194,89781242,0,44131987
H1|chr16:45740644-45740686,chr16,45740644,45740686,H1|chr16:14727639-14727683,chr16,14727639,14727683,0,31013005
H1|chr16:45812430-45812577,chr16,45812430,45812577,H1|chr16:87902223-87902373,chr16,87902223,87902373,0,42089793
H1|chr16:45902681-45902754,chr16,45902681,45902754,H1|chr16:3449191-3449268,chr16,3449191,3449268,0,42453490
H1|chr16:46206753-46206836,chr16,46206753,46206836,H1|chr16:31466116-31466183,chr16,31466116,31466183,0,14740637
H1|chr16:46480583-46480660,chr16,46480583,46480660,H1|chr16:87897669-87897742,chr16,87897669,87897742,0,41417086
H1|chr16:46911615-46911703,chr16,46911615,46911703,H1|chr16:18937900-18938014,chr16,18937900,18938014,0,27973715
H1|chr16:47123347-47123427,chr16,47123347,47123427,H1|chr16:690416-690531,chr16,690416,690531,0,46432931
H1|chr16:47249703-47249774,chr16,47249703,47249774,H1|chr16:56461910-56461950,chr16,56461910,56461950,0,9212207
H1|chr16:47328751-47328799,chr16,47328751,47328799,H1|chr16:4900256-4900321,chr16,4900256,4900321,0,42428495
H1|chr16:47427939-47427962,chr16,47427939,47427962,H1|chr16:69365950-69366057,chr16,69365950,69366057,0,21938011
H1|chr16:47566543-47566606,chr16,47566543,47566606,H1|chr16:31467965-31468020,chr16,31467965,31468020,0,16098578
H1|chr16:47878950-47879032,chr16,47878950,47879032,H1|chr16:9769552-9769620,chr16,9769552,9769620,0,38109398
H1|chr16:47968771-47968917,chr16,47968771,47968917,H1|chr16:18937922-18937978,chr16,18937922,18937978,0,29030849
H1|chr16:47971435-47971481,chr16,47971435,47971481,H1|chr16:31713415-31713486,chr16,31713415,31713486,0,16258020
H1|chr16:48080912-48081012,chr16,48080912,48081012,H1|chr16:58663074-58663111,chr16,58663074,58663111,0,10582162
H1|chr16:48233828-48233861,chr16,48233828,48233861,H1|chr16:31467511-31467622,chr16,31467511,31467622,0,16766317
H1|chr16:48385177-48385273,chr16,48385177,48385273,H1|chr16:9775607-9775661,chr16,9775607,9775661,0,38609570
H1|chr16:48564249-48564293,chr16,48564249,48564293,H1|chr16:4321699-4321787,chr16,4321699,4321787,0,44242550
H1|chr16:48731382-48731511,chr16,48731382,48731511,H1|chr16:87899035-87899166,chr16,87899035,87899166,0,39167653
H1|chr16:48805540-48805578,chr16,48805540,48805578,H1|chr16:89284913-89285019,chr16,89284913,89285019,0,40479373
H1|chr16:48858019-48858169,chr16,48858019,48858169,H1|chr16:31465883-31465940,chr16,31465883,31465940,0,17392136
H1|chr16:49258410-49258535,chr16,49258410,49258535,H1|chr16:88870774-88870799,chr16,88870774,88870799,0,39612364
H1|chr16:49444418-49444558,chr16,49444418,49444558,H1|chr16:9773984-9774043,chr16,9773984,9774043,0,39670434
H1|chr16:49537936-49538015,chr16,49537936,49538015,H1|chr16:85644356-85644375,chr16,85644356,85644375,0,36106420
H1|chr16:49651733-49651867,chr16,49651733,49651867,H1|chr16:1355093-1355166,chr16,1355093,1355166,0,48296640
H1|chr16:49710363-49710513,chr16,49710363,49710513,H1|chr16:75497349-75497499,chr16,75497349,75497499,0,25786986
H1|chr16:50157960-50158010,chr16,50157960,50158010,H1|chr16:89284321-89284384,chr16,89284321,89284384,0,39126361
H1|chr16:50207607-50207632,chr16,50207607,50207632,H1|chr16:25271063-25271187,chr16,25271063,25271187,0,24936544
H1|chr16:50343220-50343302,chr16,50343220,50343302,H1|chr16:9769552-9769620,chr16,9769552,9769620,0,40573668
H1|chr16:50366417-50366567,chr16,50366417,50366567,H1|chr16:18937909-18938059,chr16,18937909,18938059,0,31428508
H1|chr16:50477553-50477586,chr16,50477553,50477586,H1|chr16:4399994-4400109,chr16,4399994,4400109,0,46077559
H1|chr16:50701205-50701236,chr16,50701205,50701236,H1|chr16:23604006-23604156,chr16,23604006,23604156,0,27097199
H1|chr16:50743346-50743395,chr16,50743346,50743395,H1|chr16:23520325-23520409,chr16,23520325,23520409,0,27223021
H1|chr16:50756051-50756090,chr16,50756051,50756090,H1|chr16:9773048-9773147,chr16,9773048,9773147,0,40983003
H1|chr16:50824136-50824172,chr16,50824136,50824172,H1|chr16:4399994-4400109,chr16,4399994,4400109,0,46424142
H1|chr16:50840729-50840781,chr16,50840729,50840781,H1|chr16:89780779-89780877,chr16,89780779,89780877,0,38940050
H1|chr16:50935911-50936018,chr16,50935911,50936018,H1|chr16:56461910-56461950,chr16,56461910,56461950,0,5525999
H1|chr16:51035452-51035486,chr16,51035452,51035486,H1|chr16:31465346-31465426,chr16,31465346,31465426,0,19570106
H1|chr16:51143020-51143110,chr16,51143020,51143110,H1|chr16:85644765-85644812,chr16,85644765,85644812,0,34501745
H1|chr16:51342315-51342465,chr16,51342315,51342465,H1|chr16:31465883-31465940,chr16,31465883,31465940,0,19876432
H1|chr16:51417038-51417160,chr16,51417038,51417160,H1|chr16:89625240-89625268,chr16,89625240,89625268,0,38208202
H1|chr16:51442624-51442711,chr16,51442624,51442711,H1|chr16:85642737-85642800,chr16,85642737,85642800,0,34200113
H1|chr16:51577531-51577672,chr16,51577531,51577672,H1|chr16:2014046-2014147,chr16,2014046,2014147,0,49563485
H1|chr16:51596924-51597070,chr16,51596924,51597070,H1|chr16:87899058-87899205,chr16,87899058,87899205,0,36302134
H1|chr16:51840586-51840620,chr16,51840586,51840620,H1|chr16:31467477-31467582,chr16,31467477,31467582,0,20373109
H1|chr16:51948774-51948860,chr16,51948774,51948860,H1|chr16:31465014-31465040,chr16,31465014,31465040,0,20483760
H1|chr16:51995478-51995527,chr16,51995478,51995527,H1|chr16:89268396-89268438,chr16,89268396,89268438,0,37272918
H1|chr16:52016870-52016955,chr16,52016870,52016955,H1|chr16:9769579-9769644,chr16,9769579,9769644,0,42247291
H1|chr16:52033243-52033319,chr16,52033243,52033319,H1|chr16:85646134-85646208,chr16,85646134,85646208,0,33612891
H1|chr16:52109539-52109623,chr16,52109539,52109623,H1|chr16:3084473-3084539,chr16,3084473,3084539,0,49025066
H1|chr16:52142314-52142387,chr16,52142314,52142387,H1|chr16:85644730-85644807,chr16,85644730,85644807,0,33502416
H1|chr16:52556188-52556338,chr16,52556188,52556338,H1|chr16:87899093-87899199,chr16,87899093,87899199,0,35342905
H1|chr16:52618099-52618212,chr16,52618099,52618212,H1|chr16:277677-277711,chr16,277677,277711,0,52340422
H1|chr16:52685951-52685973,chr16,52685951,52685973,H1|chr16:69365950-69366057,chr16,69365950,69366057,0,16679999
H1|chr16:52852125-52852178,chr16,52852125,52852178,H1|chr16:89780779-89780877,chr16,89780779,89780877,0,36928654
H1|chr16:52901160-52901236,chr16,52901160,52901236,H1|chr16:90088002-90088076,chr16,90088002,90088076,0,37186842
H1|chr16:52923053-52923134,chr16,52923053,52923134,H1|chr16:89284321-89284384,chr16,89284321,89284384,0,36361268
H1|chr16:52948601-52948673,chr16,52948601,52948673,H1|chr16:48637648-48637721,chr16,48637648,48637721,0,4310953
H1|chr16:52986300-52986449,chr16,52986300,52986449,H1|chr16:9773315-9773366,chr16,9773315,9773366,0,43212985
H1|chr16:53031523-53031602,chr16,53031523,53031602,H1|chr16:18937922-18937980,chr16,18937922,18937980,0,34093601
H1|chr16:53174678-53174730,chr16,53174678,53174730,H1|chr16:85647652-85647750,chr16,85647652,85647750,0,32472974
H1|chr16:53222880-53222927,chr16,53222880,53222927,H1|chr16:58660789-58660879,chr16,58660789,58660879,0,5437909
H1|chr16:53351374-53351424,chr16,53351374,53351424,H1|chr16:3031480-3031630,chr16,3031480,3031630,0,50319894
H1|chr16:53368410-53368497,chr16,53368410,53368497,H1|chr16:31467657-31467720,chr16,31467657,31467720,0,21900753
H1|chr16:53505476-53505546,chr16,53505476,53505546,H1|chr16:24736822-24736876,chr16,24736822,24736876,0,28768654
H1|chr16:53532734-53532772,chr16,53532734,53532772,H1|chr16:85643378-85643421,chr16,85643378,85643421,0,32110644
H1|chr16:53608123-53608271,chr16,53608123,53608271,H1|chr16:85648383-85648418,chr16,85648383,85648418,0,32040260
H1|chr16:53743716-53743742,chr16,53743716,53743742,H1|chr16:67968904-67969024,chr16,67968904,67969024,0,14225188
H1|chr16:53757797-53757867,chr16,53757797,53757867,H1|chr16:31465892-31465917,chr16,31465892,31465917,0,22291905
H1|chr16:53836812-53836912,chr16,53836812,53836912,H1|chr16:9058500-9058526,chr16,9058500,9058526,0,44778312
H1|chr16:53860091-53860160,chr16,53860091,53860160,H1|chr16:75018566-75018596,chr16,75018566,75018596,0,21158475
H1|chr16:53900386-53900444,chr16,53900386,53900444,H1|chr16:9769469-9769545,chr16,9769469,9769545,0,44130917
H1|chr16:54021138-54021288,chr16,54021138,54021288,H1|chr16:89779669-89779721,chr16,89779669,89779721,0,35758531
H1|chr16:54053853-54053964,chr16,54053853,54053964,H1|chr16:3013685-3013716,chr16,3013685,3013716,0,51040168
H1|chr16:54318888-54318983,chr16,54318888,54318983,H1|chr16:18937922-18937976,chr16,18937922,18937976,0,35380966
H1|chr16:54459679-54459829,chr16,54459679,54459829,H1|chr16:18937922-18937976,chr16,18937922,18937976,0,35521757
H1|chr16:54527432-54527493,chr16,54527432,54527493,H1|chr16:88728875-88728963,chr16,88728875,88728963,0,34201443
H1|chr16:54596418-54596518,chr16,54596418,54596518,H1|chr16:9775235-9775285,chr16,9775235,9775285,0,44821183
H1|chr16:54721588-54721679,chr16,54721588,54721679,H1|chr16:85640453-85640531,chr16,85640453,85640531,0,30918865
H1|chr16:54781938-54782023,chr16,54781938,54782023,H1|chr16:85641906-85641968,chr16,85641906,85641968,0,30859968
H1|chr16:54813648-54813699,chr16,54813648,54813699,H1|chr16:18937909-18938059,chr16,18937909,18938059,0,35875739
H1|chr16:54825154-54825282,chr16,54825154,54825282,H1|chr16:9775607-9775661,chr16,9775607,9775661,0,45049547
H1|chr16:55088124-55088195,chr16,55088124,55088195,H1|chr16:90088131-90088160,chr16,90088131,90088160,0,35000007
H1|chr16:55126661-55126732,chr16,55126661,55126732,H1|chr16:84734340-84734384,chr16,84734340,84734384,0,29607679
H1|chr16:55214601-55214652,chr16,55214601,55214652,H1|chr16:3010230-3010380,chr16,3010230,3010380,0,52204371
H1|chr16:55247128-55247277,chr16,55247128,55247277,H1|chr16:18937922-18937988,chr16,18937922,18937988,0,36309206
H1|chr16:55252793-55252848,chr16,55252793,55252848,H1|chr16:285620-285727,chr16,285620,285727,0,54967173
H1|chr16:55326334-55326377,chr16,55326334,55326377,H1|chr16:788787-788881,chr16,788787,788881,0,54537547
H1|chr16:55763841-55763922,chr16,55763841,55763922,H1|chr16:9772577-9772642,chr16,9772577,9772642,0,45991264
H1|chr16:55874695-55874845,chr16,55874695,55874845,H1|chr16:18937909-18938059,chr16,18937909,18938059,0,36936786
H1|chr16:55954686-55954785,chr16,55954686,55954785,H1|chr16:18937922-18937973,chr16,18937922,18937973,0,37016764
H1|chr16:56183910-56183996,chr16,56183910,56183996,H1|chr16:9769579-9769643,chr16,9769579,9769643,0,46414331
H1|chr16:56291409-56291449,chr16,56291409,56291449,H1|chr16:85640212-85640322,chr16,85640212,85640322,0,29348803
H1|chr16:56304491-56304590,chr16,56304491,56304590,H1|chr16:85647338-85647376,chr16,85647338,85647376,0,29342847
H1|chr16:56458839-56458924,chr16,56458839,56458924,H1|chr16:85641906-85641968,chr16,85641906,85641968,0,29183067
H1|chr16:56488094-56488140,chr16,56488094,56488140,H1|chr16:19730380-19730484,chr16,19730380,19730484,0,36757714
H1|chr16:56507468-56507539,chr16,56507468,56507539,H1|chr16:68772531-68772607,chr16,68772531,68772607,0,12265063
H1|chr16:56614725-56614791,chr16,56614725,56614791,H1|chr16:9774407-9774446,chr16,9774407,9774446,0,46840318
H1|chr16:56740157-56740235,chr16,56740157,56740235,H1|chr16:18937922-18937975,chr16,18937922,18937975,0,37802235
H1|chr16:56777633-56777698,chr16,56777633,56777698,H1|chr16:25273834-25273875,chr16,25273834,25273875,0,31503799
H1|chr16:57110220-57110337,chr16,57110220,57110337,H1|chr16:23606457-23606489,chr16,23606457,23606489,0,33503763
H1|chr16:57123066-57123108,chr16,57123066,57123108,H1|chr16:3155396-3155471,chr16,3155396,3155471,0,53967670
H1|chr16:57175787-57175886,chr16,57175787,57175886,H1|chr16:9769579-9769605,chr16,9769579,9769605,0,47406208
H1|chr16:57420240-57420263,chr16,57420240,57420263,H1|chr16:69365950-69366057,chr16,69365950,69366057,0,11945710
H1|chr16:57545087-57545176,chr16,57545087,57545176,H1|chr16:18937922-18937983,chr16,18937922,18937983,0,38607165
H1|chr16:57691090-57691132,chr16,57691090,57691132,H1|chr16:9772577-9772642,chr16,9772577,9772642,0,47918513
H1|chr16:57738910-57739025,chr16,57738910,57739025,H1|chr16:85648383-85648418,chr16,85648383,85648418,0,27909473
H1|chr16:57809097-57809201,chr16,57809097,57809201,H1|chr16:85644410-85644462,chr16,85644410,85644462,0,27835313
H1|chr16:57954752-57954845,chr16,57954752,57954845,H1|chr16:89270852-89270907,chr16,89270852,89270907,0,31316100
H1|chr16:57961291-57961316,chr16,57961291,57961316,H1|chr16:67972359-67972444,chr16,67972359,67972444,0,10011068
H1|chr16:57970630-57970711,chr16,57970630,57970711,H1|chr16:1355098-1355167,chr16,1355098,1355167,0,56615532
H1|chr16:58058050-58058184,chr16,58058050,58058184,H1|chr16:1355093-1355166,chr16,1355093,1355166,0,56702957
H1|chr16:58086159-58086210,chr16,58086159,58086210,H1|chr16:14726925-14727033,chr16,14726925,14727033,0,43359234
H1|chr16:58097213-58097340,chr16,58097213,58097340,H1|chr16:89270709-89270757,chr16,89270709,89270757,0,31173496
H1|chr16:58172817-58172891,chr16,58172817,58172891,H1|chr16:3148330-3148390,chr16,3148330,3148390,0,55024487
H1|chr16:58211508-58211584,chr16,58211508,58211584,H1|chr16:90088002-90088076,chr16,90088002,90088076,0,31876494
H1|chr16:58278309-58278359,chr16,58278309,58278359,H1|chr16:3031480-3031630,chr16,3031480,3031630,0,55246829
H1|chr16:58322590-58322700,chr16,58322590,58322700,H1|chr16:9771916-9771956,chr16,9771916,9771956,0,48550674
H1|chr16:58496050-58496170,chr16,58496050,58496170,H1|chr16:85647575-85647605,chr16,85647575,85647605,0,27151525
H1|chr16:58543592-58543660,chr16,58543592,58543660,H1|chr16:75018565-75018596,chr16,75018565,75018596,0,16474973
H1|chr16:58623673-58623803,chr16,58623673,58623803,H1|chr16:31467493-31467566,chr16,31467493,31467566,0,27156180
H1|chr16:58740159-58740254,chr16,58740159,58740254,H1|chr16:9771889-9771945,chr16,9771889,9771945,0,48968270
H1|chr16:58789583-58789608,chr16,58789583,58789608,H1|chr16:67972359-67972444,chr16,67972359,67972444,0,9182776
H1|chr16:58979398-58979486,chr16,58979398,58979486,H1|chr16:795606-795643,chr16,795606,795643,0,58183792
H1|chr16:59296085-59296173,chr16,59296085,59296173,H1|chr16:9058500-9058526,chr16,9058500,9058526,0,50237585
H1|chr16:59482580-59482611,chr16,59482580,59482611,H1|chr16:89285021-89285140,chr16,89285021,89285140,0,29802441
H1|chr16:59547373-59547472,chr16,59547373,59547472,H1|chr16:9774959-9774993,chr16,9774959,9774993,0,49772414
H1|chr16:59613425-59613489,chr16,59613425,59613489,H1|chr16:19724238-19724307,chr16,19724238,19724307,0,39889187
H1|chr16:59632725-59632818,chr16,59632725,59632818,H1|chr16:9770171-9770214,chr16,9770171,9770214,0,49862554
H1|chr16:59669733-59669810,chr16,59669733,59669810,H1|chr16:2179526-2179649,chr16,2179526,2179649,0,57490207
H1|chr16:59862468-59862560,chr16,59862468,59862560,H1|chr16:3062267-3062313,chr16,3062267,3062313,0,56800201
H1|chr16:59879627-59879713,chr16,59879627,59879713,H1|chr16:25270624-25270701,chr16,25270624,25270701,0,34609003
H1|chr16:60457700-60457850,chr16,60457700,60457850,H1|chr16:85640908-85640985,chr16,85640908,85640985,0,25183208
H1|chr16:60458247-60458331,chr16,60458247,60458331,H1|chr16:89285398-89285437,chr16,89285398,89285437,0,28827151
H1|chr16:60677079-60677181,chr16,60677079,60677181,H1|chr16:87899441-87899489,chr16,87899441,87899489,0,27222362
H1|chr16:60851076-60851207,chr16,60851076,60851207,H1|chr16:1757271-1757290,chr16,1757271,1757290,0,59093805
H1|chr16:60956710-60956748,chr16,60956710,60956748,H1|chr16:85645940-85646010,chr16,85645940,85646010,0,24689230
H1|chr16:61121898-61122046,chr16,61121898,61122046,H1|chr16:18937861-18937990,chr16,18937861,18937990,0,42184037
H1|chr16:61154068-61154197,chr16,61154068,61154197,H1|chr16:791407-791428,chr16,791407,791428,0,60362661
H1|chr16:61357607-61357656,chr16,61357607,61357656,H1|chr16:9771714-9771864,chr16,9771714,9771864,0,51585893
H1|chr16:61388950-61388982,chr16,61388950,61388982,H1|chr16:87899170-87899287,chr16,87899170,87899287,0,26510220
H1|chr16:61569286-61569408,chr16,61569286,61569408,H1|chr16:89625240-89625268,chr16,89625240,89625268,0,28055954
H1|chr16:61610308-61610350,chr16,61610308,61610350,H1|chr16:8961775-8961919,chr16,8961775,8961919,0,52648533
H1|chr16:61745244-61745394,chr16,61745244,61745394,H1|chr16:2180575-2180621,chr16,2180575,2180621,0,59564669
H1|chr16:61756825-61756897,chr16,61756825,61756897,H1|chr16:85640453-85640531,chr16,85640453,85640531,0,23883628
H1|chr16:61780507-61780611,chr16,61780507,61780611,H1|chr16:85644410-85644462,chr16,85644410,85644462,0,23863903
H1|chr16:61806559-61806664,chr16,61806559,61806664,H1|chr16:85641671-85641707,chr16,85641671,85641707,0,23835112
H1|chr16:61864082-61864122,chr16,61864082,61864122,H1|chr16:85645514-85645601,chr16,85645514,85645601,0,23781432
H1|chr16:61917055-61917205,chr16,61917055,61917205,H1|chr16:2180575-2180621,chr16,2180575,2180621,0,59736480
H1|chr16:61949620-61949701,chr16,61949620,61949701,H1|chr16:89781171-89781279,chr16,89781171,89781279,0,27831551
H1|chr16:62148484-62148532,chr16,62148484,62148532,H1|chr16:4900256-4900321,chr16,4900256,4900321,0,57248228
H1|chr16:62152726-62152750,chr16,62152726,62152750,H1|chr16:58662800-58662921,chr16,58662800,58662921,0,3489926
H1|chr16:62237178-62237227,chr16,62237178,62237227,H1|chr16:89887958-89888039,chr16,89887958,89888039,0,27650780
H1|chr16:62389630-62389689,chr16,62389630,62389689,H1|chr16:85646625-85646671,chr16,85646625,85646671,0,23256995
H1|chr16:62456592-62456670,chr16,62456592,62456670,H1|chr16:18937922-18937988,chr16,18937922,18937988,0,43518670
H1|chr16:62481222-62481278,chr16,62481222,62481278,H1|chr16:2179530-2179613,chr16,2179530,2179613,0,60301692
H1|chr16:62650644-62650716,chr16,62650644,62650716,H1|chr16:2182659-2182709,chr16,2182659,2182709,0,60467985
H1|chr16:62651480-62651517,chr16,62651480,62651517,H1|chr16:9058500-9058526,chr16,9058500,9058526,0,53592980
H1|chr16:62653703-62653823,chr16,62653703,62653823,H1|chr16:9769579-9769605,chr16,9769579,9769605,0,52884124
H1|chr16:62741327-62741364,chr16,62741327,62741364,H1|chr16:89886407-89886518,chr16,89886407,89886518,0,27145080
H1|chr16:62764360-62764420,chr16,62764360,62764420,H1|chr16:3175050-3175097,chr16,3175050,3175097,0,59589310
H1|chr16:62822424-62822549,chr16,62822424,62822549,H1|chr16:85647575-85647605,chr16,85647575,85647605,0,22825151
H1|chr16:62870164-62870211,chr16,62870164,62870211,H1|chr16:31467541-31467691,chr16,31467541,31467691,0,31402623
H1|chr16:62999307-62999371,chr16,62999307,62999371,H1|chr16:84734486-84734548,chr16,84734486,84734548,0,21735179
H1|chr16:63054837-63054872,chr16,63054837,63054872,H1|chr16:85642440-85642496,chr16,85642440,85642496,0,22587603
H1|chr16:63081179-63081228,chr16,63081179,63081228,H1|chr16:89268396-89268438,chr16,89268396,89268438,0,26187217
H1|chr16:63167871-63167963,chr16,63167871,63167963,H1|chr16:89772333-89772391,chr16,89772333,89772391,0,26604462
H1|chr16:63226108-63226191,chr16,63226108,63226191,H1|chr16:85640453-85640505,chr16,85640453,85640505,0,22414345
H1|chr16:63231532-63231565,chr16,63231532,63231565,H1|chr16:87899170-87899287,chr16,87899170,87899287,0,24667638
H1|chr16:63248127-63248208,chr16,63248127,63248208,H1|chr16:84734340-84734384,chr16,84734340,84734384,0,21486213
H1|chr16:63308569-63308652,chr16,63308569,63308652,H1|chr16:85640453-85640505,chr16,85640453,85640505,0,22331884
H1|chr16:63416880-63416959,chr16,63416880,63416959,H1|chr16:18937922-18937980,chr16,18937922,18937980,0,44478958
H1|chr16:63540354-63540451,chr16,63540354,63540451,H1|chr16:18937922-18937975,chr16,18937922,18937975,0,44602432
H1|chr16:63552853-63552952,chr16,63552853,63552952,H1|chr16:9774959-9774993,chr16,9774959,9774993,0,53777894
H1|chr16:63583732-63583777,chr16,63583732,63583777,H1|chr16:4321699-4321787,chr16,4321699,4321787,0,59262033
H1|chr16:63812469-63812542,chr16,63812469,63812542,H1|chr16:31725155-31725232,chr16,31725155,31725232,0,32087314
H1|chr16:64244858-64245008,chr16,64244858,64245008,H1|chr16:2180497-2180624,chr16,2180497,2180624,0,62064361
H1|chr16:64469836-64469953,chr16,64469836,64469953,H1|chr16:31467029-31467062,chr16,31467029,31467062,0,33002807
H1|chr16:64475567-64475696,chr16,64475567,64475696,H1|chr16:87899035-87899166,chr16,87899035,87899166,0,23423468
H1|chr16:64511942-64512044,chr16,64511942,64512044,H1|chr16:85640924-85640943,chr16,85640924,85640943,0,21128982
H1|chr16:64718981-64719062,chr16,64718981,64719062,H1|chr16:18937922-18937988,chr16,18937922,18937988,0,45781059
H1|chr16:64822702-64822772,chr16,64822702,64822772,H1|chr16:25270624-25270701,chr16,25270624,25270701,0,39552078
H1|chr16:65036855-65036896,chr16,65036855,65036896,H1|chr16:89781171-89781279,chr16,89781171,89781279,0,24744316
H1|chr16:65213484-65213547,chr16,65213484,65213547,H1|chr16:31467965-31468020,chr16,31467965,31468020,0,33745519
H1|chr16:65231067-65231122,chr16,65231067,65231122,H1|chr16:3066913-3067054,chr16,3066913,3067054,0,62164154
H1|chr16:65277551-65277589,chr16,65277551,65277589,H1|chr16:3013378-3013442,chr16,3013378,3013442,0,62264173
H1|chr16:65479153-65479205,chr16,65479153,65479205,H1|chr16:31467556-31467647,chr16,31467556,31467647,0,34011597
H1|chr16:65580189-65580225,chr16,65580189,65580225,H1|chr16:8957392-8957464,chr16,8957392,8957464,0,56622797
H1|chr16:65656804-65656948,chr16,65656804,65656948,H1|chr16:2179508-2179547,chr16,2179508,2179547,0,63477296
H1|chr16:65718816-65718868,chr16,65718816,65718868,H1|chr16:31467556-31467647,chr16,31467556,31467647,0,34251260
H1|chr16:65769659-65769702,chr16,65769659,65769702,H1|chr16:57516105-57516243,chr16,57516105,57516243,0,8253554
H1|chr16:65968934-65968981,chr16,65968934,65968981,H1|chr16:3155396-3155471,chr16,3155396,3155471,0,62813538
H1|chr16:66097612-66097686,chr16,66097612,66097686,H1|chr16:56717553-56717608,chr16,56717553,56717608,0,9380059
H1|chr16:66236820-66236935,chr16,66236820,66236935,H1|chr16:85648383-85648418,chr16,85648383,85648418,0,19411563
H1|chr16:66371845-66371908,chr16,66371845,66371908,H1|chr16:85641856-85641901,chr16,85641856,85641901,0,19270011
H1|chr16:66624324-66624418,chr16,66624324,66624418,H1|chr16:85647652-85647750,chr16,85647652,85647750,0,19023328
H1|chr16:66758727-66758812,chr16,66758727,66758812,H1|chr16:9769579-9769644,chr16,9769579,9769644,0,56989148
H1|chr16:66861366-66861417,chr16,66861366,66861417,H1|chr16:3010230-3010380,chr16,3010230,3010380,0,63851136
H1|chr16:66929259-66929294,chr16,66929259,66929294,H1|chr16:9773472-9773613,chr16,9773472,9773613,0,57155787
H1|chr16:66981874-66981910,chr16,66981874,66981910,H1|chr16:4399994-4400109,chr16,4399994,4400109,0,62581880
H1|chr16:67045917-67045952,chr16,67045917,67045952,H1|chr16:14727639-14727683,chr16,14727639,14727683,0,52318278
H1|chr16:67111766-67111916,chr16,67111766,67111916,H1|chr16:87899047-87899194,chr16,87899047,87899194,0,20787281
H1|chr16:67117085-67117124,chr16,67117085,67117124,H1|chr16:3035319-3035356,chr16,3035319,3035356,0,64081766
H1|chr16:67185178-67185273,chr16,67185178,67185273,H1|chr16:89270709-89270757,chr16,89270709,89270757,0,22085531
H1|chr16:67287044-67287095,chr16,67287044,67287095,H1|chr16:89284321-89284384,chr16,89284321,89284384,0,21997277
H1|chr16:67293835-67293913,chr16,67293835,67293913,H1|chr16:31465892-31465917,chr16,31465892,31465917,0,35827943
H1|chr16:67630510-67630534,chr16,67630510,67630534,H1|chr16:4324372-4324426,chr16,4324372,4324426,0,63306138
H1|chr16:67746812-67746841,chr16,67746812,67746841,H1|chr16:58662800-58662921,chr16,58662800,58662921,0,9084012
H1|chr16:67791389-67791484,chr16,67791389,67791484,H1|chr16:24739719-24739770,chr16,24739719,24739770,0,43051670
H1|chr16:67877434-67877478,chr16,67877434,67877478,H1|chr16:87900238-87900344,chr16,87900238,87900344,0,20022804
H1|chr16:67912382-67912480,chr16,67912382,67912480,H1|chr16:9774959-9774993,chr16,9774959,9774993,0,58137423
H1|chr16:67924162-67924195,chr16,67924162,67924195,H1|chr16:4399994-4400109,chr16,4399994,4400109,0,63524168
H1|chr16:68068162-68068312,chr16,68068162,68068312,H1|chr16:18937922-18937978,chr16,18937922,18937978,0,49130240
H1|chr16:68110446-68110483,chr16,68110446,68110483,H1|chr16:89886407-89886518,chr16,89886407,89886518,0,21775961
H1|chr16:68159226-68159258,chr16,68159226,68159258,H1|chr16:9772562-9772712,chr16,9772562,9772712,0,58386664
H1|chr16:68190854-68190967,chr16,68190854,68190967,H1|chr16:9775235-9775285,chr16,9775235,9775285,0,58415619
H1|chr16:68452931-68452989,chr16,68452931,68452989,H1|chr16:9769469-9769545,chr16,9769469,9769545,0,58683462
H1|chr16:68791200-68791242,chr16,68791200,68791242,H1|chr16:3155396-3155471,chr16,3155396,3155471,0,65635804
H1|chr16:68792945-68793095,chr16,68792945,68793095,H1|chr16:88870774-88870799,chr16,88870774,88870799,0,20077829
H1|chr16:68858071-68858103,chr16,68858071,68858103,H1|chr16:89780336-89780486,chr16,89780336,89780486,0,20922265
H1|chr16:68891207-68891312,chr16,68891207,68891312,H1|chr16:3083476-3083510,chr16,3083476,3083510,0,65807731
H1|chr16:68940883-68940977,chr16,68940883,68940977,H1|chr16:9771889-9771945,chr16,9771889,9771945,0,59168994
H1|chr16:69009666-69009763,chr16,69009666,69009763,H1|chr16:68679845-68679887,chr16,68679845,68679887,0,329821
H1|chr16:69031309-69031418,chr16,69031309,69031418,H1|chr16:3356478-3356594,chr16,3356478,3356594,0,65674831
H1|chr16:69109794-69109895,chr16,69109794,69109895,H1|chr16:68679845-68679887,chr16,68679845,68679887,0,429949
H1|chr16:69489965-69490067,chr16,69489965,69490067,H1|chr16:87899441-87899489,chr16,87899441,87899489,0,18409476
H1|chr16:69556265-69556346,chr16,69556265,69556346,H1|chr16:84734340-84734384,chr16,84734340,84734384,0,15178075
H1|chr16:69703636-69703713,chr16,69703636,69703713,H1|chr16:2179526-2179649,chr16,2179526,2179649,0,67524110
H1|chr16:70084952-70084981,chr16,70084952,70084981,H1|chr16:58662800-58662921,chr16,58662800,58662921,0,11422152
H1|chr16:70174223-70174294,chr16,70174223,70174294,H1|chr16:48643495-48643560,chr16,48643495,48643560,0,21530728
H1|chr16:70251616-70251692,chr16,70251616,70251692,H1|chr16:85646134-85646208,chr16,85646134,85646208,0,15394518
H1|chr16:70438051-70438096,chr16,70438051,70438096,H1|chr16:89780394-89780485,chr16,89780394,89780485,0,19342343
H1|chr16:70589127-70589227,chr16,70589127,70589227,H1|chr16:9775235-9775285,chr16,9775235,9775285,0,60813892
H1|chr16:70817300-70817370,chr16,70817300,70817370,H1|chr16:85642804-85642884,chr16,85642804,85642884,0,14825504
H1|chr16:70930615-70930713,chr16,70930615,70930713,H1|chr16:68774150-68774234,chr16,68774150,68774234,0,2156465
H1|chr16:71282622-71282709,chr16,71282622,71282709,H1|chr16:88491214-88491273,chr16,88491214,88491273,0,17208592
H1|chr16:71294746-71294890,chr16,71294746,71294890,H1|chr16:87899050-87899200,chr16,87899050,87899200,0,16604304
H1|chr16:71353865-71353961,chr16,71353865,71353961,H1|chr16:18937922-18937976,chr16,18937922,18937976,0,52415943
H1|chr16:71522200-71522327,chr16,71522200,71522327,H1|chr16:2179515-2179659,chr16,2179515,2179659,0,69342685
H1|chr16:71873976-71874101,chr16,71873976,71874101,H1|chr16:88870774-88870799,chr16,88870774,88870799,0,16996798
H1|chr16:71974350-71974490,chr16,71974350,71974490,H1|chr16:9773984-9774043,chr16,9773984,9774043,0,62200366
H1|chr16:72082013-72082095,chr16,72082013,72082095,H1|chr16:89779669-89779721,chr16,89779669,89779721,0,17697656
H1|chr16:72088080-72088098,chr16,72088080,72088098,H1|chr16:31467207-31467339,chr16,31467207,31467339,0,40620873
H1|chr16:72224456-72224572,chr16,72224456,72224572,H1|chr16:9768494-9768558,chr16,9768494,9768558,0,62455962
H1|chr16:72248508-72248602,chr16,72248508,72248602,H1|chr16:70561853-70561922,chr16,70561853,70561922,0,1686655
H1|chr16:72311976-72312075,chr16,72311976,72312075,H1|chr16:9774303-9774422,chr16,9774303,9774422,0,62537673
H1|chr16:72364916-72364995,chr16,72364916,72364995,H1|chr16:85644356-85644375,chr16,85644356,85644375,0,13279440
H1|chr16:72461301-72461397,chr16,72461301,72461397,H1|chr16:19730380-19730484,chr16,19730380,19730484,0,52730921
H1|chr16:72520475-72520625,chr16,72520475,72520625,H1|chr16:87902223-87902373,chr16,87902223,87902373,0,15381748
H1|chr16:72555956-72556017,chr16,72555956,72556017,H1|chr16:88728875-88728963,chr16,88728875,88728963,0,16172919
H1|chr16:72797876-72798024,chr16,72797876,72798024,H1|chr16:85644730-85644807,chr16,85644730,85644807,0,12846854
H1|chr16:72818147-72818244,chr16,72818147,72818244,H1|chr16:18937922-18937975,chr16,18937922,18937975,0,53880225
H1|chr16:73149626-73149714,chr16,73149626,73149714,H1|chr16:9058500-9058526,chr16,9058500,9058526,0,64091126
H1|chr16:73317938-73317989,chr16,73317938,73317989,H1|chr16:31465010-31465039,chr16,31465010,31465039,0,41852928
H1|chr16:73435648-73435794,chr16,73435648,73435794,H1|chr16:15187570-15187720,chr16,15187570,15187720,0,58248078
H1|chr16:73514698-73514775,chr16,73514698,73514775,H1|chr16:87897669-87897742,chr16,87897669,87897742,0,14382971
H1|chr16:73595577-73595689,chr16,73595577,73595689,H1|chr16:84730939-84731003,chr16,84730939,84731003,0,11135362
H1|chr16:74132618-74132718,chr16,74132618,74132718,H1|chr16:85644379-85644395,chr16,85644379,85644395,0,11511761
H1|chr16:74689893-74689950,chr16,74689893,74689950,H1|chr16:9769469-9769545,chr16,9769469,9769545,0,64920424
H1|chr16:74920925-74920977,chr16,74920925,74920977,H1|chr16:85647652-85647750,chr16,85647652,85647750,0,10726727
H1|chr16:74991536-74991636,chr16,74991536,74991636,H1|chr16:85640492-85640542,chr16,85640492,85640542,0,10648956
H1|chr16:75177676-75177775,chr16,75177676,75177775,H1|chr16:88867827-88867862,chr16,88867827,88867862,0,13690151
H1|chr16:75462138-75462219,chr16,75462138,75462219,H1|chr16:9772577-9772642,chr16,9772577,9772642,0,65689561
H1|chr16:75494691-75494730,chr16,75494691,75494730,H1|chr16:85642917-85643028,chr16,85642917,85643028,0,10148226
H1|chr16:75653250-75653280,chr16,75653250,75653280,H1|chr16:9769834-9769982,chr16,9769834,9769982,0,65883416
H1|chr16:75916398-75916438,chr16,75916398,75916438,H1|chr16:85640212-85640322,chr16,85640212,85640322,0,9723814
H1|chr16:76175040-76175091,chr16,76175040,76175091,H1|chr16:14726925-14727033,chr16,14726925,14727033,0,61448115
H1|chr16:76296576-76296717,chr16,76296576,76296717,H1|chr16:67968904-67969024,chr16,67968904,67969024,0,8327672
H1|chr16:76377089-76377162,chr16,76377089,76377162,H1|chr16:85640908-85640985,chr16,85640908,85640985,0,9263819
H1|chr16:76443968-76444034,chr16,76443968,76444034,H1|chr16:68774150-68774234,chr16,68774150,68774234,0,7669818
H1|chr16:76445292-76445389,chr16,76445292,76445389,H1|chr16:89782798-89782845,chr16,89782798,89782845,0,13337506
H1|chr16:76484034-76484141,chr16,76484034,76484141,H1|chr16:56461910-56461950,chr16,56461910,56461950,0,20022124
H1|chr16:76513249-76513399,chr16,76513249,76513399,H1|chr16:9771916-9771956,chr16,9771916,9771956,0,66741333
H1|chr16:76568029-76568069,chr16,76568029,76568069,H1|chr16:3144972-3145082,chr16,3144972,3145082,0,73423057
H1|chr16:76600997-76601034,chr16,76600997,76601034,H1|chr16:3013378-3013442,chr16,3013378,3013442,0,73587619
H1|chr16:76726976-76727021,chr16,76726976,76727021,H1|chr16:8960236-8960324,chr16,8960236,8960324,0,67766740
H1|chr16:76835033-76835146,chr16,76835033,76835146,H1|chr16:89272075-89272112,chr16,89272075,89272112,0,12437042
H1|chr16:76868122-76868262,chr16,76868122,76868262,H1|chr16:67968904-67969024,chr16,67968904,67969024,0,8899218
H1|chr16:76870703-76870773,chr16,76870703,76870773,H1|chr16:31465892-31465917,chr16,31465892,31465917,0,45404811
H1|chr16:76930450-76930548,chr16,76930450,76930548,H1|chr16:85645119-85645170,chr16,85645119,85645170,0,8714669
H1|chr16:77071550-77071613,chr16,77071550,77071613,H1|chr16:56717613-56717695,chr16,56717613,56717695,0,20353937
H1|chr16:77113589-77113680,chr16,77113589,77113680,H1|chr16:3144972-3145082,chr16,3144972,3145082,0,73968617
H1|chr16:77142322-77142397,chr16,77142322,77142397,H1|chr16:85645661-85645692,chr16,85645661,85645692,0,8503339
H1|chr16:77169344-77169428,chr16,77169344,77169428,H1|chr16:89284913-89285019,chr16,89284913,89285019,0,12115569
H1|chr16:77302086-77302173,chr16,77302086,77302173,H1|chr16:88491214-88491273,chr16,88491214,88491273,0,11189128
H1|chr16:77394357-77394396,chr16,77394357,77394396,H1|chr16:9772051-9772162,chr16,9772051,9772162,0,67622306
H1|chr16:77442712-77442822,chr16,77442712,77442822,H1|chr16:9774036-9774127,chr16,9774036,9774127,0,67668676
H1|chr16:77465452-77465546,chr16,77465452,77465546,H1|chr16:70561853-70561922,chr16,70561853,70561922,0,6903599
H1|chr16:77525202-77525248,chr16,77525202,77525248,H1|chr16:87898988-87899089,chr16,87898988,87899089,0,10373786
H1|chr16:77659175-77659246,chr16,77659175,77659246,H1|chr16:85641456-85641534,chr16,85641456,85641534,0,7982281
H1|chr16:77883677-77883717,chr16,77883677,77883717,H1|chr16:3144972-3145082,chr16,3144972,3145082,0,74738705
H1|chr16:77952195-77952345,chr16,77952195,77952345,H1|chr16:85640908-85640985,chr16,85640908,85640985,0,7688713
H1|chr16:78010472-78010622,chr16,78010472,78010622,H1|chr16:4326380-4326433,chr16,4326380,4326433,0,73684092
H1|chr16:78044432-78044504,chr16,78044432,78044504,H1|chr16:793208-793283,chr16,793208,793283,0,77251224
H1|chr16:78105768-78105846,chr16,78105768,78105846,H1|chr16:31723555-31723616,chr16,31723555,31723616,0,46382213
H1|chr16:78240066-78240084,chr16,78240066,78240084,H1|chr16:87899068-87899217,chr16,87899068,87899217,0,9659002
H1|chr16:78451762-78451859,chr16,78451762,78451859,H1|chr16:89782798-89782845,chr16,89782798,89782845,0,11331036
H1|chr16:78529989-78530139,chr16,78529989,78530139,H1|chr16:87899093-87899199,chr16,87899093,87899199,0,9369104
H1|chr16:78535278-78535309,chr16,78535278,78535309,H1|chr16:87899446-87899592,chr16,87899446,87899592,0,9364168
H1|chr16:78851596-78851726,chr16,78851596,78851726,H1|chr16:31467493-31467566,chr16,31467493,31467566,0,47384103
H1|chr16:79110147-79110236,chr16,79110147,79110236,H1|chr16:11759786-11759816,chr16,11759786,11759816,0,67350361
H1|chr16:79184182-79184296,chr16,79184182,79184296,H1|chr16:89781858-89781960,chr16,89781858,89781960,0,10597676
H1|chr16:79211479-79211606,chr16,79211479,79211606,H1|chr16:87900158-87900285,chr16,87900158,87900285,0,8688679
H1|chr16:79231882-79231931,chr16,79231882,79231931,H1|chr16:23520325-23520409,chr16,23520325,23520409,0,55711557
H1|chr16:79242787-79242937,chr16,79242787,79242937,H1|chr16:75497349-75497499,chr16,75497349,75497499,0,3745438
H1|chr16:79293095-79293193,chr16,79293095,79293193,H1|chr16:85645119-85645170,chr16,85645119,85645170,0,6352024
H1|chr16:79460801-79460896,chr16,79460801,79460896,H1|chr16:2288981-2289080,chr16,2288981,2289080,0,77171820
H1|chr16:79497758-79497781,chr16,79497758,79497781,H1|chr16:31467554-31467704,chr16,31467554,31467704,0,48030204
H1|chr16:79498950-79499086,chr16,79498950,79499086,H1|chr16:791407-791428,chr16,791407,791428,0,78707543
H1|chr16:79520512-79520560,chr16,79520512,79520560,H1|chr16:8960236-8960324,chr16,8960236,8960324,0,70560276
H1|chr16:79561918-79562003,chr16,79561918,79562003,H1|chr16:89786676-89786712,chr16,89786676,89786712,0,10224758
H1|chr16:79575588-79575711,chr16,79575588,79575711,H1|chr16:31467029-31467062,chr16,31467029,31467062,0,48108559
H1|chr16:79741855-79741881,chr16,79741855,79741881,H1|chr16:794586-794710,chr16,794586,794710,0,78947269
H1|chr16:79851396-79851477,chr16,79851396,79851477,H1|chr16:70561853-70561922,chr16,70561853,70561922,0,9289543
H1|chr16:79882934-79882972,chr16,79882934,79882972,H1|chr16:85645940-85646010,chr16,85645940,85646010,0,5763006
H1|chr16:80059197-80059295,chr16,80059197,80059295,H1|chr16:9774959-9774993,chr16,9774959,9774993,0,70284238
H1|chr16:80072710-80072836,chr16,80072710,80072836,H1|chr16:89270709-89270757,chr16,89270709,89270757,0,9197999
H1|chr16:80174752-80174901,chr16,80174752,80174901,H1|chr16:9773315-9773366,chr16,9773315,9773366,0,70401437
H1|chr16:80238750-80238895,chr16,80238750,80238895,H1|chr16:18937922-18937973,chr16,18937922,18937973,0,61300828
H1|chr16:80334439-80334510,chr16,80334439,80334510,H1|chr16:56461910-56461950,chr16,56461910,56461950,0,23872529
H1|chr16:80488376-80488482,chr16,80488376,80488482,H1|chr16:25117081-25117118,chr16,25117081,25117118,0,55371295
H1|chr16:80648926-80649044,chr16,80648926,80649044,H1|chr16:2179148-2179181,chr16,2179148,2179181,0,78469778
H1|chr16:80833281-80833327,chr16,80833281,80833327,H1|chr16:3155396-3155471,chr16,3155396,3155471,0,77677885
H1|chr16:80858384-80858438,chr16,80858384,80858438,H1|chr16:18937930-18937990,chr16,18937930,18937990,0,61920454
H1|chr16:80898783-80898816,chr16,80898783,80898816,H1|chr16:8956577-8956674,chr16,8956577,8956674,0,71942206
H1|chr16:80941364-80941396,chr16,80941364,80941396,H1|chr16:89780336-89780486,chr16,89780336,89780486,0,8838972
H1|chr16:80974586-80974706,chr16,80974586,80974706,H1|chr16:85647575-85647605,chr16,85647575,85647605,0,4672989
H1|chr16:81139560-81139609,chr16,81139560,81139609,H1|chr16:89887958-89888039,chr16,89887958,89888039,0,8748398
H1|chr16:81240578-81240651,chr16,81240578,81240651,H1|chr16:31725155-31725232,chr16,31725155,31725232,0,49515423
H1|chr16:81398705-81398819,chr16,81398705,81398819,H1|chr16:89781858-89781960,chr16,89781858,89781960,0,8383153
H1|chr16:81463140-81463262,chr16,81463140,81463262,H1|chr16:88491214-88491273,chr16,88491214,88491273,0,7028074
H1|chr16:81463447-81463596,chr16,81463447,81463596,H1|chr16:9769579-9769605,chr16,9769579,9769605,0,71693868
H1|chr16:81506651-81506729,chr16,81506651,81506729,H1|chr16:87899042-87899192,chr16,87899042,87899192,0,6392391
H1|chr16:81678426-81678454,chr16,81678426,81678454,H1|chr16:75497675-75497742,chr16,75497675,75497742,0,6180751
H1|chr16:81896798-81896855,chr16,81896798,81896855,H1|chr16:75498043-75498193,chr16,75498043,75498193,0,6398755
H1|chr16:81932158-81932217,chr16,81932158,81932217,H1|chr16:85646625-85646671,chr16,85646625,85646671,0,3714467
H1|chr16:82032637-82032762,chr16,82032637,82032762,H1|chr16:87899717-87899843,chr16,87899717,87899843,0,5867080
H1|chr16:82075153-82075240,chr16,82075153,82075240,H1|chr16:18937922-18937982,chr16,18937922,18937982,0,63137231
H1|chr16:82285857-82286007,chr16,82285857,82286007,H1|chr16:18937922-18937976,chr16,18937922,18937976,0,63347935
H1|chr16:82413442-82413530,chr16,82413442,82413530,H1|chr16:795606-795643,chr16,795606,795643,0,81617836
H1|chr16:82451493-82451640,chr16,82451493,82451640,H1|chr16:87902223-87902373,chr16,87902223,87902373,0,5450730
H1|chr16:82473900-82473994,chr16,82473900,82473994,H1|chr16:85642917-85643028,chr16,85642917,85643028,0,3169017
H1|chr16:82487981-82488091,chr16,82487981,82488091,H1|chr16:9771916-9771956,chr16,9771916,9771956,0,72716065
H1|chr16:82710987-82711134,chr16,82710987,82711134,H1|chr16:1355098-1355167,chr16,1355098,1355167,0,81355889
H1|chr16:82938100-82938176,chr16,82938100,82938176,H1|chr16:89781194-89781242,chr16,89781194,89781242,0,6843094
H1|chr16:83027987-83028117,chr16,83027987,83028117,H1|chr16:3013685-3013716,chr16,3013685,3013716,0,80014302
H1|chr16:83092534-83092684,chr16,83092534,83092684,H1|chr16:87899087-87899234,chr16,87899087,87899234,0,4806553
H1|chr16:83572829-83572937,chr16,83572829,83572937,H1|chr16:9774036-9774127,chr16,9774036,9774127,0,73798793
H1|chr16:83713106-83713256,chr16,83713106,83713256,H1|chr16:87899037-87899185,chr16,87899037,87899185,0,4185931
H1|chr16:83776967-83777059,chr16,83776967,83777059,H1|chr16:89772333-89772391,chr16,89772333,89772391,0,5995366
H1|chr16:83778354-83778434,chr16,83778354,83778434,H1|chr16:56717553-56717608,chr16,56717553,56717608,0,27060801
H1|chr16:83805901-83806028,chr16,83805901,83806028,H1|chr16:56717613-56717695,chr16,56717613,56717695,0,27088288
H1|chr16:84094372-84094453,chr16,84094372,84094453,H1|chr16:31126890-31126942,chr16,31126890,31126942,0,52967482
H1|chr16:84203020-84203098,chr16,84203020,84203098,H1|chr16:31465892-31465917,chr16,31465892,31465917,0,52737128
H1|chr16:84508946-84509016,chr16,84508946,84509016,H1|chr16:24736822-24736876,chr16,24736822,24736876,0,59772124
H1|chr16:84526719-84526868,chr16,84526719,84526868,H1|chr16:9769579-9769605,chr16,9769579,9769605,0,74757140
H1|chr16:84625157-84625226,chr16,84625157,84625226,H1|chr16:75018566-75018596,chr16,75018566,75018596,0,9606591
H1|chr16:84781102-84781135,chr16,84781102,84781135,H1|chr16:8956577-8956674,chr16,8956577,8956674,0,75824525
H1|chr16:84802481-84802559,chr16,84802481,84802559,H1|chr16:3186642-3186720,chr16,3186642,3186720,0,81615839
H1|chr16:85034764-85034835,chr16,85034764,85034835,H1|chr16:85641456-85641534,chr16,85641456,85641534,0,606692
H1|chr16:85216113-85216208,chr16,85216113,85216208,H1|chr16:89782798-89782845,chr16,89782798,89782845,0,4566685
H1|chr16:85263431-85263485,chr16,85263431,85263485,H1|chr16:18937930-18937990,chr16,18937930,18937990,0,66325501
H1|chr16:85412178-85412274,chr16,85412178,85412274,H1|chr16:88867827-88867862,chr16,88867827,88867862,0,3455649
H1|chr16:85502285-85502363,chr16,85502285,85502363,H1|chr16:31723555-31723616,chr16,31723555,31723616,0,53778730
H1|chr16:85593275-85593293,chr16,85593275,85593293,H1|chr16:87899068-87899217,chr16,87899068,87899217,0,2305793
H1|chr16:85707295-85707435,chr16,85707295,85707435,H1|chr16:31467657-31467720,chr16,31467657,31467720,0,54239638
H1|chr16:85724135-85724285,chr16,85724135,85724285,H1|chr16:87902229-87902374,chr16,87902229,87902374,0,2178094
H1|chr16:85757693-85757792,chr16,85757693,85757792,H1|chr16:9769579-9769605,chr16,9769579,9769605,0,75988114
H1|chr16:86075571-86075641,chr16,86075571,86075641,H1|chr16:25270624-25270701,chr16,25270624,25270701,0,60804947
H1|chr16:86406404-86406542,chr16,86406404,86406542,H1|chr16:18937861-18937974,chr16,18937861,18937974,0,67468543
H1|chr16:86427795-86427890,chr16,86427795,86427890,H1|chr16:2288981-2289080,chr16,2288981,2289080,0,84138814
H1|chr16:86503673-86503772,chr16,86503673,86503772,H1|chr16:74699759-74699784,chr16,74699759,74699784,0,11803914
H1|chr16:86593098-86593178,chr16,86593098,86593178,H1|chr16:85640908-85640929,chr16,85640908,85640929,0,952190
H1|chr16:86650942-86651028,chr16,86650942,86651028,H1|chr16:3083623-3083687,chr16,3083623,3083687,0,83567319
H1|chr16:86962618-86962730,chr16,86962618,86962730,H1|chr16:23606457-23606489,chr16,23606457,23606489,0,63356161
H1|chr16:87070296-87070347,chr16,87070296,87070347,H1|chr16:2288981-2289080,chr16,2288981,2289080,0,84781315
H1|chr16:87072643-87072738,chr16,87072643,87072738,H1|chr16:9771889-9771945,chr16,9771889,9771945,0,77300754
H1|chr16:87117071-87117118,chr16,87117071,87117118,H1|chr16:9773048-9773147,chr16,9773048,9773147,0,77344023
H1|chr16:87131695-87131810,chr16,87131695,87131810,H1|chr16:2183080-2183120,chr16,2183080,2183120,0,84948615
H1|chr16:87316960-87317047,chr16,87316960,87317047,H1|chr16:85642737-85642800,chr16,85642737,85642800,0,1674223
H1|chr16:87659614-87659686,chr16,87659614,87659686,H1|chr16:31465892-31465917,chr16,31465892,31465917,0,56193722
H1|chr16:87660714-87660777,chr16,87660714,87660777,H1|chr16:85641856-85641901,chr16,85641856,85641901,0,2018858
H1|chr16:87703967-87704049,chr16,87703967,87704049,H1|chr16:88491214-88491280,chr16,88491214,88491280,0,787247
H1|chr16:87772995-87773031,chr16,87772995,87773031,H1|chr16:8957392-8957464,chr16,8957392,8957464,0,78815603
H1|chr16:87855398-87855435,chr16,87855398,87855435,H1|chr16:31464819-31464912,chr16,31464819,31464912,0,56390579
H1|chr16:87999600-87999701,chr16,87999600,87999701,H1|chr16:89268397-89268439,chr16,89268397,89268439,0,1268797
H1|chr16:88012730-88012767,chr16,88012730,88012767,H1|chr16:9774447-9774538,chr16,9774447,9774538,0,78238283
H1|chr16:88276953-88277002,chr16,88276953,88277002,H1|chr16:9771714-9771864,chr16,9771714,9771864,0,78505239
H1|chr16:88318937-88318975,chr16,88318937,88318975,H1|chr16:89284913-89285019,chr16,89284913,89285019,0,965976
H1|chr16:88437542-88437691,chr16,88437542,88437691,H1|chr16:87899090-87899234,chr16,87899090,87899234,0,538452
H1|chr16:88718955-88719082,chr16,88718955,88719082,H1|chr16:2179515-2179659,chr16,2179515,2179659,0,86539440
H1|chr16:88861723-88861813,chr16,88861723,88861813,H1|chr16:11759786-11759816,chr16,11759786,11759816,0,77101937
H1|chr16:88923990-88924140,chr16,88923990,88924140,H1|chr16:1757271-1757290,chr16,1757271,1757290,0,87166719
H1|chr16:89028758-89028839,chr16,89028758,89028839,H1|chr16:89628517-89628540,chr16,89628517,89628540,0,599759
H1|chr16:89049713-89049796,chr16,89049713,89049796,H1|chr16:84730939-84731003,chr16,84730939,84731003,0,4318774
H1|chr16:89063153-89063227,chr16,89063153,89063227,H1|chr16:3148330-3148390,chr16,3148330,3148390,0,85914823
H1|chr16:89201673-89201714,chr16,89201673,89201714,H1|chr16:87899143-87899287,chr16,87899143,87899287,0,1302530
H1|chr16:89263101-89263119,chr16,89263101,89263119,H1|chr16:70559260-70559410,chr16,70559260,70559410,0,18703841
H1|chr16:89294185-89294202,chr16,89294185,89294202,H1|chr16:3011383-3011520,chr16,3011383,3011520,0,86282802
H1|chr16:89486274-89486390,chr16,89486274,89486390,H1|chr16:2179585-2179720,chr16,2179585,2179720,0,87306689
H1|chr16:89524839-89524884,chr16,89524839,89524884,H1|chr16:31713414-31713455,chr16,31713414,31713455,0,57811425
H1|chr16:89602551-89602644,chr16,89602551,89602644,H1|chr16:3084482-3084539,chr16,3084482,3084539,0,86518069
H1|chr16:89801392-89801443,chr16,89801392,89801443,H1|chr16:85641906-85641968,chr16,85641906,85641968,0,4159486
H1|chr16:89836063-89836095,chr16,89836063,89836095,H1|chr16:9772562-9772712,chr16,9772562,9772712,0,80063501
H1|chr16:90202412-90202490,chr16,90202412,90202490,H1|chr16:87899042-87899192,chr16,87899042,87899192,0,2303370
H1|chr16:90215385-90215501,chr16,90215385,90215501,H1|chr16:9768494-9768558,chr16,9768494,9768558,0,80446891
H1|chr16:90242028-90242075,chr16,90242028,90242075,H1|chr16:58660789-58660879,chr16,58660789,58660879,0,31581239
H1|chr16:90277041-90277092,chr16,90277041,90277092,H1|chr16:18937909-18938059,chr16,18937909,18938059,0,71339132
H1|chr17:94895-95044,chr17,94895,95044,H1|chr17:62915755-62915900,chr17,62915755,62915900,0,62820860
H1|chr17:283112-283149,chr17,283112,283149,H1|chr17:62918454-62918566,chr17,62918454,62918566,0,62635342
H1|chr17:296243-296292,chr17,296243,296292,H1|chr17:4170041-4170134,chr17,4170041,4170134,0,3873798
H1|chr17:405742-405812,chr17,405742,405812,H1|chr17:65822514-65822594,chr17,65822514,65822594,0,65416772
H1|chr17:570039-570078,chr17,570039,570078,H1|chr17:63055942-63055970,chr17,63055942,63055970,0,62485903
H1|chr17:699831-699933,chr17,699831,699933,H1|chr17:62915435-62915521,chr17,62915435,62915521,0,62215604
H1|chr17:720686-720719,chr17,720686,720719,H1|chr17:65825367-65825474,chr17,65825367,65825474,0,65104681
H1|chr17:771511-771560,chr17,771511,771560,H1|chr17:36612604-36612705,chr17,36612604,36612705,0,35841093
H1|chr17:864130-864175,chr17,864130,864175,H1|chr17:7466012-7466082,chr17,7466012,7466082,0,6601882
H1|chr17:878063-878107,chr17,878063,878107,H1|chr17:7383903-7384045,chr17,7383903,7384045,0,6505840
H1|chr17:1010964-1011023,chr17,1010964,1011023,H1|chr17:62918449-62918597,chr17,62918449,62918597,0,61907485
H1|chr17:1031074-1031123,chr17,1031074,1031123,H1|chr17:62918454-62918532,chr17,62918454,62918532,0,61887380
H1|chr17:1107919-1107963,chr17,1107919,1107963,H1|chr17:7383903-7384045,chr17,7383903,7384045,0,6275984
H1|chr17:1246743-1246800,chr17,1246743,1246800,H1|chr17:62918454-62918532,chr17,62918454,62918532,0,61671711
H1|chr17:1262742-1262816,chr17,1262742,1262816,H1|chr17:74120079-74120154,chr17,74120079,74120154,0,72857337
H1|chr17:1369121-1369159,chr17,1369121,1369159,H1|chr17:42191043-42191074,chr17,42191043,42191074,0,40821922
H1|chr17:1397101-1397178,chr17,1397101,1397178,H1|chr17:27717418-27717461,chr17,27717418,27717461,0,26320317
H1|chr17:1442967-1442989,chr17,1442967,1442989,H1|chr17:62918452-62918580,chr17,62918452,62918580,0,61475485
H1|chr17:1751800-1751831,chr17,1751800,1751831,H1|chr17:62918449-62918568,chr17,62918449,62918568,0,61166649
H1|chr17:1910449-1910523,chr17,1910449,1910523,H1|chr17:62918454-62918530,chr17,62918454,62918530,0,61008005
H1|chr17:1977066-1977155,chr17,1977066,1977155,H1|chr17:48424824-48424871,chr17,48424824,48424871,0,46447758
H1|chr17:2213033-2213091,chr17,2213033,2213091,H1|chr17:65244793-65244863,chr17,65244793,65244863,0,63031760
H1|chr17:2267135-2267184,chr17,2267135,2267184,H1|chr17:35076963-35077064,chr17,35076963,35077064,0,32809828
H1|chr17:2298980-2299130,chr17,2298980,2299130,H1|chr17:62915755-62915900,chr17,62915755,62915900,0,60616775
H1|chr17:2555179-2555329,chr17,2555179,2555329,H1|chr17:62915469-62915579,chr17,62915469,62915579,0,60360290
H1|chr17:2560436-2560547,chr17,2560436,2560547,H1|chr17:43322472-43322559,chr17,43322472,43322559,0,40762036
H1|chr17:2578024-2578114,chr17,2578024,2578114,H1|chr17:36608483-36608566,chr17,36608483,36608566,0,34030459
H1|chr17:2632085-2632136,chr17,2632085,2632136,H1|chr17:27718472-27718569,chr17,27718472,27718569,0,25086387
H1|chr17:2693409-2693439,chr17,2693409,2693439,H1|chr17:36580716-36580786,chr17,36580716,36580786,0,33887307
H1|chr17:2917033-2917146,chr17,2917033,2917146,H1|chr17:44316959-44316996,chr17,44316959,44316996,0,41399926
H1|chr17:3103881-3103976,chr17,3103881,3103976,H1|chr17:17726151-17726206,chr17,17726151,17726206,0,14622270
H1|chr17:3182980-3183129,chr17,3182980,3183129,H1|chr17:20436693-20436745,chr17,20436693,20436745,0,17253713
H1|chr17:3282277-3282372,chr17,3282277,3282372,H1|chr17:74121063-74121118,chr17,74121063,74121118,0,70838786
H1|chr17:3491049-3491193,chr17,3491049,3491193,H1|chr17:62915431-62915528,chr17,62915431,62915528,0,59424382
H1|chr17:3525406-3525455,chr17,3525406,3525455,H1|chr17:62918454-62918532,chr17,62918454,62918532,0,59393048
H1|chr17:3573371-3573432,chr17,3573371,3573432,H1|chr17:36580547-36580578,chr17,36580547,36580578,0,33007176
H1|chr17:3654808-3654903,chr17,3654808,3654903,H1|chr17:42191043-42191074,chr17,42191043,42191074,0,38536235
H1|chr17:3719609-3719759,chr17,3719609,3719759,H1|chr17:62915456-62915579,chr17,62915456,62915579,0,59195847
H1|chr17:3871347-3871386,chr17,3871347,3871386,H1|chr17:62918454-62918532,chr17,62918454,62918532,0,59047107
H1|chr17:3903264-3903314,chr17,3903264,3903314,H1|chr17:36581172-36581262,chr17,36581172,36581262,0,32677908
H1|chr17:3947145-3947256,chr17,3947145,3947256,H1|chr17:36612344-36612363,chr17,36612344,36612363,0,32665199
H1|chr17:4026662-4026752,chr17,4026662,4026752,H1|chr17:27169319-27169336,chr17,27169319,27169336,0,23142657
H1|chr17:4240392-4240437,chr17,4240392,4240437,H1|chr17:7466012-7466082,chr17,7466012,7466082,0,3225620
H1|chr17:4312523-4312596,chr17,4312523,4312596,H1|chr17:62918516-62918587,chr17,62918516,62918587,0,58605993
H1|chr17:4372813-4372852,chr17,4372813,4372852,H1|chr17:44316593-44316648,chr17,44316593,44316648,0,39943780
H1|chr17:4536371-4536414,chr17,4536371,4536414,H1|chr17:62918449-62918572,chr17,62918449,62918572,0,58382078
H1|chr17:4600343-4600411,chr17,4600343,4600411,H1|chr17:62918449-62918587,chr17,62918449,62918587,0,58318106
H1|chr17:4695512-4695560,chr17,4695512,4695560,H1|chr17:62918454-62918532,chr17,62918454,62918532,0,58222942
H1|chr17:4829202-4829243,chr17,4829202,4829243,H1|chr17:7466012-7466082,chr17,7466012,7466082,0,2636810
H1|chr17:4891038-4891058,chr17,4891038,4891058,H1|chr17:65825338-65825366,chr17,65825338,65825366,0,60934300
H1|chr17:5018911-5018941,chr17,5018911,5018941,H1|chr17:74448227-74448323,chr17,74448227,74448323,0,69429316
H1|chr17:5036318-5036346,chr17,5036318,5036346,H1|chr17:36580640-36580760,chr17,36580640,36580760,0,31544322
H1|chr17:5055064-5055181,chr17,5055064,5055181,H1|chr17:36610436-36610460,chr17,36610436,36610460,0,31555372
H1|chr17:5057872-5057969,chr17,5057872,5057969,H1|chr17:75448413-75448509,chr17,75448413,75448509,0,70390541
H1|chr17:5125694-5125771,chr17,5125694,5125771,H1|chr17:65246575-65246600,chr17,65246575,65246600,0,60120881
H1|chr17:5252312-5252380,chr17,5252312,5252380,H1|chr17:62918449-62918587,chr17,62918449,62918587,0,57666137
H1|chr17:5265357-5265380,chr17,5265357,5265380,H1|chr17:74448669-74448796,chr17,74448669,74448796,0,69183312
H1|chr17:5295718-5295771,chr17,5295718,5295771,H1|chr17:36507821-36507936,chr17,36507821,36507936,0,31212103
H1|chr17:5415064-5415119,chr17,5415064,5415119,H1|chr17:62918486-62918633,chr17,62918486,62918633,0,57503422
H1|chr17:5445814-5445853,chr17,5445814,5445853,H1|chr17:44316593-44316648,chr17,44316593,44316648,0,38870779
H1|chr17:5562817-5562905,chr17,5562817,5562905,H1|chr17:44318719-44318774,chr17,44318719,44318774,0,38755902
H1|chr17:5603047-5603076,chr17,5603047,5603076,H1|chr17:27138404-27138477,chr17,27138404,27138477,0,21535357
H1|chr17:5711594-5711628,chr17,5711594,5711628,H1|chr17:62918449-62918597,chr17,62918449,62918597,0,57206855
H1|chr17:5764737-5764784,chr17,5764737,5764784,H1|chr17:38514240-38514328,chr17,38514240,38514328,0,32749503
H1|chr17:5961505-5961547,chr17,5961505,5961547,H1|chr17:44316439-44316547,chr17,44316439,44316547,0,38354934
H1|chr17:6092086-6092236,chr17,6092086,6092236,H1|chr17:20434293-20434424,chr17,20434293,20434424,0,14342207
H1|chr17:6099508-6099584,chr17,6099508,6099584,H1|chr17:62918449-62918587,chr17,62918449,62918587,0,56818941
H1|chr17:6170399-6170482,chr17,6170399,6170482,H1|chr17:36580536-36580603,chr17,36580536,36580603,0,30410137
H1|chr17:6296858-6296893,chr17,6296858,6296893,H1|chr17:36507821-36507936,chr17,36507821,36507936,0,30210963
H1|chr17:6348482-6348546,chr17,6348482,6348546,H1|chr17:41277935-41277993,chr17,41277935,41277993,0,34929453
H1|chr17:6478674-6478719,chr17,6478674,6478719,H1|chr17:74122254-74122300,chr17,74122254,74122300,0,67643580
H1|chr17:6700930-6701011,chr17,6700930,6701011,H1|chr17:36580622-36580691,chr17,36580622,36580691,0,29879692
H1|chr17:6875160-6875187,chr17,6875160,6875187,H1|chr17:62918449-62918572,chr17,62918449,62918572,0,56043289
H1|chr17:6909338-6909417,chr17,6909338,6909417,H1|chr17:74120138-74120205,chr17,74120138,74120205,0,67210800
H1|chr17:6926291-6926346,chr17,6926291,6926346,H1|chr17:74118525-74118567,chr17,74118525,74118567,0,67192234
H1|chr17:7081783-7081933,chr17,7081783,7081933,H1|chr17:62915471-62915583,chr17,62915471,62915583,0,55833688
H1|chr17:7232982-7233053,chr17,7232982,7233053,H1|chr17:62918455-62918534,chr17,62918455,62918534,0,55685473
H1|chr17:7244242-7244390,chr17,7244242,7244390,H1|chr17:20436717-20436789,chr17,20436717,20436789,0,13192475
H1|chr17:7249563-7249585,chr17,7249563,7249585,H1|chr17:62918452-62918580,chr17,62918452,62918580,0,55668889
H1|chr17:7436601-7436665,chr17,7436601,7436665,H1|chr17:41277935-41277993,chr17,41277935,41277993,0,33841334
H1|chr17:7465827-7465932,chr17,7465827,7465932,H1|chr17:17726151-17726206,chr17,17726151,17726206,0,10260324
H1|chr17:7729960-7730000,chr17,7729960,7730000,H1|chr17:46135238-46135347,chr17,46135238,46135347,0,38405278
H1|chr17:8005845-8005864,chr17,8005845,8005864,H1|chr17:36582166-36582316,chr17,36582166,36582316,0,28576321
H1|chr17:8008794-8008944,chr17,8008794,8008944,H1|chr17:62915476-62915575,chr17,62915476,62915575,0,54906682
H1|chr17:8119597-8119699,chr17,8119597,8119699,H1|chr17:1360676-1360728,chr17,1360676,1360728,0,6758921
H1|chr17:8172570-8172645,chr17,8172570,8172645,H1|chr17:47928243-47928393,chr17,47928243,47928393,0,39755673
H1|chr17:8252439-8252536,chr17,8252439,8252536,H1|chr17:62915431-62915538,chr17,62915431,62915538,0,54662992
H1|chr17:8269388-8269437,chr17,8269388,8269437,H1|chr17:4170041-4170134,chr17,4170041,4170134,0,4099347
H1|chr17:8473781-8473821,chr17,8473781,8473821,H1|chr17:46985111-46985155,chr17,46985111,46985155,0,38511330
H1|chr17:8544907-8544984,chr17,8544907,8544984,H1|chr17:62915431-62915523,chr17,62915431,62915523,0,54370524
H1|chr17:8582969-8583050,chr17,8582969,8583050,H1|chr17:62915425-62915559,chr17,62915425,62915559,0,54332456
H1|chr17:8683146-8683202,chr17,8683146,8683202,H1|chr17:62918449-62918580,chr17,62918449,62918580,0,54235303
H1|chr17:8878687-8878801,chr17,8878687,8878801,H1|chr17:62918454-62918551,chr17,62918454,62918551,0,54039767
H1|chr17:9009897-9009999,chr17,9009897,9009999,H1|chr17:62918449-62918580,chr17,62918449,62918580,0,53908552
H1|chr17:9084625-9084775,chr17,9084625,9084775,H1|chr17:75451945-75451988,chr17,75451945,75451988,0,66367320
H1|chr17:9202679-9202757,chr17,9202679,9202757,H1|chr17:62918454-62918530,chr17,62918454,62918530,0,53715775
H1|chr17:9352814-9352882,chr17,9352814,9352882,H1|chr17:35075760-35075803,chr17,35075760,35075803,0,25722946
H1|chr17:9449907-9449970,chr17,9449907,9449970,H1|chr17:44316442-44316518,chr17,44316442,44316518,0,34866535
H1|chr17:9461317-9461392,chr17,9461317,9461392,H1|chr17:38278091-38278140,chr17,38278091,38278140,0,28816774
H1|chr17:9487303-9487379,chr17,9487303,9487379,H1|chr17:44316105-44316162,chr17,44316105,44316162,0,34828802
H1|chr17:9603522-9603664,chr17,9603522,9603664,H1|chr17:44316959-44316996,chr17,44316959,44316996,0,34713437
H1|chr17:9769516-9769666,chr17,9769516,9769666,H1|chr17:62915431-62915532,chr17,62915431,62915532,0,53145915
H1|chr17:9874187-9874255,chr17,9874187,9874255,H1|chr17:38277292-38277354,chr17,38277292,38277354,0,28403105
H1|chr17:9972914-9972984,chr17,9972914,9972984,H1|chr17:36579809-36579889,chr17,36579809,36579889,0,26606895
H1|chr17:9991780-9991882,chr17,9991780,9991882,H1|chr17:62915435-62915521,chr17,62915435,62915521,0,52923655
H1|chr17:10002227-10002357,chr17,10002227,10002357,H1|chr17:62915633-62915783,chr17,62915633,62915783,0,52913406
H1|chr17:10257519-10257666,chr17,10257519,10257666,H1|chr17:62915448-62915582,chr17,62915448,62915582,0,52657929
H1|chr17:10619557-10619641,chr17,10619557,10619641,H1|chr17:62915431-62915538,chr17,62915431,62915538,0,52295874
H1|chr17:10665169-10665213,chr17,10665169,10665213,H1|chr17:36580511-36580573,chr17,36580511,36580573,0,25915342
H1|chr17:10716351-10716442,chr17,10716351,10716442,H1|chr17:36580536-36580603,chr17,36580536,36580603,0,25864185
H1|chr17:10727682-10727735,chr17,10727682,10727735,H1|chr17:62915430-62915532,chr17,62915430,62915532,0,52187748
H1|chr17:10765269-10765361,chr17,10765269,10765361,H1|chr17:27169319-27169336,chr17,27169319,27169336,0,16404050
H1|chr17:10801056-10801184,chr17,10801056,10801184,H1|chr17:36580622-36580691,chr17,36580622,36580691,0,25779566
H1|chr17:10954637-10954714,chr17,10954637,10954714,H1|chr17:25606479-25606544,chr17,25606479,25606544,0,14651842
H1|chr17:11021478-11021522,chr17,11021478,11021522,H1|chr17:34949625-34949731,chr17,34949625,34949731,0,23928147
H1|chr17:11187683-11187754,chr17,11187683,11187754,H1|chr17:62918449-62918520,chr17,62918449,62918520,0,51730766
H1|chr17:11262046-11262079,chr17,11262046,11262079,H1|chr17:27190479-27190589,chr17,27190479,27190589,0,15928433
H1|chr17:11308498-11308531,chr17,11308498,11308531,H1|chr17:34959156-34959241,chr17,34959156,34959241,0,23650658
H1|chr17:11441800-11441850,chr17,11441800,11441850,H1|chr17:80058268-80058358,chr17,80058268,80058358,0,68616468
H1|chr17:11452403-11452421,chr17,11452403,11452421,H1|chr17:1733520-1733646,chr17,1733520,1733646,0,9718883
H1|chr17:11475504-11475528,chr17,11475504,11475528,H1|chr17:62918449-62918555,chr17,62918449,62918555,0,51442945
H1|chr17:11726438-11726549,chr17,11726438,11726549,H1|chr17:46987415-46987449,chr17,46987415,46987449,0,35260977
H1|chr17:12045671-12045704,chr17,12045671,12045704,H1|chr17:65825367-65825474,chr17,65825367,65825474,0,53779696
H1|chr17:12303014-12303087,chr17,12303014,12303087,H1|chr17:74120079-74120154,chr17,74120079,74120154,0,61817065
H1|chr17:12309186-12309283,chr17,12309186,12309283,H1|chr17:1360626-1360712,chr17,1360626,1360712,0,10948560
H1|chr17:12443624-12443697,chr17,12443624,12443697,H1|chr17:62918449-62918574,chr17,62918449,62918574,0,50474825
H1|chr17:12691683-12691799,chr17,12691683,12691799,H1|chr17:79820781-79820815,chr17,79820781,79820815,0,67129098
H1|chr17:12769204-12769246,chr17,12769204,12769246,H1|chr17:44316439-44316547,chr17,44316439,44316547,0,31547235
H1|chr17:13000182-13000204,chr17,13000182,13000204,H1|chr17:62918449-62918519,chr17,62918449,62918519,0,49918267
H1|chr17:13134419-13134452,chr17,13134419,13134452,H1|chr17:62918454-62918552,chr17,62918454,62918552,0,49784035
H1|chr17:13165131-13165226,chr17,13165131,13165226,H1|chr17:42191043-42191074,chr17,42191043,42191074,0,29025912
H1|chr17:13275743-13275778,chr17,13275743,13275778,H1|chr17:62918449-62918572,chr17,62918449,62918572,0,49642706
H1|chr17:13570052-13570116,chr17,13570052,13570116,H1|chr17:38273511-38273596,chr17,38273511,38273596,0,24703459
H1|chr17:13643870-13644020,chr17,13643870,13644020,H1|chr17:43567254-43567404,chr17,43567254,43567404,0,29923384
H1|chr17:13653422-13653492,chr17,13653422,13653492,H1|chr17:65972955-65973008,chr17,65972955,65973008,0,52319533
H1|chr17:13668352-13668451,chr17,13668352,13668451,H1|chr17:74262692-74262772,chr17,74262692,74262772,0,60594340
H1|chr17:13690684-13690833,chr17,13690684,13690833,H1|chr17:20436693-20436745,chr17,20436693,20436745,0,6746009
H1|chr17:14023682-14023741,chr17,14023682,14023741,H1|chr17:62918449-62918597,chr17,62918449,62918597,0,48894767
H1|chr17:14096841-14096947,chr17,14096841,14096947,H1|chr17:36612604-36612705,chr17,36612604,36612705,0,22515763
H1|chr17:14141088-14141197,chr17,14141088,14141197,H1|chr17:35076963-35077064,chr17,35076963,35077064,0,20935875
H1|chr17:14365801-14365891,chr17,14365801,14365891,H1|chr17:62918454-62918551,chr17,62918454,62918551,0,48552653
H1|chr17:14454992-14455053,chr17,14454992,14455053,H1|chr17:62918449-62918538,chr17,62918449,62918538,0,48463457
H1|chr17:14641832-14641894,chr17,14641832,14641894,H1|chr17:74119654-74119804,chr17,74119654,74119804,0,59477822
H1|chr17:14673350-14673439,chr17,14673350,14673439,H1|chr17:44319851-44319912,chr17,44319851,44319912,0,29646501
H1|chr17:14686916-14686966,chr17,14686916,14686966,H1|chr17:44316440-44316585,chr17,44316440,44316585,0,29629524
H1|chr17:14738417-14738493,chr17,14738417,14738493,H1|chr17:62918449-62918587,chr17,62918449,62918587,0,48180032
H1|chr17:14978712-14978781,chr17,14978712,14978781,H1|chr17:56084163-56084192,chr17,56084163,56084192,0,41105451
H1|chr17:15079092-15079157,chr17,15079092,15079157,H1|chr17:65826236-65826292,chr17,65826236,65826292,0,50747144
H1|chr17:15096011-15096064,chr17,15096011,15096064,H1|chr17:62915430-62915532,chr17,62915430,62915532,0,47819419
H1|chr17:15121243-15121336,chr17,15121243,15121336,H1|chr17:62918454-62918526,chr17,62918454,62918526,0,47797211
H1|chr17:15224945-15225087,chr17,15224945,15225087,H1|chr17:44316959-44316996,chr17,44316959,44316996,0,29092014
H1|chr17:15490844-15490874,chr17,15490844,15490874,H1|chr17:62918454-62918571,chr17,62918454,62918571,0,47427610
H1|chr17:15520541-15520619,chr17,15520541,15520619,H1|chr17:62918454-62918530,chr17,62918454,62918530,0,47397913
H1|chr17:15644272-15644334,chr17,15644272,15644334,H1|chr17:74121063-74121118,chr17,74121063,74121118,0,58476791
H1|chr17:15780583-15780653,chr17,15780583,15780653,H1|chr17:36580476-36580534,chr17,36580476,36580534,0,20799893
H1|chr17:16091062-16091161,chr17,16091062,16091161,H1|chr17:62918449-62918592,chr17,62918449,62918592,0,46827387
H1|chr17:16143900-16143956,chr17,16143900,16143956,H1|chr17:62918449-62918580,chr17,62918449,62918580,0,46774549
H1|chr17:16275210-16275254,chr17,16275210,16275254,H1|chr17:62918454-62918532,chr17,62918454,62918532,0,46643244
H1|chr17:16350393-16350521,chr17,16350393,16350521,H1|chr17:36580622-36580691,chr17,36580622,36580691,0,20230229
H1|chr17:16404103-16404193,chr17,16404103,16404193,H1|chr17:36608483-36608566,chr17,36608483,36608566,0,20204380
H1|chr17:16680115-16680261,chr17,16680115,16680261,H1|chr17:20434261-20434407,chr17,20434261,20434407,0,3754146
H1|chr17:16701228-16701321,chr17,16701228,16701321,H1|chr17:62918454-62918526,chr17,62918454,62918526,0,46217226
H1|chr17:16759764-16759858,chr17,16759764,16759858,H1|chr17:42191043-42191074,chr17,42191043,42191074,0,25431279
H1|chr17:16862702-16862774,chr17,16862702,16862774,H1|chr17:28804582-28804611,chr17,28804582,28804611,0,11941880
H1|chr17:16921239-16921301,chr17,16921239,16921301,H1|chr17:62918455-62918534,chr17,62918455,62918534,0,45997216
H1|chr17:16935255-16935328,chr17,16935255,16935328,H1|chr17:62918449-62918524,chr17,62918449,62918524,0,45983194
H1|chr17:16947130-16947173,chr17,16947130,16947173,H1|chr17:62918454-62918532,chr17,62918454,62918532,0,45971324
H1|chr17:16955970-16956112,chr17,16955970,16956112,H1|chr17:62915428-62915577,chr17,62915428,62915577,0,45959458
H1|chr17:17003096-17003124,chr17,17003096,17003124,H1|chr17:62918452-62918580,chr17,62918452,62918580,0,45915356
H1|chr17:17055955-17056013,chr17,17055955,17056013,H1|chr17:17726151-17726206,chr17,17726151,17726206,0,670196
H1|chr17:17092629-17092676,chr17,17092629,17092676,H1|chr17:74119045-74119094,chr17,74119045,74119094,0,57026416
H1|chr17:17118188-17118236,chr17,17118188,17118236,H1|chr17:65825367-65825474,chr17,65825367,65825474,0,48707179
H1|chr17:17346489-17346554,chr17,17346489,17346554,H1|chr17:34949625-34949731,chr17,34949625,34949731,0,17603136
H1|chr17:17442756-17442832,chr17,17442756,17442832,H1|chr17:3542056-3542128,chr17,3542056,3542128,0,13900700
H1|chr17:17610135-17610214,chr17,17610135,17610214,H1|chr17:62918449-62918596,chr17,62918449,62918596,0,45308314
H1|chr17:17675921-17675946,chr17,17675921,17675946,H1|chr17:62918449-62918574,chr17,62918449,62918574,0,45242528
H1|chr17:17918541-17918586,chr17,17918541,17918586,H1|chr17:62918453-62918556,chr17,62918453,62918556,0,44999912
H1|chr17:18094966-18095098,chr17,18094966,18095098,H1|chr17:62918638-62918656,chr17,62918638,62918656,0,44823672
H1|chr17:18152952-18153043,chr17,18152952,18153043,H1|chr17:40730722-40730778,chr17,40730722,40730778,0,22577770
H1|chr17:18390042-18390125,chr17,18390042,18390125,H1|chr17:62918454-62918553,chr17,62918454,62918553,0,44528412
H1|chr17:18467445-18467545,chr17,18467445,18467545,H1|chr17:75137343-75137391,chr17,75137343,75137391,0,56669898
H1|chr17:18544286-18544344,chr17,18544286,18544344,H1|chr17:62918449-62918526,chr17,62918449,62918526,0,44374163
H1|chr17:18565059-18565209,chr17,18565059,18565209,H1|chr17:62915456-62915579,chr17,62915456,62915579,0,44350397
H1|chr17:19176075-19176126,chr17,19176075,19176126,H1|chr17:36580718-36580788,chr17,36580718,36580788,0,17404643
H1|chr17:19236713-19236858,chr17,19236713,19236858,H1|chr17:36579809-36579889,chr17,36579809,36579889,0,17343096
H1|chr17:19453965-19454106,chr17,19453965,19454106,H1|chr17:62915631-62915780,chr17,62915631,62915780,0,43461666
H1|chr17:19535702-19535769,chr17,19535702,19535769,H1|chr17:65972955-65973008,chr17,65972955,65973008,0,46437253
H1|chr17:19569571-19569616,chr17,19569571,19569616,H1|chr17:62918449-62918554,chr17,62918449,62918554,0,43348878
H1|chr17:19833210-19833228,chr17,19833210,19833228,H1|chr17:36610436-36610460,chr17,36610436,36610460,0,16777226
H1|chr17:19838938-19838968,chr17,19838938,19838968,H1|chr17:36580716-36580786,chr17,36580716,36580786,0,16741778
H1|chr17:19854396-19854479,chr17,19854396,19854479,H1|chr17:62915431-62915519,chr17,62915431,62915519,0,43061035
H1|chr17:19864884-19864919,chr17,19864884,19864919,H1|chr17:36584033-36584129,chr17,36584033,36584129,0,16719149
H1|chr17:20020950-20021026,chr17,20020950,20021026,H1|chr17:44316163-44316272,chr17,44316163,44316272,0,24295213
H1|chr17:20022257-20022370,chr17,20022257,20022370,H1|chr17:44316959-44316996,chr17,44316959,44316996,0,24294702
H1|chr17:20120885-20120946,chr17,20120885,20120946,H1|chr17:62918449-62918538,chr17,62918449,62918538,0,42797564
H1|chr17:20229560-20229665,chr17,20229560,20229665,H1|chr17:74120174-74120205,chr17,74120174,74120205,0,53890614
H1|chr17:20280523-20280568,chr17,20280523,20280568,H1|chr17:74122254-74122300,chr17,74122254,74122300,0,53841731
H1|chr17:20321610-20321678,chr17,20321610,20321678,H1|chr17:38277292-38277354,chr17,38277292,38277354,0,17955682
H1|chr17:20499387-20499495,chr17,20499387,20499495,H1|chr17:62915431-62915538,chr17,62915431,62915538,0,42416044
H1|chr17:20600781-20600828,chr17,20600781,20600828,H1|chr17:74119045-74119094,chr17,74119045,74119094,0,53518264
H1|chr17:20647305-20647365,chr17,20647305,20647365,H1|chr17:65244793-65244863,chr17,65244793,65244863,0,44597488
H1|chr17:20735459-20735569,chr17,20735459,20735569,H1|chr17:46987415-46987449,chr17,46987415,46987449,0,26251956
H1|chr17:20885622-20885655,chr17,20885622,20885655,H1|chr17:75086770-75086850,chr17,75086770,75086850,0,54201148
H1|chr17:20897442-20897490,chr17,20897442,20897490,H1|chr17:65825367-65825474,chr17,65825367,65825474,0,44927925
H1|chr17:20941775-20941796,chr17,20941775,20941796,H1|chr17:1733520-1733646,chr17,1733520,1733646,0,19208255
H1|chr17:21393021-21393068,chr17,21393021,21393068,H1|chr17:65825367-65825474,chr17,65825367,65825474,0,44432346
H1|chr17:21521930-21522078,chr17,21521930,21522078,H1|chr17:20436717-20436789,chr17,20436717,20436789,0,1085213
H1|chr17:21861995-21862140,chr17,21861995,21862140,H1|chr17:62915431-62915539,chr17,62915431,62915539,0,41053436
H1|chr17:22193452-22193499,chr17,22193452,22193499,H1|chr17:7194735-7194802,chr17,7194735,7194802,0,14998717
H1|chr17:22198706-22198743,chr17,22198706,22198743,H1|chr17:36581792-36581860,chr17,36581792,36581860,0,14383086
H1|chr17:22322599-22322682,chr17,22322599,22322682,H1|chr17:62918454-62918553,chr17,62918454,62918553,0,40595855
H1|chr17:22323216-22323257,chr17,22323216,22323257,H1|chr17:62918449-62918572,chr17,62918449,62918572,0,40595233
H1|chr17:22487486-22487631,chr17,22487486,22487631,H1|chr17:62918638-62918656,chr17,62918638,62918656,0,40431152
H1|chr17:22599020-22599054,chr17,22599020,22599054,H1|chr17:74117754-74117863,chr17,74117754,74117863,0,51518734
H1|chr17:22635818-22635847,chr17,22635818,22635847,H1|chr17:27138404-27138477,chr17,27138404,27138477,0,4502586
H1|chr17:22775869-22775945,chr17,22775869,22775945,H1|chr17:38278091-38278140,chr17,38278091,38278140,0,15502222
H1|chr17:23115613-23115655,chr17,23115613,23115655,H1|chr17:74119039-74119094,chr17,74119039,74119094,0,51003426
H1|chr17:23270892-23270961,chr17,23270892,23270961,H1|chr17:63055940-63055970,chr17,63055940,63055970,0,39785048
H1|chr17:23360630-23360652,chr17,23360630,23360652,H1|chr17:18906713-18906772,chr17,18906713,18906772,0,4453917
H1|chr17:23561598-23561643,chr17,23561598,23561643,H1|chr17:62918505-62918586,chr17,62918505,62918586,0,39356907
H1|chr17:23630135-23630165,chr17,23630135,23630165,H1|chr17:62918449-62918586,chr17,62918449,62918586,0,39288314
H1|chr17:23704212-23704261,chr17,23704212,23704261,H1|chr17:62918449-62918589,chr17,62918449,62918589,0,39214237
H1|chr17:23711549-23711593,chr17,23711549,23711593,H1|chr17:62918454-62918524,chr17,62918454,62918524,0,39206905
H1|chr17:23832347-23832405,chr17,23832347,23832405,H1|chr17:36582201-36582317,chr17,36582201,36582317,0,12749854
H1|chr17:23937625-23937748,chr17,23937625,23937748,H1|chr17:26369038-26369065,chr17,26369038,26369065,0,2431413
H1|chr17:24040596-24040649,chr17,24040596,24040649,H1|chr17:27718424-27718467,chr17,27718424,27718467,0,3677828
H1|chr17:24215826-24215956,chr17,24215826,24215956,H1|chr17:62915633-62915783,chr17,62915633,62915783,0,38699807
H1|chr17:24326719-24326754,chr17,24326719,24326754,H1|chr17:27190479-27190589,chr17,27190479,27190589,0,2863760
H1|chr17:24449844-24449991,chr17,24449844,24449991,H1|chr17:62915448-62915582,chr17,62915448,62915582,0,38465604
H1|chr17:24619574-24619724,chr17,24619574,24619724,H1|chr17:62915454-62915582,chr17,62915454,62915582,0,38295880
H1|chr17:24630787-24630901,chr17,24630787,24630901,H1|chr17:43322472-43322559,chr17,43322472,43322559,0,18691685
H1|chr17:24658165-24658210,chr17,24658165,24658210,H1|chr17:44316439-44316547,chr17,44316439,44316547,0,19658274
H1|chr17:24707320-24707370,chr17,24707320,24707370,H1|chr17:62918454-62918553,chr17,62918454,62918553,0,38211134
H1|chr17:24725245-24725327,chr17,24725245,24725327,H1|chr17:62918454-62918518,chr17,62918454,62918518,0,38193209
H1|chr17:24884245-24884275,chr17,24884245,24884275,H1|chr17:62918454-62918571,chr17,62918454,62918571,0,38034209
H1|chr17:24959800-24959861,chr17,24959800,24959861,H1|chr17:62918454-62918543,chr17,62918454,62918543,0,37958654
H1|chr17:24970449-24970518,chr17,24970449,24970518,H1|chr17:62918454-62918532,chr17,62918454,62918532,0,37948005
H1|chr17:25093826-25093973,chr17,25093826,25093973,H1|chr17:62915438-62915577,chr17,62915438,62915577,0,37821612
H1|chr17:25195353-25195439,chr17,25195353,25195439,H1|chr17:41281176-41281240,chr17,41281176,41281240,0,16085823
H1|chr17:25340105-25340193,chr17,25340105,25340193,H1|chr17:74120240-74120388,chr17,74120240,74120388,0,48780135
H1|chr17:25357974-25358019,chr17,25357974,25358019,H1|chr17:62918505-62918586,chr17,62918505,62918586,0,37560531
H1|chr17:25398650-25398710,chr17,25398650,25398710,H1|chr17:62918454-62918530,chr17,62918454,62918530,0,37519804
H1|chr17:25464892-25465037,chr17,25464892,25465037,H1|chr17:62915467-62915575,chr17,62915467,62915575,0,37450575
H1|chr17:25642676-25642704,chr17,25642676,25642704,H1|chr17:62918459-62918581,chr17,62918459,62918581,0,37275783
H1|chr17:25770880-25770937,chr17,25770880,25770937,H1|chr17:44318774-44318887,chr17,44318774,44318887,0,18547894
H1|chr17:25868353-25868410,chr17,25868353,25868410,H1|chr17:44318774-44318887,chr17,44318774,44318887,0,18450421
H1|chr17:26022827-26022869,chr17,26022827,26022869,H1|chr17:62918454-62918532,chr17,62918454,62918532,0,36895627
H1|chr17:26149404-26149452,chr17,26149404,26149452,H1|chr17:74448669-74448796,chr17,74448669,74448796,0,48299265
H1|chr17:26198037-26198108,chr17,26198037,26198108,H1|chr17:62915431-62915538,chr17,62915431,62915538,0,36717394
H1|chr17:26348756-26348830,chr17,26348756,26348830,H1|chr17:74120079-74120154,chr17,74120079,74120154,0,47771323
H1|chr17:26508906-26508945,chr17,26508906,26508945,H1|chr17:62918454-62918532,chr17,62918454,62918532,0,36409548
H1|chr17:26826768-26826813,chr17,26826768,26826813,H1|chr17:62915430-62915532,chr17,62915430,62915532,0,36088662
H1|chr17:26883094-26883167,chr17,26883094,26883167,H1|chr17:80058268-80058358,chr17,80058268,80058358,0,53175174
H1|chr17:27130540-27130606,chr17,27130540,27130606,H1|chr17:44316165-44316240,chr17,44316165,44316240,0,17185625
H1|chr17:27365959-27366109,chr17,27365959,27366109,H1|chr17:62918449-62918583,chr17,62918449,62918583,0,35552490
H1|chr17:27394699-27394750,chr17,27394699,27394750,H1|chr17:36583656-36583711,chr17,36583656,36583711,0,9188957
H1|chr17:27461415-27461534,chr17,27461415,27461534,H1|chr17:74121063-74121118,chr17,74121063,74121118,0,46659648
H1|chr17:27637657-27637742,chr17,27637657,27637742,H1|chr17:62918449-62918584,chr17,62918449,62918584,0,35280792
H1|chr17:27789278-27789302,chr17,27789278,27789302,H1|chr17:62918459-62918585,chr17,62918459,62918585,0,35129181
H1|chr17:27807769-27807803,chr17,27807769,27807803,H1|chr17:44318774-44318887,chr17,44318774,44318887,0,16511005
H1|chr17:27837051-27837198,chr17,27837051,27837198,H1|chr17:62915456-62915575,chr17,62915456,62915575,0,35078405
H1|chr17:27912900-27912995,chr17,27912900,27912995,H1|chr17:74122254-74122300,chr17,74122254,74122300,0,46209354
H1|chr17:27929536-27929557,chr17,27929536,27929557,H1|chr17:1733520-1733646,chr17,1733520,1733646,0,26196016
H1|chr17:28247236-28247312,chr17,28247236,28247312,H1|chr17:74378366-74378440,chr17,74378366,74378440,0,46131130
H1|chr17:28248704-28248751,chr17,28248704,28248751,H1|chr17:65819949-65820084,chr17,65819949,65820084,0,37571245
H1|chr17:28297837-28297987,chr17,28297837,28297987,H1|chr17:62915476-62915582,chr17,62915476,62915582,0,34617639
H1|chr17:28533730-28533870,chr17,28533730,28533870,H1|chr17:62915459-62915583,chr17,62915459,62915583,0,34381729
H1|chr17:28611660-28611683,chr17,28611660,28611683,H1|chr17:62918480-62918628,chr17,62918480,62918628,0,34306820
H1|chr17:28705284-28705324,chr17,28705284,28705324,H1|chr17:62918449-62918558,chr17,62918449,62918558,0,34213165
H1|chr17:28764448-28764562,chr17,28764448,28764562,H1|chr17:43322472-43322559,chr17,43322472,43322559,0,14558024
H1|chr17:28894416-28894479,chr17,28894416,28894479,H1|chr17:44316442-44316518,chr17,44316442,44316518,0,15422026
H1|chr17:29031986-29032113,chr17,29031986,29032113,H1|chr17:1360679-1360729,chr17,1360679,1360729,0,27671307
H1|chr17:29067940-29067989,chr17,29067940,29067989,H1|chr17:36612604-36612705,chr17,36612604,36612705,0,7544664
H1|chr17:29171657-29171712,chr17,29171657,29171712,H1|chr17:74118525-74118567,chr17,74118525,74118567,0,44946868
H1|chr17:29391529-29391574,chr17,29391529,29391574,H1|chr17:62918497-62918626,chr17,62918497,62918626,0,33526968
H1|chr17:29402491-29402590,chr17,29402491,29402590,H1|chr17:62918454-62918543,chr17,62918454,62918543,0,33515963
H1|chr17:29541078-29541151,chr17,29541078,29541151,H1|chr17:62918516-62918587,chr17,62918516,62918587,0,33377438
H1|chr17:29857084-29857148,chr17,29857084,29857148,H1|chr17:36579809-36579889,chr17,36579809,36579889,0,6722725
H1|chr17:29997029-29997077,chr17,29997029,29997077,H1|chr17:62918454-62918532,chr17,62918454,62918532,0,32921425
H1|chr17:30101569-30101624,chr17,30101569,30101624,H1|chr17:44316142-44316222,chr17,44316142,44316222,0,14214573
H1|chr17:30445125-30445201,chr17,30445125,30445201,H1|chr17:44316105-44316162,chr17,44316105,44316162,0,13870980
H1|chr17:30526113-30526212,chr17,30526113,30526212,H1|chr17:62918449-62918592,chr17,62918449,62918592,0,32392336
H1|chr17:30580734-30580810,chr17,30580734,30580810,H1|chr17:38278091-38278140,chr17,38278091,38278140,0,7697357
H1|chr17:30801339-30801441,chr17,30801339,30801441,H1|chr17:1360676-1360728,chr17,1360676,1360728,0,29440663
H1|chr17:30830975-30831032,chr17,30830975,30831032,H1|chr17:62918449-62918535,chr17,62918449,62918535,0,32087474
H1|chr17:30956769-30956852,chr17,30956769,30956852,H1|chr17:62915431-62915519,chr17,62915431,62915519,0,31958662
H1|chr17:31094307-31094394,chr17,31094307,31094394,H1|chr17:47024083-47024117,chr17,47024083,47024117,0,15929776
H1|chr17:31272695-31272715,chr17,31272695,31272715,H1|chr17:44318787-44318889,chr17,44318787,44318889,0,13046092
H1|chr17:31330516-31330595,chr17,31330516,31330595,H1|chr17:62918449-62918596,chr17,62918449,62918596,0,31587933
H1|chr17:31442682-31442807,chr17,31442682,31442807,H1|chr17:65826239-65826264,chr17,65826239,65826264,0,34383557
H1|chr17:31646326-31646471,chr17,31646326,31646471,H1|chr17:62915431-62915539,chr17,62915431,62915539,0,31269105
H1|chr17:31760020-31760050,chr17,31760020,31760050,H1|chr17:74448227-74448323,chr17,74448227,74448323,0,42688207
H1|chr17:31780893-31780944,chr17,31780893,31780944,H1|chr17:36579972-36580051,chr17,36579972,36580051,0,4799079
H1|chr17:31930025-31930098,chr17,31930025,31930098,H1|chr17:38329274-38329339,chr17,38329274,38329339,0,6399249
H1|chr17:32318202-32318226,chr17,32318202,32318226,H1|chr17:62918449-62918555,chr17,62918449,62918555,0,30600247
H1|chr17:32360385-32360496,chr17,32360385,32360496,H1|chr17:43322472-43322559,chr17,43322472,43322559,0,10962087
H1|chr17:32366900-32366958,chr17,32366900,32366958,H1|chr17:36582201-36582317,chr17,36582201,36582317,0,4215301
H1|chr17:32391297-32391333,chr17,32391297,32391333,H1|chr17:62918449-62918528,chr17,62918449,62918528,0,30527152
H1|chr17:32460698-32460733,chr17,32460698,32460733,H1|chr17:36584033-36584129,chr17,36584033,36584129,0,4123335
H1|chr17:32515657-32515712,chr17,32515657,32515712,H1|chr17:43321657-43321680,chr17,43321657,43321680,0,10806000
H1|chr17:32535601-32535683,chr17,32535601,32535683,H1|chr17:38275895-38276009,chr17,38275895,38276009,0,5740294
H1|chr17:32548149-32548220,chr17,32548149,32548220,H1|chr17:62918455-62918534,chr17,62918455,62918534,0,30370306
H1|chr17:32587109-32587259,chr17,32587109,32587259,H1|chr17:75451945-75451988,chr17,75451945,75451988,0,42864836
H1|chr17:32598448-32598491,chr17,32598448,32598491,H1|chr17:62918454-62918532,chr17,62918454,62918532,0,30320006
H1|chr17:32674236-32674385,chr17,32674236,32674385,H1|chr17:62915755-62915900,chr17,62915755,62915900,0,30241519
H1|chr17:32693453-32693499,chr17,32693453,32693499,H1|chr17:62918449-62918589,chr17,62918449,62918589,0,30224996
H1|chr17:32778146-32778172,chr17,32778146,32778172,H1|chr17:62918449-62918584,chr17,62918449,62918584,0,30140303
H1|chr17:32917811-32917906,chr17,32917811,32917906,H1|chr17:62918485-62918518,chr17,62918485,62918518,0,30000674
H1|chr17:33013311-33013363,chr17,33013311,33013363,H1|chr17:62918454-62918552,chr17,62918454,62918552,0,29905143
H1|chr17:33075695-33075737,chr17,33075695,33075737,H1|chr17:7466011-7466082,chr17,7466011,7466082,0,25609684
H1|chr17:33079293-33079353,chr17,33079293,33079353,H1|chr17:62918454-62918530,chr17,62918454,62918530,0,29839161
H1|chr17:33251567-33251608,chr17,33251567,33251608,H1|chr17:62918449-62918572,chr17,62918449,62918572,0,29666882
H1|chr17:33361082-33361110,chr17,33361082,33361110,H1|chr17:62918452-62918580,chr17,62918452,62918580,0,29557370
H1|chr17:33577506-33577558,chr17,33577506,33577558,H1|chr17:62918454-62918552,chr17,62918454,62918552,0,29340948
H1|chr17:33587198-33587341,chr17,33587198,33587341,H1|chr17:80378550-80378700,chr17,80378550,80378700,0,46791352
H1|chr17:33594870-33594921,chr17,33594870,33594921,H1|chr17:62918454-62918532,chr17,62918454,62918532,0,29323584
H1|chr17:33625118-33625143,chr17,33625118,33625143,H1|chr17:41281176-41281240,chr17,41281176,41281240,0,7656058
H1|chr17:33772178-33772225,chr17,33772178,33772225,H1|chr17:38514240-38514328,chr17,38514240,38514328,0,4742062
H1|chr17:33868376-33868410,chr17,33868376,33868410,H1|chr17:62918449-62918586,chr17,62918449,62918586,0,29050073
H1|chr17:34650400-34650458,chr17,34650400,34650458,H1|chr17:17726151-17726206,chr17,17726151,17726206,0,16924249
H1|chr17:34656200-34656274,chr17,34656200,34656274,H1|chr17:62918454-62918530,chr17,62918454,62918530,0,28262254
H1|chr17:35235162-35235225,chr17,35235162,35235225,H1|chr17:43322472-43322559,chr17,43322472,43322559,0,8087310
H1|chr17:35707002-35707044,chr17,35707002,35707044,H1|chr17:74119039-74119094,chr17,74119039,74119094,0,38412037
H1|chr17:35954183-35954205,chr17,35954183,35954205,H1|chr17:80057610-80057705,chr17,80057610,80057705,0,44103427
H1|chr17:36240640-36240759,chr17,36240640,36240759,H1|chr17:74121063-74121118,chr17,74121063,74121118,0,37880423
H1|chr17:36258460-36258605,chr17,36258460,36258605,H1|chr17:62915467-62915575,chr17,62915467,62915575,0,26657007
H1|chr17:36342206-36342252,chr17,36342206,36342252,H1|chr17:46133004-46133095,chr17,46133004,46133095,0,9790798
H1|chr17:36672908-36672959,chr17,36672908,36672959,H1|chr17:47755037-47755094,chr17,47755037,47755094,0,11082129
H1|chr17:36697240-36697283,chr17,36697240,36697283,H1|chr17:62918454-62918532,chr17,62918454,62918532,0,26221214
H1|chr17:36757188-36757260,chr17,36757188,36757260,H1|chr17:29054858-29054905,chr17,29054858,29054905,0,7702330
H1|chr17:36866787-36866821,chr17,36866787,36866821,H1|chr17:36583664-36583806,chr17,36583664,36583806,0,283123
H1|chr17:37023457-37023584,chr17,37023457,37023584,H1|chr17:1360679-1360729,chr17,1360679,1360729,0,35662778
H1|chr17:37229824-37229897,chr17,37229824,37229897,H1|chr17:62918449-62918574,chr17,62918449,62918574,0,25688625
H1|chr17:37416839-37416908,chr17,37416839,37416908,H1|chr17:56084163-56084192,chr17,56084163,56084192,0,18667324
H1|chr17:37459219-37459256,chr17,37459219,37459256,H1|chr17:65823321-65823374,chr17,65823321,65823374,0,28364102
H1|chr17:37478702-37478751,chr17,37478702,37478751,H1|chr17:35076963-35077064,chr17,35076963,35077064,0,2401739
H1|chr17:37704562-37704606,chr17,37704562,37704606,H1|chr17:62918454-62918524,chr17,62918454,62918524,0,25213892
H1|chr17:37958057-37958110,chr17,37958057,37958110,H1|chr17:36582459-36582540,chr17,36582459,36582540,0,1375598
H1|chr17:38004620-38004715,chr17,38004620,38004715,H1|chr17:74121063-74121118,chr17,74121063,74121118,0,36116443
H1|chr17:38070531-38070630,chr17,38070531,38070630,H1|chr17:62918454-62918543,chr17,62918454,62918543,0,24847923
H1|chr17:38097096-38097165,chr17,38097096,38097165,H1|chr17:62918454-62918532,chr17,62918454,62918532,0,24821358
H1|chr17:38110966-38111035,chr17,38110966,38111035,H1|chr17:44316336-44316417,chr17,44316336,44316417,0,6205370
H1|chr17:38258121-38258218,chr17,38258121,38258218,H1|chr17:75448413-75448509,chr17,75448413,75448509,0,37190292
H1|chr17:38261526-38261579,chr17,38261526,38261579,H1|chr17:36507821-36507936,chr17,36507821,36507936,0,1753705
H1|chr17:38278736-38278883,chr17,38278736,38278883,H1|chr17:62915456-62915575,chr17,62915456,62915575,0,24636720
H1|chr17:38494263-38494318,chr17,38494263,38494318,H1|chr17:62918486-62918633,chr17,62918486,62918633,0,24424223
H1|chr17:38494357-38494404,chr17,38494357,38494404,H1|chr17:62918454-62918543,chr17,62918454,62918543,0,24424097
H1|chr17:38521990-38522036,chr17,38521990,38522036,H1|chr17:56084039-56084082,chr17,56084039,56084082,0,17562049
H1|chr17:39286676-39286755,chr17,39286676,39286755,H1|chr17:74120126-74120205,chr17,74120126,74120205,0,34833450
H1|chr17:39386649-39386739,chr17,39386649,39386739,H1|chr17:36581206-36581236,chr17,36581206,36581236,0,2805443
H1|chr17:39400102-39400215,chr17,39400102,39400215,H1|chr17:44318719-44318774,chr17,44318719,44318774,0,4918617
H1|chr17:39448528-39448564,chr17,39448528,39448564,H1|chr17:43321657-43321680,chr17,43321657,43321680,0,3873129
H1|chr17:39529960-39530071,chr17,39529960,39530071,H1|chr17:46987415-46987449,chr17,46987415,46987449,0,7457455
H1|chr17:39539941-39539979,chr17,39539941,39539979,H1|chr17:34959275-34959325,chr17,34959275,34959325,0,4580666
H1|chr17:39551396-39551491,chr17,39551396,39551491,H1|chr17:74121181-74121222,chr17,74121181,74121222,0,34569785
H1|chr17:39687633-39687703,chr17,39687633,39687703,H1|chr17:36580476-36580534,chr17,36580476,36580534,0,3107157
H1|chr17:39714362-39714421,chr17,39714362,39714421,H1|chr17:30676265-30676367,chr17,30676265,30676367,0,9038097
H1|chr17:39810960-39811003,chr17,39810960,39811003,H1|chr17:34959275-34959325,chr17,34959275,34959325,0,4851685
H1|chr17:39933986-39934011,chr17,39933986,39934011,H1|chr17:62918449-62918574,chr17,62918449,62918574,0,22984463
H1|chr17:39958572-39958671,chr17,39958572,39958671,H1|chr17:74262692-74262772,chr17,74262692,74262772,0,34304120
H1|chr17:40030618-40030688,chr17,40030618,40030688,H1|chr17:62918449-62918597,chr17,62918449,62918597,0,22887831
H1|chr17:40154821-40154903,chr17,40154821,40154903,H1|chr17:38275895-38276009,chr17,38275895,38276009,0,1878926
H1|chr17:40240955-40241004,chr17,40240955,40241004,H1|chr17:62918449-62918589,chr17,62918449,62918589,0,22677494
H1|chr17:40272192-40272219,chr17,40272192,40272219,H1|chr17:62915431-62915529,chr17,62915431,62915529,0,22643239
H1|chr17:40524489-40524567,chr17,40524489,40524567,H1|chr17:38273510-38273596,chr17,38273510,38273596,0,2250979
H1|chr17:40704718-40704756,chr17,40704718,40704756,H1|chr17:6540099-6540165,chr17,6540099,6540165,0,34164619
H1|chr17:40725913-40726013,chr17,40725913,40726013,H1|chr17:75137343-75137391,chr17,75137343,75137391,0,34411430
H1|chr17:40849585-40849638,chr17,40849585,40849638,H1|chr17:62918454-62918551,chr17,62918454,62918551,0,22068869
H1|chr17:40926332-40926418,chr17,40926332,40926418,H1|chr17:41281176-41281240,chr17,41281176,41281240,0,354844
H1|chr17:41071841-41071929,chr17,41071841,41071929,H1|chr17:44318719-44318774,chr17,44318719,44318774,0,3246878
H1|chr17:41227311-41227353,chr17,41227311,41227353,H1|chr17:27892808-27892916,chr17,27892808,27892916,0,13334503
H1|chr17:41452833-41452920,chr17,41452833,41452920,H1|chr17:47024083-47024117,chr17,47024083,47024117,0,5571250
H1|chr17:41576327-41576379,chr17,41576327,41576379,H1|chr17:62915431-62915570,chr17,62915431,62915570,0,21339104
H1|chr17:41836670-41836707,chr17,41836670,41836707,H1|chr17:62918449-62918587,chr17,62918449,62918587,0,21081779
H1|chr17:41905547-41905580,chr17,41905547,41905580,H1|chr17:27190479-27190589,chr17,27190479,27190589,0,14715068
H1|chr17:41989046-41989162,chr17,41989046,41989162,H1|chr17:79820781-79820815,chr17,79820781,79820815,0,37831735
H1|chr17:42006901-42006986,chr17,42006901,42006986,H1|chr17:62918449-62918584,chr17,62918449,62918584,0,20911548
H1|chr17:42136707-42136811,chr17,42136707,42136811,H1|chr17:62915431-62915525,chr17,62915431,62915525,0,20778724
H1|chr17:42456193-42456242,chr17,42456193,42456242,H1|chr17:62918454-62918532,chr17,62918454,62918532,0,20462261
H1|chr17:42582180-42582284,chr17,42582180,42582284,H1|chr17:62918449-62918590,chr17,62918449,62918590,0,20336269
H1|chr17:42935621-42935679,chr17,42935621,42935679,H1|chr17:65244793-65244863,chr17,65244793,65244863,0,22309172
H1|chr17:43020786-43020909,chr17,43020786,43020909,H1|chr17:74121570-74121597,chr17,74121570,74121597,0,31100784
H1|chr17:43186012-43186062,chr17,43186012,43186062,H1|chr17:36581172-36581262,chr17,36581172,36581262,0,6604840
H1|chr17:43187449-43187524,chr17,43187449,43187524,H1|chr17:62918454-62918526,chr17,62918454,62918526,0,19731005
H1|chr17:43226670-43226764,chr17,43226670,43226764,H1|chr17:74121181-74121222,chr17,74121181,74121222,0,30894511
H1|chr17:43305922-43306024,chr17,43305922,43306024,H1|chr17:62918449-62918580,chr17,62918449,62918580,0,19612527
H1|chr17:43365098-43365176,chr17,43365098,43365176,H1|chr17:74120151-74120205,chr17,74120151,74120205,0,30755053
H1|chr17:43427936-43427987,chr17,43427936,43427987,H1|chr17:27718472-27718569,chr17,27718472,27718569,0,15709464
H1|chr17:43488854-43488913,chr17,43488854,43488913,H1|chr17:30676265-30676367,chr17,30676265,30676367,0,12812589
H1|chr17:43785709-43785757,chr17,43785709,43785757,H1|chr17:7194735-7194805,chr17,7194735,7194805,0,36590974
H1|chr17:43988796-43988900,chr17,43988796,43988900,H1|chr17:62915431-62915525,chr17,62915431,62915525,0,18926635
H1|chr17:44003214-44003234,chr17,44003214,44003234,H1|chr17:44318787-44318889,chr17,44318787,44318889,0,315573
H1|chr17:44037685-44037835,chr17,44037685,44037835,H1|chr17:62915471-62915583,chr17,62915471,62915583,0,18877786
H1|chr17:44058844-44058885,chr17,44058844,44058885,H1|chr17:46135238-46135347,chr17,46135238,46135347,0,2076394
H1|chr17:44079288-44079354,chr17,44079288,44079354,H1|chr17:62918454-62918518,chr17,62918454,62918518,0,18839166
H1|chr17:44276891-44276933,chr17,44276891,44276933,H1|chr17:62918454-62918532,chr17,62918454,62918532,0,18641563
H1|chr17:44355729-44355802,chr17,44355729,44355802,H1|chr17:80058268-80058358,chr17,80058268,80058358,0,35702539
H1|chr17:44456677-44456714,chr17,44456677,44456714,H1|chr17:74257559-74257606,chr17,74257559,74257606,0,29800882
H1|chr17:44522335-44522397,chr17,44522335,44522397,H1|chr17:44319419-44319472,chr17,44319419,44319472,0,202916
H1|chr17:44525797-44525867,chr17,44525797,44525867,H1|chr17:65822514-65822594,chr17,65822514,65822594,0,21296717
H1|chr17:44587044-44587090,chr17,44587044,44587090,H1|chr17:46133004-46133095,chr17,46133004,46133095,0,1545960
H1|chr17:44603872-44603927,chr17,44603872,44603927,H1|chr17:44316142-44316222,chr17,44316142,44316222,0,287730
H1|chr17:44728912-44729060,chr17,44728912,44729060,H1|chr17:62915431-62915537,chr17,62915431,62915537,0,18186519
H1|chr17:44829597-44829711,chr17,44829597,44829711,H1|chr17:40730722-40730778,chr17,40730722,40730778,0,4098875
H1|chr17:44944529-44944574,chr17,44944529,44944574,H1|chr17:36507883-36507942,chr17,36507883,36507942,0,8436646
H1|chr17:45298499-45298534,chr17,45298499,45298534,H1|chr17:74118414-74118549,chr17,74118414,74118549,0,28819915
H1|chr17:45340472-45340550,chr17,45340472,45340550,H1|chr17:74120151-74120205,chr17,74120151,74120205,0,28779679
H1|chr17:45381320-45381367,chr17,45381320,45381367,H1|chr17:62918454-62918532,chr17,62918454,62918532,0,17537134
H1|chr17:45466184-45466290,chr17,45466184,45466290,H1|chr17:62918454-62918518,chr17,62918454,62918518,0,17452270
H1|chr17:45556198-45556268,chr17,45556198,45556268,H1|chr17:62918449-62918597,chr17,62918449,62918597,0,17362251
H1|chr17:45615911-45615959,chr17,45615911,45615959,H1|chr17:46132997-46133095,chr17,46132997,46133095,0,517086
H1|chr17:45676255-45676289,chr17,45676255,45676289,H1|chr17:36582201-36582317,chr17,36582201,36582317,0,9094054
H1|chr17:45880760-45880854,chr17,45880760,45880854,H1|chr17:40730722-40730778,chr17,40730722,40730778,0,5150038
H1|chr17:45999685-45999725,chr17,45999685,45999725,H1|chr17:47928292-47928358,chr17,47928292,47928358,0,1928607
H1|chr17:46008634-46008675,chr17,46008634,46008675,H1|chr17:74120174-74120205,chr17,74120174,74120205,0,28111540
H1|chr17:46289669-46289689,chr17,46289669,46289689,H1|chr17:65825338-65825366,chr17,65825338,65825366,0,19535669
H1|chr17:46333986-46334100,chr17,46333986,46334100,H1|chr17:62918454-62918551,chr17,62918454,62918551,0,16584468
H1|chr17:46537465-46537539,chr17,46537465,46537539,H1|chr17:74121570-74121646,chr17,74121570,74121646,0,27584105
H1|chr17:46567055-46567096,chr17,46567055,46567096,H1|chr17:7466012-7466082,chr17,7466012,7466082,0,39101043
H1|chr17:46711995-46712057,chr17,46711995,46712057,H1|chr17:62918449-62918585,chr17,62918449,62918585,0,16206454
H1|chr17:46771343-46771420,chr17,46771343,46771420,H1|chr17:62915431-62915523,chr17,62915431,62915523,0,16144088
H1|chr17:46773194-46773215,chr17,46773194,46773215,H1|chr17:62918449-62918591,chr17,62918449,62918591,0,16145255
H1|chr17:46994588-46994635,chr17,46994588,46994635,H1|chr17:65819949-65820084,chr17,65819949,65820084,0,18825361
H1|chr17:47012828-47012876,chr17,47012828,47012876,H1|chr17:4170041-4170134,chr17,4170041,4170134,0,42842787
H1|chr17:47049682-47049826,chr17,47049682,47049826,H1|chr17:62915431-62915528,chr17,62915431,62915528,0,15865749
H1|chr17:47222156-47222179,chr17,47222156,47222179,H1|chr17:18906713-18906772,chr17,18906713,18906772,0,28315443
H1|chr17:47225185-47225220,chr17,47225185,47225220,H1|chr17:27190479-27190589,chr17,27190479,27190589,0,20034706
H1|chr17:47276730-47276766,chr17,47276730,47276766,H1|chr17:36579648-36579737,chr17,36579648,36579737,0,10697082
H1|chr17:47345178-47345226,chr17,47345178,47345226,H1|chr17:4170041-4170134,chr17,4170041,4170134,0,43175137
H1|chr17:47445394-47445427,chr17,47445394,47445427,H1|chr17:34959156-34959241,chr17,34959156,34959241,0,12486238
H1|chr17:47652257-47652301,chr17,47652257,47652301,H1|chr17:36580511-36580573,chr17,36580511,36580573,0,11071746
H1|chr17:47734803-47734848,chr17,47734803,47734848,H1|chr17:30676265-30676367,chr17,30676265,30676367,0,17058538
H1|chr17:48033114-48033138,chr17,48033114,48033138,H1|chr17:62918459-62918585,chr17,62918459,62918585,0,14885345
H1|chr17:48130378-48130440,chr17,48130378,48130440,H1|chr17:62918455-62918534,chr17,62918455,62918534,0,14788077
H1|chr17:48304823-48304892,chr17,48304823,48304892,H1|chr17:44316336-44316417,chr17,44316336,44316417,0,3988487
H1|chr17:48802510-48802660,chr17,48802510,48802660,H1|chr17:62915476-62915582,chr17,62915476,62915582,0,14112966
H1|chr17:49069523-49069555,chr17,49069523,49069555,H1|chr17:62918454-62918571,chr17,62918454,62918571,0,13848931
H1|chr17:49312537-49312565,chr17,49312537,49312565,H1|chr17:62918459-62918581,chr17,62918459,62918581,0,13605922
H1|chr17:49348662-49348698,chr17,49348662,49348698,H1|chr17:62915766-62915912,chr17,62915766,62915912,0,13567104
H1|chr17:49355854-49355949,chr17,49355854,49355949,H1|chr17:74122254-74122300,chr17,74122254,74122300,0,24766400
H1|chr17:49491571-49491715,chr17,49491571,49491715,H1|chr17:62915467-62915583,chr17,62915467,62915583,0,13423896
H1|chr17:49883679-49883770,chr17,49883679,49883770,H1|chr17:36580536-36580603,chr17,36580536,36580603,0,13303143
H1|chr17:49884797-49884926,chr17,49884797,49884926,H1|chr17:29057347-29057387,chr17,29057347,29057387,0,20827450
H1|chr17:49892182-49892219,chr17,49892182,49892219,H1|chr17:62918449-62918587,chr17,62918449,62918587,0,13026267
H1|chr17:50114069-50114131,chr17,50114069,50114131,H1|chr17:44319419-44319472,chr17,44319419,44319472,0,5794650
H1|chr17:50235695-50235721,chr17,50235695,50235721,H1|chr17:63055942-63055970,chr17,63055942,63055970,0,12820247
H1|chr17:50366495-50366560,chr17,50366495,50366560,H1|chr17:62915431-62915520,chr17,62915431,62915520,0,12548936
H1|chr17:50526260-50526298,chr17,50526260,50526298,H1|chr17:34959275-34959325,chr17,34959275,34959325,0,15566985
H1|chr17:50595751-50595824,chr17,50595751,50595824,H1|chr17:62918449-62918524,chr17,62918449,62918524,0,12322698
H1|chr17:50624928-50624996,chr17,50624928,50624996,H1|chr17:35075760-35075803,chr17,35075760,35075803,0,15549168
H1|chr17:50780236-50780282,chr17,50780236,50780282,H1|chr17:56084039-56084082,chr17,56084039,56084082,0,5303803
H1|chr17:50833564-50833605,chr17,50833564,50833605,H1|chr17:46135238-46135347,chr17,46135238,46135347,0,4698326
H1|chr17:50850269-50850377,chr17,50850269,50850377,H1|chr17:62915431-62915538,chr17,62915431,62915538,0,12065162
H1|chr17:50921723-50921794,chr17,50921723,50921794,H1|chr17:62918813-62918888,chr17,62918813,62918888,0,11997090
H1|chr17:50999996-51000121,chr17,50999996,51000121,H1|chr17:65826239-65826264,chr17,65826239,65826264,0,14826243
H1|chr17:51003799-51003878,chr17,51003799,51003878,H1|chr17:74120138-74120205,chr17,74120138,74120205,0,23116339
H1|chr17:51193548-51193613,chr17,51193548,51193613,H1|chr17:34949625-34949731,chr17,34949625,34949731,0,16243923
H1|chr17:51282246-51282299,chr17,51282246,51282299,H1|chr17:62918454-62918551,chr17,62918454,62918551,0,11636208
H1|chr17:51352773-51352845,chr17,51352773,51352845,H1|chr17:62918454-62918532,chr17,62918454,62918532,0,11565681
H1|chr17:51395309-51395371,chr17,51395309,51395371,H1|chr17:62918454-62918532,chr17,62918454,62918532,0,11523145
H1|chr17:51585533-51585573,chr17,51585533,51585573,H1|chr17:46985111-46985155,chr17,46985111,46985155,0,4600422
H1|chr17:51878543-51878640,chr17,51878543,51878640,H1|chr17:62915431-62915538,chr17,62915431,62915538,0,11036888
H1|chr17:51922812-51922874,chr17,51922812,51922874,H1|chr17:62918454-62918532,chr17,62918454,62918532,0,10995642
H1|chr17:51932158-51932206,chr17,51932158,51932206,H1|chr17:46132997-46133095,chr17,46132997,46133095,0,5799161
H1|chr17:52019792-52019925,chr17,52019792,52019925,H1|chr17:80378483-80378633,chr17,80378483,80378633,0,28358691
H1|chr17:52300294-52300312,chr17,52300294,52300312,H1|chr17:1733520-1733646,chr17,1733520,1733646,0,50566774
H1|chr17:52306755-52306860,chr17,52306755,52306860,H1|chr17:17726151-17726206,chr17,17726151,17726206,0,34580604
H1|chr17:52851507-52851559,chr17,52851507,52851559,H1|chr17:18906713-18906772,chr17,18906713,18906772,0,33944794
H1|chr17:52947366-52947516,chr17,52947366,52947516,H1|chr17:43567254-43567404,chr17,43567254,43567404,0,9380112
H1|chr17:53100330-53100368,chr17,53100330,53100368,H1|chr17:27892808-27892916,chr17,27892808,27892916,0,25207522
H1|chr17:53540887-53540944,chr17,53540887,53540944,H1|chr17:62918454-62918532,chr17,62918454,62918532,0,9377567
H1|chr17:53560325-53560397,chr17,53560325,53560397,H1|chr17:29054858-29054905,chr17,29054858,29054905,0,24505467
H1|chr17:53749042-53749132,chr17,53749042,53749132,H1|chr17:36584361-36584421,chr17,36584361,36584421,0,17164681
H1|chr17:53765904-53765993,chr17,53765904,53765993,H1|chr17:44319851-44319912,chr17,44319851,44319912,0,9446053
H1|chr17:53870278-53870362,chr17,53870278,53870362,H1|chr17:62915431-62915538,chr17,62915431,62915538,0,9045153
H1|chr17:54014538-54014592,chr17,54014538,54014592,H1|chr17:27718424-27718467,chr17,27718424,27718467,0,26296114
H1|chr17:54039195-54039272,chr17,54039195,54039272,H1|chr17:65246575-65246600,chr17,65246575,65246600,0,11207380
H1|chr17:54043617-54043720,chr17,54043617,54043720,H1|chr17:62918449-62918584,chr17,62918449,62918584,0,8874832
H1|chr17:54187048-54187118,chr17,54187048,54187118,H1|chr17:65972955-65973008,chr17,65972955,65973008,0,11785907
H1|chr17:54199262-54199365,chr17,54199262,54199365,H1|chr17:62918449-62918584,chr17,62918449,62918584,0,8719187
H1|chr17:54261406-54261468,chr17,54261406,54261468,H1|chr17:62918449-62918585,chr17,62918449,62918585,0,8657043
H1|chr17:54277389-54277427,chr17,54277389,54277427,H1|chr17:6540099-6540165,chr17,6540099,6540165,0,47737290
H1|chr17:54400499-54400533,chr17,54400499,54400533,H1|chr17:74117754-74117863,chr17,74117754,74117863,0,19717255
H1|chr17:54573890-54573935,chr17,54573890,54573935,H1|chr17:36507883-36507942,chr17,36507883,36507942,0,18066007
H1|chr17:54620283-54620356,chr17,54620283,54620356,H1|chr17:38329274-38329339,chr17,38329274,38329339,0,16291009
H1|chr17:54717821-54717934,chr17,54717821,54717934,H1|chr17:36612344-36612363,chr17,36612344,36612363,0,18105477
H1|chr17:54740346-54740389,chr17,54740346,54740389,H1|chr17:34959275-34959325,chr17,34959275,34959325,0,19781071
H1|chr17:54777389-54777465,chr17,54777389,54777465,H1|chr17:3542056-3542128,chr17,3542056,3542128,0,51235333
H1|chr17:55066821-55066855,chr17,55066821,55066855,H1|chr17:36582201-36582317,chr17,36582201,36582317,0,18484620
H1|chr17:55142760-55142821,chr17,55142760,55142821,H1|chr17:36580547-36580578,chr17,36580547,36580578,0,18562213
H1|chr17:55303158-55303308,chr17,55303158,55303308,H1|chr17:65826239-65826264,chr17,65826239,65826264,0,10523081
H1|chr17:55737123-55737176,chr17,55737123,55737176,H1|chr17:27718424-27718467,chr17,27718424,27718467,0,28018699
H1|chr17:55966368-55966478,chr17,55966368,55966478,H1|chr17:46987415-46987449,chr17,46987415,46987449,0,8978953
H1|chr17:56156225-56156247,chr17,56156225,56156247,H1|chr17:80057610-80057705,chr17,80057610,80057705,0,23901385
H1|chr17:56163137-56163231,chr17,56163137,56163231,H1|chr17:48424838-48424872,chr17,48424838,48424872,0,7738299
H1|chr17:56177098-56177246,chr17,56177098,56177246,H1|chr17:62915467-62915583,chr17,62915467,62915583,0,6738369
H1|chr17:56232161-56232252,chr17,56232161,56232252,H1|chr17:40730722-40730778,chr17,40730722,40730778,0,15501439
H1|chr17:56358165-56358231,chr17,56358165,56358231,H1|chr17:62918454-62918518,chr17,62918454,62918518,0,6560289
H1|chr17:56405612-56405706,chr17,56405612,56405706,H1|chr17:48424838-48424872,chr17,48424838,48424872,0,7980774
H1|chr17:56606968-56607039,chr17,56606968,56607039,H1|chr17:62918449-62918520,chr17,62918449,62918520,0,6311481
H1|chr17:56931992-56932108,chr17,56931992,56932108,H1|chr17:62915431-62915538,chr17,62915431,62915538,0,5983439
H1|chr17:57249270-57249302,chr17,57249270,57249302,H1|chr17:62918449-62918567,chr17,62918449,62918567,0,5669179
H1|chr17:57320179-57320217,chr17,57320179,57320217,H1|chr17:65825032-65825071,chr17,65825032,65825071,0,8504853
H1|chr17:57379290-57379338,chr17,57379290,57379338,H1|chr17:7194735-7194805,chr17,7194735,7194805,0,50184555
H1|chr17:57437601-57437652,chr17,57437601,57437652,H1|chr17:36583656-36583711,chr17,36583656,36583711,0,20853945
H1|chr17:57595086-57595131,chr17,57595086,57595131,H1|chr17:62918454-62918555,chr17,62918454,62918555,0,5323368
H1|chr17:57722071-57722132,chr17,57722071,57722132,H1|chr17:62918454-62918543,chr17,62918454,62918543,0,5196383
H1|chr17:57773713-57773751,chr17,57773713,57773751,H1|chr17:62918454-62918532,chr17,62918454,62918532,0,5144741
H1|chr17:57774109-57774154,chr17,57774109,57774154,H1|chr17:62918454-62918555,chr17,62918454,62918555,0,5144345
H1|chr17:57796995-57797085,chr17,57796995,57797085,H1|chr17:28804582-28804611,chr17,28804582,28804611,0,28992413
H1|chr17:57816699-57816796,chr17,57816699,57816796,H1|chr17:1360626-1360712,chr17,1360626,1360712,0,56456073
H1|chr17:58110153-58110235,chr17,58110153,58110235,H1|chr17:63055940-63055970,chr17,63055940,63055970,0,4945787
H1|chr17:58164623-58164668,chr17,58164623,58164668,H1|chr17:62915430-62915532,chr17,62915430,62915532,0,4750807
H1|chr17:58275082-58275229,chr17,58275082,58275229,H1|chr17:62915438-62915577,chr17,62915438,62915577,0,4640356
H1|chr17:58376218-58376293,chr17,58376218,58376293,H1|chr17:47928243-47928393,chr17,47928243,47928393,0,10447975
H1|chr17:58391962-58391997,chr17,58391962,58391997,H1|chr17:62918449-62918572,chr17,62918449,62918572,0,4526487
H1|chr17:58424854-58424999,chr17,58424854,58424999,H1|chr17:62918638-62918656,chr17,62918638,62918656,0,4493784
H1|chr17:58483463-58483606,chr17,58483463,58483606,H1|chr17:80378550-80378700,chr17,80378550,80378700,0,21895087
H1|chr17:58507169-58507220,chr17,58507169,58507220,H1|chr17:36580718-36580788,chr17,36580718,36580788,0,21926451
H1|chr17:58630092-58630168,chr17,58630092,58630168,H1|chr17:44316163-44316272,chr17,44316163,44316272,0,14313929
H1|chr17:58642692-58642725,chr17,58642692,58642725,H1|chr17:62918454-62918552,chr17,62918454,62918552,0,4275762
H1|chr17:58651925-58651962,chr17,58651925,58651962,H1|chr17:74257559-74257606,chr17,74257559,74257606,0,15605634
H1|chr17:58707508-58707544,chr17,58707508,58707544,H1|chr17:62918449-62918528,chr17,62918449,62918528,0,4210941
H1|chr17:58715584-58715690,chr17,58715584,58715690,H1|chr17:36612604-36612705,chr17,36612604,36612705,0,22102980
H1|chr17:59069602-59069620,chr17,59069602,59069620,H1|chr17:36610436-36610460,chr17,36610436,36610460,0,22459166
H1|chr17:59339078-59339147,chr17,59339078,59339147,H1|chr17:62918457-62918607,chr17,62918457,62918607,0,3579379
H1|chr17:59421429-59421453,chr17,59421429,59421453,H1|chr17:1360568-1360687,chr17,1360568,1360687,0,58060861
H1|chr17:59709902-59710043,chr17,59709902,59710043,H1|chr17:62915485-62915582,chr17,62915485,62915582,0,3205583
H1|chr17:59841778-59841821,chr17,59841778,59841821,H1|chr17:62918449-62918572,chr17,62918449,62918572,0,3076671
H1|chr17:59904325-59904475,chr17,59904325,59904475,H1|chr17:26369038-26369065,chr17,26369038,26369065,0,33535287
H1|chr17:59947915-59947996,chr17,59947915,59947996,H1|chr17:62915425-62915559,chr17,62915425,62915559,0,2967510
H1|chr17:60030254-60030404,chr17,60030254,60030404,H1|chr17:43567170-43567320,chr17,43567170,43567320,0,16463084
H1|chr17:60092121-60092232,chr17,60092121,60092232,H1|chr17:36612344-36612363,chr17,36612344,36612363,0,23479777
H1|chr17:60141998-60142053,chr17,60141998,60142053,H1|chr17:43321657-43321680,chr17,43321657,43321680,0,16820341
H1|chr17:60413435-60413530,chr17,60413435,60413530,H1|chr17:17726151-17726206,chr17,17726151,17726206,0,42687284
H1|chr17:60446081-60446104,chr17,60446081,60446104,H1|chr17:62918480-62918628,chr17,62918480,62918628,0,2472399
H1|chr17:60603332-60603447,chr17,60603332,60603447,H1|chr17:62918516-62918587,chr17,62918516,62918587,0,2315184
H1|chr17:60744290-60744309,chr17,60744290,60744309,H1|chr17:36582166-36582316,chr17,36582166,36582316,0,24162124
H1|chr17:60832320-60832362,chr17,60832320,60832362,H1|chr17:7466011-7466082,chr17,7466011,7466082,0,53366309
H1|chr17:60970184-60970301,chr17,60970184,60970301,H1|chr17:36610436-36610460,chr17,36610436,36610460,0,24359748
H1|chr17:61087108-61087158,chr17,61087108,61087158,H1|chr17:47755037-47755094,chr17,47755037,47755094,0,13332071
H1|chr17:61222309-61222384,chr17,61222309,61222384,H1|chr17:38278091-38278140,chr17,38278091,38278140,0,22944218
H1|chr17:61266161-61266193,chr17,61266161,61266193,H1|chr17:62918454-62918571,chr17,62918454,62918571,0,1652293
H1|chr17:61372461-61372607,chr17,61372461,61372607,H1|chr17:20434261-20434407,chr17,20434261,20434407,0,40938200
H1|chr17:61421054-61421204,chr17,61421054,61421204,H1|chr17:62915454-62915582,chr17,62915454,62915582,0,1494400
H1|chr17:61427853-61427890,chr17,61427853,61427890,H1|chr17:62918454-62918566,chr17,62918454,62918566,0,1490601
H1|chr17:61460866-61460947,chr17,61460866,61460947,H1|chr17:62918454-62918518,chr17,62918454,62918518,0,1457588
H1|chr17:61515949-61515982,chr17,61515949,61515982,H1|chr17:75086770-75086850,chr17,75086770,75086850,0,13570821
H1|chr17:61883513-61883578,chr17,61883513,61883578,H1|chr17:65826236-65826292,chr17,65826236,65826292,0,3942723
H1|chr17:62018430-62018455,chr17,62018430,62018455,H1|chr17:41281176-41281240,chr17,41281176,41281240,0,20737254
H1|chr17:62125368-62125393,chr17,62125368,62125393,H1|chr17:62918449-62918563,chr17,62918449,62918563,0,793081
H1|chr17:62260134-62260179,chr17,62260134,62260179,H1|chr17:44316439-44316547,chr17,44316439,44316547,0,17943695
H1|chr17:62473919-62473989,chr17,62473919,62473989,H1|chr17:36579809-36579889,chr17,36579809,36579889,0,25894110
H1|chr17:62638410-62638542,chr17,62638410,62638542,H1|chr17:62918638-62918656,chr17,62918638,62918656,0,280228
H1|chr17:62644327-62644403,chr17,62644327,62644403,H1|chr17:74378366-74378440,chr17,74378366,74378440,0,11734039
H1|chr17:62730634-62730701,chr17,62730634,62730701,H1|chr17:65972955-65973008,chr17,65972955,65973008,0,3242321
H1|chr17:63334772-63334895,chr17,63334772,63334895,H1|chr17:74121570-74121597,chr17,74121570,74121597,0,10786798
H1|chr17:63474077-63474104,chr17,63474077,63474104,H1|chr17:62918449-62918572,chr17,62918449,62918572,0,555628
H1|chr17:63626880-63626957,chr17,63626880,63626957,H1|chr17:25606479-25606544,chr17,25606479,25606544,0,38020401
H1|chr17:63773425-63773453,chr17,63773425,63773453,H1|chr17:36580640-36580760,chr17,36580640,36580760,0,27192785
H1|chr17:63775564-63775615,chr17,63775564,63775615,H1|chr17:36579972-36580051,chr17,36579972,36580051,0,27195592
H1|chr17:63876706-63876744,chr17,63876706,63876744,H1|chr17:65825032-65825071,chr17,65825032,65825071,0,1948326
H1|chr17:63892914-63892961,chr17,63892914,63892961,H1|chr17:62918454-62918543,chr17,62918454,62918543,0,974460
H1|chr17:63898110-63898135,chr17,63898110,63898135,H1|chr17:62918449-62918563,chr17,62918449,62918563,0,979661
H1|chr17:63969945-63970058,chr17,63969945,63970058,H1|chr17:44318719-44318774,chr17,44318719,44318774,0,19651226
H1|chr17:64359296-64359438,chr17,64359296,64359438,H1|chr17:62915428-62915577,chr17,62915428,62915577,0,1443868
H1|chr17:64387916-64387938,chr17,64387916,64387938,H1|chr17:62918449-62918519,chr17,62918449,62918519,0,1469467
H1|chr17:64507798-64507833,chr17,64507798,64507833,H1|chr17:74118414-74118549,chr17,74118414,74118549,0,9610616
H1|chr17:64584430-64584508,chr17,64584430,64584508,H1|chr17:38273510-38273596,chr17,38273510,38273596,0,26310920
H1|chr17:65052346-65052407,chr17,65052346,65052407,H1|chr17:36584300-36584352,chr17,36584300,36584352,0,28468046
H1|chr17:65056835-65056985,chr17,65056835,65056985,H1|chr17:65826239-65826264,chr17,65826239,65826264,0,769404
H1|chr17:65057540-65057621,chr17,65057540,65057621,H1|chr17:36580689-36580719,chr17,36580689,36580719,0,28476851
H1|chr17:65083296-65083359,chr17,65083296,65083359,H1|chr17:62918454-62918560,chr17,62918454,62918560,0,2164842
H1|chr17:65201717-65201846,chr17,65201717,65201846,H1|chr17:29057347-29057387,chr17,29057347,29057387,0,36144370
H1|chr17:65257770-65257810,chr17,65257770,65257810,H1|chr17:62918449-62918558,chr17,62918449,62918558,0,2339321
H1|chr17:65314190-65314262,chr17,65314190,65314262,H1|chr17:62918454-62918532,chr17,62918454,62918532,0,2395736
H1|chr17:65316678-65316740,chr17,65316678,65316740,H1|chr17:74119654-74119804,chr17,74119654,74119804,0,8802976
H1|chr17:65510048-65510117,chr17,65510048,65510117,H1|chr17:62918457-62918607,chr17,62918457,62918607,0,2591591
H1|chr17:65537356-65537506,chr17,65537356,65537506,H1|chr17:62915476-62915575,chr17,62915476,62915575,0,2621880
H1|chr17:65576234-65576288,chr17,65576234,65576288,H1|chr17:62918454-62918532,chr17,62918454,62918532,0,2657780
H1|chr17:65880713-65880823,chr17,65880713,65880823,H1|chr17:80058466-80058561,chr17,80058466,80058561,0,14177753
H1|chr17:66506825-66506887,chr17,66506825,66506887,H1|chr17:74121063-74121118,chr17,74121063,74121118,0,7614238
H1|chr17:66747593-66747658,chr17,66747593,66747658,H1|chr17:62915431-62915520,chr17,62915431,62915520,0,3832162
H1|chr17:66939592-66939665,chr17,66939592,66939665,H1|chr17:74120079-74120154,chr17,74120079,74120154,0,7180487
H1|chr17:67167474-67167524,chr17,67167474,67167524,H1|chr17:47755037-47755094,chr17,47755037,47755094,0,19412437
H1|chr17:67276329-67276368,chr17,67276329,67276368,H1|chr17:63055942-63055970,chr17,63055942,63055970,0,4220387
H1|chr17:67391926-67391969,chr17,67391926,67391969,H1|chr17:62918454-62918532,chr17,62918454,62918532,0,4473472
H1|chr17:67450209-67450249,chr17,67450209,67450249,H1|chr17:46135238-46135347,chr17,46135238,46135347,0,21314971
H1|chr17:67479240-67479328,chr17,67479240,67479328,H1|chr17:74120240-74120388,chr17,74120240,74120388,0,6641000
H1|chr17:67823557-67823707,chr17,67823557,67823707,H1|chr17:62915431-62915532,chr17,62915431,62915532,0,4908126
H1|chr17:67880714-67880795,chr17,67880714,67880795,H1|chr17:62918454-62918518,chr17,62918454,62918518,0,4962260
H1|chr17:67979290-67979423,chr17,67979290,67979423,H1|chr17:62915413-62915539,chr17,62915413,62915539,0,5063877
H1|chr17:68013242-68013289,chr17,68013242,68013289,H1|chr17:62918454-62918532,chr17,62918454,62918532,0,5094788
H1|chr17:68068851-68068899,chr17,68068851,68068899,H1|chr17:74448669-74448796,chr17,74448669,74448796,0,6379818
H1|chr17:68105929-68106073,chr17,68105929,68106073,H1|chr17:62915467-62915583,chr17,62915467,62915583,0,5190462
H1|chr17:68135472-68135543,chr17,68135472,68135543,H1|chr17:62915431-62915538,chr17,62915431,62915538,0,5220041
H1|chr17:68285472-68285518,chr17,68285472,68285518,H1|chr17:44318254-44318400,chr17,44318254,44318400,0,23967218
H1|chr17:68306802-68306892,chr17,68306802,68306892,H1|chr17:62918454-62918551,chr17,62918454,62918551,0,5388348
H1|chr17:68381366-68381480,chr17,68381366,68381480,H1|chr17:40730722-40730778,chr17,40730722,40730778,0,27650644
H1|chr17:68573450-68573595,chr17,68573450,68573595,H1|chr17:36579809-36579889,chr17,36579809,36579889,0,31993641
H1|chr17:68625718-68625756,chr17,68625718,68625756,H1|chr17:27892808-27892916,chr17,27892808,27892916,0,40732910
H1|chr17:69159810-69159879,chr17,69159810,69159879,H1|chr17:63055940-63055970,chr17,63055940,63055970,0,6103870
H1|chr17:69174169-69174223,chr17,69174169,69174223,H1|chr17:62918454-62918532,chr17,62918454,62918532,0,6255715
H1|chr17:69205992-69206049,chr17,69205992,69206049,H1|chr17:62918449-62918535,chr17,62918449,62918535,0,6287543
H1|chr17:69326592-69326624,chr17,69326592,69326624,H1|chr17:62918456-62918571,chr17,62918456,62918571,0,6408136
H1|chr17:69356482-69356529,chr17,69356482,69356529,H1|chr17:65825367-65825474,chr17,65825367,65825474,0,3531115
H1|chr17:69382215-69382326,chr17,69382215,69382326,H1|chr17:62918454-62918532,chr17,62918454,62918532,0,6463761
H1|chr17:69737062-69737152,chr17,69737062,69737152,H1|chr17:36584361-36584421,chr17,36584361,36584421,0,33152701
H1|chr17:69828272-69828380,chr17,69828272,69828380,H1|chr17:62918455-62918534,chr17,62918455,62918534,0,6909817
H1|chr17:70066161-70066188,chr17,70066161,70066188,H1|chr17:65822498-65822552,chr17,65822498,65822552,0,4243663
H1|chr17:70153619-70153734,chr17,70153619,70153734,H1|chr17:62918516-62918587,chr17,62918516,62918587,0,7235103
H1|chr17:70195215-70195241,chr17,70195215,70195241,H1|chr17:63055942-63055970,chr17,63055942,63055970,0,7139273
H1|chr17:70205243-70205289,chr17,70205243,70205289,H1|chr17:62918449-62918589,chr17,62918449,62918589,0,7286794
H1|chr17:70350686-70350710,chr17,70350686,70350710,H1|chr17:1360568-1360687,chr17,1360568,1360687,0,68990118
H1|chr17:70723291-70723339,chr17,70723291,70723339,H1|chr17:27892852-27892916,chr17,27892852,27892916,0,42830439
H1|chr17:70836361-70836432,chr17,70836361,70836432,H1|chr17:62918813-62918888,chr17,62918813,62918888,0,7917548
H1|chr17:70846614-70846659,chr17,70846614,70846659,H1|chr17:62918449-62918554,chr17,62918449,62918554,0,7928165
H1|chr17:70987057-70987092,chr17,70987057,70987092,H1|chr17:36507821-36507936,chr17,36507821,36507936,0,34479236
H1|chr17:70997144-70997181,chr17,70997144,70997181,H1|chr17:65823321-65823374,chr17,65823321,65823374,0,5173823
H1|chr17:71110330-71110364,chr17,71110330,71110364,H1|chr17:36583664-36583806,chr17,36583664,36583806,0,34526666
H1|chr17:71142646-71142750,chr17,71142646,71142750,H1|chr17:62918449-62918590,chr17,62918449,62918590,0,8224197
H1|chr17:71251455-71251545,chr17,71251455,71251545,H1|chr17:36581206-36581236,chr17,36581206,36581236,0,34670249
H1|chr17:71344767-71344915,chr17,71344767,71344915,H1|chr17:62915467-62915583,chr17,62915467,62915583,0,8429300
H1|chr17:71368843-71368875,chr17,71368843,71368875,H1|chr17:62918449-62918567,chr17,62918449,62918567,0,8450394
H1|chr17:71404147-71404186,chr17,71404147,71404186,H1|chr17:62918454-62918524,chr17,62918454,62918524,0,8485693
H1|chr17:71507668-71507712,chr17,71507668,71507712,H1|chr17:62918454-62918532,chr17,62918454,62918532,0,8589214
H1|chr17:71513095-71513191,chr17,71513095,71513191,H1|chr17:62918454-62918543,chr17,62918454,62918543,0,8594641
H1|chr17:71603450-71603531,chr17,71603450,71603531,H1|chr17:36580622-36580691,chr17,36580622,36580691,0,35022828
H1|chr17:71607990-71608072,chr17,71607990,71608072,H1|chr17:62918454-62918518,chr17,62918454,62918518,0,8689536
H1|chr17:71721933-71722042,chr17,71721933,71722042,H1|chr17:35076963-35077064,chr17,35076963,35077064,0,36644970
H1|chr17:71858685-71858731,chr17,71858685,71858731,H1|chr17:62918454-62918534,chr17,62918454,62918534,0,8940231
H1|chr17:72212441-72212536,chr17,72212441,72212536,H1|chr17:74121181-74121222,chr17,74121181,74121222,0,1908740
H1|chr17:72215866-72215889,chr17,72215866,72215889,H1|chr17:18906713-18906772,chr17,18906713,18906772,0,53309153
H1|chr17:72349840-72349885,chr17,72349840,72349885,H1|chr17:30676265-30676367,chr17,30676265,30676367,0,41673575
H1|chr17:72448536-72448582,chr17,72448536,72448582,H1|chr17:44318254-44318400,chr17,44318254,44318400,0,28130282
H1|chr17:72451849-72451913,chr17,72451849,72451913,H1|chr17:36579809-36579889,chr17,36579809,36579889,0,35872040
H1|chr17:72779610-72779660,chr17,72779610,72779660,H1|chr17:62918454-62918553,chr17,62918454,62918553,0,9861156
H1|chr17:72813398-72813538,chr17,72813398,72813538,H1|chr17:62915459-62915583,chr17,62915459,62915583,0,9897939
H1|chr17:72821843-72821893,chr17,72821843,72821893,H1|chr17:44316440-44316585,chr17,44316440,44316585,0,28505403
H1|chr17:72832104-72832156,chr17,72832104,72832156,H1|chr17:18906713-18906772,chr17,18906713,18906772,0,53925391
H1|chr17:72887753-72887886,chr17,72887753,72887886,H1|chr17:80378483-80378633,chr17,80378483,80378633,0,7490730
H1|chr17:72931755-72931871,chr17,72931755,72931871,H1|chr17:62915431-62915538,chr17,62915431,62915538,0,10016324
H1|chr17:72935564-72935594,chr17,72935564,72935594,H1|chr17:62918449-62918586,chr17,62918449,62918586,0,10017115
H1|chr17:72969380-72969407,chr17,72969380,72969407,H1|chr17:62915431-62915529,chr17,62915431,62915529,0,10053949
H1|chr17:72991696-72991846,chr17,72991696,72991846,H1|chr17:62915755-62915900,chr17,62915755,62915900,0,10075941
H1|chr17:73246219-73246315,chr17,73246219,73246315,H1|chr17:62918454-62918543,chr17,62918454,62918543,0,10327765
H1|chr17:73311140-73311253,chr17,73311140,73311253,H1|chr17:36612344-36612363,chr17,36612344,36612363,0,36698796
H1|chr17:73403566-73403716,chr17,73403566,73403716,H1|chr17:26369038-26369065,chr17,26369038,26369065,0,47034528
H1|chr17:73493640-73493690,chr17,73493640,73493690,H1|chr17:80058268-80058358,chr17,80058268,80058358,0,6564628
H1|chr17:73597254-73597402,chr17,73597254,73597402,H1|chr17:62915431-62915537,chr17,62915431,62915537,0,10681823
H1|chr17:73643479-73643545,chr17,73643479,73643545,H1|chr17:44316165-44316240,chr17,44316165,44316240,0,29327314
H1|chr17:73688354-73688426,chr17,73688354,73688426,H1|chr17:28804582-28804611,chr17,28804582,28804611,0,44883772
H1|chr17:73724674-73724726,chr17,73724674,73724726,H1|chr17:62915431-62915570,chr17,62915431,62915570,0,10809243
H1|chr17:73780072-73780166,chr17,73780072,73780166,H1|chr17:74121181-74121222,chr17,74121181,74121222,0,341109
H1|chr17:73780646-73780723,chr17,73780646,73780723,H1|chr17:27717418-27717461,chr17,27717418,27717461,0,46063228
H1|chr17:73882807-73882838,chr17,73882807,73882838,H1|chr17:62918449-62918568,chr17,62918449,62918568,0,10964358
H1|chr17:74292049-74292086,chr17,74292049,74292086,H1|chr17:36581792-36581860,chr17,36581792,36581860,0,37710257
H1|chr17:74343220-74343265,chr17,74343220,74343265,H1|chr17:62918497-62918626,chr17,62918497,62918626,0,11424723
H1|chr17:74773082-74773187,chr17,74773082,74773187,H1|chr17:74120174-74120205,chr17,74120174,74120205,0,652908
H1|chr17:74911847-74911881,chr17,74911847,74911881,H1|chr17:62918449-62918597,chr17,62918449,62918597,0,11993398
H1|chr17:75038186-75038281,chr17,75038186,75038281,H1|chr17:62918485-62918518,chr17,62918485,62918518,0,12119701
H1|chr17:75336098-75336134,chr17,75336098,75336134,H1|chr17:43321657-43321680,chr17,43321657,43321680,0,32014441
H1|chr17:75505579-75505671,chr17,75505579,75505671,H1|chr17:27169319-27169336,chr17,27169319,27169336,0,48336260
H1|chr17:75546558-75546708,chr17,75546558,75546708,H1|chr17:62915469-62915579,chr17,62915469,62915579,0,12631089
H1|chr17:75571686-75571827,chr17,75571686,75571827,H1|chr17:62915485-62915582,chr17,62915485,62915582,0,12656201
H1|chr17:75609362-75609394,chr17,75609362,75609394,H1|chr17:62918456-62918571,chr17,62918456,62918571,0,12690906
H1|chr17:75835156-75835179,chr17,75835156,75835179,H1|chr17:74448669-74448796,chr17,74448669,74448796,0,1386487
H1|chr17:75856513-75856540,chr17,75856513,75856540,H1|chr17:65822498-65822552,chr17,65822498,65822552,0,10034015
H1|chr17:75867929-75868062,chr17,75867929,75868062,H1|chr17:62915413-62915539,chr17,62915413,62915539,0,12952516
H1|chr17:75881945-75881984,chr17,75881945,75881984,H1|chr17:62918454-62918524,chr17,62918454,62918524,0,12963491
H1|chr17:75913952-75914005,chr17,75913952,75914005,H1|chr17:36582459-36582540,chr17,36582459,36582540,0,39331493
H1|chr17:75991440-75991474,chr17,75991440,75991474,H1|chr17:62918449-62918586,chr17,62918449,62918586,0,13072991
H1|chr17:76000408-76000442,chr17,76000408,76000442,H1|chr17:44318774-44318887,chr17,44318774,44318887,0,31681634
H1|chr17:76060388-76060432,chr17,76060388,76060432,H1|chr17:34949625-34949731,chr17,34949625,34949731,0,41110763
H1|chr17:76106628-76106676,chr17,76106628,76106676,H1|chr17:27892852-27892916,chr17,27892852,27892916,0,48213776
H1|chr17:76383411-76383432,chr17,76383411,76383432,H1|chr17:62918449-62918591,chr17,62918449,62918591,0,13464962
H1|chr17:76466424-76466478,chr17,76466424,76466478,H1|chr17:27718424-27718467,chr17,27718424,27718467,0,48748000
H1|chr17:76482745-76482781,chr17,76482745,76482781,H1|chr17:62915766-62915912,chr17,62915766,62915912,0,13566979
H1|chr17:76519115-76519194,chr17,76519115,76519194,H1|chr17:74120126-74120205,chr17,74120126,74120205,0,2398989
H1|chr17:76557710-76557759,chr17,76557710,76557759,H1|chr17:62918449-62918587,chr17,62918449,62918587,0,13639261
H1|chr17:76557995-76558021,chr17,76557995,76558021,H1|chr17:62918449-62918584,chr17,62918449,62918584,0,13639546
H1|chr17:76651245-76651386,chr17,76651245,76651386,H1|chr17:62915631-62915780,chr17,62915631,62915780,0,13735614
H1|chr17:76793983-76794024,chr17,76793983,76794024,H1|chr17:74120174-74120205,chr17,74120174,74120205,0,2673809
H1|chr17:76888536-76888587,chr17,76888536,76888587,H1|chr17:47755037-47755094,chr17,47755037,47755094,0,29133499
H1|chr17:76939052-76939076,chr17,76939052,76939076,H1|chr17:36580044-36580156,chr17,36580044,36580156,0,40359008
H1|chr17:76954824-76954866,chr17,76954824,76954866,H1|chr17:27892808-27892916,chr17,27892808,27892916,0,49062016
H1|chr17:77028724-77028787,chr17,77028724,77028787,H1|chr17:62918454-62918560,chr17,62918454,62918560,0,14110270
H1|chr17:77079143-77079179,chr17,77079143,77079179,H1|chr17:36579648-36579737,chr17,36579648,36579737,0,40499495
H1|chr17:77302046-77302094,chr17,77302046,77302094,H1|chr17:62918454-62918532,chr17,62918454,62918532,0,14383592
H1|chr17:77357223-77357298,chr17,77357223,77357298,H1|chr17:62918454-62918526,chr17,62918454,62918526,0,14438769
H1|chr17:77388060-77388210,chr17,77388060,77388210,H1|chr17:20434293-20434424,chr17,20434293,20434424,0,56953767
H1|chr17:77397051-77397157,chr17,77397051,77397157,H1|chr17:62918454-62918518,chr17,62918454,62918518,0,14478597
H1|chr17:77582588-77582648,chr17,77582588,77582648,H1|chr17:65244793-65244863,chr17,65244793,65244863,0,12337795
H1|chr17:77694821-77694845,chr17,77694821,77694845,H1|chr17:36580044-36580156,chr17,36580044,36580156,0,41114777
H1|chr17:77800373-77800413,chr17,77800373,77800413,H1|chr17:47928292-47928358,chr17,47928292,47928358,0,29872081
H1|chr17:77853020-77853058,chr17,77853020,77853058,H1|chr17:62918454-62918532,chr17,62918454,62918532,0,14934566
H1|chr17:77991199-77991293,chr17,77991199,77991293,H1|chr17:40730722-40730778,chr17,40730722,40730778,0,37260477
H1|chr17:78125220-78125343,chr17,78125220,78125343,H1|chr17:26369038-26369065,chr17,26369038,26369065,0,51756182
H1|chr17:78577026-78577108,chr17,78577026,78577108,H1|chr17:63055940-63055970,chr17,63055940,63055970,0,15521086
H1|chr17:78592398-78592492,chr17,78592398,78592492,H1|chr17:42191043-42191074,chr17,42191043,42191074,0,36401355
H1|chr17:78605779-78605853,chr17,78605779,78605853,H1|chr17:74121570-74121646,chr17,74121570,74121646,0,4484209
H1|chr17:78607361-78607451,chr17,78607361,78607451,H1|chr17:28804582-28804611,chr17,28804582,28804611,0,49802779
H1|chr17:78643879-78644029,chr17,78643879,78644029,H1|chr17:62918449-62918583,chr17,62918449,62918583,0,15725430
H1|chr17:78902613-78902763,chr17,78902613,78902763,H1|chr17:43567170-43567320,chr17,43567170,43567320,0,35335443
H1|chr17:78917496-78917559,chr17,78917496,78917559,H1|chr17:43322472-43322559,chr17,43322472,43322559,0,35595024
H1|chr17:78939174-78939232,chr17,78939174,78939232,H1|chr17:62918449-62918526,chr17,62918449,62918526,0,16020725
H1|chr17:79013474-79013584,chr17,79013474,79013584,H1|chr17:80058466-80058561,chr17,80058466,80058561,0,1044992
H1|chr17:79061054-79061102,chr17,79061054,79061102,H1|chr17:62918454-62918532,chr17,62918454,62918532,0,16142600
H1|chr17:79152779-79152840,chr17,79152779,79152840,H1|chr17:36584300-36584352,chr17,36584300,36584352,0,42568479
H1|chr17:79218927-79218972,chr17,79218927,79218972,H1|chr17:62918453-62918556,chr17,62918453,62918556,0,16300474
H1|chr17:79347297-79347346,chr17,79347297,79347346,H1|chr17:62918454-62918532,chr17,62918454,62918532,0,16428843
H1|chr17:79738924-79739035,chr17,79738924,79739035,H1|chr17:62918454-62918532,chr17,62918454,62918532,0,16820470
H1|chr17:79835550-79835658,chr17,79835550,79835658,H1|chr17:62918455-62918534,chr17,62918455,62918534,0,16917095
H1|chr17:79991358-79991422,chr17,79991358,79991422,H1|chr17:38273511-38273596,chr17,38273511,38273596,0,41717847
H1|chr17:80096206-80096244,chr17,80096206,80096244,H1|chr17:42191043-42191074,chr17,42191043,42191074,0,37905163
H1|chr17:80312122-80312212,chr17,80312122,80312212,H1|chr17:27169319-27169336,chr17,27169319,27169336,0,53142803
H1|chr17:80330592-80330614,chr17,80330592,80330614,H1|chr17:18906713-18906772,chr17,18906713,18906772,0,61423879
H1|chr17:80527921-80527968,chr17,80527921,80527968,H1|chr17:7194735-7194802,chr17,7194735,7194802,0,73333186
H1|chr17:80664714-80664797,chr17,80664714,80664797,H1|chr17:36580536-36580603,chr17,36580536,36580603,0,44084178
H1|chr17:80774269-80774350,chr17,80774269,80774350,H1|chr17:36580689-36580719,chr17,36580689,36580719,0,44193580
H1|chr17:80934008-80934097,chr17,80934008,80934097,H1|chr17:48424824-48424871,chr17,48424824,48424871,0,32509184
H1|chr17:81009641-81009687,chr17,81009641,81009687,H1|chr17:62918454-62918534,chr17,62918454,62918534,0,18091187
H1|chr17:81076443-81076492,chr17,81076443,81076492,H1|chr17:62918449-62918587,chr17,62918449,62918587,0,18157994
H1|chr17:81100205-81100256,chr17,81100205,81100256,H1|chr17:62918454-62918532,chr17,62918454,62918532,0,18181751
H1|chr18:77594-77663,chr18,77594,77663,H1|chr18:46478151-46478203,chr18,46478151,46478203,0,46400557
H1|chr18:620350-620395,chr18,620350,620395,H1|chr18:59995733-59995777,chr18,59995733,59995777,0,59375383
H1|chr18:787669-787718,chr18,787669,787718,H1|chr18:24445171-24445244,chr18,24445171,24445244,0,23657502
H1|chr18:1746657-1746732,chr18,1746657,1746732,H1|chr18:56533846-56533921,chr18,56533846,56533921,0,54787189
H1|chr18:3740644-3740677,chr18,3740644,3740677,H1|chr18:46478869-46478930,chr18,46478869,46478930,0,42738225
H1|chr18:3981459-3981573,chr18,3981459,3981573,H1|chr18:46477185-46477218,chr18,46477185,46477218,0,42495726
H1|chr18:4149130-4149182,chr18,4149130,4149182,H1|chr18:77867925-77867950,chr18,77867925,77867950,0,73718795
H1|chr18:6506933-6506961,chr18,6506933,6506961,H1|chr18:8707637-8707759,chr18,8707637,8707759,0,2200704
H1|chr18:8257406-8257528,chr18,8257406,8257528,H1|chr18:43661195-43661223,chr18,43661195,43661223,0,35403789
H1|chr18:9630422-9630462,chr18,9630422,9630462,H1|chr18:3453465-3453540,chr18,3453465,3453540,0,6176957
H1|chr18:11086617-11086683,chr18,11086617,11086683,H1|chr18:60189721-60189786,chr18,60189721,60189786,0,49103104
H1|chr18:11328227-11328329,chr18,11328227,11328329,H1|chr18:46477360-46477391,chr18,46477360,46477391,0,35149133
H1|chr18:15141904-15141996,chr18,15141904,15141996,H1|chr18:19179476-19179522,chr18,19179476,19179522,0,4037572
H1|chr18:15209442-15209531,chr18,15209442,15209531,H1|chr18:3454238-3454276,chr18,3454238,3454276,0,11755204
H1|chr18:18231226-18231308,chr18,18231226,18231308,H1|chr18:22009286-22009322,chr18,22009286,22009322,0,3778060
H1|chr18:19281933-19281960,chr18,19281933,19281960,H1|chr18:8707637-8707759,chr18,8707637,8707759,0,10574296
H1|chr18:21175055-21175089,chr18,21175055,21175089,H1|chr18:65183319-65183385,chr18,65183319,65183385,0,44008264
H1|chr18:21873772-21873894,chr18,21873772,21873894,H1|chr18:46477185-46477218,chr18,46477185,46477218,0,24603413
H1|chr18:22050935-22051032,chr18,22050935,22051032,H1|chr18:19179476-19179522,chr18,19179476,19179522,0,2871459
H1|chr18:23575715-23575817,chr18,23575715,23575817,H1|chr18:46477360-46477391,chr18,46477360,46477391,0,22901645
H1|chr18:24887481-24887515,chr18,24887481,24887515,H1|chr18:65183319-65183385,chr18,65183319,65183385,0,40295838
H1|chr18:29288628-29288680,chr18,29288628,29288680,H1|chr18:77867925-77867950,chr18,77867925,77867950,0,48579297
H1|chr18:30668293-30668342,chr18,30668293,30668342,H1|chr18:24445171-24445244,chr18,24445171,24445244,0,6223122
H1|chr18:33513295-33513332,chr18,33513295,33513332,H1|chr18:3453383-3453496,chr18,3453383,3453496,0,30059912
H1|chr18:33720665-33720750,chr18,33720665,33720750,H1|chr18:12882223-12882279,chr18,12882223,12882279,0,20838442
H1|chr18:35757147-35757219,chr18,35757147,35757219,H1|chr18:3453383-3453460,chr18,3453383,3453460,0,32303764
H1|chr18:37357002-37357030,chr18,37357002,37357030,H1|chr18:8707637-8707759,chr18,8707637,8707759,0,28649365
H1|chr18:39045231-39045298,chr18,39045231,39045298,H1|chr18:19179476-19179522,chr18,19179476,19179522,0,19865755
H1|chr18:42131269-42131341,chr18,42131269,42131341,H1|chr18:3453383-3453460,chr18,3453383,3453460,0,38677886
H1|chr18:42185305-42185380,chr18,42185305,42185380,H1|chr18:56533846-56533921,chr18,56533846,56533921,0,14348541
H1|chr18:42677849-42677999,chr18,42677849,42677999,H1|chr18:43661195-43661223,chr18,43661195,43661223,0,983346
H1|chr18:43656492-43656583,chr18,43656492,43656583,H1|chr18:3450664-3450713,chr18,3450664,3450713,0,40205828
H1|chr18:44959851-44959894,chr18,44959851,44959894,H1|chr18:3453465-3453540,chr18,3453465,3453540,0,41506386
H1|chr18:45578580-45578611,chr18,45578580,45578611,H1|chr18:60186134-60186227,chr18,60186134,60186227,0,14607554
H1|chr18:47302398-47302427,chr18,47302398,47302427,H1|chr18:46478151-46478203,chr18,46478151,46478203,0,824247
H1|chr18:48108792-48108858,chr18,48108792,48108858,H1|chr18:60189721-60189786,chr18,60189721,60189786,0,12080929
H1|chr18:50354887-50354984,chr18,50354887,50354984,H1|chr18:19179476-19179522,chr18,19179476,19179522,0,31175411
H1|chr18:51113235-51113357,chr18,51113235,51113357,H1|chr18:46477185-46477218,chr18,46477185,46477218,0,4636050
H1|chr18:52520635-52520749,chr18,52520635,52520749,H1|chr18:46477185-46477218,chr18,46477185,46477218,0,6043450
H1|chr18:52953057-52953126,chr18,52953057,52953126,H1|chr18:46478151-46478203,chr18,46478151,46478203,0,6474906
H1|chr18:54217373-54217395,chr18,54217373,54217395,H1|chr18:77868259-77868362,chr18,77868259,77868362,0,23650886
H1|chr18:54581759-54581841,chr18,54581759,54581841,H1|chr18:22009286-22009322,chr18,22009286,22009322,0,32572473
H1|chr18:55185892-55185932,chr18,55185892,55185932,H1|chr18:3453465-3453540,chr18,3453465,3453540,0,51732427
H1|chr18:57967010-57967047,chr18,57967010,57967047,H1|chr18:3453383-3453496,chr18,3453383,3453496,0,54513627
H1|chr18:60180158-60180280,chr18,60180158,60180280,H1|chr18:43661195-43661223,chr18,43661195,43661223,0,16518963
H1|chr18:62685250-62685400,chr18,62685250,62685400,H1|chr18:43661195-43661223,chr18,43661195,43661223,0,19024055
H1|chr18:63037937-63038009,chr18,63037937,63038009,H1|chr18:56534472-56534546,chr18,56534472,56534546,0,6503465
H1|chr18:64648205-64648290,chr18,64648205,64648290,H1|chr18:12882223-12882279,chr18,12882223,12882279,0,51765982
H1|chr18:64858428-64858523,chr18,64858428,64858523,H1|chr18:3450664-3450713,chr18,3450664,3450713,0,61407764
H1|chr18:64860463-64860506,chr18,64860463,64860506,H1|chr18:3453465-3453540,chr18,3453465,3453540,0,61406998
H1|chr18:65272812-65272834,chr18,65272812,65272834,H1|chr18:77868259-77868362,chr18,77868259,77868362,0,12595447
H1|chr18:67107463-67107552,chr18,67107463,67107552,H1|chr18:3454238-3454276,chr18,3454238,3454276,0,63653225
H1|chr18:69026680-69026752,chr18,69026680,69026752,H1|chr18:56534472-56534546,chr18,56534472,56534546,0,12492208
H1|chr18:70454127-70454160,chr18,70454127,70454160,H1|chr18:46478869-46478930,chr18,46478869,46478930,0,23975258
H1|chr18:71278048-71278079,chr18,71278048,71278079,H1|chr18:60186134-60186227,chr18,60186134,60186227,0,11091914
H1|chr18:71815515-71815607,chr18,71815515,71815607,H1|chr18:19179476-19179522,chr18,19179476,19179522,0,52636039
H1|chr18:74362707-74362802,chr18,74362707,74362802,H1|chr18:3450664-3450713,chr18,3450664,3450713,0,70912043
H1|chr18:74519597-74519624,chr18,74519597,74519624,H1|chr18:8707637-8707759,chr18,8707637,8707759,0,65811960
H1|chr18:74913094-74913185,chr18,74913094,74913185,H1|chr18:3450664-3450713,chr18,3450664,3450713,0,71462430
H1|chr18:75403421-75403450,chr18,75403421,75403450,H1|chr18:46478151-46478203,chr18,46478151,46478203,0,28925270
H1|chr18:75637005-75637072,chr18,75637005,75637072,H1|chr18:19179476-19179522,chr18,19179476,19179522,0,56457529
H1|chr18:76107627-76107672,chr18,76107627,76107672,H1|chr18:59995733-59995777,chr18,59995733,59995777,0,16111894
H1|chr19:87801-87938,chr19,87801,87938,H1|chr19:1408901-1408981,chr19,1408901,1408981,0,1321100
H1|chr19:293020-293061,chr19,293020,293061,H1|chr19:630986-631069,chr19,630986,631069,0,337966
H1|chr19:794942-794964,chr19,794942,794964,H1|chr19:8673629-8673652,chr19,8673629,8673652,0,7878687
H1|chr19:953456-953522,chr19,953456,953522,H1|chr19:13947494-13947520,chr19,13947494,13947520,0,12994038
H1|chr19:1218022-1218069,chr19,1218022,1218069,H1|chr19:793188-793286,chr19,793188,793286,0,424834
H1|chr19:1429702-1429806,chr19,1429702,1429806,H1|chr19:48280642-48280688,chr19,48280642,48280688,0,46850940
H1|chr19:1758343-1758426,chr19,1758343,1758426,H1|chr19:5823778-5823811,chr19,5823778,5823811,0,4065435
H1|chr19:1800695-1800842,chr19,1800695,1800842,H1|chr19:3972191-3972292,chr19,3972191,3972292,0,2171496
H1|chr19:1912507-1912616,chr19,1912507,1912616,H1|chr19:12889964-12890065,chr19,12889964,12890065,0,10977457
H1|chr19:2190622-2190654,chr19,2190622,2190654,H1|chr19:45308543-45308577,chr19,45308543,45308577,0,43117921
H1|chr19:2191556-2191605,chr19,2191556,2191605,H1|chr19:13947771-13947827,chr19,13947771,13947827,0,11756215
H1|chr19:2261118-2261202,chr19,2261118,2261202,H1|chr19:41698776-41698823,chr19,41698776,41698823,0,39437658
H1|chr19:2280488-2280570,chr19,2280488,2280570,H1|chr19:52407983-52408041,chr19,52407983,52408041,0,50127495
H1|chr19:2545474-2545587,chr19,2545474,2545587,H1|chr19:13947477-13947520,chr19,13947477,13947520,0,11402003
H1|chr19:2627719-2627741,chr19,2627719,2627741,H1|chr19:47556032-47556099,chr19,47556032,47556099,0,44928313
H1|chr19:2803211-2803260,chr19,2803211,2803260,H1|chr19:8455838-8455939,chr19,8455838,8455939,0,5652627
H1|chr19:2924396-2924424,chr19,2924396,2924424,H1|chr19:792425-792542,chr19,792425,792542,0,2131971
H1|chr19:3125924-3126009,chr19,3125924,3126009,H1|chr19:52408039-52408102,chr19,52408039,52408102,0,49282115
H1|chr19:3280610-3280698,chr19,3280610,3280698,H1|chr19:13055820-13055960,chr19,13055820,13055960,0,9775210
H1|chr19:3347515-3347595,chr19,3347515,3347595,H1|chr19:793245-793314,chr19,793245,793314,0,2554270
H1|chr19:3690820-3690917,chr19,3690820,3690917,H1|chr19:53074132-53074180,chr19,53074132,53074180,0,49383312
H1|chr19:3700878-3700919,chr19,3700878,3700919,H1|chr19:2949521-2949614,chr19,2949521,2949614,0,751357
H1|chr19:3756667-3756720,chr19,3756667,3756720,H1|chr19:13947497-13947520,chr19,13947497,13947520,0,10190830
H1|chr19:3859046-3859130,chr19,3859046,3859130,H1|chr19:52408039-52408102,chr19,52408039,52408102,0,48548993
H1|chr19:4107911-4107980,chr19,4107911,4107980,H1|chr19:3575941-3576000,chr19,3575941,3576000,0,531970
H1|chr19:4287449-4287552,chr19,4287449,4287552,H1|chr19:13947497-13947520,chr19,13947497,13947520,0,9660048
H1|chr19:4765400-4765484,chr19,4765400,4765484,H1|chr19:52407983-52408041,chr19,52407983,52408041,0,47642583
H1|chr19:4822767-4822814,chr19,4822767,4822814,H1|chr19:14611299-14611353,chr19,14611299,14611353,0,9788532
H1|chr19:5319975-5320045,chr19,5319975,5320045,H1|chr19:9694447-9694494,chr19,9694447,9694494,0,4374472
H1|chr19:5458924-5458983,chr19,5458924,5458983,H1|chr19:48280396-48280443,chr19,48280396,48280443,0,42821472
H1|chr19:5464830-5464879,chr19,5464830,5464879,H1|chr19:39465315-39465416,chr19,39465315,39465416,0,34000485
H1|chr19:5756356-5756401,chr19,5756356,5756401,H1|chr19:54461761-54461866,chr19,54461761,54461866,0,48705405
H1|chr19:5793723-5793749,chr19,5793723,5793749,H1|chr19:47976008-47976029,chr19,47976008,47976029,0,42182285
H1|chr19:5866348-5866403,chr19,5866348,5866403,H1|chr19:1411058-1411150,chr19,1411058,1411150,0,4455290
H1|chr19:5882338-5882376,chr19,5882338,5882376,H1|chr19:19244361-19244449,chr19,19244361,19244449,0,13362023
H1|chr19:5928624-5928734,chr19,5928624,5928734,H1|chr19:39139155-39139179,chr19,39139155,39139179,0,33210531
H1|chr19:5938010-5938116,chr19,5938010,5938116,H1|chr19:48280642-48280688,chr19,48280642,48280688,0,42342632
H1|chr19:6044026-6044079,chr19,6044026,6044079,H1|chr19:39519203-39519245,chr19,39519203,39519245,0,33475177
H1|chr19:6461931-6461979,chr19,6461931,6461979,H1|chr19:3969266-3969302,chr19,3969266,3969302,0,2492665
H1|chr19:6665738-6665821,chr19,6665738,6665821,H1|chr19:14527403-14527461,chr19,14527403,14527461,0,7861665
H1|chr19:6708351-6708385,chr19,6708351,6708385,H1|chr19:13947485-13947520,chr19,13947485,13947520,0,7239134
H1|chr19:7023238-7023260,chr19,7023238,7023260,H1|chr19:39466063-39466205,chr19,39466063,39466205,0,32442825
H1|chr19:7061669-7061786,chr19,7061669,7061786,H1|chr19:35604250-35604310,chr19,35604250,35604310,0,28542581
H1|chr19:7117978-7118053,chr19,7117978,7118053,H1|chr19:13947492-13947520,chr19,13947492,13947520,0,6829514
H1|chr19:7247668-7247715,chr19,7247668,7247715,H1|chr19:14611299-14611353,chr19,14611299,14611353,0,7363631
H1|chr19:8295016-8295047,chr19,8295016,8295047,H1|chr19:51306154-51306304,chr19,51306154,51306304,0,43011138
H1|chr19:8604752-8604864,chr19,8604752,8604864,H1|chr19:13947486-13947520,chr19,13947486,13947520,0,5342734
H1|chr19:8974758-8974851,chr19,8974758,8974851,H1|chr19:54953977-54954028,chr19,54953977,54954028,0,45979219
H1|chr19:9076222-9076320,chr19,9076222,9076320,H1|chr19:13947494-13947520,chr19,13947494,13947520,0,4871272
H1|chr19:9225207-9225320,chr19,9225207,9225320,H1|chr19:54955032-54955076,chr19,54955032,54955076,0,45729825
H1|chr19:9256511-9256539,chr19,9256511,9256539,H1|chr19:792090-792207,chr19,792090,792207,0,8464421
H1|chr19:9411121-9411151,chr19,9411121,9411151,H1|chr19:54462998-54463059,chr19,54462998,54463059,0,45051877
H1|chr19:9807052-9807136,chr19,9807052,9807136,H1|chr19:52407983-52408041,chr19,52407983,52408041,0,42600931
H1|chr19:10149312-10149349,chr19,10149312,10149349,H1|chr19:19244361-19244449,chr19,19244361,19244449,0,9095049
H1|chr19:10167592-10167657,chr19,10167592,10167657,H1|chr19:13947484-13947520,chr19,13947484,13947520,0,3779892
H1|chr19:10207358-10207400,chr19,10207358,10207400,H1|chr19:2947941-2948016,chr19,2947941,2948016,0,7259417
H1|chr19:10472548-10472659,chr19,10472548,10472659,H1|chr19:3883757-3883777,chr19,3883757,3883777,0,6588791
H1|chr19:10541679-10541767,chr19,10541679,10541767,H1|chr19:8213535-8213597,chr19,8213535,8213597,0,2328144
H1|chr19:10680590-10680626,chr19,10680590,10680626,H1|chr19:54462820-54462900,chr19,54462820,54462900,0,43782230
H1|chr19:10727550-10727666,chr19,10727550,10727666,H1|chr19:39465315-39465416,chr19,39465315,39465416,0,28737765
H1|chr19:10918379-10918485,chr19,10918379,10918485,H1|chr19:48280642-48280688,chr19,48280642,48280688,0,37362263
H1|chr19:11336562-11336647,chr19,11336562,11336647,H1|chr19:52408039-52408102,chr19,52408039,52408102,0,41071477
H1|chr19:11345402-11345515,chr19,11345402,11345515,H1|chr19:13947477-13947520,chr19,13947477,13947520,0,2602075
H1|chr19:11346466-11346572,chr19,11346466,11346572,H1|chr19:54955032-54955076,chr19,54955032,54955076,0,43608566
H1|chr19:11399746-11399848,chr19,11399746,11399848,H1|chr19:793245-793314,chr19,793245,793314,0,10606501
H1|chr19:11818980-11819008,chr19,11818980,11819008,H1|chr19:792425-792542,chr19,792425,792542,0,11026555
H1|chr19:11886583-11886633,chr19,11886583,11886633,H1|chr19:14603192-14603261,chr19,14603192,14603261,0,2716609
H1|chr19:11966378-11966494,chr19,11966378,11966494,H1|chr19:38745945-38745979,chr19,38745945,38745979,0,26779567
H1|chr19:12181444-12181509,chr19,12181444,12181509,H1|chr19:47738768-47738841,chr19,47738768,47738841,0,35557324
H1|chr19:12292717-12292791,chr19,12292717,12292791,H1|chr19:58691781-58691810,chr19,58691781,58691810,0,46399064
H1|chr19:12381932-12382052,chr19,12381932,12382052,H1|chr19:58691781-58691811,chr19,58691781,58691811,0,46309849
H1|chr19:12952377-12952417,chr19,12952377,12952417,H1|chr19:11709064-11709174,chr19,11709064,11709174,0,1243313
H1|chr19:13034693-13034781,chr19,13034693,13034781,H1|chr19:35604250-35604310,chr19,35604250,35604310,0,22569557
H1|chr19:13303833-13303975,chr19,13303833,13303975,H1|chr19:793385-793532,chr19,793385,793532,0,12510448
H1|chr19:13315682-13315726,chr19,13315682,13315726,H1|chr19:39139001-39139071,chr19,39139001,39139071,0,25823319
H1|chr19:13538884-13538970,chr19,13538884,13538970,H1|chr19:47287554-47287625,chr19,47287554,47287625,0,33748670
H1|chr19:13575987-13576094,chr19,13575987,13576094,H1|chr19:13947501-13947520,chr19,13947501,13947520,0,371514
H1|chr19:13878188-13878301,chr19,13878188,13878301,H1|chr19:54955032-54955076,chr19,54955032,54955076,0,41076844
H1|chr19:13976915-13976959,chr19,13976915,13976959,H1|chr19:59057611-59057672,chr19,59057611,59057672,0,45080696
H1|chr19:13988150-13988270,chr19,13988150,13988270,H1|chr19:35602543-35602590,chr19,35602543,35602590,0,21614393
H1|chr19:14553440-14553500,chr19,14553440,14553500,H1|chr19:13947485-13947520,chr19,13947485,13947520,0,605955
H1|chr19:14722659-14722700,chr19,14722659,14722700,H1|chr19:630986-631069,chr19,630986,631069,0,14091673
H1|chr19:14877592-14877652,chr19,14877592,14877652,H1|chr19:52776718-52776741,chr19,52776718,52776741,0,37899126
H1|chr19:15358319-15358394,chr19,15358319,15358394,H1|chr19:47730763-47730817,chr19,47730763,47730817,0,32372444
H1|chr19:15363075-15363158,chr19,15363075,15363158,H1|chr19:54954177-54954244,chr19,54954177,54954244,0,39591102
H1|chr19:15487243-15487317,chr19,15487243,15487317,H1|chr19:47731059-47731135,chr19,47731059,47731135,0,32243816
H1|chr19:15855885-15855964,chr19,15855885,15855964,H1|chr19:17969199-17969250,chr19,17969199,17969250,0,2113314
H1|chr19:15865139-15865197,chr19,15865139,15865197,H1|chr19:3883318-3883384,chr19,3883318,3883384,0,11981821
H1|chr19:16014246-16014332,chr19,16014246,16014332,H1|chr19:47287554-47287625,chr19,47287554,47287625,0,31273308
H1|chr19:16252128-16252202,chr19,16252128,16252202,H1|chr19:14530892-14530941,chr19,14530892,14530941,0,1721236
H1|chr19:16253827-16253937,chr19,16253827,16253937,H1|chr19:39139155-39139179,chr19,39139155,39139179,0,22885328
H1|chr19:16452475-16452556,chr19,16452475,16452556,H1|chr19:13947477-13947520,chr19,13947477,13947520,0,2504998
H1|chr19:16582685-16582750,chr19,16582685,16582750,H1|chr19:47733116-47733178,chr19,47733116,47733178,0,31150431
H1|chr19:16609675-16609712,chr19,16609675,16609712,H1|chr19:3569515-3569588,chr19,3569515,3569588,0,13040160
H1|chr19:17011706-17011795,chr19,17011706,17011795,H1|chr19:11709064-11709174,chr19,11709064,11709174,0,5302642
H1|chr19:17019163-17019199,chr19,17019163,17019199,H1|chr19:794041-794155,chr19,794041,794155,0,16225122
H1|chr19:17043075-17043137,chr19,17043075,17043137,H1|chr19:5823778-5823811,chr19,5823778,5823811,0,11219297
H1|chr19:17192872-17192961,chr19,17192872,17192961,H1|chr19:11709064-11709174,chr19,11709064,11709174,0,5483808
H1|chr19:17193523-17193551,chr19,17193523,17193551,H1|chr19:792090-792207,chr19,792090,792207,0,16401433
H1|chr19:17256658-17256691,chr19,17256658,17256691,H1|chr19:47356004-47356074,chr19,47356004,47356074,0,30099346
H1|chr19:17352573-17352660,chr19,17352573,17352660,H1|chr19:14527403-14527461,chr19,14527403,14527461,0,2825170
H1|chr19:17648122-17648147,chr19,17648122,17648147,H1|chr19:47287487-47287542,chr19,47287487,47287542,0,29639365
H1|chr19:17657910-17657943,chr19,17657910,17657943,H1|chr19:54954182-54954297,chr19,54954182,54954297,0,37296272
H1|chr19:17845165-17845239,chr19,17845165,17845239,H1|chr19:47731059-47731135,chr19,47731059,47731135,0,29885894
H1|chr19:17932967-17933053,chr19,17932967,17933053,H1|chr19:13055820-13055960,chr19,13055820,13055960,0,4877147
H1|chr19:17994824-17994915,chr19,17994824,17994915,H1|chr19:46392810-46392869,chr19,46392810,46392869,0,28397986
H1|chr19:18037447-18037535,chr19,18037447,18037535,H1|chr19:8213535-8213597,chr19,8213535,8213597,0,9823912
H1|chr19:18178805-18178901,chr19,18178805,18178901,H1|chr19:47287695-47287824,chr19,47287695,47287824,0,29108890
H1|chr19:18275364-18275479,chr19,18275364,18275479,H1|chr19:45308543-45308577,chr19,45308543,45308577,0,27033179
H1|chr19:18409622-18409687,chr19,18409622,18409687,H1|chr19:13947484-13947520,chr19,13947484,13947520,0,4462138
H1|chr19:18448796-18448884,chr19,18448796,18448884,H1|chr19:35604250-35604310,chr19,35604250,35604310,0,17155454
H1|chr19:18498000-18498072,chr19,18498000,18498072,H1|chr19:54023349-54023406,chr19,54023349,54023406,0,35525349
H1|chr19:18738567-18738641,chr19,18738567,18738641,H1|chr19:58691781-58691810,chr19,58691781,58691810,0,39953214
H1|chr19:18803157-18803229,chr19,18803157,18803229,H1|chr19:17529407-17529464,chr19,17529407,17529464,0,1273750
H1|chr19:18839839-18839862,chr19,18839839,18839862,H1|chr19:49257158-49257285,chr19,49257158,49257285,0,30417319
H1|chr19:18954391-18954413,chr19,18954391,18954413,H1|chr19:792491-792542,chr19,792491,792542,0,18161900
H1|chr19:19392685-19392764,chr19,19392685,19392764,H1|chr19:17969199-17969250,chr19,17969199,17969250,0,1423486
H1|chr19:19476700-19476783,chr19,19476700,19476783,H1|chr19:5823778-5823811,chr19,5823778,5823811,0,13652922
H1|chr19:19645860-19645952,chr19,19645860,19645952,H1|chr19:47977739-47977792,chr19,47977739,47977792,0,28331879
H1|chr19:19722574-19722645,chr19,19722574,19722645,H1|chr19:36000664-36000702,chr19,36000664,36000702,0,16278090
H1|chr19:19749334-19749434,chr19,19749334,19749434,H1|chr19:49257162-49257286,chr19,49257162,49257286,0,29507828
H1|chr19:19864725-19864839,chr19,19864725,19864839,H1|chr19:13947496-13947520,chr19,13947496,13947520,0,5917229
H1|chr19:20185055-20185152,chr19,20185055,20185152,H1|chr19:53074132-53074180,chr19,53074132,53074180,0,32889077
H1|chr19:20232014-20232131,chr19,20232014,20232131,H1|chr19:35632825-35632858,chr19,35632825,35632858,0,15400811
H1|chr19:20547569-20547665,chr19,20547569,20547665,H1|chr19:47977739-47977792,chr19,47977739,47977792,0,27430170
H1|chr19:20621409-20621478,chr19,20621409,20621478,H1|chr19:3575941-3576000,chr19,3575941,3576000,0,17045468
H1|chr19:20739295-20739317,chr19,20739295,20739317,H1|chr19:8673629-8673652,chr19,8673629,8673652,0,12065666
H1|chr19:21169863-21169907,chr19,21169863,21169907,H1|chr19:630986-631069,chr19,630986,631069,0,20538877
H1|chr19:21357024-21357174,chr19,21357024,21357174,H1|chr19:35632825-35632858,chr19,35632825,35632858,0,14275801
H1|chr19:21434795-21434828,chr19,21434795,21434828,H1|chr19:47356004-47356074,chr19,47356004,47356074,0,25921209
H1|chr19:21828787-21828818,chr19,21828787,21828818,H1|chr19:51306154-51306304,chr19,51306154,51306304,0,29477367
H1|chr19:21903420-21903549,chr19,21903420,21903549,H1|chr19:3883757-3883777,chr19,3883757,3883777,0,18019663
H1|chr19:22057830-22057867,chr19,22057830,22057867,H1|chr19:3569515-3569588,chr19,3569515,3569588,0,18488315
H1|chr19:22208889-22208938,chr19,22208889,22208938,H1|chr19:13947771-13947827,chr19,13947771,13947827,0,8261118
H1|chr19:22334706-22334727,chr19,22334706,22334727,H1|chr19:49257162-49257286,chr19,49257162,49257286,0,26922456
H1|chr19:22361698-22361840,chr19,22361698,22361840,H1|chr19:793385-793532,chr19,793385,793532,0,21568313
H1|chr19:22431211-22431252,chr19,22431211,22431252,H1|chr19:2949521-2949614,chr19,2949521,2949614,0,19481690
H1|chr19:22531975-22532053,chr19,22531975,22532053,H1|chr19:47287553-47287625,chr19,47287553,47287625,0,24755578
H1|chr19:22676214-22676277,chr19,22676214,22676277,H1|chr19:53074132-53074180,chr19,53074132,53074180,0,30397918
H1|chr19:22928207-22928269,chr19,22928207,22928269,H1|chr19:5823778-5823811,chr19,5823778,5823811,0,17104429
H1|chr19:23276906-23277012,chr19,23276906,23277012,H1|chr19:54955032-54955076,chr19,54955032,54955076,0,31678126
H1|chr19:23369767-23369786,chr19,23369767,23369786,H1|chr19:54464952-54465058,chr19,54464952,54465058,0,31095185
H1|chr19:23394104-23394207,chr19,23394104,23394207,H1|chr19:13947497-13947520,chr19,13947497,13947520,0,9446607
H1|chr19:23434617-23434719,chr19,23434617,23434719,H1|chr19:793245-793314,chr19,793245,793314,0,22641372
H1|chr19:23513720-23513765,chr19,23513720,23513765,H1|chr19:37160075-37160210,chr19,37160075,37160210,0,13646355
H1|chr19:23713279-23713332,chr19,23713279,23713332,H1|chr19:54466205-54466326,chr19,54466205,54466326,0,30752926
H1|chr19:24293809-24293874,chr19,24293809,24293874,H1|chr19:48250685-48250749,chr19,48250685,48250749,0,23956876
H1|chr19:24393003-24393121,chr19,24393003,24393121,H1|chr19:54954177-54954244,chr19,54954177,54954244,0,30561174
H1|chr19:24395801-24395836,chr19,24395801,24395836,H1|chr19:3575942-3575990,chr19,3575942,3575990,0,20819859
H1|chr19:24469891-24469994,chr19,24469891,24469994,H1|chr19:13947477-13947520,chr19,13947477,13947520,0,10522414
H1|chr19:24501458-24501495,chr19,24501458,24501495,H1|chr19:13948226-13948353,chr19,13948226,13948353,0,10553232
H1|chr19:24738265-24738327,chr19,24738265,24738327,H1|chr19:52776718-52776741,chr19,52776718,52776741,0,28038453
H1|chr19:25452786-25452828,chr19,25452786,25452828,H1|chr19:8213536-8213644,chr19,8213536,8213644,0,17239250
H1|chr19:25516350-25516469,chr19,25516350,25516469,H1|chr19:13947493-13947520,chr19,13947493,13947520,0,11568857
H1|chr19:25918545-25918575,chr19,25918545,25918575,H1|chr19:54462998-54463059,chr19,54462998,54463059,0,28544453
H1|chr19:26273305-26273352,chr19,26273305,26273352,H1|chr19:793188-793286,chr19,793188,793286,0,25480117
H1|chr19:26275722-26275828,chr19,26275722,26275828,H1|chr19:8455832-8455939,chr19,8455832,8455939,0,17819890
H1|chr19:26647079-26647147,chr19,26647079,26647147,H1|chr19:9694447-9694494,chr19,9694447,9694494,0,16952632
H1|chr19:26676005-26676052,chr19,26676005,26676052,H1|chr19:13947486-13947520,chr19,13947486,13947520,0,12728519
H1|chr19:26888550-26888648,chr19,26888550,26888648,H1|chr19:14525440-14525471,chr19,14525440,14525471,0,12363110
H1|chr19:27087373-27087425,chr19,27087373,27087425,H1|chr19:631016-631157,chr19,631016,631157,0,26456357
H1|chr19:27171703-27171786,chr19,27171703,27171786,H1|chr19:14527403-14527461,chr19,14527403,14527461,0,12644300
H1|chr19:27240362-27240387,chr19,27240362,27240387,H1|chr19:47287487-47287542,chr19,47287487,47287542,0,20047125
H1|chr19:27259524-27259607,chr19,27259524,27259607,H1|chr19:54954177-54954244,chr19,54954177,54954244,0,27694653
H1|chr19:27324697-27324762,chr19,27324697,27324762,H1|chr19:47738768-47738841,chr19,47738768,47738841,0,20414071
H1|chr19:28085798-28085854,chr19,28085798,28085854,H1|chr19:35480677-35480725,chr19,35480677,35480725,0,7394879
H1|chr19:28183180-28183203,chr19,28183180,28183203,H1|chr19:49257158-49257285,chr19,49257158,49257285,0,21073978
H1|chr19:28366338-28366443,chr19,28366338,28366443,H1|chr19:13947501-13947520,chr19,13947501,13947520,0,14418837
H1|chr19:28558552-28558636,chr19,28558552,28558636,H1|chr19:52408039-52408102,chr19,52408039,52408102,0,23849487
H1|chr19:28683960-28684009,chr19,28683960,28684009,H1|chr19:8455838-8455939,chr19,8455838,8455939,0,20228122
H1|chr19:28870443-28870561,chr19,28870443,28870561,H1|chr19:54954177-54954244,chr19,54954177,54954244,0,26083734
H1|chr19:28871669-28871772,chr19,28871669,28871772,H1|chr19:13947477-13947520,chr19,13947477,13947520,0,14924192
H1|chr19:28947883-28947979,chr19,28947883,28947979,H1|chr19:47977739-47977792,chr19,47977739,47977792,0,19029856
H1|chr19:29005064-29005119,chr19,29005064,29005119,H1|chr19:39519203-39519245,chr19,39519203,39519245,0,10514139
H1|chr19:29536293-29536356,chr19,29536293,29536356,H1|chr19:5823778-5823811,chr19,5823778,5823811,0,23712515
H1|chr19:29600634-29600773,chr19,29600634,29600773,H1|chr19:58691781-58691810,chr19,58691781,58691810,0,29091147
H1|chr19:29646924-29646999,chr19,29646924,29646999,H1|chr19:47730763-47730817,chr19,47730763,47730817,0,18083839
H1|chr19:29710799-29710833,chr19,29710799,29710833,H1|chr19:54954182-54954297,chr19,54954182,54954297,0,25243383
H1|chr19:29731414-29731436,chr19,29731414,29731436,H1|chr19:13948226-13948353,chr19,13948226,13948353,0,15783188
H1|chr19:30067945-30067977,chr19,30067945,30067977,H1|chr19:47356004-47356074,chr19,47356004,47356074,0,17288059
H1|chr19:31136727-31136787,chr19,31136727,31136787,H1|chr19:58364408-58364477,chr19,58364408,58364477,0,27227681
H1|chr19:31287751-31287814,chr19,31287751,31287814,H1|chr19:53074132-53074180,chr19,53074132,53074180,0,21786381
H1|chr19:31378802-31378910,chr19,31378802,31378910,H1|chr19:792090-792207,chr19,792090,792207,0,30586712
H1|chr19:32071128-32071163,chr19,32071128,32071163,H1|chr19:3575942-3575990,chr19,3575942,3575990,0,28495186
H1|chr19:32115385-32115430,chr19,32115385,32115430,H1|chr19:54461761-54461866,chr19,54461761,54461866,0,22346376
H1|chr19:32145339-32145361,chr19,32145339,32145361,H1|chr19:47556032-47556099,chr19,47556032,47556099,0,15410693
H1|chr19:32228493-32228613,chr19,32228493,32228613,H1|chr19:58691781-58691811,chr19,58691781,58691811,0,26463288
H1|chr19:32360123-32360186,chr19,32360123,32360186,H1|chr19:792491-792542,chr19,792491,792542,0,31567632
H1|chr19:32782562-32782588,chr19,32782562,32782588,H1|chr19:41699864-41699958,chr19,41699864,41699958,0,8917302
H1|chr19:32925898-32926018,chr19,32925898,32926018,H1|chr19:47731059-47731135,chr19,47731059,47731135,0,14805161
H1|chr19:33084000-33084117,chr19,33084000,33084117,H1|chr19:58364529-58364563,chr19,58364529,58364563,0,25280529
H1|chr19:33248822-33248927,chr19,33248822,33248927,H1|chr19:13947501-13947520,chr19,13947501,13947520,0,19301321
H1|chr19:33279414-33279448,chr19,33279414,33279448,H1|chr19:54954182-54954297,chr19,54954182,54954297,0,21674768
H1|chr19:33426260-33426293,chr19,33426260,33426293,H1|chr19:54954182-54954297,chr19,54954182,54954297,0,21527922
H1|chr19:33432292-33432315,chr19,33432292,33432315,H1|chr19:13947927-13948077,chr19,13947927,13948077,0,19484365
H1|chr19:33597936-33597976,chr19,33597936,33597976,H1|chr19:794041-794155,chr19,794041,794155,0,32803895
H1|chr19:34249988-34250039,chr19,34249988,34250039,H1|chr19:54461761-54461866,chr19,54461761,54461866,0,20211773
H1|chr19:34531696-34531756,chr19,34531696,34531756,H1|chr19:13947485-13947520,chr19,13947485,13947520,0,20584211
H1|chr19:34542080-34542129,chr19,34542080,34542129,H1|chr19:39465315-39465416,chr19,39465315,39465416,0,4923235
H1|chr19:34551800-34551882,chr19,34551800,34551882,H1|chr19:5823778-5823818,chr19,5823778,5823818,0,28728022
H1|chr19:34554181-34554226,chr19,34554181,34554226,H1|chr19:12889964-12890065,chr19,12889964,12890065,0,21664217
H1|chr19:34844821-34844881,chr19,34844821,34844881,H1|chr19:5823778-5823818,chr19,5823778,5823818,0,29021043
H1|chr19:34958499-34958535,chr19,34958499,34958535,H1|chr19:794041-794155,chr19,794041,794155,0,34164458
H1|chr19:35165925-35166009,chr19,35165925,35166009,H1|chr19:13947494-13947520,chr19,13947494,13947520,0,21218431
H1|chr19:35326638-35326719,chr19,35326638,35326719,H1|chr19:13947477-13947520,chr19,13947477,13947520,0,21379161
H1|chr19:35348672-35348712,chr19,35348672,35348712,H1|chr19:8673790-8673839,chr19,8673790,8673839,0,26674882
H1|chr19:36235712-36235746,chr19,36235712,36235746,H1|chr19:13947485-13947520,chr19,13947485,13947520,0,22288227
H1|chr19:36259450-36259466,chr19,36259450,36259466,H1|chr19:6735598-6735635,chr19,6735598,6735635,0,29523852
H1|chr19:36320438-36320480,chr19,36320438,36320480,H1|chr19:13947771-13947827,chr19,13947771,13947827,0,22372667
H1|chr19:36586526-36586619,chr19,36586526,36586619,H1|chr19:54953977-54954028,chr19,54953977,54954028,0,18367451
H1|chr19:36595233-36595299,chr19,36595233,36595299,H1|chr19:13947494-13947520,chr19,13947494,13947520,0,22647739
H1|chr19:36740427-36740495,chr19,36740427,36740495,H1|chr19:9694447-9694494,chr19,9694447,9694494,0,27045980
H1|chr19:36766359-36766425,chr19,36766359,36766425,H1|chr19:35487935-35487960,chr19,35487935,35487960,0,1278424
H1|chr19:36778709-36778731,chr19,36778709,36778731,H1|chr19:39466063-39466205,chr19,39466063,39466205,0,2687354
H1|chr19:37004878-37004915,chr19,37004878,37004915,H1|chr19:19244361-19244449,chr19,19244361,19244449,0,17760517
H1|chr19:37203867-37203976,chr19,37203867,37203976,H1|chr19:41698776-41698823,chr19,41698776,41698823,0,4494909
H1|chr19:37353751-37353866,chr19,37353751,37353866,H1|chr19:53074132-53074180,chr19,53074132,53074180,0,15720381
H1|chr19:37415957-37416027,chr19,37415957,37416027,H1|chr19:13947494-13947520,chr19,13947494,13947520,0,23468463
H1|chr19:37473855-37473918,chr19,37473855,37473918,H1|chr19:5823778-5823811,chr19,5823778,5823811,0,31650077
H1|chr19:38236324-38236408,chr19,38236324,38236408,H1|chr19:915340-915406,chr19,915340,915406,0,37320984
H1|chr19:38241486-38241564,chr19,38241486,38241564,H1|chr19:48110960-48111032,chr19,48110960,48111032,0,9869474
H1|chr19:38350981-38351077,chr19,38350981,38351077,H1|chr19:47287695-47287824,chr19,47287695,47287824,0,8936714
H1|chr19:38372894-38372946,chr19,38372894,38372946,H1|chr19:17971285-17971344,chr19,17971285,17971344,0,20401609
H1|chr19:38418935-38419045,chr19,38418935,38419045,H1|chr19:13947494-13947520,chr19,13947494,13947520,0,24471441
H1|chr19:39145398-39145489,chr19,39145398,39145489,H1|chr19:11709064-11709174,chr19,11709064,11709174,0,27436334
H1|chr19:39292849-39292905,chr19,39292849,39292905,H1|chr19:35480677-35480725,chr19,35480677,35480725,0,3812172
H1|chr19:39325852-39325930,chr19,39325852,39325930,H1|chr19:48110960-48111032,chr19,48110960,48111032,0,8785108
H1|chr19:39359412-39359492,chr19,39359412,39359492,H1|chr19:793245-793314,chr19,793245,793314,0,38566167
H1|chr19:39397359-39397414,chr19,39397359,39397414,H1|chr19:39519203-39519245,chr19,39519203,39519245,0,121844
H1|chr19:39423517-39423555,chr19,39423517,39423555,H1|chr19:799123-799245,chr19,799123,799245,0,38624394
H1|chr19:39616626-39616733,chr19,39616626,39616733,H1|chr19:13947501-13947520,chr19,13947501,13947520,0,25669125
H1|chr19:39993405-39993426,chr19,39993405,39993426,H1|chr19:47287695-47287824,chr19,47287695,47287824,0,7294290
H1|chr19:40248698-40248740,chr19,40248698,40248740,H1|chr19:13947771-13947827,chr19,13947771,13947827,0,26300927
H1|chr19:40262306-40262456,chr19,40262306,40262456,H1|chr19:35632825-35632858,chr19,35632825,35632858,0,4629481
H1|chr19:40273231-40273262,chr19,40273231,40273262,H1|chr19:45308543-45308572,chr19,45308543,45308572,0,5035312
H1|chr19:40535945-40536075,chr19,40535945,40536075,H1|chr19:3883757-3883777,chr19,3883757,3883777,0,36652188
H1|chr19:40632570-40632610,chr19,40632570,40632610,H1|chr19:794041-794155,chr19,794041,794155,0,39838529
H1|chr19:40722340-40722393,chr19,40722340,40722393,H1|chr19:54466205-54466326,chr19,54466205,54466326,0,13743865
H1|chr19:41560410-41560520,chr19,41560410,41560520,H1|chr19:13947494-13947520,chr19,13947494,13947520,0,27612916
H1|chr19:41663503-41663619,chr19,41663503,41663619,H1|chr19:38745945-38745979,chr19,38745945,38745979,0,2917558
H1|chr19:42217385-42217496,chr19,42217385,42217496,H1|chr19:3883757-3883777,chr19,3883757,3883777,0,38333628
H1|chr19:42263565-42263625,chr19,42263565,42263625,H1|chr19:52776718-52776741,chr19,52776718,52776741,0,10513153
H1|chr19:42572432-42572536,chr19,42572432,42572536,H1|chr19:48280642-48280688,chr19,48280642,48280688,0,5708210
H1|chr19:42716627-42716709,chr19,42716627,42716709,H1|chr19:5823778-5823818,chr19,5823778,5823818,0,36892849
H1|chr19:42770873-42770971,chr19,42770873,42770971,H1|chr19:14525440-14525471,chr19,14525440,14525471,0,28245433
H1|chr19:43318754-43318855,chr19,43318754,43318855,H1|chr19:13947494-13947520,chr19,13947494,13947520,0,29371260
H1|chr19:43331629-43331651,chr19,43331629,43331651,H1|chr19:13948226-13948353,chr19,13948226,13948353,0,29383403
H1|chr19:43859429-43859461,chr19,43859429,43859461,H1|chr19:47356004-47356074,chr19,47356004,47356074,0,3496575
H1|chr19:44077878-44077963,chr19,44077878,44077963,H1|chr19:13947477-13947520,chr19,13947477,13947520,0,30130401
H1|chr19:44127016-44127056,chr19,44127016,44127056,H1|chr19:11709064-11709174,chr19,11709064,11709174,0,32417952
H1|chr19:44319861-44319922,chr19,44319861,44319922,H1|chr19:35604250-35604293,chr19,35604250,35604293,0,8715611
H1|chr19:44419356-44419387,chr19,44419356,44419387,H1|chr19:35602502-35602608,chr19,35602502,35602608,0,8816854
H1|chr19:44547415-44547532,chr19,44547415,44547532,H1|chr19:58364529-58364563,chr19,58364529,58364563,0,13817114
H1|chr19:44661124-44661253,chr19,44661124,44661253,H1|chr19:3883757-3883777,chr19,3883757,3883777,0,40777367
H1|chr19:44916478-44916509,chr19,44916478,44916509,H1|chr19:35602502-35602608,chr19,35602502,35602608,0,9313976
H1|chr19:44916906-44916998,chr19,44916906,44916998,H1|chr19:47977739-47977792,chr19,47977739,47977792,0,3060833
H1|chr19:45160183-45160291,chr19,45160183,45160291,H1|chr19:792090-792207,chr19,792090,792207,0,44368093
H1|chr19:45345054-45345140,chr19,45345054,45345140,H1|chr19:13055820-13055960,chr19,13055820,13055960,0,32289234
H1|chr19:45347116-45347180,chr19,45347116,45347180,H1|chr19:35604250-35604300,chr19,35604250,35604300,0,9742866
H1|chr19:45463720-45463746,chr19,45463720,45463746,H1|chr19:41699864-41699958,chr19,41699864,41699958,0,3763856
H1|chr19:45726906-45726996,chr19,45726906,45726996,H1|chr19:58364529-58364589,chr19,58364529,58364589,0,12637623
H1|chr19:45729765-45729837,chr19,45729765,45729837,H1|chr19:54023349-54023406,chr19,54023349,54023406,0,8293584
H1|chr19:46307281-46307398,chr19,46307281,46307398,H1|chr19:35604250-35604310,chr19,35604250,35604310,0,10703031
H1|chr19:46438934-46438987,chr19,46438934,46438987,H1|chr19:13947497-13947520,chr19,13947497,13947520,0,32491437
H1|chr19:46737358-46737377,chr19,46737358,46737377,H1|chr19:54464952-54465058,chr19,54464952,54465058,0,7727594
H1|chr19:46758878-46758976,chr19,46758878,46758976,H1|chr19:13947494-13947520,chr19,13947494,13947520,0,32811384
H1|chr19:46922580-46922603,chr19,46922580,46922603,H1|chr19:13947927-13948077,chr19,13947927,13948077,0,32974653
H1|chr19:46939426-46939486,chr19,46939426,46939486,H1|chr19:58364408-58364477,chr19,58364408,58364477,0,11424982
H1|chr19:47485823-47485845,chr19,47485823,47485845,H1|chr19:792491-792542,chr19,792491,792542,0,46693332
H1|chr19:47504906-47504966,chr19,47504906,47504966,H1|chr19:1411058-1411150,chr19,1411058,1411150,0,46093848
H1|chr19:47505264-47505348,chr19,47505264,47505348,H1|chr19:13947494-13947520,chr19,13947494,13947520,0,33557770
H1|chr19:47628681-47628717,chr19,47628681,47628717,H1|chr19:54462820-54462900,chr19,54462820,54462900,0,6834139
H1|chr19:47759995-47760087,chr19,47759995,47760087,H1|chr19:58364529-58364563,chr19,58364529,58364563,0,10604534
H1|chr19:48122247-48122362,chr19,48122247,48122362,H1|chr19:53074132-53074180,chr19,53074132,53074180,0,4951885
H1|chr19:48138674-48138727,chr19,48138674,48138727,H1|chr19:638203-638278,chr19,638203,638278,0,47500471
H1|chr19:48269923-48270070,chr19,48269923,48270070,H1|chr19:3972191-3972292,chr19,3972191,3972292,0,44297732
H1|chr19:48309676-48309793,chr19,48309676,48309793,H1|chr19:35632825-35632858,chr19,35632825,35632858,0,12676851
H1|chr19:48559573-48559618,chr19,48559573,48559618,H1|chr19:59057611-59057671,chr19,59057611,59057671,0,10498038
H1|chr19:48574136-48574248,chr19,48574136,48574248,H1|chr19:13947486-13947520,chr19,13947486,13947520,0,34626650
H1|chr19:48671941-48672032,chr19,48671941,48672032,H1|chr19:11709064-11709174,chr19,11709064,11709174,0,36962877
H1|chr19:48698071-48698208,chr19,48698071,48698208,H1|chr19:1408901-1408981,chr19,1408901,1408981,0,47289170
H1|chr19:48820818-48820900,chr19,48820818,48820900,H1|chr19:52407983-52408041,chr19,52407983,52408041,0,3587165
H1|chr19:48873601-48873697,chr19,48873601,48873697,H1|chr19:5823775-5823829,chr19,5823775,5823829,0,43049826
H1|chr19:49138439-49138510,chr19,49138439,49138510,H1|chr19:36000664-36000702,chr19,36000664,36000702,0,13137775
H1|chr19:49146213-49146265,chr19,49146213,49146265,H1|chr19:17971285-17971344,chr19,17971285,17971344,0,31174928
H1|chr19:49213917-49213969,chr19,49213917,49213969,H1|chr19:631016-631157,chr19,631016,631157,0,48582901
H1|chr19:49365173-49365238,chr19,49365173,49365238,H1|chr19:48250685-48250749,chr19,48250685,48250749,0,1114488
H1|chr19:49365366-49365436,chr19,49365366,49365436,H1|chr19:13947494-13947520,chr19,13947494,13947520,0,35417872
H1|chr19:49384858-49384958,chr19,49384858,49384958,H1|chr19:49257162-49257286,chr19,49257162,49257286,0,127696
H1|chr19:49710315-49710431,chr19,49710315,49710431,H1|chr19:39465315-39465416,chr19,39465315,39465416,0,10245000
H1|chr19:49845891-49845994,chr19,49845891,49845994,H1|chr19:58364529-58364589,chr19,58364529,58364589,0,8518638
H1|chr19:50106006-50106076,chr19,50106006,50106076,H1|chr19:9694447-9694494,chr19,9694447,9694494,0,40411559
H1|chr19:50256001-50256110,chr19,50256001,50256110,H1|chr19:41698776-41698823,chr19,41698776,41698823,0,8557225
H1|chr19:50280490-50280605,chr19,50280490,50280605,H1|chr19:45308543-45308577,chr19,45308543,45308577,0,4971947
H1|chr19:50299284-50299300,chr19,50299284,50299300,H1|chr19:6735598-6735635,chr19,6735598,6735635,0,43563686
H1|chr19:50540538-50540576,chr19,50540538,50540576,H1|chr19:19244361-19244449,chr19,19244361,19244449,0,31296177
H1|chr19:50579297-50579342,chr19,50579297,50579342,H1|chr19:12889964-12890065,chr19,12889964,12890065,0,37689333
H1|chr19:50963345-50963433,chr19,50963345,50963433,H1|chr19:13055820-13055960,chr19,13055820,13055960,0,37907525
H1|chr19:51867913-51868033,chr19,51867913,51868033,H1|chr19:47731059-47731135,chr19,47731059,47731135,0,4136854
H1|chr19:52175248-52175280,chr19,52175248,52175280,H1|chr19:45308543-45308577,chr19,45308543,45308577,0,6866705
H1|chr19:52387013-52387103,chr19,52387013,52387103,H1|chr19:58364529-58364589,chr19,58364529,58364589,0,5977516
H1|chr19:52970910-52971006,chr19,52970910,52971006,H1|chr19:5823775-5823829,chr19,5823775,5823829,0,47147135
H1|chr19:52971815-52971907,chr19,52971815,52971907,H1|chr19:58364529-58364563,chr19,58364529,58364563,0,5392714
H1|chr19:52991115-52991174,chr19,52991115,52991174,H1|chr19:48280396-48280443,chr19,48280396,48280443,0,4710719
H1|chr19:53092024-53092088,chr19,53092024,53092088,H1|chr19:35604250-35604300,chr19,35604250,35604300,0,17487774
H1|chr19:53425259-53425320,chr19,53425259,53425320,H1|chr19:35604250-35604293,chr19,35604250,35604293,0,17821009
H1|chr19:53459005-53459049,chr19,53459005,53459049,H1|chr19:39139001-39139071,chr19,39139001,39139071,0,14320004
H1|chr19:53460428-53460493,chr19,53460428,53460493,H1|chr19:47733116-47733178,chr19,47733116,47733178,0,5727312
H1|chr19:53535446-53535472,chr19,53535446,53535472,H1|chr19:47976008-47976029,chr19,47976008,47976029,0,5559438
H1|chr19:53576430-53576539,chr19,53576430,53576539,H1|chr19:12889964-12890065,chr19,12889964,12890065,0,40686466
H1|chr19:53781225-53781267,chr19,53781225,53781267,H1|chr19:8213536-8213644,chr19,8213536,8213644,0,45567689
H1|chr19:53918898-53918953,chr19,53918898,53918953,H1|chr19:1411058-1411150,chr19,1411058,1411150,0,52507840
H1|chr19:54366862-54366934,chr19,54366862,54366934,H1|chr19:17529407-17529464,chr19,17529407,17529464,0,36837455
H1|chr19:54816609-54816647,chr19,54816609,54816647,H1|chr19:799123-799245,chr19,799123,799245,0,54017486
H1|chr19:54945164-54945251,chr19,54945164,54945251,H1|chr19:14527403-14527461,chr19,14527403,14527461,0,40417761
H1|chr19:55044029-55044149,chr19,55044029,55044149,H1|chr19:35602543-35602590,chr19,35602543,35602590,0,19441486
H1|chr19:55049212-55049260,chr19,55049212,55049260,H1|chr19:3969266-3969302,chr19,3969266,3969302,0,51079946
H1|chr19:55201491-55201551,chr19,55201491,55201551,H1|chr19:1411058-1411150,chr19,1411058,1411150,0,53790433
H1|chr19:55263693-55263796,chr19,55263693,55263796,H1|chr19:58364529-58364589,chr19,58364529,58364589,0,3100836
H1|chr19:55380292-55380366,chr19,55380292,55380366,H1|chr19:14530892-14530941,chr19,14530892,14530941,0,40849400
H1|chr19:55581866-55581950,chr19,55581866,55581950,H1|chr19:41698776-41698823,chr19,41698776,41698823,0,13883090
H1|chr19:55723251-55723301,chr19,55723251,55723301,H1|chr19:14603192-14603261,chr19,14603192,14603261,0,41120059
H1|chr19:55876008-55876055,chr19,55876008,55876055,H1|chr19:13947486-13947520,chr19,13947486,13947520,0,41928522
H1|chr19:56046417-56046480,chr19,56046417,56046480,H1|chr19:792491-792542,chr19,792491,792542,0,55253926
H1|chr19:56098451-56098526,chr19,56098451,56098526,H1|chr19:13947492-13947520,chr19,13947492,13947520,0,42150959
H1|chr19:56164562-56164599,chr19,56164562,56164599,H1|chr19:13948226-13948353,chr19,13948226,13948353,0,42216336
H1|chr19:56265330-56265372,chr19,56265330,56265372,H1|chr19:2947941-2948016,chr19,2947941,2948016,0,53317389
H1|chr19:56306646-56306686,chr19,56306646,56306686,H1|chr19:8673790-8673839,chr19,8673790,8673839,0,47632856
H1|chr19:56324516-56324607,chr19,56324516,56324607,H1|chr19:46392810-46392869,chr19,46392810,46392869,0,9931706
H1|chr19:56365583-56365634,chr19,56365583,56365634,H1|chr19:54461761-54461866,chr19,54461761,54461866,0,1903822
H1|chr19:56402487-56402593,chr19,56402487,56402593,H1|chr19:8455832-8455939,chr19,8455832,8455939,0,47946655
H1|chr19:56695358-56695402,chr19,56695358,56695402,H1|chr19:630986-631069,chr19,630986,631069,0,56064372
H1|chr19:56736501-56736532,chr19,56736501,56736532,H1|chr19:45308543-45308572,chr19,45308543,45308572,0,11427958
H1|chr19:56941847-56941966,chr19,56941847,56941966,H1|chr19:13947493-13947520,chr19,13947493,13947520,0,42994354
H1|chr19:56970835-56970901,chr19,56970835,56970901,H1|chr19:35487935-35487960,chr19,35487935,35487960,0,21482900
H1|chr19:57125190-57125275,chr19,57125190,57125275,H1|chr19:13947477-13947520,chr19,13947477,13947520,0,43177713
H1|chr19:57300850-57300903,chr19,57300850,57300903,H1|chr19:638203-638278,chr19,638203,638278,0,56662647
H1|chr19:57323684-57323705,chr19,57323684,57323705,H1|chr19:49257162-49257286,chr19,49257162,49257286,0,8066522
H1|chr19:57346145-57346190,chr19,57346145,57346190,H1|chr19:59057611-59057671,chr19,59057611,59057671,0,1711466
H1|chr19:57439286-57439346,chr19,57439286,57439346,H1|chr19:5823778-5823818,chr19,5823778,5823818,0,51615508
H1|chr19:57494273-57494351,chr19,57494273,57494351,H1|chr19:47287553-47287625,chr19,47287553,47287625,0,10206720
H1|chr19:57828093-57828207,chr19,57828093,57828207,H1|chr19:13947496-13947520,chr19,13947496,13947520,0,43880597
H1|chr19:57895636-57895737,chr19,57895636,57895737,H1|chr19:13947494-13947520,chr19,13947494,13947520,0,43948142
H1|chr19:58033540-58033585,chr19,58033540,58033585,H1|chr19:37160075-37160210,chr19,37160075,37160210,0,20873465
H1|chr19:58266776-58266834,chr19,58266776,58266834,H1|chr19:3883318-3883384,chr19,3883318,3883384,0,54383458
H1|chr19:58398791-58398853,chr19,58398791,58398853,H1|chr19:52776718-52776741,chr19,52776718,52776741,0,5622073
H1|chr19:58416066-58416150,chr19,58416066,58416150,H1|chr19:915340-915406,chr19,915340,915406,0,57500726
H1|chr19:58560085-58560215,chr19,58560085,58560215,H1|chr19:3883757-3883777,chr19,3883757,3883777,0,54676328
H1|chr19:58733052-58733073,chr19,58733052,58733073,H1|chr19:47287695-47287824,chr19,47287695,47287824,0,11445357
H1|chr19:58783721-58783860,chr19,58783721,58783860,H1|chr19:58691781-58691810,chr19,58691781,58691810,0,91940
H1|chr19:58848443-58848496,chr19,58848443,58848496,H1|chr19:39519203-39519245,chr19,39519203,39519245,0,19329240
H1|chr19:59024701-59024745,chr19,59024701,59024745,H1|chr19:59057611-59057672,chr19,59057611,59057672,0,32910
H1|chr20:137099-137167,chr20,137099,137167,H1|chr20:31279402-31279456,chr20,31279402,31279456,0,31142303
H1|chr20:138162-138225,chr20,138162,138225,H1|chr20:45989170-45989225,chr20,45989170,45989225,0,45851008
H1|chr20:268967-269002,chr20,268967,269002,H1|chr20:60960494-60960574,chr20,60960494,60960574,0,60691527
H1|chr20:420485-420577,chr20,420485,420577,H1|chr20:47896589-47896669,chr20,47896589,47896669,0,47476104
H1|chr20:451396-451502,chr20,451396,451502,H1|chr20:31280002-31280042,chr20,31280002,31280042,0,30828606
H1|chr20:532258-532317,chr20,532258,532317,H1|chr20:30194356-30194413,chr20,30194356,30194413,0,29662098
H1|chr20:605219-605287,chr20,605219,605287,H1|chr20:31352640-31352669,chr20,31352640,31352669,0,30747421
H1|chr20:761468-761541,chr20,761468,761541,H1|chr20:45988564-45988638,chr20,45988564,45988638,0,45227096
H1|chr20:938171-938261,chr20,938171,938261,H1|chr20:47899471-47899549,chr20,47899471,47899549,0,46961300
H1|chr20:976752-976816,chr20,976752,976816,H1|chr20:31352694-31352717,chr20,31352694,31352717,0,30375942
H1|chr20:1205737-1205776,chr20,1205737,1205776,H1|chr20:47896578-47896667,chr20,47896578,47896667,0,46690841
H1|chr20:1430629-1430707,chr20,1430629,1430707,H1|chr20:31281983-31282052,chr20,31281983,31282052,0,29851354
H1|chr20:2440490-2440603,chr20,2440490,2440603,H1|chr20:45989751-45989787,chr20,45989751,45989787,0,43549261
H1|chr20:2520511-2520600,chr20,2520511,2520600,H1|chr20:17943731-17943792,chr20,17943731,17943792,0,15423220
H1|chr20:2786234-2786307,chr20,2786234,2786307,H1|chr20:31331072-31331128,chr20,31331072,31331128,0,28544838
H1|chr20:2887040-2887097,chr20,2887040,2887097,H1|chr20:5105229-5105316,chr20,5105229,5105316,0,2218189
H1|chr20:3071424-3071480,chr20,3071424,3071480,H1|chr20:5105222-5105316,chr20,5105222,5105316,0,2033798
H1|chr20:3411389-3411508,chr20,3411389,3411508,H1|chr20:31280778-31280809,chr20,31280778,31280809,0,27869389
H1|chr20:3491235-3491268,chr20,3491235,3491268,H1|chr20:31283623-31283764,chr20,31283623,31283764,0,27792388
H1|chr20:3524540-3524674,chr20,3524540,3524674,H1|chr20:31353347-31353375,chr20,31353347,31353375,0,27828807
H1|chr20:3612971-3613060,chr20,3612971,3613060,H1|chr20:17943731-17943792,chr20,17943731,17943792,0,14330760
H1|chr20:3670951-3671028,chr20,3670951,3671028,H1|chr20:36149215-36149235,chr20,36149215,36149235,0,32478264
H1|chr20:3761776-3761826,chr20,3761776,3761826,H1|chr20:31279693-31279793,chr20,31279693,31279793,0,27517917
H1|chr20:3795480-3795510,chr20,3795480,3795510,H1|chr20:57467838-57467927,chr20,57467838,57467927,0,53672358
H1|chr20:3887892-3887995,chr20,3887892,3887995,H1|chr20:45944173-45944207,chr20,45944173,45944207,0,42056281
H1|chr20:4078171-4078243,chr20,4078171,4078243,H1|chr20:31353784-31353862,chr20,31353784,31353862,0,27275613
H1|chr20:4305602-4305641,chr20,4305602,4305641,H1|chr20:30308348-30308448,chr20,30308348,30308448,0,26002746
H1|chr20:4446258-4446288,chr20,4446258,4446288,H1|chr20:60961365-60961449,chr20,60961365,60961449,0,56515107
H1|chr20:4659397-4659479,chr20,4659397,4659479,H1|chr20:60959040-60959096,chr20,60959040,60959096,0,56299643
H1|chr20:4765290-4765340,chr20,4765290,4765340,H1|chr20:31279693-31279793,chr20,31279693,31279793,0,26514403
H1|chr20:5167025-5167065,chr20,5167025,5167065,H1|chr20:31281035-31281111,chr20,31281035,31281111,0,26114010
H1|chr20:5303086-5303143,chr20,5303086,5303143,H1|chr20:31281492-31281555,chr20,31281492,31281555,0,25978406
H1|chr20:5464448-5464593,chr20,5464448,5464593,H1|chr20:45987198-45987347,chr20,45987198,45987347,0,40522750
H1|chr20:5620276-5620376,chr20,5620276,5620376,H1|chr20:60960937-60961021,chr20,60960937,60961021,0,55340661
H1|chr20:5634920-5635041,chr20,5634920,5635041,H1|chr20:45987564-45987587,chr20,45987564,45987587,0,40352644
H1|chr20:5794572-5794625,chr20,5794572,5794625,H1|chr20:62495319-62495412,chr20,62495319,62495412,0,56700747
H1|chr20:6164378-6164452,chr20,6164378,6164452,H1|chr20:47898786-47898831,chr20,47898786,47898831,0,41734408
H1|chr20:6187725-6187781,chr20,6187725,6187781,H1|chr20:45946752-45946842,chr20,45946752,45946842,0,39759027
H1|chr20:6310726-6310835,chr20,6310726,6310835,H1|chr20:57424403-57424444,chr20,57424403,57424444,0,51113677
H1|chr20:6314497-6314563,chr20,6314497,6314563,H1|chr20:60960937-60961021,chr20,60960937,60961021,0,54646440
H1|chr20:6381362-6381417,chr20,6381362,6381417,H1|chr20:31402869-31402971,chr20,31402869,31402971,0,25021507
H1|chr20:6787018-6787064,chr20,6787018,6787064,H1|chr20:45985534-45985633,chr20,45985534,45985633,0,39198516
H1|chr20:6801304-6801348,chr20,6801304,6801348,H1|chr20:57424403-57424444,chr20,57424403,57424444,0,50623099
H1|chr20:6805466-6805525,chr20,6805466,6805525,H1|chr20:45987472-45987522,chr20,45987472,45987522,0,39182006
H1|chr20:6885527-6885612,chr20,6885527,6885612,H1|chr20:47898669-47898732,chr20,47898669,47898732,0,41013142
H1|chr20:7023689-7023749,chr20,7023689,7023749,H1|chr20:47897826-47897916,chr20,47897826,47897916,0,40874137
H1|chr20:7196609-7196628,chr20,7196609,7196628,H1|chr20:31280791-31280921,chr20,31280791,31280921,0,24084182
H1|chr20:7447077-7447122,chr20,7447077,7447122,H1|chr20:45990051-45990144,chr20,45990051,45990144,0,38542974
H1|chr20:7456141-7456159,chr20,7456141,7456159,H1|chr20:47896487-47896635,chr20,47896487,47896635,0,40440346
H1|chr20:7508886-7508939,chr20,7508886,7508939,H1|chr20:45985989-45986083,chr20,45985989,45986083,0,38477103
H1|chr20:7509172-7509196,chr20,7509172,7509196,H1|chr20:30190225-30190372,chr20,30190225,30190372,0,22681053
H1|chr20:7532702-7532804,chr20,7532702,7532804,H1|chr20:17943731-17943792,chr20,17943731,17943792,0,10411029
H1|chr20:7549506-7549649,chr20,7549506,7549649,H1|chr20:31353784-31353862,chr20,31353784,31353862,0,23804278
H1|chr20:7624306-7624364,chr20,7624306,7624364,H1|chr20:45989321-45989397,chr20,45989321,45989397,0,38365015
H1|chr20:7763592-7763628,chr20,7763592,7763628,H1|chr20:45989967-45990021,chr20,45989967,45990021,0,38226375
H1|chr20:7782562-7782634,chr20,7782562,7782634,H1|chr20:47898666-47898744,chr20,47898666,47898744,0,40116104
H1|chr20:7852469-7852564,chr20,7852469,7852564,H1|chr20:31403948-31403977,chr20,31403948,31403977,0,23551479
H1|chr20:8033521-8033619,chr20,8033521,8033619,H1|chr20:45985989-45986083,chr20,45985989,45986083,0,37952468
H1|chr20:8402140-8402257,chr20,8402140,8402257,H1|chr20:31281912-31281945,chr20,31281912,31281945,0,22879772
H1|chr20:8581808-8581860,chr20,8581808,8581860,H1|chr20:62495361-62495413,chr20,62495361,62495413,0,53913553
H1|chr20:8589163-8589243,chr20,8589163,8589243,H1|chr20:30189262-30189329,chr20,30189262,30189329,0,21600099
H1|chr20:9075798-9075879,chr20,9075798,9075879,H1|chr20:31279735-31279820,chr20,31279735,31279820,0,22203937
H1|chr20:9386279-9386309,chr20,9386279,9386309,H1|chr20:36150169-36150286,chr20,36150169,36150286,0,26763890
H1|chr20:9497469-9497588,chr20,9497469,9497588,H1|chr20:45990446-45990521,chr20,45990446,45990521,0,36492977
H1|chr20:9629639-9629721,chr20,9629639,9629721,H1|chr20:60959040-60959096,chr20,60959040,60959096,0,51329401
H1|chr20:9686330-9686398,chr20,9686330,9686398,H1|chr20:47899212-47899294,chr20,47899212,47899294,0,38212882
H1|chr20:9942208-9942312,chr20,9942208,9942312,H1|chr20:45987373-45987416,chr20,45987373,45987416,0,36045165
H1|chr20:10072085-10072156,chr20,10072085,10072156,H1|chr20:45988564-45988638,chr20,45988564,45988638,0,35916479
H1|chr20:10113015-10113068,chr20,10113015,10113068,H1|chr20:62495319-62495412,chr20,62495319,62495412,0,52382304
H1|chr20:10125579-10125653,chr20,10125579,10125653,H1|chr20:30192352-30192386,chr20,30192352,30192386,0,20066773
H1|chr20:10347202-10347301,chr20,10347202,10347301,H1|chr20:45989610-45989632,chr20,45989610,45989632,0,35642408
H1|chr20:10380132-10380249,chr20,10380132,10380249,H1|chr20:47899212-47899294,chr20,47899212,47899294,0,37519080
H1|chr20:10393706-10393795,chr20,10393706,10393795,H1|chr20:40244654-40244715,chr20,40244654,40244715,0,29850948
H1|chr20:10514221-10514279,chr20,10514221,10514279,H1|chr20:60958997-60959062,chr20,60958997,60959062,0,50444776
H1|chr20:10536683-10536774,chr20,10536683,10536774,H1|chr20:33101442-33101496,chr20,33101442,33101496,0,22564759
H1|chr20:10657282-10657363,chr20,10657282,10657363,H1|chr20:31279735-31279820,chr20,31279735,31279820,0,20622453
H1|chr20:10721067-10721209,chr20,10721067,10721209,H1|chr20:31281912-31281945,chr20,31281912,31281945,0,20560845
H1|chr20:10915997-10916016,chr20,10915997,10916016,H1|chr20:40245812-40245882,chr20,40245812,40245882,0,29329815
H1|chr20:10961160-10961291,chr20,10961160,10961291,H1|chr20:45988447-45988466,chr20,45988447,45988466,0,35027287
H1|chr20:11057136-11057184,chr20,11057136,11057184,H1|chr20:31402869-31402971,chr20,31402869,31402971,0,20345733
H1|chr20:11112753-11112794,chr20,11112753,11112794,H1|chr20:47896408-47896481,chr20,47896408,47896481,0,36783655
H1|chr20:11166796-11166852,chr20,11166796,11166852,H1|chr20:47897079-47897174,chr20,47897079,47897174,0,36730283
H1|chr20:11179461-11179515,chr20,11179461,11179515,H1|chr20:31282587-31282704,chr20,31282587,31282704,0,20103126
H1|chr20:11558371-11558412,chr20,11558371,11558412,H1|chr20:45988352-45988468,chr20,45988352,45988468,0,34429981
H1|chr20:11570760-11570905,chr20,11570760,11570905,H1|chr20:45987198-45987347,chr20,45987198,45987347,0,34416438
H1|chr20:11693565-11693715,chr20,11693565,11693715,H1|chr20:31281277-31281427,chr20,31281277,31281427,0,19587712
H1|chr20:11703327-11703372,chr20,11703327,11703372,H1|chr20:45990051-45990144,chr20,45990051,45990144,0,34286724
H1|chr20:11725376-11725447,chr20,11725376,11725447,H1|chr20:47899471-47899549,chr20,47899471,47899549,0,36174095
H1|chr20:11907537-11907555,chr20,11907537,11907555,H1|chr20:40245812-40245882,chr20,40245812,40245882,0,28338275
H1|chr20:11907911-11907938,chr20,11907911,11907938,H1|chr20:47900117-47900240,chr20,47900117,47900240,0,35992206
H1|chr20:11953687-11953790,chr20,11953687,11953790,H1|chr20:45944173-45944207,chr20,45944173,45944207,0,33990486
H1|chr20:12174413-12174483,chr20,12174413,12174483,H1|chr20:31334986-31335136,chr20,31334986,31335136,0,19160573
H1|chr20:12341791-12341885,chr20,12341791,12341885,H1|chr20:31333409-31333492,chr20,31333409,31333492,0,18991618
H1|chr20:12583289-12583348,chr20,12583289,12583348,H1|chr20:45985523-45985633,chr20,45985523,45985633,0,33402234
H1|chr20:12666225-12666274,chr20,12666225,12666274,H1|chr20:17946554-17946621,chr20,17946554,17946621,0,5280329
H1|chr20:12808855-12808931,chr20,12808855,12808931,H1|chr20:31280001-31280033,chr20,31280001,31280033,0,18471146
H1|chr20:12864434-12864468,chr20,12864434,12864468,H1|chr20:47897071-47897184,chr20,47897071,47897184,0,35032637
H1|chr20:13042109-13042209,chr20,13042109,13042209,H1|chr20:523391-523424,chr20,523391,523424,0,12518718
H1|chr20:13057230-13057285,chr20,13057230,13057285,H1|chr20:31402869-31402971,chr20,31402869,31402971,0,18345639
H1|chr20:13064076-13064117,chr20,13064076,13064117,H1|chr20:31281035-31281111,chr20,31281035,31281111,0,18216959
H1|chr20:13069093-13069135,chr20,13069093,13069135,H1|chr20:30191477-30191546,chr20,30191477,30191546,0,17122384
H1|chr20:13393990-13394044,chr20,13393990,13394044,H1|chr20:31280723-31280813,chr20,31280723,31280813,0,17886733
H1|chr20:13405245-13405269,chr20,13405245,13405269,H1|chr20:62489934-62490058,chr20,62489934,62490058,0,49084689
H1|chr20:13467855-13467893,chr20,13467855,13467893,H1|chr20:30188891-30188922,chr20,30188891,30188922,0,16721036
H1|chr20:13533497-13533568,chr20,13533497,13533568,H1|chr20:47896807-47896886,chr20,47896807,47896886,0,34363310
H1|chr20:13570289-13570388,chr20,13570289,13570388,H1|chr20:45985783-45985831,chr20,45985783,45985831,0,32415494
H1|chr20:13574955-13575047,chr20,13574955,13575047,H1|chr20:47896589-47896669,chr20,47896589,47896669,0,34321634
H1|chr20:13846164-13846189,chr20,13846164,13846189,H1|chr20:31280301-31280423,chr20,31280301,31280423,0,17434137
H1|chr20:13881812-13881930,chr20,13881812,13881930,H1|chr20:42294708-42294792,chr20,42294708,42294792,0,28412896
H1|chr20:14195071-14195156,chr20,14195071,14195156,H1|chr20:45986428-45986489,chr20,45986428,45986489,0,31791357
H1|chr20:14333234-14333302,chr20,14333234,14333302,H1|chr20:45989906-45989983,chr20,45989906,45989983,0,31656672
H1|chr20:14558128-14558271,chr20,14558128,14558271,H1|chr20:31353784-31353862,chr20,31353784,31353862,0,16795656
H1|chr20:14644438-14644484,chr20,14644438,14644484,H1|chr20:45990185-45990261,chr20,45990185,45990261,0,31345747
H1|chr20:14680066-14680194,chr20,14680066,14680194,H1|chr20:31280778-31280809,chr20,31280778,31280809,0,16600712
H1|chr20:14713379-14713408,chr20,14713379,14713408,H1|chr20:57467838-57467927,chr20,57467838,57467927,0,42754459
H1|chr20:14739474-14739498,chr20,14739474,14739498,H1|chr20:30190225-30190372,chr20,30190225,30190372,0,15450751
H1|chr20:14740774-14740795,chr20,14740774,14740795,H1|chr20:47898195-47898340,chr20,47898195,47898340,0,33157421
H1|chr20:14939828-14939887,chr20,14939828,14939887,H1|chr20:45989321-45989397,chr20,45989321,45989397,0,31049493
H1|chr20:15269049-15269116,chr20,15269049,15269116,H1|chr20:31333409-31333492,chr20,31333409,31333492,0,16064360
H1|chr20:15476207-15476247,chr20,15476207,15476247,H1|chr20:45985523-45985633,chr20,45985523,45985633,0,30509316
H1|chr20:15627379-15627411,chr20,15627379,15627411,H1|chr20:47898769-47898853,chr20,47898769,47898853,0,32271390
H1|chr20:15795133-15795170,chr20,15795133,15795170,H1|chr20:31336180-31336267,chr20,31336180,31336267,0,15541047
H1|chr20:15841603-15841680,chr20,15841603,15841680,H1|chr20:36149215-36149235,chr20,36149215,36149235,0,20307612
H1|chr20:15957473-15957615,chr20,15957473,15957615,H1|chr20:31281912-31281945,chr20,31281912,31281945,0,15324439
H1|chr20:15988468-15988531,chr20,15988468,15988531,H1|chr20:45989170-45989225,chr20,45989170,45989225,0,30000702
H1|chr20:16420243-16420383,chr20,16420243,16420383,H1|chr20:31280002-31280042,chr20,31280002,31280042,0,14859759
H1|chr20:16740955-16740973,chr20,16740955,16740973,H1|chr20:47896487-47896635,chr20,47896487,47896635,0,31155532
H1|chr20:16742141-16742188,chr20,16742141,16742188,H1|chr20:44988158-44988277,chr20,44988158,44988277,0,28246017
H1|chr20:16752112-16752154,chr20,16752112,16752154,H1|chr20:31330918-31330985,chr20,31330918,31330985,0,14578806
H1|chr20:16918045-16918069,chr20,16918045,16918069,H1|chr20:57430349-57430435,chr20,57430349,57430435,0,40512304
H1|chr20:16947597-16947688,chr20,16947597,16947688,H1|chr20:33101442-33101496,chr20,33101442,33101496,0,16153845
H1|chr20:17056451-17056498,chr20,17056451,17056498,H1|chr20:45990185-45990261,chr20,45990185,45990261,0,28933734
H1|chr20:17082444-17082463,chr20,17082444,17082463,H1|chr20:45989837-45989939,chr20,45989837,45989939,0,28907393
H1|chr20:17296079-17296110,chr20,17296079,17296110,H1|chr20:44988158-44988277,chr20,44988158,44988277,0,27692079
H1|chr20:17460054-17460083,chr20,17460054,17460083,H1|chr20:32078490-32078555,chr20,32078490,32078555,0,14618436
H1|chr20:17872868-17872943,chr20,17872868,17872943,H1|chr20:45990446-45990521,chr20,45990446,45990521,0,28117578
H1|chr20:17892614-17892676,chr20,17892614,17892676,H1|chr20:31282616-31282710,chr20,31282616,31282710,0,13390002
H1|chr20:17905264-17905334,chr20,17905264,17905334,H1|chr20:30188821-30188901,chr20,30188821,30188901,0,12283557
H1|chr20:18093862-18093903,chr20,18093862,18093903,H1|chr20:47896408-47896481,chr20,47896408,47896481,0,29802546
H1|chr20:18343485-18343514,chr20,18343485,18343514,H1|chr20:57467838-57467927,chr20,57467838,57467927,0,39124353
H1|chr20:18440401-18440523,chr20,18440401,18440523,H1|chr20:31353347-31353375,chr20,31353347,31353375,0,12912946
H1|chr20:18588516-18588636,chr20,18588516,18588636,H1|chr20:30551123-30551149,chr20,30551123,30551149,0,11962607
H1|chr20:18596720-18596790,chr20,18596720,18596790,H1|chr20:31334986-31335136,chr20,31334986,31335136,0,12738266
H1|chr20:18631046-18631065,chr20,18631046,18631065,H1|chr20:31280791-31280921,chr20,31280791,31280921,0,12649745
H1|chr20:18743090-18743157,chr20,18743090,18743157,H1|chr20:47896589-47896669,chr20,47896589,47896669,0,29153499
H1|chr20:18773444-18773525,chr20,18773444,18773525,H1|chr20:17951809-17951863,chr20,17951809,17951863,0,821635
H1|chr20:18850170-18850240,chr20,18850170,18850240,H1|chr20:31282371-31282451,chr20,31282371,31282451,0,12432201
H1|chr20:18863935-18863990,chr20,18863935,18863990,H1|chr20:47897079-47897174,chr20,47897079,47897174,0,29033144
H1|chr20:18952979-18953087,chr20,18952979,18953087,H1|chr20:31280306-31280385,chr20,31280306,31280385,0,12327327
H1|chr20:19172387-19172464,chr20,19172387,19172464,H1|chr20:47896107-47896171,chr20,47896107,47896171,0,28723720
H1|chr20:19175449-19175471,chr20,19175449,19175471,H1|chr20:31282654-31282771,chr20,31282654,31282771,0,12107205
H1|chr20:19643743-19643796,chr20,19643743,19643796,H1|chr20:47900102-47900179,chr20,47900102,47900179,0,28256359
H1|chr20:19675993-19676053,chr20,19675993,19676053,H1|chr20:30556587-30556641,chr20,30556587,30556641,0,10880594
H1|chr20:19725496-19725533,chr20,19725496,19725533,H1|chr20:31336180-31336267,chr20,31336180,31336267,0,11610684
H1|chr20:19807171-19807203,chr20,19807171,19807203,H1|chr20:31279553-31279642,chr20,31279553,31279642,0,11472382
H1|chr20:20179456-20179522,chr20,20179456,20179522,H1|chr20:60960937-60961021,chr20,60960937,60961021,0,40781481
H1|chr20:20182705-20182750,chr20,20182705,20182750,H1|chr20:47898619-47898724,chr20,47898619,47898724,0,27715914
H1|chr20:20315249-20315271,chr20,20315249,20315271,H1|chr20:31282654-31282771,chr20,31282654,31282771,0,10967405
H1|chr20:20358986-20359029,chr20,20358986,20359029,H1|chr20:31330918-31330985,chr20,31330918,31330985,0,10971932
H1|chr20:20430398-20430517,chr20,20430398,20430517,H1|chr20:31280778-31280809,chr20,31280778,31280809,0,10850380
H1|chr20:20436341-20436387,chr20,20436341,20436387,H1|chr20:31282631-31282735,chr20,31282631,31282735,0,10846290
H1|chr20:20462674-20462759,chr20,20462674,20462759,H1|chr20:47898669-47898732,chr20,47898669,47898732,0,27435995
H1|chr20:20572770-20572791,chr20,20572770,20572791,H1|chr20:36150169-36150286,chr20,36150169,36150286,0,15577399
H1|chr20:20833923-20833993,chr20,20833923,20833993,H1|chr20:30194404-30194478,chr20,30194404,30194478,0,9360481
H1|chr20:20904377-20904435,chr20,20904377,20904435,H1|chr20:30194373-30194414,chr20,30194373,30194414,0,9289996
H1|chr20:20922162-20922206,chr20,20922162,20922206,H1|chr20:47898653-47898735,chr20,47898653,47898735,0,26976491
H1|chr20:20936944-20937046,chr20,20936944,20937046,H1|chr20:45990071-45990125,chr20,45990071,45990125,0,25053127
H1|chr20:20991617-20991738,chr20,20991617,20991738,H1|chr20:45987564-45987587,chr20,45987564,45987587,0,24995947
H1|chr20:21355015-21355088,chr20,21355015,21355088,H1|chr20:31331072-31331128,chr20,31331072,31331128,0,9976057
H1|chr20:21429804-21429862,chr20,21429804,21429862,H1|chr20:31280444-31280502,chr20,31280444,31280502,0,9850640
H1|chr20:21441392-21441521,chr20,21441392,21441521,H1|chr20:60961630-60961651,chr20,60961630,60961651,0,39520238
H1|chr20:21467932-21468000,chr20,21467932,21468000,H1|chr20:31352640-31352669,chr20,31352640,31352669,0,9884708
H1|chr20:21623643-21623748,chr20,21623643,21623748,H1|chr20:45988644-45988689,chr20,45988644,45988689,0,24365001
H1|chr20:21665606-21665660,chr20,21665606,21665660,H1|chr20:17951809-17951866,chr20,17951809,17951866,0,3713797
H1|chr20:21737210-21737281,chr20,21737210,21737281,H1|chr20:31280306-31280385,chr20,31280306,31280385,0,9543096
H1|chr20:21811367-21811439,chr20,21811367,21811439,H1|chr20:44637955-44638021,chr20,44637955,44638021,0,22826588
H1|chr20:21833221-21833295,chr20,21833221,21833295,H1|chr20:31331072-31331128,chr20,31331072,31331128,0,9497851
H1|chr20:21999905-21999941,chr20,21999905,21999941,H1|chr20:31283623-31283764,chr20,31283623,31283764,0,9283718
H1|chr20:22017785-22017825,chr20,22017785,22017825,H1|chr20:31283623-31283764,chr20,31283623,31283764,0,9265838
H1|chr20:22239093-22239176,chr20,22239093,22239176,H1|chr20:47899574-47899640,chr20,47899574,47899640,0,25660481
H1|chr20:22586012-22586071,chr20,22586012,22586071,H1|chr20:45989442-45989524,chr20,45989442,45989524,0,23403430
H1|chr20:22658018-22658103,chr20,22658018,22658103,H1|chr20:45986428-45986489,chr20,45986428,45986489,0,23328410
H1|chr20:22669771-22669813,chr20,22669771,22669813,H1|chr20:30191477-30191546,chr20,30191477,30191546,0,7521706
H1|chr20:22877162-22877181,chr20,22877162,22877181,H1|chr20:40245812-40245882,chr20,40245812,40245882,0,17368650
H1|chr20:22991121-22991232,chr20,22991121,22991232,H1|chr20:523391-523424,chr20,523391,523424,0,22467730
H1|chr20:23059535-23059638,chr20,23059535,23059638,H1|chr20:47896059-47896177,chr20,47896059,47896177,0,24836524
H1|chr20:23227517-23227580,chr20,23227517,23227580,H1|chr20:30189427-30189575,chr20,30189427,30189575,0,6961910
H1|chr20:23453997-23454144,chr20,23453997,23454144,H1|chr20:30188821-30188901,chr20,30188821,30188901,0,6734824
H1|chr20:23581351-23581403,chr20,23581351,23581403,H1|chr20:62495361-62495413,chr20,62495361,62495413,0,38914010
H1|chr20:23762315-23762354,chr20,23762315,23762354,H1|chr20:47896408-47896481,chr20,47896408,47896481,0,24134093
H1|chr20:23867010-23867049,chr20,23867010,23867049,H1|chr20:30308348-30308448,chr20,30308348,30308448,0,6441338
H1|chr20:23965629-23965719,chr20,23965629,23965719,H1|chr20:47899471-47899549,chr20,47899471,47899549,0,23933842
H1|chr20:23971743-23971800,chr20,23971743,23971800,H1|chr20:31281492-31281555,chr20,31281492,31281555,0,7309749
H1|chr20:24019206-24019300,chr20,24019206,24019300,H1|chr20:30308410-30308440,chr20,30308410,30308440,0,6289204
H1|chr20:24076976-24077034,chr20,24076976,24077034,H1|chr20:60958997-60959062,chr20,60958997,60959062,0,36882021
H1|chr20:24287465-24287560,chr20,24287465,24287560,H1|chr20:47897903-47897954,chr20,47897903,47897954,0,23610438
H1|chr20:24334971-24335017,chr20,24334971,24335017,H1|chr20:45985534-45985633,chr20,45985534,45985633,0,21650563
H1|chr20:24620232-24620304,chr20,24620232,24620304,H1|chr20:47898666-47898744,chr20,47898666,47898744,0,23278434
H1|chr20:24631981-24632068,chr20,24631981,24632068,H1|chr20:45988653-45988712,chr20,45988653,45988712,0,21356672
H1|chr20:25027140-25027249,chr20,25027140,25027249,H1|chr20:57424403-57424444,chr20,57424403,57424444,0,32397263
H1|chr20:25031687-25031815,chr20,25031687,25031815,H1|chr20:47897903-47897954,chr20,47897903,47897954,0,22866216
H1|chr20:25034904-25034988,chr20,25034904,25034988,H1|chr20:45986428-45986489,chr20,45986428,45986489,0,20951524
H1|chr20:25076489-25076520,chr20,25076489,25076520,H1|chr20:47896604-47896741,chr20,47896604,47896741,0,22820115
H1|chr20:25105372-25105426,chr20,25105372,25105426,H1|chr20:17951809-17951866,chr20,17951809,17951866,0,7153563
H1|chr20:25471753-25471850,chr20,25471753,25471850,H1|chr20:57424403-57424444,chr20,57424403,57424444,0,31952650
H1|chr20:25490645-25490758,chr20,25490645,25490758,H1|chr20:45989751-45989787,chr20,45989751,45989787,0,20499106
H1|chr20:25513775-25513891,chr20,25513775,25513891,H1|chr20:60944818-60944847,chr20,60944818,60944847,0,35431043
H1|chr20:25575073-25575131,chr20,25575073,25575131,H1|chr20:31280444-31280502,chr20,31280444,31280502,0,5705371
H1|chr20:25618502-25618535,chr20,25618502,25618535,H1|chr20:31282659-31282762,chr20,31282659,31282762,0,5664157
H1|chr20:25717547-25717618,chr20,25717547,25717618,H1|chr20:31280306-31280385,chr20,31280306,31280385,0,5562759
H1|chr20:25735319-25735374,chr20,25735319,25735374,H1|chr20:30190851-30190943,chr20,30190851,30190943,0,4455532
H1|chr20:25859231-25859315,chr20,25859231,25859315,H1|chr20:33872883-33872914,chr20,33872883,33872914,0,8013652
H1|chr20:25859419-25859492,chr20,25859419,25859492,H1|chr20:47899892-47899987,chr20,47899892,47899987,0,22040473
H1|chr20:26352910-26352972,chr20,26352910,26352972,H1|chr20:45989170-45989225,chr20,45989170,45989225,0,19636260
H1|chr20:26718059-26718209,chr20,26718059,26718209,H1|chr20:31281277-31281427,chr20,31281277,31281427,0,4563218
H1|chr20:26964863-26964899,chr20,26964863,26964899,H1|chr20:45989967-45990021,chr20,45989967,45990021,0,19025104
H1|chr20:26966761-26966817,chr20,26966761,26966817,H1|chr20:5105222-5105316,chr20,5105222,5105316,0,21861539
H1|chr20:27073324-27073373,chr20,27073324,27073373,H1|chr20:32078618-32078700,chr20,32078618,32078700,0,5005294
H1|chr20:27265247-27265359,chr20,27265247,27265359,H1|chr20:45988320-45988350,chr20,45988320,45988350,0,18723073
H1|chr20:27303463-27303588,chr20,27303463,27303588,H1|chr20:45988965-45988990,chr20,45988965,45988990,0,18685502
H1|chr20:27310941-27311035,chr20,27310941,27311035,H1|chr20:30308410-30308440,chr20,30308410,30308440,0,2997469
H1|chr20:27328106-27328199,chr20,27328106,27328199,H1|chr20:45989884-45989919,chr20,45989884,45989919,0,18661778
H1|chr20:27502308-27502341,chr20,27502308,27502341,H1|chr20:31282587-31282704,chr20,31282587,31282704,0,3780279
H1|chr20:27686767-27686880,chr20,27686767,27686880,H1|chr20:60945421-60945553,chr20,60945421,60945553,0,33258654
H1|chr20:27721674-27721709,chr20,27721674,27721709,H1|chr20:30188854-30188925,chr20,30188854,30188925,0,2467180
H1|chr20:27731750-27731839,chr20,27731750,27731839,H1|chr20:57467855-57467883,chr20,57467855,57467883,0,29736105
H1|chr20:28015170-28015256,chr20,28015170,28015256,H1|chr20:57467643-57467666,chr20,57467643,57467666,0,29452473
H1|chr20:28184945-28185073,chr20,28184945,28185073,H1|chr20:31280778-31280809,chr20,31280778,31280809,0,3095833
H1|chr20:28399186-28399258,chr20,28399186,28399258,H1|chr20:44637955-44638021,chr20,44637955,44638021,0,16238769
H1|chr20:28404736-28404779,chr20,28404736,28404779,H1|chr20:31404643-31404793,chr20,31404643,31404793,0,2999907
H1|chr20:28693579-28693641,chr20,28693579,28693641,H1|chr20:45989442-45989524,chr20,45989442,45989524,0,17295863
H1|chr20:28882698-28882758,chr20,28882698,28882758,H1|chr20:30556587-30556641,chr20,30556587,30556641,0,1673889
H1|chr20:28908198-28908243,chr20,28908198,28908243,H1|chr20:45985534-45985633,chr20,45985534,45985633,0,17077336
H1|chr20:29160373-29160437,chr20,29160373,29160437,H1|chr20:30190570-30190633,chr20,30190570,30190633,0,1030197
H1|chr20:29466168-29466276,chr20,29466168,29466276,H1|chr20:45989433-45989453,chr20,45989433,45989453,0,16523265
H1|chr20:29583340-29583447,chr20,29583340,29583447,H1|chr20:45985783-45985831,chr20,45985783,45985831,0,16402443
H1|chr20:29653522-29653609,chr20,29653522,29653609,H1|chr20:45988653-45988712,chr20,45988653,45988712,0,16335131
H1|chr20:29697186-29697293,chr20,29697186,29697293,H1|chr20:45988252-45988281,chr20,45988252,45988281,0,16291066
H1|chr20:29944376-29944429,chr20,29944376,29944429,H1|chr20:45946752-45946842,chr20,45946752,45946842,0,16002376
H1|chr20:29969232-29969258,chr20,29969232,29969258,H1|chr20:62489934-62490058,chr20,62489934,62490058,0,32520702
H1|chr20:30004828-30004852,chr20,30004828,30004852,H1|chr20:57430349-57430435,chr20,57430349,57430435,0,27425521
H1|chr20:30302233-30302301,chr20,30302233,30302301,H1|chr20:31279402-31279456,chr20,31279402,31279456,0,977169
H1|chr20:30426553-30426620,chr20,30426553,30426620,H1|chr20:45989009-45989056,chr20,45989009,45989056,0,15562456
H1|chr20:30429445-30429567,chr20,30429445,30429567,H1|chr20:31353347-31353375,chr20,31353347,31353375,0,923902
H1|chr20:30523896-30524013,chr20,30523896,30524013,H1|chr20:45987564-45987587,chr20,45987564,45987587,0,15463668
H1|chr20:30766066-30766104,chr20,30766066,30766104,H1|chr20:30188891-30188922,chr20,30188891,30188922,0,577175
H1|chr20:30947373-30947441,chr20,30947373,30947441,H1|chr20:30194404-30194478,chr20,30194404,30194478,0,752969
H1|chr20:30967081-30967124,chr20,30967081,30967124,H1|chr20:31330918-31330985,chr20,31330918,31330985,0,363837
H1|chr20:31013336-31013406,chr20,31013336,31013406,H1|chr20:30192694-30192744,chr20,30192694,30192744,0,820642
H1|chr20:31059443-31059476,chr20,31059443,31059476,H1|chr20:31282659-31282762,chr20,31282659,31282762,0,223216
H1|chr20:31234931-31234989,chr20,31234931,31234989,H1|chr20:30194373-30194414,chr20,30194373,30194414,0,1040558
H1|chr20:31466964-31467035,chr20,31466964,31467035,H1|chr20:30192694-30192744,chr20,30192694,30192744,0,1274270
H1|chr20:31513057-31513177,chr20,31513057,31513177,H1|chr20:30551123-30551149,chr20,30551123,30551149,0,961934
H1|chr20:31691714-31691773,chr20,31691714,31691773,H1|chr20:30194356-30194413,chr20,30194356,30194413,0,1497358
H1|chr20:31728549-31728616,chr20,31728549,31728616,H1|chr20:47896589-47896669,chr20,47896589,47896669,0,16168040
H1|chr20:31841036-31841091,chr20,31841036,31841091,H1|chr20:5105222-5105316,chr20,5105222,5105316,0,26735814
H1|chr20:31846777-31846846,chr20,31846777,31846846,H1|chr20:31282371-31282451,chr20,31282371,31282451,0,564406
H1|chr20:32022613-32022712,chr20,32022613,32022712,H1|chr20:45989610-45989632,chr20,45989610,45989632,0,13966997
H1|chr20:32024935-32025009,chr20,32024935,32025009,H1|chr20:47896738-47896814,chr20,47896738,47896814,0,15871803
H1|chr20:32045738-32045793,chr20,32045738,32045793,H1|chr20:47897079-47897174,chr20,47897079,47897174,0,15851341
H1|chr20:32072837-32072877,chr20,32072837,32072877,H1|chr20:31283623-31283764,chr20,31283623,31283764,0,789214
H1|chr20:32177400-32177476,chr20,32177400,32177476,H1|chr20:31280001-31280033,chr20,31280001,31280033,0,897399
H1|chr20:32583438-32583538,chr20,32583438,32583538,H1|chr20:47896807-47896886,chr20,47896807,47896886,0,15313369
H1|chr20:32835460-32835606,chr20,32835460,32835606,H1|chr20:40244654-40244715,chr20,40244654,40244715,0,7409194
H1|chr20:32844855-32844928,chr20,32844855,32844928,H1|chr20:47899892-47899987,chr20,47899892,47899987,0,15055037
H1|chr20:33069741-33069830,chr20,33069741,33069830,H1|chr20:40244654-40244715,chr20,40244654,40244715,0,7174913
H1|chr20:33158771-33158798,chr20,33158771,33158798,H1|chr20:47900117-47900240,chr20,47900117,47900240,0,14741346
H1|chr20:33298617-33298643,chr20,33298617,33298643,H1|chr20:45988107-45988215,chr20,45988107,45988215,0,12689490
H1|chr20:33783104-33783180,chr20,33783104,33783180,H1|chr20:31282310-31282384,chr20,31282310,31282384,0,2500794
H1|chr20:34030518-34030586,chr20,34030518,34030586,H1|chr20:45989906-45989983,chr20,45989906,45989983,0,11959388
H1|chr20:34077952-34078005,chr20,34077952,34078005,H1|chr20:45946752-45946842,chr20,45946752,45946842,0,11868800
H1|chr20:34215617-34215658,chr20,34215617,34215658,H1|chr20:31281035-31281111,chr20,31281035,31281111,0,2934582
H1|chr20:34275189-34275263,chr20,34275189,34275263,H1|chr20:30192352-30192386,chr20,30192352,30192386,0,4082837
H1|chr20:34372647-34372671,chr20,34372647,34372671,H1|chr20:45988329-45988430,chr20,45988329,45988430,0,11615682
H1|chr20:34581297-34581356,chr20,34581297,34581356,H1|chr20:33871264-33871346,chr20,33871264,33871346,0,710033
H1|chr20:34652523-34652619,chr20,34652523,34652619,H1|chr20:45990071-45990125,chr20,45990071,45990125,0,11337548
H1|chr20:34726579-34726608,chr20,34726579,34726608,H1|chr20:32078490-32078555,chr20,32078490,32078555,0,2648089
H1|chr20:34829547-34829658,chr20,34829547,34829658,H1|chr20:523391-523424,chr20,523391,523424,0,34306156
H1|chr20:34852306-34852368,chr20,34852306,34852368,H1|chr20:45987521-45987671,chr20,45987521,45987671,0,11135215
H1|chr20:34873430-34873511,chr20,34873430,34873511,H1|chr20:47896738-47896814,chr20,47896738,47896814,0,13023308
H1|chr20:35045715-35045808,chr20,35045715,35045808,H1|chr20:47899931-47899982,chr20,47899931,47899982,0,12854216
H1|chr20:35046471-35046495,chr20,35046471,35046495,H1|chr20:31280301-31280423,chr20,31280301,31280423,0,3766170
H1|chr20:35106459-35106508,chr20,35106459,35106508,H1|chr20:17946554-17946621,chr20,17946554,17946621,0,17159905
H1|chr20:35386509-35386589,chr20,35386509,35386589,H1|chr20:47897071-47897184,chr20,47897071,47897184,0,12510562
H1|chr20:35733396-35733486,chr20,35733396,35733486,H1|chr20:62488998-62489028,chr20,62488998,62489028,0,26755602
H1|chr20:35848580-35848647,chr20,35848580,35848647,H1|chr20:45989906-45989983,chr20,45989906,45989983,0,10141326
H1|chr20:35907071-35907106,chr20,35907071,35907106,H1|chr20:30188854-30188925,chr20,30188854,30188925,0,5718217
H1|chr20:35916223-35916283,chr20,35916223,35916283,H1|chr20:60961365-60961449,chr20,60961365,60961449,0,25045142
H1|chr20:36001738-36001777,chr20,36001738,36001777,H1|chr20:47896578-47896667,chr20,47896578,47896667,0,11894840
H1|chr20:36063906-36064010,chr20,36063906,36064010,H1|chr20:45987373-45987416,chr20,45987373,45987416,0,9923467
H1|chr20:36173408-36173476,chr20,36173408,36173476,H1|chr20:30194404-30194478,chr20,30194404,30194478,0,5979004
H1|chr20:36195858-36195927,chr20,36195858,36195927,H1|chr20:31282371-31282451,chr20,31282371,31282451,0,4913487
H1|chr20:36279555-36279660,chr20,36279555,36279660,H1|chr20:45988644-45988689,chr20,45988644,45988689,0,9709089
H1|chr20:36295793-36295838,chr20,36295793,36295838,H1|chr20:45985534-45985633,chr20,45985534,45985633,0,9689741
H1|chr20:36296692-36296710,chr20,36296692,36296710,H1|chr20:31280791-31280921,chr20,31280791,31280921,0,5015901
H1|chr20:36413639-36413726,chr20,36413639,36413726,H1|chr20:47898669-47898732,chr20,47898669,47898732,0,11485030
H1|chr20:36451142-36451202,chr20,36451142,36451202,H1|chr20:47897826-47897916,chr20,47897826,47897916,0,11446684
H1|chr20:36495592-36495665,chr20,36495592,36495665,H1|chr20:30192352-30192386,chr20,30192352,30192386,0,6303240
H1|chr20:36637230-36637300,chr20,36637230,36637300,H1|chr20:31282371-31282451,chr20,31282371,31282451,0,5354859
H1|chr20:36743718-36743781,chr20,36743718,36743781,H1|chr20:47898619-47898724,chr20,47898619,47898724,0,11154901
H1|chr20:36773049-36773133,chr20,36773049,36773133,H1|chr20:45986428-45986489,chr20,45986428,45986489,0,9213379
H1|chr20:36773756-36773805,chr20,36773756,36773805,H1|chr20:32078618-32078700,chr20,32078618,32078700,0,4695138
H1|chr20:36873148-36873218,chr20,36873148,36873218,H1|chr20:30188821-30188901,chr20,30188821,30188901,0,6684327
H1|chr20:37033113-37033137,chr20,37033113,37033137,H1|chr20:62489934-62490058,chr20,62489934,62490058,0,25456821
H1|chr20:37229760-37229811,chr20,37229760,37229811,H1|chr20:45989826-45989923,chr20,45989826,45989923,0,8760066
H1|chr20:37329956-37330059,chr20,37329956,37330059,H1|chr20:45989362-45989389,chr20,45989362,45989389,0,8659406
H1|chr20:37364517-37364582,chr20,37364517,37364582,H1|chr20:31279735-31279820,chr20,31279735,31279820,0,6084782
H1|chr20:37516534-37516590,chr20,37516534,37516590,H1|chr20:47897079-47897174,chr20,47897079,47897174,0,10380545
H1|chr20:37544652-37544758,chr20,37544652,37544758,H1|chr20:31280002-31280042,chr20,31280002,31280042,0,6264650
H1|chr20:37619376-37619421,chr20,37619376,37619421,H1|chr20:47898619-47898724,chr20,47898619,47898724,0,10279243
H1|chr20:37822733-37822773,chr20,37822733,37822773,H1|chr20:47899892-47899987,chr20,47899892,47899987,0,10077159
H1|chr20:37937187-37937305,chr20,37937187,37937305,H1|chr20:30551123-30551149,chr20,30551123,30551149,0,7386064
H1|chr20:38204098-38204182,chr20,38204098,38204182,H1|chr20:62495967-62495992,chr20,62495967,62495992,0,24291869
H1|chr20:38231771-38231803,chr20,38231771,38231803,H1|chr20:31279553-31279642,chr20,31279553,31279642,0,6952218
H1|chr20:38343563-38343654,chr20,38343563,38343654,H1|chr20:33099396-33099436,chr20,33099396,33099436,0,5244167
H1|chr20:38373169-38373315,chr20,38373169,38373315,H1|chr20:47895943-47896000,chr20,47895943,47896000,0,9522774
H1|chr20:38471271-38471369,chr20,38471271,38471369,H1|chr20:45985989-45986083,chr20,45985989,45986083,0,7514718
H1|chr20:38592315-38592405,chr20,38592315,38592405,H1|chr20:62488998-62489028,chr20,62488998,62489028,0,23896683
H1|chr20:38669385-38669410,chr20,38669385,38669410,H1|chr20:31280301-31280423,chr20,31280301,31280423,0,7389084
H1|chr20:38783147-38783280,chr20,38783147,38783280,H1|chr20:45988447-45988466,chr20,45988447,45988466,0,7205300
H1|chr20:38835435-38835530,chr20,38835435,38835530,H1|chr20:31403948-31403977,chr20,31403948,31403977,0,7431487
H1|chr20:39155581-39155600,chr20,39155581,39155600,H1|chr20:60944818-60944847,chr20,60944818,60944847,0,21789237
H1|chr20:39176652-39176705,chr20,39176652,39176705,H1|chr20:48424842-48424916,chr20,48424842,48424916,0,9248190
H1|chr20:39210287-39210319,chr20,39210287,39210319,H1|chr20:47898769-47898853,chr20,47898769,47898853,0,8688482
H1|chr20:39220973-39221008,chr20,39220973,39221008,H1|chr20:60960494-60960574,chr20,60960494,60960574,0,21739521
H1|chr20:39279654-39279698,chr20,39279654,39279698,H1|chr20:47898653-47898735,chr20,47898653,47898735,0,8618999
H1|chr20:39766537-39766604,chr20,39766537,39766604,H1|chr20:45989009-45989056,chr20,45989009,45989056,0,6222472
H1|chr20:39785011-39785056,chr20,39785011,39785056,H1|chr20:47897134-47897189,chr20,47897134,47897189,0,8112123
H1|chr20:39798696-39798814,chr20,39798696,39798814,H1|chr20:30551123-30551149,chr20,30551123,30551149,0,9247573
H1|chr20:39807961-39808108,chr20,39807961,39808108,H1|chr20:30188821-30188901,chr20,30188821,30188901,0,9619140
H1|chr20:40056448-40056481,chr20,40056448,40056481,H1|chr20:31282587-31282704,chr20,31282587,31282704,0,8773861
H1|chr20:40073864-40073949,chr20,40073864,40073949,H1|chr20:45990471-45990506,chr20,45990471,45990506,0,5916607
H1|chr20:40147550-40147596,chr20,40147550,40147596,H1|chr20:45990185-45990261,chr20,45990185,45990261,0,5842635
H1|chr20:40246622-40246672,chr20,40246622,40246672,H1|chr20:57467643-57467666,chr20,57467643,57467666,0,17221021
H1|chr20:40263224-40263245,chr20,40263224,40263245,H1|chr20:47898195-47898340,chr20,47898195,47898340,0,7634971
H1|chr20:40264339-40264373,chr20,40264339,40264373,H1|chr20:45989826-45989923,chr20,45989826,45989923,0,5725487
H1|chr20:40484670-40484778,chr20,40484670,40484778,H1|chr20:45989433-45989453,chr20,45989433,45989453,0,5504763
H1|chr20:40658350-40658420,chr20,40658350,40658420,H1|chr20:30192694-30192744,chr20,30192694,30192744,0,10465656
H1|chr20:40740977-40741037,chr20,40740977,40741037,H1|chr20:48534290-48534438,chr20,48534290,48534438,0,7793313
H1|chr20:40787904-40787977,chr20,40787904,40787977,H1|chr20:30192352-30192386,chr20,30192352,30192386,0,10595552
H1|chr20:41228595-41228625,chr20,41228595,41228625,H1|chr20:60961365-60961449,chr20,60961365,60961449,0,19732770
H1|chr20:41431432-41431472,chr20,41431432,41431472,H1|chr20:45985523-45985633,chr20,45985523,45985633,0,4554091
H1|chr20:41666544-41666603,chr20,41666544,41666603,H1|chr20:45989321-45989397,chr20,45989321,45989397,0,4322777
H1|chr20:42241782-42241840,chr20,42241782,42241840,H1|chr20:31281492-31281555,chr20,31281492,31281555,0,10960290
H1|chr20:42242771-42242855,chr20,42242771,42242855,H1|chr20:62495967-62495992,chr20,62495967,62495992,0,20253196
H1|chr20:42358891-42358958,chr20,42358891,42358958,H1|chr20:31333409-31333492,chr20,31333409,31333492,0,11025482
H1|chr20:42463766-42463847,chr20,42463766,42463847,H1|chr20:17951809-17951863,chr20,17951809,17951863,0,24511957
H1|chr20:42464352-42464454,chr20,42464352,42464454,H1|chr20:17943731-17943792,chr20,17943731,17943792,0,24520621
H1|chr20:42612327-42612353,chr20,42612327,42612353,H1|chr20:45988107-45988215,chr20,45988107,45988215,0,3375780
H1|chr20:42655720-42655739,chr20,42655720,42655739,H1|chr20:45987360-45987507,chr20,45987360,45987507,0,3331640
H1|chr20:42949652-42949710,chr20,42949652,42949710,H1|chr20:31281492-31281555,chr20,31281492,31281555,0,11668160
H1|chr20:42964379-42964512,chr20,42964379,42964512,H1|chr20:45988447-45988466,chr20,45988447,45988466,0,3024068
H1|chr20:42997061-42997169,chr20,42997061,42997169,H1|chr20:31280306-31280385,chr20,31280306,31280385,0,11716755
H1|chr20:43025588-43025685,chr20,43025588,43025685,H1|chr20:57425428-57425521,chr20,57425428,57425521,0,14399840
H1|chr20:43042945-43043034,chr20,43042945,43043034,H1|chr20:57467855-57467883,chr20,57467855,57467883,0,14424910
H1|chr20:43086795-43086839,chr20,43086795,43086839,H1|chr20:57424403-57424444,chr20,57424403,57424444,0,14337608
H1|chr20:43103347-43103427,chr20,43103347,43103427,H1|chr20:47897071-47897184,chr20,47897071,47897184,0,4793724
H1|chr20:43168349-43168409,chr20,43168349,43168409,H1|chr20:31280444-31280502,chr20,31280444,31280502,0,11887905
H1|chr20:43191731-43191808,chr20,43191731,43191808,H1|chr20:47896107-47896171,chr20,47896107,47896171,0,4704376
H1|chr20:43252299-43252353,chr20,43252299,43252353,H1|chr20:31280723-31280813,chr20,31280723,31280813,0,11971576
H1|chr20:43261048-43261142,chr20,43261048,43261142,H1|chr20:31333409-31333492,chr20,31333409,31333492,0,11927639
H1|chr20:43269158-43269227,chr20,43269158,43269227,H1|chr20:44635864-44635923,chr20,44635864,44635923,0,1366706
H1|chr20:43426215-43426291,chr20,43426215,43426291,H1|chr20:47898046-47898120,chr20,47898046,47898120,0,4471831
H1|chr20:43444354-43444400,chr20,43444354,43444400,H1|chr20:31282631-31282735,chr20,31282631,31282735,0,12161723
H1|chr20:43514264-43514289,chr20,43514264,43514289,H1|chr20:57430349-57430435,chr20,57430349,57430435,0,13916085
H1|chr20:43550464-43550565,chr20,43550464,43550565,H1|chr20:30189554-30189599,chr20,30189554,30189599,0,13360910
H1|chr20:43648973-43649044,chr20,43648973,43649044,H1|chr20:47896807-47896886,chr20,47896807,47896886,0,4247834
H1|chr20:43669803-43669896,chr20,43669803,43669896,H1|chr20:45989884-45989919,chr20,45989884,45989919,0,2320081
H1|chr20:43700818-43700845,chr20,43700818,43700845,H1|chr20:47896527-47896623,chr20,47896527,47896623,0,4195709
H1|chr20:44559760-44559836,chr20,44559760,44559836,H1|chr20:47898046-47898120,chr20,47898046,47898120,0,3338286
H1|chr20:44606010-44606057,chr20,44606010,44606057,H1|chr20:45990185-45990261,chr20,45990185,45990261,0,1384175
H1|chr20:44625287-44625390,chr20,44625287,44625390,H1|chr20:47896059-47896177,chr20,47896059,47896177,0,3270772
H1|chr20:44749768-44749821,chr20,44749768,44749821,H1|chr20:45985989-45986083,chr20,45985989,45986083,0,1236221
H1|chr20:44816961-44817041,chr20,44816961,44817041,H1|chr20:30189262-30189329,chr20,30189262,30189329,0,14627699
H1|chr20:44833752-44833778,chr20,44833752,44833778,H1|chr20:62489934-62490058,chr20,62489934,62490058,0,17656182
H1|chr20:44880777-44880862,chr20,44880777,44880862,H1|chr20:45990471-45990506,chr20,45990471,45990506,0,1109694
H1|chr20:44988898-44988954,chr20,44988898,44988954,H1|chr20:30189554-30189599,chr20,30189554,30189599,0,14799344
H1|chr20:45034831-45034977,chr20,45034831,45034977,H1|chr20:40244654-40244715,chr20,40244654,40244715,0,4790177
H1|chr20:45259194-45259280,chr20,45259194,45259280,H1|chr20:57467643-57467666,chr20,57467643,57467666,0,12208449
H1|chr20:45325548-45325624,chr20,45325548,45325624,H1|chr20:31282310-31282384,chr20,31282310,31282384,0,14043238
H1|chr20:45423604-45423665,chr20,45423604,45423665,H1|chr20:47897891-47898040,chr20,47897891,47898040,0,2474287
H1|chr20:45454328-45454411,chr20,45454328,45454411,H1|chr20:47899574-47899640,chr20,47899574,47899640,0,2445246
H1|chr20:46032796-46032814,chr20,46032796,46032814,H1|chr20:31280791-31280921,chr20,31280791,31280921,0,14752005
H1|chr20:46062179-46062209,chr20,46062179,46062209,H1|chr20:57467838-57467927,chr20,57467838,57467927,0,11405659
H1|chr20:46154420-46154461,chr20,46154420,46154461,H1|chr20:45988352-45988468,chr20,45988352,45988468,0,166068
H1|chr20:46270591-46270610,chr20,46270591,46270610,H1|chr20:60944818-60944847,chr20,60944818,60944847,0,14674227
H1|chr20:46358326-46358379,chr20,46358326,46358379,H1|chr20:48424842-48424916,chr20,48424842,48424916,0,2066516
H1|chr20:46393880-46393954,chr20,46393880,46393954,H1|chr20:31331072-31331128,chr20,31331072,31331128,0,15062808
H1|chr20:47431521-47431593,chr20,47431521,47431593,H1|chr20:31353784-31353862,chr20,31353784,31353862,0,16077737
H1|chr20:47559347-47559472,chr20,47559347,47559472,H1|chr20:45988965-45988990,chr20,45988965,45988990,0,1570382
H1|chr20:47761209-47761274,chr20,47761209,47761274,H1|chr20:31282909-31282935,chr20,31282909,31282935,0,16478300
H1|chr20:47798491-47798534,chr20,47798491,47798534,H1|chr20:31404643-31404793,chr20,31404643,31404793,0,16393848
H1|chr20:47866553-47866577,chr20,47866553,47866577,H1|chr20:45988329-45988430,chr20,45988329,45988430,0,1878224
H1|chr20:47910441-47910525,chr20,47910441,47910525,H1|chr20:33872883-33872914,chr20,33872883,33872914,0,14037558
H1|chr20:47969798-47969843,chr20,47969798,47969843,H1|chr20:47897134-47897189,chr20,47897134,47897189,0,72664
H1|chr20:48236898-48237016,chr20,48236898,48237016,H1|chr20:42294708-42294792,chr20,42294708,42294792,0,5942190
H1|chr20:48375566-48375614,chr20,48375566,48375614,H1|chr20:31402869-31402971,chr20,31402869,31402971,0,16972697
H1|chr20:48556064-48556157,chr20,48556064,48556157,H1|chr20:47899931-47899982,chr20,47899931,47899982,0,656133
H1|chr20:49185172-49185191,chr20,49185172,49185191,H1|chr20:45987360-45987507,chr20,45987360,45987507,0,3197812
H1|chr20:49255850-49255931,chr20,49255850,49255931,H1|chr20:47896738-47896814,chr20,47896738,47896814,0,1359112
H1|chr20:49267474-49267533,chr20,49267474,49267533,H1|chr20:31282764-31282836,chr20,31282764,31282836,0,17984710
H1|chr20:49290079-49290198,chr20,49290079,49290198,H1|chr20:45990446-45990521,chr20,45990446,45990521,0,3299633
H1|chr20:49297341-49297415,chr20,49297341,49297415,H1|chr20:47896738-47896814,chr20,47896738,47896814,0,1400603
H1|chr20:49412445-49412472,chr20,49412445,49412472,H1|chr20:47896527-47896623,chr20,47896527,47896623,0,1515918
H1|chr20:49469998-49470060,chr20,49469998,49470060,H1|chr20:45989442-45989524,chr20,45989442,45989524,0,3480556
H1|chr20:49630752-49630785,chr20,49630752,49630785,H1|chr20:31283623-31283764,chr20,31283623,31283764,0,18347129
H1|chr20:49791288-49791359,chr20,49791288,49791359,H1|chr20:31279693-31279793,chr20,31279693,31279793,0,18511595
H1|chr20:49810851-49810951,chr20,49810851,49810951,H1|chr20:60960937-60961021,chr20,60960937,60961021,0,11150086
H1|chr20:49906782-49906813,chr20,49906782,49906813,H1|chr20:44988158-44988277,chr20,44988158,44988277,0,4918624
H1|chr20:49927299-49927333,chr20,49927299,49927333,H1|chr20:47897071-47897184,chr20,47897071,47897184,0,2030228
H1|chr20:49970844-49970941,chr20,49970844,49970941,H1|chr20:57424403-57424444,chr20,57424403,57424444,0,7453559
H1|chr20:50068468-50068529,chr20,50068468,50068529,H1|chr20:47897891-47898040,chr20,47897891,47898040,0,2170577
H1|chr20:50114044-50114097,chr20,50114044,50114097,H1|chr20:47900102-47900179,chr20,47900102,47900179,0,2213942
H1|chr20:50143425-50143524,chr20,50143425,50143524,H1|chr20:33872883-33872914,chr20,33872883,33872914,0,16270542
H1|chr20:50236919-50236958,chr20,50236919,50236958,H1|chr20:47896408-47896481,chr20,47896408,47896481,0,2340511
H1|chr20:50363814-50363883,chr20,50363814,50363883,H1|chr20:44635864-44635923,chr20,44635864,44635923,0,5727950
H1|chr20:50452585-50452672,chr20,50452585,50452672,H1|chr20:31282901-31282964,chr20,31282901,31282964,0,19169684
H1|chr20:50503298-50503408,chr20,50503298,50503408,H1|chr20:523391-523424,chr20,523391,523424,0,49979907
H1|chr20:50780096-50780162,chr20,50780096,50780162,H1|chr20:48534290-48534438,chr20,48534290,48534438,0,2245806
H1|chr20:51387814-51387881,chr20,51387814,51387881,H1|chr20:45989906-45989983,chr20,45989906,45989983,0,5397908
H1|chr20:51560905-51560926,chr20,51560905,51560926,H1|chr20:36150169-36150286,chr20,36150169,36150286,0,15410736
H1|chr20:51679973-51679991,chr20,51679973,51679991,H1|chr20:40245812-40245882,chr20,40245812,40245882,0,11434161
H1|chr20:51727444-51727578,chr20,51727444,51727578,H1|chr20:31353347-31353375,chr20,31353347,31353375,0,20374097
H1|chr20:51777191-51777303,chr20,51777191,51777303,H1|chr20:45988644-45988689,chr20,45988644,45988689,0,5788547
H1|chr20:51822454-51822541,chr20,51822454,51822541,H1|chr20:47898669-47898732,chr20,47898669,47898732,0,3923785
H1|chr20:51943455-51943491,chr20,51943455,51943491,H1|chr20:31283623-31283764,chr20,31283623,31283764,0,20659832
H1|chr20:52098349-52098449,chr20,52098349,52098449,H1|chr20:47896807-47896886,chr20,47896807,47896886,0,4201542
H1|chr20:52224908-52225024,chr20,52224908,52225024,H1|chr20:60944818-60944847,chr20,60944818,60944847,0,8719910
H1|chr20:52327854-52327966,chr20,52327854,52327966,H1|chr20:45988644-45988689,chr20,45988644,45988689,0,6339210
H1|chr20:52729851-52729950,chr20,52729851,52729950,H1|chr20:45985783-45985831,chr20,45985783,45985831,0,6744068
H1|chr20:52730094-52730197,chr20,52730094,52730197,H1|chr20:45989362-45989389,chr20,45989362,45989389,0,6740732
H1|chr20:52959529-52959654,chr20,52959529,52959654,H1|chr20:45989751-45989787,chr20,45989751,45989787,0,6969778
H1|chr20:53085868-53085918,chr20,53085868,53085918,H1|chr20:57467643-57467666,chr20,57467643,57467666,0,4381775
H1|chr20:53103705-53103769,chr20,53103705,53103769,H1|chr20:30190570-30190633,chr20,30190570,30190633,0,22913135
H1|chr20:53160262-53160317,chr20,53160262,53160317,H1|chr20:30190851-30190943,chr20,30190851,30190943,0,22969411
H1|chr20:53565278-53565308,chr20,53565278,53565308,H1|chr20:36150169-36150286,chr20,36150169,36150286,0,17415109
H1|chr20:53863642-53863713,chr20,53863642,53863713,H1|chr20:45988564-45988638,chr20,45988564,45988638,0,7875078
H1|chr20:53961747-53961807,chr20,53961747,53961807,H1|chr20:60961365-60961449,chr20,60961365,60961449,0,6999618
H1|chr20:54046057-54046122,chr20,54046057,54046122,H1|chr20:31279735-31279820,chr20,31279735,31279820,0,22766322
H1|chr20:54289720-54289811,chr20,54289720,54289811,H1|chr20:33099396-33099436,chr20,33099396,33099436,0,21190324
H1|chr20:54519058-54519187,chr20,54519058,54519187,H1|chr20:60961630-60961651,chr20,60961630,60961651,0,6442572
H1|chr20:54630963-54631010,chr20,54630963,54631010,H1|chr20:44988158-44988277,chr20,44988158,44988277,0,9642805
H1|chr20:54646503-54646522,chr20,54646503,54646522,H1|chr20:45989837-45989939,chr20,45989837,45989939,0,8656666
H1|chr20:54679364-54679427,chr20,54679364,54679427,H1|chr20:47898619-47898724,chr20,47898619,47898724,0,6780745
H1|chr20:54934447-54934481,chr20,54934447,54934481,H1|chr20:45989826-45989923,chr20,45989826,45989923,0,8944621
H1|chr20:55043091-55043147,chr20,55043091,55043147,H1|chr20:31282616-31282710,chr20,31282616,31282710,0,23760475
H1|chr20:55594090-55594140,chr20,55594090,55594140,H1|chr20:32078618-32078700,chr20,32078618,32078700,0,23515472
H1|chr20:55828158-55828217,chr20,55828158,55828217,H1|chr20:33871264-33871346,chr20,33871264,33871346,0,21956894
H1|chr20:56319656-56319806,chr20,56319656,56319806,H1|chr20:45988965-45988990,chr20,45988965,45988990,0,10330691
H1|chr20:56399487-56399545,chr20,56399487,56399545,H1|chr20:45989321-45989397,chr20,45989321,45989397,0,10410166
H1|chr20:56517912-56518040,chr20,56517912,56518040,H1|chr20:47897903-47897954,chr20,47897903,47897954,0,8620009
H1|chr20:56584594-56584691,chr20,56584594,56584691,H1|chr20:57425428-57425521,chr20,57425428,57425521,0,840834
H1|chr20:56655039-56655089,chr20,56655039,56655089,H1|chr20:32078618-32078700,chr20,32078618,32078700,0,24576421
H1|chr20:56721805-56721862,chr20,56721805,56721862,H1|chr20:5105229-5105316,chr20,5105229,5105316,0,51616576
H1|chr20:56784083-56784200,chr20,56784083,56784200,H1|chr20:47899212-47899294,chr20,47899212,47899294,0,8884871
H1|chr20:56891617-56891657,chr20,56891617,56891657,H1|chr20:47899892-47899987,chr20,47899892,47899987,0,8991725
H1|chr20:57055523-57055654,chr20,57055523,57055654,H1|chr20:45988447-45988466,chr20,45988447,45988466,0,11067076
H1|chr20:57195885-57195953,chr20,57195885,57195953,H1|chr20:47899212-47899294,chr20,47899212,47899294,0,9296673
H1|chr20:57202657-57202774,chr20,57202657,57202774,H1|chr20:45987564-45987587,chr20,45987564,45987587,0,11215093
H1|chr20:57221022-57221064,chr20,57221022,57221064,H1|chr20:31330918-31330985,chr20,31330918,31330985,0,25890104
H1|chr20:57256584-57256694,chr20,57256584,57256694,H1|chr20:523391-523424,chr20,523391,523424,0,56733193
H1|chr20:57329888-57329961,chr20,57329888,57329961,H1|chr20:45988564-45988638,chr20,45988564,45988638,0,11341324
H1|chr20:57394611-57394761,chr20,57394611,57394761,H1|chr20:45988965-45988990,chr20,45988965,45988990,0,11405646
H1|chr20:57412582-57412669,chr20,57412582,57412669,H1|chr20:31282901-31282964,chr20,31282901,31282964,0,26129681
H1|chr20:57440385-57440525,chr20,57440385,57440525,H1|chr20:31280002-31280042,chr20,31280002,31280042,0,26160383
H1|chr20:57507780-57507851,chr20,57507780,57507851,H1|chr20:31279693-31279793,chr20,31279693,31279793,0,26228087
H1|chr20:57649194-57649311,chr20,57649194,57649311,H1|chr20:31281912-31281945,chr20,31281912,31281945,0,26367282
H1|chr20:57675541-57675640,chr20,57675541,57675640,H1|chr20:33872883-33872914,chr20,33872883,33872914,0,23802658
H1|chr20:57734516-57734579,chr20,57734516,57734579,H1|chr20:30189427-30189575,chr20,30189427,30189575,0,27545089
H1|chr20:57911506-57911613,chr20,57911506,57911613,H1|chr20:45985783-45985831,chr20,45985783,45985831,0,11925723
H1|chr20:58037282-58037313,chr20,58037282,58037313,H1|chr20:47896604-47896741,chr20,47896604,47896741,0,10140678
H1|chr20:58125854-58125932,chr20,58125854,58125932,H1|chr20:31281983-31282052,chr20,31281983,31282052,0,26843871
H1|chr20:58248363-58248422,chr20,58248363,58248422,H1|chr20:31282764-31282836,chr20,31282764,31282836,0,26965599
H1|chr20:58538207-58538314,chr20,58538207,58538314,H1|chr20:45988252-45988281,chr20,45988252,45988281,0,12549955
H1|chr20:58682307-58682363,chr20,58682307,58682363,H1|chr20:45946752-45946842,chr20,45946752,45946842,0,12735555
H1|chr20:58707327-58707351,chr20,58707327,58707351,H1|chr20:31280301-31280423,chr20,31280301,31280423,0,27427026
H1|chr20:58977656-58977681,chr20,58977656,58977681,H1|chr20:57430349-57430435,chr20,57430349,57430435,0,1547307
H1|chr20:59017693-59017747,chr20,59017693,59017747,H1|chr20:31282587-31282704,chr20,31282587,31282704,0,27735106
H1|chr20:59289123-59289187,chr20,59289123,59289187,H1|chr20:31352694-31352717,chr20,31352694,31352717,0,27936429
H1|chr20:59509857-59509947,chr20,59509857,59509947,H1|chr20:57467855-57467883,chr20,57467855,57467883,0,2042002
H1|chr20:59707184-59707243,chr20,59707184,59707243,H1|chr20:45985523-45985633,chr20,45985523,45985633,0,13721661
H1|chr20:59777700-59777766,chr20,59777700,59777766,H1|chr20:48534290-48534438,chr20,48534290,48534438,0,11243410
H1|chr20:60009893-60009989,chr20,60009893,60009989,H1|chr20:45990071-45990125,chr20,45990071,45990125,0,14019822
H1|chr20:60217011-60217106,chr20,60217011,60217106,H1|chr20:47897903-47897954,chr20,47897903,47897954,0,12319108
H1|chr20:60342135-60342237,chr20,60342135,60342237,H1|chr20:45990071-45990125,chr20,45990071,45990125,0,14352064
H1|chr20:60456447-60456507,chr20,60456447,60456507,H1|chr20:48534290-48534438,chr20,48534290,48534438,0,11922157
H1|chr20:60489583-60489729,chr20,60489583,60489729,H1|chr20:47895943-47896000,chr20,47895943,47896000,0,12593640
H1|chr20:60634100-60634160,chr20,60634100,60634160,H1|chr20:31280444-31280502,chr20,31280444,31280502,0,29353656
H1|chr20:60705262-60705387,chr20,60705262,60705387,H1|chr20:45989751-45989787,chr20,45989751,45989787,0,14715511
H1|chr20:60860880-60860936,chr20,60860880,60860936,H1|chr20:31282616-31282710,chr20,31282616,31282710,0,29578264
H1|chr20:60868321-60868392,chr20,60868321,60868392,H1|chr20:30192694-30192744,chr20,30192694,30192744,0,30675627
H1|chr20:60900285-60900398,chr20,60900285,60900398,H1|chr20:60945421-60945553,chr20,60945421,60945553,0,45136
H1|chr20:61111068-61111124,chr20,61111068,61111124,H1|chr20:30189554-30189599,chr20,30189554,30189599,0,30921514
H1|chr20:61114869-61114917,chr20,61114869,61114917,H1|chr20:47899931-47899978,chr20,47899931,47899978,0,13214938
H1|chr20:61152356-61152427,chr20,61152356,61152427,H1|chr20:47899471-47899549,chr20,47899471,47899549,0,13252885
H1|chr20:61431125-61431184,chr20,61431125,61431184,H1|chr20:45987472-45987522,chr20,45987472,45987522,0,15443653
H1|chr20:61635404-61635452,chr20,61635404,61635452,H1|chr20:47899931-47899978,chr20,47899931,47899978,0,13735473
H1|chr20:61680543-61680613,chr20,61680543,61680613,H1|chr20:30194404-30194478,chr20,30194404,30194478,0,31486139
H1|chr20:61717909-61717984,chr20,61717909,61717984,H1|chr20:45990446-45990521,chr20,45990446,45990521,0,15727463
H1|chr20:61748481-61748546,chr20,61748481,61748546,H1|chr20:31282909-31282935,chr20,31282909,31282935,0,30465572
H1|chr20:61765069-61765109,chr20,61765069,61765109,H1|chr20:31281035-31281111,chr20,31281035,31281111,0,30484034
H1|chr20:61854974-61855033,chr20,61854974,61855033,H1|chr20:45989442-45989524,chr20,45989442,45989524,0,15865532
H1|chr20:61896209-61896310,chr20,61896209,61896310,H1|chr20:30189554-30189599,chr20,30189554,30189599,0,31706655
H1|chr20:62027441-62027553,chr20,62027441,62027553,H1|chr20:45988320-45988350,chr20,45988320,45988350,0,16039121
H1|chr20:62044303-62044393,chr20,62044303,62044393,H1|chr20:57467855-57467883,chr20,57467855,57467883,0,4576448
H1|chr20:62101051-62101113,chr20,62101051,62101113,H1|chr20:45989170-45989225,chr20,45989170,45989225,0,16111881
H1|chr20:62143408-62143482,chr20,62143408,62143482,H1|chr20:47898786-47898831,chr20,47898786,47898831,0,14244622
H1|chr20:62325780-62325880,chr20,62325780,62325880,H1|chr20:523391-523424,chr20,523391,523424,0,61802389
H1|chr20:62336567-62336629,chr20,62336567,62336629,H1|chr20:31282616-31282710,chr20,31282616,31282710,0,31053951
H1|chr20:62703586-62703641,chr20,62703586,62703641,H1|chr20:5105222-5105316,chr20,5105222,5105316,0,57598364
H1|chr20:62833566-62833617,chr20,62833566,62833617,H1|chr20:45989826-45989923,chr20,45989826,45989923,0,16843740
H1|chr20:62951834-62951896,chr20,62951834,62951896,H1|chr20:45987521-45987671,chr20,45987521,45987671,0,16964313
H1|chr21:1200353-1200461,chr21,1200353,1200461,H1|chr21:44500115-44500150,chr21,44500115,44500150,0,43299762
H1|chr21:1878654-1878708,chr21,1878654,1878708,H1|chr21:44500292-44500388,chr21,44500292,44500388,0,42621638
H1|chr21:3323120-3323169,chr21,3323120,3323169,H1|chr21:44501781-44501887,chr21,44501781,44501887,0,41178661
H1|chr21:3663393-3663512,chr21,3663393,3663512,H1|chr21:44500115-44500150,chr21,44500115,44500150,0,40836722
H1|chr21:3770215-3770313,chr21,3770215,3770313,H1|chr21:44501982-44502034,chr21,44501982,44502034,0,40731767
H1|chr21:3941633-3941738,chr21,3941633,3941738,H1|chr21:44527535-44527580,chr21,44527535,44527580,0,40585902
H1|chr21:4083187-4083309,chr21,4083187,4083309,H1|chr21:32932792-32932841,chr21,32932792,32932841,0,28849605
H1|chr21:4710388-4710488,chr21,4710388,4710488,H1|chr21:32932792-32932841,chr21,32932792,32932841,0,28222404
H1|chr21:5436586-5436614,chr21,5436586,5436614,H1|chr21:44497663-44497785,chr21,44497663,44497785,0,39061077
H1|chr21:6422615-6422734,chr21,6422615,6422734,H1|chr21:32932792-32932841,chr21,32932792,32932841,0,26510177
H1|chr21:7440974-7441052,chr21,7440974,7441052,H1|chr21:44498337-44498404,chr21,44498337,44498404,0,37057363
H1|chr21:7722678-7722800,chr21,7722678,7722800,H1|chr21:32932792-32932841,chr21,32932792,32932841,0,25210114
H1|chr21:8071489-8071597,chr21,8071489,8071597,H1|chr21:44500115-44500150,chr21,44500115,44500150,0,36428626
H1|chr21:8511590-8511672,chr21,8511590,8511672,H1|chr21:44392873-44392973,chr21,44392873,44392973,0,35881283
H1|chr21:8682688-8682737,chr21,8682688,8682737,H1|chr21:44501781-44501887,chr21,44501781,44501887,0,35819093
H1|chr21:9237173-9237216,chr21,9237173,9237216,H1|chr21:44499310-44499436,chr21,44499310,44499436,0,35262137
H1|chr21:9959091-9959145,chr21,9959091,9959145,H1|chr21:44500292-44500388,chr21,44500292,44500388,0,34541201
H1|chr21:10197308-10197422,chr21,10197308,10197422,H1|chr21:44501983-44502030,chr21,44501983,44502030,0,34304675
H1|chr21:10437617-10437661,chr21,10437617,10437661,H1|chr21:44501728-44501834,chr21,44501728,44501834,0,34064111
H1|chr21:11335477-11335554,chr21,11335477,11335554,H1|chr21:44527128-44527169,chr21,44527128,44527169,0,33191651
H1|chr21:11666211-11666255,chr21,11666211,11666255,H1|chr21:44501781-44501887,chr21,44501781,44501887,0,32835570
H1|chr21:11937664-11937708,chr21,11937664,11937708,H1|chr21:44501728-44501834,chr21,44501728,44501834,0,32564064
H1|chr21:12738150-12738228,chr21,12738150,12738228,H1|chr21:44527128-44527169,chr21,44527128,44527169,0,31788978
H1|chr21:13102185-13102304,chr21,13102185,13102304,H1|chr21:32932792-32932841,chr21,32932792,32932841,0,19830607
H1|chr21:13125702-13125776,chr21,13125702,13125776,H1|chr21:44499464-44499523,chr21,44499464,44499523,0,31373762
H1|chr21:13532906-13533011,chr21,13532906,13533011,H1|chr21:44501728-44501834,chr21,44501728,44501834,0,30968822
H1|chr21:13886744-13886844,chr21,13886744,13886844,H1|chr21:32932792-32932841,chr21,32932792,32932841,0,19046048
H1|chr21:14139946-14140002,chr21,14139946,14140002,H1|chr21:44500962-44501033,chr21,44500962,44501033,0,30361016
H1|chr21:14884788-14884848,chr21,14884788,14884848,H1|chr21:44500327-44500417,chr21,44500327,44500417,0,29615539
H1|chr21:15659788-15659836,chr21,15659788,15659836,H1|chr21:44497663-44497785,chr21,44497663,44497785,0,28837875
H1|chr21:16166713-16166791,chr21,16166713,16166791,H1|chr21:44501491-44501567,chr21,44501491,44501567,0,28334778
H1|chr21:16379654-16379732,chr21,16379654,16379732,H1|chr21:44501491-44501567,chr21,44501491,44501567,0,28121837
H1|chr21:17924909-17924964,chr21,17924909,17924964,H1|chr21:44500962-44501033,chr21,44500962,44501033,0,26576053
H1|chr21:18403907-18403987,chr21,18403907,18403987,H1|chr21:44500327-44500417,chr21,44500327,44500417,0,26096420
H1|chr21:19650700-19650743,chr21,19650700,19650743,H1|chr21:44499310-44499436,chr21,44499310,44499436,0,24848610
H1|chr21:20076078-20076183,chr21,20076078,20076183,H1|chr21:44501728-44501834,chr21,44501728,44501834,0,24425650
H1|chr21:20991648-20991762,chr21,20991648,20991762,H1|chr21:44493929-44493959,chr21,44493929,44493959,0,23502281
H1|chr21:21751785-21751863,chr21,21751785,21751863,H1|chr21:44527128-44527169,chr21,44527128,44527169,0,22775343
H1|chr21:22230242-22230319,chr21,22230242,22230319,H1|chr21:44527128-44527169,chr21,44527128,44527169,0,22296886
H1|chr21:22756338-22756448,chr21,22756338,22756448,H1|chr21:44500115-44500150,chr21,44500115,44500150,0,21743777
H1|chr21:23416661-23416766,chr21,23416661,23416766,H1|chr21:44527535-44527580,chr21,44527535,44527580,0,21110874
H1|chr21:23955379-23955489,chr21,23955379,23955489,H1|chr21:44500115-44500150,chr21,44500115,44500150,0,20544736
H1|chr21:24932057-24932079,chr21,24932057,24932079,H1|chr21:33034324-33034448,chr21,33034324,33034448,0,8102267
H1|chr21:25105173-25105253,chr21,25105173,25105253,H1|chr21:44493929-44493959,chr21,44493929,44493959,0,19388756
H1|chr21:26240425-26240485,chr21,26240425,26240485,H1|chr21:44500327-44500417,chr21,44500327,44500417,0,18259902
H1|chr21:26386804-26386859,chr21,26386804,26386859,H1|chr21:44500962-44501033,chr21,44500962,44501033,0,18114158
H1|chr21:26774942-26774999,chr21,26774942,26774999,H1|chr21:33034324-33034448,chr21,33034324,33034448,0,6259382
H1|chr21:27011934-27012035,chr21,27011934,27012035,H1|chr21:32932792-32932841,chr21,32932792,32932841,0,5920858
H1|chr21:27200346-27200374,chr21,27200346,27200374,H1|chr21:44497663-44497785,chr21,44497663,44497785,0,17297317
H1|chr21:27609278-27609328,chr21,27609278,27609328,H1|chr21:17103894-17103981,chr21,17103894,17103981,0,10505384
H1|chr21:27763880-27763902,chr21,27763880,27763902,H1|chr21:33034324-33034448,chr21,33034324,33034448,0,5270444
H1|chr21:27987897-27987947,chr21,27987897,27987947,H1|chr21:17103894-17103981,chr21,17103894,17103981,0,10884003
H1|chr21:29689235-29689285,chr21,29689235,29689285,H1|chr21:44392873-44392973,chr21,44392873,44392973,0,14703638
H1|chr21:29770266-29770364,chr21,29770266,29770364,H1|chr21:44501982-44502034,chr21,44501982,44502034,0,14731716
H1|chr21:31282763-31282836,chr21,31282763,31282836,H1|chr21:44501491-44501567,chr21,44501491,44501567,0,13218728
H1|chr21:31957637-31957690,chr21,31957637,31957690,H1|chr21:44500292-44500388,chr21,44500292,44500388,0,12542655
H1|chr21:32036557-32036635,chr21,32036557,32036635,H1|chr21:44498337-44498404,chr21,44498337,44498404,0,12461780
H1|chr21:32752885-32752933,chr21,32752885,32752933,H1|chr21:44497663-44497785,chr21,44497663,44497785,0,11744778
H1|chr21:33906191-33906271,chr21,33906191,33906271,H1|chr21:44500327-44500417,chr21,44500327,44500417,0,10594136
H1|chr21:34000695-34000751,chr21,34000695,34000751,H1|chr21:44500962-44501033,chr21,44500962,44501033,0,10500267
H1|chr21:34289786-34289839,chr21,34289786,34289839,H1|chr21:44500292-44500388,chr21,44500292,44500388,0,10210506
H1|chr21:34480654-34480739,chr21,34480654,34480739,H1|chr21:44498337-44498404,chr21,44498337,44498404,0,10017683
H1|chr21:35100127-35100203,chr21,35100127,35100203,H1|chr21:33784322-33784357,chr21,33784322,33784357,0,1315805
H1|chr21:35331843-35331919,chr21,35331843,35331919,H1|chr21:33784322-33784357,chr21,33784322,33784357,0,1547521
H1|chr21:35432999-35433113,chr21,35432999,35433113,H1|chr21:44501983-44502030,chr21,44501983,44502030,0,9068984
H1|chr21:35527795-35527914,chr21,35527795,35527914,H1|chr21:44500115-44500150,chr21,44500115,44500150,0,8972320
H1|chr21:36018586-36018671,chr21,36018586,36018671,H1|chr21:44498337-44498404,chr21,44498337,44498404,0,8479751
H1|chr21:38316460-38316574,chr21,38316460,38316574,H1|chr21:44493929-44493959,chr21,44493929,44493959,0,6177469
H1|chr21:38591443-38591499,chr21,38591443,38591499,H1|chr21:33783244-33783302,chr21,33783244,33783302,0,4808199
H1|chr21:39375472-39375529,chr21,39375472,39375529,H1|chr21:33034324-33034448,chr21,33034324,33034448,0,6341148
H1|chr21:41113599-41113679,chr21,41113599,41113679,H1|chr21:44493929-44493959,chr21,44493929,44493959,0,3380330
H1|chr21:43509909-43509953,chr21,43509909,43509953,H1|chr21:44501781-44501887,chr21,44501781,44501887,0,991872
H1|chr21:44028030-44028074,chr21,44028030,44028074,H1|chr21:44493929-44493959,chr21,44493929,44493959,0,465899
H1|chr21:44325687-44325731,chr21,44325687,44325731,H1|chr21:44493929-44493959,chr21,44493929,44493959,0,168242
H1|chr21:44733452-44733553,chr21,44733452,44733553,H1|chr21:32932792-32932841,chr21,32932792,32932841,0,11800660
H1|chr21:45335780-45335853,chr21,45335780,45335853,H1|chr21:44501491-44501567,chr21,44501491,44501567,0,834289
H1|chr21:45625790-45625864,chr21,45625790,45625864,H1|chr21:44499464-44499523,chr21,44499464,44499523,0,1126326
H1|chr21:45692318-45692368,chr21,45692318,45692368,H1|chr21:44392873-44392973,chr21,44392873,44392973,0,1299445
H1|chr21:45906853-45906935,chr21,45906853,45906935,H1|chr21:44392873-44392973,chr21,44392873,44392973,0,1513980
H1|chr21:46893609-46893665,chr21,46893609,46893665,H1|chr21:33783244-33783302,chr21,33783244,33783302,0,13110365
H1|chr22:168632-168691,chr22,168632,168691,H1|chr22:42079847-42079924,chr22,42079847,42079924,0,41911215
H1|chr22:171619-171695,chr22,171619,171695,H1|chr22:42326133-42326188,chr22,42326133,42326188,0,42154514
H1|chr22:172673-172727,chr22,172673,172727,H1|chr22:19846668-19846739,chr22,19846668,19846739,0,19673995
H1|chr22:181495-181548,chr22,181495,181548,H1|chr22:19846668-19846739,chr22,19846668,19846739,0,19665173
H1|chr22:270424-270496,chr22,270424,270496,H1|chr22:18122386-18122430,chr22,18122386,18122430,0,17851962
H1|chr22:323041-323125,chr22,323041,323125,H1|chr22:18038740-18038833,chr22,18038740,18038833,0,17715699
H1|chr22:467792-467849,chr22,467792,467849,H1|chr22:45404142-45404235,chr22,45404142,45404235,0,44936350
H1|chr22:622454-622557,chr22,622454,622557,H1|chr22:18110877-18110894,chr22,18110877,18110894,0,17488423
H1|chr22:732728-732765,chr22,732728,732765,H1|chr22:18039823-18039903,chr22,18039823,18039903,0,17307095
H1|chr22:895625-895689,chr22,895625,895689,H1|chr22:38794529-38794602,chr22,38794529,38794602,0,37898904
H1|chr22:1226904-1226957,chr22,1226904,1226957,H1|chr22:38059190-38059287,chr22,38059190,38059287,0,36832286
H1|chr22:1457809-1457946,chr22,1457809,1457946,H1|chr22:39053321-39053370,chr22,39053321,39053370,0,37595512
H1|chr22:1459094-1459131,chr22,1459094,1459131,H1|chr22:42914489-42914583,chr22,42914489,42914583,0,41455395
H1|chr22:1567511-1567661,chr22,1567511,1567661,H1|chr22:38032642-38032729,chr22,38032642,38032729,0,36465131
H1|chr22:1765913-1765983,chr22,1765913,1765983,H1|chr22:38901160-38901235,chr22,38901160,38901235,0,37135247
H1|chr22:1918389-1918479,chr22,1918389,1918479,H1|chr22:39051993-39052045,chr22,39051993,39052045,0,37133604
H1|chr22:1947263-1947374,chr22,1947263,1947374,H1|chr22:38053979-38053996,chr22,38053979,38053996,0,36106716
H1|chr22:2029658-2029697,chr22,2029658,2029697,H1|chr22:32027145-32027245,chr22,32027145,32027245,0,29997487
H1|chr22:2099884-2099949,chr22,2099884,2099949,H1|chr22:41680835-41680867,chr22,41680835,41680867,0,39580951
H1|chr22:2204454-2204509,chr22,2204454,2204509,H1|chr22:42326018-42326113,chr22,42326018,42326113,0,40121564
H1|chr22:2241157-2241201,chr22,2241157,2241201,H1|chr22:40575355-40575435,chr22,40575355,40575435,0,38334198
H1|chr22:2267138-2267193,chr22,2267138,2267193,H1|chr22:33452357-33452452,chr22,33452357,33452452,0,31185219
H1|chr22:2286395-2286427,chr22,2286395,2286427,H1|chr22:18041949-18042017,chr22,18041949,18042017,0,15755554
H1|chr22:2638552-2638602,chr22,2638552,2638602,H1|chr22:42915393-42915447,chr22,42915393,42915447,0,40276841
H1|chr22:2703139-2703232,chr22,2703139,2703232,H1|chr22:41840320-41840337,chr22,41840320,41840337,0,39137181
H1|chr22:2780708-2780783,chr22,2780708,2780783,H1|chr22:45404142-45404235,chr22,45404142,45404235,0,42623434
H1|chr22:2891978-2892031,chr22,2891978,2892031,H1|chr22:20846197-20846292,chr22,20846197,20846292,0,17954219
H1|chr22:2928945-2929024,chr22,2928945,2929024,H1|chr22:51020440-51020583,chr22,51020440,51020583,0,48091495
H1|chr22:3100564-3100652,chr22,3100564,3100652,H1|chr22:50221144-50221206,chr22,50221144,50221206,0,47120580
H1|chr22:3257018-3257083,chr22,3257018,3257083,H1|chr22:36906431-36906512,chr22,36906431,36906512,0,33649413
H1|chr22:3414249-3414311,chr22,3414249,3414311,H1|chr22:20068251-20068335,chr22,20068251,20068335,0,16654002
H1|chr22:3448394-3448490,chr22,3448394,3448490,H1|chr22:42915393-42915447,chr22,42915393,42915447,0,39466999
H1|chr22:3519608-3519690,chr22,3519608,3519690,H1|chr22:42326715-42326788,chr22,42326715,42326788,0,38807107
H1|chr22:3724948-3724999,chr22,3724948,3724999,H1|chr22:40576440-40576485,chr22,40576440,40576485,0,36851492
H1|chr22:3833029-3833139,chr22,3833029,3833139,H1|chr22:50221144-50221206,chr22,50221144,50221206,0,46388115
H1|chr22:4067862-4067893,chr22,4067862,4067893,H1|chr22:45559120-45559208,chr22,45559120,45559208,0,41491258
H1|chr22:4295781-4295815,chr22,4295781,4295815,H1|chr22:20070958-20071039,chr22,20070958,20071039,0,15775177
H1|chr22:4415666-4415719,chr22,4415666,4415719,H1|chr22:20846197-20846292,chr22,20846197,20846292,0,16430531
H1|chr22:4570490-4570562,chr22,4570490,4570562,H1|chr22:38901160-38901235,chr22,38901160,38901235,0,34330670
H1|chr22:4580795-4580816,chr22,4580795,4580816,H1|chr22:20116238-20116348,chr22,20116238,20116348,0,15535443
H1|chr22:4745253-4745323,chr22,4745253,4745323,H1|chr22:46968534-46968586,chr22,46968534,46968586,0,42223281
H1|chr22:4754345-4754398,chr22,4754345,4754398,H1|chr22:38059190-38059287,chr22,38059190,38059287,0,33304845
H1|chr22:4907979-4908029,chr22,4907979,4908029,H1|chr22:18039897-18039997,chr22,18039897,18039997,0,13131918
H1|chr22:5356270-5356332,chr22,5356270,5356332,H1|chr22:20068251-20068335,chr22,20068251,20068335,0,14711981
H1|chr22:5584347-5584431,chr22,5584347,5584431,H1|chr22:42915551-42915665,chr22,42915551,42915665,0,37331204
H1|chr22:5606927-5606964,chr22,5606927,5606964,H1|chr22:18038783-18038868,chr22,18038783,18038868,0,12431856
H1|chr22:5656510-5656562,chr22,5656510,5656562,H1|chr22:40576440-40576485,chr22,40576440,40576485,0,34919930
H1|chr22:5793674-5793749,chr22,5793674,5793749,H1|chr22:18039179-18039217,chr22,18039179,18039217,0,12245505
H1|chr22:5954606-5954650,chr22,5954606,5954650,H1|chr22:21767838-21767898,chr22,21767838,21767898,0,15813232
H1|chr22:6361194-6361287,chr22,6361194,6361287,H1|chr22:39051993-39052045,chr22,39051993,39052045,0,32690799
H1|chr22:6396377-6396476,chr22,6396377,6396476,H1|chr22:33198237-33198306,chr22,33198237,33198306,0,26801860
H1|chr22:6480991-6481075,chr22,6480991,6481075,H1|chr22:38032599-38032707,chr22,38032599,38032707,0,31551608
H1|chr22:6828987-6829059,chr22,6828987,6829059,H1|chr22:38901160-38901235,chr22,38901160,38901235,0,32072173
H1|chr22:7323026-7323124,chr22,7323026,7323124,H1|chr22:41840320-41840337,chr22,41840320,41840337,0,34517294
H1|chr22:7391690-7391739,chr22,7391690,7391739,H1|chr22:19846668-19846739,chr22,19846668,19846739,0,12454978
H1|chr22:7775019-7775112,chr22,7775019,7775112,H1|chr22:18122005-18122062,chr22,18122005,18122062,0,10346986
H1|chr22:8031702-8031812,chr22,8031702,8031812,H1|chr22:50221144-50221206,chr22,50221144,50221206,0,42189442
H1|chr22:8152018-8152108,chr22,8152018,8152108,H1|chr22:38033995-38034051,chr22,38033995,38034051,0,29881977
H1|chr22:8744073-8744161,chr22,8744073,8744161,H1|chr22:42915418-42915469,chr22,42915418,42915469,0,34171345
H1|chr22:8807691-8807750,chr22,8807691,8807750,H1|chr22:42079847-42079924,chr22,42079847,42079924,0,33272156
H1|chr22:9306271-9306345,chr22,9306271,9306345,H1|chr22:18039179-18039217,chr22,18039179,18039217,0,8732908
H1|chr22:9320782-9320871,chr22,9320782,9320871,H1|chr22:29697595-29697656,chr22,29697595,29697656,0,20376813
H1|chr22:9576276-9576297,chr22,9576276,9576297,H1|chr22:19844191-19844307,chr22,19844191,19844307,0,10267915
H1|chr22:9666196-9666237,chr22,9666196,9666237,H1|chr22:42347900-42347973,chr22,42347900,42347973,0,32681704
H1|chr22:9734369-9734421,chr22,9734369,9734421,H1|chr22:40576440-40576485,chr22,40576440,40576485,0,30842071
H1|chr22:9843247-9843340,chr22,9843247,9843340,H1|chr22:18122005-18122062,chr22,18122005,18122062,0,8278758
H1|chr22:10099627-10099777,chr22,10099627,10099777,H1|chr22:18110998-18111051,chr22,18110998,18111051,0,8011371
H1|chr22:10193754-10193831,chr22,10193754,10193831,H1|chr22:21272884-21273001,chr22,21272884,21273001,0,11079130
H1|chr22:10684047-10684100,chr22,10684047,10684100,H1|chr22:19846668-19846739,chr22,19846668,19846739,0,9162621
H1|chr22:10790571-10790657,chr22,10790571,10790657,H1|chr22:42915405-42915469,chr22,42915405,42915469,0,32124834
H1|chr22:10970960-10971057,chr22,10970960,10971057,H1|chr22:41840320-41840337,chr22,41840320,41840337,0,30869360
H1|chr22:11029788-11029845,chr22,11029788,11029845,H1|chr22:45404142-45404235,chr22,45404142,45404235,0,34374354
H1|chr22:11108019-11108106,chr22,11108019,11108106,H1|chr22:50221144-50221206,chr22,50221144,50221206,0,39113125
H1|chr22:11477749-11477790,chr22,11477749,11477790,H1|chr22:32027145-32027245,chr22,32027145,32027245,0,20549396
H1|chr22:11716063-11716122,chr22,11716063,11716122,H1|chr22:39053625-39053702,chr22,39053625,39053702,0,27337562
H1|chr22:11983422-11983468,chr22,11983422,11983468,H1|chr22:40575355-40575435,chr22,40575355,40575435,0,28591933
H1|chr22:12007221-12007291,chr22,12007221,12007291,H1|chr22:38901160-38901235,chr22,38901160,38901235,0,26893939
H1|chr22:12107594-12107691,chr22,12107594,12107691,H1|chr22:33452543-33452632,chr22,33452543,33452632,0,21344949
H1|chr22:12279415-12279474,chr22,12279415,12279474,H1|chr22:29697768-29697918,chr22,29697768,29697918,0,17418353
H1|chr22:12324029-12324117,chr22,12324029,12324117,H1|chr22:42915418-42915469,chr22,42915418,42915469,0,30591389
H1|chr22:12489826-12489888,chr22,12489826,12489888,H1|chr22:18041949-18042017,chr22,18041949,18042017,0,5552123
H1|chr22:12492398-12492447,chr22,12492398,12492447,H1|chr22:19846668-19846739,chr22,19846668,19846739,0,7354270
H1|chr22:12533337-12533427,chr22,12533337,12533427,H1|chr22:39051993-39052045,chr22,39051993,39052045,0,26518656
H1|chr22:12662946-12662978,chr22,12662946,12662978,H1|chr22:38214673-38214704,chr22,38214673,38214704,0,25551727
H1|chr22:12747960-12748041,chr22,12747960,12748041,H1|chr22:33198237-33198306,chr22,33198237,33198306,0,20450277
H1|chr22:13083683-13083714,chr22,13083683,13083714,H1|chr22:33198237-33198306,chr22,33198237,33198306,0,20114554
H1|chr22:13163328-13163398,chr22,13163328,13163398,H1|chr22:20069975-20070055,chr22,20069975,20070055,0,6906647
H1|chr22:13331980-13332072,chr22,13331980,13332072,H1|chr22:20795182-20795240,chr22,20795182,20795240,0,7463202
H1|chr22:13344823-13344922,chr22,13344823,13344922,H1|chr22:33198237-33198306,chr22,33198237,33198306,0,19853414
H1|chr22:13425379-13425417,chr22,13425379,13425417,H1|chr22:18039823-18039903,chr22,18039823,18039903,0,4614444
H1|chr22:13597476-13597541,chr22,13597476,13597541,H1|chr22:36906431-36906512,chr22,36906431,36906512,0,23308955
H1|chr22:13718252-13718348,chr22,13718252,13718348,H1|chr22:41840320-41840337,chr22,41840320,41840337,0,28122068
H1|chr22:13747811-13747920,chr22,13747811,13747920,H1|chr22:50221144-50221206,chr22,50221144,50221206,0,36473333
H1|chr22:14240219-14240322,chr22,14240219,14240322,H1|chr22:50766666-50766785,chr22,50766666,50766785,0,36526447
H1|chr22:14273814-14273865,chr22,14273814,14273865,H1|chr22:51019673-51019770,chr22,51019673,51019770,0,36745859
H1|chr22:15121972-15121992,chr22,15121972,15121992,H1|chr22:18041949-18042017,chr22,18041949,18042017,0,2919977
H1|chr22:15707220-15707251,chr22,15707220,15707251,H1|chr22:50766666-50766785,chr22,50766666,50766785,0,35059446
H1|chr22:15768522-15768611,chr22,15768522,15768611,H1|chr22:42915410-42915469,chr22,42915410,42915469,0,27146888
H1|chr22:15857164-15857314,chr22,15857164,15857314,H1|chr22:18110998-18111051,chr22,18110998,18111051,0,2253834
H1|chr22:15906647-15906728,chr22,15906647,15906728,H1|chr22:33198237-33198306,chr22,33198237,33198306,0,17291590
H1|chr22:15973757-15973821,chr22,15973757,15973821,H1|chr22:38794529-38794602,chr22,38794529,38794602,0,22820772
H1|chr22:16061739-16061811,chr22,16061739,16061811,H1|chr22:46968534-46968586,chr22,46968534,46968586,0,30906795
H1|chr22:16389168-16389205,chr22,16389168,16389205,H1|chr22:42914489-42914583,chr22,42914489,42914583,0,26525321
H1|chr22:16499068-16499150,chr22,16499068,16499150,H1|chr22:18040073-18040113,chr22,18040073,18040113,0,1541005
H1|chr22:17497238-17497388,chr22,17497238,17497388,H1|chr22:38032642-38032729,chr22,38032642,38032729,0,20535404
H1|chr22:17504759-17504849,chr22,17504759,17504849,H1|chr22:38033995-38034051,chr22,38033995,38034051,0,20529236
H1|chr22:17728295-17728332,chr22,17728295,17728332,H1|chr22:38214673-38214823,chr22,38214673,38214823,0,20486378
H1|chr22:17908742-17908818,chr22,17908742,17908818,H1|chr22:42326133-42326188,chr22,42326133,42326188,0,24417391
H1|chr22:17972976-17973048,chr22,17972976,17973048,H1|chr22:46968534-46968586,chr22,46968534,46968586,0,28995558
H1|chr22:18096753-18096807,chr22,18096753,18096807,H1|chr22:18039897-18039997,chr22,18039897,18039997,0,56856
H1|chr22:18120517-18120610,chr22,18120517,18120610,H1|chr22:41840320-41840337,chr22,41840320,41840337,0,23719803
H1|chr22:18124047-18124129,chr22,18124047,18124129,H1|chr22:18040073-18040113,chr22,18040073,18040113,0,83974
H1|chr22:18490260-18490334,chr22,18490260,18490334,H1|chr22:18039179-18039217,chr22,18039179,18039217,0,451081
H1|chr22:18575748-18575792,chr22,18575748,18575792,H1|chr22:21767838-21767898,chr22,21767838,21767898,0,3192090
H1|chr22:18830559-18830668,chr22,18830559,18830668,H1|chr22:38008033-38008055,chr22,38008033,38008055,0,19177474
H1|chr22:19021624-19021724,chr22,19021624,19021724,H1|chr22:35796916-35796966,chr22,35796916,35796966,0,16775292
H1|chr22:19181012-19181108,chr22,19181012,19181108,H1|chr22:20795182-20795240,chr22,20795182,20795240,0,1614170
H1|chr22:19518601-19518655,chr22,19518601,19518655,H1|chr22:19846668-19846739,chr22,19846668,19846739,0,328067
H1|chr22:19749931-19749963,chr22,19749931,19749963,H1|chr22:18040114-18040232,chr22,18040114,18040232,0,1709817
H1|chr22:19816549-19816600,chr22,19816549,19816600,H1|chr22:38059190-38059287,chr22,38059190,38059287,0,18242641
H1|chr22:20320345-20320442,chr22,20320345,20320442,H1|chr22:41840320-41840337,chr22,41840320,41840337,0,21519975
H1|chr22:20339852-20339917,chr22,20339852,20339917,H1|chr22:46968534-46968585,chr22,46968534,46968585,0,26628682
H1|chr22:21076164-21076192,chr22,21076164,21076192,H1|chr22:42314661-42314733,chr22,42314661,42314733,0,21238497
H1|chr22:21160469-21160535,chr22,21160469,21160535,H1|chr22:36906478-36906512,chr22,36906478,36906512,0,15746009
H1|chr22:21415229-21415267,chr22,21415229,21415267,H1|chr22:42347900-42347973,chr22,42347900,42347973,0,20932671
H1|chr22:21838258-21838343,chr22,21838258,21838343,H1|chr22:45409686-45409727,chr22,45409686,45409727,0,23571428
H1|chr22:22170797-22170869,chr22,22170797,22170869,H1|chr22:22653734-22653812,chr22,22653734,22653812,0,482937
H1|chr22:22207979-22208017,chr22,22207979,22208017,H1|chr22:18041949-18042017,chr22,18041949,18042017,0,4166030
H1|chr22:22513744-22513855,chr22,22513744,22513855,H1|chr22:38053979-38053996,chr22,38053979,38053996,0,15540235
H1|chr22:22696701-22696776,chr22,22696701,22696776,H1|chr22:18039179-18039217,chr22,18039179,18039217,0,4657522
H1|chr22:22716794-22716867,chr22,22716794,22716867,H1|chr22:45560251-45560299,chr22,45560251,45560299,0,22843457
H1|chr22:22733473-22733532,chr22,22733473,22733532,H1|chr22:39053625-39053702,chr22,39053625,39053702,0,16320152
H1|chr22:22739873-22739952,chr22,22739873,22739952,H1|chr22:51020440-51020583,chr22,51020440,51020583,0,28280567
H1|chr22:22752831-22752885,chr22,22752831,22752885,H1|chr22:38900867-38900912,chr22,38900867,38900912,0,16148036
H1|chr22:23162155-23162252,chr22,23162155,23162252,H1|chr22:33452543-33452632,chr22,33452543,33452632,0,10290388
H1|chr22:23217385-23217450,chr22,23217385,23217450,H1|chr22:41680835-41680867,chr22,41680835,41680867,0,18463450
H1|chr22:23362357-23362410,chr22,23362357,23362410,H1|chr22:22653734-22653812,chr22,22653734,22653812,0,708623
H1|chr22:23418052-23418134,chr22,23418052,23418134,H1|chr22:42326715-42326788,chr22,42326715,42326788,0,18908663
H1|chr22:23866795-23866904,chr22,23866795,23866904,H1|chr22:50221144-50221206,chr22,50221144,50221206,0,26354349
H1|chr22:24072653-24072684,chr22,24072653,24072684,H1|chr22:45559120-45559208,chr22,45559120,45559208,0,21486467
H1|chr22:24112990-24113090,chr22,24112990,24113090,H1|chr22:35796916-35796966,chr22,35796916,35796966,0,11683926
H1|chr22:24149905-24149956,chr22,24149905,24149956,H1|chr22:40576440-40576485,chr22,40576440,40576485,0,16426535
H1|chr22:24172556-24172650,chr22,24172556,24172650,H1|chr22:38006455-38006511,chr22,38006455,38006511,0,13833899
H1|chr22:24175888-24175943,chr22,24175888,24175943,H1|chr22:42326018-42326113,chr22,42326018,42326113,0,18150130
H1|chr22:24274088-24274150,chr22,24274088,24274150,H1|chr22:19844401-19844484,chr22,19844401,19844484,0,4429687
H1|chr22:24295066-24295141,chr22,24295066,24295141,H1|chr22:22011496-22011571,chr22,22011496,22011571,0,2283570
H1|chr22:24303149-24303169,chr22,24303149,24303169,H1|chr22:18041949-18042017,chr22,18041949,18042017,0,6261200
H1|chr22:24307451-24307521,chr22,24307451,24307521,H1|chr22:46968534-46968586,chr22,46968534,46968586,0,22661083
H1|chr22:24678134-24678170,chr22,24678134,24678170,H1|chr22:22011496-22011610,chr22,22011496,22011610,0,2666638
H1|chr22:24699878-24699928,chr22,24699878,24699928,H1|chr22:42915393-42915447,chr22,42915393,42915447,0,18215515
H1|chr22:24800047-24800113,chr22,24800047,24800113,H1|chr22:36906478-36906512,chr22,36906478,36906512,0,12106431
H1|chr22:24874198-24874239,chr22,24874198,24874239,H1|chr22:32027145-32027245,chr22,32027145,32027245,0,7152947
H1|chr22:24963981-24964002,chr22,24963981,24964002,H1|chr22:19844191-19844307,chr22,19844191,19844307,0,5119790
H1|chr22:24983298-24983336,chr22,24983298,24983336,H1|chr22:42347900-42347973,chr22,42347900,42347973,0,17364602
H1|chr22:25173119-25173157,chr22,25173119,25173157,H1|chr22:45400498-45400532,chr22,45400498,45400532,0,20227379
H1|chr22:25683337-25683411,chr22,25683337,25683411,H1|chr22:18111253-18111329,chr22,18111253,18111329,0,7572084
H1|chr22:25704795-25704833,chr22,25704795,25704833,H1|chr22:45400498-45400532,chr22,45400498,45400532,0,19695703
H1|chr22:25879796-25879866,chr22,25879796,25879866,H1|chr22:41683574-41683718,chr22,41683574,41683718,0,15803778
H1|chr22:26000367-26000463,chr22,26000367,26000463,H1|chr22:41840320-41840337,chr22,41840320,41840337,0,15839953
H1|chr22:26097168-26097198,chr22,26097168,26097198,H1|chr22:45559120-45559208,chr22,45559120,45559208,0,19461952
H1|chr22:26238692-26238722,chr22,26238692,26238722,H1|chr22:45559120-45559208,chr22,45559120,45559208,0,19320428
H1|chr22:26415877-26415941,chr22,26415877,26415941,H1|chr22:41680835-41680867,chr22,41680835,41680867,0,15264958
H1|chr22:26541226-26541291,chr22,26541226,26541291,H1|chr22:35796981-35797101,chr22,35796981,35797101,0,9255755
H1|chr22:26603041-26603078,chr22,26603041,26603078,H1|chr22:18039823-18039903,chr22,18039823,18039903,0,8563218
H1|chr22:26816039-26816137,chr22,26816039,26816137,H1|chr22:41840320-41840337,chr22,41840320,41840337,0,15024281
H1|chr22:27389420-27389522,chr22,27389420,27389522,H1|chr22:18040114-18040232,chr22,18040114,18040232,0,9349306
H1|chr22:27716428-27716467,chr22,27716428,27716467,H1|chr22:32027145-32027245,chr22,32027145,32027245,0,4310717
H1|chr22:28813351-28813368,chr22,28813351,28813368,H1|chr22:38214907-38214995,chr22,38214907,38214995,0,9401556
H1|chr22:28973903-28974045,chr22,28973903,28974045,H1|chr22:35796916-35796966,chr22,35796916,35796966,0,6823013
H1|chr22:29385033-29385170,chr22,29385033,29385170,H1|chr22:39053321-39053370,chr22,39053321,39053370,0,9668288
H1|chr22:29811727-29811800,chr22,29811727,29811800,H1|chr22:45560251-45560299,chr22,45560251,45560299,0,15748524
H1|chr22:30298232-30298371,chr22,30298232,30298371,H1|chr22:39053321-39053370,chr22,39053321,39053370,0,8755089
H1|chr22:30348424-30348461,chr22,30348424,30348461,H1|chr22:18038783-18038868,chr22,18038783,18038868,0,12309641
H1|chr22:30379179-30379210,chr22,30379179,30379210,H1|chr22:50766666-50766785,chr22,50766666,50766785,0,20387487
H1|chr22:30707952-30708074,chr22,30707952,30708074,H1|chr22:38901180-38901330,chr22,38901180,38901330,0,8193228
H1|chr22:30740703-30740802,chr22,30740703,30740802,H1|chr22:33452357-33452452,chr22,33452357,33452452,0,2711654
H1|chr22:30784917-30785024,chr22,30784917,30785024,H1|chr22:19847320-19847339,chr22,19847320,19847339,0,10937597
H1|chr22:30910733-30910817,chr22,30910733,30910817,H1|chr22:18038740-18038833,chr22,18038740,18038833,0,12871993
H1|chr22:31315721-31315795,chr22,31315721,31315795,H1|chr22:18111253-18111329,chr22,18111253,18111329,0,13204468
H1|chr22:31673706-31673807,chr22,31673706,31673807,H1|chr22:18040114-18040232,chr22,18040114,18040232,0,13633592
H1|chr22:32708783-32708822,chr22,32708783,32708822,H1|chr22:42347900-42347973,chr22,42347900,42347973,0,9639117
H1|chr22:32800516-32800554,chr22,32800516,32800554,H1|chr22:18041949-18042017,chr22,18041949,18042017,0,14758567
H1|chr22:32996879-32996951,chr22,32996879,32996951,H1|chr22:22653734-22653812,chr22,22653734,22653812,0,10343145
H1|chr22:33012572-33012622,chr22,33012572,33012622,H1|chr22:18039897-18039997,chr22,18039897,18039997,0,14972675
H1|chr22:33141757-33141846,chr22,33141757,33141846,H1|chr22:29697595-29697656,chr22,29697595,29697656,0,3444162
H1|chr22:33229017-33229092,chr22,33229017,33229092,H1|chr22:45404142-45404235,chr22,45404142,45404235,0,12175125
H1|chr22:33393187-33393225,chr22,33393187,33393225,H1|chr22:18039823-18039903,chr22,18039823,18039903,0,15353364
H1|chr22:33480927-33480950,chr22,33480927,33480950,H1|chr22:20116240-20116348,chr22,20116240,20116348,0,13364687
H1|chr22:33674708-33674810,chr22,33674708,33674810,H1|chr22:18040114-18040232,chr22,18040114,18040232,0,15634594
H1|chr22:33758393-33758447,chr22,33758393,33758447,H1|chr22:18039897-18039997,chr22,18039897,18039997,0,15718496
H1|chr22:34272185-34272236,chr22,34272185,34272236,H1|chr22:42325991-42326086,chr22,42325991,42326086,0,8053806
H1|chr22:34423199-34423302,chr22,34423199,34423302,H1|chr22:45562692-45562734,chr22,45562692,45562734,0,11139493
H1|chr22:35225871-35225935,chr22,35225871,35225935,H1|chr22:41680835-41680867,chr22,41680835,41680867,0,6454964
H1|chr22:35243277-35243373,chr22,35243277,35243373,H1|chr22:42915393-42915447,chr22,42915393,42915447,0,7672116
H1|chr22:35275419-35275481,chr22,35275419,35275481,H1|chr22:19844401-19844484,chr22,19844401,19844484,0,15431018
H1|chr22:35539960-35539983,chr22,35539960,35539983,H1|chr22:20116240-20116348,chr22,20116240,20116348,0,15423720
H1|chr22:35826990-35827029,chr22,35826990,35827029,H1|chr22:45409835-45409946,chr22,45409835,45409946,0,9582845
H1|chr22:35882293-35882382,chr22,35882293,35882382,H1|chr22:42915410-42915469,chr22,42915410,42915469,0,7033117
H1|chr22:36183008-36183115,chr22,36183008,36183115,H1|chr22:19847320-19847339,chr22,19847320,19847339,0,16335688
H1|chr22:36226190-36226225,chr22,36226190,36226225,H1|chr22:33452543-33452632,chr22,33452543,33452632,0,2773647
H1|chr22:36388659-36388768,chr22,36388659,36388768,H1|chr22:38008033-38008055,chr22,38008033,38008055,0,1619374
H1|chr22:36441240-36441358,chr22,36441240,36441358,H1|chr22:45562692-45562734,chr22,45562692,45562734,0,9121452
H1|chr22:36921886-36921940,chr22,36921886,36921940,H1|chr22:38900867-38900912,chr22,38900867,38900912,0,1978981
H1|chr22:37098304-37098336,chr22,37098304,37098336,H1|chr22:18040114-18040232,chr22,18040114,18040232,0,19058190
H1|chr22:37122553-37122647,chr22,37122553,37122647,H1|chr22:38006455-38006511,chr22,38006455,38006511,0,883902
H1|chr22:37155285-37155336,chr22,37155285,37155336,H1|chr22:51019673-51019770,chr22,51019673,51019770,0,13864388
H1|chr22:37315834-37315891,chr22,37315834,37315891,H1|chr22:38214485-38214542,chr22,38214485,38214542,0,898651
H1|chr22:37348415-37348480,chr22,37348415,37348480,H1|chr22:35796981-35797101,chr22,35796981,35797101,0,1551434
H1|chr22:37473006-37473107,chr22,37473006,37473107,H1|chr22:18040114-18040232,chr22,18040114,18040232,0,19432892
H1|chr22:37537144-37537237,chr22,37537144,37537237,H1|chr22:39051993-39052045,chr22,39051993,39052045,0,1514849
H1|chr22:37574298-37574375,chr22,37574298,37574375,H1|chr22:21272884-21273001,chr22,21272884,21273001,0,16301414
H1|chr22:37578491-37578563,chr22,37578491,37578563,H1|chr22:18122386-18122430,chr22,18122386,18122430,0,19456105
H1|chr22:37718719-37718822,chr22,37718719,37718822,H1|chr22:18110877-18110894,chr22,18110877,18110894,0,19607842
H1|chr22:38222606-38222716,chr22,38222606,38222716,H1|chr22:38053979-38053996,chr22,38053979,38053996,0,168627
H1|chr22:38237289-38237374,chr22,38237289,38237374,H1|chr22:45409686-45409727,chr22,45409686,45409727,0,7172397
H1|chr22:38329934-38330021,chr22,38329934,38330021,H1|chr22:50221144-50221206,chr22,50221144,50221206,0,11891210
H1|chr22:38430145-38430263,chr22,38430145,38430263,H1|chr22:45562692-45562734,chr22,45562692,45562734,0,7132547
H1|chr22:38488561-38488596,chr22,38488561,38488596,H1|chr22:33452543-33452632,chr22,33452543,33452632,0,5036018
H1|chr22:38581243-38581338,chr22,38581243,38581338,H1|chr22:18110998-18111051,chr22,18110998,18111051,0,20470245
H1|chr22:38879887-38879919,chr22,38879887,38879919,H1|chr22:38214673-38214704,chr22,38214673,38214704,0,665214
H1|chr22:39095397-39095425,chr22,39095397,39095425,H1|chr22:42314661-42314733,chr22,42314661,42314733,0,3219264
H1|chr22:39163837-39163896,chr22,39163837,39163896,H1|chr22:51019673-51019770,chr22,51019673,51019770,0,11855836
H1|chr22:39274601-39274704,chr22,39274601,39274704,H1|chr22:50766666-50766785,chr22,50766666,50766785,0,11492065
H1|chr22:39317605-39317706,chr22,39317605,39317706,H1|chr22:39053321-39053370,chr22,39053321,39053370,0,264284
H1|chr22:39708771-39708841,chr22,39708771,39708841,H1|chr22:20069975-20070055,chr22,20069975,20070055,0,19638796
H1|chr22:39997622-39997668,chr22,39997622,39997668,H1|chr22:40575355-40575435,chr22,40575355,40575435,0,577733
H1|chr22:40593656-40593772,chr22,40593656,40593772,H1|chr22:20069975-20070055,chr22,20069975,20070055,0,20523681
H1|chr22:40648615-40648703,chr22,40648615,40648703,H1|chr22:50221144-50221206,chr22,50221144,50221206,0,9572529
H1|chr22:40862446-40862487,chr22,40862446,40862487,H1|chr22:42347900-42347973,chr22,42347900,42347973,0,1485454
H1|chr22:41120390-41120474,chr22,41120390,41120474,H1|chr22:38032599-38032707,chr22,38032599,38032707,0,3087791
H1|chr22:41155484-41155520,chr22,41155484,41155520,H1|chr22:22011496-22011610,chr22,22011496,22011610,0,19143988
H1|chr22:41556796-41556853,chr22,41556796,41556853,H1|chr22:38214485-38214542,chr22,38214485,38214542,0,3342311
H1|chr22:41570433-41570534,chr22,41570433,41570534,H1|chr22:39053321-39053370,chr22,39053321,39053370,0,2517112
H1|chr22:41741036-41741089,chr22,41741036,41741089,H1|chr22:22653734-22653812,chr22,22653734,22653812,0,19087302
H1|chr22:41872514-41872556,chr22,41872514,41872556,H1|chr22:38032599-38032707,chr22,38032599,38032707,0,3839915
H1|chr22:41995611-41995631,chr22,41995611,41995631,H1|chr22:38901101-38901225,chr22,38901101,38901225,0,3094510
H1|chr22:42148278-42148329,chr22,42148278,42148329,H1|chr22:42325991-42326086,chr22,42325991,42326086,0,177713
H1|chr22:42418169-42418279,chr22,42418169,42418279,H1|chr22:38053979-38053996,chr22,38053979,38053996,0,4364190
H1|chr22:42468740-42468777,chr22,42468740,42468777,H1|chr22:38214673-38214823,chr22,38214673,38214823,0,4254067
H1|chr22:42893687-42893762,chr22,42893687,42893762,H1|chr22:22011496-22011571,chr22,22011496,22011571,0,20882191
H1|chr22:43084498-43084557,chr22,43084498,43084557,H1|chr22:29697768-29697918,chr22,29697768,29697918,0,13386730
H1|chr22:43597764-43597798,chr22,43597764,43597798,H1|chr22:20070958-20071039,chr22,20070958,20071039,0,23526806
H1|chr22:43599047-43599098,chr22,43599047,43599098,H1|chr22:38059190-38059287,chr22,38059190,38059287,0,5539857
H1|chr22:43889810-43889906,chr22,43889810,43889906,H1|chr22:20795182-20795240,chr22,20795182,20795240,0,23094628
H1|chr22:43992401-43992517,chr22,43992401,43992517,H1|chr22:20069975-20070055,chr22,20069975,20070055,0,23922426
H1|chr22:44013442-44013471,chr22,44013442,44013471,H1|chr22:18041583-18041694,chr22,18041583,18041694,0,25971859
H1|chr22:44516427-44516471,chr22,44516427,44516471,H1|chr22:40575355-40575435,chr22,40575355,40575435,0,3941072
H1|chr22:44676853-44676945,chr22,44676853,44676945,H1|chr22:20795182-20795240,chr22,20795182,20795240,0,23881671
H1|chr22:45017941-45018011,chr22,45017941,45018011,H1|chr22:41683574-41683718,chr22,41683574,41683718,0,3334367
H1|chr22:45173622-45173717,chr22,45173622,45173717,H1|chr22:18110998-18111051,chr22,18110998,18111051,0,27062624
H1|chr22:45186573-45186593,chr22,45186573,45186593,H1|chr22:38901101-38901225,chr22,38901101,38901225,0,6285472
H1|chr22:45319696-45319838,chr22,45319696,45319838,H1|chr22:35796916-35796966,chr22,35796916,35796966,0,9522780
H1|chr22:45384813-45384845,chr22,45384813,45384845,H1|chr22:18041949-18042017,chr22,18041949,18042017,0,27342864
H1|chr22:45879237-45879266,chr22,45879237,45879266,H1|chr22:18041583-18041694,chr22,18041583,18041694,0,27837654
H1|chr22:46069438-46069493,chr22,46069438,46069493,H1|chr22:33452357-33452452,chr22,33452357,33452452,0,12617081
H1|chr22:46464239-46464270,chr22,46464239,46464270,H1|chr22:33198237-33198306,chr22,33198237,33198306,0,13266002
H1|chr22:46976159-46976201,chr22,46976159,46976201,H1|chr22:38032599-38032707,chr22,38032599,38032707,0,8943560
H1|chr22:47406411-47406473,chr22,47406411,47406473,H1|chr22:18041949-18042017,chr22,18041949,18042017,0,29364462
H1|chr22:47985059-47985098,chr22,47985059,47985098,H1|chr22:45409835-45409946,chr22,45409835,45409946,0,2575224
H1|chr22:49064063-49064155,chr22,49064063,49064155,H1|chr22:20068566-20068597,chr22,20068566,20068597,0,28995497
H1|chr22:49512761-49512847,chr22,49512761,49512847,H1|chr22:42915405-42915469,chr22,42915405,42915469,0,6597356
H1|chr22:49588431-49588470,chr22,49588431,49588470,H1|chr22:42347900-42347973,chr22,42347900,42347973,0,7240531
H1|chr22:49671408-49671492,chr22,49671408,49671492,H1|chr22:42915551-42915665,chr22,42915551,42915665,0,6755857
H1|chr22:49686086-49686185,chr22,49686086,49686185,H1|chr22:33452357-33452452,chr22,33452357,33452452,0,16233729
H1|chr22:50032746-50032811,chr22,50032746,50032811,H1|chr22:46968534-46968585,chr22,46968534,46968585,0,3064212
H1|chr22:50178397-50178489,chr22,50178397,50178489,H1|chr22:20068566-20068597,chr22,20068566,20068597,0,30109831
H1|chr22:50397391-50397412,chr22,50397391,50397412,H1|chr22:20116238-20116348,chr22,20116238,20116348,0,30281153
H1|chr22:50664200-50664277,chr22,50664200,50664277,H1|chr22:42326715-42326788,chr22,42326715,42326788,0,8337485
H1|chr22:50683920-50684023,chr22,50683920,50684023,H1|chr22:45562692-45562734,chr22,45562692,45562734,0,5121228
H1|chr22:50778562-50778684,chr22,50778562,50778684,H1|chr22:38901180-38901330,chr22,38901180,38901330,0,11877382
H1|chr22:51132519-51132578,chr22,51132519,51132578,H1|chr22:51019673-51019770,chr22,51019673,51019770,0,112846
H1|chr22:51193296-51193313,chr22,51193296,51193313,H1|chr22:38214907-38214995,chr22,38214907,38214995,0,12978389
H1|chr22:51251949-51252026,chr22,51251949,51252026,H1|chr22:42326715-42326788,chr22,42326715,42326788,0,8925234
H1|chr22:51271432-51271571,chr22,51271432,51271571,H1|chr22:39053321-39053370,chr22,39053321,39053370,0,12218111
