enhancer_name,enhancer_chrom,enhancer_start,enhancer_end,promoter_name,promoter_chrom,promoter_start,promoter_end,label,enhancer_distance_to_promoter
HepG2|chr1:713410-713560,chr1,713410,713560,HepG2|chr1:224179571-224179669,chr1,224179571,224179669,1,223466161
HepG2|chr1:713504-713652,chr1,713504,713652,HepG2|chr1:224179593-224179669,chr1,224179593,224179669,1,223466089
HepG2|chr1:1441080-1441117,chr1,1441080,1441117,HepG2|chr1:1444611-1444761,chr1,1444611,1444761,1,3531
HepG2|chr1:1441080-1441116,chr1,1441080,1441116,HepG2|chr1:1444584-1444699,chr1,1444584,1444699,1,3504
HepG2|chr1:1441081-1441116,chr1,1441081,1441116,HepG2|chr1:1444584-1444699,chr1,1444584,1444699,1,3503
HepG2|chr1:1441084-1441116,chr1,1441084,1441116,HepG2|chr1:1444629-1444776,chr1,1444629,1444776,1,3545
HepG2|chr1:1441091-1441116,chr1,1441091,1441116,HepG2|chr1:1444584-1444691,chr1,1444584,1444691,1,3493
HepG2|chr1:1612236-1612268,chr1,1612236,1612268,HepG2|chr1:200634597-200634722,chr1,200634597,200634722,1,199022361
HepG2|chr1:1612236-1612266,chr1,1612236,1612266,HepG2|chr1:200634577-200634722,chr1,200634577,200634722,1,199022341
HepG2|chr1:1797137-1797157,chr1,1797137,1797157,HepG2|chr1:235321999-235322035,chr1,235321999,235322035,1,233524862
HepG2|chr1:1815587-1815714,chr1,1815587,1815714,HepG2|chr1:235323075-235323119,chr1,235323075,235323119,1,233507488
HepG2|chr1:1815596-1815699,chr1,1815596,1815699,HepG2|chr1:235323075-235323119,chr1,235323075,235323119,1,233507479
HepG2|chr1:3361907-3361969,chr1,3361907,3361969,HepG2|chr1:3370591-3370675,chr1,3370591,3370675,1,8684
HepG2|chr1:8801738-8801874,chr1,8801738,8801874,HepG2|chr1:226252827-226252953,chr1,226252827,226252953,1,217451089
HepG2|chr1:8801850-8801874,chr1,8801850,8801874,HepG2|chr1:226252827-226252953,chr1,226252827,226252953,1,217450977
HepG2|chr1:8933239-8933384,chr1,8933239,8933384,HepG2|chr1:8481219-8481269,chr1,8481219,8481269,1,452020
HepG2|chr1:9212092-9212226,chr1,9212092,9212226,HepG2|chr1:156022645-156022745,chr1,156022645,156022745,1,146810553
HepG2|chr1:9212179-9212226,chr1,9212179,9212226,HepG2|chr1:156022645-156022745,chr1,156022645,156022745,1,146810466
HepG2|chr1:9231879-9231996,chr1,9231879,9231996,HepG2|chr1:228656174-228656230,chr1,228656174,228656230,1,219424295
HepG2|chr1:9231897-9231982,chr1,9231897,9231982,HepG2|chr1:228656169-228656231,chr1,228656169,228656231,1,219424272
HepG2|chr1:10144869-10144922,chr1,10144869,10144922,HepG2|chr1:94345865-94345974,chr1,94345865,94345974,1,84200996
HepG2|chr1:10144895-10145011,chr1,10144895,10145011,HepG2|chr1:94345883-94345915,chr1,94345883,94345915,1,84200988
HepG2|chr1:12503495-12503578,chr1,12503495,12503578,HepG2|chr1:44174051-44174084,chr1,44174051,44174084,1,31670556
HepG2|chr1:12667416-12667545,chr1,12667416,12667545,HepG2|chr1:12678743-12678803,chr1,12678743,12678803,1,11327
HepG2|chr1:12667460-12667550,chr1,12667460,12667550,HepG2|chr1:12678743-12678803,chr1,12678743,12678803,1,11283
HepG2|chr1:12671687-12671776,chr1,12671687,12671776,HepG2|chr1:12677891-12677952,chr1,12677891,12677952,1,6204
HepG2|chr1:12671728-12671878,chr1,12671728,12671878,HepG2|chr1:12677891-12677952,chr1,12677891,12677952,1,6163
HepG2|chr1:15716568-15716628,chr1,15716568,15716628,HepG2|chr1:15939163-15939229,chr1,15939163,15939229,1,222595
HepG2|chr1:15716569-15716628,chr1,15716569,15716628,HepG2|chr1:15939163-15939229,chr1,15939163,15939229,1,222594
HepG2|chr1:16122436-16122462,chr1,16122436,16122462,HepG2|chr1:38467676-38467806,chr1,38467676,38467806,1,22345240
HepG2|chr1:16699963-16700070,chr1,16699963,16700070,HepG2|chr1:16352026-16352069,chr1,16352026,16352069,1,347937
HepG2|chr1:17024195-17024342,chr1,17024195,17024342,HepG2|chr1:6510867-6510920,chr1,6510867,6510920,1,10513328
HepG2|chr1:17026683-17026833,chr1,17026683,17026833,HepG2|chr1:6508384-6508421,chr1,6508384,6508421,1,10518299
HepG2|chr1:17027808-17027937,chr1,17027808,17027937,HepG2|chr1:6507209-6507238,chr1,6507209,6507238,1,10520599
HepG2|chr1:17027901-17027937,chr1,17027901,17027937,HepG2|chr1:6507200-6507255,chr1,6507200,6507255,1,10520701
HepG2|chr1:17196211-17196361,chr1,17196211,17196361,HepG2|chr1:16864537-16864687,chr1,16864537,16864687,1,331674
HepG2|chr1:17197780-17197930,chr1,17197780,17197930,HepG2|chr1:16862926-16863076,chr1,16862926,16863076,1,334854
HepG2|chr1:17198000-17198150,chr1,17198000,17198150,HepG2|chr1:16862660-16862810,chr1,16862660,16862810,1,335340
HepG2|chr1:17198215-17198365,chr1,17198215,17198365,HepG2|chr1:16862452-16862602,chr1,16862452,16862602,1,335763
HepG2|chr1:17198216-17198362,chr1,17198216,17198362,HepG2|chr1:16862446-16862593,chr1,16862446,16862593,1,335770
HepG2|chr1:17198220-17198370,chr1,17198220,17198370,HepG2|chr1:16862401-16862551,chr1,16862401,16862551,1,335819
HepG2|chr1:17198520-17198667,chr1,17198520,17198667,HepG2|chr1:16862336-16862486,chr1,16862336,16862486,1,336184
HepG2|chr1:17198522-17198672,chr1,17198522,17198672,HepG2|chr1:16862400-16862549,chr1,16862400,16862549,1,336122
HepG2|chr1:17198528-17198678,chr1,17198528,17198678,HepG2|chr1:16862395-16862545,chr1,16862395,16862545,1,336133
HepG2|chr1:17198548-17198697,chr1,17198548,17198697,HepG2|chr1:16862318-16862468,chr1,16862318,16862468,1,336230
HepG2|chr1:17198549-17198699,chr1,17198549,17198699,HepG2|chr1:16862336-16862479,chr1,16862336,16862479,1,336213
HepG2|chr1:17223977-17224049,chr1,17223977,17224049,HepG2|chr1:46154048-46154134,chr1,46154048,46154134,1,28930071
HepG2|chr1:17932611-17932680,chr1,17932611,17932680,HepG2|chr1:26561669-26561748,chr1,26561669,26561748,1,8629058
HepG2|chr1:17932614-17932684,chr1,17932614,17932684,HepG2|chr1:26561669-26561748,chr1,26561669,26561748,1,8629055
HepG2|chr1:21443149-21443194,chr1,21443149,21443194,HepG2|chr1:155176366-155176484,chr1,155176366,155176484,1,133733217
HepG2|chr1:21967063-21967213,chr1,21967063,21967213,HepG2|chr1:1282518-1282592,chr1,1282518,1282592,1,20684545
HepG2|chr1:22769484-22769634,chr1,22769484,22769634,HepG2|chr1:22775780-22775919,chr1,22775780,22775919,1,6296
HepG2|chr1:22771177-22771279,chr1,22771177,22771279,HepG2|chr1:22777902-22778052,chr1,22777902,22778052,1,6725
HepG2|chr1:23777503-23777521,chr1,23777503,23777521,HepG2|chr1:108229196-108229315,chr1,108229196,108229315,1,84451693
HepG2|chr1:25566272-25566372,chr1,25566272,25566372,HepG2|chr1:25561671-25561785,chr1,25561671,25561785,1,4601
HepG2|chr1:25566272-25566308,chr1,25566272,25566308,HepG2|chr1:25561671-25561785,chr1,25561671,25561785,1,4601
HepG2|chr1:25566300-25566400,chr1,25566300,25566400,HepG2|chr1:25560216-25560254,chr1,25560216,25560254,1,6084
HepG2|chr1:28906323-28906405,chr1,28906323,28906405,HepG2|chr1:173836015-173836065,chr1,173836015,173836065,1,144929692
HepG2|chr1:28907468-28907566,chr1,28907468,28907566,HepG2|chr1:173836015-173836066,chr1,173836015,173836066,1,144928547
HepG2|chr1:28907470-28907566,chr1,28907470,28907566,HepG2|chr1:173836015-173836066,chr1,173836015,173836066,1,144928545
HepG2|chr1:28975188-28975238,chr1,28975188,28975238,HepG2|chr1:3447363-3447490,chr1,3447363,3447490,1,25527825
HepG2|chr1:28975215-28975238,chr1,28975215,28975238,HepG2|chr1:3447363-3447490,chr1,3447363,3447490,1,25527852
HepG2|chr1:29081606-29081756,chr1,29081606,29081756,HepG2|chr1:22262450-22262469,chr1,22262450,22262469,1,6819156
HepG2|chr1:29081678-29081809,chr1,29081678,29081809,HepG2|chr1:22262450-22262469,chr1,22262450,22262469,1,6819228
HepG2|chr1:31448346-31448445,chr1,31448346,31448445,HepG2|chr1:31539734-31539777,chr1,31539734,31539777,1,91388
HepG2|chr1:31448389-31448458,chr1,31448389,31448458,HepG2|chr1:31539734-31539777,chr1,31539734,31539777,1,91345
HepG2|chr1:31448392-31448458,chr1,31448392,31448458,HepG2|chr1:31539734-31539777,chr1,31539734,31539777,1,91342
HepG2|chr1:32785552-32785702,chr1,32785552,32785702,HepG2|chr1:31383174-31383204,chr1,31383174,31383204,1,1402378
HepG2|chr1:32785596-32785746,chr1,32785596,32785746,HepG2|chr1:31383170-31383204,chr1,31383170,31383204,1,1402426
HepG2|chr1:32785710-32785820,chr1,32785710,32785820,HepG2|chr1:31383170-31383203,chr1,31383170,31383203,1,1402540
HepG2|chr1:33190678-33190818,chr1,33190678,33190818,HepG2|chr1:33171343-33171466,chr1,33171343,33171466,1,19335
HepG2|chr1:33190678-33190808,chr1,33190678,33190808,HepG2|chr1:33171355-33171466,chr1,33171355,33171466,1,19323
HepG2|chr1:33190678-33190791,chr1,33190678,33190791,HepG2|chr1:33171400-33171466,chr1,33171400,33171466,1,19278
HepG2|chr1:33190678-33190772,chr1,33190678,33190772,HepG2|chr1:33170035-33170182,chr1,33170035,33170182,1,20643
HepG2|chr1:33190678-33190770,chr1,33190678,33190770,HepG2|chr1:33170116-33170180,chr1,33170116,33170180,1,20562
HepG2|chr1:33190678-33190765,chr1,33190678,33190765,HepG2|chr1:33171403-33171466,chr1,33171403,33171466,1,19275
HepG2|chr1:33190678-33190764,chr1,33190678,33190764,HepG2|chr1:33170116-33170180,chr1,33170116,33170180,1,20562
HepG2|chr1:33190678-33190761,chr1,33190678,33190761,HepG2|chr1:33171400-33171466,chr1,33171400,33171466,1,19278
HepG2|chr1:33190678-33190744,chr1,33190678,33190744,HepG2|chr1:33171977-33172061,chr1,33171977,33172061,1,18701
HepG2|chr1:33190678-33190740,chr1,33190678,33190740,HepG2|chr1:33170050-33170200,chr1,33170050,33170200,1,20628
HepG2|chr1:33190678-33190717,chr1,33190678,33190717,HepG2|chr1:33171355-33171466,chr1,33171355,33171466,1,19323
HepG2|chr1:33190678-33190715,chr1,33190678,33190715,HepG2|chr1:33170057-33170180,chr1,33170057,33170180,1,20621
HepG2|chr1:33190678-33190711,chr1,33190678,33190711,HepG2|chr1:33171928-33172064,chr1,33171928,33172064,1,18750
HepG2|chr1:33190678-33190705,chr1,33190678,33190705,HepG2|chr1:33171343-33171466,chr1,33171343,33171466,1,19335
HepG2|chr1:33190678-33190698,chr1,33190678,33190698,HepG2|chr1:33170071-33170180,chr1,33170071,33170180,1,20607
HepG2|chr1:33190693-33190841,chr1,33190693,33190841,HepG2|chr1:33171403-33171466,chr1,33171403,33171466,1,19290
HepG2|chr1:36702913-36703063,chr1,36702913,36703063,HepG2|chr1:28992994-28993050,chr1,28992994,28993050,1,7709919
HepG2|chr1:36702936-36703069,chr1,36702936,36703069,HepG2|chr1:28992994-28993050,chr1,28992994,28993050,1,7709942
HepG2|chr1:36702982-36703088,chr1,36702982,36703088,HepG2|chr1:28992994-28993052,chr1,28992994,28993052,1,7709988
HepG2|chr1:36702984-36703088,chr1,36702984,36703088,HepG2|chr1:28992994-28993050,chr1,28992994,28993050,1,7709990
HepG2|chr1:36841437-36841477,chr1,36841437,36841477,HepG2|chr1:36686019-36686091,chr1,36686019,36686091,1,155418
HepG2|chr1:36841437-36841474,chr1,36841437,36841474,HepG2|chr1:36686019-36686091,chr1,36686019,36686091,1,155418
HepG2|chr1:37986325-37986411,chr1,37986325,37986411,HepG2|chr1:37982301-37982365,chr1,37982301,37982365,1,4024
HepG2|chr1:37986325-37986406,chr1,37986325,37986406,HepG2|chr1:37982296-37982365,chr1,37982296,37982365,1,4029
HepG2|chr1:37986325-37986403,chr1,37986325,37986403,HepG2|chr1:37982293-37982365,chr1,37982293,37982365,1,4032
HepG2|chr1:39863211-39863340,chr1,39863211,39863340,HepG2|chr1:204042325-204042449,chr1,204042325,204042449,1,164179114
HepG2|chr1:39863314-39863340,chr1,39863314,39863340,HepG2|chr1:204042325-204042449,chr1,204042325,204042449,1,164179011
HepG2|chr1:39975960-39976110,chr1,39975960,39976110,HepG2|chr1:40241552-40241702,chr1,40241552,40241702,1,265592
HepG2|chr1:39975976-39976120,chr1,39975976,39976120,HepG2|chr1:40241541-40241691,chr1,40241541,40241691,1,265565
HepG2|chr1:39979304-39979451,chr1,39979304,39979451,HepG2|chr1:40238414-40238466,chr1,40238414,40238466,1,259110
HepG2|chr1:39979345-39979495,chr1,39979345,39979495,HepG2|chr1:40237903-40238050,chr1,40237903,40238050,1,258558
HepG2|chr1:39979370-39979517,chr1,39979370,39979517,HepG2|chr1:40237931-40238081,chr1,40237931,40238081,1,258561
HepG2|chr1:39979370-39979507,chr1,39979370,39979507,HepG2|chr1:40237931-40238081,chr1,40237931,40238081,1,258561
HepG2|chr1:39979382-39979532,chr1,39979382,39979532,HepG2|chr1:40237903-40238050,chr1,40237903,40238050,1,258521
HepG2|chr1:39980432-39980581,chr1,39980432,39980581,HepG2|chr1:40237084-40237234,chr1,40237084,40237234,1,256652
HepG2|chr1:39980437-39980568,chr1,39980437,39980568,HepG2|chr1:40236986-40237117,chr1,40236986,40237117,1,256549
HepG2|chr1:39980438-39980588,chr1,39980438,39980588,HepG2|chr1:40237007-40237154,chr1,40237007,40237154,1,256569
HepG2|chr1:39980444-39980594,chr1,39980444,39980594,HepG2|chr1:40237097-40237243,chr1,40237097,40237243,1,256653
HepG2|chr1:39980446-39980596,chr1,39980446,39980596,HepG2|chr1:40237007-40237154,chr1,40237007,40237154,1,256561
HepG2|chr1:45259102-45259202,chr1,45259102,45259202,HepG2|chr1:45255492-45255566,chr1,45255492,45255566,1,3610
HepG2|chr1:45259102-45259178,chr1,45259102,45259178,HepG2|chr1:45255492-45255566,chr1,45255492,45255566,1,3610
HepG2|chr1:47846578-47846657,chr1,47846578,47846657,HepG2|chr1:47875353-47875478,chr1,47875353,47875478,1,28775
HepG2|chr1:47846789-47846815,chr1,47846789,47846815,HepG2|chr1:47875353-47875426,chr1,47875353,47875426,1,28564
HepG2|chr1:52158225-52158327,chr1,52158225,52158327,HepG2|chr1:78149986-78150012,chr1,78149986,78150012,1,25991761
HepG2|chr1:52158225-52158321,chr1,52158225,52158321,HepG2|chr1:78149986-78150012,chr1,78149986,78150012,1,25991761
HepG2|chr1:52158225-52158317,chr1,52158225,52158317,HepG2|chr1:78149986-78150012,chr1,78149986,78150012,1,25991761
HepG2|chr1:54816672-54816809,chr1,54816672,54816809,HepG2|chr1:70669737-70669760,chr1,70669737,70669760,1,15853065
HepG2|chr1:54816672-54816799,chr1,54816672,54816799,HepG2|chr1:70669737-70669760,chr1,70669737,70669760,1,15853065
HepG2|chr1:59812676-59812785,chr1,59812676,59812785,HepG2|chr1:100805718-100805865,chr1,100805718,100805865,1,40993042
HepG2|chr1:59812676-59812768,chr1,59812676,59812768,HepG2|chr1:100805718-100805865,chr1,100805718,100805865,1,40993042
HepG2|chr1:59812681-59812774,chr1,59812681,59812774,HepG2|chr1:100805718-100805865,chr1,100805718,100805865,1,40993037
HepG2|chr1:61592245-61592368,chr1,61592245,61592368,HepG2|chr1:208429975-208429992,chr1,208429975,208429992,1,146837730
HepG2|chr1:63193779-63193873,chr1,63193779,63193873,HepG2|chr1:63156650-63156800,chr1,63156650,63156800,1,37129
HepG2|chr1:63196668-63196783,chr1,63196668,63196783,HepG2|chr1:63154356-63154395,chr1,63154356,63154395,1,42312
HepG2|chr1:63196668-63196776,chr1,63196668,63196776,HepG2|chr1:63154356-63154395,chr1,63154356,63154395,1,42312
HepG2|chr1:63196668-63196775,chr1,63196668,63196775,HepG2|chr1:63154356-63154395,chr1,63154356,63154395,1,42312
HepG2|chr1:67527016-67527134,chr1,67527016,67527134,HepG2|chr1:67520773-67520846,chr1,67520773,67520846,1,6243
HepG2|chr1:85956756-85956906,chr1,85956756,85956906,HepG2|chr1:86043986-86044033,chr1,86043986,86044033,1,87230
HepG2|chr1:85956823-85956926,chr1,85956823,85956926,HepG2|chr1:86043986-86044033,chr1,86043986,86044033,1,87163
HepG2|chr1:85956824-85956926,chr1,85956824,85956926,HepG2|chr1:86043986-86044033,chr1,86043986,86044033,1,87162
HepG2|chr1:89500476-89500512,chr1,89500476,89500512,HepG2|chr1:89488300-89488389,chr1,89488300,89488389,1,12176
HepG2|chr1:92284194-92284216,chr1,92284194,92284216,HepG2|chr1:152008220-152008370,chr1,152008220,152008370,1,59724026
HepG2|chr1:93249740-93249794,chr1,93249740,93249794,HepG2|chr1:148556876-148556965,chr1,148556876,148556965,1,55307136
HepG2|chr1:93249740-93249776,chr1,93249740,93249776,HepG2|chr1:148556876-148556958,chr1,148556876,148556958,1,55307136
HepG2|chr1:93249740-93249767,chr1,93249740,93249767,HepG2|chr1:148556876-148556962,chr1,148556876,148556962,1,55307136
HepG2|chr1:93249747-93249776,chr1,93249747,93249776,HepG2|chr1:148556876-148556958,chr1,148556876,148556958,1,55307129
HepG2|chr1:93249747-93249767,chr1,93249747,93249767,HepG2|chr1:148556876-148556962,chr1,148556876,148556962,1,55307129
HepG2|chr1:93249747-93249765,chr1,93249747,93249765,HepG2|chr1:148556910-148557060,chr1,148556910,148557060,1,55307163
HepG2|chr1:93250362-93250386,chr1,93250362,93250386,HepG2|chr1:148556690-148556810,chr1,148556690,148556810,1,55306328
HepG2|chr1:93250362-93250384,chr1,93250362,93250384,HepG2|chr1:148556690-148556797,chr1,148556690,148556797,1,55306328
HepG2|chr1:93250362-93250383,chr1,93250362,93250383,HepG2|chr1:148556690-148556716,chr1,148556690,148556716,1,55306328
HepG2|chr1:109642825-109642900,chr1,109642825,109642900,HepG2|chr1:220443804-220443954,chr1,220443804,220443954,1,110800979
HepG2|chr1:109642953-109642990,chr1,109642953,109642990,HepG2|chr1:179197937-179198050,chr1,179197937,179198050,1,69554984
HepG2|chr1:109642956-109643052,chr1,109642956,109643052,HepG2|chr1:179197937-179198050,chr1,179197937,179198050,1,69554981
HepG2|chr1:109843492-109843580,chr1,109843492,109843580,HepG2|chr1:109851507-109851569,chr1,109851507,109851569,1,8015
HepG2|chr1:109843492-109843579,chr1,109843492,109843579,HepG2|chr1:109851507-109851569,chr1,109851507,109851569,1,8015
HepG2|chr1:109843496-109843643,chr1,109843496,109843643,HepG2|chr1:109851507-109851569,chr1,109851507,109851569,1,8011
HepG2|chr1:110892849-110892939,chr1,110892849,110892939,HepG2|chr1:155108716-155108772,chr1,155108716,155108772,1,44215867
HepG2|chr1:120170345-120170439,chr1,120170345,120170439,HepG2|chr1:120190693-120190749,chr1,120190693,120190749,1,20348
HepG2|chr1:120170355-120170444,chr1,120170355,120170444,HepG2|chr1:120190693-120190752,chr1,120190693,120190752,1,20338
HepG2|chr1:120170358-120170444,chr1,120170358,120170444,HepG2|chr1:120190693-120190752,chr1,120190693,120190752,1,20335
HepG2|chr1:120170378-120170444,chr1,120170378,120170444,HepG2|chr1:120190693-120190774,chr1,120190693,120190774,1,20315
HepG2|chr1:120180287-120180437,chr1,120180287,120180437,HepG2|chr1:120190693-120190764,chr1,120190693,120190764,1,10406
HepG2|chr1:120180375-120180440,chr1,120180375,120180440,HepG2|chr1:120190693-120190823,chr1,120190693,120190823,1,10318
HepG2|chr1:120180379-120180440,chr1,120180379,120180440,HepG2|chr1:120190751-120190897,chr1,120190751,120190897,1,10372
HepG2|chr1:120180380-120180440,chr1,120180380,120180440,HepG2|chr1:120190693-120190802,chr1,120190693,120190802,1,10313
HepG2|chr1:120180389-120180440,chr1,120180389,120180440,HepG2|chr1:120190693-120190815,chr1,120190693,120190815,1,10304
HepG2|chr1:120180399-120180440,chr1,120180399,120180440,HepG2|chr1:120190693-120190802,chr1,120190693,120190802,1,10294
HepG2|chr1:120180412-120180440,chr1,120180412,120180440,HepG2|chr1:120190693-120190815,chr1,120190693,120190815,1,10281
HepG2|chr1:120764778-120764886,chr1,120764778,120764886,HepG2|chr1:8762439-8762459,chr1,8762439,8762459,1,112002339
HepG2|chr1:144592661-144592704,chr1,144592661,144592704,HepG2|chr1:148556691-148556777,chr1,148556691,148556777,1,3964030
HepG2|chr1:144593633-144593721,chr1,144593633,144593721,HepG2|chr1:148555829-148555979,chr1,148555829,148555979,1,3962196
HepG2|chr1:144593643-144593721,chr1,144593643,144593721,HepG2|chr1:148555857-148556007,chr1,148555857,148556007,1,3962214
HepG2|chr1:144593651-144593721,chr1,144593651,144593721,HepG2|chr1:148555862-148556009,chr1,148555862,148556009,1,3962211
HepG2|chr1:144593696-144593721,chr1,144593696,144593721,HepG2|chr1:148555829-148555979,chr1,148555829,148555979,1,3962133
HepG2|chr1:144593698-144593721,chr1,144593698,144593721,HepG2|chr1:148556134-148556180,chr1,148556134,148556180,1,3962436
HepG2|chr1:144593706-144593853,chr1,144593706,144593853,HepG2|chr1:148556090-148556240,chr1,148556090,148556240,1,3962384
HepG2|chr1:144593721-144593871,chr1,144593721,144593871,HepG2|chr1:148556132-148556180,chr1,148556132,148556180,1,3962411
HepG2|chr1:144593721-144593870,chr1,144593721,144593870,HepG2|chr1:148556135-148556180,chr1,148556135,148556180,1,3962414
HepG2|chr1:144593721-144593866,chr1,144593721,144593866,HepG2|chr1:148556133-148556180,chr1,148556133,148556180,1,3962412
HepG2|chr1:144593721-144593863,chr1,144593721,144593863,HepG2|chr1:148556130-148556180,chr1,148556130,148556180,1,3962409
HepG2|chr1:144593721-144593861,chr1,144593721,144593861,HepG2|chr1:148555903-148556027,chr1,148555903,148556027,1,3962182
HepG2|chr1:144593721-144593860,chr1,144593721,144593860,HepG2|chr1:148556180-148556314,chr1,148556180,148556314,1,3962459
HepG2|chr1:144593721-144593856,chr1,144593721,144593856,HepG2|chr1:148556147-148556180,chr1,148556147,148556180,1,3962426
HepG2|chr1:144593721-144593855,chr1,144593721,144593855,HepG2|chr1:148556135-148556180,chr1,148556135,148556180,1,3962414
HepG2|chr1:144593721-144593854,chr1,144593721,144593854,HepG2|chr1:148556130-148556180,chr1,148556130,148556180,1,3962409
HepG2|chr1:144593721-144593848,chr1,144593721,144593848,HepG2|chr1:148556134-148556180,chr1,148556134,148556180,1,3962413
HepG2|chr1:144593721-144593838,chr1,144593721,144593838,HepG2|chr1:148556214-148556357,chr1,148556214,148556357,1,3962493
HepG2|chr1:144593721-144593836,chr1,144593721,144593836,HepG2|chr1:148556143-148556180,chr1,148556143,148556180,1,3962422
HepG2|chr1:144593721-144593831,chr1,144593721,144593831,HepG2|chr1:148555906-148556027,chr1,148555906,148556027,1,3962185
HepG2|chr1:144593721-144593819,chr1,144593721,144593819,HepG2|chr1:148556180-148556314,chr1,148556180,148556314,1,3962459
HepG2|chr1:144593721-144593810,chr1,144593721,144593810,HepG2|chr1:148556180-148556325,chr1,148556180,148556325,1,3962459
HepG2|chr1:144593721-144593803,chr1,144593721,144593803,HepG2|chr1:148556135-148556180,chr1,148556135,148556180,1,3962414
HepG2|chr1:144593722-144593872,chr1,144593722,144593872,HepG2|chr1:148556141-148556180,chr1,148556141,148556180,1,3962419
HepG2|chr1:144593723-144593873,chr1,144593723,144593873,HepG2|chr1:148556140-148556180,chr1,148556140,148556180,1,3962417
HepG2|chr1:144593723-144593836,chr1,144593723,144593836,HepG2|chr1:148556154-148556180,chr1,148556154,148556180,1,3962431
HepG2|chr1:144593725-144593875,chr1,144593725,144593875,HepG2|chr1:148556122-148556180,chr1,148556122,148556180,1,3962397
HepG2|chr1:144593726-144593875,chr1,144593726,144593875,HepG2|chr1:148556134-148556180,chr1,148556134,148556180,1,3962408
HepG2|chr1:144593728-144593875,chr1,144593728,144593875,HepG2|chr1:148556691-148556710,chr1,148556691,148556710,1,3962963
HepG2|chr1:144593729-144593765,chr1,144593729,144593765,HepG2|chr1:148556132-148556180,chr1,148556132,148556180,1,3962403
HepG2|chr1:144593734-144593875,chr1,144593734,144593875,HepG2|chr1:148556201-148556351,chr1,148556201,148556351,1,3962467
HepG2|chr1:144593737-144593875,chr1,144593737,144593875,HepG2|chr1:148556123-148556180,chr1,148556123,148556180,1,3962386
HepG2|chr1:144593737-144593836,chr1,144593737,144593836,HepG2|chr1:148556180-148556314,chr1,148556180,148556314,1,3962443
HepG2|chr1:144593739-144593875,chr1,144593739,144593875,HepG2|chr1:148556180-148556330,chr1,148556180,148556330,1,3962441
HepG2|chr1:144593739-144593836,chr1,144593739,144593836,HepG2|chr1:148556143-148556180,chr1,148556143,148556180,1,3962404
HepG2|chr1:144593740-144593875,chr1,144593740,144593875,HepG2|chr1:148556217-148556367,chr1,148556217,148556367,1,3962477
HepG2|chr1:144593740-144593836,chr1,144593740,144593836,HepG2|chr1:148556180-148556316,chr1,148556180,148556316,1,3962440
HepG2|chr1:144593741-144593875,chr1,144593741,144593875,HepG2|chr1:148556130-148556180,chr1,148556130,148556180,1,3962389
HepG2|chr1:144593743-144593836,chr1,144593743,144593836,HepG2|chr1:148556691-148556777,chr1,148556691,148556777,1,3962948
HepG2|chr1:144593744-144593875,chr1,144593744,144593875,HepG2|chr1:148556133-148556180,chr1,148556133,148556180,1,3962389
HepG2|chr1:144593744-144593836,chr1,144593744,144593836,HepG2|chr1:148556144-148556180,chr1,148556144,148556180,1,3962400
HepG2|chr1:144593747-144593875,chr1,144593747,144593875,HepG2|chr1:148556130-148556180,chr1,148556130,148556180,1,3962383
HepG2|chr1:144593749-144593836,chr1,144593749,144593836,HepG2|chr1:148556153-148556180,chr1,148556153,148556180,1,3962404
HepG2|chr1:144593749-144593819,chr1,144593749,144593819,HepG2|chr1:148556204-148556354,chr1,148556204,148556354,1,3962455
HepG2|chr1:144593749-144593818,chr1,144593749,144593818,HepG2|chr1:148556208-148556354,chr1,148556208,148556354,1,3962459
HepG2|chr1:144593752-144593836,chr1,144593752,144593836,HepG2|chr1:148556209-148556359,chr1,148556209,148556359,1,3962457
HepG2|chr1:144593754-144593836,chr1,144593754,144593836,HepG2|chr1:148556143-148556180,chr1,148556143,148556180,1,3962389
HepG2|chr1:144593755-144593873,chr1,144593755,144593873,HepG2|chr1:148556061-148556120,chr1,148556061,148556120,1,3962306
HepG2|chr1:144593755-144593836,chr1,144593755,144593836,HepG2|chr1:148556191-148556341,chr1,148556191,148556341,1,3962436
HepG2|chr1:144593757-144593836,chr1,144593757,144593836,HepG2|chr1:148556691-148556738,chr1,148556691,148556738,1,3962934
HepG2|chr1:144593761-144593874,chr1,144593761,144593874,HepG2|chr1:148556133-148556180,chr1,148556133,148556180,1,3962372
HepG2|chr1:144593761-144593836,chr1,144593761,144593836,HepG2|chr1:148556691-148556783,chr1,148556691,148556783,1,3962930
HepG2|chr1:144593763-144593874,chr1,144593763,144593874,HepG2|chr1:148556133-148556180,chr1,148556133,148556180,1,3962370
HepG2|chr1:144593766-144593874,chr1,144593766,144593874,HepG2|chr1:148556153-148556180,chr1,148556153,148556180,1,3962387
HepG2|chr1:144593767-144593874,chr1,144593767,144593874,HepG2|chr1:148556132-148556180,chr1,148556132,148556180,1,3962365
HepG2|chr1:144593772-144593875,chr1,144593772,144593875,HepG2|chr1:148556134-148556180,chr1,148556134,148556180,1,3962362
HepG2|chr1:144593772-144593874,chr1,144593772,144593874,HepG2|chr1:148556130-148556180,chr1,148556130,148556180,1,3962358
HepG2|chr1:144593774-144593874,chr1,144593774,144593874,HepG2|chr1:148556691-148556711,chr1,148556691,148556711,1,3962917
HepG2|chr1:144593775-144593874,chr1,144593775,144593874,HepG2|chr1:148556136-148556180,chr1,148556136,148556180,1,3962361
HepG2|chr1:144593776-144593874,chr1,144593776,144593874,HepG2|chr1:148556134-148556180,chr1,148556134,148556180,1,3962358
HepG2|chr1:144593777-144593874,chr1,144593777,144593874,HepG2|chr1:148556134-148556180,chr1,148556134,148556180,1,3962357
HepG2|chr1:144593778-144593875,chr1,144593778,144593875,HepG2|chr1:148556691-148556777,chr1,148556691,148556777,1,3962913
HepG2|chr1:144593778-144593874,chr1,144593778,144593874,HepG2|chr1:148556122-148556180,chr1,148556122,148556180,1,3962344
HepG2|chr1:144593781-144593875,chr1,144593781,144593875,HepG2|chr1:148556155-148556180,chr1,148556155,148556180,1,3962374
HepG2|chr1:144593785-144593875,chr1,144593785,144593875,HepG2|chr1:148556135-148556180,chr1,148556135,148556180,1,3962350
HepG2|chr1:144593785-144593874,chr1,144593785,144593874,HepG2|chr1:148556153-148556180,chr1,148556153,148556180,1,3962368
HepG2|chr1:144593786-144593875,chr1,144593786,144593875,HepG2|chr1:148556691-148556733,chr1,148556691,148556733,1,3962905
HepG2|chr1:144593788-144593875,chr1,144593788,144593875,HepG2|chr1:148556135-148556180,chr1,148556135,148556180,1,3962347
HepG2|chr1:144593793-144593874,chr1,144593793,144593874,HepG2|chr1:148556212-148556358,chr1,148556212,148556358,1,3962419
HepG2|chr1:144593794-144593874,chr1,144593794,144593874,HepG2|chr1:148556154-148556180,chr1,148556154,148556180,1,3962360
HepG2|chr1:144593795-144593875,chr1,144593795,144593875,HepG2|chr1:148556133-148556180,chr1,148556133,148556180,1,3962338
HepG2|chr1:144593795-144593874,chr1,144593795,144593874,HepG2|chr1:148556135-148556180,chr1,148556135,148556180,1,3962340
HepG2|chr1:144593796-144593874,chr1,144593796,144593874,HepG2|chr1:148556132-148556180,chr1,148556132,148556180,1,3962336
HepG2|chr1:144593797-144593874,chr1,144593797,144593874,HepG2|chr1:148556206-148556353,chr1,148556206,148556353,1,3962409
HepG2|chr1:144593798-144593875,chr1,144593798,144593875,HepG2|chr1:148556132-148556180,chr1,148556132,148556180,1,3962334
HepG2|chr1:144593798-144593874,chr1,144593798,144593874,HepG2|chr1:148556153-148556180,chr1,148556153,148556180,1,3962355
HepG2|chr1:144593801-144593875,chr1,144593801,144593875,HepG2|chr1:148556132-148556180,chr1,148556132,148556180,1,3962331
HepG2|chr1:144593802-144593937,chr1,144593802,144593937,HepG2|chr1:148556691-148556711,chr1,148556691,148556711,1,3962889
HepG2|chr1:144593802-144593875,chr1,144593802,144593875,HepG2|chr1:148556465-148556515,chr1,148556465,148556515,1,3962663
HepG2|chr1:144593803-144593875,chr1,144593803,144593875,HepG2|chr1:148556203-148556353,chr1,148556203,148556353,1,3962400
HepG2|chr1:144593804-144593875,chr1,144593804,144593875,HepG2|chr1:148556132-148556180,chr1,148556132,148556180,1,3962328
HepG2|chr1:144593806-144593875,chr1,144593806,144593875,HepG2|chr1:148556133-148556180,chr1,148556133,148556180,1,3962327
HepG2|chr1:144593806-144593873,chr1,144593806,144593873,HepG2|chr1:148556148-148556180,chr1,148556148,148556180,1,3962342
HepG2|chr1:144593807-144593956,chr1,144593807,144593956,HepG2|chr1:148556045-148556170,chr1,148556045,148556170,1,3962238
HepG2|chr1:144593807-144593875,chr1,144593807,144593875,HepG2|chr1:148556141-148556180,chr1,148556141,148556180,1,3962334
HepG2|chr1:144593808-144593875,chr1,144593808,144593875,HepG2|chr1:148556180-148556293,chr1,148556180,148556293,1,3962372
HepG2|chr1:144593809-144593875,chr1,144593809,144593875,HepG2|chr1:148556132-148556180,chr1,148556132,148556180,1,3962323
HepG2|chr1:144593811-144593875,chr1,144593811,144593875,HepG2|chr1:148556132-148556180,chr1,148556132,148556180,1,3962321
HepG2|chr1:144593811-144593874,chr1,144593811,144593874,HepG2|chr1:148556132-148556180,chr1,148556132,148556180,1,3962321
HepG2|chr1:144593829-144593875,chr1,144593829,144593875,HepG2|chr1:148556135-148556180,chr1,148556135,148556180,1,3962306
HepG2|chr1:144593832-144593875,chr1,144593832,144593875,HepG2|chr1:148556691-148556773,chr1,148556691,148556773,1,3962859
HepG2|chr1:144593832-144593874,chr1,144593832,144593874,HepG2|chr1:148556202-148556273,chr1,148556202,148556273,1,3962370
HepG2|chr1:144593837-144593875,chr1,144593837,144593875,HepG2|chr1:148556143-148556180,chr1,148556143,148556180,1,3962306
HepG2|chr1:144593843-144593875,chr1,144593843,144593875,HepG2|chr1:148556149-148556180,chr1,148556149,148556180,1,3962306
HepG2|chr1:144593846-144593875,chr1,144593846,144593875,HepG2|chr1:148556153-148556180,chr1,148556153,148556180,1,3962307
HepG2|chr1:144593850-144593875,chr1,144593850,144593875,HepG2|chr1:148556210-148556360,chr1,148556210,148556360,1,3962360
HepG2|chr1:144593851-144593875,chr1,144593851,144593875,HepG2|chr1:148556138-148556180,chr1,148556138,148556180,1,3962287
HepG2|chr1:144593852-144593875,chr1,144593852,144593875,HepG2|chr1:148556206-148556353,chr1,148556206,148556353,1,3962354
HepG2|chr1:144593854-144593875,chr1,144593854,144593875,HepG2|chr1:148556210-148556360,chr1,148556210,148556360,1,3962356
HepG2|chr1:144593855-144593875,chr1,144593855,144593875,HepG2|chr1:148556195-148556345,chr1,148556195,148556345,1,3962340
HepG2|chr1:144593856-144593875,chr1,144593856,144593875,HepG2|chr1:148556198-148556348,chr1,148556198,148556348,1,3962342
HepG2|chr1:144593857-144593875,chr1,144593857,144593875,HepG2|chr1:148556204-148556354,chr1,148556204,148556354,1,3962347
HepG2|chr1:144593858-144593875,chr1,144593858,144593875,HepG2|chr1:148556364-148556420,chr1,148556364,148556420,1,3962506
HepG2|chr1:144593911-144594061,chr1,144593911,144594061,HepG2|chr1:148556370-148556423,chr1,148556370,148556423,1,3962459
HepG2|chr1:144594010-144594160,chr1,144594010,144594160,HepG2|chr1:148556478-148556628,chr1,148556478,148556628,1,3962468
HepG2|chr1:144594029-144594176,chr1,144594029,144594176,HepG2|chr1:148556264-148556413,chr1,148556264,148556413,1,3962235
HepG2|chr1:144594029-144594155,chr1,144594029,144594155,HepG2|chr1:148556202-148556349,chr1,148556202,148556349,1,3962173
HepG2|chr1:144594030-144594180,chr1,144594030,144594180,HepG2|chr1:148556464-148556614,chr1,148556464,148556614,1,3962434
HepG2|chr1:144594033-144594183,chr1,144594033,144594183,HepG2|chr1:148556466-148556616,chr1,148556466,148556616,1,3962433
HepG2|chr1:144594040-144594186,chr1,144594040,144594186,HepG2|chr1:148556272-148556422,chr1,148556272,148556422,1,3962232
HepG2|chr1:144594045-144594195,chr1,144594045,144594195,HepG2|chr1:148556567-148556717,chr1,148556567,148556717,1,3962522
HepG2|chr1:144594049-144594194,chr1,144594049,144594194,HepG2|chr1:148556504-148556654,chr1,148556504,148556654,1,3962455
HepG2|chr1:144594055-144594149,chr1,144594055,144594149,HepG2|chr1:148556350-148556382,chr1,148556350,148556382,1,3962295
HepG2|chr1:144594056-144594203,chr1,144594056,144594203,HepG2|chr1:148556474-148556623,chr1,148556474,148556623,1,3962418
HepG2|chr1:144594056-144594186,chr1,144594056,144594186,HepG2|chr1:148556363-148556407,chr1,148556363,148556407,1,3962307
HepG2|chr1:144594057-144594202,chr1,144594057,144594202,HepG2|chr1:148556466-148556616,chr1,148556466,148556616,1,3962409
HepG2|chr1:144594057-144594170,chr1,144594057,144594170,HepG2|chr1:148556466-148556616,chr1,148556466,148556616,1,3962409
HepG2|chr1:144594058-144594208,chr1,144594058,144594208,HepG2|chr1:148556215-148556365,chr1,148556215,148556365,1,3962157
HepG2|chr1:144594059-144594204,chr1,144594059,144594204,HepG2|chr1:148556503-148556650,chr1,148556503,148556650,1,3962444
HepG2|chr1:144594059-144594186,chr1,144594059,144594186,HepG2|chr1:148556272-148556422,chr1,148556272,148556422,1,3962213
HepG2|chr1:144594060-144594210,chr1,144594060,144594210,HepG2|chr1:148556502-148556644,chr1,148556502,148556644,1,3962442
HepG2|chr1:144594061-144594211,chr1,144594061,144594211,HepG2|chr1:148556319-148556377,chr1,148556319,148556377,1,3962258
HepG2|chr1:144594062-144594211,chr1,144594062,144594211,HepG2|chr1:148556180-148556323,chr1,148556180,148556323,1,3962118
HepG2|chr1:144594062-144594209,chr1,144594062,144594209,HepG2|chr1:148556287-148556434,chr1,148556287,148556434,1,3962225
HepG2|chr1:144594062-144594176,chr1,144594062,144594176,HepG2|chr1:148556180-148556318,chr1,148556180,148556318,1,3962118
HepG2|chr1:144594062-144594149,chr1,144594062,144594149,HepG2|chr1:148556180-148556325,chr1,148556180,148556325,1,3962118
HepG2|chr1:144594063-144594211,chr1,144594063,144594211,HepG2|chr1:148556183-148556331,chr1,148556183,148556331,1,3962120
HepG2|chr1:144594063-144594195,chr1,144594063,144594195,HepG2|chr1:148556217-148556367,chr1,148556217,148556367,1,3962154
HepG2|chr1:144594063-144594157,chr1,144594063,144594157,HepG2|chr1:148556276-148556426,chr1,148556276,148556426,1,3962213
HepG2|chr1:144594063-144594149,chr1,144594063,144594149,HepG2|chr1:148556202-148556349,chr1,148556202,148556349,1,3962139
HepG2|chr1:144594064-144594214,chr1,144594064,144594214,HepG2|chr1:148556464-148556614,chr1,148556464,148556614,1,3962400
HepG2|chr1:144594064-144594211,chr1,144594064,144594211,HepG2|chr1:148556216-148556366,chr1,148556216,148556366,1,3962152
HepG2|chr1:144594064-144594209,chr1,144594064,144594209,HepG2|chr1:148556319-148556398,chr1,148556319,148556398,1,3962255
HepG2|chr1:144594065-144594215,chr1,144594065,144594215,HepG2|chr1:148556296-148556443,chr1,148556296,148556443,1,3962231
HepG2|chr1:144594068-144594217,chr1,144594068,144594217,HepG2|chr1:148556562-148556709,chr1,148556562,148556709,1,3962494
HepG2|chr1:144594068-144594216,chr1,144594068,144594216,HepG2|chr1:148556230-148556380,chr1,148556230,148556380,1,3962162
HepG2|chr1:144594068-144594215,chr1,144594068,144594215,HepG2|chr1:148556143-148556180,chr1,148556143,148556180,1,3962075
HepG2|chr1:144594068-144594214,chr1,144594068,144594214,HepG2|chr1:148556288-148556366,chr1,148556288,148556366,1,3962220
HepG2|chr1:144594068-144594212,chr1,144594068,144594212,HepG2|chr1:148556230-148556380,chr1,148556230,148556380,1,3962162
HepG2|chr1:144594068-144594211,chr1,144594068,144594211,HepG2|chr1:148556286-148556366,chr1,148556286,148556366,1,3962218
HepG2|chr1:144594068-144594209,chr1,144594068,144594209,HepG2|chr1:148556262-148556412,chr1,148556262,148556412,1,3962194
HepG2|chr1:144594068-144594195,chr1,144594068,144594195,HepG2|chr1:148556232-148556373,chr1,148556232,148556373,1,3962164
HepG2|chr1:144594068-144594188,chr1,144594068,144594188,HepG2|chr1:148556267-148556416,chr1,148556267,148556416,1,3962199
HepG2|chr1:144594068-144594186,chr1,144594068,144594186,HepG2|chr1:148556232-148556374,chr1,148556232,148556374,1,3962164
HepG2|chr1:144594068-144594184,chr1,144594068,144594184,HepG2|chr1:148556183-148556333,chr1,148556183,148556333,1,3962115
HepG2|chr1:144594068-144594157,chr1,144594068,144594157,HepG2|chr1:148556276-148556426,chr1,148556276,148556426,1,3962208
HepG2|chr1:144594068-144594156,chr1,144594068,144594156,HepG2|chr1:148556209-148556359,chr1,148556209,148556359,1,3962141
HepG2|chr1:144594068-144594153,chr1,144594068,144594153,HepG2|chr1:148556249-148556366,chr1,148556249,148556366,1,3962181
HepG2|chr1:144594068-144594150,chr1,144594068,144594150,HepG2|chr1:148556229-148556379,chr1,148556229,148556379,1,3962161
HepG2|chr1:144594068-144594149,chr1,144594068,144594149,HepG2|chr1:148556202-148556349,chr1,148556202,148556349,1,3962134
HepG2|chr1:144594068-144594146,chr1,144594068,144594146,HepG2|chr1:148556249-148556399,chr1,148556249,148556399,1,3962181
HepG2|chr1:144594069-144594219,chr1,144594069,144594219,HepG2|chr1:148556503-148556650,chr1,148556503,148556650,1,3962434
HepG2|chr1:144594069-144594214,chr1,144594069,144594214,HepG2|chr1:148556216-148556353,chr1,148556216,148556353,1,3962147
HepG2|chr1:144594069-144594211,chr1,144594069,144594211,HepG2|chr1:148556216-148556366,chr1,148556216,148556366,1,3962147
HepG2|chr1:144594070-144594220,chr1,144594070,144594220,HepG2|chr1:148556294-148556444,chr1,148556294,148556444,1,3962224
HepG2|chr1:144594071-144594218,chr1,144594071,144594218,HepG2|chr1:148556286-148556436,chr1,148556286,148556436,1,3962215
HepG2|chr1:144594071-144594214,chr1,144594071,144594214,HepG2|chr1:148556249-148556399,chr1,148556249,148556399,1,3962178
HepG2|chr1:144594071-144594195,chr1,144594071,144594195,HepG2|chr1:148556345-148556369,chr1,148556345,148556369,1,3962274
HepG2|chr1:144594073-144594218,chr1,144594073,144594218,HepG2|chr1:148556270-148556420,chr1,148556270,148556420,1,3962197
HepG2|chr1:144594074-144594224,chr1,144594074,144594224,HepG2|chr1:148556510-148556660,chr1,148556510,148556660,1,3962436
HepG2|chr1:144594075-144594225,chr1,144594075,144594225,HepG2|chr1:148556577-148556725,chr1,148556577,148556725,1,3962502
HepG2|chr1:144594082-144594232,chr1,144594082,144594232,HepG2|chr1:148556466-148556616,chr1,148556466,148556616,1,3962384
HepG2|chr1:144594082-144594220,chr1,144594082,144594220,HepG2|chr1:148556294-148556444,chr1,148556294,148556444,1,3962212
HepG2|chr1:144594084-144594234,chr1,144594084,144594234,HepG2|chr1:148556562-148556709,chr1,148556562,148556709,1,3962478
HepG2|chr1:144594087-144594237,chr1,144594087,144594237,HepG2|chr1:148556577-148556725,chr1,148556577,148556725,1,3962490
HepG2|chr1:144594088-144594238,chr1,144594088,144594238,HepG2|chr1:148556476-148556626,chr1,148556476,148556626,1,3962388
HepG2|chr1:144594089-144594239,chr1,144594089,144594239,HepG2|chr1:148556468-148556618,chr1,148556468,148556618,1,3962379
HepG2|chr1:144594089-144594234,chr1,144594089,144594234,HepG2|chr1:148556270-148556377,chr1,148556270,148556377,1,3962181
HepG2|chr1:144594098-144594248,chr1,144594098,144594248,HepG2|chr1:148556562-148556709,chr1,148556562,148556709,1,3962464
HepG2|chr1:144594103-144594253,chr1,144594103,144594253,HepG2|chr1:148556655-148556763,chr1,148556655,148556763,1,3962552
HepG2|chr1:144594103-144594241,chr1,144594103,144594241,HepG2|chr1:148556635-148556741,chr1,148556635,148556741,1,3962532
HepG2|chr1:144594104-144594254,chr1,144594104,144594254,HepG2|chr1:148556345-148556391,chr1,148556345,148556391,1,3962241
HepG2|chr1:144594108-144594255,chr1,144594108,144594255,HepG2|chr1:148556576-148556725,chr1,148556576,148556725,1,3962468
HepG2|chr1:144594111-144594261,chr1,144594111,144594261,HepG2|chr1:148556562-148556709,chr1,148556562,148556709,1,3962451
HepG2|chr1:144594111-144594254,chr1,144594111,144594254,HepG2|chr1:148556603-148556751,chr1,148556603,148556751,1,3962492
HepG2|chr1:144594111-144594251,chr1,144594111,144594251,HepG2|chr1:148556571-148556721,chr1,148556571,148556721,1,3962460
HepG2|chr1:144594112-144594262,chr1,144594112,144594262,HepG2|chr1:148556481-148556631,chr1,148556481,148556631,1,3962369
HepG2|chr1:144594112-144594261,chr1,144594112,144594261,HepG2|chr1:148556561-148556711,chr1,148556561,148556711,1,3962449
HepG2|chr1:144594113-144594263,chr1,144594113,144594263,HepG2|chr1:148556294-148556444,chr1,148556294,148556444,1,3962181
HepG2|chr1:144594114-144594264,chr1,144594114,144594264,HepG2|chr1:148556249-148556398,chr1,148556249,148556398,1,3962135
HepG2|chr1:144594114-144594263,chr1,144594114,144594263,HepG2|chr1:148556296-148556443,chr1,148556296,148556443,1,3962182
HepG2|chr1:144594115-144594262,chr1,144594115,144594262,HepG2|chr1:148556579-148556729,chr1,148556579,148556729,1,3962464
HepG2|chr1:144594116-144594262,chr1,144594116,144594262,HepG2|chr1:148556476-148556626,chr1,148556476,148556626,1,3962360
HepG2|chr1:144594116-144594218,chr1,144594116,144594218,HepG2|chr1:148556272-148556421,chr1,148556272,148556421,1,3962156
HepG2|chr1:144594118-144594268,chr1,144594118,144594268,HepG2|chr1:148556279-148556429,chr1,148556279,148556429,1,3962161
HepG2|chr1:144594125-144594275,chr1,144594125,144594275,HepG2|chr1:148556579-148556728,chr1,148556579,148556728,1,3962454
HepG2|chr1:144594128-144594278,chr1,144594128,144594278,HepG2|chr1:148556623-148556773,chr1,148556623,148556773,1,3962495
HepG2|chr1:144594130-144594280,chr1,144594130,144594280,HepG2|chr1:148556286-148556366,chr1,148556286,148556366,1,3962156
HepG2|chr1:144594131-144594281,chr1,144594131,144594281,HepG2|chr1:148556569-148556718,chr1,148556569,148556718,1,3962438
HepG2|chr1:144594132-144594282,chr1,144594132,144594282,HepG2|chr1:148556502-148556644,chr1,148556502,148556644,1,3962370
HepG2|chr1:144594132-144594281,chr1,144594132,144594281,HepG2|chr1:148556593-148556743,chr1,148556593,148556743,1,3962461
HepG2|chr1:144594132-144594279,chr1,144594132,144594279,HepG2|chr1:148556464-148556614,chr1,148556464,148556614,1,3962332
HepG2|chr1:144594132-144594158,chr1,144594132,144594158,HepG2|chr1:148556648-148556798,chr1,148556648,148556798,1,3962516
HepG2|chr1:144594133-144594280,chr1,144594133,144594280,HepG2|chr1:148556600-148556750,chr1,148556600,148556750,1,3962467
HepG2|chr1:144594138-144594288,chr1,144594138,144594288,HepG2|chr1:148556615-148556765,chr1,148556615,148556765,1,3962477
HepG2|chr1:144594138-144594285,chr1,144594138,144594285,HepG2|chr1:148556478-148556628,chr1,148556478,148556628,1,3962340
HepG2|chr1:144594139-144594285,chr1,144594139,144594285,HepG2|chr1:148556561-148556711,chr1,148556561,148556711,1,3962422
HepG2|chr1:144594143-144594293,chr1,144594143,144594293,HepG2|chr1:148556510-148556660,chr1,148556510,148556660,1,3962367
HepG2|chr1:144594151-144594247,chr1,144594151,144594247,HepG2|chr1:148556581-148556731,chr1,148556581,148556731,1,3962430
HepG2|chr1:144594151-144594211,chr1,144594151,144594211,HepG2|chr1:148556581-148556731,chr1,148556581,148556731,1,3962430
HepG2|chr1:144594159-144594309,chr1,144594159,144594309,HepG2|chr1:148556628-148556778,chr1,148556628,148556778,1,3962469
HepG2|chr1:144594159-144594215,chr1,144594159,144594215,HepG2|chr1:148556591-148556741,chr1,148556591,148556741,1,3962432
HepG2|chr1:144594161-144594311,chr1,144594161,144594311,HepG2|chr1:148556562-148556709,chr1,148556562,148556709,1,3962401
HepG2|chr1:144594163-144594212,chr1,144594163,144594212,HepG2|chr1:148556364-148556437,chr1,148556364,148556437,1,3962201
HepG2|chr1:144594178-144594328,chr1,144594178,144594328,HepG2|chr1:148556634-148556776,chr1,148556634,148556776,1,3962456
HepG2|chr1:144594178-144594325,chr1,144594178,144594325,HepG2|chr1:148556628-148556778,chr1,148556628,148556778,1,3962450
HepG2|chr1:144594179-144594329,chr1,144594179,144594329,HepG2|chr1:148556571-148556721,chr1,148556571,148556721,1,3962392
HepG2|chr1:144594180-144594214,chr1,144594180,144594214,HepG2|chr1:148556180-148556325,chr1,148556180,148556325,1,3962000
HepG2|chr1:144594182-144594211,chr1,144594182,144594211,HepG2|chr1:148556138-148556180,chr1,148556138,148556180,1,3961956
HepG2|chr1:144594184-144594233,chr1,144594184,144594233,HepG2|chr1:148556364-148556407,chr1,148556364,148556407,1,3962180
HepG2|chr1:144594227-144594376,chr1,144594227,144594376,HepG2|chr1:148556651-148556800,chr1,148556651,148556800,1,3962424
HepG2|chr1:144594252-144594286,chr1,144594252,144594286,HepG2|chr1:148556601-148556751,chr1,148556601,148556751,1,3962349
HepG2|chr1:144594608-144594758,chr1,144594608,144594758,HepG2|chr1:148556921-148557071,chr1,148556921,148557071,1,3962313
HepG2|chr1:144594614-144594763,chr1,144594614,144594763,HepG2|chr1:148556917-148557067,chr1,148556917,148557067,1,3962303
HepG2|chr1:144594621-144594771,chr1,144594621,144594771,HepG2|chr1:148556880-148556942,chr1,148556880,148556942,1,3962259
HepG2|chr1:144594621-144594763,chr1,144594621,144594763,HepG2|chr1:148556915-148557065,chr1,148556915,148557065,1,3962294
HepG2|chr1:144594623-144594773,chr1,144594623,144594773,HepG2|chr1:148556895-148557045,chr1,148556895,148557045,1,3962272
HepG2|chr1:144594624-144594774,chr1,144594624,144594774,HepG2|chr1:148556895-148557045,chr1,148556895,148557045,1,3962271
HepG2|chr1:144594625-144594775,chr1,144594625,144594775,HepG2|chr1:148556908-148557058,chr1,148556908,148557058,1,3962283
HepG2|chr1:144594644-144594794,chr1,144594644,144594794,HepG2|chr1:148556869-148557014,chr1,148556869,148557014,1,3962225
HepG2|chr1:144594646-144594796,chr1,144594646,144594796,HepG2|chr1:148556816-148556867,chr1,148556816,148556867,1,3962170
HepG2|chr1:144594650-144594800,chr1,144594650,144594800,HepG2|chr1:148556885-148557035,chr1,148556885,148557035,1,3962235
HepG2|chr1:144594653-144594803,chr1,144594653,144594803,HepG2|chr1:148556905-148557055,chr1,148556905,148557055,1,3962252
HepG2|chr1:144594661-144594810,chr1,144594661,144594810,HepG2|chr1:148556914-148557064,chr1,148556914,148557064,1,3962253
HepG2|chr1:144594669-144594818,chr1,144594669,144594818,HepG2|chr1:148556930-148557080,chr1,148556930,148557080,1,3962261
HepG2|chr1:144594693-144594800,chr1,144594693,144594800,HepG2|chr1:148556876-148556962,chr1,148556876,148556962,1,3962183
HepG2|chr1:144594701-144594851,chr1,144594701,144594851,HepG2|chr1:148556921-148557071,chr1,148556921,148557071,1,3962220
HepG2|chr1:144594707-144594857,chr1,144594707,144594857,HepG2|chr1:148556885-148557035,chr1,148556885,148557035,1,3962178
HepG2|chr1:144594708-144594858,chr1,144594708,144594858,HepG2|chr1:148556869-148557014,chr1,148556869,148557014,1,3962161
HepG2|chr1:144594713-144594863,chr1,144594713,144594863,HepG2|chr1:148556889-148557039,chr1,148556889,148557039,1,3962176
HepG2|chr1:144594716-144594866,chr1,144594716,144594866,HepG2|chr1:148556908-148556999,chr1,148556908,148556999,1,3962192
HepG2|chr1:144594743-144594893,chr1,144594743,144594893,HepG2|chr1:148556869-148557004,chr1,148556869,148557004,1,3962126
HepG2|chr1:144595145-144595295,chr1,144595145,144595295,HepG2|chr1:148557600-148557652,chr1,148557600,148557652,1,3962455
HepG2|chr1:144595149-144595296,chr1,144595149,144595296,HepG2|chr1:148557628-148557683,chr1,148557628,148557683,1,3962479
HepG2|chr1:144595149-144595292,chr1,144595149,144595292,HepG2|chr1:148557628-148557689,chr1,148557628,148557689,1,3962479
HepG2|chr1:144595150-144595296,chr1,144595150,144595296,HepG2|chr1:148557625-148557689,chr1,148557625,148557689,1,3962475
HepG2|chr1:144595152-144595301,chr1,144595152,144595301,HepG2|chr1:148557600-148557652,chr1,148557600,148557652,1,3962448
HepG2|chr1:144595155-144595304,chr1,144595155,144595304,HepG2|chr1:148557628-148557704,chr1,148557628,148557704,1,3962473
HepG2|chr1:144595164-144595293,chr1,144595164,144595293,HepG2|chr1:148557607-148557658,chr1,148557607,148557658,1,3962443
HepG2|chr1:144595172-144595322,chr1,144595172,144595322,HepG2|chr1:148557625-148557656,chr1,148557625,148557656,1,3962453
HepG2|chr1:144595173-144595310,chr1,144595173,144595310,HepG2|chr1:148557627-148557701,chr1,148557627,148557701,1,3962454
HepG2|chr1:144595174-144595321,chr1,144595174,144595321,HepG2|chr1:148557600-148557656,chr1,148557600,148557656,1,3962426
HepG2|chr1:144595175-144595325,chr1,144595175,144595325,HepG2|chr1:148557625-148557659,chr1,148557625,148557659,1,3962450
HepG2|chr1:144595175-144595324,chr1,144595175,144595324,HepG2|chr1:148557628-148557707,chr1,148557628,148557707,1,3962453
HepG2|chr1:144595175-144595322,chr1,144595175,144595322,HepG2|chr1:148557625-148557658,chr1,148557625,148557658,1,3962450
HepG2|chr1:144595175-144595320,chr1,144595175,144595320,HepG2|chr1:148557625-148557655,chr1,148557625,148557655,1,3962450
HepG2|chr1:144595175-144595319,chr1,144595175,144595319,HepG2|chr1:148557625-148557656,chr1,148557625,148557656,1,3962450
HepG2|chr1:144595176-144595323,chr1,144595176,144595323,HepG2|chr1:148557628-148557658,chr1,148557628,148557658,1,3962452
HepG2|chr1:144595176-144595319,chr1,144595176,144595319,HepG2|chr1:148557625-148557655,chr1,148557625,148557655,1,3962449
HepG2|chr1:144595176-144595299,chr1,144595176,144595299,HepG2|chr1:148557625-148557712,chr1,148557625,148557712,1,3962449
HepG2|chr1:144595177-144595322,chr1,144595177,144595322,HepG2|chr1:148557625-148557661,chr1,148557625,148557661,1,3962448
HepG2|chr1:144595181-144595314,chr1,144595181,144595314,HepG2|chr1:148557630-148557689,chr1,148557630,148557689,1,3962449
HepG2|chr1:144595181-144595301,chr1,144595181,144595301,HepG2|chr1:148557628-148557658,chr1,148557628,148557658,1,3962447
HepG2|chr1:144595181-144595293,chr1,144595181,144595293,HepG2|chr1:148557625-148557669,chr1,148557625,148557669,1,3962444
HepG2|chr1:144595182-144595295,chr1,144595182,144595295,HepG2|chr1:148557628-148557658,chr1,148557628,148557658,1,3962446
HepG2|chr1:144595183-144595295,chr1,144595183,144595295,HepG2|chr1:148557628-148557689,chr1,148557628,148557689,1,3962445
HepG2|chr1:144595189-144595320,chr1,144595189,144595320,HepG2|chr1:148557625-148557655,chr1,148557625,148557655,1,3962436
HepG2|chr1:144595195-144595327,chr1,144595195,144595327,HepG2|chr1:148557625-148557704,chr1,148557625,148557704,1,3962430
HepG2|chr1:144595201-144595266,chr1,144595201,144595266,HepG2|chr1:148557508-148557623,chr1,148557508,148557623,1,3962307
HepG2|chr1:144595205-144595325,chr1,144595205,144595325,HepG2|chr1:148557600-148557661,chr1,148557600,148557661,1,3962395
HepG2|chr1:144595213-144595304,chr1,144595213,144595304,HepG2|chr1:148557628-148557689,chr1,148557628,148557689,1,3962415
HepG2|chr1:144595214-144595299,chr1,144595214,144595299,HepG2|chr1:148557625-148557689,chr1,148557625,148557689,1,3962411
HepG2|chr1:144595221-144595296,chr1,144595221,144595296,HepG2|chr1:148557625-148557709,chr1,148557625,148557709,1,3962404
HepG2|chr1:144595229-144595350,chr1,144595229,144595350,HepG2|chr1:148557625-148557707,chr1,148557625,148557707,1,3962396
HepG2|chr1:144595231-144595313,chr1,144595231,144595313,HepG2|chr1:148557628-148557689,chr1,148557628,148557689,1,3962397
HepG2|chr1:144595244-144595322,chr1,144595244,144595322,HepG2|chr1:148557628-148557689,chr1,148557628,148557689,1,3962384
HepG2|chr1:144595251-144595286,chr1,144595251,144595286,HepG2|chr1:148557509-148557623,chr1,148557509,148557623,1,3962258
HepG2|chr1:144595268-144595391,chr1,144595268,144595391,HepG2|chr1:148557510-148557628,chr1,148557510,148557628,1,3962242
HepG2|chr1:144595268-144595372,chr1,144595268,144595372,HepG2|chr1:148557501-148557628,chr1,148557501,148557628,1,3962233
HepG2|chr1:144595268-144595321,chr1,144595268,144595321,HepG2|chr1:148557509-148557628,chr1,148557509,148557628,1,3962241
HepG2|chr1:144595268-144595315,chr1,144595268,144595315,HepG2|chr1:148557504-148557624,chr1,148557504,148557624,1,3962236
HepG2|chr1:144595290-144595325,chr1,144595290,144595325,HepG2|chr1:148557536-148557625,chr1,148557536,148557625,1,3962246
HepG2|chr1:144595290-144595323,chr1,144595290,144595323,HepG2|chr1:148557504-148557621,chr1,148557504,148557621,1,3962214
HepG2|chr1:144595293-144595325,chr1,144595293,144595325,HepG2|chr1:148557536-148557625,chr1,148557536,148557625,1,3962243
HepG2|chr1:144595295-144595354,chr1,144595295,144595354,HepG2|chr1:148557508-148557623,chr1,148557508,148557623,1,3962213
HepG2|chr1:144595324-144595474,chr1,144595324,144595474,HepG2|chr1:148557625-148557698,chr1,148557625,148557698,1,3962301
HepG2|chr1:144595326-144595476,chr1,144595326,144595476,HepG2|chr1:148557521-148557622,chr1,148557521,148557622,1,3962195
HepG2|chr1:144595591-144595735,chr1,144595591,144595735,HepG2|chr1:148556895-148556995,chr1,148556895,148556995,1,3961304
HepG2|chr1:144595592-144595742,chr1,144595592,144595742,HepG2|chr1:148558160-148558294,chr1,148558160,148558294,1,3962568
HepG2|chr1:144595611-144595761,chr1,144595611,144595761,HepG2|chr1:148558086-148558235,chr1,148558086,148558235,1,3962475
HepG2|chr1:144595616-144595763,chr1,144595616,144595763,HepG2|chr1:148558040-148558189,chr1,148558040,148558189,1,3962424
HepG2|chr1:144595616-144595762,chr1,144595616,144595762,HepG2|chr1:148558040-148558189,chr1,148558040,148558189,1,3962424
HepG2|chr1:144595636-144595783,chr1,144595636,144595783,HepG2|chr1:148558086-148558232,chr1,148558086,148558232,1,3962450
HepG2|chr1:144595637-144595787,chr1,144595637,144595787,HepG2|chr1:148558013-148558163,chr1,148558013,148558163,1,3962376
HepG2|chr1:144595656-144595806,chr1,144595656,144595806,HepG2|chr1:148558160-148558286,chr1,148558160,148558286,1,3962504
HepG2|chr1:144595658-144595808,chr1,144595658,144595808,HepG2|chr1:148558066-148558216,chr1,148558066,148558216,1,3962408
HepG2|chr1:144595665-144595810,chr1,144595665,144595810,HepG2|chr1:148558160-148558286,chr1,148558160,148558286,1,3962495
HepG2|chr1:144595665-144595728,chr1,144595665,144595728,HepG2|chr1:148558084-148558229,chr1,148558084,148558229,1,3962419
HepG2|chr1:144595666-144595810,chr1,144595666,144595810,HepG2|chr1:148558062-148558212,chr1,148558062,148558212,1,3962396
HepG2|chr1:144595668-144595810,chr1,144595668,144595810,HepG2|chr1:148558082-148558228,chr1,148558082,148558228,1,3962414
HepG2|chr1:144595680-144595830,chr1,144595680,144595830,HepG2|chr1:148558160-148558294,chr1,148558160,148558294,1,3962480
HepG2|chr1:144595684-144595809,chr1,144595684,144595809,HepG2|chr1:148558080-148558230,chr1,148558080,148558230,1,3962396
HepG2|chr1:144595690-144595840,chr1,144595690,144595840,HepG2|chr1:148558202-148558352,chr1,148558202,148558352,1,3962512
HepG2|chr1:144595690-144595826,chr1,144595690,144595826,HepG2|chr1:148558141-148558219,chr1,148558141,148558219,1,3962451
HepG2|chr1:144595690-144595751,chr1,144595690,144595751,HepG2|chr1:148558085-148558232,chr1,148558085,148558232,1,3962395
HepG2|chr1:144595697-144595809,chr1,144595697,144595809,HepG2|chr1:148558068-148558218,chr1,148558068,148558218,1,3962371
HepG2|chr1:144595707-144595857,chr1,144595707,144595857,HepG2|chr1:148558185-148558331,chr1,148558185,148558331,1,3962478
HepG2|chr1:144595707-144595852,chr1,144595707,144595852,HepG2|chr1:148558185-148558331,chr1,148558185,148558331,1,3962478
HepG2|chr1:144595717-144595866,chr1,144595717,144595866,HepG2|chr1:148558204-148558354,chr1,148558204,148558354,1,3962487
HepG2|chr1:144595729-144595810,chr1,144595729,144595810,HepG2|chr1:148558181-148558331,chr1,148558181,148558331,1,3962452
HepG2|chr1:144595732-144595882,chr1,144595732,144595882,HepG2|chr1:148558160-148558299,chr1,148558160,148558299,1,3962428
HepG2|chr1:144595740-144595890,chr1,144595740,144595890,HepG2|chr1:148558152-148558302,chr1,148558152,148558302,1,3962412
HepG2|chr1:144595740-144595820,chr1,144595740,144595820,HepG2|chr1:148558588-148558700,chr1,148558588,148558700,1,3962848
HepG2|chr1:144595752-144595902,chr1,144595752,144595902,HepG2|chr1:148558235-148558384,chr1,148558235,148558384,1,3962483
HepG2|chr1:144595752-144595898,chr1,144595752,144595898,HepG2|chr1:148558235-148558384,chr1,148558235,148558384,1,3962483
HepG2|chr1:144595753-144595902,chr1,144595753,144595902,HepG2|chr1:148560538-148560562,chr1,148560538,148560562,1,3964785
HepG2|chr1:144595757-144595907,chr1,144595757,144595907,HepG2|chr1:148558202-148558352,chr1,148558202,148558352,1,3962445
HepG2|chr1:144595761-144595911,chr1,144595761,144595911,HepG2|chr1:148558185-148558332,chr1,148558185,148558332,1,3962424
HepG2|chr1:144595769-144595919,chr1,144595769,144595919,HepG2|chr1:148558160-148558300,chr1,148558160,148558300,1,3962391
HepG2|chr1:144595780-144595930,chr1,144595780,144595930,HepG2|chr1:148558193-148558343,chr1,148558193,148558343,1,3962413
HepG2|chr1:144595781-144595928,chr1,144595781,144595928,HepG2|chr1:148558152-148558302,chr1,148558152,148558302,1,3962371
HepG2|chr1:144595783-144595928,chr1,144595783,144595928,HepG2|chr1:148558160-148558286,chr1,148558160,148558286,1,3962377
HepG2|chr1:144595783-144595820,chr1,144595783,144595820,HepG2|chr1:148558145-148558287,chr1,148558145,148558287,1,3962362
HepG2|chr1:144595789-144595939,chr1,144595789,144595939,HepG2|chr1:148558160-148558300,chr1,148558160,148558300,1,3962371
HepG2|chr1:144595789-144595938,chr1,144595789,144595938,HepG2|chr1:148558221-148558370,chr1,148558221,148558370,1,3962432
HepG2|chr1:144595789-144595820,chr1,144595789,144595820,HepG2|chr1:148558206-148558356,chr1,148558206,148558356,1,3962417
HepG2|chr1:144595791-144595941,chr1,144595791,144595941,HepG2|chr1:148558160-148558286,chr1,148558160,148558286,1,3962369
HepG2|chr1:144595793-144595842,chr1,144595793,144595842,HepG2|chr1:148558160-148558306,chr1,148558160,148558306,1,3962367
HepG2|chr1:144595795-144595847,chr1,144595795,144595847,HepG2|chr1:148558160-148558297,chr1,148558160,148558297,1,3962365
HepG2|chr1:144595796-144595946,chr1,144595796,144595946,HepG2|chr1:148560503-148560539,chr1,148560503,148560539,1,3964707
HepG2|chr1:144595799-144595949,chr1,144595799,144595949,HepG2|chr1:148558202-148558352,chr1,148558202,148558352,1,3962403
HepG2|chr1:144595801-144595950,chr1,144595801,144595950,HepG2|chr1:148558160-148558287,chr1,148558160,148558287,1,3962359
HepG2|chr1:144595803-144595953,chr1,144595803,144595953,HepG2|chr1:148558160-148558305,chr1,148558160,148558305,1,3962357
HepG2|chr1:144595803-144595952,chr1,144595803,144595952,HepG2|chr1:148558160-148558305,chr1,148558160,148558305,1,3962357
HepG2|chr1:144595804-144595954,chr1,144595804,144595954,HepG2|chr1:148558185-148558332,chr1,148558185,148558332,1,3962381
HepG2|chr1:144595811-144595952,chr1,144595811,144595952,HepG2|chr1:148558133-148558281,chr1,148558133,148558281,1,3962322
HepG2|chr1:144595812-144595943,chr1,144595812,144595943,HepG2|chr1:148558114-148558253,chr1,148558114,148558253,1,3962302
HepG2|chr1:144595820-144595960,chr1,144595820,144595960,HepG2|chr1:148558086-148558236,chr1,148558086,148558236,1,3962266
HepG2|chr1:144595834-144595935,chr1,144595834,144595935,HepG2|chr1:148556135-148556269,chr1,148556135,148556269,1,3960301
HepG2|chr1:144595909-144596059,chr1,144595909,144596059,HepG2|chr1:148558117-148558262,chr1,148558117,148558262,1,3962208
HepG2|chr1:144595913-144596063,chr1,144595913,144596063,HepG2|chr1:148558202-148558352,chr1,148558202,148558352,1,3962289
HepG2|chr1:144595914-144596064,chr1,144595914,144596064,HepG2|chr1:148558185-148558332,chr1,148558185,148558332,1,3962271
HepG2|chr1:144595933-144596063,chr1,144595933,144596063,HepG2|chr1:148558202-148558319,chr1,148558202,148558319,1,3962269
HepG2|chr1:144595945-144596095,chr1,144595945,144596095,HepG2|chr1:148558219-148558369,chr1,148558219,148558369,1,3962274
HepG2|chr1:144595948-144596098,chr1,144595948,144596098,HepG2|chr1:148558200-148558318,chr1,148558200,148558318,1,3962252
HepG2|chr1:144595949-144596099,chr1,144595949,144596099,HepG2|chr1:148558202-148558352,chr1,148558202,148558352,1,3962253
HepG2|chr1:144595950-144596100,chr1,144595950,144596100,HepG2|chr1:148558259-148558409,chr1,148558259,148558409,1,3962309
HepG2|chr1:144595951-144596100,chr1,144595951,144596100,HepG2|chr1:148558238-148558388,chr1,148558238,148558388,1,3962287
HepG2|chr1:144595954-144596104,chr1,144595954,144596104,HepG2|chr1:148558267-148558318,chr1,148558267,148558318,1,3962313
HepG2|chr1:144595957-144596107,chr1,144595957,144596107,HepG2|chr1:148558235-148558384,chr1,148558235,148558384,1,3962278
HepG2|chr1:144595958-144596108,chr1,144595958,144596108,HepG2|chr1:148558278-148558331,chr1,148558278,148558331,1,3962320
HepG2|chr1:144595963-144596113,chr1,144595963,144596113,HepG2|chr1:148558238-148558388,chr1,148558238,148558388,1,3962275
HepG2|chr1:144595965-144596084,chr1,144595965,144596084,HepG2|chr1:148558119-148558262,chr1,148558119,148558262,1,3962154
HepG2|chr1:147550924-147551071,chr1,147550924,147551071,HepG2|chr1:145611429-145611579,chr1,145611429,145611579,1,1939495
HepG2|chr1:147550924-147551070,chr1,147550924,147551070,HepG2|chr1:145611429-145611579,chr1,145611429,145611579,1,1939495
HepG2|chr1:147550981-147551131,chr1,147550981,147551131,HepG2|chr1:145611439-145611589,chr1,145611439,145611589,1,1939542
HepG2|chr1:147550982-147551129,chr1,147550982,147551129,HepG2|chr1:145611378-145611528,chr1,145611378,145611528,1,1939604
HepG2|chr1:147550985-147551135,chr1,147550985,147551135,HepG2|chr1:145611370-145611514,chr1,145611370,145611514,1,1939615
HepG2|chr1:147550988-147551138,chr1,147550988,147551138,HepG2|chr1:145611376-145611526,chr1,145611376,145611526,1,1939612
HepG2|chr1:147551000-147551144,chr1,147551000,147551144,HepG2|chr1:145611408-145611558,chr1,145611408,145611558,1,1939592
HepG2|chr1:149299223-149299373,chr1,149299223,149299373,HepG2|chr1:149684821-149684968,chr1,149684821,149684968,1,385598
HepG2|chr1:149299352-149299502,chr1,149299352,149299502,HepG2|chr1:149684997-149685143,chr1,149684997,149685143,1,385645
HepG2|chr1:149299363-149299513,chr1,149299363,149299513,HepG2|chr1:149684993-149685143,chr1,149684993,149685143,1,385630
HepG2|chr1:149299373-149299523,chr1,149299373,149299523,HepG2|chr1:149685005-149685155,chr1,149685005,149685155,1,385632
HepG2|chr1:149299393-149299543,chr1,149299393,149299543,HepG2|chr1:149684820-149684967,chr1,149684820,149684967,1,385427
HepG2|chr1:149299415-149299561,chr1,149299415,149299561,HepG2|chr1:149684996-149685146,chr1,149684996,149685146,1,385581
HepG2|chr1:149299422-149299572,chr1,149299422,149299572,HepG2|chr1:149685009-149685156,chr1,149685009,149685156,1,385587
HepG2|chr1:149299423-149299573,chr1,149299423,149299573,HepG2|chr1:149685007-149685157,chr1,149685007,149685157,1,385584
HepG2|chr1:149299436-149299583,chr1,149299436,149299583,HepG2|chr1:149685052-149685202,chr1,149685052,149685202,1,385616
HepG2|chr1:149299598-149299745,chr1,149299598,149299745,HepG2|chr1:149685087-149685212,chr1,149685087,149685212,1,385489
HepG2|chr1:150370463-150370589,chr1,150370463,150370589,HepG2|chr1:78224041-78224079,chr1,78224041,78224079,1,72146422
HepG2|chr1:150370463-150370575,chr1,150370463,150370575,HepG2|chr1:78224041-78224079,chr1,78224041,78224079,1,72146422
HepG2|chr1:150492169-150492226,chr1,150492169,150492226,HepG2|chr1:150456166-150456316,chr1,150456166,150456316,1,36003
HepG2|chr1:150492719-150492762,chr1,150492719,150492762,HepG2|chr1:150460059-150460131,chr1,150460059,150460131,1,32660
HepG2|chr1:150494650-150494689,chr1,150494650,150494689,HepG2|chr1:150456425-150456447,chr1,150456425,150456447,1,38225
HepG2|chr1:150591604-150591709,chr1,150591604,150591709,HepG2|chr1:26631979-26632024,chr1,26631979,26632024,1,123959625
HepG2|chr1:153973303-153973359,chr1,153973303,153973359,HepG2|chr1:153964689-153964721,chr1,153964689,153964721,1,8614
HepG2|chr1:153973303-153973357,chr1,153973303,153973357,HepG2|chr1:153964654-153964721,chr1,153964654,153964721,1,8649
HepG2|chr1:153973303-153973356,chr1,153973303,153973356,HepG2|chr1:153964686-153964721,chr1,153964686,153964721,1,8617
HepG2|chr1:153973303-153973355,chr1,153973303,153973355,HepG2|chr1:153964601-153964721,chr1,153964601,153964721,1,8702
HepG2|chr1:153973303-153973354,chr1,153973303,153973354,HepG2|chr1:153964676-153964721,chr1,153964676,153964721,1,8627
HepG2|chr1:153973303-153973353,chr1,153973303,153973353,HepG2|chr1:153964669-153964721,chr1,153964669,153964721,1,8634
HepG2|chr1:153973303-153973352,chr1,153973303,153973352,HepG2|chr1:153964657-153964721,chr1,153964657,153964721,1,8646
HepG2|chr1:153973303-153973351,chr1,153973303,153973351,HepG2|chr1:153964694-153964721,chr1,153964694,153964721,1,8609
HepG2|chr1:153973303-153973349,chr1,153973303,153973349,HepG2|chr1:153964687-153964721,chr1,153964687,153964721,1,8616
HepG2|chr1:153973303-153973348,chr1,153973303,153973348,HepG2|chr1:153964697-153964721,chr1,153964697,153964721,1,8606
HepG2|chr1:153973303-153973347,chr1,153973303,153973347,HepG2|chr1:153964695-153964721,chr1,153964695,153964721,1,8608
HepG2|chr1:153973303-153973346,chr1,153973303,153973346,HepG2|chr1:153964666-153964721,chr1,153964666,153964721,1,8637
HepG2|chr1:153973303-153973342,chr1,153973303,153973342,HepG2|chr1:153964692-153964721,chr1,153964692,153964721,1,8611
HepG2|chr1:153973303-153973339,chr1,153973303,153973339,HepG2|chr1:153964660-153964721,chr1,153964660,153964721,1,8643
HepG2|chr1:153973303-153973337,chr1,153973303,153973337,HepG2|chr1:153964655-153964721,chr1,153964655,153964721,1,8648
HepG2|chr1:153973303-153973336,chr1,153973303,153973336,HepG2|chr1:153964641-153964721,chr1,153964641,153964721,1,8662
HepG2|chr1:153973303-153973335,chr1,153973303,153973335,HepG2|chr1:153964668-153964721,chr1,153964668,153964721,1,8635
HepG2|chr1:153973303-153973334,chr1,153973303,153973334,HepG2|chr1:153964580-153964722,chr1,153964580,153964722,1,8723
HepG2|chr1:153973303-153973333,chr1,153973303,153973333,HepG2|chr1:153964655-153964721,chr1,153964655,153964721,1,8648
HepG2|chr1:153973303-153973332,chr1,153973303,153973332,HepG2|chr1:153964694-153964721,chr1,153964694,153964721,1,8609
HepG2|chr1:153973303-153973331,chr1,153973303,153973331,HepG2|chr1:153964645-153964721,chr1,153964645,153964721,1,8658
HepG2|chr1:153973303-153973330,chr1,153973303,153973330,HepG2|chr1:153964701-153964721,chr1,153964701,153964721,1,8602
HepG2|chr1:153973303-153973329,chr1,153973303,153973329,HepG2|chr1:153964630-153964721,chr1,153964630,153964721,1,8673
HepG2|chr1:153973303-153973328,chr1,153973303,153973328,HepG2|chr1:153964644-153964715,chr1,153964644,153964715,1,8659
HepG2|chr1:153973303-153973325,chr1,153973303,153973325,HepG2|chr1:153964695-153964721,chr1,153964695,153964721,1,8608
HepG2|chr1:153973303-153973323,chr1,153973303,153973323,HepG2|chr1:153964658-153964721,chr1,153964658,153964721,1,8645
HepG2|chr1:156111383-156111455,chr1,156111383,156111455,HepG2|chr1:156113494-156113571,chr1,156113494,156113571,1,2111
HepG2|chr1:156111385-156111455,chr1,156111385,156111455,HepG2|chr1:156113494-156113571,chr1,156113494,156113571,1,2109
HepG2|chr1:156111393-156111432,chr1,156111393,156111432,HepG2|chr1:156112102-156112252,chr1,156112102,156112252,1,709
HepG2|chr1:162183910-162183975,chr1,162183910,162183975,HepG2|chr1:160258611-160258757,chr1,160258611,160258757,1,1925299
HepG2|chr1:162195867-162195975,chr1,162195867,162195975,HepG2|chr1:153581802-153581844,chr1,153581802,153581844,1,8614065
HepG2|chr1:165826584-165826700,chr1,165826584,165826700,HepG2|chr1:54406651-54406801,chr1,54406651,54406801,1,111419933
HepG2|chr1:165872263-165872413,chr1,165872263,165872413,HepG2|chr1:54410614-54410657,chr1,54410614,54410657,1,111461649
HepG2|chr1:165872320-165872427,chr1,165872320,165872427,HepG2|chr1:54410614-54410657,chr1,54410614,54410657,1,111461706
HepG2|chr1:167683717-167683867,chr1,167683717,167683867,HepG2|chr1:167690855-167690928,chr1,167690855,167690928,1,7138
HepG2|chr1:167683749-167683899,chr1,167683749,167683899,HepG2|chr1:167690855-167690892,chr1,167690855,167690892,1,7106
HepG2|chr1:167683765-167683909,chr1,167683765,167683909,HepG2|chr1:167690828-167690893,chr1,167690828,167690893,1,7063
HepG2|chr1:167683794-167683907,chr1,167683794,167683907,HepG2|chr1:167690855-167690892,chr1,167690855,167690892,1,7061
HepG2|chr1:167683822-167683907,chr1,167683822,167683907,HepG2|chr1:167690828-167690893,chr1,167690828,167690893,1,7006
HepG2|chr1:167683834-167683907,chr1,167683834,167683907,HepG2|chr1:167690855-167690928,chr1,167690855,167690928,1,7021
HepG2|chr1:167683856-167683907,chr1,167683856,167683907,HepG2|chr1:167690874-167691024,chr1,167690874,167691024,1,7018
HepG2|chr1:173409851-173409889,chr1,173409851,173409889,HepG2|chr1:173446955-173447104,chr1,173446955,173447104,1,37104
HepG2|chr1:173411067-173411187,chr1,173411067,173411187,HepG2|chr1:173445770-173445907,chr1,173445770,173445907,1,34703
HepG2|chr1:173411069-173411153,chr1,173411069,173411153,HepG2|chr1:173445770-173445788,chr1,173445770,173445788,1,34701
HepG2|chr1:173411104-173411153,chr1,173411104,173411153,HepG2|chr1:173445770-173445787,chr1,173445770,173445787,1,34666
HepG2|chr1:173411124-173411153,chr1,173411124,173411153,HepG2|chr1:173445776-173445815,chr1,173445776,173445815,1,34652
HepG2|chr1:173411216-173411236,chr1,173411216,173411236,HepG2|chr1:173446958-173446985,chr1,173446958,173446985,1,35742
HepG2|chr1:173411983-173412129,chr1,173411983,173412129,HepG2|chr1:173444013-173444054,chr1,173444013,173444054,1,32030
HepG2|chr1:173412093-173412202,chr1,173412093,173412202,HepG2|chr1:173444013-173444054,chr1,173444013,173444054,1,31920
HepG2|chr1:174689446-174689559,chr1,174689446,174689559,HepG2|chr1:154537265-154537321,chr1,154537265,154537321,1,20152181
HepG2|chr1:174689490-174689640,chr1,174689490,174689640,HepG2|chr1:154537266-154537328,chr1,154537266,154537328,1,20152224
HepG2|chr1:174954008-174954093,chr1,174954008,174954093,HepG2|chr1:174966720-174966831,chr1,174966720,174966831,1,12712
HepG2|chr1:174954058-174954093,chr1,174954058,174954093,HepG2|chr1:174966720-174966831,chr1,174966720,174966831,1,12662
HepG2|chr1:174954722-174954815,chr1,174954722,174954815,HepG2|chr1:174966482-174966539,chr1,174966482,174966539,1,11760
HepG2|chr1:174954724-174954816,chr1,174954724,174954816,HepG2|chr1:174966482-174966539,chr1,174966482,174966539,1,11758
HepG2|chr1:174957477-174957588,chr1,174957477,174957588,HepG2|chr1:174966681-174966809,chr1,174966681,174966809,1,9204
HepG2|chr1:174957566-174957588,chr1,174957566,174957588,HepG2|chr1:174966681-174966809,chr1,174966681,174966809,1,9115
HepG2|chr1:178986589-178986659,chr1,178986589,178986659,HepG2|chr1:178991081-178991188,chr1,178991081,178991188,1,4492
HepG2|chr1:178986620-178986659,chr1,178986620,178986659,HepG2|chr1:178991081-178991188,chr1,178991081,178991188,1,4461
HepG2|chr1:178986994-178987093,chr1,178986994,178987093,HepG2|chr1:178990498-178990546,chr1,178990498,178990546,1,3504
HepG2|chr1:178986997-178987090,chr1,178986997,178987090,HepG2|chr1:178990498-178990546,chr1,178990498,178990546,1,3501
HepG2|chr1:197143455-197143552,chr1,197143455,197143552,HepG2|chr1:226251053-226251104,chr1,226251053,226251104,1,29107598
HepG2|chr1:197143455-197143551,chr1,197143455,197143551,HepG2|chr1:226251053-226251104,chr1,226251053,226251104,1,29107598
HepG2|chr1:201818184-201818221,chr1,201818184,201818221,HepG2|chr1:205600116-205600263,chr1,205600116,205600263,1,3781932
HepG2|chr1:201820580-201820621,chr1,201820580,201820621,HepG2|chr1:201924301-201924417,chr1,201924301,201924417,1,103721
HepG2|chr1:201820590-201820621,chr1,201820590,201820621,HepG2|chr1:201924301-201924417,chr1,201924301,201924417,1,103711
HepG2|chr1:205658877-205659015,chr1,205658877,205659015,HepG2|chr1:205652616-205652703,chr1,205652616,205652703,1,6261
HepG2|chr1:205658878-205658941,chr1,205658878,205658941,HepG2|chr1:205652616-205652703,chr1,205652616,205652703,1,6262
HepG2|chr1:205658878-205658928,chr1,205658878,205658928,HepG2|chr1:205652566-205652700,chr1,205652566,205652700,1,6312
HepG2|chr1:205658878-205658927,chr1,205658878,205658927,HepG2|chr1:205652586-205652703,chr1,205652586,205652703,1,6292
HepG2|chr1:205658878-205658905,chr1,205658878,205658905,HepG2|chr1:205652586-205652703,chr1,205652586,205652703,1,6292
HepG2|chr1:205697434-205697502,chr1,205697434,205697502,HepG2|chr1:205599369-205599436,chr1,205599369,205599436,1,98065
HepG2|chr1:205708933-205709012,chr1,205708933,205709012,HepG2|chr1:205601761-205601832,chr1,205601761,205601832,1,107172
HepG2|chr1:205708937-205709012,chr1,205708937,205709012,HepG2|chr1:205601761-205601832,chr1,205601761,205601832,1,107176
HepG2|chr1:225944262-225944317,chr1,225944262,225944317,HepG2|chr1:225963524-225963631,chr1,225963524,225963631,1,19262
HepG2|chr1:225944262-225944301,chr1,225944262,225944301,HepG2|chr1:225963524-225963631,chr1,225963524,225963631,1,19262
HepG2|chr1:225958244-225958331,chr1,225958244,225958331,HepG2|chr1:225964812-225964857,chr1,225964812,225964857,1,6568
HepG2|chr1:225958334-225958427,chr1,225958334,225958427,HepG2|chr1:225964812-225964857,chr1,225964812,225964857,1,6478
HepG2|chr1:225958555-225958663,chr1,225958555,225958663,HepG2|chr1:225961309-225961351,chr1,225961309,225961351,1,2754
HepG2|chr1:225958596-225958729,chr1,225958596,225958729,HepG2|chr1:225961309-225961351,chr1,225961309,225961351,1,2713
HepG2|chr1:225958661-225958698,chr1,225958661,225958698,HepG2|chr1:225961476-225961626,chr1,225961476,225961626,1,2815
HepG2|chr1:225959099-225959244,chr1,225959099,225959244,HepG2|chr1:225964643-225964711,chr1,225964643,225964711,1,5544
HepG2|chr1:225959161-225959243,chr1,225959161,225959243,HepG2|chr1:225964643-225964711,chr1,225964643,225964711,1,5482
HepG2|chr1:228302404-228302432,chr1,228302404,228302432,HepG2|chr1:228298913-228299056,chr1,228298913,228299056,1,3491
HepG2|chr1:228302750-228302812,chr1,228302750,228302812,HepG2|chr1:228300737-228300850,chr1,228300737,228300850,1,2013
HepG2|chr1:228302782-228302816,chr1,228302782,228302816,HepG2|chr1:228300737-228300850,chr1,228300737,228300850,1,2045
HepG2|chr1:228302956-228303028,chr1,228302956,228303028,HepG2|chr1:228297829-228297930,chr1,228297829,228297930,1,5127
HepG2|chr1:228618664-228618781,chr1,228618664,228618781,HepG2|chr1:228608345-228608396,chr1,228608345,228608396,1,10319
HepG2|chr1:228618664-228618731,chr1,228618664,228618731,HepG2|chr1:228608345-228608397,chr1,228608345,228608397,1,10319
HepG2|chr1:228619482-228619567,chr1,228619482,228619567,HepG2|chr1:228609515-228609580,chr1,228609515,228609580,1,9967
HepG2|chr1:228620765-228620845,chr1,228620765,228620845,HepG2|chr1:228595215-228595285,chr1,228595215,228595285,1,25550
HepG2|chr1:228620766-228620846,chr1,228620766,228620846,HepG2|chr1:228595215-228595285,chr1,228595215,228595285,1,25551
HepG2|chr1:228620786-228620834,chr1,228620786,228620834,HepG2|chr1:228603863-228603984,chr1,228603863,228603984,1,16923
HepG2|chr1:228620786-228620815,chr1,228620786,228620815,HepG2|chr1:228603863-228603984,chr1,228603863,228603984,1,16923
HepG2|chr1:235251639-235251655,chr1,235251639,235251655,HepG2|chr1:235321462-235321521,chr1,235321462,235321521,1,69823
HepG2|chr1:235475322-235475438,chr1,235475322,235475438,HepG2|chr1:235531154-235531187,chr1,235531154,235531187,1,55832
HepG2|chr1:235475322-235475431,chr1,235475322,235475431,HepG2|chr1:235531154-235531187,chr1,235531154,235531187,1,55832
HepG2|chr1:235475322-235475429,chr1,235475322,235475429,HepG2|chr1:235531154-235531189,chr1,235531154,235531189,1,55832
HepG2|chr1:243264443-243264566,chr1,243264443,243264566,HepG2|chr1:224179579-224179667,chr1,224179579,224179667,1,19084864
HepG2|chr1:243264507-243264566,chr1,243264507,243264566,HepG2|chr1:224179579-224179667,chr1,224179579,224179667,1,19084928
HepG2|chr1:245004445-245004497,chr1,245004445,245004497,HepG2|chr1:245020750-245020900,chr1,245020750,245020900,1,16305
HepG2|chr1:245006235-245006375,chr1,245006235,245006375,HepG2|chr1:245025570-245025608,chr1,245025570,245025608,1,19335
HepG2|chr1:245006235-245006347,chr1,245006235,245006347,HepG2|chr1:245025570-245025608,chr1,245025570,245025608,1,19335
HepG2|chr1:245008479-245008500,chr1,245008479,245008500,HepG2|chr1:245019113-245019216,chr1,245019113,245019216,1,10634
HepG2|chr1:245011664-245011721,chr1,245011664,245011721,HepG2|chr1:245022842-245022941,chr1,245022842,245022941,1,11178
HepG2|chr1:245011664-245011715,chr1,245011664,245011715,HepG2|chr1:245022842-245022941,chr1,245022842,245022941,1,11178
HepG2|chr1:245011684-245011706,chr1,245011684,245011706,HepG2|chr1:245024999-245025063,chr1,245024999,245025063,1,13315
HepG2|chr1:245011921-245011988,chr1,245011921,245011988,HepG2|chr1:245000232-245000265,chr1,245000232,245000265,1,11689
HepG2|chr1:245011921-245011987,chr1,245011921,245011987,HepG2|chr1:245000232-245000265,chr1,245000232,245000265,1,11689
HepG2|chr1:245012688-245012802,chr1,245012688,245012802,HepG2|chr1:245024858-245024898,chr1,245024858,245024898,1,12170
HepG2|chr1:245012692-245012802,chr1,245012692,245012802,HepG2|chr1:245024858-245024898,chr1,245024858,245024898,1,12166
HepG2|chr1:245012716-245012826,chr1,245012716,245012826,HepG2|chr1:245001128-245001159,chr1,245001128,245001159,1,11588
HepG2|chr1:245012716-245012807,chr1,245012716,245012807,HepG2|chr1:245001128-245001159,chr1,245001128,245001159,1,11588
HepG2|chr1:245012819-245012883,chr1,245012819,245012883,HepG2|chr1:220441237-220441314,chr1,220441237,220441314,1,24571582
HepG2|chr1:245012820-245012883,chr1,245012820,245012883,HepG2|chr1:220441237-220441314,chr1,220441237,220441314,1,24571583
HepG2|chr1:245012970-245013070,chr1,245012970,245013070,HepG2|chr1:245000045-245000132,chr1,245000045,245000132,1,12925
HepG2|chr1:245012970-245013033,chr1,245012970,245013033,HepG2|chr1:245000045-245000132,chr1,245000045,245000132,1,12925
HepG2|chr1:245013752-245013793,chr1,245013752,245013793,HepG2|chr1:245019122-245019148,chr1,245019122,245019148,1,5370
HepG2|chr1:245554225-245554263,chr1,245554225,245554263,HepG2|chr1:245025641-245025697,chr1,245025641,245025697,1,528584
HepG2|chr1:245554226-245554263,chr1,245554226,245554263,HepG2|chr1:245025596-245025697,chr1,245025596,245025697,1,528630
HepG2|chr1:246339055-246339094,chr1,246339055,246339094,HepG2|chr1:148557625-148557732,chr1,148557625,148557732,1,97781430
HepG2|chr1:247501524-247501598,chr1,247501524,247501598,HepG2|chr1:247499555-247499581,chr1,247499555,247499581,1,1969
HepG2|chr1:247501561-247501605,chr1,247501561,247501605,HepG2|chr1:247499946-247500049,chr1,247499946,247500049,1,1615
HepG2|chr1:247501614-247501761,chr1,247501614,247501761,HepG2|chr1:247499555-247499581,chr1,247499555,247499581,1,2059
HepG2|chr1:247501642-247501778,chr1,247501642,247501778,HepG2|chr1:247498777-247498875,chr1,247498777,247498875,1,2865
HepG2|chr1:247501949-247501991,chr1,247501949,247501991,HepG2|chr1:247497791-247497830,chr1,247497791,247497830,1,4158
HepG2|chr1:247502031-247502113,chr1,247502031,247502113,HepG2|chr1:247497829-247497876,chr1,247497829,247497876,1,4202
HepG2|chr1:247502047-247502097,chr1,247502047,247502097,HepG2|chr1:247497791-247497830,chr1,247497791,247497830,1,4256
HepG2|chr1:247502067-247502086,chr1,247502067,247502086,HepG2|chr1:247498107-247498257,chr1,247498107,247498257,1,3960
HepG2|chr1:247502169-247502258,chr1,247502169,247502258,HepG2|chr1:247499340-247499401,chr1,247499340,247499401,1,2829
HepG2|chr1:247502238-247502388,chr1,247502238,247502388,HepG2|chr1:247499340-247499401,chr1,247499340,247499401,1,2898
HepG2|chr1:247502436-247502560,chr1,247502436,247502560,HepG2|chr1:247497893-247497913,chr1,247497893,247497913,1,4543
HepG2|chr1:247502437-247502560,chr1,247502437,247502560,HepG2|chr1:247497893-247497913,chr1,247497893,247497913,1,4544
HepG2|chr1:247502456-247502606,chr1,247502456,247502606,HepG2|chr1:247497612-247497694,chr1,247497612,247497694,1,4844
HepG2|chr1:247502953-247503034,chr1,247502953,247503034,HepG2|chr1:247497795-247497855,chr1,247497795,247497855,1,5158
HepG2|chr1:247503065-247503197,chr1,247503065,247503197,HepG2|chr1:247497284-247497302,chr1,247497284,247497302,1,5781
HepG2|chr1:247503108-247503258,chr1,247503108,247503258,HepG2|chr1:247497284-247497302,chr1,247497284,247497302,1,5824
HepG2|chr1:247503251-247503401,chr1,247503251,247503401,HepG2|chr1:247498919-247498955,chr1,247498919,247498955,1,4332
HepG2|chr1:247503282-247503394,chr1,247503282,247503394,HepG2|chr1:247499397-247499515,chr1,247499397,247499515,1,3885
HepG2|chr1:247503282-247503314,chr1,247503282,247503314,HepG2|chr1:247499397-247499515,chr1,247499397,247499515,1,3885
HepG2|chr1:247503293-247503404,chr1,247503293,247503404,HepG2|chr1:247498919-247498955,chr1,247498919,247498955,1,4374
HepG2|chr1:247503419-247503500,chr1,247503419,247503500,HepG2|chr1:247496594-247496689,chr1,247496594,247496689,1,6825
HepG2|chr1:247503419-247503474,chr1,247503419,247503474,HepG2|chr1:247496594-247496689,chr1,247496594,247496689,1,6825
HepG2|chr1:247503626-247503700,chr1,247503626,247503700,HepG2|chr1:247498152-247498228,chr1,247498152,247498228,1,5474
HepG2|chr1:247503730-247503831,chr1,247503730,247503831,HepG2|chr1:247499026-247499161,chr1,247499026,247499161,1,4704
HepG2|chr1:247504389-247504415,chr1,247504389,247504415,HepG2|chr1:247498985-247499135,chr1,247498985,247499135,1,5404
HepG2|chr1:247504772-247504827,chr1,247504772,247504827,HepG2|chr1:247497320-247497447,chr1,247497320,247497447,1,7452
HepG2|chr1:247504806-247504828,chr1,247504806,247504828,HepG2|chr1:247497320-247497447,chr1,247497320,247497447,1,7486
HepG2|chr1:247505196-247505284,chr1,247505196,247505284,HepG2|chr1:247497977-247498127,chr1,247497977,247498127,1,7219
HepG2|chr1:247505703-247505853,chr1,247505703,247505853,HepG2|chr1:247499533-247499552,chr1,247499533,247499552,1,6170
HepG2|chr1:247505820-247505947,chr1,247505820,247505947,HepG2|chr1:247499533-247499552,chr1,247499533,247499552,1,6287
HepG2|chr1:247505994-247506075,chr1,247505994,247506075,HepG2|chr1:247496606-247496632,chr1,247496606,247496632,1,9388
HepG2|chr1:247505994-247506074,chr1,247505994,247506074,HepG2|chr1:247496606-247496632,chr1,247496606,247496632,1,9388
HepG2|chr1:247508831-247508850,chr1,247508831,247508850,HepG2|chr1:247499342-247499492,chr1,247499342,247499492,1,9489
HepG2|chr2:3588016-3588080,chr2,3588016,3588080,HepG2|chr2:3644008-3644074,chr2,3644008,3644074,1,55992
HepG2|chr2:11453715-11453865,chr2,11453715,11453865,HepG2|chr2:11603328-11603350,chr2,11603328,11603350,1,149613
HepG2|chr2:11453715-11453864,chr2,11453715,11453864,HepG2|chr2:11603328-11603349,chr2,11603328,11603349,1,149613
HepG2|chr2:11453776-11453904,chr2,11453776,11453904,HepG2|chr2:11603328-11603350,chr2,11603328,11603350,1,149552
HepG2|chr2:11612990-11613116,chr2,11612990,11613116,HepG2|chr2:11609567-11609713,chr2,11609567,11609713,1,3423
HepG2|chr2:11613187-11613283,chr2,11613187,11613283,HepG2|chr2:11607210-11607264,chr2,11607210,11607264,1,5977
HepG2|chr2:11613253-11613400,chr2,11613253,11613400,HepG2|chr2:11607210-11607264,chr2,11607210,11607264,1,6043
HepG2|chr2:11613289-11613328,chr2,11613289,11613328,HepG2|chr2:11606405-11606519,chr2,11606405,11606519,1,6884
HepG2|chr2:11613289-11613325,chr2,11613289,11613325,HepG2|chr2:11606405-11606519,chr2,11606405,11606519,1,6884
HepG2|chr2:11613289-11613311,chr2,11613289,11613311,HepG2|chr2:11606341-11606444,chr2,11606341,11606444,1,6948
HepG2|chr2:11613289-11613310,chr2,11613289,11613310,HepG2|chr2:11606412-11606519,chr2,11606412,11606519,1,6877
HepG2|chr2:11613289-11613309,chr2,11613289,11613309,HepG2|chr2:11606412-11606519,chr2,11606412,11606519,1,6877
HepG2|chr2:11613831-11613920,chr2,11613831,11613920,HepG2|chr2:11610132-11610173,chr2,11610132,11610173,1,3699
HepG2|chr2:11613831-11613919,chr2,11613831,11613919,HepG2|chr2:11610132-11610173,chr2,11610132,11610173,1,3699
HepG2|chr2:11614018-11614071,chr2,11614018,11614071,HepG2|chr2:11606790-11606940,chr2,11606790,11606940,1,7228
HepG2|chr2:11617516-11617571,chr2,11617516,11617571,HepG2|chr2:11606855-11606950,chr2,11606855,11606950,1,10661
HepG2|chr2:11619041-11619097,chr2,11619041,11619097,HepG2|chr2:11610310-11610411,chr2,11610310,11610411,1,8731
HepG2|chr2:11619041-11619090,chr2,11619041,11619090,HepG2|chr2:11610310-11610411,chr2,11610310,11610411,1,8731
HepG2|chr2:11646485-11646635,chr2,11646485,11646635,HepG2|chr2:11610428-11610456,chr2,11610428,11610456,1,36057
HepG2|chr2:11646583-11646705,chr2,11646583,11646705,HepG2|chr2:11610428-11610456,chr2,11610428,11610456,1,36155
HepG2|chr2:32839511-32839536,chr2,32839511,32839536,HepG2|chr2:32850912-32851025,chr2,32850912,32851025,1,11401
HepG2|chr2:32844069-32844173,chr2,32844069,32844173,HepG2|chr2:32850874-32850920,chr2,32850874,32850920,1,6805
HepG2|chr2:32844070-32844173,chr2,32844070,32844173,HepG2|chr2:32850874-32850920,chr2,32850874,32850920,1,6804
HepG2|chr2:32844832-32844873,chr2,32844832,32844873,HepG2|chr2:32853850-32854000,chr2,32853850,32854000,1,9018
HepG2|chr2:32845827-32845919,chr2,32845827,32845919,HepG2|chr2:32850326-32850384,chr2,32850326,32850384,1,4499
HepG2|chr2:32976935-32976996,chr2,32976935,32976996,HepG2|chr2:32852094-32852181,chr2,32852094,32852181,1,124841
HepG2|chr2:32976936-32976996,chr2,32976936,32976996,HepG2|chr2:32852094-32852181,chr2,32852094,32852181,1,124842
HepG2|chr2:42282279-42282297,chr2,42282279,42282297,HepG2|chr2:172779820-172779949,chr2,172779820,172779949,1,130497541
HepG2|chr2:42419667-42419687,chr2,42419667,42419687,HepG2|chr2:69970375-69970525,chr2,69970375,69970525,1,27550708
HepG2|chr2:43054585-43054670,chr2,43054585,43054670,HepG2|chr2:43019463-43019528,chr2,43019463,43019528,1,35122
HepG2|chr2:43054594-43054744,chr2,43054594,43054744,HepG2|chr2:43019463-43019528,chr2,43019463,43019528,1,35131
HepG2|chr2:47257788-47257915,chr2,47257788,47257915,HepG2|chr2:44296282-44296299,chr2,44296282,44296299,1,2961506
HepG2|chr2:48470663-48470758,chr2,48470663,48470758,HepG2|chr2:48540828-48540888,chr2,48540828,48540888,1,70165
HepG2|chr2:48470668-48470758,chr2,48470668,48470758,HepG2|chr2:48540828-48540888,chr2,48540828,48540888,1,70160
HepG2|chr2:48470670-48470756,chr2,48470670,48470756,HepG2|chr2:48540828-48540888,chr2,48540828,48540888,1,70158
HepG2|chr2:54771482-54771527,chr2,54771482,54771527,HepG2|chr2:201724865-201725015,chr2,201724865,201725015,1,146953383
HepG2|chr2:55248470-55248620,chr2,55248470,55248620,HepG2|chr2:30370162-30370262,chr2,30370162,30370262,1,24878308
HepG2|chr2:55506082-55506166,chr2,55506082,55506166,HepG2|chr2:55496965-55496983,chr2,55496965,55496983,1,9117
HepG2|chr2:55506082-55506131,chr2,55506082,55506131,HepG2|chr2:55496857-55496983,chr2,55496857,55496983,1,9225
HepG2|chr2:58434650-58434681,chr2,58434650,58434681,HepG2|chr2:27807868-27807975,chr2,27807868,27807975,1,30626782
HepG2|chr2:58434651-58434681,chr2,58434651,58434681,HepG2|chr2:27807868-27807975,chr2,27807868,27807975,1,30626783
HepG2|chr2:62247722-62247859,chr2,62247722,62247859,HepG2|chr2:203133596-203133659,chr2,203133596,203133659,1,140885874
HepG2|chr2:62247722-62247858,chr2,62247722,62247858,HepG2|chr2:203133596-203133659,chr2,203133596,203133659,1,140885874
HepG2|chr2:62247767-62247854,chr2,62247767,62247854,HepG2|chr2:203133596-203133659,chr2,203133596,203133659,1,140885829
HepG2|chr2:65094360-65094393,chr2,65094360,65094393,HepG2|chr2:65139293-65139343,chr2,65139293,65139343,1,44933
HepG2|chr2:71565796-71565819,chr2,71565796,71565819,HepG2|chr2:219432757-219432878,chr2,219432757,219432878,1,147866961
HepG2|chr2:71565796-71565817,chr2,71565796,71565817,HepG2|chr2:233384914-233385041,chr2,233384914,233385041,1,161819118
HepG2|chr2:71565799-71565821,chr2,71565799,71565821,HepG2|chr2:174829046-174829166,chr2,174829046,174829166,1,103263247
HepG2|chr2:71565799-71565820,chr2,71565799,71565820,HepG2|chr2:233384906-233385044,chr2,233384906,233385044,1,161819107
HepG2|chr2:73788331-73788420,chr2,73788331,73788420,HepG2|chr2:242848595-242848625,chr2,242848595,242848625,1,169060264
HepG2|chr2:73788331-73788416,chr2,73788331,73788416,HepG2|chr2:242848595-242848625,chr2,242848595,242848625,1,169060264
HepG2|chr2:74213608-74213758,chr2,74213608,74213758,HepG2|chr2:74230236-74230355,chr2,74230236,74230355,1,16628
HepG2|chr2:74213648-74213798,chr2,74213648,74213798,HepG2|chr2:74230320-74230369,chr2,74230320,74230369,1,16672
HepG2|chr2:74213717-74213833,chr2,74213717,74213833,HepG2|chr2:74230236-74230369,chr2,74230236,74230369,1,16519
HepG2|chr2:74213727-74213833,chr2,74213727,74213833,HepG2|chr2:74230317-74230467,chr2,74230317,74230467,1,16590
HepG2|chr2:74213745-74213833,chr2,74213745,74213833,HepG2|chr2:74230320-74230351,chr2,74230320,74230351,1,16575
HepG2|chr2:74213746-74213833,chr2,74213746,74213833,HepG2|chr2:74230266-74230416,chr2,74230266,74230416,1,16520
HepG2|chr2:74213758-74213833,chr2,74213758,74213833,HepG2|chr2:74230262-74230412,chr2,74230262,74230412,1,16504
HepG2|chr2:74213762-74213833,chr2,74213762,74213833,HepG2|chr2:74230254-74230404,chr2,74230254,74230404,1,16492
HepG2|chr2:74213763-74213833,chr2,74213763,74213833,HepG2|chr2:74230418-74230463,chr2,74230418,74230463,1,16655
HepG2|chr2:74213764-74213833,chr2,74213764,74213833,HepG2|chr2:74230414-74230463,chr2,74230414,74230463,1,16650
HepG2|chr2:74213766-74213833,chr2,74213766,74213833,HepG2|chr2:74230243-74230390,chr2,74230243,74230390,1,16477
HepG2|chr2:74213773-74213833,chr2,74213773,74213833,HepG2|chr2:74230236-74230353,chr2,74230236,74230353,1,16463
HepG2|chr2:74213778-74213833,chr2,74213778,74213833,HepG2|chr2:74230320-74230351,chr2,74230320,74230351,1,16542
HepG2|chr2:74213780-74213833,chr2,74213780,74213833,HepG2|chr2:74230262-74230412,chr2,74230262,74230412,1,16482
HepG2|chr2:74213785-74213833,chr2,74213785,74213833,HepG2|chr2:74230236-74230353,chr2,74230236,74230353,1,16451
HepG2|chr2:74213789-74213833,chr2,74213789,74213833,HepG2|chr2:74230236-74230363,chr2,74230236,74230363,1,16447
HepG2|chr2:74213800-74213833,chr2,74213800,74213833,HepG2|chr2:74230236-74230353,chr2,74230236,74230353,1,16436
HepG2|chr2:74213802-74213833,chr2,74213802,74213833,HepG2|chr2:74230236-74230355,chr2,74230236,74230355,1,16434
HepG2|chr2:74213803-74213833,chr2,74213803,74213833,HepG2|chr2:74230236-74230358,chr2,74230236,74230358,1,16433
HepG2|chr2:74213805-74213833,chr2,74213805,74213833,HepG2|chr2:74230268-74230418,chr2,74230268,74230418,1,16463
HepG2|chr2:74213807-74213833,chr2,74213807,74213833,HepG2|chr2:74230320-74230363,chr2,74230320,74230363,1,16513
HepG2|chr2:74213808-74213833,chr2,74213808,74213833,HepG2|chr2:74230320-74230353,chr2,74230320,74230353,1,16512
HepG2|chr2:74214021-74214080,chr2,74214021,74214080,HepG2|chr2:74226167-74226317,chr2,74226167,74226317,1,12146
HepG2|chr2:75142712-75142799,chr2,75142712,75142799,HepG2|chr2:75874486-75874521,chr2,75874486,75874521,1,731774
HepG2|chr2:75148194-75148238,chr2,75148194,75148238,HepG2|chr2:75181289-75181423,chr2,75181289,75181423,1,33095
HepG2|chr2:75155513-75155594,chr2,75155513,75155594,HepG2|chr2:75183823-75183869,chr2,75183823,75183869,1,28310
HepG2|chr2:75155575-75155594,chr2,75155575,75155594,HepG2|chr2:75183726-75183811,chr2,75183726,75183811,1,28151
HepG2|chr2:75164274-75164386,chr2,75164274,75164386,HepG2|chr2:75184082-75184232,chr2,75184082,75184232,1,19808
HepG2|chr2:75167506-75167613,chr2,75167506,75167613,HepG2|chr2:75183230-75183262,chr2,75183230,75183262,1,15724
HepG2|chr2:75167506-75167612,chr2,75167506,75167612,HepG2|chr2:75183230-75183262,chr2,75183230,75183262,1,15724
HepG2|chr2:75167858-75167891,chr2,75167858,75167891,HepG2|chr2:75184773-75184890,chr2,75184773,75184890,1,16915
HepG2|chr2:75167859-75167892,chr2,75167859,75167892,HepG2|chr2:75184773-75184890,chr2,75184773,75184890,1,16914
HepG2|chr2:75169780-75169834,chr2,75169780,75169834,HepG2|chr2:75184076-75184226,chr2,75184076,75184226,1,14296
HepG2|chr2:75179980-75180130,chr2,75179980,75180130,HepG2|chr2:75181364-75181402,chr2,75181364,75181402,1,1384
HepG2|chr2:75180031-75180143,chr2,75180031,75180143,HepG2|chr2:75181364-75181402,chr2,75181364,75181402,1,1333
HepG2|chr2:75803690-75803806,chr2,75803690,75803806,HepG2|chr2:75801251-75801340,chr2,75801251,75801340,1,2439
HepG2|chr2:75812869-75812982,chr2,75812869,75812982,HepG2|chr2:75800353-75800386,chr2,75800353,75800386,1,12516
HepG2|chr2:75813052-75813162,chr2,75813052,75813162,HepG2|chr2:75800352-75800386,chr2,75800352,75800386,1,12700
HepG2|chr2:75816871-75816960,chr2,75816871,75816960,HepG2|chr2:75788934-75789024,chr2,75788934,75789024,1,27937
HepG2|chr2:75816900-75816960,chr2,75816900,75816960,HepG2|chr2:75788934-75789024,chr2,75788934,75789024,1,27966
HepG2|chr2:75822859-75822898,chr2,75822859,75822898,HepG2|chr2:75797518-75797665,chr2,75797518,75797665,1,25341
HepG2|chr2:85172130-85172158,chr2,85172130,85172158,HepG2|chr2:85196263-85196376,chr2,85196263,85196376,1,24133
HepG2|chr2:85173750-85173820,chr2,85173750,85173820,HepG2|chr2:85128905-85129002,chr2,85128905,85129002,1,44845
HepG2|chr2:85173750-85173803,chr2,85173750,85173803,HepG2|chr2:85128905-85129002,chr2,85128905,85129002,1,44845
HepG2|chr2:85173750-85173772,chr2,85173750,85173772,HepG2|chr2:85128896-85129002,chr2,85128896,85129002,1,44854
HepG2|chr2:85175312-85175430,chr2,85175312,85175430,HepG2|chr2:85193865-85193885,chr2,85193865,85193885,1,18553
HepG2|chr2:85177038-85177121,chr2,85177038,85177121,HepG2|chr2:85195624-85195668,chr2,85195624,85195668,1,18586
HepG2|chr2:85184588-85184660,chr2,85184588,85184660,HepG2|chr2:85194418-85194568,chr2,85194418,85194568,1,9830
HepG2|chr2:85184805-85184848,chr2,85184805,85184848,HepG2|chr2:85193547-85193638,chr2,85193547,85193638,1,8742
HepG2|chr2:85184806-85184848,chr2,85184806,85184848,HepG2|chr2:85193547-85193638,chr2,85193547,85193638,1,8741
HepG2|chr2:85185965-85186003,chr2,85185965,85186003,HepG2|chr2:85195869-85195998,chr2,85195869,85195998,1,9904
HepG2|chr2:85189124-85189212,chr2,85189124,85189212,HepG2|chr2:85197480-85197630,chr2,85197480,85197630,1,8356
HepG2|chr2:85189124-85189189,chr2,85189124,85189189,HepG2|chr2:85197480-85197630,chr2,85197480,85197630,1,8356
HepG2|chr2:85189930-85189952,chr2,85189930,85189952,HepG2|chr2:85194638-85194774,chr2,85194638,85194774,1,4708
HepG2|chr2:85190038-85190185,chr2,85190038,85190185,HepG2|chr2:85193944-85193976,chr2,85193944,85193976,1,3906
HepG2|chr2:85190038-85190147,chr2,85190038,85190147,HepG2|chr2:85128899-85129002,chr2,85128899,85129002,1,61139
HepG2|chr2:85190038-85190085,chr2,85190038,85190085,HepG2|chr2:85128899-85129002,chr2,85128899,85129002,1,61139
HepG2|chr2:85190038-85190081,chr2,85190038,85190081,HepG2|chr2:85128877-85129002,chr2,85128877,85129002,1,61161
HepG2|chr2:85190038-85190063,chr2,85190038,85190063,HepG2|chr2:85128877-85129002,chr2,85128877,85129002,1,61161
HepG2|chr2:85190045-85190195,chr2,85190045,85190195,HepG2|chr2:85196491-85196588,chr2,85196491,85196588,1,6446
HepG2|chr2:85190085-85190226,chr2,85190085,85190226,HepG2|chr2:85193944-85193986,chr2,85193944,85193986,1,3859
HepG2|chr2:85190108-85190226,chr2,85190108,85190226,HepG2|chr2:85193944-85193976,chr2,85193944,85193976,1,3836
HepG2|chr2:85190114-85190226,chr2,85190114,85190226,HepG2|chr2:85193944-85193982,chr2,85193944,85193982,1,3830
HepG2|chr2:85190118-85190226,chr2,85190118,85190226,HepG2|chr2:85193944-85193986,chr2,85193944,85193986,1,3826
HepG2|chr2:85190121-85190226,chr2,85190121,85190226,HepG2|chr2:85193944-85193986,chr2,85193944,85193986,1,3823
HepG2|chr2:85190136-85190226,chr2,85190136,85190226,HepG2|chr2:85193944-85194020,chr2,85193944,85194020,1,3808
HepG2|chr2:85190146-85190226,chr2,85190146,85190226,HepG2|chr2:85197055-85197101,chr2,85197055,85197101,1,6909
HepG2|chr2:85190152-85190226,chr2,85190152,85190226,HepG2|chr2:85193944-85194020,chr2,85193944,85194020,1,3792
HepG2|chr2:85190154-85190252,chr2,85190154,85190252,HepG2|chr2:85194632-85194659,chr2,85194632,85194659,1,4478
HepG2|chr2:85190179-85190329,chr2,85190179,85190329,HepG2|chr2:85193944-85194003,chr2,85193944,85194003,1,3765
HepG2|chr2:85190179-85190268,chr2,85190179,85190268,HepG2|chr2:85193423-85193568,chr2,85193423,85193568,1,3244
HepG2|chr2:85190185-85190226,chr2,85190185,85190226,HepG2|chr2:85193944-85194004,chr2,85193944,85194004,1,3759
HepG2|chr2:85190191-85190226,chr2,85190191,85190226,HepG2|chr2:85197055-85197140,chr2,85197055,85197140,1,6864
HepG2|chr2:85190193-85190268,chr2,85190193,85190268,HepG2|chr2:85193435-85193542,chr2,85193435,85193542,1,3242
HepG2|chr2:85190206-85190349,chr2,85190206,85190349,HepG2|chr2:85193944-85193979,chr2,85193944,85193979,1,3738
HepG2|chr2:85190211-85190268,chr2,85190211,85190268,HepG2|chr2:85193435-85193529,chr2,85193435,85193529,1,3224
HepG2|chr2:85190213-85190268,chr2,85190213,85190268,HepG2|chr2:85193435-85193529,chr2,85193435,85193529,1,3222
HepG2|chr2:85190218-85190268,chr2,85190218,85190268,HepG2|chr2:85196491-85196588,chr2,85196491,85196588,1,6273
HepG2|chr2:85190219-85190349,chr2,85190219,85190349,HepG2|chr2:85193944-85193993,chr2,85193944,85193993,1,3725
HepG2|chr2:85190225-85190268,chr2,85190225,85190268,HepG2|chr2:85193435-85193542,chr2,85193435,85193542,1,3210
HepG2|chr2:85190226-85190250,chr2,85190226,85190250,HepG2|chr2:85195596-85195732,chr2,85195596,85195732,1,5370
HepG2|chr2:85190234-85190349,chr2,85190234,85190349,HepG2|chr2:85193944-85193979,chr2,85193944,85193979,1,3710
HepG2|chr2:85190242-85190349,chr2,85190242,85190349,HepG2|chr2:85193944-85194017,chr2,85193944,85194017,1,3702
HepG2|chr2:85190245-85190349,chr2,85190245,85190349,HepG2|chr2:85193944-85193963,chr2,85193944,85193963,1,3699
HepG2|chr2:85190248-85190349,chr2,85190248,85190349,HepG2|chr2:85193944-85193993,chr2,85193944,85193993,1,3696
HepG2|chr2:85190258-85190349,chr2,85190258,85190349,HepG2|chr2:85193944-85194003,chr2,85193944,85194003,1,3686
HepG2|chr2:85190259-85190278,chr2,85190259,85190278,HepG2|chr2:85194010-85194109,chr2,85194010,85194109,1,3751
HepG2|chr2:85190282-85190349,chr2,85190282,85190349,HepG2|chr2:85193944-85194017,chr2,85193944,85194017,1,3662
HepG2|chr2:85190317-85190349,chr2,85190317,85190349,HepG2|chr2:85193944-85194017,chr2,85193944,85194017,1,3627
HepG2|chr2:85190319-85190349,chr2,85190319,85190349,HepG2|chr2:85193944-85194042,chr2,85193944,85194042,1,3625
HepG2|chr2:85190342-85190382,chr2,85190342,85190382,HepG2|chr2:85193179-85193326,chr2,85193179,85193326,1,2837
HepG2|chr2:85190349-85190369,chr2,85190349,85190369,HepG2|chr2:85193392-85193531,chr2,85193392,85193531,1,3043
HepG2|chr2:85190501-85190606,chr2,85190501,85190606,HepG2|chr2:85194034-85194075,chr2,85194034,85194075,1,3533
HepG2|chr2:85190728-85190810,chr2,85190728,85190810,HepG2|chr2:85194004-85194058,chr2,85194004,85194058,1,3276
HepG2|chr2:85190728-85190773,chr2,85190728,85190773,HepG2|chr2:85194005-85194058,chr2,85194005,85194058,1,3277
HepG2|chr2:85190732-85190810,chr2,85190732,85190810,HepG2|chr2:85194005-85194058,chr2,85194005,85194058,1,3273
HepG2|chr2:85190775-85190922,chr2,85190775,85190922,HepG2|chr2:85194100-85194126,chr2,85194100,85194126,1,3325
HepG2|chr2:85190904-85191028,chr2,85190904,85191028,HepG2|chr2:85194100-85194126,chr2,85194100,85194126,1,3196
HepG2|chr2:85191017-85191047,chr2,85191017,85191047,HepG2|chr2:85193499-85193649,chr2,85193499,85193649,1,2482
HepG2|chr2:85191031-85191059,chr2,85191031,85191059,HepG2|chr2:85193802-85193952,chr2,85193802,85193952,1,2771
HepG2|chr2:85191254-85191359,chr2,85191254,85191359,HepG2|chr2:85195625-85195669,chr2,85195625,85195669,1,4371
HepG2|chr2:85191305-85191455,chr2,85191305,85191455,HepG2|chr2:85195625-85195669,chr2,85195625,85195669,1,4320
HepG2|chr2:85192178-85192265,chr2,85192178,85192265,HepG2|chr2:85197527-85197589,chr2,85197527,85197589,1,5349
HepG2|chr2:85192298-85192447,chr2,85192298,85192447,HepG2|chr2:85197527-85197589,chr2,85197527,85197589,1,5229
HepG2|chr2:85192514-85192639,chr2,85192514,85192639,HepG2|chr2:85194273-85194343,chr2,85194273,85194343,1,1759
HepG2|chr2:85192514-85192594,chr2,85192514,85192594,HepG2|chr2:85194273-85194343,chr2,85194273,85194343,1,1759
HepG2|chr2:85192550-85192678,chr2,85192550,85192678,HepG2|chr2:85193448-85193542,chr2,85193448,85193542,1,898
HepG2|chr2:85192550-85192605,chr2,85192550,85192605,HepG2|chr2:85193448-85193542,chr2,85193448,85193542,1,898
HepG2|chr2:85192557-85192574,chr2,85192557,85192574,HepG2|chr2:85193162-85193312,chr2,85193162,85193312,1,605
HepG2|chr2:87302099-87302249,chr2,87302099,87302249,HepG2|chr2:86948769-86948919,chr2,86948769,86948919,1,353330
HepG2|chr2:87302127-87302184,chr2,87302127,87302184,HepG2|chr2:86948788-86948919,chr2,86948788,86948919,1,353339
HepG2|chr2:87302230-87302376,chr2,87302230,87302376,HepG2|chr2:86948714-86948759,chr2,86948714,86948759,1,353516
HepG2|chr2:87302265-87302415,chr2,87302265,87302415,HepG2|chr2:86948605-86948753,chr2,86948605,86948753,1,353660
HepG2|chr2:87302367-87302517,chr2,87302367,87302517,HepG2|chr2:86948601-86948747,chr2,86948601,86948747,1,353766
HepG2|chr2:87304040-87304190,chr2,87304040,87304190,HepG2|chr2:86946797-86946947,chr2,86946797,86946947,1,357243
HepG2|chr2:87304077-87304222,chr2,87304077,87304222,HepG2|chr2:86946823-86946966,chr2,86946823,86946966,1,357254
HepG2|chr2:98205709-98205754,chr2,98205709,98205754,HepG2|chr2:97779754-97779904,chr2,97779754,97779904,1,425955
HepG2|chr2:98205714-98205754,chr2,98205714,98205754,HepG2|chr2:97779776-97779923,chr2,97779776,97779923,1,425938
HepG2|chr2:98205915-98206065,chr2,98205915,98206065,HepG2|chr2:97779789-97779850,chr2,97779789,97779850,1,426126
HepG2|chr2:98205920-98206070,chr2,98205920,98206070,HepG2|chr2:97779792-97779826,chr2,97779792,97779826,1,426128
HepG2|chr2:98205932-98206082,chr2,98205932,98206082,HepG2|chr2:97779756-97779801,chr2,97779756,97779801,1,426176
HepG2|chr2:98205933-98206083,chr2,98205933,98206083,HepG2|chr2:97779792-97779825,chr2,97779792,97779825,1,426141
HepG2|chr2:98206042-98206192,chr2,98206042,98206192,HepG2|chr2:97779646-97779792,chr2,97779646,97779792,1,426396
HepG2|chr2:101460755-101460817,chr2,101460755,101460817,HepG2|chr2:101435208-101435358,chr2,101435208,101435358,1,25547
HepG2|chr2:101480623-101480688,chr2,101480623,101480688,HepG2|chr2:101435628-101435763,chr2,101435628,101435763,1,44995
HepG2|chr2:101486369-101486477,chr2,101486369,101486477,HepG2|chr2:96677704-96677854,chr2,96677704,96677854,1,4808665
HepG2|chr2:101486383-101486482,chr2,101486383,101486482,HepG2|chr2:96677688-96677739,chr2,96677688,96677739,1,4808695
HepG2|chr2:101516733-101516846,chr2,101516733,101516846,HepG2|chr2:101435710-101435805,chr2,101435710,101435805,1,81023
HepG2|chr2:101516733-101516784,chr2,101516733,101516784,HepG2|chr2:101435710-101435805,chr2,101435710,101435805,1,81023
HepG2|chr2:114573015-114573091,chr2,114573015,114573091,HepG2|chr2:114518058-114518093,chr2,114518058,114518093,1,54957
HepG2|chr2:114573015-114573050,chr2,114573015,114573050,HepG2|chr2:114518013-114518093,chr2,114518013,114518093,1,55002
HepG2|chr2:114573015-114573041,chr2,114573015,114573041,HepG2|chr2:114517955-114518098,chr2,114517955,114518098,1,55060
HepG2|chr2:114576011-114576068,chr2,114576011,114576068,HepG2|chr2:114518058-114518093,chr2,114518058,114518093,1,57953
HepG2|chr2:127985287-127985400,chr2,127985287,127985400,HepG2|chr2:127982625-127982662,chr2,127982625,127982662,1,2662
HepG2|chr2:127985287-127985352,chr2,127985287,127985352,HepG2|chr2:127982581-127982662,chr2,127982581,127982662,1,2706
HepG2|chr2:127985287-127985346,chr2,127985287,127985346,HepG2|chr2:127982581-127982662,chr2,127982581,127982662,1,2706
HepG2|chr2:127985324-127985470,chr2,127985324,127985470,HepG2|chr2:127982625-127982662,chr2,127982625,127982662,1,2699
HepG2|chr2:131967129-131967279,chr2,131967129,131967279,HepG2|chr2:130886862-130886896,chr2,130886862,130886896,1,1080267
HepG2|chr2:131967140-131967279,chr2,131967140,131967279,HepG2|chr2:130886784-130886817,chr2,130886784,130886817,1,1080356
HepG2|chr2:131967147-131967297,chr2,131967147,131967297,HepG2|chr2:130886775-130886817,chr2,130886775,130886817,1,1080372
HepG2|chr2:131967152-131967302,chr2,131967152,131967302,HepG2|chr2:130886773-130886817,chr2,130886773,130886817,1,1080379
HepG2|chr2:131967154-131967304,chr2,131967154,131967304,HepG2|chr2:130886831-130886896,chr2,130886831,130886896,1,1080323
HepG2|chr2:131967193-131967343,chr2,131967193,131967343,HepG2|chr2:130886774-130886817,chr2,130886774,130886817,1,1080419
HepG2|chr2:131967201-131967350,chr2,131967201,131967350,HepG2|chr2:130886774-130886817,chr2,130886774,130886817,1,1080427
HepG2|chr2:143623618-143623675,chr2,143623618,143623675,HepG2|chr2:143636505-143636655,chr2,143636505,143636655,1,12887
HepG2|chr2:143626687-143626762,chr2,143626687,143626762,HepG2|chr2:143637279-143637353,chr2,143637279,143637353,1,10592
HepG2|chr2:153246356-153246451,chr2,153246356,153246451,HepG2|chr2:188417302-188417363,chr2,188417302,188417363,1,35170946
HepG2|chr2:153246356-153246445,chr2,153246356,153246445,HepG2|chr2:188417302-188417363,chr2,188417302,188417363,1,35170946
HepG2|chr2:171778844-171778940,chr2,171778844,171778940,HepG2|chr2:171781001-171781055,chr2,171781001,171781055,1,2157
HepG2|chr2:171778872-171779018,chr2,171778872,171779018,HepG2|chr2:171781001-171781055,chr2,171781001,171781055,1,2129
HepG2|chr2:171778952-171779100,chr2,171778952,171779100,HepG2|chr2:171783605-171783668,chr2,171783605,171783668,1,4653
HepG2|chr2:171778952-171779039,chr2,171778952,171779039,HepG2|chr2:171783605-171783668,chr2,171783605,171783668,1,4653
HepG2|chr2:171997013-171997141,chr2,171997013,171997141,HepG2|chr2:11611126-11611276,chr2,11611126,11611276,1,160385887
HepG2|chr2:171997013-171997140,chr2,171997013,171997140,HepG2|chr2:11611126-11611276,chr2,11611126,11611276,1,160385887
HepG2|chr2:188384374-188384472,chr2,188384374,188384472,HepG2|chr2:218804150-218804210,chr2,218804150,218804210,1,30419776
HepG2|chr2:188384384-188384474,chr2,188384384,188384474,HepG2|chr2:218804150-218804210,chr2,218804150,218804210,1,30419766
HepG2|chr2:188384386-188384474,chr2,188384386,188384474,HepG2|chr2:218804150-218804209,chr2,218804150,218804209,1,30419764
HepG2|chr2:188394897-188394944,chr2,188394897,188394944,HepG2|chr2:198366363-198366509,chr2,198366363,198366509,1,9971466
HepG2|chr2:190294044-190294190,chr2,190294044,190294190,HepG2|chr2:190305748-190305798,chr2,190305748,190305798,1,11704
HepG2|chr2:190294065-190294188,chr2,190294065,190294188,HepG2|chr2:190305748-190305766,chr2,190305748,190305766,1,11683
HepG2|chr2:190294076-190294188,chr2,190294076,190294188,HepG2|chr2:190305748-190305786,chr2,190305748,190305786,1,11672
HepG2|chr2:190294085-190294188,chr2,190294085,190294188,HepG2|chr2:190305748-190305773,chr2,190305748,190305773,1,11663
HepG2|chr2:190294088-190294188,chr2,190294088,190294188,HepG2|chr2:190305748-190305798,chr2,190305748,190305798,1,11660
HepG2|chr2:190294089-190294188,chr2,190294089,190294188,HepG2|chr2:190305748-190305798,chr2,190305748,190305798,1,11659
HepG2|chr2:191680453-191680525,chr2,191680453,191680525,HepG2|chr2:191511084-191511128,chr2,191511084,191511128,1,169369
HepG2|chr2:191680453-191680475,chr2,191680453,191680475,HepG2|chr2:191511084-191511128,chr2,191511084,191511128,1,169369
HepG2|chr2:201959756-201959892,chr2,201959756,201959892,HepG2|chr2:201978401-201978423,chr2,201978401,201978423,1,18645
HepG2|chr2:201959756-201959884,chr2,201959756,201959884,HepG2|chr2:201978401-201978423,chr2,201978401,201978423,1,18645
HepG2|chr2:201959795-201959892,chr2,201959795,201959892,HepG2|chr2:201978401-201978423,chr2,201978401,201978423,1,18606
HepG2|chr2:201963206-201963350,chr2,201963206,201963350,HepG2|chr2:201979665-201979693,chr2,201979665,201979693,1,16459
HepG2|chr2:201963255-201963374,chr2,201963255,201963374,HepG2|chr2:201979665-201979693,chr2,201979665,201979693,1,16410
HepG2|chr2:201964605-201964752,chr2,201964605,201964752,HepG2|chr2:201991921-201991997,chr2,201991921,201991997,1,27316
HepG2|chr2:201964605-201964676,chr2,201964605,201964676,HepG2|chr2:201991921-201991997,chr2,201991921,201991997,1,27316
HepG2|chr2:201970461-201970526,chr2,201970461,201970526,HepG2|chr2:201979664-201979803,chr2,201979664,201979803,1,9203
HepG2|chr2:201972687-201972733,chr2,201972687,201972733,HepG2|chr2:201979666-201979715,chr2,201979666,201979715,1,6979
HepG2|chr2:208672180-208672244,chr2,208672180,208672244,HepG2|chr2:208494090-208494129,chr2,208494090,208494129,1,178090
HepG2|chr2:208739053-208739102,chr2,208739053,208739102,HepG2|chr2:208493988-208494083,chr2,208493988,208494083,1,245065
HepG2|chr2:208801582-208801642,chr2,208801582,208801642,HepG2|chr2:191746758-191746872,chr2,191746758,191746872,1,17054824
HepG2|chr2:208801612-208801648,chr2,208801612,208801648,HepG2|chr2:191746758-191746872,chr2,191746758,191746872,1,17054854
HepG2|chr2:216158901-216158969,chr2,216158901,216158969,HepG2|chr2:216175480-216175630,chr2,216175480,216175630,1,16579
HepG2|chr2:216158902-216158969,chr2,216158902,216158969,HepG2|chr2:216175401-216175501,chr2,216175401,216175501,1,16499
HepG2|chr2:216158919-216158969,chr2,216158919,216158969,HepG2|chr2:216175401-216175501,chr2,216175401,216175501,1,16482
HepG2|chr2:216158926-216158969,chr2,216158926,216158969,HepG2|chr2:216175401-216175468,chr2,216175401,216175468,1,16475
HepG2|chr2:216158927-216158969,chr2,216158927,216158969,HepG2|chr2:216175400-216175533,chr2,216175400,216175533,1,16473
HepG2|chr2:223750286-223750313,chr2,223750286,223750313,HepG2|chr2:230784261-230784384,chr2,230784261,230784384,1,7033975
HepG2|chr2:223750289-223750328,chr2,223750289,223750328,HepG2|chr2:230784261-230784384,chr2,230784261,230784384,1,7033972
HepG2|chr2:232489003-232489100,chr2,232489003,232489100,HepG2|chr2:232514160-232514204,chr2,232514160,232514204,1,25157
HepG2|chr2:232489776-232489834,chr2,232489776,232489834,HepG2|chr2:232514181-232514273,chr2,232514181,232514273,1,24405
HepG2|chr2:233230639-233230759,chr2,233230639,233230759,HepG2|chr2:27631687-27631717,chr2,27631687,27631717,1,205598952
HepG2|chr2:233230703-233230815,chr2,233230703,233230815,HepG2|chr2:233199818-233199902,chr2,233199818,233199902,1,30885
HepG2|chr2:233230703-233230767,chr2,233230703,233230767,HepG2|chr2:233199818-233199902,chr2,233199818,233199902,1,30885
HepG2|chr2:233230780-233230930,chr2,233230780,233230930,HepG2|chr2:27631687-27631717,chr2,27631687,27631717,1,205599093
HepG2|chr2:233231465-233231565,chr2,233231465,233231565,HepG2|chr2:233200037-233200062,chr2,233200037,233200062,1,31428
HepG2|chr2:233308457-233308594,chr2,233308457,233308594,HepG2|chr2:233197078-233197215,chr2,233197078,233197215,1,111379
HepG2|chr2:233308495-233308645,chr2,233308495,233308645,HepG2|chr2:233196960-233197110,chr2,233196960,233197110,1,111535
HepG2|chr2:233308498-233308648,chr2,233308498,233308648,HepG2|chr2:233197065-233197215,chr2,233197065,233197215,1,111433
HepG2|chr2:233308498-233308618,chr2,233308498,233308618,HepG2|chr2:233197010-233197117,chr2,233197010,233197117,1,111488
HepG2|chr2:233308500-233308555,chr2,233308500,233308555,HepG2|chr2:233197393-233197488,chr2,233197393,233197488,1,111107
HepG2|chr2:233308514-233308664,chr2,233308514,233308664,HepG2|chr2:233197061-233197211,chr2,233197061,233197211,1,111453
HepG2|chr2:233308515-233308662,chr2,233308515,233308662,HepG2|chr2:233197080-233197230,chr2,233197080,233197230,1,111435
HepG2|chr2:233308531-233308681,chr2,233308531,233308681,HepG2|chr2:233197088-233197238,chr2,233197088,233197238,1,111443
HepG2|chr2:233308536-233308681,chr2,233308536,233308681,HepG2|chr2:233197094-233197241,chr2,233197094,233197241,1,111442
HepG2|chr2:233308574-233308721,chr2,233308574,233308721,HepG2|chr2:233197088-233197238,chr2,233197088,233197238,1,111486
HepG2|chr2:233308576-233308721,chr2,233308576,233308721,HepG2|chr2:233196981-233197124,chr2,233196981,233197124,1,111595
HepG2|chr2:233308613-233308716,chr2,233308613,233308716,HepG2|chr2:233197073-233197223,chr2,233197073,233197223,1,111540
HepG2|chr2:233308614-233308655,chr2,233308614,233308655,HepG2|chr2:233197732-233197812,chr2,233197732,233197812,1,110882
HepG2|chr2:233308614-233308654,chr2,233308614,233308654,HepG2|chr2:233197732-233197812,chr2,233197732,233197812,1,110882
HepG2|chr2:233308634-233308784,chr2,233308634,233308784,HepG2|chr2:233197428-233197578,chr2,233197428,233197578,1,111206
HepG2|chr2:233310659-233310809,chr2,233310659,233310809,HepG2|chr2:233199824-233199974,chr2,233199824,233199974,1,110835
HepG2|chr2:233310667-233310817,chr2,233310667,233310817,HepG2|chr2:233199803-233199953,chr2,233199803,233199953,1,110864
HepG2|chr2:233310694-233310844,chr2,233310694,233310844,HepG2|chr2:233199832-233199982,chr2,233199832,233199982,1,110862
HepG2|chr2:233310701-233310744,chr2,233310701,233310744,HepG2|chr2:233200306-233200413,chr2,233200306,233200413,1,110395
HepG2|chr2:233310708-233310857,chr2,233310708,233310857,HepG2|chr2:233199830-233199980,chr2,233199830,233199980,1,110878
HepG2|chr2:233310715-233310865,chr2,233310715,233310865,HepG2|chr2:233199836-233199986,chr2,233199836,233199986,1,110879
HepG2|chr2:233310718-233310868,chr2,233310718,233310868,HepG2|chr2:233199830-233199980,chr2,233199830,233199980,1,110888
HepG2|chr2:233310719-233310869,chr2,233310719,233310869,HepG2|chr2:233199829-233199979,chr2,233199829,233199979,1,110890
HepG2|chr2:233310725-233310875,chr2,233310725,233310875,HepG2|chr2:233199807-233199957,chr2,233199807,233199957,1,110918
HepG2|chr2:233310726-233310875,chr2,233310726,233310875,HepG2|chr2:233199807-233199957,chr2,233199807,233199957,1,110919
HepG2|chr2:233310764-233310912,chr2,233310764,233310912,HepG2|chr2:233199926-233200076,chr2,233199926,233200076,1,110838
HepG2|chr2:233310860-233310944,chr2,233310860,233310944,HepG2|chr2:233199916-233200066,chr2,233199916,233200066,1,110944
HepG2|chr2:233310913-233310997,chr2,233310913,233310997,HepG2|chr2:233199994-233200141,chr2,233199994,233200141,1,110919
HepG2|chr2:233310938-233310992,chr2,233310938,233310992,HepG2|chr2:233200048-233200198,chr2,233200048,233200198,1,110890
HepG2|chr2:233311042-233311192,chr2,233311042,233311192,HepG2|chr2:233200033-233200183,chr2,233200033,233200183,1,111009
HepG2|chr2:233311043-233311193,chr2,233311043,233311193,HepG2|chr2:233200022-233200172,chr2,233200022,233200172,1,111021
HepG2|chr2:233311044-233311194,chr2,233311044,233311194,HepG2|chr2:233200016-233200166,chr2,233200016,233200166,1,111028
HepG2|chr2:233311044-233311184,chr2,233311044,233311184,HepG2|chr2:233199941-233200091,chr2,233199941,233200091,1,111103
HepG2|chr2:233311045-233311194,chr2,233311045,233311194,HepG2|chr2:233199922-233200069,chr2,233199922,233200069,1,111123
HepG2|chr2:233311046-233311194,chr2,233311046,233311194,HepG2|chr2:233200018-233200168,chr2,233200018,233200168,1,111028
HepG2|chr2:233311046-233311192,chr2,233311046,233311192,HepG2|chr2:233200056-233200206,chr2,233200056,233200206,1,110990
HepG2|chr2:233311049-233311198,chr2,233311049,233311198,HepG2|chr2:233200058-233200208,chr2,233200058,233200208,1,110991
HepG2|chr2:233311050-233311200,chr2,233311050,233311200,HepG2|chr2:233200018-233200168,chr2,233200018,233200168,1,111032
HepG2|chr2:233311054-233311204,chr2,233311054,233311204,HepG2|chr2:233200057-233200207,chr2,233200057,233200207,1,110997
HepG2|chr2:233311055-233311205,chr2,233311055,233311205,HepG2|chr2:233200030-233200180,chr2,233200030,233200180,1,111025
HepG2|chr2:233311062-233311212,chr2,233311062,233311212,HepG2|chr2:233200018-233200168,chr2,233200018,233200168,1,111044
HepG2|chr2:233311076-233311226,chr2,233311076,233311226,HepG2|chr2:233200050-233200200,chr2,233200050,233200200,1,111026
HepG2|chr2:233311077-233311227,chr2,233311077,233311227,HepG2|chr2:233199992-233200142,chr2,233199992,233200142,1,111085
HepG2|chr2:233311077-233311198,chr2,233311077,233311198,HepG2|chr2:233200051-233200189,chr2,233200051,233200189,1,111026
HepG2|chr2:233311080-233311227,chr2,233311080,233311227,HepG2|chr2:233200037-233200187,chr2,233200037,233200187,1,111043
HepG2|chr2:233311083-233311232,chr2,233311083,233311232,HepG2|chr2:233200008-233200155,chr2,233200008,233200155,1,111075
HepG2|chr2:233311107-233311257,chr2,233311107,233311257,HepG2|chr2:233199987-233200130,chr2,233199987,233200130,1,111120
HepG2|chr2:233311162-233311227,chr2,233311162,233311227,HepG2|chr2:233200041-233200190,chr2,233200041,233200190,1,111121
HepG2|chr2:233311175-233311322,chr2,233311175,233311322,HepG2|chr2:233200018-233200168,chr2,233200018,233200168,1,111157
HepG2|chr2:233311186-233311234,chr2,233311186,233311234,HepG2|chr2:233200318-233200444,chr2,233200318,233200444,1,110868
HepG2|chr2:236421763-236421894,chr2,236421763,236421894,HepG2|chr2:219860990-219861007,chr2,219860990,219861007,1,16560773
HepG2|chr2:236421769-236421894,chr2,236421769,236421894,HepG2|chr2:219860990-219861012,chr2,219860990,219861012,1,16560779
HepG2|chr2:236421775-236421894,chr2,236421775,236421894,HepG2|chr2:219860990-219861012,chr2,219860990,219861012,1,16560785
HepG2|chr2:236421776-236421894,chr2,236421776,236421894,HepG2|chr2:219860990-219861012,chr2,219860990,219861012,1,16560786
HepG2|chr2:236421807-236421894,chr2,236421807,236421894,HepG2|chr2:219860990-219861012,chr2,219860990,219861012,1,16560817
HepG2|chr2:236421824-236421894,chr2,236421824,236421894,HepG2|chr2:219860990-219861007,chr2,219860990,219861007,1,16560834
HepG2|chr2:236452400-236452531,chr2,236452400,236452531,HepG2|chr2:220091642-220091765,chr2,220091642,220091765,1,16360758
HepG2|chr2:236452504-236452531,chr2,236452504,236452531,HepG2|chr2:220091642-220091765,chr2,220091642,220091765,1,16360862
HepG2|chr2:236452504-236452529,chr2,236452504,236452529,HepG2|chr2:220091642-220091767,chr2,220091642,220091767,1,16360862
HepG2|chr2:236492197-236492307,chr2,236492197,236492307,HepG2|chr2:27990010-27990047,chr2,27990010,27990047,1,208502187
HepG2|chr2:236492268-236492418,chr2,236492268,236492418,HepG2|chr2:27990010-27990046,chr2,27990010,27990046,1,208502258
HepG2|chr2:239311678-239311722,chr2,239311678,239311722,HepG2|chr2:239333123-239333223,chr2,239333123,239333223,1,21445
HepG2|chr2:239311681-239311722,chr2,239311681,239311722,HepG2|chr2:239333123-239333223,chr2,239333123,239333223,1,21442
HepG2|chr2:239319143-239319180,chr2,239319143,239319180,HepG2|chr2:239334372-239334461,chr2,239334372,239334461,1,15229
HepG2|chr2:240183936-240184083,chr2,240183936,240184083,HepG2|chr2:242290454-242290585,chr2,242290454,242290585,1,2106518
HepG2|chr2:240184074-240184093,chr2,240184074,240184093,HepG2|chr2:242290454-242290585,chr2,242290454,242290585,1,2106380
HepG2|chr2:240190977-240191123,chr2,240190977,240191123,HepG2|chr2:242293913-242293962,chr2,242293913,242293962,1,2102936
HepG2|chr3:5171569-5171681,chr3,5171569,5171681,HepG2|chr3:5230376-5230414,chr3,5230376,5230414,1,58807
HepG2|chr3:5171572-5171698,chr3,5171572,5171698,HepG2|chr3:5230376-5230414,chr3,5230376,5230414,1,58804
HepG2|chr3:5173017-5173167,chr3,5173017,5173167,HepG2|chr3:5228205-5228315,chr3,5228205,5228315,1,55188
HepG2|chr3:5173181-5173221,chr3,5173181,5173221,HepG2|chr3:5228205-5228315,chr3,5228205,5228315,1,55024
HepG2|chr3:12517769-12517848,chr3,12517769,12517848,HepG2|chr3:12525756-12525900,chr3,12525756,12525900,1,7987
HepG2|chr3:12517814-12517848,chr3,12517814,12517848,HepG2|chr3:12525855-12526005,chr3,12525855,12526005,1,8041
HepG2|chr3:15818672-15818814,chr3,15818672,15818814,HepG2|chr3:122921516-122921645,chr3,122921516,122921645,1,107102844
HepG2|chr3:40535809-40535867,chr3,40535809,40535867,HepG2|chr3:40542504-40542560,chr3,40542504,40542560,1,6695
HepG2|chr3:40535809-40535863,chr3,40535809,40535863,HepG2|chr3:40542500-40542519,chr3,40542500,40542519,1,6691
HepG2|chr3:42069952-42069994,chr3,42069952,42069994,HepG2|chr3:37286556-37286667,chr3,37286556,37286667,1,4783396
HepG2|chr3:42069956-42069995,chr3,42069956,42069995,HepG2|chr3:37286556-37286667,chr3,37286556,37286667,1,4783400
HepG2|chr3:42069957-42069995,chr3,42069957,42069995,HepG2|chr3:37286556-37286667,chr3,37286556,37286667,1,4783401
HepG2|chr3:42110107-42110186,chr3,42110107,42110186,HepG2|chr3:33137287-33137376,chr3,33137287,33137376,1,8972820
HepG2|chr3:42110129-42110186,chr3,42110129,42110186,HepG2|chr3:33137287-33137376,chr3,33137287,33137376,1,8972842
HepG2|chr3:49785611-49785641,chr3,49785611,49785641,HepG2|chr3:49824672-49824780,chr3,49824672,49824780,1,39061
HepG2|chr3:52116102-52116217,chr3,52116102,52116217,HepG2|chr3:178866104-178866209,chr3,178866104,178866209,1,126750002
HepG2|chr3:52116102-52116210,chr3,52116102,52116210,HepG2|chr3:178866126-178866168,chr3,178866126,178866168,1,126750024
HepG2|chr3:52116143-52116205,chr3,52116143,52116205,HepG2|chr3:178866121-178866209,chr3,178866121,178866209,1,126749978
HepG2|chr3:53180160-53180246,chr3,53180160,53180246,HepG2|chr3:53168804-53168869,chr3,53168804,53168869,1,11356
HepG2|chr3:53180161-53180246,chr3,53180161,53180246,HepG2|chr3:53168804-53168869,chr3,53168804,53168869,1,11357
HepG2|chr3:57760900-57760982,chr3,57760900,57760982,HepG2|chr3:57537050-57537118,chr3,57537050,57537118,1,223850
HepG2|chr3:57786056-57786133,chr3,57786056,57786133,HepG2|chr3:57529710-57529782,chr3,57529710,57529782,1,256346
HepG2|chr3:57791921-57791942,chr3,57791921,57791942,HepG2|chr3:57537925-57537983,chr3,57537925,57537983,1,253996
HepG2|chr3:79046961-79047065,chr3,79046961,79047065,HepG2|chr3:179322873-179322936,chr3,179322873,179322936,1,100275912
HepG2|chr3:79052426-79052576,chr3,79052426,79052576,HepG2|chr3:57582325-57582475,chr3,57582325,57582475,1,21470101
HepG2|chr3:99754111-99754160,chr3,99754111,99754160,HepG2|chr3:194346170-194346308,chr3,194346170,194346308,1,94592059
HepG2|chr3:99754114-99754160,chr3,99754114,99754160,HepG2|chr3:194346170-194346308,chr3,194346170,194346308,1,94592056
HepG2|chr3:114089512-114089661,chr3,114089512,114089661,HepG2|chr3:39449710-39449841,chr3,39449710,39449841,1,74639802
HepG2|chr3:114089512-114089660,chr3,114089512,114089660,HepG2|chr3:39449710-39449778,chr3,39449710,39449778,1,74639802
HepG2|chr3:122110401-122110476,chr3,122110401,122110476,HepG2|chr3:121552870-121552922,chr3,121552870,121552922,1,557531
HepG2|chr3:122110403-122110476,chr3,122110403,122110476,HepG2|chr3:121552870-121552922,chr3,121552870,121552922,1,557533
HepG2|chr3:122110403-122110475,chr3,122110403,122110475,HepG2|chr3:121552870-121552922,chr3,121552870,121552922,1,557533
HepG2|chr3:122854044-122854082,chr3,122854044,122854082,HepG2|chr3:100429966-100430074,chr3,100429966,100430074,1,22424078
HepG2|chr3:122854046-122854082,chr3,122854046,122854082,HepG2|chr3:100429966-100430074,chr3,100429966,100430074,1,22424080
HepG2|chr3:129084509-129084527,chr3,129084509,129084527,HepG2|chr3:128887381-128887472,chr3,128887381,128887472,1,197128
HepG2|chr3:129109470-129109583,chr3,129109470,129109583,HepG2|chr3:129159623-129159664,chr3,129159623,129159664,1,50153
HepG2|chr3:129109470-129109571,chr3,129109470,129109571,HepG2|chr3:129159623-129159664,chr3,129159623,129159664,1,50153
HepG2|chr3:129136161-129136186,chr3,129136161,129136186,HepG2|chr3:128887367-128887473,chr3,128887367,128887473,1,248794
HepG2|chr3:150469447-150469536,chr3,150469447,150469536,HepG2|chr3:139064677-139064738,chr3,139064677,139064738,1,11404770
HepG2|chr3:150469448-150469553,chr3,150469448,150469553,HepG2|chr3:139064677-139064738,chr3,139064677,139064738,1,11404771
HepG2|chr3:171862723-171862786,chr3,171862723,171862786,HepG2|chr3:187455926-187456005,chr3,187455926,187456005,1,15593203
HepG2|chr3:171862723-171862782,chr3,171862723,171862782,HepG2|chr3:187455926-187456013,chr3,187455926,187456013,1,15593203
HepG2|chr3:171862723-171862781,chr3,171862723,171862781,HepG2|chr3:187455926-187456012,chr3,187455926,187456012,1,15593203
HepG2|chr3:184883249-184883321,chr3,184883249,184883321,HepG2|chr3:185047873-185047933,chr3,185047873,185047933,1,164624
HepG2|chr3:184883270-184883321,chr3,184883270,184883321,HepG2|chr3:185047873-185047933,chr3,185047873,185047933,1,164603
HepG2|chr3:185464417-185464567,chr3,185464417,185464567,HepG2|chr3:113464310-113464349,chr3,113464310,113464349,1,72000107
HepG2|chr3:185464519-185464630,chr3,185464519,185464630,HepG2|chr3:113464310-113464349,chr3,113464310,113464349,1,72000209
HepG2|chr3:195359928-195360078,chr3,195359928,195360078,HepG2|chr3:195683318-195683468,chr3,195683318,195683468,1,323390
HepG2|chr3:195359935-195360085,chr3,195359935,195360085,HepG2|chr3:195683319-195683469,chr3,195683319,195683469,1,323384
HepG2|chr3:195359939-195360089,chr3,195359939,195360089,HepG2|chr3:195683319-195683469,chr3,195683319,195683469,1,323380
HepG2|chr3:195359940-195360087,chr3,195359940,195360087,HepG2|chr3:195683323-195683471,chr3,195683323,195683471,1,323383
HepG2|chr3:195359942-195360092,chr3,195359942,195360092,HepG2|chr3:195683319-195683469,chr3,195683319,195683469,1,323377
HepG2|chr3:195359952-195360098,chr3,195359952,195360098,HepG2|chr3:195683319-195683469,chr3,195683319,195683469,1,323367
HepG2|chr3:195360090-195360237,chr3,195360090,195360237,HepG2|chr3:195683068-195683218,chr3,195683068,195683218,1,322978
HepG2|chr3:195360992-195361137,chr3,195360992,195361137,HepG2|chr3:195682141-195682249,chr3,195682141,195682249,1,321149
HepG2|chr3:195360999-195361140,chr3,195360999,195361140,HepG2|chr3:195682149-195682249,chr3,195682149,195682249,1,321150
HepG2|chr3:195361022-195361138,chr3,195361022,195361138,HepG2|chr3:195682066-195682216,chr3,195682066,195682216,1,321044
HepG2|chr3:195361022-195361116,chr3,195361022,195361116,HepG2|chr3:195682158-195682217,chr3,195682158,195682217,1,321136
HepG2|chr3:195361023-195361116,chr3,195361023,195361116,HepG2|chr3:195682154-195682249,chr3,195682154,195682249,1,321131
HepG2|chr3:195361043-195361140,chr3,195361043,195361140,HepG2|chr3:195682105-195682249,chr3,195682105,195682249,1,321062
HepG2|chr3:195361063-195361116,chr3,195361063,195361116,HepG2|chr3:195682058-195682208,chr3,195682058,195682208,1,320995
HepG2|chr3:195361068-195361110,chr3,195361068,195361110,HepG2|chr3:195682045-195682195,chr3,195682045,195682195,1,320977
HepG2|chr3:195361070-195361110,chr3,195361070,195361110,HepG2|chr3:195682111-195682249,chr3,195682111,195682249,1,321041
HepG2|chr3:195361075-195361116,chr3,195361075,195361116,HepG2|chr3:195682154-195682249,chr3,195682154,195682249,1,321079
HepG2|chr4:2577783-2577840,chr4,2577783,2577840,HepG2|chr4:492504-492538,chr4,492504,492538,1,2085279
HepG2|chr4:6628201-6628292,chr4,6628201,6628292,HepG2|chr4:6640434-6640516,chr4,6640434,6640516,1,12233
HepG2|chr4:6628230-6628292,chr4,6628230,6628292,HepG2|chr4:6640434-6640516,chr4,6640434,6640516,1,12204
HepG2|chr4:6635033-6635110,chr4,6635033,6635110,HepG2|chr4:6637614-6637687,chr4,6637614,6637687,1,2581
HepG2|chr4:6635092-6635242,chr4,6635092,6635242,HepG2|chr4:6637614-6637687,chr4,6637614,6637687,1,2522
HepG2|chr4:40045565-40045715,chr4,40045565,40045715,HepG2|chr4:40059023-40059083,chr4,40059023,40059083,1,13458
HepG2|chr4:40045714-40045804,chr4,40045714,40045804,HepG2|chr4:40059023-40059083,chr4,40059023,40059083,1,13309
HepG2|chr4:40045732-40045804,chr4,40045732,40045804,HepG2|chr4:40059023-40059079,chr4,40059023,40059079,1,13291
HepG2|chr4:40046602-40046690,chr4,40046602,40046690,HepG2|chr4:40059023-40059081,chr4,40059023,40059081,1,12421
HepG2|chr4:40046604-40046690,chr4,40046604,40046690,HepG2|chr4:40059023-40059108,chr4,40059023,40059108,1,12419
HepG2|chr4:40046625-40046690,chr4,40046625,40046690,HepG2|chr4:40059023-40059108,chr4,40059023,40059108,1,12398
HepG2|chr4:57308650-57308712,chr4,57308650,57308712,HepG2|chr4:57327746-57327867,chr4,57327746,57327867,1,19096
HepG2|chr4:57308683-57308712,chr4,57308683,57308712,HepG2|chr4:57327746-57327867,chr4,57327746,57327867,1,19063
HepG2|chr4:129478143-129478229,chr4,129478143,129478229,HepG2|chr4:129525231-129525292,chr4,129525231,129525292,1,47088
HepG2|chr4:129478144-129478229,chr4,129478144,129478229,HepG2|chr4:129525231-129525265,chr4,129525231,129525265,1,47087
HepG2|chr4:140079259-140079318,chr4,140079259,140079318,HepG2|chr4:140098561-140098691,chr4,140098561,140098691,1,19302
HepG2|chr4:140089124-140089196,chr4,140089124,140089196,HepG2|chr4:140098632-140098659,chr4,140098632,140098659,1,9508
HepG2|chr4:152218146-152218261,chr4,152218146,152218261,HepG2|chr4:152021768-152021818,chr4,152021768,152021818,1,196378
HepG2|chr4:152218146-152218246,chr4,152218146,152218246,HepG2|chr4:152021768-152021818,chr4,152021768,152021818,1,196378
HepG2|chr4:186149485-186149599,chr4,186149485,186149599,HepG2|chr4:129734215-129734243,chr4,129734215,129734243,1,56415270
HepG2|chr4:186149485-186149593,chr4,186149485,186149593,HepG2|chr4:129734215-129734243,chr4,129734215,129734243,1,56415270
HepG2|chr5:1593692-1593797,chr5,1593692,1593797,HepG2|chr5:236110-236153,chr5,236110,236153,1,1357582
HepG2|chr5:1593783-1593933,chr5,1593783,1593933,HepG2|chr5:235872-236018,chr5,235872,236018,1,1357911
HepG2|chr5:1593783-1593885,chr5,1593783,1593885,HepG2|chr5:235872-236018,chr5,235872,236018,1,1357911
HepG2|chr5:1593783-1593850,chr5,1593783,1593850,HepG2|chr5:236126-236244,chr5,236126,236244,1,1357657
HepG2|chr5:1593784-1593934,chr5,1593784,1593934,HepG2|chr5:236100-236250,chr5,236100,236250,1,1357684
HepG2|chr5:1593785-1593849,chr5,1593785,1593849,HepG2|chr5:236153-236299,chr5,236153,236299,1,1357632
HepG2|chr5:1593785-1593837,chr5,1593785,1593837,HepG2|chr5:236181-236328,chr5,236181,236328,1,1357604
HepG2|chr5:1593786-1593854,chr5,1593786,1593854,HepG2|chr5:236103-236252,chr5,236103,236252,1,1357683
HepG2|chr5:1593787-1593931,chr5,1593787,1593931,HepG2|chr5:236104-236141,chr5,236104,236141,1,1357683
HepG2|chr5:1593790-1593931,chr5,1593790,1593931,HepG2|chr5:236104-236141,chr5,236104,236141,1,1357686
HepG2|chr5:1593790-1593921,chr5,1593790,1593921,HepG2|chr5:236152-236257,chr5,236152,236257,1,1357638
HepG2|chr5:1593790-1593886,chr5,1593790,1593886,HepG2|chr5:236101-236141,chr5,236101,236141,1,1357689
HepG2|chr5:1593790-1593875,chr5,1593790,1593875,HepG2|chr5:236103-236141,chr5,236103,236141,1,1357687
HepG2|chr5:1593790-1593872,chr5,1593790,1593872,HepG2|chr5:236144-236284,chr5,236144,236284,1,1357646
HepG2|chr5:1593790-1593840,chr5,1593790,1593840,HepG2|chr5:236103-236141,chr5,236103,236141,1,1357687
HepG2|chr5:1593790-1593837,chr5,1593790,1593837,HepG2|chr5:236153-236299,chr5,236153,236299,1,1357637
HepG2|chr5:1593790-1593835,chr5,1593790,1593835,HepG2|chr5:236152-236257,chr5,236152,236257,1,1357638
HepG2|chr5:1593791-1593850,chr5,1593791,1593850,HepG2|chr5:236142-236244,chr5,236142,236244,1,1357649
HepG2|chr5:1593797-1593875,chr5,1593797,1593875,HepG2|chr5:236108-236258,chr5,236108,236258,1,1357689
HepG2|chr5:1594014-1594164,chr5,1594014,1594164,HepG2|chr5:235882-236032,chr5,235882,236032,1,1358132
HepG2|chr5:1597071-1597221,chr5,1597071,1597221,HepG2|chr5:217759-217853,chr5,217759,217853,1,1379312
HepG2|chr5:1597193-1597343,chr5,1597193,1597343,HepG2|chr5:217771-217917,chr5,217771,217917,1,1379422
HepG2|chr5:1597205-1597337,chr5,1597205,1597337,HepG2|chr5:217791-217941,chr5,217791,217941,1,1379414
HepG2|chr5:1597208-1597358,chr5,1597208,1597358,HepG2|chr5:217776-217926,chr5,217776,217926,1,1379432
HepG2|chr5:1597208-1597357,chr5,1597208,1597357,HepG2|chr5:217752-217902,chr5,217752,217902,1,1379456
HepG2|chr5:1597209-1597356,chr5,1597209,1597356,HepG2|chr5:217701-217851,chr5,217701,217851,1,1379508
HepG2|chr5:1597210-1597360,chr5,1597210,1597360,HepG2|chr5:217710-217860,chr5,217710,217860,1,1379500
HepG2|chr5:1597211-1597361,chr5,1597211,1597361,HepG2|chr5:217825-217950,chr5,217825,217950,1,1379386
HepG2|chr5:1597213-1597363,chr5,1597213,1597363,HepG2|chr5:217766-217803,chr5,217766,217803,1,1379447
HepG2|chr5:1597215-1597365,chr5,1597215,1597365,HepG2|chr5:217739-217871,chr5,217739,217871,1,1379476
HepG2|chr5:1597226-1597376,chr5,1597226,1597376,HepG2|chr5:217724-217871,chr5,217724,217871,1,1379502
HepG2|chr5:1597226-1597375,chr5,1597226,1597375,HepG2|chr5:217791-217941,chr5,217791,217941,1,1379435
HepG2|chr5:1597227-1597327,chr5,1597227,1597327,HepG2|chr5:217828-217885,chr5,217828,217885,1,1379399
HepG2|chr5:1597228-1597378,chr5,1597228,1597378,HepG2|chr5:217796-217946,chr5,217796,217946,1,1379432
HepG2|chr5:1597230-1597380,chr5,1597230,1597380,HepG2|chr5:217723-217872,chr5,217723,217872,1,1379507
HepG2|chr5:1597231-1597381,chr5,1597231,1597381,HepG2|chr5:217806-217956,chr5,217806,217956,1,1379425
HepG2|chr5:1597232-1597382,chr5,1597232,1597382,HepG2|chr5:217733-217883,chr5,217733,217883,1,1379499
HepG2|chr5:1597232-1597337,chr5,1597232,1597337,HepG2|chr5:217797-217871,chr5,217797,217871,1,1379435
HepG2|chr5:1597232-1597334,chr5,1597232,1597334,HepG2|chr5:217761-217907,chr5,217761,217907,1,1379471
HepG2|chr5:1597236-1597383,chr5,1597236,1597383,HepG2|chr5:217796-217946,chr5,217796,217946,1,1379440
HepG2|chr5:1597252-1597374,chr5,1597252,1597374,HepG2|chr5:217679-217829,chr5,217679,217829,1,1379573
HepG2|chr5:1597256-1597406,chr5,1597256,1597406,HepG2|chr5:217962-218112,chr5,217962,218112,1,1379294
HepG2|chr5:1597258-1597408,chr5,1597258,1597408,HepG2|chr5:217664-217814,chr5,217664,217814,1,1379594
HepG2|chr5:1597258-1597404,chr5,1597258,1597404,HepG2|chr5:218040-218140,chr5,218040,218140,1,1379218
HepG2|chr5:1597259-1597409,chr5,1597259,1597409,HepG2|chr5:218038-218167,chr5,218038,218167,1,1379221
HepG2|chr5:1597283-1597397,chr5,1597283,1597397,HepG2|chr5:217928-217964,chr5,217928,217964,1,1379355
HepG2|chr5:1597303-1597453,chr5,1597303,1597453,HepG2|chr5:217838-217987,chr5,217838,217987,1,1379465
HepG2|chr5:1597305-1597452,chr5,1597305,1597452,HepG2|chr5:217896-218042,chr5,217896,218042,1,1379409
HepG2|chr5:1597315-1597462,chr5,1597315,1597462,HepG2|chr5:217831-217981,chr5,217831,217981,1,1379484
HepG2|chr5:1597321-1597468,chr5,1597321,1597468,HepG2|chr5:217835-217985,chr5,217835,217985,1,1379486
HepG2|chr5:1597322-1597472,chr5,1597322,1597472,HepG2|chr5:217833-217983,chr5,217833,217983,1,1379489
HepG2|chr5:1597365-1597515,chr5,1597365,1597515,HepG2|chr5:217490-217639,chr5,217490,217639,1,1379875
HepG2|chr5:1597427-1597577,chr5,1597427,1597577,HepG2|chr5:217725-217871,chr5,217725,217871,1,1379702
HepG2|chr5:1597443-1597593,chr5,1597443,1597593,HepG2|chr5:217668-217818,chr5,217668,217818,1,1379775
HepG2|chr5:1597456-1597602,chr5,1597456,1597602,HepG2|chr5:217654-217804,chr5,217654,217804,1,1379802
HepG2|chr5:1597487-1597637,chr5,1597487,1597637,HepG2|chr5:217721-217871,chr5,217721,217871,1,1379766
HepG2|chr5:1597488-1597638,chr5,1597488,1597638,HepG2|chr5:217724-217871,chr5,217724,217871,1,1379764
HepG2|chr5:1597502-1597652,chr5,1597502,1597652,HepG2|chr5:217726-217872,chr5,217726,217872,1,1379776
HepG2|chr5:1597505-1597626,chr5,1597505,1597626,HepG2|chr5:217723-217871,chr5,217723,217871,1,1379782
HepG2|chr5:1597524-1597674,chr5,1597524,1597674,HepG2|chr5:217724-217871,chr5,217724,217871,1,1379800
HepG2|chr5:1632040-1632124,chr5,1632040,1632124,HepG2|chr5:273037-273159,chr5,273037,273159,1,1359003
HepG2|chr5:1632068-1632178,chr5,1632068,1632178,HepG2|chr5:273807-273847,chr5,273807,273847,1,1358261
HepG2|chr5:1632068-1632165,chr5,1632068,1632165,HepG2|chr5:273807-273850,chr5,273807,273850,1,1358261
HepG2|chr5:1632068-1632133,chr5,1632068,1632133,HepG2|chr5:273815-273895,chr5,273815,273895,1,1358253
HepG2|chr5:1632068-1632124,chr5,1632068,1632124,HepG2|chr5:273812-273892,chr5,273812,273892,1,1358256
HepG2|chr5:1632393-1632543,chr5,1632393,1632543,HepG2|chr5:273034-273184,chr5,273034,273184,1,1359359
HepG2|chr5:1632414-1632564,chr5,1632414,1632564,HepG2|chr5:273077-273227,chr5,273077,273227,1,1359337
HepG2|chr5:1632435-1632582,chr5,1632435,1632582,HepG2|chr5:273075-273192,chr5,273075,273192,1,1359360
HepG2|chr5:1632465-1632613,chr5,1632465,1632613,HepG2|chr5:273077-273227,chr5,273077,273227,1,1359388
HepG2|chr5:1632467-1632617,chr5,1632467,1632617,HepG2|chr5:273077-273227,chr5,273077,273227,1,1359390
HepG2|chr5:1632499-1632649,chr5,1632499,1632649,HepG2|chr5:273054-273204,chr5,273054,273204,1,1359445
HepG2|chr5:1632507-1632657,chr5,1632507,1632657,HepG2|chr5:273065-273215,chr5,273065,273215,1,1359442
HepG2|chr5:1632517-1632667,chr5,1632517,1632667,HepG2|chr5:273054-273204,chr5,273054,273204,1,1359463
HepG2|chr5:1632520-1632670,chr5,1632520,1632670,HepG2|chr5:273065-273215,chr5,273065,273215,1,1359455
HepG2|chr5:1632691-1632841,chr5,1632691,1632841,HepG2|chr5:273036-273186,chr5,273036,273186,1,1359655
HepG2|chr5:1632697-1632847,chr5,1632697,1632847,HepG2|chr5:273041-273187,chr5,273041,273187,1,1359656
HepG2|chr5:1632699-1632849,chr5,1632699,1632849,HepG2|chr5:273037-273187,chr5,273037,273187,1,1359662
HepG2|chr5:1632713-1632860,chr5,1632713,1632860,HepG2|chr5:273221-273367,chr5,273221,273367,1,1359492
HepG2|chr5:1632717-1632867,chr5,1632717,1632867,HepG2|chr5:273060-273210,chr5,273060,273210,1,1359657
HepG2|chr5:1632739-1632889,chr5,1632739,1632889,HepG2|chr5:273060-273210,chr5,273060,273210,1,1359679
HepG2|chr5:1632741-1632891,chr5,1632741,1632891,HepG2|chr5:273074-273224,chr5,273074,273224,1,1359667
HepG2|chr5:1632768-1632918,chr5,1632768,1632918,HepG2|chr5:273026-273176,chr5,273026,273176,1,1359742
HepG2|chr5:1632789-1632939,chr5,1632789,1632939,HepG2|chr5:273041-273188,chr5,273041,273188,1,1359748
HepG2|chr5:1632812-1632859,chr5,1632812,1632859,HepG2|chr5:273082-273232,chr5,273082,273232,1,1359730
HepG2|chr5:1632848-1632998,chr5,1632848,1632998,HepG2|chr5:272730-272880,chr5,272730,272880,1,1360118
HepG2|chr5:1632869-1633019,chr5,1632869,1633019,HepG2|chr5:272706-272856,chr5,272706,272856,1,1360163
HepG2|chr5:1633021-1633171,chr5,1633021,1633171,HepG2|chr5:272819-272969,chr5,272819,272969,1,1360202
HepG2|chr5:1633136-1633286,chr5,1633136,1633286,HepG2|chr5:272431-272581,chr5,272431,272581,1,1360705
HepG2|chr5:1633141-1633291,chr5,1633141,1633291,HepG2|chr5:272648-272798,chr5,272648,272798,1,1360493
HepG2|chr5:1633142-1633286,chr5,1633142,1633286,HepG2|chr5:272612-272762,chr5,272612,272762,1,1360530
HepG2|chr5:1633147-1633294,chr5,1633147,1633294,HepG2|chr5:272675-272825,chr5,272675,272825,1,1360472
HepG2|chr5:1633147-1633286,chr5,1633147,1633286,HepG2|chr5:272647-272797,chr5,272647,272797,1,1360500
HepG2|chr5:1633150-1633300,chr5,1633150,1633300,HepG2|chr5:272641-272791,chr5,272641,272791,1,1360509
HepG2|chr5:1633253-1633401,chr5,1633253,1633401,HepG2|chr5:272384-272534,chr5,272384,272534,1,1360869
HepG2|chr5:1633273-1633408,chr5,1633273,1633408,HepG2|chr5:272383-272529,chr5,272383,272529,1,1360890
HepG2|chr5:1633281-1633413,chr5,1633281,1633413,HepG2|chr5:272433-272566,chr5,272433,272566,1,1360848
HepG2|chr5:1633282-1633430,chr5,1633282,1633430,HepG2|chr5:272416-272535,chr5,272416,272535,1,1360866
HepG2|chr5:1633330-1633480,chr5,1633330,1633480,HepG2|chr5:272416-272566,chr5,272416,272566,1,1360914
HepG2|chr5:1633330-1633479,chr5,1633330,1633479,HepG2|chr5:272405-272555,chr5,272405,272555,1,1360925
HepG2|chr5:1633332-1633482,chr5,1633332,1633482,HepG2|chr5:272416-272565,chr5,272416,272565,1,1360916
HepG2|chr5:1633338-1633488,chr5,1633338,1633488,HepG2|chr5:272416-272566,chr5,272416,272566,1,1360922
HepG2|chr5:1633339-1633488,chr5,1633339,1633488,HepG2|chr5:272415-272565,chr5,272415,272565,1,1360924
HepG2|chr5:1633340-1633490,chr5,1633340,1633490,HepG2|chr5:272427-272571,chr5,272427,272571,1,1360913
HepG2|chr5:1633342-1633492,chr5,1633342,1633492,HepG2|chr5:272405-272555,chr5,272405,272555,1,1360937
HepG2|chr5:1633344-1633494,chr5,1633344,1633494,HepG2|chr5:272405-272555,chr5,272405,272555,1,1360939
HepG2|chr5:1633344-1633493,chr5,1633344,1633493,HepG2|chr5:272416-272566,chr5,272416,272566,1,1360928
HepG2|chr5:1633346-1633494,chr5,1633346,1633494,HepG2|chr5:272383-272529,chr5,272383,272529,1,1360963
HepG2|chr5:1633347-1633497,chr5,1633347,1633497,HepG2|chr5:272177-272324,chr5,272177,272324,1,1361170
HepG2|chr5:1633348-1633495,chr5,1633348,1633495,HepG2|chr5:272212-272362,chr5,272212,272362,1,1361136
HepG2|chr5:1633350-1633500,chr5,1633350,1633500,HepG2|chr5:272391-272541,chr5,272391,272541,1,1360959
HepG2|chr5:1633351-1633495,chr5,1633351,1633495,HepG2|chr5:272383-272529,chr5,272383,272529,1,1360968
HepG2|chr5:1633356-1633506,chr5,1633356,1633506,HepG2|chr5:272422-272572,chr5,272422,272572,1,1360934
HepG2|chr5:1633356-1633490,chr5,1633356,1633490,HepG2|chr5:272383-272529,chr5,272383,272529,1,1360973
HepG2|chr5:1633356-1633485,chr5,1633356,1633485,HepG2|chr5:272383-272529,chr5,272383,272529,1,1360973
HepG2|chr5:1633357-1633507,chr5,1633357,1633507,HepG2|chr5:272149-272291,chr5,272149,272291,1,1361208
HepG2|chr5:1633359-1633509,chr5,1633359,1633509,HepG2|chr5:272416-272566,chr5,272416,272566,1,1360943
HepG2|chr5:1633360-1633510,chr5,1633360,1633510,HepG2|chr5:272383-272530,chr5,272383,272530,1,1360977
HepG2|chr5:1633361-1633511,chr5,1633361,1633511,HepG2|chr5:272207-272357,chr5,272207,272357,1,1361154
HepG2|chr5:1633362-1633512,chr5,1633362,1633512,HepG2|chr5:272416-272566,chr5,272416,272566,1,1360946
HepG2|chr5:1633384-1633534,chr5,1633384,1633534,HepG2|chr5:272427-272571,chr5,272427,272571,1,1360957
HepG2|chr5:1633390-1633540,chr5,1633390,1633540,HepG2|chr5:272413-272561,chr5,272413,272561,1,1360977
HepG2|chr5:1633393-1633543,chr5,1633393,1633543,HepG2|chr5:272405-272555,chr5,272405,272555,1,1360988
HepG2|chr5:1633394-1633544,chr5,1633394,1633544,HepG2|chr5:272416-272566,chr5,272416,272566,1,1360978
HepG2|chr5:1633396-1633546,chr5,1633396,1633546,HepG2|chr5:272383-272529,chr5,272383,272529,1,1361013
HepG2|chr5:1633398-1633548,chr5,1633398,1633548,HepG2|chr5:272442-272592,chr5,272442,272592,1,1360956
HepG2|chr5:1633402-1633550,chr5,1633402,1633550,HepG2|chr5:272427-272571,chr5,272427,272571,1,1360975
HepG2|chr5:1633403-1633543,chr5,1633403,1633543,HepG2|chr5:272416-272566,chr5,272416,272566,1,1360987
HepG2|chr5:1633405-1633555,chr5,1633405,1633555,HepG2|chr5:272421-272571,chr5,272421,272571,1,1360984
HepG2|chr5:1633421-1633571,chr5,1633421,1633571,HepG2|chr5:272210-272360,chr5,272210,272360,1,1361211
HepG2|chr5:1633422-1633572,chr5,1633422,1633572,HepG2|chr5:272413-272561,chr5,272413,272561,1,1361009
HepG2|chr5:1633427-1633577,chr5,1633427,1633577,HepG2|chr5:272377-272527,chr5,272377,272527,1,1361050
HepG2|chr5:1633433-1633583,chr5,1633433,1633583,HepG2|chr5:272383-272530,chr5,272383,272530,1,1361050
HepG2|chr5:1633437-1633587,chr5,1633437,1633587,HepG2|chr5:272210-272360,chr5,272210,272360,1,1361227
HepG2|chr5:1633438-1633588,chr5,1633438,1633588,HepG2|chr5:272398-272548,chr5,272398,272548,1,1361040
HepG2|chr5:1633439-1633586,chr5,1633439,1633586,HepG2|chr5:272383-272529,chr5,272383,272529,1,1361056
HepG2|chr5:1633444-1633594,chr5,1633444,1633594,HepG2|chr5:272416-272566,chr5,272416,272566,1,1361028
HepG2|chr5:1633445-1633595,chr5,1633445,1633595,HepG2|chr5:272377-272527,chr5,272377,272527,1,1361068
HepG2|chr5:1633445-1633554,chr5,1633445,1633554,HepG2|chr5:272377-272527,chr5,272377,272527,1,1361068
HepG2|chr5:1633449-1633599,chr5,1633449,1633599,HepG2|chr5:272212-272362,chr5,272212,272362,1,1361237
HepG2|chr5:1633451-1633601,chr5,1633451,1633601,HepG2|chr5:272418-272567,chr5,272418,272567,1,1361033
HepG2|chr5:1633452-1633602,chr5,1633452,1633602,HepG2|chr5:272189-272339,chr5,272189,272339,1,1361263
HepG2|chr5:1633455-1633605,chr5,1633455,1633605,HepG2|chr5:272147-272291,chr5,272147,272291,1,1361308
HepG2|chr5:1633457-1633607,chr5,1633457,1633607,HepG2|chr5:272115-272264,chr5,272115,272264,1,1361342
HepG2|chr5:1633458-1633608,chr5,1633458,1633608,HepG2|chr5:272161-272305,chr5,272161,272305,1,1361297
HepG2|chr5:1633459-1633609,chr5,1633459,1633609,HepG2|chr5:272148-272291,chr5,272148,272291,1,1361311
HepG2|chr5:1633461-1633611,chr5,1633461,1633611,HepG2|chr5:272078-272222,chr5,272078,272222,1,1361383
HepG2|chr5:1633462-1633612,chr5,1633462,1633612,HepG2|chr5:272207-272357,chr5,272207,272357,1,1361255
HepG2|chr5:1633465-1633615,chr5,1633465,1633615,HepG2|chr5:272377-272527,chr5,272377,272527,1,1361088
HepG2|chr5:1633466-1633616,chr5,1633466,1633616,HepG2|chr5:272376-272526,chr5,272376,272526,1,1361090
HepG2|chr5:1633472-1633619,chr5,1633472,1633619,HepG2|chr5:272414-272564,chr5,272414,272564,1,1361058
HepG2|chr5:1633473-1633621,chr5,1633473,1633621,HepG2|chr5:272414-272564,chr5,272414,272564,1,1361059
HepG2|chr5:1633477-1633583,chr5,1633477,1633583,HepG2|chr5:272415-272565,chr5,272415,272565,1,1361062
HepG2|chr5:1633478-1633619,chr5,1633478,1633619,HepG2|chr5:272161-272307,chr5,272161,272307,1,1361317
HepG2|chr5:1633505-1633649,chr5,1633505,1633649,HepG2|chr5:272377-272527,chr5,272377,272527,1,1361128
HepG2|chr5:5360314-5360334,chr5,5360314,5360334,HepG2|chr5:5417816-5417958,chr5,5417816,5417958,1,57502
HepG2|chr5:5361493-5361543,chr5,5361493,5361543,HepG2|chr5:5421515-5421566,chr5,5421515,5421566,1,60022
HepG2|chr5:5415669-5415736,chr5,5415669,5415736,HepG2|chr5:5420404-5420477,chr5,5420404,5420477,1,4735
HepG2|chr5:5415765-5415903,chr5,5415765,5415903,HepG2|chr5:5421856-5421887,chr5,5421856,5421887,1,6091
HepG2|chr5:36179166-36179218,chr5,36179166,36179218,HepG2|chr5:36149710-36149860,chr5,36149710,36149860,1,29456
HepG2|chr5:36179167-36179218,chr5,36179167,36179218,HepG2|chr5:36149710-36149860,chr5,36149710,36149860,1,29457
HepG2|chr5:38833510-38833641,chr5,38833510,38833641,HepG2|chr5:139035319-139035345,chr5,139035319,139035345,1,100201809
HepG2|chr5:38833519-38833643,chr5,38833519,38833643,HepG2|chr5:139035319-139035345,chr5,139035319,139035345,1,100201800
HepG2|chr5:39053675-39053752,chr5,39053675,39053752,HepG2|chr5:178988929-178989079,chr5,178988929,178989079,1,139935254
HepG2|chr5:39053679-39053752,chr5,39053679,39053752,HepG2|chr5:178988929-178989000,chr5,178988929,178989000,1,139935250
HepG2|chr5:40781456-40781532,chr5,40781456,40781532,HepG2|chr5:40756225-40756272,chr5,40756225,40756272,1,25231
HepG2|chr5:40781456-40781514,chr5,40781456,40781514,HepG2|chr5:40756195-40756272,chr5,40756195,40756272,1,25261
HepG2|chr5:40790053-40790091,chr5,40790053,40790091,HepG2|chr5:40756239-40756272,chr5,40756239,40756272,1,33814
HepG2|chr5:40790053-40790082,chr5,40790053,40790082,HepG2|chr5:40756222-40756272,chr5,40756222,40756272,1,33831
HepG2|chr5:43009536-43009613,chr5,43009536,43009613,HepG2|chr5:43067341-43067441,chr5,43067341,43067441,1,57805
HepG2|chr5:43009564-43009613,chr5,43009564,43009613,HepG2|chr5:43067341-43067441,chr5,43067341,43067441,1,57777
HepG2|chr5:43009595-43009613,chr5,43009595,43009613,HepG2|chr5:43067341-43067441,chr5,43067341,43067441,1,57746
HepG2|chr5:66335560-66335591,chr5,66335560,66335591,HepG2|chr5:175970596-175970746,chr5,175970596,175970746,1,109635036
HepG2|chr5:68477621-68477771,chr5,68477621,68477771,HepG2|chr5:68484817-68484884,chr5,68484817,68484884,1,7196
HepG2|chr5:68477674-68477824,chr5,68477674,68477824,HepG2|chr5:68483746-68483889,chr5,68483746,68483889,1,6072
HepG2|chr5:68477724-68477829,chr5,68477724,68477829,HepG2|chr5:68483072-68483101,chr5,68483072,68483101,1,5348
HepG2|chr5:68477746-68477829,chr5,68477746,68477829,HepG2|chr5:68484817-68484884,chr5,68484817,68484884,1,7071
HepG2|chr5:76477354-76477377,chr5,76477354,76477377,HepG2|chr5:76502237-76502367,chr5,76502237,76502367,1,24883
HepG2|chr5:76477357-76477377,chr5,76477357,76477377,HepG2|chr5:76502237-76502367,chr5,76502237,76502367,1,24880
HepG2|chr5:76477717-76477800,chr5,76477717,76477800,HepG2|chr5:76502355-76502420,chr5,76502355,76502420,1,24638
HepG2|chr5:76477735-76477836,chr5,76477735,76477836,HepG2|chr5:76508226-76508275,chr5,76508226,76508275,1,30491
HepG2|chr5:76477747-76477836,chr5,76477747,76477836,HepG2|chr5:76508226-76508287,chr5,76508226,76508287,1,30479
HepG2|chr5:76479085-76479143,chr5,76479085,76479143,HepG2|chr5:76503244-76503321,chr5,76503244,76503321,1,24159
HepG2|chr5:76480974-76481018,chr5,76480974,76481018,HepG2|chr5:76505720-76505870,chr5,76505720,76505870,1,24746
HepG2|chr5:76481128-76481184,chr5,76481128,76481184,HepG2|chr5:76505948-76506093,chr5,76505948,76506093,1,24820
HepG2|chr5:76482303-76482331,chr5,76482303,76482331,HepG2|chr5:76501934-76501959,chr5,76501934,76501959,1,19631
HepG2|chr5:76482333-76482442,chr5,76482333,76482442,HepG2|chr5:76501934-76501959,chr5,76501934,76501959,1,19601
HepG2|chr5:76482719-76482864,chr5,76482719,76482864,HepG2|chr5:76503028-76503128,chr5,76503028,76503128,1,20309
HepG2|chr5:76482811-76482861,chr5,76482811,76482861,HepG2|chr5:76503028-76503128,chr5,76503028,76503128,1,20217
HepG2|chr5:76483056-76483086,chr5,76483056,76483086,HepG2|chr5:76502414-76502506,chr5,76502414,76502506,1,19358
HepG2|chr5:98191009-98191151,chr5,98191009,98191151,HepG2|chr5:98264402-98264455,chr5,98264402,98264455,1,73393
HepG2|chr5:98191009-98191102,chr5,98191009,98191102,HepG2|chr5:98264402-98264455,chr5,98264402,98264455,1,73393
HepG2|chr5:98191310-98191402,chr5,98191310,98191402,HepG2|chr5:98264282-98264307,chr5,98264282,98264307,1,72972
HepG2|chr5:126129149-126129283,chr5,126129149,126129283,HepG2|chr5:613754-613872,chr5,613754,613872,1,125515395
HepG2|chr5:126129149-126129279,chr5,126129149,126129279,HepG2|chr5:613754-613872,chr5,613754,613872,1,125515395
HepG2|chr5:126129247-126129279,chr5,126129247,126129279,HepG2|chr5:613754-613872,chr5,613754,613872,1,125515493
HepG2|chr5:133843714-133843824,chr5,133843714,133843824,HepG2|chr5:133855244-133855289,chr5,133855244,133855289,1,11530
HepG2|chr5:133843714-133843819,chr5,133843714,133843819,HepG2|chr5:133855244-133855289,chr5,133855244,133855289,1,11530
HepG2|chr5:133844673-133844763,chr5,133844673,133844763,HepG2|chr5:133857603-133857634,chr5,133857603,133857634,1,12930
HepG2|chr5:133845734-133845752,chr5,133845734,133845752,HepG2|chr5:133857533-133857683,chr5,133857533,133857683,1,11799
HepG2|chr5:133846930-133846997,chr5,133846930,133846997,HepG2|chr5:133856945-133857004,chr5,133856945,133857004,1,10015
HepG2|chr5:133846930-133846960,chr5,133846930,133846960,HepG2|chr5:133856945-133857004,chr5,133856945,133857004,1,10015
HepG2|chr5:133849336-133849409,chr5,133849336,133849409,HepG2|chr5:133855516-133855559,chr5,133855516,133855559,1,6180
HepG2|chr5:139049332-139049414,chr5,139049332,139049414,HepG2|chr5:96143956-96143999,chr5,96143956,96143999,1,42905376
HepG2|chr5:139049357-139049417,chr5,139049357,139049417,HepG2|chr5:96143956-96143999,chr5,96143956,96143999,1,42905401
HepG2|chr5:139578456-139578526,chr5,139578456,139578526,HepG2|chr5:139491608-139491648,chr5,139491608,139491648,1,86848
HepG2|chr5:148704248-148704398,chr5,148704248,148704398,HepG2|chr5:148724734-148724813,chr5,148724734,148724813,1,20486
HepG2|chr5:148704408-148704478,chr5,148704408,148704478,HepG2|chr5:148724734-148724764,chr5,148724734,148724764,1,20326
HepG2|chr5:148704408-148704477,chr5,148704408,148704477,HepG2|chr5:148724734-148724764,chr5,148724734,148724764,1,20326
HepG2|chr5:148704409-148704477,chr5,148704409,148704477,HepG2|chr5:148724734-148724822,chr5,148724734,148724822,1,20325
HepG2|chr5:148704421-148704477,chr5,148704421,148704477,HepG2|chr5:148724734-148724822,chr5,148724734,148724822,1,20313
HepG2|chr5:148716154-148716235,chr5,148716154,148716235,HepG2|chr5:148724734-148724759,chr5,148724734,148724759,1,8580
HepG2|chr5:148716319-148716443,chr5,148716319,148716443,HepG2|chr5:148724734-148724759,chr5,148724734,148724759,1,8415
HepG2|chr5:149954352-149954457,chr5,149954352,149954457,HepG2|chr5:150019651-150019696,chr5,150019651,150019696,1,65299
HepG2|chr5:149959228-149959295,chr5,149959228,149959295,HepG2|chr5:150019651-150019696,chr5,150019651,150019696,1,60423
HepG2|chr5:154062511-154062597,chr5,154062511,154062597,HepG2|chr5:154134232-154134382,chr5,154134232,154134382,1,71721
HepG2|chr5:154062577-154062597,chr5,154062577,154062597,HepG2|chr5:154134201-154134300,chr5,154134201,154134300,1,71624
HepG2|chr5:154078125-154078167,chr5,154078125,154078167,HepG2|chr5:154084787-154084895,chr5,154084787,154084895,1,6662
HepG2|chr5:154078130-154078247,chr5,154078130,154078247,HepG2|chr5:154084787-154084895,chr5,154084787,154084895,1,6657
HepG2|chr5:154079052-154079139,chr5,154079052,154079139,HepG2|chr5:154089077-154089128,chr5,154089077,154089128,1,10025
HepG2|chr5:154079052-154079136,chr5,154079052,154079136,HepG2|chr5:154089077-154089128,chr5,154089077,154089128,1,10025
HepG2|chr5:154079054-154079139,chr5,154079054,154079139,HepG2|chr5:154089077-154089128,chr5,154089077,154089128,1,10023
HepG2|chr5:154079072-154079139,chr5,154079072,154079139,HepG2|chr5:154089077-154089128,chr5,154089077,154089128,1,10005
HepG2|chr5:158607220-158607338,chr5,158607220,158607338,HepG2|chr5:53974-53993,chr5,53974,53993,1,158553246
HepG2|chr5:158610151-158610191,chr5,158610151,158610191,HepG2|chr5:180236419-180236510,chr5,180236419,180236510,1,21626268
HepG2|chr5:158610152-158610191,chr5,158610152,158610191,HepG2|chr5:180236419-180236510,chr5,180236419,180236510,1,21626267
HepG2|chr5:171571481-171571539,chr5,171571481,171571539,HepG2|chr5:179049011-179049103,chr5,179049011,179049103,1,7477530
HepG2|chr5:171571483-171571556,chr5,171571483,171571556,HepG2|chr5:179049011-179049103,chr5,179049011,179049103,1,7477528
HepG2|chr5:173123488-173123506,chr5,173123488,173123506,HepG2|chr5:173113059-173113098,chr5,173113059,173113098,1,10429
HepG2|chr5:173124149-173124210,chr5,173124149,173124210,HepG2|chr5:173111839-173111902,chr5,173111839,173111902,1,12310
HepG2|chr5:173144107-173144254,chr5,173144107,173144254,HepG2|chr5:173114844-173114866,chr5,173114844,173114866,1,29263
HepG2|chr5:175612650-175612724,chr5,175612650,175612724,HepG2|chr5:175628481-175628556,chr5,175628481,175628556,1,15831
HepG2|chr5:175614454-175614599,chr5,175614454,175614599,HepG2|chr5:175631751-175631842,chr5,175631751,175631842,1,17297
HepG2|chr5:175614540-175614599,chr5,175614540,175614599,HepG2|chr5:175631751-175631842,chr5,175631751,175631842,1,17211
HepG2|chr5:176745200-176745259,chr5,176745200,176745259,HepG2|chr5:176744515-176744665,chr5,176744515,176744665,1,685
HepG2|chr5:176745843-176745937,chr5,176745843,176745937,HepG2|chr5:176744544-176744643,chr5,176744544,176744643,1,1299
HepG2|chr5:176745843-176745894,chr5,176745843,176745894,HepG2|chr5:176744544-176744643,chr5,176744544,176744643,1,1299
HepG2|chr5:176746298-176746369,chr5,176746298,176746369,HepG2|chr5:176742931-176743047,chr5,176742931,176743047,1,3367
HepG2|chr5:176746338-176746372,chr5,176746338,176746372,HepG2|chr5:176742931-176743047,chr5,176742931,176743047,1,3407
HepG2|chr5:176746979-176747087,chr5,176746979,176747087,HepG2|chr5:176741673-176741719,chr5,176741673,176741719,1,5306
HepG2|chr5:176746979-176747083,chr5,176746979,176747083,HepG2|chr5:176741673-176741719,chr5,176741673,176741719,1,5306
HepG2|chr5:176748196-176748346,chr5,176748196,176748346,HepG2|chr5:176740291-176740382,chr5,176740291,176740382,1,7905
HepG2|chr5:176748323-176748382,chr5,176748323,176748382,HepG2|chr5:176740291-176740382,chr5,176740291,176740382,1,8032
HepG2|chr5:176748336-176748361,chr5,176748336,176748361,HepG2|chr5:176744069-176744219,chr5,176744069,176744219,1,4267
HepG2|chr5:176748665-176748718,chr5,176748665,176748718,HepG2|chr5:176742610-176742707,chr5,176742610,176742707,1,6055
HepG2|chr5:176748714-176748864,chr5,176748714,176748864,HepG2|chr5:176742610-176742707,chr5,176742610,176742707,1,6104
HepG2|chr5:176749459-176749604,chr5,176749459,176749604,HepG2|chr5:176743449-176743494,chr5,176743449,176743494,1,6010
HepG2|chr5:176753977-176754066,chr5,176753977,176754066,HepG2|chr5:176740213-176740250,chr5,176740213,176740250,1,13764
HepG2|chr5:176754000-176754025,chr5,176754000,176754025,HepG2|chr5:176742934-176743073,chr5,176742934,176743073,1,11066
HepG2|chr5:176754832-176754982,chr5,176754832,176754982,HepG2|chr5:176743246-176743289,chr5,176743246,176743289,1,11586
HepG2|chr5:176754832-176754966,chr5,176754832,176754966,HepG2|chr5:176743246-176743289,chr5,176743246,176743289,1,11586
HepG2|chr5:176754985-176755092,chr5,176754985,176755092,HepG2|chr5:176743246-176743289,chr5,176743246,176743289,1,11739
HepG2|chr5:177303067-177303217,chr5,177303067,177303217,HepG2|chr5:175394492-175394590,chr5,175394492,175394590,1,1908575
HepG2|chr5:177303073-177303223,chr5,177303073,177303223,HepG2|chr5:175394468-175394590,chr5,175394468,175394590,1,1908605
HepG2|chr5:177303088-177303237,chr5,177303088,177303237,HepG2|chr5:175394468-175394603,chr5,175394468,175394603,1,1908620
HepG2|chr5:177303092-177303238,chr5,177303092,177303238,HepG2|chr5:175394527-175394590,chr5,175394527,175394590,1,1908565
HepG2|chr5:177303161-177303218,chr5,177303161,177303218,HepG2|chr5:175394517-175394567,chr5,175394517,175394567,1,1908644
HepG2|chr5:177303237-177303384,chr5,177303237,177303384,HepG2|chr5:175394476-175394626,chr5,175394476,175394626,1,1908761
HepG2|chr5:177303238-177303378,chr5,177303238,177303378,HepG2|chr5:175394453-175394603,chr5,175394453,175394603,1,1908785
HepG2|chr5:179932177-179932231,chr5,179932177,179932231,HepG2|chr5:37248904-37248971,chr5,37248904,37248971,1,142683273
HepG2|chr6:1276273-1276423,chr6,1276273,1276423,HepG2|chr6:1310457-1310530,chr6,1310457,1310530,1,34184
HepG2|chr6:1276354-1276431,chr6,1276354,1276431,HepG2|chr6:1310457-1310530,chr6,1310457,1310530,1,34103
HepG2|chr6:1284689-1284710,chr6,1284689,1284710,HepG2|chr6:1307690-1307816,chr6,1307690,1307816,1,23001
HepG2|chr6:1284690-1284711,chr6,1284690,1284711,HepG2|chr6:1307690-1307816,chr6,1307690,1307816,1,23000
HepG2|chr6:1286395-1286455,chr6,1286395,1286455,HepG2|chr6:1309381-1309527,chr6,1309381,1309527,1,22986
HepG2|chr6:1286510-1286660,chr6,1286510,1286660,HepG2|chr6:1310867-1310967,chr6,1310867,1310967,1,24357
HepG2|chr6:1286621-1286671,chr6,1286621,1286671,HepG2|chr6:1310867-1310967,chr6,1310867,1310967,1,24246
HepG2|chr6:1287195-1287263,chr6,1287195,1287263,HepG2|chr6:1309638-1309685,chr6,1309638,1309685,1,22443
HepG2|chr6:1287216-1287263,chr6,1287216,1287263,HepG2|chr6:1308817-1308883,chr6,1308817,1308883,1,21601
HepG2|chr6:1287281-1287431,chr6,1287281,1287431,HepG2|chr6:1309638-1309685,chr6,1309638,1309685,1,22357
HepG2|chr6:1287373-1287468,chr6,1287373,1287468,HepG2|chr6:1309638-1309672,chr6,1309638,1309672,1,22265
HepG2|chr6:1287385-1287468,chr6,1287385,1287468,HepG2|chr6:1309191-1309259,chr6,1309191,1309259,1,21806
HepG2|chr6:1287403-1287468,chr6,1287403,1287468,HepG2|chr6:1308817-1308941,chr6,1308817,1308941,1,21414
HepG2|chr6:1287418-1287468,chr6,1287418,1287468,HepG2|chr6:1309191-1309274,chr6,1309191,1309274,1,21773
HepG2|chr6:1287422-1287468,chr6,1287422,1287468,HepG2|chr6:1308817-1308853,chr6,1308817,1308853,1,21395
HepG2|chr6:1287423-1287468,chr6,1287423,1287468,HepG2|chr6:1308817-1308870,chr6,1308817,1308870,1,21394
HepG2|chr6:1287442-1287468,chr6,1287442,1287468,HepG2|chr6:1308817-1308941,chr6,1308817,1308941,1,21375
HepG2|chr6:1287815-1287893,chr6,1287815,1287893,HepG2|chr6:1309638-1309693,chr6,1309638,1309693,1,21823
HepG2|chr6:1287834-1287893,chr6,1287834,1287893,HepG2|chr6:1308817-1308853,chr6,1308817,1308853,1,20983
HepG2|chr6:1288115-1288188,chr6,1288115,1288188,HepG2|chr6:1308817-1308853,chr6,1308817,1308853,1,20702
HepG2|chr6:1288121-1288188,chr6,1288121,1288188,HepG2|chr6:1308817-1308853,chr6,1308817,1308853,1,20696
HepG2|chr6:1288124-1288188,chr6,1288124,1288188,HepG2|chr6:1308817-1308875,chr6,1308817,1308875,1,20693
HepG2|chr6:1288152-1288188,chr6,1288152,1288188,HepG2|chr6:1308817-1308920,chr6,1308817,1308920,1,20665
HepG2|chr6:1288157-1288188,chr6,1288157,1288188,HepG2|chr6:1308817-1308853,chr6,1308817,1308853,1,20660
HepG2|chr6:1325065-1325162,chr6,1325065,1325162,HepG2|chr6:1389253-1389293,chr6,1389253,1389293,1,64188
HepG2|chr6:1336134-1336179,chr6,1336134,1336179,HepG2|chr6:1385438-1385588,chr6,1385438,1385588,1,49304
HepG2|chr6:2229670-2229793,chr6,2229670,2229793,HepG2|chr6:7722668-7722711,chr6,7722668,7722711,1,5492998
HepG2|chr6:2229726-2229876,chr6,2229726,2229876,HepG2|chr6:7722668-7722710,chr6,7722668,7722710,1,5492942
HepG2|chr6:2856683-2856806,chr6,2856683,2856806,HepG2|chr6:2841446-2841574,chr6,2841446,2841574,1,15237
HepG2|chr6:2856683-2856764,chr6,2856683,2856764,HepG2|chr6:2841501-2841574,chr6,2841501,2841574,1,15182
HepG2|chr6:2856683-2856760,chr6,2856683,2856760,HepG2|chr6:2841501-2841574,chr6,2841501,2841574,1,15182
HepG2|chr6:2857556-2857619,chr6,2857556,2857619,HepG2|chr6:2840570-2840630,chr6,2840570,2840630,1,16986
HepG2|chr6:3052533-3052602,chr6,3052533,3052602,HepG2|chr6:3002854-3002896,chr6,3002854,3002896,1,49679
HepG2|chr6:3052556-3052610,chr6,3052556,3052610,HepG2|chr6:3003690-3003833,chr6,3003690,3003833,1,48866
HepG2|chr6:3052572-3052625,chr6,3052572,3052625,HepG2|chr6:3003461-3003610,chr6,3003461,3003610,1,49111
HepG2|chr6:3109495-3109632,chr6,3109495,3109632,HepG2|chr6:3118022-3118077,chr6,3118022,3118077,1,8527
HepG2|chr6:3109510-3109630,chr6,3109510,3109630,HepG2|chr6:3118022-3118051,chr6,3118022,3118051,1,8512
HepG2|chr6:3109511-3109630,chr6,3109511,3109630,HepG2|chr6:3118022-3118051,chr6,3118022,3118051,1,8511
HepG2|chr6:3109535-3109630,chr6,3109535,3109630,HepG2|chr6:3118022-3118044,chr6,3118022,3118044,1,8487
HepG2|chr6:3109544-3109630,chr6,3109544,3109630,HepG2|chr6:3118022-3118083,chr6,3118022,3118083,1,8478
HepG2|chr6:3109566-3109630,chr6,3109566,3109630,HepG2|chr6:3118022-3118105,chr6,3118022,3118105,1,8456
HepG2|chr6:3112432-3112568,chr6,3112432,3112568,HepG2|chr6:3118022-3118134,chr6,3118022,3118134,1,5590
HepG2|chr6:3112471-3112588,chr6,3112471,3112588,HepG2|chr6:3118022-3118054,chr6,3118022,3118054,1,5551
HepG2|chr6:3112484-3112588,chr6,3112484,3112588,HepG2|chr6:3118022-3118111,chr6,3118022,3118111,1,5538
HepG2|chr6:3112492-3112588,chr6,3112492,3112588,HepG2|chr6:3118022-3118054,chr6,3118022,3118054,1,5530
HepG2|chr6:3112527-3112588,chr6,3112527,3112588,HepG2|chr6:3118022-3118111,chr6,3118022,3118111,1,5495
HepG2|chr6:3112528-3112588,chr6,3112528,3112588,HepG2|chr6:3118022-3118087,chr6,3118022,3118087,1,5494
HepG2|chr6:3112541-3112588,chr6,3112541,3112588,HepG2|chr6:3118078-3118222,chr6,3118078,3118222,1,5537
HepG2|chr6:3112543-3112588,chr6,3112543,3112588,HepG2|chr6:3118022-3118138,chr6,3118022,3118138,1,5479
HepG2|chr6:3112550-3112588,chr6,3112550,3112588,HepG2|chr6:3118022-3118134,chr6,3118022,3118134,1,5472
HepG2|chr6:3112554-3112588,chr6,3112554,3112588,HepG2|chr6:3118022-3118138,chr6,3118022,3118138,1,5468
HepG2|chr6:4791578-4791648,chr6,4791578,4791648,HepG2|chr6:10530537-10530619,chr6,10530537,10530619,1,5738959
HepG2|chr6:4791578-4791646,chr6,4791578,4791646,HepG2|chr6:10530537-10530619,chr6,10530537,10530619,1,5738959
HepG2|chr6:4796748-4796791,chr6,4796748,4796791,HepG2|chr6:10531791-10531918,chr6,10531791,10531918,1,5735043
HepG2|chr6:4796768-4796791,chr6,4796768,4796791,HepG2|chr6:10531791-10531918,chr6,10531791,10531918,1,5735023
HepG2|chr6:5014308-5014371,chr6,5014308,5014371,HepG2|chr6:5004936-5005041,chr6,5004936,5005041,1,9372
HepG2|chr6:5014329-5014374,chr6,5014329,5014374,HepG2|chr6:5004936-5005041,chr6,5004936,5005041,1,9393
HepG2|chr6:5021612-5021669,chr6,5021612,5021669,HepG2|chr6:5004060-5004148,chr6,5004060,5004148,1,17552
HepG2|chr6:5021612-5021668,chr6,5021612,5021668,HepG2|chr6:5004060-5004148,chr6,5004060,5004148,1,17552
HepG2|chr6:5021614-5021762,chr6,5021614,5021762,HepG2|chr6:5004083-5004122,chr6,5004083,5004122,1,17531
HepG2|chr6:5021614-5021698,chr6,5021614,5021698,HepG2|chr6:5004021-5004171,chr6,5004021,5004171,1,17593
HepG2|chr6:5021614-5021666,chr6,5021614,5021666,HepG2|chr6:5004038-5004188,chr6,5004038,5004188,1,17576
HepG2|chr6:5205959-5206020,chr6,5205959,5206020,HepG2|chr6:150183599-150183688,chr6,150183599,150183688,1,144977640
HepG2|chr6:5206039-5206189,chr6,5206039,5206189,HepG2|chr6:150183599-150183688,chr6,150183599,150183688,1,144977560
HepG2|chr6:5206039-5206188,chr6,5206039,5206188,HepG2|chr6:150183600-150183688,chr6,150183600,150183688,1,144977561
HepG2|chr6:5206121-5206189,chr6,5206121,5206189,HepG2|chr6:150183599-150183688,chr6,150183599,150183688,1,144977478
HepG2|chr6:5243849-5243867,chr6,5243849,5243867,HepG2|chr6:116691843-116691972,chr6,116691843,116691972,1,111447994
HepG2|chr6:7119562-7119599,chr6,7119562,7119599,HepG2|chr6:5262399-5262512,chr6,5262399,5262512,1,1857163
HepG2|chr6:7119599-7119716,chr6,7119599,7119716,HepG2|chr6:5262512-5262545,chr6,5262512,5262545,1,1857087
HepG2|chr6:7119599-7119714,chr6,7119599,7119714,HepG2|chr6:5262512-5262546,chr6,5262512,5262546,1,1857087
HepG2|chr6:7119599-7119713,chr6,7119599,7119713,HepG2|chr6:5262512-5262548,chr6,5262512,5262548,1,1857087
HepG2|chr6:13823847-13823970,chr6,13823847,13823970,HepG2|chr6:13821457-13821575,chr6,13821457,13821575,1,2390
HepG2|chr6:13823943-13823975,chr6,13823943,13823975,HepG2|chr6:13821457-13821575,chr6,13821457,13821575,1,2486
HepG2|chr6:13825304-13825374,chr6,13825304,13825374,HepG2|chr6:13815505-13815585,chr6,13815505,13815585,1,9799
HepG2|chr6:13825304-13825340,chr6,13825304,13825340,HepG2|chr6:13815491-13815585,chr6,13815491,13815585,1,9813
HepG2|chr6:15310903-15311053,chr6,15310903,15311053,HepG2|chr6:26159066-26159195,chr6,26159066,26159195,1,10848163
HepG2|chr6:15311090-15311111,chr6,15311090,15311111,HepG2|chr6:26159066-26159195,chr6,26159066,26159195,1,10847976
HepG2|chr6:20966323-20966393,chr6,20966323,20966393,HepG2|chr6:26285998-26286070,chr6,26285998,26286070,1,5319675
HepG2|chr6:20966323-20966390,chr6,20966323,20966390,HepG2|chr6:26285998-26286070,chr6,26285998,26286070,1,5319675
HepG2|chr6:26259823-26259851,chr6,26259823,26259851,HepG2|chr6:26252333-26252483,chr6,26252333,26252483,1,7490
HepG2|chr6:26261599-26261714,chr6,26261599,26261714,HepG2|chr6:26252295-26252371,chr6,26252295,26252371,1,9304
HepG2|chr6:26261599-26261713,chr6,26261599,26261713,HepG2|chr6:26252298-26252371,chr6,26252298,26252371,1,9301
HepG2|chr6:26261599-26261676,chr6,26261599,26261676,HepG2|chr6:26252298-26252371,chr6,26252298,26252371,1,9301
HepG2|chr6:26261599-26261673,chr6,26261599,26261673,HepG2|chr6:26252295-26252371,chr6,26252295,26252371,1,9304
HepG2|chr6:26296182-26296256,chr6,26296182,26296256,HepG2|chr6:26288608-26288665,chr6,26288608,26288665,1,7574
HepG2|chr6:26296298-26296407,chr6,26296298,26296407,HepG2|chr6:26286238-26286281,chr6,26286238,26286281,1,10060
HepG2|chr6:26296298-26296399,chr6,26296298,26296399,HepG2|chr6:26286233-26286281,chr6,26286233,26286281,1,10065
HepG2|chr6:26296298-26296398,chr6,26296298,26296398,HepG2|chr6:26286233-26286281,chr6,26286233,26286281,1,10065
HepG2|chr6:26296298-26296397,chr6,26296298,26296397,HepG2|chr6:26286239-26286281,chr6,26286239,26286281,1,10059
HepG2|chr6:26296298-26296391,chr6,26296298,26296391,HepG2|chr6:26286130-26286280,chr6,26286130,26286280,1,10168
HepG2|chr6:26296298-26296346,chr6,26296298,26296346,HepG2|chr6:26286201-26286281,chr6,26286201,26286281,1,10097
HepG2|chr6:26296367-26296517,chr6,26296367,26296517,HepG2|chr6:26286238-26286281,chr6,26286238,26286281,1,10129
HepG2|chr6:26297587-26297669,chr6,26297587,26297669,HepG2|chr6:26286088-26286152,chr6,26286088,26286152,1,11499
HepG2|chr6:27445902-27446012,chr6,27445902,27446012,HepG2|chr6:27445089-27445129,chr6,27445089,27445129,1,813
HepG2|chr6:27445916-27446009,chr6,27445916,27446009,HepG2|chr6:27445100-27445136,chr6,27445100,27445136,1,816
HepG2|chr6:27445917-27446010,chr6,27445917,27446010,HepG2|chr6:27445100-27445136,chr6,27445100,27445136,1,817
HepG2|chr6:27445919-27446069,chr6,27445919,27446069,HepG2|chr6:27445089-27445129,chr6,27445089,27445129,1,830
HepG2|chr6:27446958-27446981,chr6,27446958,27446981,HepG2|chr6:27443120-27443224,chr6,27443120,27443224,1,3838
HepG2|chr6:27446960-27446981,chr6,27446960,27446981,HepG2|chr6:27443120-27443224,chr6,27443120,27443224,1,3840
HepG2|chr6:27447266-27447413,chr6,27447266,27447413,HepG2|chr6:27442962-27443021,chr6,27442962,27443021,1,4304
HepG2|chr6:27447267-27447381,chr6,27447267,27447381,HepG2|chr6:27442973-27443021,chr6,27442973,27443021,1,4294
HepG2|chr6:27447267-27447369,chr6,27447267,27447369,HepG2|chr6:27442973-27443021,chr6,27442973,27443021,1,4294
HepG2|chr6:27447267-27447358,chr6,27447267,27447358,HepG2|chr6:27442962-27443021,chr6,27442962,27443021,1,4305
HepG2|chr6:27447267-27447355,chr6,27447267,27447355,HepG2|chr6:27442964-27443021,chr6,27442964,27443021,1,4303
HepG2|chr6:28770521-28770601,chr6,28770521,28770601,HepG2|chr6:28236895-28236935,chr6,28236895,28236935,1,533626
HepG2|chr6:29942446-29942496,chr6,29942446,29942496,HepG2|chr6:31372533-31372674,chr6,31372533,31372674,1,1430087
HepG2|chr6:29942452-29942519,chr6,29942452,29942519,HepG2|chr6:31372552-31372638,chr6,31372552,31372638,1,1430100
HepG2|chr6:29944415-29944562,chr6,29944415,29944562,HepG2|chr6:31462099-31462141,chr6,31462099,31462141,1,1517684
HepG2|chr6:29944461-29944569,chr6,29944461,29944569,HepG2|chr6:31462099-31462141,chr6,31462099,31462141,1,1517638
HepG2|chr6:29944545-29944692,chr6,29944545,29944692,HepG2|chr6:31461989-31462139,chr6,31461989,31462139,1,1517444
HepG2|chr6:29944991-29945041,chr6,29944991,29945041,HepG2|chr6:31461699-31461843,chr6,31461699,31461843,1,1516708
HepG2|chr6:30533627-30533704,chr6,30533627,30533704,HepG2|chr6:30535035-30535108,chr6,30535035,30535108,1,1408
HepG2|chr6:30533687-30533704,chr6,30533687,30533704,HepG2|chr6:30535035-30535108,chr6,30535035,30535108,1,1348
HepG2|chr6:30533691-30533724,chr6,30533691,30533724,HepG2|chr6:30538052-30538202,chr6,30538052,30538202,1,4361
HepG2|chr6:30533743-30533888,chr6,30533743,30533888,HepG2|chr6:30537962-30538112,chr6,30537962,30538112,1,4219
HepG2|chr6:30533787-30533872,chr6,30533787,30533872,HepG2|chr6:30538448-30538512,chr6,30538448,30538512,1,4661
HepG2|chr6:30533789-30533875,chr6,30533789,30533875,HepG2|chr6:30538448-30538512,chr6,30538448,30538512,1,4659
HepG2|chr6:30533863-30533883,chr6,30533863,30533883,HepG2|chr6:30535497-30535570,chr6,30535497,30535570,1,1634
HepG2|chr6:30533930-30534074,chr6,30533930,30534074,HepG2|chr6:30534152-30534214,chr6,30534152,30534214,1,222
HepG2|chr6:30533932-30534082,chr6,30533932,30534082,HepG2|chr6:30534240-30534346,chr6,30534240,30534346,1,308
HepG2|chr6:30533933-30534083,chr6,30533933,30534083,HepG2|chr6:30534228-30534272,chr6,30534228,30534272,1,295
HepG2|chr6:30533937-30533963,chr6,30533937,30533963,HepG2|chr6:30534242-30534299,chr6,30534242,30534299,1,305
HepG2|chr6:30533952-30534099,chr6,30533952,30534099,HepG2|chr6:30534235-30534272,chr6,30534235,30534272,1,283
HepG2|chr6:30533973-30534123,chr6,30533973,30534123,HepG2|chr6:30534258-30534291,chr6,30534258,30534291,1,285
HepG2|chr6:30533974-30534121,chr6,30533974,30534121,HepG2|chr6:30534156-30534306,chr6,30534156,30534306,1,182
HepG2|chr6:30533979-30534126,chr6,30533979,30534126,HepG2|chr6:30534179-30534250,chr6,30534179,30534250,1,200
HepG2|chr6:30533987-30534137,chr6,30533987,30534137,HepG2|chr6:30534244-30534277,chr6,30534244,30534277,1,257
HepG2|chr6:30534094-30534149,chr6,30534094,30534149,HepG2|chr6:30536264-30536336,chr6,30536264,30536336,1,2170
HepG2|chr6:30534095-30534149,chr6,30534095,30534149,HepG2|chr6:30536264-30536336,chr6,30536264,30536336,1,2169
HepG2|chr6:30534122-30534146,chr6,30534122,30534146,HepG2|chr6:30534147-30534269,chr6,30534147,30534269,1,25
HepG2|chr6:30534124-30534146,chr6,30534124,30534146,HepG2|chr6:30534147-30534269,chr6,30534147,30534269,1,23
HepG2|chr6:31362265-31362407,chr6,31362265,31362407,HepG2|chr6:31458200-31458324,chr6,31458200,31458324,1,95935
HepG2|chr6:31362265-31362291,chr6,31362265,31362291,HepG2|chr6:31458200-31458324,chr6,31458200,31458324,1,95935
HepG2|chr6:31363130-31363240,chr6,31363130,31363240,HepG2|chr6:31457886-31457919,chr6,31457886,31457919,1,94756
HepG2|chr6:31363175-31363291,chr6,31363175,31363291,HepG2|chr6:31457909-31457971,chr6,31457909,31457971,1,94734
HepG2|chr6:31363175-31363263,chr6,31363175,31363263,HepG2|chr6:31457909-31457960,chr6,31457909,31457960,1,94734
HepG2|chr6:31363182-31363246,chr6,31363182,31363246,HepG2|chr6:31457909-31458013,chr6,31457909,31458013,1,94727
HepG2|chr6:31363214-31363266,chr6,31363214,31363266,HepG2|chr6:31457909-31457986,chr6,31457909,31457986,1,94695
HepG2|chr6:31363226-31363266,chr6,31363226,31363266,HepG2|chr6:31457909-31458013,chr6,31457909,31458013,1,94683
HepG2|chr6:31363260-31363318,chr6,31363260,31363318,HepG2|chr6:31457746-31457871,chr6,31457746,31457871,1,94486
HepG2|chr6:31363260-31363311,chr6,31363260,31363311,HepG2|chr6:31458067-31458107,chr6,31458067,31458107,1,94807
HepG2|chr6:31363957-31364010,chr6,31363957,31364010,HepG2|chr6:31458623-31458772,chr6,31458623,31458772,1,94666
HepG2|chr6:31364309-31364345,chr6,31364309,31364345,HepG2|chr6:31459012-31459084,chr6,31459012,31459084,1,94703
HepG2|chr6:31364412-31364535,chr6,31364412,31364535,HepG2|chr6:31459026-31459077,chr6,31459026,31459077,1,94614
HepG2|chr6:31364412-31364526,chr6,31364412,31364526,HepG2|chr6:31459041-31459077,chr6,31459041,31459077,1,94629
HepG2|chr6:31364412-31364511,chr6,31364412,31364511,HepG2|chr6:31459026-31459077,chr6,31459026,31459077,1,94614
HepG2|chr6:31364412-31364509,chr6,31364412,31364509,HepG2|chr6:31459024-31459077,chr6,31459024,31459077,1,94612
HepG2|chr6:31364412-31364504,chr6,31364412,31364504,HepG2|chr6:31459019-31459077,chr6,31459019,31459077,1,94607
HepG2|chr6:31364412-31364503,chr6,31364412,31364503,HepG2|chr6:31459018-31459077,chr6,31459018,31459077,1,94606
HepG2|chr6:31364412-31364499,chr6,31364412,31364499,HepG2|chr6:31459014-31459077,chr6,31459014,31459077,1,94602
HepG2|chr6:31364412-31364497,chr6,31364412,31364497,HepG2|chr6:31459012-31459077,chr6,31459012,31459077,1,94600
HepG2|chr6:31364412-31364471,chr6,31364412,31364471,HepG2|chr6:31459019-31459077,chr6,31459019,31459077,1,94607
HepG2|chr6:31364412-31364460,chr6,31364412,31364460,HepG2|chr6:31459019-31459077,chr6,31459019,31459077,1,94607
HepG2|chr6:31364412-31364458,chr6,31364412,31364458,HepG2|chr6:31459026-31459077,chr6,31459026,31459077,1,94614
HepG2|chr6:31364419-31364529,chr6,31364419,31364529,HepG2|chr6:31459019-31459077,chr6,31459019,31459077,1,94600
HepG2|chr6:31364419-31364528,chr6,31364419,31364528,HepG2|chr6:31459014-31459077,chr6,31459014,31459077,1,94595
HepG2|chr6:31364419-31364521,chr6,31364419,31364521,HepG2|chr6:31459012-31459077,chr6,31459012,31459077,1,94593
HepG2|chr6:31364419-31364519,chr6,31364419,31364519,HepG2|chr6:31459034-31459084,chr6,31459034,31459084,1,94615
HepG2|chr6:31364419-31364517,chr6,31364419,31364517,HepG2|chr6:31459032-31459084,chr6,31459032,31459084,1,94613
HepG2|chr6:31364419-31364515,chr6,31364419,31364515,HepG2|chr6:31459030-31459084,chr6,31459030,31459084,1,94611
HepG2|chr6:31364419-31364514,chr6,31364419,31364514,HepG2|chr6:31459032-31459084,chr6,31459032,31459084,1,94613
HepG2|chr6:31364419-31364510,chr6,31364419,31364510,HepG2|chr6:31459025-31459084,chr6,31459025,31459084,1,94606
HepG2|chr6:31364419-31364508,chr6,31364419,31364508,HepG2|chr6:31459023-31459084,chr6,31459023,31459084,1,94604
HepG2|chr6:31364419-31364505,chr6,31364419,31364505,HepG2|chr6:31459023-31459084,chr6,31459023,31459084,1,94604
HepG2|chr6:31364419-31364502,chr6,31364419,31364502,HepG2|chr6:31459017-31459084,chr6,31459017,31459084,1,94598
HepG2|chr6:31364419-31364500,chr6,31364419,31364500,HepG2|chr6:31459015-31459084,chr6,31459015,31459084,1,94596
HepG2|chr6:31364419-31364497,chr6,31364419,31364497,HepG2|chr6:31459019-31459077,chr6,31459019,31459077,1,94600
HepG2|chr6:31364419-31364471,chr6,31364419,31364471,HepG2|chr6:31459019-31459084,chr6,31459019,31459084,1,94600
HepG2|chr6:31364419-31364458,chr6,31364419,31364458,HepG2|chr6:31459044-31459084,chr6,31459044,31459084,1,94625
HepG2|chr6:31364430-31364579,chr6,31364430,31364579,HepG2|chr6:31459019-31459077,chr6,31459019,31459077,1,94589
HepG2|chr6:31364435-31364500,chr6,31364435,31364500,HepG2|chr6:31458988-31459084,chr6,31458988,31459084,1,94553
HepG2|chr6:31364449-31364599,chr6,31364449,31364599,HepG2|chr6:31459019-31459077,chr6,31459019,31459077,1,94570
HepG2|chr6:31364468-31364613,chr6,31364468,31364613,HepG2|chr6:31459024-31459077,chr6,31459024,31459077,1,94556
HepG2|chr6:31364476-31364623,chr6,31364476,31364623,HepG2|chr6:31459041-31459077,chr6,31459041,31459077,1,94565
HepG2|chr6:31364968-31365056,chr6,31364968,31365056,HepG2|chr6:31459857-31459917,chr6,31459857,31459917,1,94889
HepG2|chr6:31365078-31365228,chr6,31365078,31365228,HepG2|chr6:31460149-31460299,chr6,31460149,31460299,1,95071
HepG2|chr6:31789915-31790065,chr6,31789915,31790065,HepG2|chr6:31794979-31795085,chr6,31794979,31795085,1,5064
HepG2|chr6:31789915-31790004,chr6,31789915,31790004,HepG2|chr6:31794979-31795093,chr6,31794979,31795093,1,5064
HepG2|chr6:31789915-31789965,chr6,31789915,31789965,HepG2|chr6:31794979-31795093,chr6,31794979,31795093,1,5064
HepG2|chr6:31789925-31790075,chr6,31789925,31790075,HepG2|chr6:31794979-31795082,chr6,31794979,31795082,1,5054
HepG2|chr6:31789938-31790078,chr6,31789938,31790078,HepG2|chr6:31794979-31794999,chr6,31794979,31794999,1,5041
HepG2|chr6:31789943-31790078,chr6,31789943,31790078,HepG2|chr6:31794979-31795072,chr6,31794979,31795072,1,5036
HepG2|chr6:31789946-31790078,chr6,31789946,31790078,HepG2|chr6:31794979-31795098,chr6,31794979,31795098,1,5033
HepG2|chr6:31789948-31790078,chr6,31789948,31790078,HepG2|chr6:31794979-31794999,chr6,31794979,31794999,1,5031
HepG2|chr6:31789950-31790078,chr6,31789950,31790078,HepG2|chr6:31794979-31795081,chr6,31794979,31795081,1,5029
HepG2|chr6:31789966-31790078,chr6,31789966,31790078,HepG2|chr6:31794979-31795017,chr6,31794979,31795017,1,5013
HepG2|chr6:31789977-31790078,chr6,31789977,31790078,HepG2|chr6:31794979-31795082,chr6,31794979,31795082,1,5002
HepG2|chr6:31789982-31790078,chr6,31789982,31790078,HepG2|chr6:31794979-31795069,chr6,31794979,31795069,1,4997
HepG2|chr6:31789983-31790078,chr6,31789983,31790078,HepG2|chr6:31795050-31795200,chr6,31795050,31795200,1,5067
HepG2|chr6:31789984-31790078,chr6,31789984,31790078,HepG2|chr6:31794979-31795093,chr6,31794979,31795093,1,4995
HepG2|chr6:31789990-31790078,chr6,31789990,31790078,HepG2|chr6:31794979-31795050,chr6,31794979,31795050,1,4989
HepG2|chr6:31789992-31790078,chr6,31789992,31790078,HepG2|chr6:31795019-31795169,chr6,31795019,31795169,1,5027
HepG2|chr6:31789997-31790078,chr6,31789997,31790078,HepG2|chr6:31795055-31795205,chr6,31795055,31795205,1,5058
HepG2|chr6:31789999-31790078,chr6,31789999,31790078,HepG2|chr6:31794979-31795050,chr6,31794979,31795050,1,4980
HepG2|chr6:31790003-31790078,chr6,31790003,31790078,HepG2|chr6:31792729-31792788,chr6,31792729,31792788,1,2726
HepG2|chr6:31790018-31790078,chr6,31790018,31790078,HepG2|chr6:31794979-31795076,chr6,31794979,31795076,1,4961
HepG2|chr6:31790019-31790078,chr6,31790019,31790078,HepG2|chr6:31794979-31795111,chr6,31794979,31795111,1,4960
HepG2|chr6:31790021-31790078,chr6,31790021,31790078,HepG2|chr6:31794979-31795072,chr6,31794979,31795072,1,4958
HepG2|chr6:31790023-31790078,chr6,31790023,31790078,HepG2|chr6:31794979-31795074,chr6,31794979,31795074,1,4956
HepG2|chr6:31790025-31790078,chr6,31790025,31790078,HepG2|chr6:31794979-31795076,chr6,31794979,31795076,1,4954
HepG2|chr6:31790027-31790078,chr6,31790027,31790078,HepG2|chr6:31794979-31795078,chr6,31794979,31795078,1,4952
HepG2|chr6:31790028-31790078,chr6,31790028,31790078,HepG2|chr6:31794979-31795093,chr6,31794979,31795093,1,4951
HepG2|chr6:31790030-31790078,chr6,31790030,31790078,HepG2|chr6:31794979-31795081,chr6,31794979,31795081,1,4949
HepG2|chr6:31790031-31790078,chr6,31790031,31790078,HepG2|chr6:31794979-31795082,chr6,31794979,31795082,1,4948
HepG2|chr6:31790034-31790078,chr6,31790034,31790078,HepG2|chr6:31794979-31795085,chr6,31794979,31795085,1,4945
HepG2|chr6:31790035-31790078,chr6,31790035,31790078,HepG2|chr6:31794972-31795112,chr6,31794972,31795112,1,4937
HepG2|chr6:31790036-31790078,chr6,31790036,31790078,HepG2|chr6:31794979-31795098,chr6,31794979,31795098,1,4943
HepG2|chr6:31790037-31790078,chr6,31790037,31790078,HepG2|chr6:31794979-31795093,chr6,31794979,31795093,1,4942
HepG2|chr6:31790038-31790078,chr6,31790038,31790078,HepG2|chr6:31795055-31795205,chr6,31795055,31795205,1,5017
HepG2|chr6:31790040-31790078,chr6,31790040,31790078,HepG2|chr6:31794979-31795100,chr6,31794979,31795100,1,4939
HepG2|chr6:31790042-31790078,chr6,31790042,31790078,HepG2|chr6:31794972-31795119,chr6,31794972,31795119,1,4930
HepG2|chr6:31790043-31790078,chr6,31790043,31790078,HepG2|chr6:31794981-31795078,chr6,31794981,31795078,1,4938
HepG2|chr6:31790046-31790078,chr6,31790046,31790078,HepG2|chr6:31795089-31795238,chr6,31795089,31795238,1,5043
HepG2|chr6:31790047-31790078,chr6,31790047,31790078,HepG2|chr6:31794979-31795098,chr6,31794979,31795098,1,4932
HepG2|chr6:31790048-31790078,chr6,31790048,31790078,HepG2|chr6:31794979-31795093,chr6,31794979,31795093,1,4931
HepG2|chr6:31790049-31790078,chr6,31790049,31790078,HepG2|chr6:31794979-31795093,chr6,31794979,31795093,1,4930
HepG2|chr6:31790054-31790078,chr6,31790054,31790078,HepG2|chr6:31794979-31795101,chr6,31794979,31795101,1,4925
HepG2|chr6:31790060-31790078,chr6,31790060,31790078,HepG2|chr6:31794979-31795111,chr6,31794979,31795111,1,4919
HepG2|chr6:31790129-31790188,chr6,31790129,31790188,HepG2|chr6:31793927-31794077,chr6,31793927,31794077,1,3798
HepG2|chr6:34585927-34586077,chr6,34585927,34586077,HepG2|chr6:116692423-116692573,chr6,116692423,116692573,1,82106496
HepG2|chr6:34680892-34680959,chr6,34680892,34680959,HepG2|chr6:34723885-34723967,chr6,34723885,34723967,1,42993
HepG2|chr6:34686864-34686938,chr6,34686864,34686938,HepG2|chr6:34723885-34723955,chr6,34723885,34723955,1,37021
HepG2|chr6:34686865-34686938,chr6,34686865,34686938,HepG2|chr6:34723885-34723939,chr6,34723885,34723939,1,37020
HepG2|chr6:34686865-34686925,chr6,34686865,34686925,HepG2|chr6:34723885-34723948,chr6,34723885,34723948,1,37020
HepG2|chr6:34686895-34686938,chr6,34686895,34686938,HepG2|chr6:34723444-34723469,chr6,34723444,34723469,1,36549
HepG2|chr6:34693994-34694113,chr6,34693994,34694113,HepG2|chr6:34723444-34723472,chr6,34723444,34723472,1,29450
HepG2|chr6:34694084-34694124,chr6,34694084,34694124,HepG2|chr6:34724875-34724928,chr6,34724875,34724928,1,30791
HepG2|chr6:35168641-35168660,chr6,35168641,35168660,HepG2|chr6:35180405-35180546,chr6,35180405,35180546,1,11764
HepG2|chr6:35169292-35169363,chr6,35169292,35169363,HepG2|chr6:35177481-35177543,chr6,35177481,35177543,1,8189
HepG2|chr6:35199149-35199257,chr6,35199149,35199257,HepG2|chr6:35226846-35226921,chr6,35226846,35226921,1,27697
HepG2|chr6:35199153-35199257,chr6,35199153,35199257,HepG2|chr6:35227066-35227094,chr6,35227066,35227094,1,27913
HepG2|chr6:35199161-35199257,chr6,35199161,35199257,HepG2|chr6:35226846-35226902,chr6,35226846,35226902,1,27685
HepG2|chr6:35199163-35199257,chr6,35199163,35199257,HepG2|chr6:35226846-35226902,chr6,35226846,35226902,1,27683
HepG2|chr6:35199174-35199257,chr6,35199174,35199257,HepG2|chr6:35226868-35226923,chr6,35226868,35226923,1,27694
HepG2|chr6:35199175-35199257,chr6,35199175,35199257,HepG2|chr6:35226850-35226895,chr6,35226850,35226895,1,27675
HepG2|chr6:35199177-35199257,chr6,35199177,35199257,HepG2|chr6:35227066-35227168,chr6,35227066,35227168,1,27889
HepG2|chr6:35199183-35199257,chr6,35199183,35199257,HepG2|chr6:35226846-35226922,chr6,35226846,35226922,1,27663
HepG2|chr6:35199184-35199257,chr6,35199184,35199257,HepG2|chr6:35227066-35227094,chr6,35227066,35227094,1,27882
HepG2|chr6:35199185-35199257,chr6,35199185,35199257,HepG2|chr6:35226847-35226997,chr6,35226847,35226997,1,27662
HepG2|chr6:35199186-35199257,chr6,35199186,35199257,HepG2|chr6:35226846-35226922,chr6,35226846,35226922,1,27660
HepG2|chr6:35199187-35199257,chr6,35199187,35199257,HepG2|chr6:35226846-35226892,chr6,35226846,35226892,1,27659
HepG2|chr6:35199187-35199225,chr6,35199187,35199225,HepG2|chr6:35226869-35227016,chr6,35226869,35227016,1,27682
HepG2|chr6:35199190-35199257,chr6,35199190,35199257,HepG2|chr6:35226854-35227004,chr6,35226854,35227004,1,27664
HepG2|chr6:35199194-35199257,chr6,35199194,35199257,HepG2|chr6:35226880-35227030,chr6,35226880,35227030,1,27686
HepG2|chr6:35199195-35199257,chr6,35199195,35199257,HepG2|chr6:35227066-35227148,chr6,35227066,35227148,1,27871
HepG2|chr6:35199200-35199257,chr6,35199200,35199257,HepG2|chr6:35227066-35227143,chr6,35227066,35227143,1,27866
HepG2|chr6:35199202-35199257,chr6,35199202,35199257,HepG2|chr6:35227066-35227128,chr6,35227066,35227128,1,27864
HepG2|chr6:35199203-35199257,chr6,35199203,35199257,HepG2|chr6:35227066-35227133,chr6,35227066,35227133,1,27863
HepG2|chr6:35199205-35199257,chr6,35199205,35199257,HepG2|chr6:35226846-35226879,chr6,35226846,35226879,1,27641
HepG2|chr6:35199207-35199257,chr6,35199207,35199257,HepG2|chr6:35226846-35226916,chr6,35226846,35226916,1,27639
HepG2|chr6:35199208-35199257,chr6,35199208,35199257,HepG2|chr6:35226846-35226916,chr6,35226846,35226916,1,27638
HepG2|chr6:35199209-35199257,chr6,35199209,35199257,HepG2|chr6:35227066-35227168,chr6,35227066,35227168,1,27857
HepG2|chr6:35199224-35199257,chr6,35199224,35199257,HepG2|chr6:35228178-35228295,chr6,35228178,35228295,1,28954
HepG2|chr6:35199226-35199257,chr6,35199226,35199257,HepG2|chr6:35226846-35226927,chr6,35226846,35226927,1,27620
HepG2|chr6:36090259-36090295,chr6,36090259,36090295,HepG2|chr6:36098917-36098934,chr6,36098917,36098934,1,8658
HepG2|chr6:36091332-36091426,chr6,36091332,36091426,HepG2|chr6:36093661-36093717,chr6,36093661,36093717,1,2329
HepG2|chr6:36091336-36091484,chr6,36091336,36091484,HepG2|chr6:36093661-36093717,chr6,36093661,36093717,1,2325
HepG2|chr6:36491829-36491969,chr6,36491829,36491969,HepG2|chr6:143771041-143771072,chr6,143771041,143771072,1,107279212
HepG2|chr6:36491897-36492013,chr6,36491897,36492013,HepG2|chr6:143771041-143771072,chr6,143771041,143771072,1,107279144
HepG2|chr6:36491915-36492013,chr6,36491915,36492013,HepG2|chr6:143771041-143771072,chr6,143771041,143771072,1,107279126
HepG2|chr6:41492725-41492756,chr6,41492725,41492756,HepG2|chr6:38672372-38672391,chr6,38672372,38672391,1,2820353
HepG2|chr6:41492725-41492752,chr6,41492725,41492752,HepG2|chr6:38672372-38672391,chr6,38672372,38672391,1,2820353
HepG2|chr6:42719623-42719770,chr6,42719623,42719770,HepG2|chr6:42719425-42719575,chr6,42719425,42719575,1,198
HepG2|chr6:42719645-42719767,chr6,42719645,42719767,HepG2|chr6:42716563-42716709,chr6,42716563,42716709,1,3082
HepG2|chr6:42719712-42719782,chr6,42719712,42719782,HepG2|chr6:42719335-42719415,chr6,42719335,42719415,1,377
HepG2|chr6:42719712-42719781,chr6,42719712,42719781,HepG2|chr6:42719335-42719415,chr6,42719335,42719415,1,377
HepG2|chr6:43706552-43706643,chr6,43706552,43706643,HepG2|chr6:43734518-43734655,chr6,43734518,43734655,1,27966
HepG2|chr6:43723369-43723455,chr6,43723369,43723455,HepG2|chr6:43734687-43734739,chr6,43734687,43734739,1,11318
HepG2|chr6:43723406-43723455,chr6,43723406,43723455,HepG2|chr6:43735801-43735899,chr6,43735801,43735899,1,12395
HepG2|chr6:43727954-43728064,chr6,43727954,43728064,HepG2|chr6:43736676-43736716,chr6,43736676,43736716,1,8722
HepG2|chr6:44070673-44070725,chr6,44070673,44070725,HepG2|chr6:44094503-44094653,chr6,44094503,44094653,1,23830
HepG2|chr6:44070803-44070859,chr6,44070803,44070859,HepG2|chr6:44233631-44233654,chr6,44233631,44233654,1,162828
HepG2|chr6:44070804-44070861,chr6,44070804,44070861,HepG2|chr6:44233631-44233653,chr6,44233631,44233653,1,162827
HepG2|chr6:44070969-44071105,chr6,44070969,44071105,HepG2|chr6:44093104-44093144,chr6,44093104,44093144,1,22135
HepG2|chr6:44071040-44071105,chr6,44071040,44071105,HepG2|chr6:44093104-44093144,chr6,44093104,44093144,1,22064
HepG2|chr6:52176069-52176219,chr6,52176069,52176219,HepG2|chr6:52285006-52285026,chr6,52285006,52285026,1,108937
HepG2|chr6:52176117-52176247,chr6,52176117,52176247,HepG2|chr6:52285006-52285026,chr6,52285006,52285026,1,108889
HepG2|chr6:52176141-52176247,chr6,52176141,52176247,HepG2|chr6:52285006-52285047,chr6,52285006,52285047,1,108865
HepG2|chr6:52176214-52176247,chr6,52176214,52176247,HepG2|chr6:52285006-52285123,chr6,52285006,52285123,1,108792
HepG2|chr6:52238901-52239008,chr6,52238901,52239008,HepG2|chr6:52281735-52281776,chr6,52281735,52281776,1,42834
HepG2|chr6:52241650-52241800,chr6,52241650,52241800,HepG2|chr6:52281185-52281206,chr6,52281185,52281206,1,39535
HepG2|chr6:52241677-52241802,chr6,52241677,52241802,HepG2|chr6:52281185-52281206,chr6,52281185,52281206,1,39508
HepG2|chr6:52244097-52244212,chr6,52244097,52244212,HepG2|chr6:52284647-52284679,chr6,52284647,52284679,1,40550
HepG2|chr6:52257461-52257541,chr6,52257461,52257541,HepG2|chr6:52282785-52282845,chr6,52282785,52282845,1,25324
HepG2|chr6:52261586-52261713,chr6,52261586,52261713,HepG2|chr6:52281032-52281106,chr6,52281032,52281106,1,19446
HepG2|chr6:52261637-52261713,chr6,52261637,52261713,HepG2|chr6:52281032-52281106,chr6,52281032,52281106,1,19395
HepG2|chr6:80262816-80262966,chr6,80262816,80262966,HepG2|chr6:80250689-80250795,chr6,80250689,80250795,1,12127
HepG2|chr6:80262942-80262983,chr6,80262942,80262983,HepG2|chr6:80250689-80250795,chr6,80250689,80250795,1,12253
HepG2|chr6:80265249-80265338,chr6,80265249,80265338,HepG2|chr6:80248469-80248560,chr6,80248469,80248560,1,16780
HepG2|chr6:80268542-80268608,chr6,80268542,80268608,HepG2|chr6:80249791-80249935,chr6,80249791,80249935,1,18751
HepG2|chr6:80270417-80270509,chr6,80270417,80270509,HepG2|chr6:80251573-80251712,chr6,80251573,80251712,1,18844
HepG2|chr6:80270624-80270696,chr6,80270624,80270696,HepG2|chr6:80250900-80250975,chr6,80250900,80250975,1,19724
HepG2|chr6:80270628-80270710,chr6,80270628,80270710,HepG2|chr6:80250900-80250975,chr6,80250900,80250975,1,19728
HepG2|chr6:80271157-80271238,chr6,80271157,80271238,HepG2|chr6:80247477-80247500,chr6,80247477,80247500,1,23680
HepG2|chr6:80271162-80271238,chr6,80271162,80271238,HepG2|chr6:80247477-80247500,chr6,80247477,80247500,1,23685
HepG2|chr6:80271173-80271268,chr6,80271173,80271268,HepG2|chr6:80248491-80248560,chr6,80248491,80248560,1,22682
HepG2|chr6:80271173-80271254,chr6,80271173,80271254,HepG2|chr6:80248491-80248560,chr6,80248491,80248560,1,22682
HepG2|chr6:80278426-80278539,chr6,80278426,80278539,HepG2|chr6:80251765-80251789,chr6,80251765,80251789,1,26661
HepG2|chr6:80278426-80278537,chr6,80278426,80278537,HepG2|chr6:80251765-80251789,chr6,80251765,80251789,1,26661
HepG2|chr6:80281275-80281318,chr6,80281275,80281318,HepG2|chr6:80249508-80249567,chr6,80249508,80249567,1,31767
HepG2|chr6:88402553-88402574,chr6,88402553,88402574,HepG2|chr6:90351617-90351748,chr6,90351617,90351748,1,1949064
HepG2|chr6:89679932-89680022,chr6,89679932,89680022,HepG2|chr6:89673810-89673849,chr6,89673810,89673849,1,6122
HepG2|chr6:89690579-89690683,chr6,89690579,89690683,HepG2|chr6:89673796-89673849,chr6,89673796,89673849,1,16783
HepG2|chr6:89690579-89690670,chr6,89690579,89690670,HepG2|chr6:89673796-89673849,chr6,89673796,89673849,1,16783
HepG2|chr6:111289972-111290049,chr6,111289972,111290049,HepG2|chr6:111281690-111281787,chr6,111281690,111281787,1,8282
HepG2|chr6:111289972-111290048,chr6,111289972,111290048,HepG2|chr6:111281677-111281787,chr6,111281677,111281787,1,8295
HepG2|chr6:111289972-111290025,chr6,111289972,111290025,HepG2|chr6:111281690-111281787,chr6,111281690,111281787,1,8282
HepG2|chr6:111289972-111290011,chr6,111289972,111290011,HepG2|chr6:111281673-111281787,chr6,111281673,111281787,1,8299
HepG2|chr6:111289972-111290009,chr6,111289972,111290009,HepG2|chr6:111281677-111281787,chr6,111281677,111281787,1,8295
HepG2|chr6:111289972-111290008,chr6,111289972,111290008,HepG2|chr6:111281673-111281787,chr6,111281673,111281787,1,8299
HepG2|chr6:111290064-111290196,chr6,111290064,111290196,HepG2|chr6:111303094-111303147,chr6,111303094,111303147,1,13030
HepG2|chr6:111290074-111290119,chr6,111290074,111290119,HepG2|chr6:111301058-111301205,chr6,111301058,111301205,1,10984
HepG2|chr6:111290099-111290193,chr6,111290099,111290193,HepG2|chr6:111303094-111303147,chr6,111303094,111303147,1,12995
HepG2|chr6:111291786-111291847,chr6,111291786,111291847,HepG2|chr6:111300357-111300384,chr6,111300357,111300384,1,8571
HepG2|chr6:111291819-111291847,chr6,111291819,111291847,HepG2|chr6:111300357-111300384,chr6,111300357,111300384,1,8538
HepG2|chr6:111294233-111294333,chr6,111294233,111294333,HepG2|chr6:111300204-111300289,chr6,111300204,111300289,1,5971
HepG2|chr6:111294606-111294671,chr6,111294606,111294671,HepG2|chr6:111300204-111300289,chr6,111300204,111300289,1,5598
HepG2|chr6:111297466-111297547,chr6,111297466,111297547,HepG2|chr6:111299049-111299118,chr6,111299049,111299118,1,1583
HepG2|chr6:111297617-111297706,chr6,111297617,111297706,HepG2|chr6:111299049-111299118,chr6,111299049,111299118,1,1432
HepG2|chr6:111297685-111297789,chr6,111297685,111297789,HepG2|chr6:111300688-111300808,chr6,111300688,111300808,1,3003
HepG2|chr6:111297782-111297905,chr6,111297782,111297905,HepG2|chr6:111300674-111300703,chr6,111300674,111300703,1,2892
HepG2|chr6:111297784-111297905,chr6,111297784,111297905,HepG2|chr6:111300674-111300703,chr6,111300674,111300703,1,2890
HepG2|chr6:111297842-111297915,chr6,111297842,111297915,HepG2|chr6:111298197-111298347,chr6,111298197,111298347,1,355
HepG2|chr6:111297865-111297925,chr6,111297865,111297925,HepG2|chr6:111300557-111300707,chr6,111300557,111300707,1,2692
HepG2|chr6:116395255-116395323,chr6,116395255,116395323,HepG2|chr6:116416942-116417092,chr6,116416942,116417092,1,21687
HepG2|chr6:116397275-116397365,chr6,116397275,116397365,HepG2|chr6:116421654-116421797,chr6,116421654,116421797,1,24379
HepG2|chr6:116397277-116397365,chr6,116397277,116397365,HepG2|chr6:116421654-116421720,chr6,116421654,116421720,1,24377
HepG2|chr6:116397278-116397365,chr6,116397278,116397365,HepG2|chr6:116421654-116421696,chr6,116421654,116421696,1,24376
HepG2|chr6:116397281-116397365,chr6,116397281,116397365,HepG2|chr6:116421654-116421720,chr6,116421654,116421720,1,24373
HepG2|chr6:116397287-116397365,chr6,116397287,116397365,HepG2|chr6:116421689-116421839,chr6,116421689,116421839,1,24402
HepG2|chr6:116397291-116397365,chr6,116397291,116397365,HepG2|chr6:116421654-116421707,chr6,116421654,116421707,1,24363
HepG2|chr6:116397293-116397365,chr6,116397293,116397365,HepG2|chr6:116421654-116421766,chr6,116421654,116421766,1,24361
HepG2|chr6:116397294-116397365,chr6,116397294,116397365,HepG2|chr6:116421654-116421719,chr6,116421654,116421719,1,24360
HepG2|chr6:116397297-116397365,chr6,116397297,116397365,HepG2|chr6:116421654-116421736,chr6,116421654,116421736,1,24357
HepG2|chr6:116397298-116397365,chr6,116397298,116397365,HepG2|chr6:116421688-116421838,chr6,116421688,116421838,1,24390
HepG2|chr6:116397300-116397365,chr6,116397300,116397365,HepG2|chr6:116421654-116421742,chr6,116421654,116421742,1,24354
HepG2|chr6:116397318-116397365,chr6,116397318,116397365,HepG2|chr6:116421654-116421742,chr6,116421654,116421742,1,24336
HepG2|chr6:116397327-116397365,chr6,116397327,116397365,HepG2|chr6:116421654-116421766,chr6,116421654,116421766,1,24327
HepG2|chr6:116397337-116397365,chr6,116397337,116397365,HepG2|chr6:116421654-116421775,chr6,116421654,116421775,1,24317
HepG2|chr6:116397344-116397365,chr6,116397344,116397365,HepG2|chr6:116421688-116421838,chr6,116421688,116421838,1,24344
HepG2|chr6:116397572-116397652,chr6,116397572,116397652,HepG2|chr6:116418098-116418217,chr6,116418098,116418217,1,20526
HepG2|chr6:116398485-116398520,chr6,116398485,116398520,HepG2|chr6:116420311-116420461,chr6,116420311,116420461,1,21826
HepG2|chr7:1133475-1133597,chr7,1133475,1133597,HepG2|chr7:41744259-41744284,chr7,41744259,41744284,1,40610784
HepG2|chr7:1133544-1133680,chr7,1133544,1133680,HepG2|chr7:41744259-41744284,chr7,41744259,41744284,1,40610715
HepG2|chr7:1138713-1138863,chr7,1138713,1138863,HepG2|chr7:41744261-41744282,chr7,41744261,41744282,1,40605548
HepG2|chr7:5278901-5278977,chr7,5278901,5278977,HepG2|chr7:100426579-100426676,chr7,100426579,100426676,1,95147678
HepG2|chr7:5609246-5609351,chr7,5609246,5609351,HepG2|chr7:5607634-5607670,chr7,5607634,5607670,1,1612
HepG2|chr7:5609321-5609388,chr7,5609321,5609388,HepG2|chr7:5607634-5607670,chr7,5607634,5607670,1,1687
HepG2|chr7:5609341-5609388,chr7,5609341,5609388,HepG2|chr7:5607634-5607670,chr7,5607634,5607670,1,1707
HepG2|chr7:5620505-5620572,chr7,5620505,5620572,HepG2|chr7:5630351-5630434,chr7,5630351,5630434,1,9846
HepG2|chr7:5620518-5620668,chr7,5620518,5620668,HepG2|chr7:5630351-5630434,chr7,5630351,5630434,1,9833
HepG2|chr7:5623974-5624033,chr7,5623974,5624033,HepG2|chr7:5631330-5631469,chr7,5631330,5631469,1,7356
HepG2|chr7:5626143-5626218,chr7,5626143,5626218,HepG2|chr7:5631793-5631943,chr7,5631793,5631943,1,5650
HepG2|chr7:5626594-5626744,chr7,5626594,5626744,HepG2|chr7:5631709-5631765,chr7,5631709,5631765,1,5115
HepG2|chr7:5626760-5626854,chr7,5626760,5626854,HepG2|chr7:5631709-5631765,chr7,5631709,5631765,1,4949
HepG2|chr7:5626853-5626959,chr7,5626853,5626959,HepG2|chr7:5628358-5628396,chr7,5628358,5628396,1,1505
HepG2|chr7:6296075-6296146,chr7,6296075,6296146,HepG2|chr7:6519792-6519871,chr7,6519792,6519871,1,223717
HepG2|chr7:6769812-6769897,chr7,6769812,6769897,HepG2|chr7:6748596-6748670,chr7,6748596,6748670,1,21216
HepG2|chr7:6774935-6774957,chr7,6774935,6774957,HepG2|chr7:6748619-6748670,chr7,6748619,6748670,1,26316
HepG2|chr7:7260152-7260234,chr7,7260152,7260234,HepG2|chr7:23568908-23568960,chr7,23568908,23568960,1,16308756
HepG2|chr7:7260154-7260234,chr7,7260154,7260234,HepG2|chr7:23568908-23568960,chr7,23568908,23568960,1,16308754
HepG2|chr7:23359801-23359948,chr7,23359801,23359948,HepG2|chr7:100729415-100729539,chr7,100729415,100729539,1,77369614
HepG2|chr7:23359804-23359948,chr7,23359804,23359948,HepG2|chr7:100729415-100729539,chr7,100729415,100729539,1,77369611
HepG2|chr7:23479048-23479172,chr7,23479048,23479172,HepG2|chr7:41744259-41744282,chr7,41744259,41744282,1,18265211
HepG2|chr7:23479048-23479163,chr7,23479048,23479163,HepG2|chr7:41744259-41744282,chr7,41744259,41744282,1,18265211
HepG2|chr7:23479747-23479865,chr7,23479747,23479865,HepG2|chr7:41744259-41744279,chr7,41744259,41744279,1,18264512
HepG2|chr7:27653254-27653296,chr7,27653254,27653296,HepG2|chr7:45146281-45146366,chr7,45146281,45146366,1,17493027
HepG2|chr7:32770004-32770154,chr7,32770004,32770154,HepG2|chr7:30327055-30327205,chr7,30327055,30327205,1,2442949
HepG2|chr7:32770624-32770774,chr7,32770624,32770774,HepG2|chr7:30327602-30327752,chr7,30327602,30327752,1,2443022
HepG2|chr7:32770630-32770776,chr7,32770630,32770776,HepG2|chr7:30327451-30327498,chr7,30327451,30327498,1,2443179
HepG2|chr7:32770650-32770800,chr7,32770650,32770800,HepG2|chr7:30327601-30327751,chr7,30327601,30327751,1,2443049
HepG2|chr7:32770693-32770843,chr7,32770693,32770843,HepG2|chr7:30327602-30327752,chr7,30327602,30327752,1,2443091
HepG2|chr7:32772296-32772338,chr7,32772296,32772338,HepG2|chr7:29720624-29720697,chr7,29720624,29720697,1,3051672
HepG2|chr7:32772419-32772569,chr7,32772419,32772569,HepG2|chr7:29720495-29720641,chr7,29720495,29720641,1,3051924
HepG2|chr7:32772421-32772571,chr7,32772421,32772571,HepG2|chr7:29720567-29720716,chr7,29720567,29720716,1,3051854
HepG2|chr7:32772438-32772587,chr7,32772438,32772587,HepG2|chr7:29720482-29720631,chr7,29720482,29720631,1,3051956
HepG2|chr7:32772455-32772605,chr7,32772455,32772605,HepG2|chr7:29720491-29720638,chr7,29720491,29720638,1,3051964
HepG2|chr7:32772477-32772622,chr7,32772477,32772622,HepG2|chr7:29720482-29720631,chr7,29720482,29720631,1,3051995
HepG2|chr7:33031740-33031845,chr7,33031740,33031845,HepG2|chr7:41744259-41744282,chr7,41744259,41744282,1,8712519
HepG2|chr7:33031740-33031839,chr7,33031740,33031839,HepG2|chr7:41744259-41744282,chr7,41744259,41744282,1,8712519
HepG2|chr7:33031776-33031865,chr7,33031776,33031865,HepG2|chr7:41744259-41744282,chr7,41744259,41744282,1,8712483
HepG2|chr7:45054901-45054926,chr7,45054901,45054926,HepG2|chr7:44620961-44621111,chr7,44620961,44621111,1,433940
HepG2|chr7:55059320-55059366,chr7,55059320,55059366,HepG2|chr7:55087217-55087367,chr7,55087217,55087367,1,27897
HepG2|chr7:55062127-55062145,chr7,55062127,55062145,HepG2|chr7:55087142-55087255,chr7,55087142,55087255,1,25015
HepG2|chr7:55063039-55063105,chr7,55063039,55063105,HepG2|chr7:55087189-55087337,chr7,55087189,55087337,1,24150
HepG2|chr7:55063080-55063105,chr7,55063080,55063105,HepG2|chr7:55084253-55084370,chr7,55084253,55084370,1,21173
HepG2|chr7:55063760-55063787,chr7,55063760,55063787,HepG2|chr7:55084896-55085019,chr7,55084896,55085019,1,21136
HepG2|chr7:55121488-55121638,chr7,55121488,55121638,HepG2|chr7:73184787-73184807,chr7,73184787,73184807,1,18063299
HepG2|chr7:55121513-55121662,chr7,55121513,55121662,HepG2|chr7:73184787-73184807,chr7,73184787,73184807,1,18063274
HepG2|chr7:55121555-55121683,chr7,55121555,55121683,HepG2|chr7:73184787-73184807,chr7,73184787,73184807,1,18063232
HepG2|chr7:55121555-55121682,chr7,55121555,55121682,HepG2|chr7:73184787-73184807,chr7,73184787,73184807,1,18063232
HepG2|chr7:55121931-55122035,chr7,55121931,55122035,HepG2|chr7:44837502-44837574,chr7,44837502,44837574,1,10284429
HepG2|chr7:55121957-55122035,chr7,55121957,55122035,HepG2|chr7:44837502-44837574,chr7,44837502,44837574,1,10284455
HepG2|chr7:55134965-55135070,chr7,55134965,55135070,HepG2|chr7:44835404-44835549,chr7,44835404,44835549,1,10299561
HepG2|chr7:55249519-55249639,chr7,55249519,55249639,HepG2|chr7:41744259-41744282,chr7,41744259,41744282,1,13505260
HepG2|chr7:55249917-55249976,chr7,55249917,55249976,HepG2|chr7:54999980-55000071,chr7,54999980,55000071,1,249937
HepG2|chr7:55249918-55250002,chr7,55249918,55250002,HepG2|chr7:54999980-55000071,chr7,54999980,55000071,1,249938
HepG2|chr7:55252040-55252154,chr7,55252040,55252154,HepG2|chr7:55001042-55001160,chr7,55001042,55001160,1,250998
HepG2|chr7:55252122-55252154,chr7,55252122,55252154,HepG2|chr7:55001042-55001160,chr7,55001042,55001160,1,251080
HepG2|chr7:55255948-55256065,chr7,55255948,55256065,HepG2|chr7:41744259-41744282,chr7,41744259,41744282,1,13511689
HepG2|chr7:55257806-55257835,chr7,55257806,55257835,HepG2|chr7:41744259-41744282,chr7,41744259,41744282,1,13513547
HepG2|chr7:55257944-55258073,chr7,55257944,55258073,HepG2|chr7:41744261-41744282,chr7,41744261,41744282,1,13513683
HepG2|chr7:55258007-55258073,chr7,55258007,55258073,HepG2|chr7:41744259-41744282,chr7,41744259,41744282,1,13513748
HepG2|chr7:64498872-64499019,chr7,64498872,64499019,HepG2|chr7:65338717-65338798,chr7,65338717,65338798,1,839845
HepG2|chr7:64498880-64498952,chr7,64498880,64498952,HepG2|chr7:65338723-65338799,chr7,65338723,65338799,1,839843
HepG2|chr7:64498883-64499033,chr7,64498883,64499033,HepG2|chr7:65338717-65338776,chr7,65338717,65338776,1,839834
HepG2|chr7:64498886-64499033,chr7,64498886,64499033,HepG2|chr7:65338717-65338818,chr7,65338717,65338818,1,839831
HepG2|chr7:64498886-64498995,chr7,64498886,64498995,HepG2|chr7:65338719-65338818,chr7,65338719,65338818,1,839833
HepG2|chr7:64498894-64499033,chr7,64498894,64499033,HepG2|chr7:65338723-65338771,chr7,65338723,65338771,1,839829
HepG2|chr7:64498894-64499031,chr7,64498894,64499031,HepG2|chr7:65338716-65338834,chr7,65338716,65338834,1,839822
HepG2|chr7:64498914-64499064,chr7,64498914,64499064,HepG2|chr7:65338723-65338820,chr7,65338723,65338820,1,839809
HepG2|chr7:64498932-64499079,chr7,64498932,64499079,HepG2|chr7:65338722-65338763,chr7,65338722,65338763,1,839790
HepG2|chr7:64498965-64499115,chr7,64498965,64499115,HepG2|chr7:65338722-65338809,chr7,65338722,65338809,1,839757
HepG2|chr7:64498965-64499112,chr7,64498965,64499112,HepG2|chr7:65338732-65338788,chr7,65338732,65338788,1,839767
HepG2|chr7:64498965-64499024,chr7,64498965,64499024,HepG2|chr7:65338716-65338795,chr7,65338716,65338795,1,839751
HepG2|chr7:64498978-64499114,chr7,64498978,64499114,HepG2|chr7:65338719-65338806,chr7,65338719,65338806,1,839741
HepG2|chr7:64498997-64499147,chr7,64498997,64499147,HepG2|chr7:65338723-65338795,chr7,65338723,65338795,1,839726
HepG2|chr7:64499004-64499154,chr7,64499004,64499154,HepG2|chr7:65338721-65338784,chr7,65338721,65338784,1,839717
HepG2|chr7:64499004-64499150,chr7,64499004,64499150,HepG2|chr7:65338726-65338828,chr7,65338726,65338828,1,839722
HepG2|chr7:64499005-64499155,chr7,64499005,64499155,HepG2|chr7:65338723-65338792,chr7,65338723,65338792,1,839718
HepG2|chr7:64499008-64499156,chr7,64499008,64499156,HepG2|chr7:65338719-65338765,chr7,65338719,65338765,1,839711
HepG2|chr7:64499008-64499114,chr7,64499008,64499114,HepG2|chr7:65338723-65338811,chr7,65338723,65338811,1,839715
HepG2|chr7:64499011-64499161,chr7,64499011,64499161,HepG2|chr7:65338723-65338782,chr7,65338723,65338782,1,839712
HepG2|chr7:64499011-64499156,chr7,64499011,64499156,HepG2|chr7:65338723-65338782,chr7,65338723,65338782,1,839712
HepG2|chr7:64499012-64499156,chr7,64499012,64499156,HepG2|chr7:65338717-65338774,chr7,65338717,65338774,1,839705
HepG2|chr7:64499013-64499094,chr7,64499013,64499094,HepG2|chr7:65338722-65338797,chr7,65338722,65338797,1,839709
HepG2|chr7:64499047-64499197,chr7,64499047,64499197,HepG2|chr7:65338735-65338819,chr7,65338735,65338819,1,839688
HepG2|chr7:64525338-64525386,chr7,64525338,64525386,HepG2|chr7:56121928-56122072,chr7,56121928,56122072,1,8403410
HepG2|chr7:64525340-64525385,chr7,64525340,64525385,HepG2|chr7:56121918-56122023,chr7,56121918,56122023,1,8403422
HepG2|chr7:64525340-64525384,chr7,64525340,64525384,HepG2|chr7:56121943-56122023,chr7,56121943,56122023,1,8403397
HepG2|chr7:64525342-64525391,chr7,64525342,64525391,HepG2|chr7:56121918-56122023,chr7,56121918,56122023,1,8403424
HepG2|chr7:64525342-64525386,chr7,64525342,64525386,HepG2|chr7:56121883-56122025,chr7,56121883,56122025,1,8403459
HepG2|chr7:64525342-64525384,chr7,64525342,64525384,HepG2|chr7:56121943-56122023,chr7,56121943,56122023,1,8403399
HepG2|chr7:64525344-64525391,chr7,64525344,64525391,HepG2|chr7:56121928-56122028,chr7,56121928,56122028,1,8403416
HepG2|chr7:64525344-64525387,chr7,64525344,64525387,HepG2|chr7:56121928-56122028,chr7,56121928,56122028,1,8403416
HepG2|chr7:64525345-64525386,chr7,64525345,64525386,HepG2|chr7:56121979-56122029,chr7,56121979,56122029,1,8403366
HepG2|chr7:64525345-64525384,chr7,64525345,64525384,HepG2|chr7:56121918-56122029,chr7,56121918,56122029,1,8403427
HepG2|chr7:64525346-64525385,chr7,64525346,64525385,HepG2|chr7:56121918-56122029,chr7,56121918,56122029,1,8403428
HepG2|chr7:64525348-64525386,chr7,64525348,64525386,HepG2|chr7:56121918-56122029,chr7,56121918,56122029,1,8403430
HepG2|chr7:64844490-64844582,chr7,64844490,64844582,HepG2|chr7:41744259-41744282,chr7,41744259,41744282,1,23100231
HepG2|chr7:64845946-64846075,chr7,64845946,64846075,HepG2|chr7:41744259-41744277,chr7,41744259,41744277,1,23101687
HepG2|chr7:65261548-65261639,chr7,65261548,65261639,HepG2|chr7:45810486-45810545,chr7,45810486,45810545,1,19451062
HepG2|chr7:65261548-65261626,chr7,65261548,65261626,HepG2|chr7:45810476-45810545,chr7,45810476,45810545,1,19451072
HepG2|chr7:65263990-65264114,chr7,65263990,65264114,HepG2|chr7:98741137-98741163,chr7,98741137,98741163,1,33477147
HepG2|chr7:65265232-65265321,chr7,65265232,65265321,HepG2|chr7:45810481-45810542,chr7,45810481,45810542,1,19454751
HepG2|chr7:65265232-65265318,chr7,65265232,65265318,HepG2|chr7:45810486-45810542,chr7,45810486,45810542,1,19454746
HepG2|chr7:65265232-65265313,chr7,65265232,65265313,HepG2|chr7:45810479-45810542,chr7,45810479,45810542,1,19454753
HepG2|chr7:72569046-72569196,chr7,72569046,72569196,HepG2|chr7:74867511-74867661,chr7,74867511,74867661,1,2298465
HepG2|chr7:72569046-72569195,chr7,72569046,72569195,HepG2|chr7:74867492-74867623,chr7,74867492,74867623,1,2298446
HepG2|chr7:72569046-72569194,chr7,72569046,72569194,HepG2|chr7:74867472-74867622,chr7,74867472,74867622,1,2298426
HepG2|chr7:72569046-72569189,chr7,72569046,72569189,HepG2|chr7:74867480-74867630,chr7,74867480,74867630,1,2298434
HepG2|chr7:72569047-72569197,chr7,72569047,72569197,HepG2|chr7:74867504-74867630,chr7,74867504,74867630,1,2298457
HepG2|chr7:72569048-72569198,chr7,72569048,72569198,HepG2|chr7:74867484-74867631,chr7,74867484,74867631,1,2298436
HepG2|chr7:72569048-72569197,chr7,72569048,72569197,HepG2|chr7:74867470-74867620,chr7,74867470,74867620,1,2298422
HepG2|chr7:72569048-72569194,chr7,72569048,72569194,HepG2|chr7:74867479-74867629,chr7,74867479,74867629,1,2298431
HepG2|chr7:72569048-72569189,chr7,72569048,72569189,HepG2|chr7:74867489-74867622,chr7,74867489,74867622,1,2298441
HepG2|chr7:72569048-72569188,chr7,72569048,72569188,HepG2|chr7:74867471-74867620,chr7,74867471,74867620,1,2298423
HepG2|chr7:72569048-72569177,chr7,72569048,72569177,HepG2|chr7:74867491-74867641,chr7,74867491,74867641,1,2298443
HepG2|chr7:72569048-72569158,chr7,72569048,72569158,HepG2|chr7:74867501-74867619,chr7,74867501,74867619,1,2298453
HepG2|chr7:72569049-72569199,chr7,72569049,72569199,HepG2|chr7:74867473-74867623,chr7,74867473,74867623,1,2298424
HepG2|chr7:72569049-72569198,chr7,72569049,72569198,HepG2|chr7:74867470-74867619,chr7,74867470,74867619,1,2298421
HepG2|chr7:72569049-72569196,chr7,72569049,72569196,HepG2|chr7:74867472-74867622,chr7,74867472,74867622,1,2298423
HepG2|chr7:72569049-72569193,chr7,72569049,72569193,HepG2|chr7:74867491-74867641,chr7,74867491,74867641,1,2298442
HepG2|chr7:72569049-72569162,chr7,72569049,72569162,HepG2|chr7:74867497-74867621,chr7,74867497,74867621,1,2298448
HepG2|chr7:72569050-72569200,chr7,72569050,72569200,HepG2|chr7:74867569-74867618,chr7,74867569,74867618,1,2298519
HepG2|chr7:72569050-72569199,chr7,72569050,72569199,HepG2|chr7:74867472-74867622,chr7,74867472,74867622,1,2298422
HepG2|chr7:72569052-72569202,chr7,72569052,72569202,HepG2|chr7:74867472-74867622,chr7,74867472,74867622,1,2298420
HepG2|chr7:72569055-72569205,chr7,72569055,72569205,HepG2|chr7:74867480-74867630,chr7,74867480,74867630,1,2298425
HepG2|chr7:72569056-72569204,chr7,72569056,72569204,HepG2|chr7:74867578-74867629,chr7,74867578,74867629,1,2298522
HepG2|chr7:72569056-72569201,chr7,72569056,72569201,HepG2|chr7:74867484-74867630,chr7,74867484,74867630,1,2298428
HepG2|chr7:72569057-72569207,chr7,72569057,72569207,HepG2|chr7:74867484-74867630,chr7,74867484,74867630,1,2298427
HepG2|chr7:72569057-72569201,chr7,72569057,72569201,HepG2|chr7:74867484-74867631,chr7,74867484,74867631,1,2298427
HepG2|chr7:72569058-72569208,chr7,72569058,72569208,HepG2|chr7:74867473-74867622,chr7,74867473,74867622,1,2298415
HepG2|chr7:72569062-72569196,chr7,72569062,72569196,HepG2|chr7:74867506-74867621,chr7,74867506,74867621,1,2298444
HepG2|chr7:72569081-72569231,chr7,72569081,72569231,HepG2|chr7:74867480-74867630,chr7,74867480,74867630,1,2298399
HepG2|chr7:72569088-72569188,chr7,72569088,72569188,HepG2|chr7:74867472-74867622,chr7,74867472,74867622,1,2298384
HepG2|chr7:72569093-72569243,chr7,72569093,72569243,HepG2|chr7:74867470-74867620,chr7,74867470,74867620,1,2298377
HepG2|chr7:72569097-72569247,chr7,72569097,72569247,HepG2|chr7:74867471-74867621,chr7,74867471,74867621,1,2298374
HepG2|chr7:72569099-72569153,chr7,72569099,72569153,HepG2|chr7:74867506-74867646,chr7,74867506,74867646,1,2298407
HepG2|chr7:72824217-72824344,chr7,72824217,72824344,HepG2|chr7:72460117-72460230,chr7,72460117,72460230,1,364100
HepG2|chr7:72824249-72824344,chr7,72824249,72824344,HepG2|chr7:72460119-72460257,chr7,72460119,72460257,1,364130
HepG2|chr7:72824260-72824343,chr7,72824260,72824343,HepG2|chr7:72460119-72460239,chr7,72460119,72460239,1,364141
HepG2|chr7:73692489-73692554,chr7,73692489,73692554,HepG2|chr7:72726255-72726321,chr7,72726255,72726321,1,966234
HepG2|chr7:73692489-73692547,chr7,73692489,73692547,HepG2|chr7:72726255-72726321,chr7,72726255,72726321,1,966234
HepG2|chr7:73692489-73692524,chr7,73692489,73692524,HepG2|chr7:72726255-72726321,chr7,72726255,72726321,1,966234
HepG2|chr7:73990765-73990813,chr7,73990765,73990813,HepG2|chr7:74311337-74311386,chr7,74311337,74311386,1,320572
HepG2|chr7:73990787-73990837,chr7,73990787,73990837,HepG2|chr7:74311328-74311385,chr7,74311328,74311385,1,320541
HepG2|chr7:74290323-74290387,chr7,74290323,74290387,HepG2|chr7:75004675-75004811,chr7,75004675,75004811,1,714352
HepG2|chr7:74290387-74290466,chr7,74290387,74290466,HepG2|chr7:75004749-75004869,chr7,75004749,75004869,1,714362
HepG2|chr7:74291076-74291226,chr7,74291076,74291226,HepG2|chr7:72460886-72461036,chr7,72460886,72461036,1,1830190
HepG2|chr7:74291102-74291252,chr7,74291102,74291252,HepG2|chr7:72460964-72461058,chr7,72460964,72461058,1,1830138
HepG2|chr7:74291102-74291246,chr7,74291102,74291246,HepG2|chr7:72460900-72461002,chr7,72460900,72461002,1,1830202
HepG2|chr7:74302319-74302448,chr7,74302319,74302448,HepG2|chr7:99937962-99938105,chr7,99937962,99938105,1,25635643
HepG2|chr7:74305107-74305186,chr7,74305107,74305186,HepG2|chr7:99934928-99935054,chr7,99934928,99935054,1,25629821
HepG2|chr7:74305255-74305405,chr7,74305255,74305405,HepG2|chr7:99934867-99935013,chr7,99934867,99935013,1,25629612
HepG2|chr7:74305338-74305488,chr7,74305338,74305488,HepG2|chr7:99934671-99934731,chr7,99934671,99934731,1,25629333
HepG2|chr7:74305479-74305623,chr7,74305479,74305623,HepG2|chr7:99934603-99934702,chr7,99934603,99934702,1,25629124
HepG2|chr7:74305486-74305623,chr7,74305486,74305623,HepG2|chr7:99934669-99934819,chr7,99934669,99934819,1,25629183
HepG2|chr7:74305489-74305623,chr7,74305489,74305623,HepG2|chr7:99934636-99934786,chr7,99934636,99934786,1,25629147
HepG2|chr7:74305501-74305651,chr7,74305501,74305651,HepG2|chr7:99934693-99934837,chr7,99934693,99934837,1,25629192
HepG2|chr7:74305513-74305651,chr7,74305513,74305651,HepG2|chr7:99934693-99934825,chr7,99934693,99934825,1,25629180
HepG2|chr7:74305517-74305666,chr7,74305517,74305666,HepG2|chr7:99934799-99934923,chr7,99934799,99934923,1,25629282
HepG2|chr7:74305517-74305639,chr7,74305517,74305639,HepG2|chr7:99934497-99934644,chr7,99934497,99934644,1,25628980
HepG2|chr7:74305524-74305623,chr7,74305524,74305623,HepG2|chr7:99934670-99934819,chr7,99934670,99934819,1,25629146
HepG2|chr7:74305530-74305680,chr7,74305530,74305680,HepG2|chr7:99934693-99934829,chr7,99934693,99934829,1,25629163
HepG2|chr7:74305534-74305632,chr7,74305534,74305632,HepG2|chr7:99934693-99934821,chr7,99934693,99934821,1,25629159
HepG2|chr7:74305543-74305667,chr7,74305543,74305667,HepG2|chr7:99934693-99934826,chr7,99934693,99934826,1,25629150
HepG2|chr7:74305549-74305699,chr7,74305549,74305699,HepG2|chr7:99934693-99934823,chr7,99934693,99934823,1,25629144
HepG2|chr7:74305549-74305639,chr7,74305549,74305639,HepG2|chr7:99934693-99934839,chr7,99934693,99934839,1,25629144
HepG2|chr7:74305553-74305703,chr7,74305553,74305703,HepG2|chr7:99934693-99934827,chr7,99934693,99934827,1,25629140
HepG2|chr7:74305553-74305639,chr7,74305553,74305639,HepG2|chr7:99934513-99934663,chr7,99934513,99934663,1,25628960
HepG2|chr7:74305565-74305644,chr7,74305565,74305644,HepG2|chr7:99934718-99934868,chr7,99934718,99934868,1,25629153
HepG2|chr7:74305566-74305661,chr7,74305566,74305661,HepG2|chr7:99934781-99934929,chr7,99934781,99934929,1,25629215
HepG2|chr7:74305568-74305714,chr7,74305568,74305714,HepG2|chr7:99934693-99934839,chr7,99934693,99934839,1,25629125
HepG2|chr7:74305621-74305735,chr7,74305621,74305735,HepG2|chr7:99934671-99934821,chr7,99934671,99934821,1,25629050
HepG2|chr7:74305621-74305729,chr7,74305621,74305729,HepG2|chr7:99934766-99934916,chr7,99934766,99934916,1,25629145
HepG2|chr7:74305623-74305758,chr7,74305623,74305758,HepG2|chr7:99934709-99934854,chr7,99934709,99934854,1,25629086
HepG2|chr7:74305623-74305732,chr7,74305623,74305732,HepG2|chr7:99934670-99934820,chr7,99934670,99934820,1,25629047
HepG2|chr7:74305624-74305765,chr7,74305624,74305765,HepG2|chr7:99934693-99934835,chr7,99934693,99934835,1,25629069
HepG2|chr7:74305624-74305758,chr7,74305624,74305758,HepG2|chr7:99934653-99934803,chr7,99934653,99934803,1,25629029
HepG2|chr7:74305624-74305740,chr7,74305624,74305740,HepG2|chr7:99934693-99934837,chr7,99934693,99934837,1,25629069
HepG2|chr7:74305624-74305735,chr7,74305624,74305735,HepG2|chr7:99934710-99934860,chr7,99934710,99934860,1,25629086
HepG2|chr7:74305625-74305765,chr7,74305625,74305765,HepG2|chr7:99934693-99934835,chr7,99934693,99934835,1,25629068
HepG2|chr7:74305626-74305770,chr7,74305626,74305770,HepG2|chr7:99934693-99934837,chr7,99934693,99934837,1,25629067
HepG2|chr7:74305627-74305729,chr7,74305627,74305729,HepG2|chr7:99934709-99934854,chr7,99934709,99934854,1,25629082
HepG2|chr7:74305639-74305773,chr7,74305639,74305773,HepG2|chr7:99934693-99934831,chr7,99934693,99934831,1,25629054
HepG2|chr7:74305641-74305780,chr7,74305641,74305780,HepG2|chr7:99934693-99934827,chr7,99934693,99934827,1,25629052
HepG2|chr7:74305641-74305778,chr7,74305641,74305778,HepG2|chr7:99934607-99934757,chr7,99934607,99934757,1,25628966
HepG2|chr7:74305641-74305755,chr7,74305641,74305755,HepG2|chr7:99934693-99934832,chr7,99934693,99934832,1,25629052
HepG2|chr7:74305641-74305732,chr7,74305641,74305732,HepG2|chr7:99934670-99934820,chr7,99934670,99934820,1,25629029
HepG2|chr7:74305643-74305761,chr7,74305643,74305761,HepG2|chr7:99934693-99934823,chr7,99934693,99934823,1,25629050
HepG2|chr7:74305644-74305793,chr7,74305644,74305793,HepG2|chr7:99934693-99934808,chr7,99934693,99934808,1,25629049
HepG2|chr7:74305649-74305735,chr7,74305649,74305735,HepG2|chr7:99934707-99934831,chr7,99934707,99934831,1,25629058
HepG2|chr7:74305664-74305793,chr7,74305664,74305793,HepG2|chr7:99934693-99934835,chr7,99934693,99934835,1,25629029
HepG2|chr7:74305668-74305793,chr7,74305668,74305793,HepG2|chr7:99934492-99934621,chr7,99934492,99934621,1,25628824
HepG2|chr7:74305672-74305793,chr7,74305672,74305793,HepG2|chr7:99934404-99934440,chr7,99934404,99934440,1,25628732
HepG2|chr7:74305677-74305793,chr7,74305677,74305793,HepG2|chr7:99934499-99934621,chr7,99934499,99934621,1,25628822
HepG2|chr7:74305681-74305829,chr7,74305681,74305829,HepG2|chr7:99934671-99934821,chr7,99934671,99934821,1,25628990
HepG2|chr7:74650407-74650555,chr7,74650407,74650555,HepG2|chr7:74381641-74381680,chr7,74381641,74381680,1,268766
HepG2|chr7:74650419-74650566,chr7,74650419,74650566,HepG2|chr7:74381609-74381682,chr7,74381609,74381682,1,268810
HepG2|chr7:74650420-74650570,chr7,74650420,74650570,HepG2|chr7:74381633-74381680,chr7,74381633,74381680,1,268787
HepG2|chr7:74650422-74650571,chr7,74650422,74650571,HepG2|chr7:74381648-74381711,chr7,74381648,74381711,1,268774
HepG2|chr7:74650430-74650557,chr7,74650430,74650557,HepG2|chr7:74381618-74381680,chr7,74381618,74381680,1,268812
HepG2|chr7:74650550-74650699,chr7,74650550,74650699,HepG2|chr7:74381675-74381712,chr7,74381675,74381712,1,268875
HepG2|chr7:74650648-74650798,chr7,74650648,74650798,HepG2|chr7:74381490-74381640,chr7,74381490,74381640,1,269158
HepG2|chr7:74652178-74652287,chr7,74652178,74652287,HepG2|chr7:74866388-74866538,chr7,74866388,74866538,1,214210
HepG2|chr7:74652179-74652284,chr7,74652179,74652284,HepG2|chr7:74866416-74866566,chr7,74866416,74866566,1,214237
HepG2|chr7:74652183-74652292,chr7,74652183,74652292,HepG2|chr7:74866388-74866480,chr7,74866388,74866480,1,214205
HepG2|chr7:74652185-74652266,chr7,74652185,74652266,HepG2|chr7:74866409-74866505,chr7,74866409,74866505,1,214224
HepG2|chr7:74652187-74652285,chr7,74652187,74652285,HepG2|chr7:74866412-74866562,chr7,74866412,74866562,1,214225
HepG2|chr7:74652189-74652286,chr7,74652189,74652286,HepG2|chr7:74379940-74380047,chr7,74379940,74380047,1,272249
HepG2|chr7:74652212-74652286,chr7,74652212,74652286,HepG2|chr7:74866405-74866537,chr7,74866405,74866537,1,214193
HepG2|chr7:74988536-74988686,chr7,74988536,74988686,HepG2|chr7:41744259-41744277,chr7,41744259,41744277,1,33244277
HepG2|chr7:74988536-74988624,chr7,74988536,74988624,HepG2|chr7:41744259-41744277,chr7,41744259,41744277,1,33244277
HepG2|chr7:74988578-74988707,chr7,74988578,74988707,HepG2|chr7:41744259-41744277,chr7,41744259,41744277,1,33244319
HepG2|chr7:75155741-75155891,chr7,75155741,75155891,HepG2|chr7:75113932-75113980,chr7,75113932,75113980,1,41809
HepG2|chr7:75156547-75156627,chr7,75156547,75156627,HepG2|chr7:75114831-75114901,chr7,75114831,75114901,1,41716
HepG2|chr7:75156633-75156689,chr7,75156633,75156689,HepG2|chr7:75114794-75114934,chr7,75114794,75114934,1,41839
HepG2|chr7:75268131-75268158,chr7,75268131,75268158,HepG2|chr7:41744259-41744283,chr7,41744259,41744283,1,33523872
HepG2|chr7:75268132-75268158,chr7,75268132,75268158,HepG2|chr7:41744259-41744283,chr7,41744259,41744283,1,33523873
HepG2|chr7:75268136-75268159,chr7,75268136,75268159,HepG2|chr7:41744259-41744282,chr7,41744259,41744282,1,33523877
HepG2|chr7:75268137-75268159,chr7,75268137,75268159,HepG2|chr7:41744259-41744282,chr7,41744259,41744282,1,33523878
HepG2|chr7:75732997-75733052,chr7,75732997,75733052,HepG2|chr7:75799215-75799310,chr7,75799215,75799310,1,66218
HepG2|chr7:75733000-75733091,chr7,75733000,75733091,HepG2|chr7:75799258-75799335,chr7,75799258,75799335,1,66258
HepG2|chr7:75733018-75733091,chr7,75733018,75733091,HepG2|chr7:75799258-75799335,chr7,75799258,75799335,1,66240
HepG2|chr7:75921359-75921481,chr7,75921359,75921481,HepG2|chr7:75931687-75931728,chr7,75931687,75931728,1,10328
HepG2|chr7:75921373-75921481,chr7,75921373,75921481,HepG2|chr7:75931687-75931728,chr7,75931687,75931728,1,10314
HepG2|chr7:75921378-75921481,chr7,75921378,75921481,HepG2|chr7:75928009-75928045,chr7,75928009,75928045,1,6631
HepG2|chr7:75922701-75922792,chr7,75922701,75922792,HepG2|chr7:75930698-75930797,chr7,75930698,75930797,1,7997
HepG2|chr7:75922741-75922792,chr7,75922741,75922792,HepG2|chr7:75930698-75930797,chr7,75930698,75930797,1,7957
HepG2|chr7:76178992-76179142,chr7,76178992,76179142,HepG2|chr7:102004842-102004992,chr7,102004842,102004992,1,25825850
HepG2|chr7:76179002-76179151,chr7,76179002,76179151,HepG2|chr7:102004837-102004987,chr7,102004837,102004987,1,25825835
HepG2|chr7:76179084-76179234,chr7,76179084,76179234,HepG2|chr7:102004838-102004988,chr7,102004838,102004988,1,25825754
HepG2|chr7:76179089-76179239,chr7,76179089,76179239,HepG2|chr7:102004837-102004987,chr7,102004837,102004987,1,25825748
HepG2|chr7:76179089-76179234,chr7,76179089,76179234,HepG2|chr7:102004837-102004987,chr7,102004837,102004987,1,25825748
HepG2|chr7:76179090-76179233,chr7,76179090,76179233,HepG2|chr7:102004837-102004987,chr7,102004837,102004987,1,25825747
HepG2|chr7:76179092-76179129,chr7,76179092,76179129,HepG2|chr7:102004837-102004987,chr7,102004837,102004987,1,25825745
HepG2|chr7:76179128-76179275,chr7,76179128,76179275,HepG2|chr7:102004890-102004987,chr7,102004890,102004987,1,25825762
HepG2|chr7:76179153-76179244,chr7,76179153,76179244,HepG2|chr7:102004840-102004990,chr7,102004840,102004990,1,25825687
HepG2|chr7:76180255-76180374,chr7,76180255,76180374,HepG2|chr7:75113905-75113963,chr7,75113905,75113963,1,1066350
HepG2|chr7:76180256-76180353,chr7,76180256,76180353,HepG2|chr7:75113873-75114020,chr7,75113873,75114020,1,1066383
HepG2|chr7:76180262-76180374,chr7,76180262,76180374,HepG2|chr7:72351543-72351671,chr7,72351543,72351671,1,3828719
HepG2|chr7:76180263-76180374,chr7,76180263,76180374,HepG2|chr7:72351631-72351733,chr7,72351631,72351733,1,3828632
HepG2|chr7:76180272-76180349,chr7,76180272,76180349,HepG2|chr7:75113875-75113962,chr7,75113875,75113962,1,1066397
HepG2|chr7:76180322-76180374,chr7,76180322,76180374,HepG2|chr7:72351633-72351730,chr7,72351633,72351730,1,3828689
HepG2|chr7:76180348-76180445,chr7,76180348,76180445,HepG2|chr7:102005966-102006035,chr7,102005966,102006035,1,25825618
HepG2|chr7:76180441-76180565,chr7,76180441,76180565,HepG2|chr7:75113936-75113985,chr7,75113936,75113985,1,1066505
HepG2|chr7:76589270-76589409,chr7,76589270,76589409,HepG2|chr7:76091157-76091296,chr7,76091157,76091296,1,498113
HepG2|chr7:76589284-76589430,chr7,76589284,76589430,HepG2|chr7:76091147-76091297,chr7,76091147,76091297,1,498137
HepG2|chr7:76589314-76589430,chr7,76589314,76589430,HepG2|chr7:76091083-76091232,chr7,76091083,76091232,1,498231
HepG2|chr7:76589315-76589367,chr7,76589315,76589367,HepG2|chr7:76091162-76091253,chr7,76091162,76091253,1,498153
HepG2|chr7:77144636-77144747,chr7,77144636,77144747,HepG2|chr7:77163525-77163631,chr7,77163525,77163631,1,18889
HepG2|chr7:77144704-77144747,chr7,77144704,77144747,HepG2|chr7:77163525-77163631,chr7,77163525,77163631,1,18821
HepG2|chr7:77144743-77144806,chr7,77144743,77144806,HepG2|chr7:77163525-77163579,chr7,77163525,77163579,1,18782
HepG2|chr7:92484222-92484304,chr7,92484222,92484304,HepG2|chr7:92465723-92465787,chr7,92465723,92465787,1,18499
HepG2|chr7:92484222-92484301,chr7,92484222,92484301,HepG2|chr7:92465699-92465737,chr7,92465699,92465737,1,18523
HepG2|chr7:94656027-94656177,chr7,94656027,94656177,HepG2|chr7:41744259-41744285,chr7,41744259,41744285,1,52911768
HepG2|chr7:94656112-94656233,chr7,94656112,94656233,HepG2|chr7:41744259-41744285,chr7,41744259,41744285,1,52911853
HepG2|chr7:97600535-97600663,chr7,97600535,97600663,HepG2|chr7:6864858-6864902,chr7,6864858,6864902,1,90735677
HepG2|chr7:97603614-97603688,chr7,97603614,97603688,HepG2|chr7:6867818-6867939,chr7,6867818,6867939,1,90735796
HepG2|chr7:99732746-99732896,chr7,99732746,99732896,HepG2|chr7:99744593-99744686,chr7,99744593,99744686,1,11847
HepG2|chr7:99732872-99732929,chr7,99732872,99732929,HepG2|chr7:99744593-99744686,chr7,99744593,99744686,1,11721
HepG2|chr7:99737923-99738062,chr7,99737923,99738062,HepG2|chr7:99746471-99746535,chr7,99746471,99746535,1,8548
HepG2|chr7:99737980-99738062,chr7,99737980,99738062,HepG2|chr7:99746471-99746535,chr7,99746471,99746535,1,8491
HepG2|chr7:99738182-99738203,chr7,99738182,99738203,HepG2|chr7:99746271-99746416,chr7,99746271,99746416,1,8089
HepG2|chr7:100161749-100161899,chr7,100161749,100161899,HepG2|chr7:75618047-75618100,chr7,75618047,75618100,1,24543702
HepG2|chr7:100161878-100161975,chr7,100161878,100161975,HepG2|chr7:75618047-75618100,chr7,75618047,75618100,1,24543831
HepG2|chr7:100438174-100438313,chr7,100438174,100438313,HepG2|chr7:102794472-102794507,chr7,102794472,102794507,1,2356298
HepG2|chr7:100438176-100438291,chr7,100438176,100438291,HepG2|chr7:102794472-102794507,chr7,102794472,102794507,1,2356296
HepG2|chr7:100438304-100438325,chr7,100438304,100438325,HepG2|chr7:102794366-102794495,chr7,102794366,102794495,1,2356062
HepG2|chr7:102147975-102148122,chr7,102147975,102148122,HepG2|chr7:102247028-102247178,chr7,102247028,102247178,1,99053
HepG2|chr7:102151117-102151267,chr7,102151117,102151267,HepG2|chr7:102251004-102251128,chr7,102251004,102251128,1,99887
HepG2|chr7:102151118-102151267,chr7,102151118,102151267,HepG2|chr7:102251004-102251128,chr7,102251004,102251128,1,99886
HepG2|chr7:121878534-121878677,chr7,121878534,121878677,HepG2|chr7:121788281-121788303,chr7,121788281,121788303,1,90253
HepG2|chr7:121878535-121878660,chr7,121878535,121878660,HepG2|chr7:121788282-121788303,chr7,121788282,121788303,1,90253
HepG2|chr7:121878535-121878633,chr7,121878535,121878633,HepG2|chr7:121788033-121788182,chr7,121788033,121788182,1,90502
HepG2|chr7:121878535-121878599,chr7,121878535,121878599,HepG2|chr7:121788102-121788249,chr7,121788102,121788249,1,90433
HepG2|chr7:121878535-121878589,chr7,121878535,121878589,HepG2|chr7:121788101-121788251,chr7,121788101,121788251,1,90434
HepG2|chr7:121878535-121878574,chr7,121878535,121878574,HepG2|chr7:121786659-121786712,chr7,121786659,121786712,1,91876
HepG2|chr7:121878535-121878556,chr7,121878535,121878556,HepG2|chr7:121788175-121788303,chr7,121788175,121788303,1,90360
HepG2|chr7:127643541-127643667,chr7,127643541,127643667,HepG2|chr7:41744259-41744280,chr7,41744259,41744280,1,85899282
HepG2|chr7:127648590-127648719,chr7,127648590,127648719,HepG2|chr7:41744259-41744277,chr7,41744259,41744277,1,85904331
HepG2|chr7:130607930-130607952,chr7,130607930,130607952,HepG2|chr7:130794056-130794206,chr7,130794056,130794206,1,186126
HepG2|chr7:131048164-131048314,chr7,131048164,131048314,HepG2|chr7:101461730-101461776,chr7,101461730,101461776,1,29586434
HepG2|chr7:131048164-131048213,chr7,131048164,131048213,HepG2|chr7:101461730-101461776,chr7,101461730,101461776,1,29586434
HepG2|chr7:131048248-131048352,chr7,131048248,131048352,HepG2|chr7:101461730-101461776,chr7,101461730,101461776,1,29586518
HepG2|chr7:134860553-134860703,chr7,134860553,134860703,HepG2|chr7:134860406-134860556,chr7,134860406,134860556,1,147
HepG2|chr7:134860557-134860647,chr7,134860557,134860647,HepG2|chr7:134860441-134860556,chr7,134860441,134860556,1,116
HepG2|chr7:134860557-134860592,chr7,134860557,134860592,HepG2|chr7:134860441-134860556,chr7,134860441,134860556,1,116
HepG2|chr7:134860558-134860672,chr7,134860558,134860672,HepG2|chr7:134860400-134860547,chr7,134860400,134860547,1,158
HepG2|chr7:134860571-134860647,chr7,134860571,134860647,HepG2|chr7:134860442-134860569,chr7,134860442,134860569,1,129
HepG2|chr7:134860571-134860594,chr7,134860571,134860594,HepG2|chr7:134860442-134860569,chr7,134860442,134860569,1,129
HepG2|chr7:134860607-134860643,chr7,134860607,134860643,HepG2|chr7:134860435-134860556,chr7,134860435,134860556,1,172
HepG2|chr7:134860609-134860759,chr7,134860609,134860759,HepG2|chr7:134860485-134860558,chr7,134860485,134860558,1,124
HepG2|chr7:134860652-134860802,chr7,134860652,134860802,HepG2|chr7:134860412-134860556,chr7,134860412,134860556,1,240
HepG2|chr7:134860666-134860710,chr7,134860666,134860710,HepG2|chr7:134860418-134860565,chr7,134860418,134860565,1,248
HepG2|chr7:134860890-134860945,chr7,134860890,134860945,HepG2|chr7:134859232-134859304,chr7,134859232,134859304,1,1658
HepG2|chr7:134860905-134861055,chr7,134860905,134861055,HepG2|chr7:134860410-134860438,chr7,134860410,134860438,1,495
HepG2|chr7:134860997-134861119,chr7,134860997,134861119,HepG2|chr7:134860410-134860438,chr7,134860410,134860438,1,587
HepG2|chr7:134861060-134861195,chr7,134861060,134861195,HepG2|chr7:134860126-134860276,chr7,134860126,134860276,1,934
HepG2|chr7:134861149-134861230,chr7,134861149,134861230,HepG2|chr7:134859765-134859838,chr7,134859765,134859838,1,1384
HepG2|chr7:134861149-134861226,chr7,134861149,134861226,HepG2|chr7:134859765-134859838,chr7,134859765,134859838,1,1384
HepG2|chr7:134861412-134861478,chr7,134861412,134861478,HepG2|chr7:134857653-134857777,chr7,134857653,134857777,1,3759
HepG2|chr7:134861412-134861437,chr7,134861412,134861437,HepG2|chr7:134857653-134857777,chr7,134857653,134857777,1,3759
HepG2|chr7:134861763-134861878,chr7,134861763,134861878,HepG2|chr7:134860375-134860406,chr7,134860375,134860406,1,1388
HepG2|chr7:134862137-134862225,chr7,134862137,134862225,HepG2|chr7:134857182-134857222,chr7,134857182,134857222,1,4955
HepG2|chr7:140013483-140013553,chr7,140013483,140013553,HepG2|chr7:139767737-139767809,chr7,139767737,139767809,1,245746
HepG2|chr7:140013483-140013552,chr7,140013483,140013552,HepG2|chr7:139767737-139767809,chr7,139767737,139767809,1,245746
HepG2|chr7:149983085-149983159,chr7,149983085,149983159,HepG2|chr7:150025858-150025930,chr7,150025858,150025930,1,42773
HepG2|chr7:149983087-149983206,chr7,149983087,149983206,HepG2|chr7:150025858-150025930,chr7,150025858,150025930,1,42771
HepG2|chr7:150013406-150013556,chr7,150013406,150013556,HepG2|chr7:150023749-150023788,chr7,150023749,150023788,1,10343
HepG2|chr7:155451375-155451461,chr7,155451375,155451461,HepG2|chr7:2395797-2395947,chr7,2395797,2395947,1,153055578
HepG2|chr8:11645473-11645576,chr8,11645473,11645576,HepG2|chr8:11658821-11658840,chr8,11658821,11658840,1,13348
HepG2|chr8:11645542-11645576,chr8,11645542,11645576,HepG2|chr8:11658859-11659009,chr8,11658859,11659009,1,13317
HepG2|chr8:22059432-22059564,chr8,22059432,22059564,HepG2|chr8:124408983-124409001,chr8,124408983,124409001,1,102349551
HepG2|chr8:30272329-30272376,chr8,30272329,30272376,HepG2|chr8:27695562-27695665,chr8,27695562,27695665,1,2576767
HepG2|chr8:37674402-37674476,chr8,37674402,37674476,HepG2|chr8:37621428-37621482,chr8,37621428,37621482,1,52974
HepG2|chr8:37762788-37762841,chr8,37762788,37762841,HepG2|chr8:37755763-37755860,chr8,37755763,37755860,1,7025
HepG2|chr8:37762794-37762847,chr8,37762794,37762847,HepG2|chr8:37755763-37755860,chr8,37755763,37755860,1,7031
HepG2|chr8:37766676-37766817,chr8,37766676,37766817,HepG2|chr8:37758537-37758570,chr8,37758537,37758570,1,8139
HepG2|chr8:37766676-37766815,chr8,37766676,37766815,HepG2|chr8:37758426-37758570,chr8,37758426,37758570,1,8250
HepG2|chr8:37766681-37766798,chr8,37766681,37766798,HepG2|chr8:37758537-37758570,chr8,37758537,37758570,1,8144
HepG2|chr8:37766681-37766782,chr8,37766681,37766782,HepG2|chr8:37758516-37758570,chr8,37758516,37758570,1,8165
HepG2|chr8:37766681-37766777,chr8,37766681,37766777,HepG2|chr8:37758516-37758570,chr8,37758516,37758570,1,8165
HepG2|chr8:37766681-37766745,chr8,37766681,37766745,HepG2|chr8:37758484-37758570,chr8,37758484,37758570,1,8197
HepG2|chr8:37766681-37766743,chr8,37766681,37766743,HepG2|chr8:37758484-37758570,chr8,37758484,37758570,1,8197
HepG2|chr8:37766681-37766734,chr8,37766681,37766734,HepG2|chr8:37758459-37758570,chr8,37758459,37758570,1,8222
HepG2|chr8:37766681-37766729,chr8,37766681,37766729,HepG2|chr8:37758426-37758570,chr8,37758426,37758570,1,8255
HepG2|chr8:37766681-37766720,chr8,37766681,37766720,HepG2|chr8:37758459-37758570,chr8,37758459,37758570,1,8222
HepG2|chr8:37766681-37766716,chr8,37766681,37766716,HepG2|chr8:37758472-37758570,chr8,37758472,37758570,1,8209
HepG2|chr8:37766720-37766737,chr8,37766720,37766737,HepG2|chr8:37758424-37758570,chr8,37758424,37758570,1,8296
HepG2|chr8:37766971-37767001,chr8,37766971,37767001,HepG2|chr8:37758450-37758570,chr8,37758450,37758570,1,8521
HepG2|chr8:37772036-37772098,chr8,37772036,37772098,HepG2|chr8:37758464-37758570,chr8,37758464,37758570,1,13572
HepG2|chr8:37772036-37772087,chr8,37772036,37772087,HepG2|chr8:37761712-37761741,chr8,37761712,37761741,1,10324
HepG2|chr8:37772036-37772082,chr8,37772036,37772082,HepG2|chr8:37758450-37758570,chr8,37758450,37758570,1,13586
HepG2|chr8:37772036-37772080,chr8,37772036,37772080,HepG2|chr8:37758464-37758570,chr8,37758464,37758570,1,13572
HepG2|chr8:40017941-40018054,chr8,40017941,40018054,HepG2|chr8:40015745-40015782,chr8,40015745,40015782,1,2196
HepG2|chr8:40017941-40017997,chr8,40017941,40017997,HepG2|chr8:40014301-40014407,chr8,40014301,40014407,1,3640
HepG2|chr8:40017941-40017963,chr8,40017941,40017963,HepG2|chr8:40014366-40014407,chr8,40014366,40014407,1,3575
HepG2|chr8:40018980-40019067,chr8,40018980,40019067,HepG2|chr8:40015719-40015782,chr8,40015719,40015782,1,3261
HepG2|chr8:40018980-40019064,chr8,40018980,40019064,HepG2|chr8:40015687-40015764,chr8,40015687,40015764,1,3293
HepG2|chr8:40018980-40019060,chr8,40018980,40019060,HepG2|chr8:40015752-40015782,chr8,40015752,40015782,1,3228
HepG2|chr8:40018980-40019057,chr8,40018980,40019057,HepG2|chr8:40015709-40015782,chr8,40015709,40015782,1,3271
HepG2|chr8:40018980-40019033,chr8,40018980,40019033,HepG2|chr8:40015685-40015782,chr8,40015685,40015782,1,3295
HepG2|chr8:40019022-40019078,chr8,40019022,40019078,HepG2|chr8:40014334-40014407,chr8,40014334,40014407,1,4688
HepG2|chr8:40019022-40019072,chr8,40019022,40019072,HepG2|chr8:40014307-40014407,chr8,40014307,40014407,1,4715
HepG2|chr8:40020225-40020246,chr8,40020225,40020246,HepG2|chr8:40014307-40014407,chr8,40014307,40014407,1,5918
HepG2|chr8:54949231-54949277,chr8,54949231,54949277,HepG2|chr8:54939418-54939535,chr8,54939418,54939535,1,9813
HepG2|chr8:54949231-54949252,chr8,54949231,54949252,HepG2|chr8:54939418-54939535,chr8,54939418,54939535,1,9813
HepG2|chr8:54949878-54950004,chr8,54949878,54950004,HepG2|chr8:54939560-54939700,chr8,54939560,54939700,1,10318
HepG2|chr8:54950764-54950824,chr8,54950764,54950824,HepG2|chr8:54935417-54935567,chr8,54935417,54935567,1,15347
HepG2|chr8:54950959-54951012,chr8,54950959,54951012,HepG2|chr8:54938556-54938591,chr8,54938556,54938591,1,12403
HepG2|chr8:54954781-54954908,chr8,54954781,54954908,HepG2|chr8:54938451-54938565,chr8,54938451,54938565,1,16330
HepG2|chr8:54954781-54954903,chr8,54954781,54954903,HepG2|chr8:54938497-54938565,chr8,54938497,54938565,1,16284
HepG2|chr8:54954781-54954890,chr8,54954781,54954890,HepG2|chr8:54938522-54938591,chr8,54938522,54938591,1,16259
HepG2|chr8:54954781-54954862,chr8,54954781,54954862,HepG2|chr8:54938522-54938591,chr8,54938522,54938591,1,16259
HepG2|chr8:54954781-54954850,chr8,54954781,54954850,HepG2|chr8:54938510-54938591,chr8,54938510,54938591,1,16271
HepG2|chr8:54954781-54954843,chr8,54954781,54954843,HepG2|chr8:54938477-54938591,chr8,54938477,54938591,1,16304
HepG2|chr8:54957841-54957896,chr8,54957841,54957896,HepG2|chr8:54936262-54936325,chr8,54936262,54936325,1,21579
HepG2|chr8:81027986-81028070,chr8,81027986,81028070,HepG2|chr8:117780105-117780168,chr8,117780105,117780168,1,36752119
HepG2|chr8:81027987-81028081,chr8,81027987,81028081,HepG2|chr8:117780105-117780168,chr8,117780105,117780168,1,36752118
HepG2|chr8:81057859-81057877,chr8,81057859,81057877,HepG2|chr8:101319894-101319988,chr8,101319894,101319988,1,20262035
HepG2|chr8:81057860-81057877,chr8,81057860,81057877,HepG2|chr8:101319896-101319988,chr8,101319896,101319988,1,20262036
HepG2|chr8:81057860-81057876,chr8,81057860,81057876,HepG2|chr8:101319896-101319989,chr8,101319896,101319989,1,20262036
HepG2|chr8:96011120-96011173,chr8,96011120,96011173,HepG2|chr8:134308878-134308943,chr8,134308878,134308943,1,38297758
HepG2|chr8:96011120-96011157,chr8,96011120,96011157,HepG2|chr8:134308878-134308943,chr8,134308878,134308943,1,38297758
HepG2|chr8:101393873-101393967,chr8,101393873,101393967,HepG2|chr8:101348669-101348725,chr8,101348669,101348725,1,45204
HepG2|chr8:101393873-101393960,chr8,101393873,101393960,HepG2|chr8:101348629-101348725,chr8,101348629,101348725,1,45244
HepG2|chr8:101393873-101393921,chr8,101393873,101393921,HepG2|chr8:101348629-101348725,chr8,101348629,101348725,1,45244
HepG2|chr8:101393901-101394045,chr8,101393901,101394045,HepG2|chr8:101348669-101348725,chr8,101348669,101348725,1,45232
HepG2|chr8:103500455-103500513,chr8,103500455,103500513,HepG2|chr8:103549208-103549286,chr8,103549208,103549286,1,48753
HepG2|chr8:103505629-103505652,chr8,103505629,103505652,HepG2|chr8:103548010-103548140,chr8,103548010,103548140,1,42381
HepG2|chr8:103512706-103512769,chr8,103512706,103512769,HepG2|chr8:103548274-103548320,chr8,103548274,103548320,1,35568
HepG2|chr8:103512707-103512769,chr8,103512707,103512769,HepG2|chr8:103548274-103548320,chr8,103548274,103548320,1,35567
HepG2|chr8:103524125-103524193,chr8,103524125,103524193,HepG2|chr8:103536171-103536318,chr8,103536171,103536318,1,12046
HepG2|chr8:103524368-103524489,chr8,103524368,103524489,HepG2|chr8:103539009-103539038,chr8,103539009,103539038,1,14641
HepG2|chr8:103524388-103524537,chr8,103524388,103524537,HepG2|chr8:103539009-103539038,chr8,103539009,103539038,1,14621
HepG2|chr8:103674975-103675072,chr8,103674975,103675072,HepG2|chr8:103669502-103669649,chr8,103669502,103669649,1,5473
HepG2|chr8:103675207-103675291,chr8,103675207,103675291,HepG2|chr8:103668874-103669014,chr8,103668874,103669014,1,6333
HepG2|chr8:103675207-103675246,chr8,103675207,103675246,HepG2|chr8:103668920-103669014,chr8,103668920,103669014,1,6287
HepG2|chr8:117877168-117877231,chr8,117877168,117877231,HepG2|chr8:119119853-119119935,chr8,119119853,119119935,1,1242685
HepG2|chr8:117877169-117877229,chr8,117877169,117877229,HepG2|chr8:119119853-119119935,chr8,119119853,119119935,1,1242684
HepG2|chr8:126225139-126225201,chr8,126225139,126225201,HepG2|chr8:134580663-134580800,chr8,134580663,134580800,1,8355524
HepG2|chr8:126231239-126231298,chr8,126231239,126231298,HepG2|chr8:134581505-134581652,chr8,134581505,134581652,1,8350266
HepG2|chr8:126354521-126354548,chr8,126354521,126354548,HepG2|chr8:125488693-125488816,chr8,125488693,125488816,1,865828
HepG2|chr8:126354523-126354554,chr8,126354523,126354554,HepG2|chr8:125488693-125488816,chr8,125488693,125488816,1,865830
HepG2|chr8:128213687-128213804,chr8,128213687,128213804,HepG2|chr8:128749088-128749137,chr8,128749088,128749137,1,535401
HepG2|chr8:128213706-128213804,chr8,128213706,128213804,HepG2|chr8:128749088-128749137,chr8,128749088,128749137,1,535382
HepG2|chr8:128229066-128229169,chr8,128229066,128229169,HepG2|chr8:17352623-17352662,chr8,17352623,17352662,1,110876443
HepG2|chr8:128231592-128231683,chr8,128231592,128231683,HepG2|chr8:144636284-144636304,chr8,144636284,144636304,1,16404692
HepG2|chr8:128231766-128231862,chr8,128231766,128231862,HepG2|chr8:22090719-22090760,chr8,22090719,22090760,1,106141047
HepG2|chr8:128232542-128232616,chr8,128232542,128232616,HepG2|chr8:128752446-128752556,chr8,128752446,128752556,1,519904
HepG2|chr8:128232576-128232616,chr8,128232576,128232616,HepG2|chr8:128752446-128752556,chr8,128752446,128752556,1,519870
HepG2|chr8:128233664-128233814,chr8,128233664,128233814,HepG2|chr8:22093915-22093942,chr8,22093915,22093942,1,106139749
HepG2|chr8:128233892-128233943,chr8,128233892,128233943,HepG2|chr8:54933541-54933632,chr8,54933541,54933632,1,73300351
HepG2|chr8:128234059-128234161,chr8,128234059,128234161,HepG2|chr8:128752343-128752483,chr8,128752343,128752483,1,518284
HepG2|chr8:128235840-128235911,chr8,128235840,128235911,HepG2|chr8:17352623-17352711,chr8,17352623,17352711,1,110883217
HepG2|chr8:128236744-128236873,chr8,128236744,128236873,HepG2|chr8:124216541-124216558,chr8,124216541,124216558,1,4020203
HepG2|chr8:128237534-128237684,chr8,128237534,128237684,HepG2|chr8:144642365-144642386,chr8,144642365,144642386,1,16404831
HepG2|chr8:128238092-128238188,chr8,128238092,128238188,HepG2|chr8:128751695-128751749,chr8,128751695,128751749,1,513603
HepG2|chr8:128238095-128238198,chr8,128238095,128238198,HepG2|chr8:128751695-128751749,chr8,128751695,128751749,1,513600
HepG2|chr8:128238188-128238230,chr8,128238188,128238230,HepG2|chr8:128746852-128746959,chr8,128746852,128746959,1,508664
HepG2|chr8:128238189-128238299,chr8,128238189,128238299,HepG2|chr8:128746852-128746959,chr8,128746852,128746959,1,508663
HepG2|chr8:128238879-128239011,chr8,128238879,128239011,HepG2|chr8:124216541-124216558,chr8,124216541,124216558,1,4022338
HepG2|chr8:128238969-128239000,chr8,128238969,128239000,HepG2|chr8:144632810-144632958,chr8,144632810,144632958,1,16393841
HepG2|chr8:128753875-128753943,chr8,128753875,128753943,HepG2|chr8:128752077-128752159,chr8,128752077,128752159,1,1798
HepG2|chr8:128754179-128754271,chr8,128754179,128754271,HepG2|chr8:128751884-128751915,chr8,128751884,128751915,1,2295
HepG2|chr8:128754179-128754261,chr8,128754179,128754261,HepG2|chr8:128751884-128751915,chr8,128751884,128751915,1,2295
HepG2|chr8:128754222-128754311,chr8,128754222,128754311,HepG2|chr8:128751642-128751731,chr8,128751642,128751731,1,2580
HepG2|chr8:128754255-128754312,chr8,128754255,128754312,HepG2|chr8:128751642-128751731,chr8,128751642,128751731,1,2613
HepG2|chr8:128815371-128815403,chr8,128815371,128815403,HepG2|chr8:128752164-128752217,chr8,128752164,128752217,1,63207
HepG2|chr8:128875389-128875509,chr8,128875389,128875509,HepG2|chr8:124408983-124409001,chr8,124408983,124409001,1,4466406
HepG2|chr8:128875389-128875508,chr8,128875389,128875508,HepG2|chr8:124408983-124409002,chr8,124408983,124409002,1,4466406
HepG2|chr8:128901213-128901337,chr8,128901213,128901337,HepG2|chr8:124408985-124409002,chr8,124408985,124409002,1,4492228
HepG2|chr8:128901213-128901334,chr8,128901213,128901334,HepG2|chr8:124408985-124409002,chr8,124408985,124409002,1,4492228
HepG2|chr8:128901370-128901500,chr8,128901370,128901500,HepG2|chr8:124408985-124409002,chr8,124408985,124409002,1,4492385
HepG2|chr8:128986665-128986779,chr8,128986665,128986779,HepG2|chr8:71017855-71017892,chr8,71017855,71017892,1,57968810
HepG2|chr8:128986689-128986779,chr8,128986689,128986779,HepG2|chr8:71017861-71017892,chr8,71017861,71017892,1,57968828
HepG2|chr8:128986692-128986779,chr8,128986692,128986779,HepG2|chr8:71017861-71017892,chr8,71017861,71017892,1,57968831
HepG2|chr8:128986703-128986779,chr8,128986703,128986779,HepG2|chr8:71017855-71017892,chr8,71017855,71017892,1,57968848
HepG2|chr8:128986840-128986989,chr8,128986840,128986989,HepG2|chr8:71017858-71017891,chr8,71017858,71017891,1,57968982
HepG2|chr8:128986840-128986987,chr8,128986840,128986987,HepG2|chr8:71017862-71017894,chr8,71017862,71017894,1,57968978
HepG2|chr8:128987366-128987445,chr8,128987366,128987445,HepG2|chr8:101162100-101162205,chr8,101162100,101162205,1,27825266
HepG2|chr8:128987536-128987559,chr8,128987536,128987559,HepG2|chr8:71017861-71017891,chr8,71017861,71017891,1,57969675
HepG2|chr8:141603805-141603825,chr8,141603805,141603825,HepG2|chr8:144677678-144677736,chr8,144677678,144677736,1,3073873
HepG2|chr8:141603890-141603982,chr8,141603890,141603982,HepG2|chr8:144677678-144677736,chr8,144677678,144677736,1,3073788
HepG2|chr8:141631936-141632063,chr8,141631936,141632063,HepG2|chr8:124408983-124409001,chr8,124408983,124409001,1,17222953
HepG2|chr8:141633436-141633524,chr8,141633436,141633524,HepG2|chr8:124408983-124409002,chr8,124408983,124409002,1,17224453
HepG2|chr8:144384174-144384202,chr8,144384174,144384202,HepG2|chr8:144396522-144396645,chr8,144396522,144396645,1,12348
HepG2|chr8:144384175-144384202,chr8,144384175,144384202,HepG2|chr8:144396522-144396645,chr8,144396522,144396645,1,12347
HepG2|chr8:144384180-144384204,chr8,144384180,144384204,HepG2|chr8:144396560-144396603,chr8,144396560,144396603,1,12380
HepG2|chr8:144384306-144384456,chr8,144384306,144384456,HepG2|chr8:144393523-144393570,chr8,144393523,144393570,1,9217
HepG2|chr8:144384351-144384454,chr8,144384351,144384454,HepG2|chr8:144393523-144393570,chr8,144393523,144393570,1,9172
HepG2|chr9:6681796-6681879,chr9,6681796,6681879,HepG2|chr9:6703562-6703606,chr9,6703562,6703606,1,21766
HepG2|chr9:6681873-6681988,chr9,6681873,6681988,HepG2|chr9:6703562-6703602,chr9,6703562,6703602,1,21689
HepG2|chr9:6681875-6681988,chr9,6681875,6681988,HepG2|chr9:6703562-6703599,chr9,6703562,6703599,1,21687
HepG2|chr9:6681878-6681988,chr9,6681878,6681988,HepG2|chr9:6703562-6703602,chr9,6703562,6703602,1,21684
HepG2|chr9:6681882-6681988,chr9,6681882,6681988,HepG2|chr9:6703562-6703606,chr9,6703562,6703606,1,21680
HepG2|chr9:19200511-19200577,chr9,19200511,19200577,HepG2|chr9:19375000-19375061,chr9,19375000,19375061,1,174489
HepG2|chr9:20686966-20687011,chr9,20686966,20687011,HepG2|chr9:33000199-33000346,chr9,33000199,33000346,1,12313233
HepG2|chr9:20686970-20687011,chr9,20686970,20687011,HepG2|chr9:33000199-33000346,chr9,33000199,33000346,1,12313229
HepG2|chr9:27051823-27051896,chr9,27051823,27051896,HepG2|chr9:26946163-26946252,chr9,26946163,26946252,1,105660
HepG2|chr9:27051839-27051896,chr9,27051839,27051896,HepG2|chr9:26946163-26946252,chr9,26946163,26946252,1,105676
HepG2|chr9:27054436-27054542,chr9,27054436,27054542,HepG2|chr9:91004558-91004590,chr9,91004558,91004590,1,63950122
HepG2|chr9:27054437-27054540,chr9,27054437,27054540,HepG2|chr9:91004558-91004590,chr9,91004558,91004590,1,63950121
HepG2|chr9:33495019-33495083,chr9,33495019,33495083,HepG2|chr9:33478860-33478946,chr9,33478860,33478946,1,16159
HepG2|chr9:33504859-33504884,chr9,33504859,33504884,HepG2|chr9:33475630-33475694,chr9,33475630,33475694,1,29229
HepG2|chr9:33504885-33504927,chr9,33504885,33504927,HepG2|chr9:33475630-33475694,chr9,33475630,33475694,1,29255
HepG2|chr9:35696118-35696268,chr9,35696118,35696268,HepG2|chr9:35695912-35696062,chr9,35695912,35696062,1,206
HepG2|chr9:35696272-35696413,chr9,35696272,35696413,HepG2|chr9:35695942-35696014,chr9,35695942,35696014,1,330
HepG2|chr9:35696335-35696413,chr9,35696335,35696413,HepG2|chr9:35695942-35696014,chr9,35695942,35696014,1,393
HepG2|chr9:35696408-35696498,chr9,35696408,35696498,HepG2|chr9:35695154-35695304,chr9,35695154,35695304,1,1254
HepG2|chr9:35696420-35696498,chr9,35696420,35696498,HepG2|chr9:35695154-35695194,chr9,35695154,35695194,1,1266
HepG2|chr9:36206886-36206916,chr9,36206886,36206916,HepG2|chr9:139309290-139309440,chr9,139309290,139309440,1,103102404
HepG2|chr9:37080840-37080894,chr9,37080840,37080894,HepG2|chr9:37121291-37121326,chr9,37121291,37121326,1,40451
HepG2|chr9:37081862-37081935,chr9,37081862,37081935,HepG2|chr9:37122045-37122120,chr9,37122045,37122120,1,40183
HepG2|chr9:37081874-37081969,chr9,37081874,37081969,HepG2|chr9:37121851-37121904,chr9,37121851,37121904,1,39977
HepG2|chr9:37081911-37081979,chr9,37081911,37081979,HepG2|chr9:37121747-37121800,chr9,37121747,37121800,1,39836
HepG2|chr9:37083066-37083139,chr9,37083066,37083139,HepG2|chr9:37121760-37121904,chr9,37121760,37121904,1,38694
HepG2|chr9:37084128-37084167,chr9,37084128,37084167,HepG2|chr9:37122031-37122081,chr9,37122031,37122081,1,37903
HepG2|chr9:37084229-37084329,chr9,37084229,37084329,HepG2|chr9:37122031-37122081,chr9,37122031,37122081,1,37802
HepG2|chr9:37088132-37088222,chr9,37088132,37088222,HepG2|chr9:37121478-37121532,chr9,37121478,37121532,1,33346
HepG2|chr9:37088133-37088192,chr9,37088133,37088192,HepG2|chr9:37121478-37121532,chr9,37121478,37121532,1,33345
HepG2|chr9:37089942-37089961,chr9,37089942,37089961,HepG2|chr9:37120938-37121018,chr9,37120938,37121018,1,30996
HepG2|chr9:42250982-42251101,chr9,42250982,42251101,HepG2|chr9:70646011-70646067,chr9,70646011,70646067,1,28395029
HepG2|chr9:42250983-42251101,chr9,42250983,42251101,HepG2|chr9:70645946-70646028,chr9,70645946,70646028,1,28394963
HepG2|chr9:42251012-42251103,chr9,42251012,42251103,HepG2|chr9:45442431-45442563,chr9,45442431,45442563,1,3191419
HepG2|chr9:42251054-42251204,chr9,42251054,42251204,HepG2|chr9:70646052-70646109,chr9,70646052,70646109,1,28394998
HepG2|chr9:42251060-42251210,chr9,42251060,42251210,HepG2|chr9:70646052-70646103,chr9,70646052,70646103,1,28394992
HepG2|chr9:42251066-42251210,chr9,42251066,42251210,HepG2|chr9:70646052-70646124,chr9,70646052,70646124,1,28394986
HepG2|chr9:42251093-42251156,chr9,42251093,42251156,HepG2|chr9:45442265-45442394,chr9,45442265,45442394,1,3191172
HepG2|chr9:42251097-42251156,chr9,42251097,42251156,HepG2|chr9:45442109-45442224,chr9,45442109,45442224,1,3191012
HepG2|chr9:42251099-42251203,chr9,42251099,42251203,HepG2|chr9:45442217-45442367,chr9,45442217,45442367,1,3191118
HepG2|chr9:42251099-42251156,chr9,42251099,42251156,HepG2|chr9:45442185-45442335,chr9,45442185,45442335,1,3191086
HepG2|chr9:42251100-42251156,chr9,42251100,42251156,HepG2|chr9:45442179-45442262,chr9,45442179,45442262,1,3191079
HepG2|chr9:42251101-42251205,chr9,42251101,42251205,HepG2|chr9:70645938-70646007,chr9,70645938,70646007,1,28394837
HepG2|chr9:42251107-42251169,chr9,42251107,42251169,HepG2|chr9:45442234-45442320,chr9,45442234,45442320,1,3191127
HepG2|chr9:42251111-42251210,chr9,42251111,42251210,HepG2|chr9:70646011-70646062,chr9,70646011,70646062,1,28394900
HepG2|chr9:42251113-42251172,chr9,42251113,42251172,HepG2|chr9:45442256-45442394,chr9,45442256,45442394,1,3191143
HepG2|chr9:42251119-42251156,chr9,42251119,42251156,HepG2|chr9:45442244-45442394,chr9,45442244,45442394,1,3191125
HepG2|chr9:42251122-42251272,chr9,42251122,42251272,HepG2|chr9:45442241-45442391,chr9,45442241,45442391,1,3191119
HepG2|chr9:42251123-42251210,chr9,42251123,42251210,HepG2|chr9:70646052-70646139,chr9,70646052,70646139,1,28394929
HepG2|chr9:42251158-42251282,chr9,42251158,42251282,HepG2|chr9:45442301-45442394,chr9,45442301,45442394,1,3191143
HepG2|chr9:42251158-42251275,chr9,42251158,42251275,HepG2|chr9:45442310-45442394,chr9,45442310,45442394,1,3191152
HepG2|chr9:42251158-42251274,chr9,42251158,42251274,HepG2|chr9:45442431-45442491,chr9,45442431,45442491,1,3191273
HepG2|chr9:42251158-42251273,chr9,42251158,42251273,HepG2|chr9:45442296-45442394,chr9,45442296,45442394,1,3191138
HepG2|chr9:42251158-42251270,chr9,42251158,42251270,HepG2|chr9:45442301-45442389,chr9,45442301,45442389,1,3191143
HepG2|chr9:42251158-42251269,chr9,42251158,42251269,HepG2|chr9:45442301-45442389,chr9,45442301,45442389,1,3191143
HepG2|chr9:42251158-42251268,chr9,42251158,42251268,HepG2|chr9:45442301-45442394,chr9,45442301,45442394,1,3191143
HepG2|chr9:42251158-42251260,chr9,42251158,42251260,HepG2|chr9:45442431-45442492,chr9,45442431,45442492,1,3191273
HepG2|chr9:42251158-42251255,chr9,42251158,42251255,HepG2|chr9:45442299-45442394,chr9,45442299,45442394,1,3191141
HepG2|chr9:42251158-42251249,chr9,42251158,42251249,HepG2|chr9:45442301-45442394,chr9,45442301,45442394,1,3191143
HepG2|chr9:42251158-42251245,chr9,42251158,42251245,HepG2|chr9:45442431-45442490,chr9,45442431,45442490,1,3191273
HepG2|chr9:42251158-42251238,chr9,42251158,42251238,HepG2|chr9:45442431-45442486,chr9,45442431,45442486,1,3191273
HepG2|chr9:42251160-42251275,chr9,42251160,42251275,HepG2|chr9:45442431-45442484,chr9,45442431,45442484,1,3191271
HepG2|chr9:42251172-42251305,chr9,42251172,42251305,HepG2|chr9:70646030-70646169,chr9,70646030,70646169,1,28394858
HepG2|chr9:42251226-42251376,chr9,42251226,42251376,HepG2|chr9:70645946-70646043,chr9,70645946,70646043,1,28394720
HepG2|chr9:42251464-42251614,chr9,42251464,42251614,HepG2|chr9:70646315-70646465,chr9,70646315,70646465,1,28394851
HepG2|chr9:42251465-42251615,chr9,42251465,42251615,HepG2|chr9:70646315-70646465,chr9,70646315,70646465,1,28394850
HepG2|chr9:67340050-67340164,chr9,67340050,67340164,HepG2|chr9:67335066-67335103,chr9,67335066,67335103,1,4984
HepG2|chr9:67340050-67340163,chr9,67340050,67340163,HepG2|chr9:67335066-67335103,chr9,67335066,67335103,1,4984
HepG2|chr9:67340050-67340162,chr9,67340050,67340162,HepG2|chr9:67335066-67335103,chr9,67335066,67335103,1,4984
HepG2|chr9:67340050-67340140,chr9,67340050,67340140,HepG2|chr9:67335081-67335103,chr9,67335081,67335103,1,4969
HepG2|chr9:67340114-67340165,chr9,67340114,67340165,HepG2|chr9:67335066-67335103,chr9,67335066,67335103,1,5048
HepG2|chr9:71720469-71720507,chr9,71720469,71720507,HepG2|chr9:71732259-71732409,chr9,71732259,71732409,1,11790
HepG2|chr9:71721107-71721199,chr9,71721107,71721199,HepG2|chr9:71734866-71734913,chr9,71734866,71734913,1,13759
HepG2|chr9:71722928-71723034,chr9,71722928,71723034,HepG2|chr9:71731728-71731878,chr9,71731728,71731878,1,8800
HepG2|chr9:71723525-71723658,chr9,71723525,71723658,HepG2|chr9:71733083-71733144,chr9,71733083,71733144,1,9558
HepG2|chr9:71723525-71723614,chr9,71723525,71723614,HepG2|chr9:71733083-71733144,chr9,71733083,71733144,1,9558
HepG2|chr9:71723646-71723735,chr9,71723646,71723735,HepG2|chr9:71733398-71733548,chr9,71733398,71733548,1,9752
HepG2|chr9:88420113-88420243,chr9,88420113,88420243,HepG2|chr9:86432779-86432848,chr9,86432779,86432848,1,1987334
HepG2|chr9:88420163-88420306,chr9,88420163,88420306,HepG2|chr9:86432762-86432813,chr9,86432762,86432813,1,1987401
HepG2|chr9:91142668-91142765,chr9,91142668,91142765,HepG2|chr9:91145491-91145543,chr9,91145491,91145543,1,2823
HepG2|chr9:91142682-91142765,chr9,91142682,91142765,HepG2|chr9:91145491-91145543,chr9,91145491,91145543,1,2809
HepG2|chr9:91142701-91142848,chr9,91142701,91142848,HepG2|chr9:91145621-91145682,chr9,91145621,91145682,1,2920
HepG2|chr9:91142754-91142775,chr9,91142754,91142775,HepG2|chr9:91148120-91148270,chr9,91148120,91148270,1,5366
HepG2|chr9:91142759-91142848,chr9,91142759,91142848,HepG2|chr9:91145621-91145682,chr9,91145621,91145682,1,2862
HepG2|chr9:91142870-91142986,chr9,91142870,91142986,HepG2|chr9:91147223-91147257,chr9,91147223,91147257,1,4353
HepG2|chr9:91142981-91143096,chr9,91142981,91143096,HepG2|chr9:91148744-91148779,chr9,91148744,91148779,1,5763
HepG2|chr9:91143037-91143187,chr9,91143037,91143187,HepG2|chr9:91148744-91148779,chr9,91148744,91148779,1,5707
HepG2|chr9:97897210-97897293,chr9,97897210,97897293,HepG2|chr9:97770132-97770187,chr9,97770132,97770187,1,127078
HepG2|chr9:97897212-97897293,chr9,97897212,97897293,HepG2|chr9:97770132-97770187,chr9,97770132,97770187,1,127080
HepG2|chr9:97897512-97897542,chr9,97897512,97897542,HepG2|chr9:97770006-97770093,chr9,97770006,97770093,1,127506
HepG2|chr9:103061967-103062040,chr9,103061967,103062040,HepG2|chr9:102860430-102860507,chr9,102860430,102860507,1,201537
HepG2|chr9:103061967-103062038,chr9,103061967,103062038,HepG2|chr9:102860430-102860507,chr9,102860430,102860507,1,201537
HepG2|chr9:103061989-103062135,chr9,103061989,103062135,HepG2|chr9:102860430-102860507,chr9,102860430,102860507,1,201559
HepG2|chr9:130368038-130368126,chr9,130368038,130368126,HepG2|chr9:130371225-130371287,chr9,130371225,130371287,1,3187
HepG2|chr9:130368039-130368143,chr9,130368039,130368143,HepG2|chr9:130371225-130371287,chr9,130371225,130371287,1,3186
HepG2|chr9:130369481-130369537,chr9,130369481,130369537,HepG2|chr9:130369985-130370068,chr9,130369985,130370068,1,504
HepG2|chr9:130369481-130369528,chr9,130369481,130369528,HepG2|chr9:130369985-130370068,chr9,130369985,130370068,1,504
HepG2|chr9:130589824-130589865,chr9,130589824,130589865,HepG2|chr9:130741146-130741291,chr9,130741146,130741291,1,151322
HepG2|chr9:130847473-130847610,chr9,130847473,130847610,HepG2|chr9:130821282-130821432,chr9,130821282,130821432,1,26191
HepG2|chr9:130847611-130847666,chr9,130847611,130847666,HepG2|chr9:130821399-130821438,chr9,130821399,130821438,1,26212
HepG2|chr9:131440228-131440271,chr9,131440228,131440271,HepG2|chr9:131443763-131443856,chr9,131443763,131443856,1,3535
HepG2|chr9:131440229-131440271,chr9,131440229,131440271,HepG2|chr9:131443763-131443856,chr9,131443763,131443856,1,3534
HepG2|chr9:131440248-131440295,chr9,131440248,131440295,HepG2|chr9:131443746-131443896,chr9,131443746,131443896,1,3498
HepG2|chr9:131440293-131440365,chr9,131440293,131440365,HepG2|chr9:131446559-131446634,chr9,131446559,131446634,1,6266
HepG2|chr9:131440293-131440346,chr9,131440293,131440346,HepG2|chr9:131446559-131446634,chr9,131446559,131446634,1,6266
HepG2|chr9:131440319-131440365,chr9,131440319,131440365,HepG2|chr9:131440756-131440830,chr9,131440756,131440830,1,437
HepG2|chr9:131440368-131440514,chr9,131440368,131440514,HepG2|chr9:131441853-131441915,chr9,131441853,131441915,1,1485
HepG2|chr9:131440368-131440416,chr9,131440368,131440416,HepG2|chr9:131446559-131446634,chr9,131446559,131446634,1,6191
HepG2|chr9:131440399-131440549,chr9,131440399,131440549,HepG2|chr9:131440727-131440779,chr9,131440727,131440779,1,328
HepG2|chr9:131440435-131440485,chr9,131440435,131440485,HepG2|chr9:131441940-131442035,chr9,131441940,131442035,1,1505
HepG2|chr9:131440454-131440528,chr9,131440454,131440528,HepG2|chr9:131441853-131441915,chr9,131441853,131441915,1,1399
HepG2|chr9:132252609-132252653,chr9,132252609,132252653,HepG2|chr9:98270346-98270484,chr9,98270346,98270484,1,33982263
HepG2|chr9:132268942-132269069,chr9,132268942,132269069,HepG2|chr9:90341808-90341825,chr9,90341808,90341825,1,41927134
HepG2|chr9:132787989-132788070,chr9,132787989,132788070,HepG2|chr9:132562389-132562446,chr9,132562389,132562446,1,225600
HepG2|chr9:139678174-139678233,chr9,139678174,139678233,HepG2|chr9:139782553-139782612,chr9,139782553,139782612,1,104379
HepG2|chr9:140023965-140024009,chr9,140023965,140024009,HepG2|chr9:140008839-140008985,chr9,140008839,140008985,1,15126
HepG2|chr10:5633361-5633377,chr10,5633361,5633377,HepG2|chr10:135207810-135207960,chr10,135207810,135207960,1,129574449
HepG2|chr10:5661947-5661966,chr10,5661947,5661966,HepG2|chr10:135207826-135207952,chr10,135207826,135207952,1,129545879
HepG2|chr10:52417511-52417627,chr10,52417511,52417627,HepG2|chr10:60030072-60030162,chr10,60030072,60030162,1,7612561
HepG2|chr10:52417511-52417571,chr10,52417511,52417571,HepG2|chr10:60030072-60030162,chr10,60030072,60030162,1,7612561
HepG2|chr10:52417513-52417628,chr10,52417513,52417628,HepG2|chr10:60030072-60030162,chr10,60030072,60030162,1,7612559
HepG2|chr10:65238636-65238717,chr10,65238636,65238717,HepG2|chr10:65281497-65281566,chr10,65281497,65281566,1,42861
HepG2|chr10:65241389-65241453,chr10,65241389,65241453,HepG2|chr10:65280528-65280574,chr10,65280528,65280574,1,39139
HepG2|chr10:65246839-65246942,chr10,65246839,65246942,HepG2|chr10:65280100-65280166,chr10,65280100,65280166,1,33261
HepG2|chr10:65246839-65246920,chr10,65246839,65246920,HepG2|chr10:65280100-65280166,chr10,65280100,65280166,1,33261
HepG2|chr10:65247037-65247055,chr10,65247037,65247055,HepG2|chr10:65277737-65277804,chr10,65277737,65277804,1,30700
HepG2|chr10:65256469-65256508,chr10,65256469,65256508,HepG2|chr10:65276908-65277057,chr10,65276908,65277057,1,20439
HepG2|chr10:65257297-65257322,chr10,65257297,65257322,HepG2|chr10:65279324-65279432,chr10,65279324,65279432,1,22027
HepG2|chr10:65257356-65257398,chr10,65257356,65257398,HepG2|chr10:65279324-65279432,chr10,65279324,65279432,1,21968
HepG2|chr10:65257816-65257906,chr10,65257816,65257906,HepG2|chr10:65279995-65280055,chr10,65279995,65280055,1,22179
HepG2|chr10:65257817-65257908,chr10,65257817,65257908,HepG2|chr10:65279995-65280055,chr10,65279995,65280055,1,22178
HepG2|chr10:65260606-65260718,chr10,65260606,65260718,HepG2|chr10:65279170-65279311,chr10,65279170,65279311,1,18564
HepG2|chr10:65260714-65260787,chr10,65260714,65260787,HepG2|chr10:65279864-65279973,chr10,65279864,65279973,1,19150
HepG2|chr10:65260818-65260859,chr10,65260818,65260859,HepG2|chr10:65279864-65279973,chr10,65279864,65279973,1,19046
HepG2|chr10:65260956-65260988,chr10,65260956,65260988,HepG2|chr10:65280117-65280238,chr10,65280117,65280238,1,19161
HepG2|chr10:65260962-65260988,chr10,65260962,65260988,HepG2|chr10:65280117-65280238,chr10,65280117,65280238,1,19155
HepG2|chr10:65263012-65263099,chr10,65263012,65263099,HepG2|chr10:65278202-65278236,chr10,65278202,65278236,1,15190
HepG2|chr10:65263034-65263120,chr10,65263034,65263120,HepG2|chr10:65279778-65279898,chr10,65279778,65279898,1,16744
HepG2|chr10:65263090-65263120,chr10,65263090,65263120,HepG2|chr10:65279778-65279898,chr10,65279778,65279898,1,16688
HepG2|chr10:65263494-65263567,chr10,65263494,65263567,HepG2|chr10:65278120-65278175,chr10,65278120,65278175,1,14626
HepG2|chr10:65263496-65263567,chr10,65263496,65263567,HepG2|chr10:65278120-65278175,chr10,65278120,65278175,1,14624
HepG2|chr10:65265159-65265266,chr10,65265159,65265266,HepG2|chr10:65278045-65278133,chr10,65278045,65278133,1,12886
HepG2|chr10:65265207-65265266,chr10,65265207,65265266,HepG2|chr10:65278045-65278133,chr10,65278045,65278133,1,12838
HepG2|chr10:65265372-65265394,chr10,65265372,65265394,HepG2|chr10:65277358-65277391,chr10,65277358,65277391,1,11986
HepG2|chr10:65265791-65265876,chr10,65265791,65265876,HepG2|chr10:65277358-65277390,chr10,65277358,65277390,1,11567
HepG2|chr10:65265819-65265964,chr10,65265819,65265964,HepG2|chr10:65277358-65277390,chr10,65277358,65277390,1,11539
HepG2|chr10:65265902-65265935,chr10,65265902,65265935,HepG2|chr10:65279313-65279463,chr10,65279313,65279463,1,13411
HepG2|chr10:65266746-65266804,chr10,65266746,65266804,HepG2|chr10:65277308-65277376,chr10,65277308,65277376,1,10562
HepG2|chr10:65270865-65271010,chr10,65270865,65271010,HepG2|chr10:65276291-65276346,chr10,65276291,65276346,1,5426
HepG2|chr10:65270914-65271009,chr10,65270914,65271009,HepG2|chr10:65276291-65276346,chr10,65276291,65276346,1,5377
HepG2|chr10:65271010-65271084,chr10,65271010,65271084,HepG2|chr10:65278248-65278365,chr10,65278248,65278365,1,7238
HepG2|chr10:65271051-65271084,chr10,65271051,65271084,HepG2|chr10:65278248-65278365,chr10,65278248,65278365,1,7197
HepG2|chr10:65272225-65272311,chr10,65272225,65272311,HepG2|chr10:65278989-65279052,chr10,65278989,65279052,1,6764
HepG2|chr10:65272227-65272320,chr10,65272227,65272320,HepG2|chr10:65278989-65279052,chr10,65278989,65279052,1,6762
HepG2|chr10:65272256-65272307,chr10,65272256,65272307,HepG2|chr10:65278371-65278451,chr10,65278371,65278451,1,6115
HepG2|chr10:65272257-65272307,chr10,65272257,65272307,HepG2|chr10:65278371-65278451,chr10,65278371,65278451,1,6114
HepG2|chr10:65272725-65272821,chr10,65272725,65272821,HepG2|chr10:65279101-65279154,chr10,65279101,65279154,1,6376
HepG2|chr10:65272726-65272821,chr10,65272726,65272821,HepG2|chr10:65279101-65279154,chr10,65279101,65279154,1,6375
HepG2|chr10:65272885-65272911,chr10,65272885,65272911,HepG2|chr10:65278463-65278521,chr10,65278463,65278521,1,5578
HepG2|chr10:65273532-65273592,chr10,65273532,65273592,HepG2|chr10:65277558-65277685,chr10,65277558,65277685,1,4026
HepG2|chr10:65273865-65273912,chr10,65273865,65273912,HepG2|chr10:65278427-65278507,chr10,65278427,65278507,1,4562
HepG2|chr10:65273866-65273912,chr10,65273866,65273912,HepG2|chr10:65278427-65278507,chr10,65278427,65278507,1,4561
HepG2|chr10:65274368-65274432,chr10,65274368,65274432,HepG2|chr10:65280408-65280494,chr10,65280408,65280494,1,6040
HepG2|chr10:65274386-65274466,chr10,65274386,65274466,HepG2|chr10:65280408-65280494,chr10,65280408,65280494,1,6022
HepG2|chr10:65274401-65274423,chr10,65274401,65274423,HepG2|chr10:65280462-65280538,chr10,65280462,65280538,1,6061
HepG2|chr10:65274769-65274879,chr10,65274769,65274879,HepG2|chr10:65276899-65276927,chr10,65276899,65276927,1,2130
HepG2|chr10:65275201-65275287,chr10,65275201,65275287,HepG2|chr10:65276767-65276827,chr10,65276767,65276827,1,1566
HepG2|chr10:65275482-65275537,chr10,65275482,65275537,HepG2|chr10:65277582-65277677,chr10,65277582,65277677,1,2100
HepG2|chr10:65275666-65275709,chr10,65275666,65275709,HepG2|chr10:65276246-65276396,chr10,65276246,65276396,1,580
HepG2|chr10:65275682-65275774,chr10,65275682,65275774,HepG2|chr10:65276788-65276846,chr10,65276788,65276846,1,1106
HepG2|chr10:65275682-65275772,chr10,65275682,65275772,HepG2|chr10:65276788-65276846,chr10,65276788,65276846,1,1106
HepG2|chr10:73755159-73755181,chr10,73755159,73755181,HepG2|chr10:73612852-73612940,chr10,73612852,73612940,1,142307
HepG2|chr10:73854517-73854593,chr10,73854517,73854593,HepG2|chr10:73853567-73853602,chr10,73853567,73853602,1,950
HepG2|chr10:73854624-73854774,chr10,73854624,73854774,HepG2|chr10:73853422-73853497,chr10,73853422,73853497,1,1202
HepG2|chr10:73854672-73854745,chr10,73854672,73854745,HepG2|chr10:73853075-73853152,chr10,73853075,73853152,1,1597
HepG2|chr10:73854682-73854730,chr10,73854682,73854730,HepG2|chr10:73853126-73853218,chr10,73853126,73853218,1,1556
HepG2|chr10:73854694-73854815,chr10,73854694,73854815,HepG2|chr10:73853391-73853502,chr10,73853391,73853502,1,1303
HepG2|chr10:73854696-73854810,chr10,73854696,73854810,HepG2|chr10:73852720-73852807,chr10,73852720,73852807,1,1976
HepG2|chr10:73854703-73854810,chr10,73854703,73854810,HepG2|chr10:73853040-73853093,chr10,73853040,73853093,1,1663
HepG2|chr10:73854706-73854788,chr10,73854706,73854788,HepG2|chr10:73853035-73853174,chr10,73853035,73853174,1,1671
HepG2|chr10:73854714-73854810,chr10,73854714,73854810,HepG2|chr10:73853040-73853093,chr10,73853040,73853093,1,1674
HepG2|chr10:73854729-73854800,chr10,73854729,73854800,HepG2|chr10:73853188-73853291,chr10,73853188,73853291,1,1541
HepG2|chr10:73854729-73854776,chr10,73854729,73854776,HepG2|chr10:73853188-73853291,chr10,73853188,73853291,1,1541
HepG2|chr10:73854741-73854816,chr10,73854741,73854816,HepG2|chr10:73853422-73853497,chr10,73853422,73853497,1,1319
HepG2|chr10:73854747-73854897,chr10,73854747,73854897,HepG2|chr10:73853075-73853152,chr10,73853075,73853152,1,1672
HepG2|chr10:73854875-73854994,chr10,73854875,73854994,HepG2|chr10:73852720-73852760,chr10,73852720,73852760,1,2155
HepG2|chr10:73854997-73855016,chr10,73854997,73855016,HepG2|chr10:73852720-73852760,chr10,73852720,73852760,1,2277
HepG2|chr10:73855003-73855096,chr10,73855003,73855096,HepG2|chr10:73852711-73852748,chr10,73852711,73852748,1,2292
HepG2|chr10:73855003-73855093,chr10,73855003,73855093,HepG2|chr10:73852711-73852748,chr10,73852711,73852748,1,2292
HepG2|chr10:73855034-73855117,chr10,73855034,73855117,HepG2|chr10:73852809-73852931,chr10,73852809,73852931,1,2225
HepG2|chr10:73855289-73855368,chr10,73855289,73855368,HepG2|chr10:73852673-73852785,chr10,73852673,73852785,1,2616
HepG2|chr10:73855289-73855318,chr10,73855289,73855318,HepG2|chr10:73852673-73852785,chr10,73852673,73852785,1,2616
HepG2|chr10:73855301-73855399,chr10,73855301,73855399,HepG2|chr10:73853035-73853164,chr10,73853035,73853164,1,2266
HepG2|chr10:73855310-73855386,chr10,73855310,73855386,HepG2|chr10:73853144-73853208,chr10,73853144,73853208,1,2166
HepG2|chr10:73855329-73855420,chr10,73855329,73855420,HepG2|chr10:73853017-73853161,chr10,73853017,73853161,1,2312
HepG2|chr10:73855486-73855632,chr10,73855486,73855632,HepG2|chr10:73852620-73852697,chr10,73852620,73852697,1,2866
HepG2|chr10:73855551-73855671,chr10,73855551,73855671,HepG2|chr10:73852707-73852820,chr10,73852707,73852820,1,2844
HepG2|chr10:73855649-73855671,chr10,73855649,73855671,HepG2|chr10:73852707-73852820,chr10,73852707,73852820,1,2942
HepG2|chr10:73855750-73855796,chr10,73855750,73855796,HepG2|chr10:73852714-73852836,chr10,73852714,73852836,1,3036
HepG2|chr10:73855769-73855797,chr10,73855769,73855797,HepG2|chr10:73852714-73852836,chr10,73852714,73852836,1,3055
HepG2|chr10:73855995-73856114,chr10,73855995,73856114,HepG2|chr10:73852780-73852823,chr10,73852780,73852823,1,3215
HepG2|chr10:73856007-73856114,chr10,73856007,73856114,HepG2|chr10:73852780-73852823,chr10,73852780,73852823,1,3227
HepG2|chr10:73856039-73856140,chr10,73856039,73856140,HepG2|chr10:73852477-73852533,chr10,73852477,73852533,1,3562
HepG2|chr10:73856058-73856094,chr10,73856058,73856094,HepG2|chr10:73849451-73849543,chr10,73849451,73849543,1,6607
HepG2|chr10:73856058-73856084,chr10,73856058,73856084,HepG2|chr10:73849451-73849543,chr10,73849451,73849543,1,6607
HepG2|chr10:73856200-73856262,chr10,73856200,73856262,HepG2|chr10:73852216-73852299,chr10,73852216,73852299,1,3984
HepG2|chr10:73856203-73856261,chr10,73856203,73856261,HepG2|chr10:73852216-73852299,chr10,73852216,73852299,1,3987
HepG2|chr10:73856211-73856276,chr10,73856211,73856276,HepG2|chr10:73852387-73852501,chr10,73852387,73852501,1,3824
HepG2|chr10:73856217-73856298,chr10,73856217,73856298,HepG2|chr10:73851490-73851595,chr10,73851490,73851595,1,4727
HepG2|chr10:73856247-73856277,chr10,73856247,73856277,HepG2|chr10:73852387-73852501,chr10,73852387,73852501,1,3860
HepG2|chr10:73856253-73856298,chr10,73856253,73856298,HepG2|chr10:73851490-73851595,chr10,73851490,73851595,1,4763
HepG2|chr10:75490346-75490492,chr10,75490346,75490492,HepG2|chr10:75503921-75503939,chr10,75503921,75503939,1,13575
HepG2|chr10:75490350-75490500,chr10,75490350,75490500,HepG2|chr10:75503921-75503946,chr10,75503921,75503946,1,13571
HepG2|chr10:75490350-75490416,chr10,75490350,75490416,HepG2|chr10:75503921-75503965,chr10,75503921,75503965,1,13571
HepG2|chr10:75490356-75490506,chr10,75490356,75490506,HepG2|chr10:75503921-75503981,chr10,75503921,75503981,1,13565
HepG2|chr10:75490358-75490402,chr10,75490358,75490402,HepG2|chr10:75503916-75504018,chr10,75503916,75504018,1,13558
HepG2|chr10:75490499-75490631,chr10,75490499,75490631,HepG2|chr10:75503921-75503939,chr10,75503921,75503939,1,13422
HepG2|chr10:75490501-75490630,chr10,75490501,75490630,HepG2|chr10:75503915-75503936,chr10,75503915,75503936,1,13414
HepG2|chr10:75490506-75490631,chr10,75490506,75490631,HepG2|chr10:75503921-75503946,chr10,75503921,75503946,1,13415
HepG2|chr10:75490511-75490630,chr10,75490511,75490630,HepG2|chr10:75503915-75503970,chr10,75503915,75503970,1,13404
HepG2|chr10:75490517-75490631,chr10,75490517,75490631,HepG2|chr10:75503921-75504012,chr10,75503921,75504012,1,13404
HepG2|chr10:75490519-75490631,chr10,75490519,75490631,HepG2|chr10:75503921-75503958,chr10,75503921,75503958,1,13402
HepG2|chr10:75490522-75490631,chr10,75490522,75490631,HepG2|chr10:75503921-75503958,chr10,75503921,75503958,1,13399
HepG2|chr10:75490524-75490631,chr10,75490524,75490631,HepG2|chr10:75503921-75503937,chr10,75503921,75503937,1,13397
HepG2|chr10:75490529-75490631,chr10,75490529,75490631,HepG2|chr10:75503921-75503959,chr10,75503921,75503959,1,13392
HepG2|chr10:75490535-75490630,chr10,75490535,75490630,HepG2|chr10:75503915-75503970,chr10,75503915,75503970,1,13380
HepG2|chr10:75490541-75490631,chr10,75490541,75490631,HepG2|chr10:75503921-75503981,chr10,75503921,75503981,1,13380
HepG2|chr10:75490545-75490631,chr10,75490545,75490631,HepG2|chr10:75504001-75504148,chr10,75504001,75504148,1,13456
HepG2|chr10:75490552-75490631,chr10,75490552,75490631,HepG2|chr10:75503921-75503959,chr10,75503921,75503959,1,13369
HepG2|chr10:75490577-75490631,chr10,75490577,75490631,HepG2|chr10:75503921-75504012,chr10,75503921,75504012,1,13344
HepG2|chr10:75490579-75490631,chr10,75490579,75490631,HepG2|chr10:75503921-75504034,chr10,75503921,75504034,1,13342
HepG2|chr10:75490584-75490631,chr10,75490584,75490631,HepG2|chr10:75503921-75504024,chr10,75503921,75504024,1,13337
HepG2|chr10:75490585-75490631,chr10,75490585,75490631,HepG2|chr10:75503924-75504074,chr10,75503924,75504074,1,13339
HepG2|chr10:75490587-75490631,chr10,75490587,75490631,HepG2|chr10:75503921-75503995,chr10,75503921,75503995,1,13334
HepG2|chr10:75490594-75490631,chr10,75490594,75490631,HepG2|chr10:75503921-75504034,chr10,75503921,75504034,1,13327
HepG2|chr10:75490610-75490630,chr10,75490610,75490630,HepG2|chr10:75503943-75504091,chr10,75503943,75504091,1,13333
HepG2|chr10:81977774-81977894,chr10,81977774,81977894,HepG2|chr10:81967218-81967248,chr10,81967218,81967248,1,10556
HepG2|chr10:81977774-81977869,chr10,81977774,81977869,HepG2|chr10:81967325-81967353,chr10,81967325,81967353,1,10449
HepG2|chr10:81977774-81977865,chr10,81977774,81977865,HepG2|chr10:81967220-81967248,chr10,81967220,81967248,1,10554
HepG2|chr10:81977774-81977864,chr10,81977774,81977864,HepG2|chr10:81967206-81967248,chr10,81967206,81967248,1,10568
HepG2|chr10:81977774-81977859,chr10,81977774,81977859,HepG2|chr10:81967183-81967248,chr10,81967183,81967248,1,10591
HepG2|chr10:81977774-81977858,chr10,81977774,81977858,HepG2|chr10:81967183-81967248,chr10,81967183,81967248,1,10591
HepG2|chr10:81977774-81977853,chr10,81977774,81977853,HepG2|chr10:81967201-81967248,chr10,81967201,81967248,1,10573
HepG2|chr10:81977774-81977850,chr10,81977774,81977850,HepG2|chr10:81967228-81967353,chr10,81967228,81967353,1,10546
HepG2|chr10:81977781-81977931,chr10,81977781,81977931,HepG2|chr10:81967218-81967248,chr10,81967218,81967248,1,10563
HepG2|chr10:81979273-81979297,chr10,81979273,81979297,HepG2|chr10:81967316-81967426,chr10,81967316,81967426,1,11957
HepG2|chr10:88997621-88997770,chr10,88997621,88997770,HepG2|chr10:89259757-89259837,chr10,89259757,89259837,1,262136
HepG2|chr10:88997624-88997774,chr10,88997624,88997774,HepG2|chr10:89259694-89259844,chr10,89259694,89259844,1,262070
HepG2|chr10:88997649-88997792,chr10,88997649,88997792,HepG2|chr10:89259694-89259844,chr10,89259694,89259844,1,262045
HepG2|chr10:88997662-88997790,chr10,88997662,88997790,HepG2|chr10:89259767-89259835,chr10,89259767,89259835,1,262105
HepG2|chr10:88997677-88997827,chr10,88997677,88997827,HepG2|chr10:89259694-89259844,chr10,89259694,89259844,1,262017
HepG2|chr10:92922789-92922838,chr10,92922789,92922838,HepG2|chr10:92981274-92981323,chr10,92981274,92981323,1,58485
HepG2|chr10:92924131-92924206,chr10,92924131,92924206,HepG2|chr10:92978941-92979039,chr10,92978941,92979039,1,54810
HepG2|chr10:92924154-92924206,chr10,92924154,92924206,HepG2|chr10:92978941-92979039,chr10,92978941,92979039,1,54787
HepG2|chr10:92925883-92925962,chr10,92925883,92925962,HepG2|chr10:92980836-92980986,chr10,92980836,92980986,1,54953
HepG2|chr10:92962640-92962660,chr10,92962640,92962660,HepG2|chr10:92978926-92979072,chr10,92978926,92979072,1,16286
HepG2|chr10:92965132-92965200,chr10,92965132,92965200,HepG2|chr10:92977507-92977654,chr10,92977507,92977654,1,12375
HepG2|chr10:92968845-92968882,chr10,92968845,92968882,HepG2|chr10:92977613-92977724,chr10,92977613,92977724,1,8768
HepG2|chr10:99173143-99173242,chr10,99173143,99173242,HepG2|chr10:99182950-99183001,chr10,99182950,99183001,1,9807
HepG2|chr10:99173143-99173241,chr10,99173143,99173241,HepG2|chr10:99182950-99183001,chr10,99182950,99183001,1,9807
HepG2|chr10:104884965-104885067,chr10,104884965,104885067,HepG2|chr10:12110910-12110927,chr10,12110910,12110927,1,92774055
HepG2|chr10:114851341-114851393,chr10,114851341,114851393,HepG2|chr10:99055111-99055164,chr10,99055111,99055164,1,15796230
HepG2|chr10:114851350-114851393,chr10,114851350,114851393,HepG2|chr10:99055111-99055164,chr10,99055111,99055164,1,15796239
HepG2|chr10:120946610-120946654,chr10,120946610,120946654,HepG2|chr10:120941976-120942067,chr10,120941976,120942067,1,4634
HepG2|chr10:120950481-120950537,chr10,120950481,120950537,HepG2|chr10:120940424-120940542,chr10,120940424,120940542,1,10057
HepG2|chr10:120950481-120950510,chr10,120950481,120950510,HepG2|chr10:120940424-120940542,chr10,120940424,120940542,1,10057
HepG2|chr10:126606746-126606896,chr10,126606746,126606896,HepG2|chr10:106098721-106098830,chr10,106098721,106098830,1,20508025
HepG2|chr10:134337867-134338014,chr10,134337867,134338014,HepG2|chr10:134350229-134350248,chr10,134350229,134350248,1,12362
HepG2|chr10:134337979-134338110,chr10,134337979,134338110,HepG2|chr10:134350229-134350248,chr10,134350229,134350248,1,12250
HepG2|chr10:134338051-134338110,chr10,134338051,134338110,HepG2|chr10:134350229-134350341,chr10,134350229,134350341,1,12178
HepG2|chr10:134338052-134338200,chr10,134338052,134338200,HepG2|chr10:134350229-134350270,chr10,134350229,134350270,1,12177
HepG2|chr10:134338070-134338110,chr10,134338070,134338110,HepG2|chr10:134350302-134350452,chr10,134350302,134350452,1,12232
HepG2|chr10:134338072-134338110,chr10,134338072,134338110,HepG2|chr10:134350229-134350341,chr10,134350229,134350341,1,12157
HepG2|chr10:134338150-134338259,chr10,134338150,134338259,HepG2|chr10:134350229-134350270,chr10,134350229,134350270,1,12079
HepG2|chr10:134339552-134339680,chr10,134339552,134339680,HepG2|chr10:134347793-134347940,chr10,134347793,134347940,1,8241
HepG2|chr11:518408-518534,chr11,518408,518534,HepG2|chr11:510967-511037,chr11,510967,511037,1,7441
HepG2|chr11:518408-518484,chr11,518408,518484,HepG2|chr11:510967-511037,chr11,510967,511037,1,7441
HepG2|chr11:518962-519108,chr11,518962,519108,HepG2|chr11:528158-528192,chr11,528158,528192,1,9196
HepG2|chr11:518978-519107,chr11,518978,519107,HepG2|chr11:528158-528192,chr11,528158,528192,1,9180
HepG2|chr11:518988-519107,chr11,518988,519107,HepG2|chr11:528158-528266,chr11,528158,528266,1,9170
HepG2|chr11:518994-519107,chr11,518994,519107,HepG2|chr11:528158-528192,chr11,528158,528192,1,9164
HepG2|chr11:519019-519107,chr11,519019,519107,HepG2|chr11:528158-528233,chr11,528158,528233,1,9139
HepG2|chr11:519024-519107,chr11,519024,519107,HepG2|chr11:528205-528352,chr11,528205,528352,1,9181
HepG2|chr11:519035-519107,chr11,519035,519107,HepG2|chr11:528158-528233,chr11,528158,528233,1,9123
HepG2|chr11:519038-519107,chr11,519038,519107,HepG2|chr11:528215-528365,chr11,528215,528365,1,9177
HepG2|chr11:519048-519107,chr11,519048,519107,HepG2|chr11:528198-528343,chr11,528198,528343,1,9150
HepG2|chr11:519055-519107,chr11,519055,519107,HepG2|chr11:528158-528240,chr11,528158,528240,1,9103
HepG2|chr11:519059-519107,chr11,519059,519107,HepG2|chr11:528158-528281,chr11,528158,528281,1,9099
HepG2|chr11:519065-519107,chr11,519065,519107,HepG2|chr11:528158-528266,chr11,528158,528266,1,9093
HepG2|chr11:519066-519107,chr11,519066,519107,HepG2|chr11:528198-528343,chr11,528198,528343,1,9132
HepG2|chr11:519069-519107,chr11,519069,519107,HepG2|chr11:528204-528354,chr11,528204,528354,1,9135
HepG2|chr11:519071-519107,chr11,519071,519107,HepG2|chr11:528215-528365,chr11,528215,528365,1,9144
HepG2|chr11:519085-519107,chr11,519085,519107,HepG2|chr11:528218-528368,chr11,528218,528368,1,9133
HepG2|chr11:519107-519145,chr11,519107,519145,HepG2|chr11:507035-507182,chr11,507035,507182,1,12072
HepG2|chr11:520628-520664,chr11,520628,520664,HepG2|chr11:509432-509530,chr11,509432,509530,1,11196
HepG2|chr11:522548-522697,chr11,522548,522697,HepG2|chr11:526956-526977,chr11,526956,526977,1,4408
HepG2|chr11:522548-522665,chr11,522548,522665,HepG2|chr11:526956-526977,chr11,526956,526977,1,4408
HepG2|chr11:3084438-3084485,chr11,3084438,3084485,HepG2|chr11:3081424-3081564,chr11,3081424,3081564,1,3014
HepG2|chr11:3084588-3084612,chr11,3084588,3084612,HepG2|chr11:3080164-3080248,chr11,3080164,3080248,1,4424
HepG2|chr11:3084636-3084743,chr11,3084636,3084743,HepG2|chr11:3081335-3081485,chr11,3081335,3081485,1,3301
HepG2|chr11:3084638-3084691,chr11,3084638,3084691,HepG2|chr11:3081405-3081476,chr11,3081405,3081476,1,3233
HepG2|chr11:14678388-14678528,chr11,14678388,14678528,HepG2|chr11:64848724-64848874,chr11,64848724,64848874,1,50170336
HepG2|chr11:14678389-14678528,chr11,14678389,14678528,HepG2|chr11:64848724-64848874,chr11,64848724,64848874,1,50170335
HepG2|chr11:48017423-48017482,chr11,48017423,48017482,HepG2|chr11:64768689-64768737,chr11,64768689,64768737,1,16751266
HepG2|chr11:48017517-48017603,chr11,48017517,48017603,HepG2|chr11:64768690-64768737,chr11,64768690,64768737,1,16751173
HepG2|chr11:63340288-63340334,chr11,63340288,63340334,HepG2|chr11:62493518-62493604,chr11,62493518,62493604,1,846770
HepG2|chr11:63340290-63340334,chr11,63340290,63340334,HepG2|chr11:62493498-62493604,chr11,62493498,62493604,1,846792
HepG2|chr11:63551535-63551594,chr11,63551535,63551594,HepG2|chr11:63540585-63540675,chr11,63540585,63540675,1,10950
HepG2|chr11:63551537-63551593,chr11,63551537,63551593,HepG2|chr11:63540585-63540675,chr11,63540585,63540675,1,10952
HepG2|chr11:63551571-63551594,chr11,63551571,63551594,HepG2|chr11:63540585-63540675,chr11,63540585,63540675,1,10986
HepG2|chr11:65066183-65066235,chr11,65066183,65066235,HepG2|chr11:65078079-65078177,chr11,65078079,65078177,1,11896
HepG2|chr11:65066185-65066277,chr11,65066185,65066277,HepG2|chr11:65078079-65078177,chr11,65078079,65078177,1,11894
HepG2|chr11:65066519-65066604,chr11,65066519,65066604,HepG2|chr11:65078301-65078325,chr11,65078301,65078325,1,11782
HepG2|chr11:65067421-65067539,chr11,65067421,65067539,HepG2|chr11:65079695-65079726,chr11,65079695,65079726,1,12274
HepG2|chr11:65067434-65067584,chr11,65067434,65067584,HepG2|chr11:65079695-65079726,chr11,65079695,65079726,1,12261
HepG2|chr11:65068692-65068780,chr11,65068692,65068780,HepG2|chr11:65079711-65079753,chr11,65079711,65079753,1,11019
HepG2|chr11:65069837-65069983,chr11,65069837,65069983,HepG2|chr11:65081078-65081099,chr11,65081078,65081099,1,11241
HepG2|chr11:65069918-65070047,chr11,65069918,65070047,HepG2|chr11:65081078-65081099,chr11,65081078,65081099,1,11160
HepG2|chr11:65070795-65070814,chr11,65070795,65070814,HepG2|chr11:65080963-65081061,chr11,65080963,65081061,1,10168
HepG2|chr11:65070832-65070863,chr11,65070832,65070863,HepG2|chr11:65080963-65081061,chr11,65080963,65081061,1,10131
HepG2|chr11:65071995-65072030,chr11,65071995,65072030,HepG2|chr11:65082529-65082657,chr11,65082529,65082657,1,10534
HepG2|chr11:65071995-65072017,chr11,65071995,65072017,HepG2|chr11:65082529-65082657,chr11,65082529,65082657,1,10534
HepG2|chr11:65072547-65072603,chr11,65072547,65072603,HepG2|chr11:65077680-65077718,chr11,65077680,65077718,1,5133
HepG2|chr11:65072804-65072870,chr11,65072804,65072870,HepG2|chr11:65079759-65079853,chr11,65079759,65079853,1,6955
HepG2|chr11:65072814-65072870,chr11,65072814,65072870,HepG2|chr11:65079759-65079853,chr11,65079759,65079853,1,6945
HepG2|chr11:65073024-65073159,chr11,65073024,65073159,HepG2|chr11:65079563-65079602,chr11,65079563,65079602,1,6539
HepG2|chr11:65073306-65073386,chr11,65073306,65073386,HepG2|chr11:65081241-65081264,chr11,65081241,65081264,1,7935
HepG2|chr11:65073883-65073993,chr11,65073883,65073993,HepG2|chr11:65080104-65080129,chr11,65080104,65080129,1,6221
HepG2|chr11:65074789-65074848,chr11,65074789,65074848,HepG2|chr11:65081241-65081283,chr11,65081241,65081283,1,6452
HepG2|chr11:65075045-65075111,chr11,65075045,65075111,HepG2|chr11:65080956-65080999,chr11,65080956,65080999,1,5911
HepG2|chr11:65075045-65075078,chr11,65075045,65075078,HepG2|chr11:65080885-65080999,chr11,65080885,65080999,1,5840
HepG2|chr11:65075400-65075540,chr11,65075400,65075540,HepG2|chr11:65078472-65078509,chr11,65078472,65078509,1,3072
HepG2|chr11:65075501-65075582,chr11,65075501,65075582,HepG2|chr11:65077347-65077470,chr11,65077347,65077470,1,1846
HepG2|chr11:65075514-65075664,chr11,65075514,65075664,HepG2|chr11:65081836-65081945,chr11,65081836,65081945,1,6322
HepG2|chr11:65075515-65075663,chr11,65075515,65075663,HepG2|chr11:65081836-65081945,chr11,65081836,65081945,1,6321
HepG2|chr11:65075555-65075582,chr11,65075555,65075582,HepG2|chr11:65077347-65077470,chr11,65077347,65077470,1,1792
HepG2|chr11:65075659-65075700,chr11,65075659,65075700,HepG2|chr11:65081836-65081945,chr11,65081836,65081945,1,6177
HepG2|chr11:65075669-65075757,chr11,65075669,65075757,HepG2|chr11:65081241-65081272,chr11,65081241,65081272,1,5572
HepG2|chr11:65075728-65075754,chr11,65075728,65075754,HepG2|chr11:65081838-65081874,chr11,65081838,65081874,1,6110
HepG2|chr11:65075731-65075754,chr11,65075731,65075754,HepG2|chr11:65081241-65081281,chr11,65081241,65081281,1,5510
HepG2|chr11:65075733-65075754,chr11,65075733,65075754,HepG2|chr11:65081241-65081274,chr11,65081241,65081274,1,5508
HepG2|chr11:65075736-65075754,chr11,65075736,65075754,HepG2|chr11:65081237-65081260,chr11,65081237,65081260,1,5501
HepG2|chr11:65076139-65076192,chr11,65076139,65076192,HepG2|chr11:65084948-65084990,chr11,65084948,65084990,1,8809
HepG2|chr11:65076417-65076567,chr11,65076417,65076567,HepG2|chr11:65081237-65081276,chr11,65081237,65081276,1,4820
HepG2|chr11:65076442-65076592,chr11,65076442,65076592,HepG2|chr11:65081241-65081324,chr11,65081241,65081324,1,4799
HepG2|chr11:65076445-65076595,chr11,65076445,65076595,HepG2|chr11:65081241-65081275,chr11,65081241,65081275,1,4796
HepG2|chr11:65076465-65076612,chr11,65076465,65076612,HepG2|chr11:65081241-65081308,chr11,65081241,65081308,1,4776
HepG2|chr11:65076467-65076617,chr11,65076467,65076617,HepG2|chr11:65081241-65081364,chr11,65081241,65081364,1,4774
HepG2|chr11:65076471-65076618,chr11,65076471,65076618,HepG2|chr11:65081237-65081272,chr11,65081237,65081272,1,4766
HepG2|chr11:65076472-65076619,chr11,65076472,65076619,HepG2|chr11:65081241-65081304,chr11,65081241,65081304,1,4769
HepG2|chr11:65076473-65076618,chr11,65076473,65076618,HepG2|chr11:65081241-65081276,chr11,65081241,65081276,1,4768
HepG2|chr11:65076480-65076618,chr11,65076480,65076618,HepG2|chr11:65081237-65081358,chr11,65081237,65081358,1,4757
HepG2|chr11:65076483-65076585,chr11,65076483,65076585,HepG2|chr11:65081241-65081272,chr11,65081241,65081272,1,4758
HepG2|chr11:65076497-65076647,chr11,65076497,65076647,HepG2|chr11:65081245-65081395,chr11,65081245,65081395,1,4748
HepG2|chr11:65076498-65076648,chr11,65076498,65076648,HepG2|chr11:65081241-65081264,chr11,65081241,65081264,1,4743
HepG2|chr11:65076520-65076670,chr11,65076520,65076670,HepG2|chr11:65081263-65081318,chr11,65081263,65081318,1,4743
HepG2|chr11:65076524-65076674,chr11,65076524,65076674,HepG2|chr11:65081256-65081406,chr11,65081256,65081406,1,4732
HepG2|chr11:65076544-65076687,chr11,65076544,65076687,HepG2|chr11:65081241-65081296,chr11,65081241,65081296,1,4697
HepG2|chr11:65076549-65076678,chr11,65076549,65076678,HepG2|chr11:65081237-65081264,chr11,65081237,65081264,1,4688
HepG2|chr11:65076550-65076678,chr11,65076550,65076678,HepG2|chr11:65081814-65081841,chr11,65081814,65081841,1,5264
HepG2|chr11:65076551-65076678,chr11,65076551,65076678,HepG2|chr11:65081237-65081260,chr11,65081237,65081260,1,4686
HepG2|chr11:65076552-65076678,chr11,65076552,65076678,HepG2|chr11:65081814-65081903,chr11,65081814,65081903,1,5262
HepG2|chr11:65076555-65076678,chr11,65076555,65076678,HepG2|chr11:65081241-65081264,chr11,65081241,65081264,1,4686
HepG2|chr11:65076556-65076678,chr11,65076556,65076678,HepG2|chr11:65081241-65081304,chr11,65081241,65081304,1,4685
HepG2|chr11:65076558-65076678,chr11,65076558,65076678,HepG2|chr11:65081814-65081841,chr11,65081814,65081841,1,5256
HepG2|chr11:65076560-65076678,chr11,65076560,65076678,HepG2|chr11:65081241-65081345,chr11,65081241,65081345,1,4681
HepG2|chr11:65076562-65076678,chr11,65076562,65076678,HepG2|chr11:65081241-65081275,chr11,65081241,65081275,1,4679
HepG2|chr11:65076564-65076678,chr11,65076564,65076678,HepG2|chr11:65081241-65081274,chr11,65081241,65081274,1,4677
HepG2|chr11:65076565-65076678,chr11,65076565,65076678,HepG2|chr11:65081237-65081272,chr11,65081237,65081272,1,4672
HepG2|chr11:65076566-65076678,chr11,65076566,65076678,HepG2|chr11:65081237-65081360,chr11,65081237,65081360,1,4671
HepG2|chr11:65076567-65076678,chr11,65076567,65076678,HepG2|chr11:65081241-65081319,chr11,65081241,65081319,1,4674
HepG2|chr11:65076568-65076678,chr11,65076568,65076678,HepG2|chr11:65081241-65081281,chr11,65081241,65081281,1,4673
HepG2|chr11:65076569-65076678,chr11,65076569,65076678,HepG2|chr11:65081241-65081276,chr11,65081241,65081276,1,4672
HepG2|chr11:65076572-65076678,chr11,65076572,65076678,HepG2|chr11:65081241-65081276,chr11,65081241,65081276,1,4669
HepG2|chr11:65076573-65076678,chr11,65076573,65076678,HepG2|chr11:65081241-65081264,chr11,65081241,65081264,1,4668
HepG2|chr11:65076575-65076678,chr11,65076575,65076678,HepG2|chr11:65081241-65081276,chr11,65081241,65081276,1,4666
HepG2|chr11:65076579-65076678,chr11,65076579,65076678,HepG2|chr11:65081237-65081308,chr11,65081237,65081308,1,4658
HepG2|chr11:65076582-65076678,chr11,65076582,65076678,HepG2|chr11:65081237-65081285,chr11,65081237,65081285,1,4655
HepG2|chr11:65076583-65076678,chr11,65076583,65076678,HepG2|chr11:65081241-65081296,chr11,65081241,65081296,1,4658
HepG2|chr11:65076584-65076678,chr11,65076584,65076678,HepG2|chr11:65081263-65081318,chr11,65081263,65081318,1,4679
HepG2|chr11:65076586-65076678,chr11,65076586,65076678,HepG2|chr11:65081261-65081378,chr11,65081261,65081378,1,4675
HepG2|chr11:65076589-65076678,chr11,65076589,65076678,HepG2|chr11:65081241-65081277,chr11,65081241,65081277,1,4652
HepG2|chr11:65076591-65076678,chr11,65076591,65076678,HepG2|chr11:65081241-65081304,chr11,65081241,65081304,1,4650
HepG2|chr11:65076594-65076678,chr11,65076594,65076678,HepG2|chr11:65082022-65082117,chr11,65082022,65082117,1,5428
HepG2|chr11:65076595-65076678,chr11,65076595,65076678,HepG2|chr11:65081241-65081276,chr11,65081241,65081276,1,4646
HepG2|chr11:65076596-65076678,chr11,65076596,65076678,HepG2|chr11:65081241-65081320,chr11,65081241,65081320,1,4645
HepG2|chr11:65076597-65076678,chr11,65076597,65076678,HepG2|chr11:65081237-65081306,chr11,65081237,65081306,1,4640
HepG2|chr11:65076598-65076678,chr11,65076598,65076678,HepG2|chr11:65081241-65081308,chr11,65081241,65081308,1,4643
HepG2|chr11:65076600-65076678,chr11,65076600,65076678,HepG2|chr11:65081970-65082021,chr11,65081970,65082021,1,5370
HepG2|chr11:65076601-65076678,chr11,65076601,65076678,HepG2|chr11:65081263-65081329,chr11,65081263,65081329,1,4662
HepG2|chr11:65076603-65076678,chr11,65076603,65076678,HepG2|chr11:65081237-65081324,chr11,65081237,65081324,1,4634
HepG2|chr11:65076603-65076668,chr11,65076603,65076668,HepG2|chr11:65081241-65081304,chr11,65081241,65081304,1,4638
HepG2|chr11:65076604-65076678,chr11,65076604,65076678,HepG2|chr11:65081970-65082047,chr11,65081970,65082047,1,5366
HepG2|chr11:65076605-65076678,chr11,65076605,65076678,HepG2|chr11:65081237-65081285,chr11,65081237,65081285,1,4632
HepG2|chr11:65076606-65076678,chr11,65076606,65076678,HepG2|chr11:65081241-65081319,chr11,65081241,65081319,1,4635
HepG2|chr11:65076607-65076678,chr11,65076607,65076678,HepG2|chr11:65081970-65082049,chr11,65081970,65082049,1,5363
HepG2|chr11:65076608-65076678,chr11,65076608,65076678,HepG2|chr11:65081970-65082047,chr11,65081970,65082047,1,5362
HepG2|chr11:65076611-65076678,chr11,65076611,65076678,HepG2|chr11:65081241-65081324,chr11,65081241,65081324,1,4630
HepG2|chr11:65076615-65076678,chr11,65076615,65076678,HepG2|chr11:65081237-65081324,chr11,65081237,65081324,1,4622
HepG2|chr11:65076617-65076678,chr11,65076617,65076678,HepG2|chr11:65081814-65081903,chr11,65081814,65081903,1,5197
HepG2|chr11:65076623-65076678,chr11,65076623,65076678,HepG2|chr11:65081241-65081332,chr11,65081241,65081332,1,4618
HepG2|chr11:65076624-65076678,chr11,65076624,65076678,HepG2|chr11:65081241-65081337,chr11,65081241,65081337,1,4617
HepG2|chr11:65076628-65076678,chr11,65076628,65076678,HepG2|chr11:65081241-65081327,chr11,65081241,65081327,1,4613
HepG2|chr11:65076629-65076682,chr11,65076629,65076682,HepG2|chr11:65081245-65081285,chr11,65081245,65081285,1,4616
HepG2|chr11:65076629-65076678,chr11,65076629,65076678,HepG2|chr11:65081814-65081915,chr11,65081814,65081915,1,5185
HepG2|chr11:65076630-65076678,chr11,65076630,65076678,HepG2|chr11:65081814-65081916,chr11,65081814,65081916,1,5184
HepG2|chr11:65076631-65076678,chr11,65076631,65076678,HepG2|chr11:65081237-65081340,chr11,65081237,65081340,1,4606
HepG2|chr11:65076636-65076678,chr11,65076636,65076678,HepG2|chr11:65081241-65081347,chr11,65081241,65081347,1,4605
HepG2|chr11:65076637-65076678,chr11,65076637,65076678,HepG2|chr11:65081258-65081408,chr11,65081258,65081408,1,4621
HepG2|chr11:65076638-65076678,chr11,65076638,65076678,HepG2|chr11:65081241-65081340,chr11,65081241,65081340,1,4603
HepG2|chr11:65076640-65076678,chr11,65076640,65076678,HepG2|chr11:65081248-65081398,chr11,65081248,65081398,1,4608
HepG2|chr11:65076642-65076678,chr11,65076642,65076678,HepG2|chr11:65081258-65081408,chr11,65081258,65081408,1,4616
HepG2|chr11:65076643-65076678,chr11,65076643,65076678,HepG2|chr11:65081241-65081332,chr11,65081241,65081332,1,4598
HepG2|chr11:65076644-65076678,chr11,65076644,65076678,HepG2|chr11:65081814-65081903,chr11,65081814,65081903,1,5170
HepG2|chr11:65076645-65076678,chr11,65076645,65076678,HepG2|chr11:65081241-65081366,chr11,65081241,65081366,1,4596
HepG2|chr11:65076646-65076678,chr11,65076646,65076678,HepG2|chr11:65081241-65081340,chr11,65081241,65081340,1,4595
HepG2|chr11:65076647-65076678,chr11,65076647,65076678,HepG2|chr11:65082034-65082117,chr11,65082034,65082117,1,5387
HepG2|chr11:65076648-65076678,chr11,65076648,65076678,HepG2|chr11:65081237-65081353,chr11,65081237,65081353,1,4589
HepG2|chr11:65076649-65076678,chr11,65076649,65076678,HepG2|chr11:65081237-65081358,chr11,65081237,65081358,1,4588
HepG2|chr11:65076650-65076678,chr11,65076650,65076678,HepG2|chr11:65081256-65081406,chr11,65081256,65081406,1,4606
HepG2|chr11:65076651-65076678,chr11,65076651,65076678,HepG2|chr11:65081241-65081366,chr11,65081241,65081366,1,4590
HepG2|chr11:65076652-65076678,chr11,65076652,65076678,HepG2|chr11:65081970-65082090,chr11,65081970,65082090,1,5318
HepG2|chr11:65076653-65076678,chr11,65076653,65076678,HepG2|chr11:65081241-65081366,chr11,65081241,65081366,1,4588
HepG2|chr11:65076654-65076678,chr11,65076654,65076678,HepG2|chr11:65081245-65081395,chr11,65081245,65081395,1,4591
HepG2|chr11:65076655-65076678,chr11,65076655,65076678,HepG2|chr11:65081241-65081294,chr11,65081241,65081294,1,4586
HepG2|chr11:65076656-65076678,chr11,65076656,65076678,HepG2|chr11:65081393-65081543,chr11,65081393,65081543,1,4737
HepG2|chr11:65076657-65076678,chr11,65076657,65076678,HepG2|chr11:65081278-65081424,chr11,65081278,65081424,1,4621
HepG2|chr11:65076658-65076678,chr11,65076658,65076678,HepG2|chr11:65081267-65081417,chr11,65081267,65081417,1,4609
HepG2|chr11:65190342-65190431,chr11,65190342,65190431,HepG2|chr11:93519130-93519170,chr11,93519130,93519170,1,28328788
HepG2|chr11:65190537-65190659,chr11,65190537,65190659,HepG2|chr11:65294924-65294952,chr11,65294924,65294952,1,104387
HepG2|chr11:65191187-65191228,chr11,65191187,65191228,HepG2|chr11:65313280-65313428,chr11,65313280,65313428,1,122093
HepG2|chr11:65192504-65192579,chr11,65192504,65192579,HepG2|chr11:65313538-65313586,chr11,65313538,65313586,1,121034
HepG2|chr11:65192861-65192898,chr11,65192861,65192898,HepG2|chr11:118887802-118887839,chr11,118887802,118887839,1,53694941
HepG2|chr11:65192875-65192939,chr11,65192875,65192939,HepG2|chr11:790424-790516,chr11,790424,790516,1,64402451
HepG2|chr11:65192877-65192937,chr11,65192877,65192937,HepG2|chr11:790423-790516,chr11,790423,790516,1,64402454
HepG2|chr11:65192885-65192940,chr11,65192885,65192940,HepG2|chr11:790424-790516,chr11,790424,790516,1,64402461
HepG2|chr11:65192885-65192939,chr11,65192885,65192939,HepG2|chr11:790423-790516,chr11,790423,790516,1,64402462
HepG2|chr11:65192974-65193087,chr11,65192974,65193087,HepG2|chr11:118887802-118887839,chr11,118887802,118887839,1,53694828
HepG2|chr11:65192975-65193087,chr11,65192975,65193087,HepG2|chr11:118887802-118887839,chr11,118887802,118887839,1,53694827
HepG2|chr11:65193327-65193447,chr11,65193327,65193447,HepG2|chr11:810565-810632,chr11,810565,810632,1,64382762
HepG2|chr11:65193327-65193410,chr11,65193327,65193410,HepG2|chr11:810565-810632,chr11,810565,810632,1,64382762
HepG2|chr11:65193327-65193409,chr11,65193327,65193409,HepG2|chr11:810565-810632,chr11,810565,810632,1,64382762
HepG2|chr11:65193722-65193763,chr11,65193722,65193763,HepG2|chr11:65342331-65342479,chr11,65342331,65342479,1,148609
HepG2|chr11:65195094-65195224,chr11,65195094,65195224,HepG2|chr11:776756-776841,chr11,776756,776841,1,64418338
HepG2|chr11:65195094-65195159,chr11,65195094,65195159,HepG2|chr11:776756-776841,chr11,776756,776841,1,64418338
HepG2|chr11:65196162-65196305,chr11,65196162,65196305,HepG2|chr11:803602-803647,chr11,803602,803647,1,64392560
HepG2|chr11:65196519-65196628,chr11,65196519,65196628,HepG2|chr11:93517976-93518094,chr11,93517976,93518094,1,28321457
HepG2|chr11:65196652-65196684,chr11,65196652,65196684,HepG2|chr11:93517976-93518094,chr11,93517976,93518094,1,28321324
HepG2|chr11:65197184-65197274,chr11,65197184,65197274,HepG2|chr11:65376905-65376949,chr11,65376905,65376949,1,179721
HepG2|chr11:65197552-65197682,chr11,65197552,65197682,HepG2|chr11:65375366-65375386,chr11,65375366,65375386,1,177814
HepG2|chr11:65197553-65197682,chr11,65197553,65197682,HepG2|chr11:65375366-65375386,chr11,65375366,65375386,1,177813
HepG2|chr11:65203916-65204033,chr11,65203916,65204033,HepG2|chr11:65377786-65377804,chr11,65377786,65377804,1,173870
HepG2|chr11:65205970-65206056,chr11,65205970,65206056,HepG2|chr11:65384135-65384199,chr11,65384135,65384199,1,178165
HepG2|chr11:65205971-65206090,chr11,65205971,65206090,HepG2|chr11:65384135-65384199,chr11,65384135,65384199,1,178164
HepG2|chr11:65206087-65206202,chr11,65206087,65206202,HepG2|chr11:59580562-59580592,chr11,59580562,59580592,1,5625525
HepG2|chr11:65206756-65206906,chr11,65206756,65206906,HepG2|chr11:65294807-65294847,chr11,65294807,65294847,1,88051
HepG2|chr11:65206800-65206950,chr11,65206800,65206950,HepG2|chr11:65317728-65317793,chr11,65317728,65317793,1,110928
HepG2|chr11:65206838-65206948,chr11,65206838,65206948,HepG2|chr11:65294807-65294847,chr11,65294807,65294847,1,87969
HepG2|chr11:65206917-65207002,chr11,65206917,65207002,HepG2|chr11:65317728-65317793,chr11,65317728,65317793,1,110811
HepG2|chr11:65207330-65207457,chr11,65207330,65207457,HepG2|chr11:59580569-59580592,chr11,59580569,59580592,1,5626761
HepG2|chr11:65207459-65207601,chr11,65207459,65207601,HepG2|chr11:59580562-59580595,chr11,59580562,59580595,1,5626897
HepG2|chr11:65207500-65207617,chr11,65207500,65207617,HepG2|chr11:59580562-59580591,chr11,59580562,59580591,1,5626938
HepG2|chr11:65207765-65207915,chr11,65207765,65207915,HepG2|chr11:17093062-17093131,chr11,17093062,17093131,1,48114703
HepG2|chr11:65207846-65207923,chr11,65207846,65207923,HepG2|chr11:17093062-17093131,chr11,17093062,17093131,1,48114784
HepG2|chr11:65208139-65208241,chr11,65208139,65208241,HepG2|chr11:17097793-17097820,chr11,17097793,17097820,1,48110346
HepG2|chr11:65208139-65208240,chr11,65208139,65208240,HepG2|chr11:17097793-17097820,chr11,17097793,17097820,1,48110346
HepG2|chr11:65208214-65208314,chr11,65208214,65208314,HepG2|chr11:73703906-73703952,chr11,73703906,73703952,1,8495692
HepG2|chr11:65208218-65208314,chr11,65208218,65208314,HepG2|chr11:73703906-73703952,chr11,73703906,73703952,1,8495688
HepG2|chr11:65208532-65208663,chr11,65208532,65208663,HepG2|chr11:65375050-65375069,chr11,65375050,65375069,1,166518
HepG2|chr11:65209501-65209612,chr11,65209501,65209612,HepG2|chr11:112832967-112832987,chr11,112832967,112832987,1,47623466
HepG2|chr11:65209570-65209628,chr11,65209570,65209628,HepG2|chr11:65220667-65220778,chr11,65220667,65220778,1,11097
HepG2|chr11:65209570-65209597,chr11,65209570,65209597,HepG2|chr11:65220667-65220778,chr11,65220667,65220778,1,11097
HepG2|chr11:65209584-65209612,chr11,65209584,65209612,HepG2|chr11:112832967-112832987,chr11,112832967,112832987,1,47623383
HepG2|chr11:65211642-65211775,chr11,65211642,65211775,HepG2|chr11:65223224-65223241,chr11,65223224,65223241,1,11582
HepG2|chr11:65211676-65211775,chr11,65211676,65211775,HepG2|chr11:65342052-65342073,chr11,65342052,65342073,1,130376
HepG2|chr11:65212471-65212551,chr11,65212471,65212551,HepG2|chr11:808036-808106,chr11,808036,808106,1,64404435
HepG2|chr11:65212477-65212552,chr11,65212477,65212552,HepG2|chr11:808030-808105,chr11,808030,808105,1,64404447
HepG2|chr11:65214460-65214539,chr11,65214460,65214539,HepG2|chr11:65218182-65218285,chr11,65218182,65218285,1,3722
HepG2|chr11:65266892-65266938,chr11,65266892,65266938,HepG2|chr11:62341694-62341779,chr11,62341694,62341779,1,2925198
HepG2|chr11:65267130-65267160,chr11,65267130,65267160,HepG2|chr11:107882054-107882127,chr11,107882054,107882127,1,42614924
HepG2|chr11:65267139-65267160,chr11,65267139,65267160,HepG2|chr11:107882054-107882127,chr11,107882054,107882127,1,42614915
HepG2|chr11:65267197-65267260,chr11,65267197,65267260,HepG2|chr11:117171622-117171683,chr11,117171622,117171683,1,51904425
HepG2|chr11:65267197-65267253,chr11,65267197,65267253,HepG2|chr11:117171622-117171683,chr11,117171622,117171683,1,51904425
HepG2|chr11:65267513-65267551,chr11,65267513,65267551,HepG2|chr11:65153440-65153540,chr11,65153440,65153540,1,114073
HepG2|chr11:65267696-65267721,chr11,65267696,65267721,HepG2|chr11:66674891-66675026,chr11,66674891,66675026,1,1407195
HepG2|chr11:65267810-65267927,chr11,65267810,65267927,HepG2|chr11:68229607-68229647,chr11,68229607,68229647,1,2961797
HepG2|chr11:65267810-65267920,chr11,65267810,65267920,HepG2|chr11:68229607-68229647,chr11,68229607,68229647,1,2961797
HepG2|chr11:65267858-65267990,chr11,65267858,65267990,HepG2|chr11:121298656-121298674,chr11,121298656,121298674,1,56030798
HepG2|chr11:65267885-65268035,chr11,65267885,65268035,HepG2|chr11:94799800-94799939,chr11,94799800,94799939,1,29531915
HepG2|chr11:65267998-65268124,chr11,65267998,65268124,HepG2|chr11:121298652-121298674,chr11,121298652,121298674,1,56030654
HepG2|chr11:65267999-65268082,chr11,65267999,65268082,HepG2|chr11:66680143-66680161,chr11,66680143,66680161,1,1412144
HepG2|chr11:65267999-65268075,chr11,65267999,65268075,HepG2|chr11:66680143-66680161,chr11,66680143,66680161,1,1412144
HepG2|chr11:65268123-65268163,chr11,65268123,65268163,HepG2|chr11:9407778-9407888,chr11,9407778,9407888,1,55860345
HepG2|chr11:65268166-65268316,chr11,65268166,65268316,HepG2|chr11:9407778-9407888,chr11,9407778,9407888,1,55860388
HepG2|chr11:65268430-65268491,chr11,65268430,65268491,HepG2|chr11:68227602-68227663,chr11,68227602,68227663,1,2959172
HepG2|chr11:65268476-65268576,chr11,65268476,65268576,HepG2|chr11:14520564-14520587,chr11,14520564,14520587,1,50747912
HepG2|chr11:65268479-65268576,chr11,65268479,65268576,HepG2|chr11:118970586-118970603,chr11,118970586,118970603,1,53702107
HepG2|chr11:65268519-65268669,chr11,65268519,65268669,HepG2|chr11:14520564-14520587,chr11,14520564,14520587,1,50747955
HepG2|chr11:65268527-65268677,chr11,65268527,65268677,HepG2|chr11:107876951-107876968,chr11,107876951,107876968,1,42608424
HepG2|chr11:65268531-65268677,chr11,65268531,65268677,HepG2|chr11:14520564-14520587,chr11,14520564,14520587,1,50747967
HepG2|chr11:65268565-65268710,chr11,65268565,65268710,HepG2|chr11:14520564-14520587,chr11,14520564,14520587,1,50748001
HepG2|chr11:65268611-65268695,chr11,65268611,65268695,HepG2|chr11:14520564-14520587,chr11,14520564,14520587,1,50748047
HepG2|chr11:65268733-65268843,chr11,65268733,65268843,HepG2|chr11:93395761-93395798,chr11,93395761,93395798,1,28127028
HepG2|chr11:65268822-65268946,chr11,65268822,65268946,HepG2|chr11:118952723-118952790,chr11,118952723,118952790,1,53683901
HepG2|chr11:65268841-65268918,chr11,65268841,65268918,HepG2|chr11:93395761-93395798,chr11,93395761,93395798,1,28126920
HepG2|chr11:65268910-65268993,chr11,65268910,65268993,HepG2|chr11:118952723-118952790,chr11,118952723,118952790,1,53683813
HepG2|chr11:65269173-65269317,chr11,65269173,65269317,HepG2|chr11:108537373-108537518,chr11,108537373,108537518,1,43268200
HepG2|chr11:65269286-65269351,chr11,65269286,65269351,HepG2|chr11:66673181-66673271,chr11,66673181,66673271,1,1403895
HepG2|chr11:65269294-65269351,chr11,65269294,65269351,HepG2|chr11:66673181-66673271,chr11,66673181,66673271,1,1403887
HepG2|chr11:65269561-65269673,chr11,65269561,65269673,HepG2|chr11:93396107-93396170,chr11,93396107,93396170,1,28126546
HepG2|chr11:65269586-65269673,chr11,65269586,65269673,HepG2|chr11:93396107-93396170,chr11,93396107,93396170,1,28126521
HepG2|chr11:65269796-65269897,chr11,65269796,65269897,HepG2|chr11:118952875-118953021,chr11,118952875,118953021,1,53683079
HepG2|chr11:65270101-65270137,chr11,65270101,65270137,HepG2|chr11:66678596-66678746,chr11,66678596,66678746,1,1408495
HepG2|chr11:65270157-65270275,chr11,65270157,65270275,HepG2|chr11:78127291-78127440,chr11,78127291,78127440,1,12857134
HepG2|chr11:65270356-65270419,chr11,65270356,65270419,HepG2|chr11:67375062-67375206,chr11,67375062,67375206,1,2104706
HepG2|chr11:65270941-65271091,chr11,65270941,65271091,HepG2|chr11:82781221-82781371,chr11,82781221,82781371,1,17510280
HepG2|chr11:65271073-65271207,chr11,65271073,65271207,HepG2|chr11:65146410-65146444,chr11,65146410,65146444,1,124663
HepG2|chr11:65271073-65271189,chr11,65271073,65271189,HepG2|chr11:65146410-65146444,chr11,65146410,65146444,1,124663
HepG2|chr11:65271198-65271321,chr11,65271198,65271321,HepG2|chr11:118962712-118962862,chr11,118962712,118962862,1,53691514
HepG2|chr11:65271226-65271332,chr11,65271226,65271332,HepG2|chr11:66676460-66676488,chr11,66676460,66676488,1,1405234
HepG2|chr11:65271312-65271433,chr11,65271312,65271433,HepG2|chr11:108532163-108532184,chr11,108532163,108532184,1,43260851
HepG2|chr11:65271389-65271490,chr11,65271389,65271490,HepG2|chr11:118959037-118959082,chr11,118959037,118959082,1,53687648
HepG2|chr11:65271473-65271623,chr11,65271473,65271623,HepG2|chr11:67375410-67375535,chr11,67375410,67375535,1,2103937
HepG2|chr11:65271473-65271622,chr11,65271473,65271622,HepG2|chr11:67375410-67375535,chr11,67375410,67375535,1,2103937
HepG2|chr11:65271661-65271682,chr11,65271661,65271682,HepG2|chr11:67375410-67375535,chr11,67375410,67375535,1,2103749
HepG2|chr11:65271685-65271714,chr11,65271685,65271714,HepG2|chr11:82781863-82782007,chr11,82781863,82782007,1,17510178
HepG2|chr11:65271840-65271871,chr11,65271840,65271871,HepG2|chr11:117167966-117168066,chr11,117167966,117168066,1,51896126
HepG2|chr11:65271849-65271955,chr11,65271849,65271955,HepG2|chr11:68227603-68227647,chr11,68227603,68227647,1,2955754
HepG2|chr11:65271965-65272088,chr11,65271965,65272088,HepG2|chr11:65819321-65819339,chr11,65819321,65819339,1,547356
HepG2|chr11:65272003-65272153,chr11,65272003,65272153,HepG2|chr11:68227596-68227627,chr11,68227596,68227627,1,2955593
HepG2|chr11:65272320-65272351,chr11,65272320,65272351,HepG2|chr11:78128564-78128606,chr11,78128564,78128606,1,12856244
HepG2|chr11:65272388-65272466,chr11,65272388,65272466,HepG2|chr11:66679838-66679964,chr11,66679838,66679964,1,1407450
HepG2|chr11:65272471-65272587,chr11,65272471,65272587,HepG2|chr11:68227453-68227603,chr11,68227453,68227603,1,2954982
HepG2|chr11:65272487-65272612,chr11,65272487,65272612,HepG2|chr11:117102139-117102285,chr11,117102139,117102285,1,51829652
HepG2|chr11:65272580-65272614,chr11,65272580,65272614,HepG2|chr11:65817378-65817393,chr11,65817378,65817393,1,544798
HepG2|chr11:65272677-65272827,chr11,65272677,65272827,HepG2|chr11:117103965-117103993,chr11,117103965,117103993,1,51831288
HepG2|chr11:65272740-65272859,chr11,65272740,65272859,HepG2|chr11:117103965-117103993,chr11,117103965,117103993,1,51831225
HepG2|chr11:65272892-65273035,chr11,65272892,65273035,HepG2|chr11:118966837-118966983,chr11,118966837,118966983,1,53693945
HepG2|chr11:65272949-65273088,chr11,65272949,65273088,HepG2|chr11:67375137-67375279,chr11,67375137,67375279,1,2102188
HepG2|chr11:65272988-65273024,chr11,65272988,65273024,HepG2|chr11:102218611-102218700,chr11,102218611,102218700,1,36945623
HepG2|chr11:65273326-65273476,chr11,65273326,65273476,HepG2|chr11:124609489-124609638,chr11,124609489,124609638,1,59336163
HepG2|chr11:65535182-65535212,chr11,65535182,65535212,HepG2|chr11:65382052-65382158,chr11,65382052,65382158,1,153130
HepG2|chr11:65535182-65535207,chr11,65535182,65535207,HepG2|chr11:65382033-65382158,chr11,65382033,65382158,1,153149
HepG2|chr11:67085470-67085620,chr11,67085470,67085620,HepG2|chr11:67155005-67155029,chr11,67155005,67155029,1,69535
HepG2|chr11:67085494-67085641,chr11,67085494,67085641,HepG2|chr11:67155005-67155047,chr11,67155005,67155047,1,69511
HepG2|chr11:67085534-67085668,chr11,67085534,67085668,HepG2|chr11:67155005-67155117,chr11,67155005,67155117,1,69471
HepG2|chr11:67085541-67085668,chr11,67085541,67085668,HepG2|chr11:67155005-67155030,chr11,67155005,67155030,1,69464
HepG2|chr11:67085580-67085668,chr11,67085580,67085668,HepG2|chr11:67155005-67155022,chr11,67155005,67155022,1,69425
HepG2|chr11:67085583-67085668,chr11,67085583,67085668,HepG2|chr11:67155005-67155135,chr11,67155005,67155135,1,69422
HepG2|chr11:67085600-67085668,chr11,67085600,67085668,HepG2|chr11:67155005-67155022,chr11,67155005,67155022,1,69405
HepG2|chr11:67085602-67085668,chr11,67085602,67085668,HepG2|chr11:67155005-67155022,chr11,67155005,67155022,1,69403
HepG2|chr11:67085632-67085668,chr11,67085632,67085668,HepG2|chr11:67155005-67155030,chr11,67155005,67155030,1,69373
HepG2|chr11:67085651-67085668,chr11,67085651,67085668,HepG2|chr11:67155054-67155083,chr11,67155054,67155083,1,69403
HepG2|chr11:68091140-68091195,chr11,68091140,68091195,HepG2|chr11:102217022-102217168,chr11,102217022,102217168,1,34125882
HepG2|chr11:68103599-68103749,chr11,68103599,68103749,HepG2|chr11:105893659-105893725,chr11,105893659,105893725,1,37790060
HepG2|chr11:68103757-68103838,chr11,68103757,68103838,HepG2|chr11:105893659-105893725,chr11,105893659,105893725,1,37789902
HepG2|chr11:68103758-68103838,chr11,68103758,68103838,HepG2|chr11:105893659-105893725,chr11,105893659,105893725,1,37789901
HepG2|chr11:73578550-73578629,chr11,73578550,73578629,HepG2|chr11:73586526-73586673,chr11,73586526,73586673,1,7976
HepG2|chr11:73579673-73579766,chr11,73579673,73579766,HepG2|chr11:73586324-73586378,chr11,73586324,73586378,1,6651
HepG2|chr11:73579711-73579861,chr11,73579711,73579861,HepG2|chr11:73586324-73586378,chr11,73586324,73586378,1,6613
HepG2|chr11:74554615-74554720,chr11,74554615,74554720,HepG2|chr11:17298712-17298734,chr11,17298712,17298734,1,57255903
HepG2|chr11:74554615-74554718,chr11,74554615,74554718,HepG2|chr11:17298712-17298734,chr11,17298712,17298734,1,57255903
HepG2|chr11:74690103-74690202,chr11,74690103,74690202,HepG2|chr11:74696585-74696652,chr11,74696585,74696652,1,6482
HepG2|chr11:74690119-74690202,chr11,74690119,74690202,HepG2|chr11:74696585-74696652,chr11,74696585,74696652,1,6466
HepG2|chr11:74692964-74693049,chr11,74692964,74693049,HepG2|chr11:74696291-74696356,chr11,74696291,74696356,1,3327
HepG2|chr11:74693906-74693942,chr11,74693906,74693942,HepG2|chr11:74695747-74695841,chr11,74695747,74695841,1,1841
HepG2|chr11:74693908-74693942,chr11,74693908,74693942,HepG2|chr11:74695747-74695841,chr11,74695747,74695841,1,1839
HepG2|chr11:94800166-94800295,chr11,94800166,94800295,HepG2|chr11:94770505-94770523,chr11,94770505,94770523,1,29661
HepG2|chr11:94800988-94801079,chr11,94800988,94801079,HepG2|chr11:94772611-94772666,chr11,94772611,94772666,1,28377
HepG2|chr11:94800990-94801076,chr11,94800990,94801076,HepG2|chr11:94772611-94772666,chr11,94772611,94772666,1,28379
HepG2|chr11:95975585-95975698,chr11,95975585,95975698,HepG2|chr11:76497986-76498069,chr11,76497986,76498069,1,19477599
HepG2|chr11:95975586-95975698,chr11,95975586,95975698,HepG2|chr11:76497986-76498069,chr11,76497986,76498069,1,19477600
HepG2|chr11:95975633-95975700,chr11,95975633,95975700,HepG2|chr11:76497986-76498069,chr11,76497986,76498069,1,19477647
HepG2|chr11:101738591-101738610,chr11,101738591,101738610,HepG2|chr11:3878239-3878320,chr11,3878239,3878320,1,97860352
HepG2|chr11:101738591-101738609,chr11,101738591,101738609,HepG2|chr11:3878239-3878320,chr11,3878239,3878320,1,97860352
HepG2|chr11:101739452-101739544,chr11,101739452,101739544,HepG2|chr11:3878914-3878971,chr11,3878914,3878971,1,97860538
HepG2|chr11:101739455-101739543,chr11,101739455,101739543,HepG2|chr11:3878914-3878971,chr11,3878914,3878971,1,97860541
HepG2|chr11:101739854-101739916,chr11,101739854,101739916,HepG2|chr11:3878793-3878881,chr11,3878793,3878881,1,97861061
HepG2|chr11:101739855-101739932,chr11,101739855,101739932,HepG2|chr11:3878793-3878881,chr11,3878793,3878881,1,97861062
HepG2|chr11:101746328-101746420,chr11,101746328,101746420,HepG2|chr11:3878688-3878809,chr11,3878688,3878809,1,97867640
HepG2|chr11:101747697-101747777,chr11,101747697,101747777,HepG2|chr11:3877643-3877754,chr11,3877643,3877754,1,97870054
HepG2|chr11:101747697-101747736,chr11,101747697,101747736,HepG2|chr11:3877643-3877754,chr11,3877643,3877754,1,97870054
HepG2|chr11:101748531-101748662,chr11,101748531,101748662,HepG2|chr11:3879331-3879372,chr11,3879331,3879372,1,97869200
HepG2|chr11:101748531-101748640,chr11,101748531,101748640,HepG2|chr11:3879331-3879372,chr11,3879331,3879372,1,97869200
HepG2|chr11:101749232-101749266,chr11,101749232,101749266,HepG2|chr11:3878763-3878845,chr11,3878763,3878845,1,97870469
HepG2|chr11:101865860-101865885,chr11,101865860,101865885,HepG2|chr11:3861052-3861202,chr11,3861052,3861202,1,98004808
HepG2|chr11:101865861-101865885,chr11,101865861,101865885,HepG2|chr11:3861052-3861202,chr11,3861052,3861202,1,98004809
HepG2|chr11:102051397-102051491,chr11,102051397,102051491,HepG2|chr11:631372-631456,chr11,631372,631456,1,101420025
HepG2|chr11:102051412-102051491,chr11,102051412,102051491,HepG2|chr11:631368-631456,chr11,631368,631456,1,101420044
HepG2|chr11:102145442-102145566,chr11,102145442,102145566,HepG2|chr11:102180615-102180677,chr11,102180615,102180677,1,35173
HepG2|chr11:102145464-102145566,chr11,102145464,102145566,HepG2|chr11:102180609-102180749,chr11,102180609,102180749,1,35145
HepG2|chr11:102145479-102145566,chr11,102145479,102145566,HepG2|chr11:102180615-102180677,chr11,102180615,102180677,1,35136
HepG2|chr11:111648899-111649049,chr11,111648899,111649049,HepG2|chr11:111637519-111637592,chr11,111637519,111637592,1,11380
HepG2|chr11:111648899-111648994,chr11,111648899,111648994,HepG2|chr11:111637563-111637592,chr11,111637563,111637592,1,11336
HepG2|chr11:111648899-111648918,chr11,111648899,111648918,HepG2|chr11:111637488-111637592,chr11,111637488,111637592,1,11411
HepG2|chr11:111649327-111649389,chr11,111649327,111649389,HepG2|chr11:111639341-111639399,chr11,111639341,111639399,1,9986
HepG2|chr11:113731974-113732124,chr11,113731974,113732124,HepG2|chr11:102218855-102218875,chr11,102218855,102218875,1,11513119
HepG2|chr11:113731994-113732124,chr11,113731994,113732124,HepG2|chr11:102218855-102218875,chr11,102218855,102218875,1,11513139
HepG2|chr11:113731995-113732124,chr11,113731995,113732124,HepG2|chr11:102218855-102218875,chr11,102218855,102218875,1,11513140
HepG2|chr11:118796399-118796526,chr11,118796399,118796526,HepG2|chr11:118787841-118787928,chr11,118787841,118787928,1,8558
HepG2|chr11:118796399-118796454,chr11,118796399,118796454,HepG2|chr11:118787841-118787928,chr11,118787841,118787928,1,8558
HepG2|chr11:118796914-118796956,chr11,118796914,118796956,HepG2|chr11:118789405-118789440,chr11,118789405,118789440,1,7509
HepG2|chr11:118796914-118796952,chr11,118796914,118796952,HepG2|chr11:118780468-118780615,chr11,118780468,118780615,1,16446
HepG2|chr11:120224408-120224520,chr11,120224408,120224520,HepG2|chr11:64043067-64043096,chr11,64043067,64043096,1,56181341
HepG2|chr11:126205626-126205776,chr11,126205626,126205776,HepG2|chr11:126224648-126224763,chr11,126224648,126224763,1,19022
HepG2|chr11:126211916-126212066,chr11,126211916,126212066,HepG2|chr11:126225336-126225357,chr11,126225336,126225357,1,13420
HepG2|chr11:126211923-126212070,chr11,126211923,126212070,HepG2|chr11:126225291-126225318,chr11,126225291,126225318,1,13368
HepG2|chr11:126211931-126212081,chr11,126211931,126212081,HepG2|chr11:126225336-126225357,chr11,126225336,126225357,1,13405
HepG2|chr11:126212030-126212180,chr11,126212030,126212180,HepG2|chr11:126225336-126225412,chr11,126225336,126225412,1,13306
HepG2|chr11:126212032-126212179,chr11,126212032,126212179,HepG2|chr11:126225364-126225430,chr11,126225364,126225430,1,13332
HepG2|chr11:126212043-126212193,chr11,126212043,126212193,HepG2|chr11:126225336-126225409,chr11,126225336,126225409,1,13293
HepG2|chr11:126212046-126212098,chr11,126212046,126212098,HepG2|chr11:126225336-126225397,chr11,126225336,126225397,1,13290
HepG2|chr11:126212047-126212197,chr11,126212047,126212197,HepG2|chr11:126225336-126225398,chr11,126225336,126225398,1,13289
HepG2|chr11:126212048-126212198,chr11,126212048,126212198,HepG2|chr11:126225336-126225415,chr11,126225336,126225415,1,13288
HepG2|chr11:126212052-126212182,chr11,126212052,126212182,HepG2|chr11:126225337-126225397,chr11,126225337,126225397,1,13285
HepG2|chr11:126212054-126212204,chr11,126212054,126212204,HepG2|chr11:126225336-126225442,chr11,126225336,126225442,1,13282
HepG2|chr11:126212060-126212210,chr11,126212060,126212210,HepG2|chr11:126225336-126225396,chr11,126225336,126225396,1,13276
HepG2|chr11:126212067-126212217,chr11,126212067,126212217,HepG2|chr11:126225336-126225356,chr11,126225336,126225356,1,13269
HepG2|chr11:126212068-126212218,chr11,126212068,126212218,HepG2|chr11:126225351-126225415,chr11,126225351,126225415,1,13283
HepG2|chr11:126212072-126212218,chr11,126212072,126212218,HepG2|chr11:126225336-126225368,chr11,126225336,126225368,1,13264
HepG2|chr11:126212078-126212217,chr11,126212078,126212217,HepG2|chr11:126225336-126225374,chr11,126225336,126225374,1,13258
HepG2|chr11:126212081-126212217,chr11,126212081,126212217,HepG2|chr11:126225336-126225355,chr11,126225336,126225355,1,13255
HepG2|chr11:126212082-126212217,chr11,126212082,126212217,HepG2|chr11:126225336-126225357,chr11,126225336,126225357,1,13254
HepG2|chr11:126212084-126212217,chr11,126212084,126212217,HepG2|chr11:126225291-126225308,chr11,126225291,126225308,1,13207
HepG2|chr11:126212085-126212217,chr11,126212085,126212217,HepG2|chr11:126225336-126225374,chr11,126225336,126225374,1,13251
HepG2|chr11:126212086-126212217,chr11,126212086,126212217,HepG2|chr11:126225336-126225391,chr11,126225336,126225391,1,13250
HepG2|chr11:126212087-126212218,chr11,126212087,126212218,HepG2|chr11:126225336-126225363,chr11,126225336,126225363,1,13249
HepG2|chr11:126212087-126212217,chr11,126212087,126212217,HepG2|chr11:126225336-126225357,chr11,126225336,126225357,1,13249
HepG2|chr11:126212087-126212216,chr11,126212087,126212216,HepG2|chr11:126225336-126225397,chr11,126225336,126225397,1,13249
HepG2|chr11:126212088-126212217,chr11,126212088,126212217,HepG2|chr11:126225336-126225397,chr11,126225336,126225397,1,13248
HepG2|chr11:126212090-126212217,chr11,126212090,126212217,HepG2|chr11:126225336-126225356,chr11,126225336,126225356,1,13246
HepG2|chr11:126212091-126212217,chr11,126212091,126212217,HepG2|chr11:126225336-126225357,chr11,126225336,126225357,1,13245
HepG2|chr11:126212091-126212174,chr11,126212091,126212174,HepG2|chr11:126225336-126225427,chr11,126225336,126225427,1,13245
HepG2|chr11:126212091-126212143,chr11,126212091,126212143,HepG2|chr11:126225336-126225379,chr11,126225336,126225379,1,13245
HepG2|chr11:126212092-126212217,chr11,126212092,126212217,HepG2|chr11:126225336-126225356,chr11,126225336,126225356,1,13244
HepG2|chr11:126212094-126212217,chr11,126212094,126212217,HepG2|chr11:126225336-126225363,chr11,126225336,126225363,1,13242
HepG2|chr11:126212094-126212216,chr11,126212094,126212216,HepG2|chr11:126225387-126225415,chr11,126225387,126225415,1,13293
HepG2|chr11:126212095-126212217,chr11,126212095,126212217,HepG2|chr11:126225336-126225364,chr11,126225336,126225364,1,13241
HepG2|chr11:126212095-126212141,chr11,126212095,126212141,HepG2|chr11:126225336-126225355,chr11,126225336,126225355,1,13241
HepG2|chr11:126212096-126212217,chr11,126212096,126212217,HepG2|chr11:126225336-126225379,chr11,126225336,126225379,1,13240
HepG2|chr11:126212096-126212216,chr11,126212096,126212216,HepG2|chr11:126225387-126225415,chr11,126225387,126225415,1,13291
HepG2|chr11:126212097-126212217,chr11,126212097,126212217,HepG2|chr11:126225336-126225397,chr11,126225336,126225397,1,13239
HepG2|chr11:126212098-126212217,chr11,126212098,126212217,HepG2|chr11:126225336-126225367,chr11,126225336,126225367,1,13238
HepG2|chr11:126212099-126212217,chr11,126212099,126212217,HepG2|chr11:126225336-126225368,chr11,126225336,126225368,1,13237
HepG2|chr11:126212101-126212217,chr11,126212101,126212217,HepG2|chr11:126225336-126225434,chr11,126225336,126225434,1,13235
HepG2|chr11:126212102-126212217,chr11,126212102,126212217,HepG2|chr11:126225336-126225391,chr11,126225336,126225391,1,13234
HepG2|chr11:126212104-126212217,chr11,126212104,126212217,HepG2|chr11:126225336-126225373,chr11,126225336,126225373,1,13232
HepG2|chr11:126212105-126212217,chr11,126212105,126212217,HepG2|chr11:126225336-126225374,chr11,126225336,126225374,1,13231
HepG2|chr11:126212107-126212217,chr11,126212107,126212217,HepG2|chr11:126225336-126225357,chr11,126225336,126225357,1,13229
HepG2|chr11:126212109-126212217,chr11,126212109,126212217,HepG2|chr11:126225336-126225389,chr11,126225336,126225389,1,13227
HepG2|chr11:126212110-126212217,chr11,126212110,126212217,HepG2|chr11:126225336-126225379,chr11,126225336,126225379,1,13226
HepG2|chr11:126212110-126212216,chr11,126212110,126212216,HepG2|chr11:126225337-126225377,chr11,126225337,126225377,1,13227
HepG2|chr11:126212111-126212217,chr11,126212111,126212217,HepG2|chr11:126225336-126225377,chr11,126225336,126225377,1,13225
HepG2|chr11:126212112-126212217,chr11,126212112,126212217,HepG2|chr11:126225336-126225415,chr11,126225336,126225415,1,13224
HepG2|chr11:126212114-126212217,chr11,126212114,126212217,HepG2|chr11:126225336-126225383,chr11,126225336,126225383,1,13222
HepG2|chr11:126212118-126212217,chr11,126212118,126212217,HepG2|chr11:126225291-126225342,chr11,126225291,126225342,1,13173
HepG2|chr11:126212119-126212217,chr11,126212119,126212217,HepG2|chr11:126225336-126225369,chr11,126225336,126225369,1,13217
HepG2|chr11:126212120-126212217,chr11,126212120,126212217,HepG2|chr11:126225336-126225389,chr11,126225336,126225389,1,13216
HepG2|chr11:126212121-126212217,chr11,126212121,126212217,HepG2|chr11:126225336-126225415,chr11,126225336,126225415,1,13215
HepG2|chr11:126212122-126212217,chr11,126212122,126212217,HepG2|chr11:126225336-126225391,chr11,126225336,126225391,1,13214
HepG2|chr11:126212122-126212216,chr11,126212122,126212216,HepG2|chr11:126225387-126225443,chr11,126225387,126225443,1,13265
HepG2|chr11:126212123-126212217,chr11,126212123,126212217,HepG2|chr11:126225336-126225422,chr11,126225336,126225422,1,13213
HepG2|chr11:126212123-126212187,chr11,126212123,126212187,HepG2|chr11:126225336-126225355,chr11,126225336,126225355,1,13213
HepG2|chr11:126212124-126212217,chr11,126212124,126212217,HepG2|chr11:126225336-126225393,chr11,126225336,126225393,1,13212
HepG2|chr11:126212125-126212217,chr11,126212125,126212217,HepG2|chr11:126225336-126225395,chr11,126225336,126225395,1,13211
HepG2|chr11:126212126-126212217,chr11,126212126,126212217,HepG2|chr11:126225336-126225395,chr11,126225336,126225395,1,13210
HepG2|chr11:126212128-126212217,chr11,126212128,126212217,HepG2|chr11:126225336-126225397,chr11,126225336,126225397,1,13208
HepG2|chr11:126212129-126212217,chr11,126212129,126212217,HepG2|chr11:126225336-126225398,chr11,126225336,126225398,1,13207
HepG2|chr11:126212130-126212217,chr11,126212130,126212217,HepG2|chr11:126225336-126225396,chr11,126225336,126225396,1,13206
HepG2|chr11:126212131-126212217,chr11,126212131,126212217,HepG2|chr11:126225336-126225396,chr11,126225336,126225396,1,13205
HepG2|chr11:126212137-126212217,chr11,126212137,126212217,HepG2|chr11:126225336-126225389,chr11,126225336,126225389,1,13199
HepG2|chr11:126212140-126212217,chr11,126212140,126212217,HepG2|chr11:126225336-126225409,chr11,126225336,126225409,1,13196
HepG2|chr11:126212146-126212217,chr11,126212146,126212217,HepG2|chr11:126225336-126225415,chr11,126225336,126225415,1,13190
HepG2|chr11:126212147-126212217,chr11,126212147,126212217,HepG2|chr11:126225336-126225357,chr11,126225336,126225357,1,13189
HepG2|chr11:126212150-126212217,chr11,126212150,126212217,HepG2|chr11:126225336-126225432,chr11,126225336,126225432,1,13186
HepG2|chr11:126212153-126212217,chr11,126212153,126212217,HepG2|chr11:126225336-126225422,chr11,126225336,126225422,1,13183
HepG2|chr11:126212154-126212217,chr11,126212154,126212217,HepG2|chr11:126225336-126225355,chr11,126225336,126225355,1,13182
HepG2|chr11:126212154-126212190,chr11,126212154,126212190,HepG2|chr11:126225389-126225435,chr11,126225389,126225435,1,13235
HepG2|chr11:126212157-126212217,chr11,126212157,126212217,HepG2|chr11:126225336-126225387,chr11,126225336,126225387,1,13179
HepG2|chr11:126212159-126212217,chr11,126212159,126212217,HepG2|chr11:126225336-126225385,chr11,126225336,126225385,1,13177
HepG2|chr11:126212160-126212217,chr11,126212160,126212217,HepG2|chr11:126225336-126225398,chr11,126225336,126225398,1,13176
HepG2|chr11:126212161-126212217,chr11,126212161,126212217,HepG2|chr11:126225336-126225396,chr11,126225336,126225396,1,13175
HepG2|chr11:126212162-126212217,chr11,126212162,126212217,HepG2|chr11:126225336-126225420,chr11,126225336,126225420,1,13174
HepG2|chr11:126212163-126212217,chr11,126212163,126212217,HepG2|chr11:126225336-126225432,chr11,126225336,126225432,1,13173
HepG2|chr11:126212164-126212217,chr11,126212164,126212217,HepG2|chr11:126225336-126225420,chr11,126225336,126225420,1,13172
HepG2|chr11:126212165-126212217,chr11,126212165,126212217,HepG2|chr11:126225336-126225434,chr11,126225336,126225434,1,13171
HepG2|chr11:126212166-126212217,chr11,126212166,126212217,HepG2|chr11:126225336-126225355,chr11,126225336,126225355,1,13170
HepG2|chr11:126212167-126212217,chr11,126212167,126212217,HepG2|chr11:126225303-126225415,chr11,126225303,126225415,1,13136
HepG2|chr11:126212168-126212217,chr11,126212168,126212217,HepG2|chr11:126225336-126225415,chr11,126225336,126225415,1,13168
HepG2|chr11:126212169-126212217,chr11,126212169,126212217,HepG2|chr11:126225336-126225418,chr11,126225336,126225418,1,13167
HepG2|chr11:126212170-126212217,chr11,126212170,126212217,HepG2|chr11:126225371-126225432,chr11,126225371,126225432,1,13201
HepG2|chr11:126212171-126212217,chr11,126212171,126212217,HepG2|chr11:126225336-126225427,chr11,126225336,126225427,1,13165
HepG2|chr11:126212172-126212217,chr11,126212172,126212217,HepG2|chr11:126225291-126225396,chr11,126225291,126225396,1,13119
HepG2|chr11:126212173-126212217,chr11,126212173,126212217,HepG2|chr11:126225336-126225442,chr11,126225336,126225442,1,13163
HepG2|chr11:126212176-126212217,chr11,126212176,126212217,HepG2|chr11:126225336-126225362,chr11,126225336,126225362,1,13160
HepG2|chr11:126212177-126212217,chr11,126212177,126212217,HepG2|chr11:126225336-126225446,chr11,126225336,126225446,1,13159
HepG2|chr11:126212178-126212217,chr11,126212178,126212217,HepG2|chr11:126225336-126225412,chr11,126225336,126225412,1,13158
HepG2|chr11:126212179-126212217,chr11,126212179,126212217,HepG2|chr11:126225336-126225448,chr11,126225336,126225448,1,13157
HepG2|chr11:126212181-126212217,chr11,126212181,126212217,HepG2|chr11:126225336-126225443,chr11,126225336,126225443,1,13155
HepG2|chr11:126212182-126212217,chr11,126212182,126212217,HepG2|chr11:126225336-126225446,chr11,126225336,126225446,1,13154
HepG2|chr11:126212184-126212217,chr11,126212184,126212217,HepG2|chr11:126225336-126225432,chr11,126225336,126225432,1,13152
HepG2|chr11:126212191-126212217,chr11,126212191,126212217,HepG2|chr11:126225388-126225430,chr11,126225388,126225430,1,13197
HepG2|chr11:126212192-126212217,chr11,126212192,126212217,HepG2|chr11:126225336-126225457,chr11,126225336,126225457,1,13144
HepG2|chr11:126212193-126212217,chr11,126212193,126212217,HepG2|chr11:126225336-126225440,chr11,126225336,126225440,1,13143
HepG2|chr11:126212200-126212217,chr11,126212200,126212217,HepG2|chr11:126225336-126225415,chr11,126225336,126225415,1,13136
HepG2|chr11:126212667-126212790,chr11,126212667,126212790,HepG2|chr11:126223345-126223427,chr11,126223345,126223427,1,10678
HepG2|chr11:126212722-126212790,chr11,126212722,126212790,HepG2|chr11:126223345-126223427,chr11,126223345,126223427,1,10623
HepG2|chr11:126212849-126212957,chr11,126212849,126212957,HepG2|chr11:126225388-126225430,chr11,126225388,126225430,1,12539
HepG2|chr11:126213408-126213433,chr11,126213408,126213433,HepG2|chr11:126221889-126222014,chr11,126221889,126222014,1,8481
HepG2|chr11:126214208-126214238,chr11,126214208,126214238,HepG2|chr11:126224450-126224563,chr11,126224450,126224563,1,10242
HepG2|chr11:126214430-126214461,chr11,126214430,126214461,HepG2|chr11:126224392-126224475,chr11,126224392,126224475,1,9962
HepG2|chr11:126215741-126215796,chr11,126215741,126215796,HepG2|chr11:126220950-126221007,chr11,126220950,126221007,1,5209
HepG2|chr11:126216420-126216533,chr11,126216420,126216533,HepG2|chr11:126222137-126222177,chr11,126222137,126222177,1,5717
HepG2|chr11:126216423-126216533,chr11,126216423,126216533,HepG2|chr11:126222137-126222177,chr11,126222137,126222177,1,5714
HepG2|chr11:126217990-126218088,chr11,126217990,126218088,HepG2|chr11:126224854-126224921,chr11,126224854,126224921,1,6864
HepG2|chr11:126217990-126218073,chr11,126217990,126218073,HepG2|chr11:126224854-126224921,chr11,126224854,126224921,1,6864
HepG2|chr11:126218544-126218673,chr11,126218544,126218673,HepG2|chr11:126224687-126224708,chr11,126224687,126224708,1,6143
HepG2|chr11:126218563-126218713,chr11,126218563,126218713,HepG2|chr11:126224687-126224708,chr11,126224687,126224708,1,6124
HepG2|chr11:126218592-126218637,chr11,126218592,126218637,HepG2|chr11:126224907-126225008,chr11,126224907,126225008,1,6315
HepG2|chr11:126218592-126218635,chr11,126218592,126218635,HepG2|chr11:126224907-126225008,chr11,126224907,126225008,1,6315
HepG2|chr11:126218601-126218708,chr11,126218601,126218708,HepG2|chr11:126224676-126224730,chr11,126224676,126224730,1,6075
HepG2|chr11:126218612-126218708,chr11,126218612,126218708,HepG2|chr11:126224676-126224730,chr11,126224676,126224730,1,6064
HepG2|chr11:126218634-126218784,chr11,126218634,126218784,HepG2|chr11:126224907-126225008,chr11,126224907,126225008,1,6273
HepG2|chr11:126218636-126218784,chr11,126218636,126218784,HepG2|chr11:126224907-126225008,chr11,126224907,126225008,1,6271
HepG2|chr12:6278919-6279040,chr12,6278919,6279040,HepG2|chr12:6472126-6472155,chr12,6472126,6472155,1,193207
HepG2|chr12:6278921-6279040,chr12,6278921,6279040,HepG2|chr12:6472126-6472157,chr12,6472126,6472157,1,193205
HepG2|chr12:6402783-6402845,chr12,6402783,6402845,HepG2|chr12:6472084-6472172,chr12,6472084,6472172,1,69301
HepG2|chr12:6722035-6722085,chr12,6722035,6722085,HepG2|chr12:6721153-6721244,chr12,6721153,6721244,1,882
HepG2|chr12:6723464-6723534,chr12,6723464,6723534,HepG2|chr12:6717126-6717187,chr12,6717126,6717187,1,6338
HepG2|chr12:6723464-6723532,chr12,6723464,6723532,HepG2|chr12:6717126-6717187,chr12,6717126,6717187,1,6338
HepG2|chr12:7270534-7270624,chr12,7270534,7270624,HepG2|chr12:7281215-7281362,chr12,7281215,7281362,1,10681
HepG2|chr12:7271134-7271273,chr12,7271134,7271273,HepG2|chr12:7280783-7280804,chr12,7280783,7280804,1,9649
HepG2|chr12:7271167-7271273,chr12,7271167,7271273,HepG2|chr12:7280783-7280807,chr12,7280783,7280807,1,9616
HepG2|chr12:7271186-7271273,chr12,7271186,7271273,HepG2|chr12:7280783-7280816,chr12,7280783,7280816,1,9597
HepG2|chr12:7271202-7271273,chr12,7271202,7271273,HepG2|chr12:7280783-7280808,chr12,7280783,7280808,1,9581
HepG2|chr12:7271213-7271273,chr12,7271213,7271273,HepG2|chr12:7280783-7280810,chr12,7280783,7280810,1,9570
HepG2|chr12:7271228-7271273,chr12,7271228,7271273,HepG2|chr12:7280783-7280808,chr12,7280783,7280808,1,9555
HepG2|chr12:7271230-7271273,chr12,7271230,7271273,HepG2|chr12:7280783-7280805,chr12,7280783,7280805,1,9553
HepG2|chr12:7271233-7271273,chr12,7271233,7271273,HepG2|chr12:7280783-7280824,chr12,7280783,7280824,1,9550
HepG2|chr12:7271237-7271273,chr12,7271237,7271273,HepG2|chr12:7280783-7280813,chr12,7280783,7280813,1,9546
HepG2|chr12:7271248-7271273,chr12,7271248,7271273,HepG2|chr12:7280783-7280881,chr12,7280783,7280881,1,9535
HepG2|chr12:7271254-7271273,chr12,7271254,7271273,HepG2|chr12:7280783-7280847,chr12,7280783,7280847,1,9529
HepG2|chr12:7271256-7271273,chr12,7271256,7271273,HepG2|chr12:7280783-7280818,chr12,7280783,7280818,1,9527
HepG2|chr12:7271499-7271622,chr12,7271499,7271622,HepG2|chr12:7280783-7280808,chr12,7280783,7280808,1,9284
HepG2|chr12:7271502-7271619,chr12,7271502,7271619,HepG2|chr12:7280783-7280818,chr12,7280783,7280818,1,9281
HepG2|chr12:7271508-7271622,chr12,7271508,7271622,HepG2|chr12:7280783-7280846,chr12,7280783,7280846,1,9275
HepG2|chr12:7271516-7271540,chr12,7271516,7271540,HepG2|chr12:7280783-7280808,chr12,7280783,7280808,1,9267
HepG2|chr12:7271519-7271540,chr12,7271519,7271540,HepG2|chr12:7280783-7280819,chr12,7280783,7280819,1,9264
HepG2|chr12:7271522-7271540,chr12,7271522,7271540,HepG2|chr12:7280783-7280842,chr12,7280783,7280842,1,9261
HepG2|chr12:7271532-7271622,chr12,7271532,7271622,HepG2|chr12:7280783-7280857,chr12,7280783,7280857,1,9251
HepG2|chr12:7271535-7271622,chr12,7271535,7271622,HepG2|chr12:7280783-7280802,chr12,7280783,7280802,1,9248
HepG2|chr12:7271542-7271622,chr12,7271542,7271622,HepG2|chr12:7280783-7280854,chr12,7280783,7280854,1,9241
HepG2|chr12:7271550-7271622,chr12,7271550,7271622,HepG2|chr12:7280783-7280854,chr12,7280783,7280854,1,9233
HepG2|chr12:7271568-7271622,chr12,7271568,7271622,HepG2|chr12:7280783-7280853,chr12,7280783,7280853,1,9215
HepG2|chr12:7271576-7271622,chr12,7271576,7271622,HepG2|chr12:7280783-7280878,chr12,7280783,7280878,1,9207
HepG2|chr12:7271577-7271622,chr12,7271577,7271622,HepG2|chr12:7280783-7280854,chr12,7280783,7280854,1,9206
HepG2|chr12:7271579-7271622,chr12,7271579,7271622,HepG2|chr12:7280783-7280851,chr12,7280783,7280851,1,9204
HepG2|chr12:7271580-7271622,chr12,7271580,7271622,HepG2|chr12:7280783-7280810,chr12,7280783,7280810,1,9203
HepG2|chr12:7271584-7271622,chr12,7271584,7271622,HepG2|chr12:7280783-7280809,chr12,7280783,7280809,1,9199
HepG2|chr12:7271592-7271622,chr12,7271592,7271622,HepG2|chr12:7280783-7280809,chr12,7280783,7280809,1,9191
HepG2|chr12:7271597-7271622,chr12,7271597,7271622,HepG2|chr12:7280783-7280814,chr12,7280783,7280814,1,9186
HepG2|chr12:7271602-7271622,chr12,7271602,7271622,HepG2|chr12:7280783-7280803,chr12,7280783,7280803,1,9181
HepG2|chr12:7271996-7272146,chr12,7271996,7272146,HepG2|chr12:7280783-7280815,chr12,7280783,7280815,1,8787
HepG2|chr12:7272094-7272149,chr12,7272094,7272149,HepG2|chr12:7280783-7280847,chr12,7280783,7280847,1,8689
HepG2|chr12:7272094-7272146,chr12,7272094,7272146,HepG2|chr12:7280783-7280810,chr12,7280783,7280810,1,8689
HepG2|chr12:7272094-7272143,chr12,7272094,7272143,HepG2|chr12:7280783-7280857,chr12,7280783,7280857,1,8689
HepG2|chr12:7272094-7272136,chr12,7272094,7272136,HepG2|chr12:7280783-7280847,chr12,7280783,7280847,1,8689
HepG2|chr12:7272095-7272149,chr12,7272095,7272149,HepG2|chr12:7280783-7280813,chr12,7280783,7280813,1,8688
HepG2|chr12:7272097-7272149,chr12,7272097,7272149,HepG2|chr12:7280783-7280854,chr12,7280783,7280854,1,8686
HepG2|chr12:7272098-7272149,chr12,7272098,7272149,HepG2|chr12:7280783-7280854,chr12,7280783,7280854,1,8685
HepG2|chr12:7272098-7272142,chr12,7272098,7272142,HepG2|chr12:7280783-7280884,chr12,7280783,7280884,1,8685
HepG2|chr12:7272100-7272149,chr12,7272100,7272149,HepG2|chr12:7280783-7280810,chr12,7280783,7280810,1,8683
HepG2|chr12:7272102-7272149,chr12,7272102,7272149,HepG2|chr12:7280783-7280854,chr12,7280783,7280854,1,8681
HepG2|chr12:7272103-7272149,chr12,7272103,7272149,HepG2|chr12:7280783-7280809,chr12,7280783,7280809,1,8680
HepG2|chr12:7272107-7272149,chr12,7272107,7272149,HepG2|chr12:7280783-7280849,chr12,7280783,7280849,1,8676
HepG2|chr12:7272108-7272149,chr12,7272108,7272149,HepG2|chr12:7280783-7280854,chr12,7280783,7280854,1,8675
HepG2|chr12:7272109-7272149,chr12,7272109,7272149,HepG2|chr12:7280783-7280807,chr12,7280783,7280807,1,8674
HepG2|chr12:7272110-7272149,chr12,7272110,7272149,HepG2|chr12:7280783-7280847,chr12,7280783,7280847,1,8673
HepG2|chr12:7272110-7272145,chr12,7272110,7272145,HepG2|chr12:7280783-7280818,chr12,7280783,7280818,1,8673
HepG2|chr12:7272111-7272149,chr12,7272111,7272149,HepG2|chr12:7280783-7280847,chr12,7280783,7280847,1,8672
HepG2|chr12:7272113-7272149,chr12,7272113,7272149,HepG2|chr12:7280783-7280810,chr12,7280783,7280810,1,8670
HepG2|chr12:7272115-7272149,chr12,7272115,7272149,HepG2|chr12:7280783-7280815,chr12,7280783,7280815,1,8668
HepG2|chr12:7272116-7272149,chr12,7272116,7272149,HepG2|chr12:7280783-7280879,chr12,7280783,7280879,1,8667
HepG2|chr12:7272118-7272149,chr12,7272118,7272149,HepG2|chr12:7280783-7280854,chr12,7280783,7280854,1,8665
HepG2|chr12:7272120-7272149,chr12,7272120,7272149,HepG2|chr12:7280783-7280817,chr12,7280783,7280817,1,8663
HepG2|chr12:7272122-7272149,chr12,7272122,7272149,HepG2|chr12:7280783-7280847,chr12,7280783,7280847,1,8661
HepG2|chr12:7272125-7272149,chr12,7272125,7272149,HepG2|chr12:7280783-7280807,chr12,7280783,7280807,1,8658
HepG2|chr12:7272126-7272149,chr12,7272126,7272149,HepG2|chr12:7280783-7280847,chr12,7280783,7280847,1,8657
HepG2|chr12:7272127-7272149,chr12,7272127,7272149,HepG2|chr12:7280783-7280883,chr12,7280783,7280883,1,8656
HepG2|chr12:7272129-7272149,chr12,7272129,7272149,HepG2|chr12:7280783-7280850,chr12,7280783,7280850,1,8654
HepG2|chr12:7272132-7272149,chr12,7272132,7272149,HepG2|chr12:7280783-7280854,chr12,7280783,7280854,1,8651
HepG2|chr12:7273063-7273108,chr12,7273063,7273108,HepG2|chr12:7280783-7280847,chr12,7280783,7280847,1,7720
HepG2|chr12:7273070-7273220,chr12,7273070,7273220,HepG2|chr12:7280783-7280854,chr12,7280783,7280854,1,7713
HepG2|chr12:7273070-7273214,chr12,7273070,7273214,HepG2|chr12:7280783-7280851,chr12,7280783,7280851,1,7713
HepG2|chr12:7273070-7273213,chr12,7273070,7273213,HepG2|chr12:7280783-7280824,chr12,7280783,7280824,1,7713
HepG2|chr12:7273070-7273212,chr12,7273070,7273212,HepG2|chr12:7280783-7280874,chr12,7280783,7280874,1,7713
HepG2|chr12:7273070-7273210,chr12,7273070,7273210,HepG2|chr12:7280783-7280883,chr12,7280783,7280883,1,7713
HepG2|chr12:7273070-7273166,chr12,7273070,7273166,HepG2|chr12:7280783-7280884,chr12,7280783,7280884,1,7713
HepG2|chr12:7273074-7273222,chr12,7273074,7273222,HepG2|chr12:7280783-7280847,chr12,7280783,7280847,1,7709
HepG2|chr12:7273074-7273219,chr12,7273074,7273219,HepG2|chr12:7280783-7280810,chr12,7280783,7280810,1,7709
HepG2|chr12:7273075-7273222,chr12,7273075,7273222,HepG2|chr12:7280783-7280818,chr12,7280783,7280818,1,7708
HepG2|chr12:7273076-7273220,chr12,7273076,7273220,HepG2|chr12:7280783-7280819,chr12,7280783,7280819,1,7707
HepG2|chr12:7273077-7273190,chr12,7273077,7273190,HepG2|chr12:7280783-7280816,chr12,7280783,7280816,1,7706
HepG2|chr12:7273079-7273229,chr12,7273079,7273229,HepG2|chr12:7280783-7280871,chr12,7280783,7280871,1,7704
HepG2|chr12:7273084-7273229,chr12,7273084,7273229,HepG2|chr12:7280783-7280804,chr12,7280783,7280804,1,7699
HepG2|chr12:7273085-7273229,chr12,7273085,7273229,HepG2|chr12:7280783-7280809,chr12,7280783,7280809,1,7698
HepG2|chr12:7273086-7273229,chr12,7273086,7273229,HepG2|chr12:7280783-7280808,chr12,7280783,7280808,1,7697
HepG2|chr12:7273086-7273219,chr12,7273086,7273219,HepG2|chr12:7280783-7280878,chr12,7280783,7280878,1,7697
HepG2|chr12:7273088-7273221,chr12,7273088,7273221,HepG2|chr12:7280783-7280847,chr12,7280783,7280847,1,7695
HepG2|chr12:7273089-7273221,chr12,7273089,7273221,HepG2|chr12:7280783-7280810,chr12,7280783,7280810,1,7694
HepG2|chr12:7273090-7273229,chr12,7273090,7273229,HepG2|chr12:7280783-7280815,chr12,7280783,7280815,1,7693
HepG2|chr12:7273090-7273221,chr12,7273090,7273221,HepG2|chr12:7280783-7280854,chr12,7280783,7280854,1,7693
HepG2|chr12:7273090-7273218,chr12,7273090,7273218,HepG2|chr12:7280781-7280802,chr12,7280781,7280802,1,7691
HepG2|chr12:7273090-7273152,chr12,7273090,7273152,HepG2|chr12:7280783-7280881,chr12,7280783,7280881,1,7693
HepG2|chr12:7273091-7273221,chr12,7273091,7273221,HepG2|chr12:7280783-7280878,chr12,7280783,7280878,1,7692
HepG2|chr12:7273092-7273221,chr12,7273092,7273221,HepG2|chr12:7280783-7280804,chr12,7280783,7280804,1,7691
HepG2|chr12:7273093-7273221,chr12,7273093,7273221,HepG2|chr12:7280783-7280805,chr12,7280783,7280805,1,7690
HepG2|chr12:7273094-7273221,chr12,7273094,7273221,HepG2|chr12:7280783-7280847,chr12,7280783,7280847,1,7689
HepG2|chr12:7273095-7273221,chr12,7273095,7273221,HepG2|chr12:7280783-7280807,chr12,7280783,7280807,1,7688
HepG2|chr12:7273096-7273221,chr12,7273096,7273221,HepG2|chr12:7280783-7280808,chr12,7280783,7280808,1,7687
HepG2|chr12:7273097-7273221,chr12,7273097,7273221,HepG2|chr12:7280783-7280809,chr12,7280783,7280809,1,7686
HepG2|chr12:7273098-7273221,chr12,7273098,7273221,HepG2|chr12:7280783-7280810,chr12,7280783,7280810,1,7685
HepG2|chr12:7273098-7273220,chr12,7273098,7273220,HepG2|chr12:7280783-7280857,chr12,7280783,7280857,1,7685
HepG2|chr12:7273098-7273218,chr12,7273098,7273218,HepG2|chr12:7280781-7280815,chr12,7280781,7280815,1,7683
HepG2|chr12:7273099-7273221,chr12,7273099,7273221,HepG2|chr12:7280783-7280811,chr12,7280783,7280811,1,7684
HepG2|chr12:7273100-7273221,chr12,7273100,7273221,HepG2|chr12:7280783-7280811,chr12,7280783,7280811,1,7683
HepG2|chr12:7273100-7273170,chr12,7273100,7273170,HepG2|chr12:7280783-7280879,chr12,7280783,7280879,1,7683
HepG2|chr12:7273101-7273221,chr12,7273101,7273221,HepG2|chr12:7280783-7280820,chr12,7280783,7280820,1,7682
HepG2|chr12:7273102-7273221,chr12,7273102,7273221,HepG2|chr12:7280783-7280810,chr12,7280783,7280810,1,7681
HepG2|chr12:7273102-7273218,chr12,7273102,7273218,HepG2|chr12:7280781-7280815,chr12,7280781,7280815,1,7679
HepG2|chr12:7273103-7273229,chr12,7273103,7273229,HepG2|chr12:7280783-7280853,chr12,7280783,7280853,1,7680
HepG2|chr12:7273103-7273221,chr12,7273103,7273221,HepG2|chr12:7280783-7280815,chr12,7280783,7280815,1,7680
HepG2|chr12:7273103-7273215,chr12,7273103,7273215,HepG2|chr12:7280783-7280854,chr12,7280783,7280854,1,7680
HepG2|chr12:7273104-7273221,chr12,7273104,7273221,HepG2|chr12:7280783-7280887,chr12,7280783,7280887,1,7679
HepG2|chr12:7273105-7273221,chr12,7273105,7273221,HepG2|chr12:7280783-7280808,chr12,7280783,7280808,1,7678
HepG2|chr12:7273105-7273219,chr12,7273105,7273219,HepG2|chr12:7280783-7280853,chr12,7280783,7280853,1,7678
HepG2|chr12:7273106-7273222,chr12,7273106,7273222,HepG2|chr12:7280783-7280808,chr12,7280783,7280808,1,7677
HepG2|chr12:7273106-7273221,chr12,7273106,7273221,HepG2|chr12:7280783-7280854,chr12,7280783,7280854,1,7677
HepG2|chr12:7273106-7273218,chr12,7273106,7273218,HepG2|chr12:7280781-7280819,chr12,7280781,7280819,1,7675
HepG2|chr12:7273106-7273138,chr12,7273106,7273138,HepG2|chr12:7280783-7280854,chr12,7280783,7280854,1,7677
HepG2|chr12:7273107-7273221,chr12,7273107,7273221,HepG2|chr12:7280783-7280818,chr12,7280783,7280818,1,7676
HepG2|chr12:7273108-7273221,chr12,7273108,7273221,HepG2|chr12:7280783-7280820,chr12,7280783,7280820,1,7675
HepG2|chr12:7273109-7273229,chr12,7273109,7273229,HepG2|chr12:7280783-7280807,chr12,7280783,7280807,1,7674
HepG2|chr12:7273109-7273221,chr12,7273109,7273221,HepG2|chr12:7280783-7280815,chr12,7280783,7280815,1,7674
HepG2|chr12:7273109-7273202,chr12,7273109,7273202,HepG2|chr12:7280783-7280818,chr12,7280783,7280818,1,7674
HepG2|chr12:7273109-7273199,chr12,7273109,7273199,HepG2|chr12:7280783-7280818,chr12,7280783,7280818,1,7674
HepG2|chr12:7273110-7273221,chr12,7273110,7273221,HepG2|chr12:7280783-7280805,chr12,7280783,7280805,1,7673
HepG2|chr12:7273112-7273221,chr12,7273112,7273221,HepG2|chr12:7280783-7280824,chr12,7280783,7280824,1,7671
HepG2|chr12:7273113-7273221,chr12,7273113,7273221,HepG2|chr12:7280783-7280818,chr12,7280783,7280818,1,7670
HepG2|chr12:7273114-7273221,chr12,7273114,7273221,HepG2|chr12:7280783-7280884,chr12,7280783,7280884,1,7669
HepG2|chr12:7273116-7273221,chr12,7273116,7273221,HepG2|chr12:7280783-7280828,chr12,7280783,7280828,1,7667
HepG2|chr12:7273117-7273221,chr12,7273117,7273221,HepG2|chr12:7280783-7280808,chr12,7280783,7280808,1,7666
HepG2|chr12:7273118-7273222,chr12,7273118,7273222,HepG2|chr12:7279426-7279522,chr12,7279426,7279522,1,6308
HepG2|chr12:7273118-7273221,chr12,7273118,7273221,HepG2|chr12:7280781-7280847,chr12,7280781,7280847,1,7663
HepG2|chr12:7273118-7273188,chr12,7273118,7273188,HepG2|chr12:7280783-7280883,chr12,7280783,7280883,1,7665
HepG2|chr12:7273119-7273221,chr12,7273119,7273221,HepG2|chr12:7280252-7280402,chr12,7280252,7280402,1,7133
HepG2|chr12:7273120-7273221,chr12,7273120,7273221,HepG2|chr12:7280783-7280832,chr12,7280783,7280832,1,7663
HepG2|chr12:7273121-7273221,chr12,7273121,7273221,HepG2|chr12:7280783-7280833,chr12,7280783,7280833,1,7662
HepG2|chr12:7273122-7273221,chr12,7273122,7273221,HepG2|chr12:7280783-7280854,chr12,7280783,7280854,1,7661
HepG2|chr12:7273122-7273218,chr12,7273122,7273218,HepG2|chr12:7280781-7280834,chr12,7280781,7280834,1,7659
HepG2|chr12:7273123-7273221,chr12,7273123,7273221,HepG2|chr12:7280783-7280881,chr12,7280783,7280881,1,7660
HepG2|chr12:7273124-7273176,chr12,7273124,7273176,HepG2|chr12:7280783-7280817,chr12,7280783,7280817,1,7659
HepG2|chr12:7273125-7273221,chr12,7273125,7273221,HepG2|chr12:7280783-7280883,chr12,7280783,7280883,1,7658
HepG2|chr12:7273125-7273170,chr12,7273125,7273170,HepG2|chr12:7280783-7280808,chr12,7280783,7280808,1,7658
HepG2|chr12:7273126-7273221,chr12,7273126,7273221,HepG2|chr12:7280783-7280815,chr12,7280783,7280815,1,7657
HepG2|chr12:7273127-7273221,chr12,7273127,7273221,HepG2|chr12:7280783-7280839,chr12,7280783,7280839,1,7656
HepG2|chr12:7273128-7273228,chr12,7273128,7273228,HepG2|chr12:7280783-7280808,chr12,7280783,7280808,1,7655
HepG2|chr12:7273128-7273221,chr12,7273128,7273221,HepG2|chr12:7280783-7280883,chr12,7280783,7280883,1,7655
HepG2|chr12:7273128-7273218,chr12,7273128,7273218,HepG2|chr12:7280781-7280810,chr12,7280781,7280810,1,7653
HepG2|chr12:7273129-7273221,chr12,7273129,7273221,HepG2|chr12:7280783-7280840,chr12,7280783,7280840,1,7654
HepG2|chr12:7273130-7273221,chr12,7273130,7273221,HepG2|chr12:7280783-7280857,chr12,7280783,7280857,1,7653
HepG2|chr12:7273131-7273221,chr12,7273131,7273221,HepG2|chr12:7280783-7280884,chr12,7280783,7280884,1,7652
HepG2|chr12:7273133-7273221,chr12,7273133,7273221,HepG2|chr12:7280783-7280808,chr12,7280783,7280808,1,7650
HepG2|chr12:7273134-7273221,chr12,7273134,7273221,HepG2|chr12:7280783-7280846,chr12,7280783,7280846,1,7649
HepG2|chr12:7273134-7273218,chr12,7273134,7273218,HepG2|chr12:7280781-7280847,chr12,7280781,7280847,1,7647
HepG2|chr12:7273135-7273221,chr12,7273135,7273221,HepG2|chr12:7280783-7280847,chr12,7280783,7280847,1,7648
HepG2|chr12:7273136-7273221,chr12,7273136,7273221,HepG2|chr12:7280783-7280847,chr12,7280783,7280847,1,7647
HepG2|chr12:7273137-7273221,chr12,7273137,7273221,HepG2|chr12:7280783-7280849,chr12,7280783,7280849,1,7646
HepG2|chr12:7273138-7273221,chr12,7273138,7273221,HepG2|chr12:7280783-7280851,chr12,7280783,7280851,1,7645
HepG2|chr12:7273139-7273221,chr12,7273139,7273221,HepG2|chr12:7280783-7280849,chr12,7280783,7280849,1,7644
HepG2|chr12:7273140-7273221,chr12,7273140,7273221,HepG2|chr12:7280783-7280857,chr12,7280783,7280857,1,7643
HepG2|chr12:7273141-7273221,chr12,7273141,7273221,HepG2|chr12:7280783-7280851,chr12,7280783,7280851,1,7642
HepG2|chr12:7273142-7273221,chr12,7273142,7273221,HepG2|chr12:7280783-7280851,chr12,7280783,7280851,1,7641
HepG2|chr12:7273143-7273221,chr12,7273143,7273221,HepG2|chr12:7280783-7280854,chr12,7280783,7280854,1,7640
HepG2|chr12:7273144-7273229,chr12,7273144,7273229,HepG2|chr12:7280783-7280878,chr12,7280783,7280878,1,7639
HepG2|chr12:7273144-7273221,chr12,7273144,7273221,HepG2|chr12:7280783-7280854,chr12,7280783,7280854,1,7639
HepG2|chr12:7273145-7273221,chr12,7273145,7273221,HepG2|chr12:7280783-7280857,chr12,7280783,7280857,1,7638
HepG2|chr12:7273146-7273221,chr12,7273146,7273221,HepG2|chr12:7280783-7280857,chr12,7280783,7280857,1,7637
HepG2|chr12:7273147-7273221,chr12,7273147,7273221,HepG2|chr12:7280783-7280859,chr12,7280783,7280859,1,7636
HepG2|chr12:7273148-7273221,chr12,7273148,7273221,HepG2|chr12:7280783-7280878,chr12,7280783,7280878,1,7635
HepG2|chr12:7273149-7273221,chr12,7273149,7273221,HepG2|chr12:7280783-7280882,chr12,7280783,7280882,1,7634
HepG2|chr12:7273150-7273221,chr12,7273150,7273221,HepG2|chr12:7280783-7280853,chr12,7280783,7280853,1,7633
HepG2|chr12:7273151-7273221,chr12,7273151,7273221,HepG2|chr12:7280783-7280854,chr12,7280783,7280854,1,7632
HepG2|chr12:7273152-7273221,chr12,7273152,7273221,HepG2|chr12:7280783-7280864,chr12,7280783,7280864,1,7631
HepG2|chr12:7273153-7273221,chr12,7273153,7273221,HepG2|chr12:7280783-7280865,chr12,7280783,7280865,1,7630
HepG2|chr12:7273154-7273221,chr12,7273154,7273221,HepG2|chr12:7280783-7280848,chr12,7280783,7280848,1,7629
HepG2|chr12:7273155-7273221,chr12,7273155,7273221,HepG2|chr12:7280783-7280854,chr12,7280783,7280854,1,7628
HepG2|chr12:7273156-7273221,chr12,7273156,7273221,HepG2|chr12:7280783-7280854,chr12,7280783,7280854,1,7627
HepG2|chr12:7273157-7273221,chr12,7273157,7273221,HepG2|chr12:7280783-7280854,chr12,7280783,7280854,1,7626
HepG2|chr12:7273158-7273221,chr12,7273158,7273221,HepG2|chr12:7280783-7280870,chr12,7280783,7280870,1,7625
HepG2|chr12:7273159-7273221,chr12,7273159,7273221,HepG2|chr12:7280783-7280853,chr12,7280783,7280853,1,7624
HepG2|chr12:7273160-7273221,chr12,7273160,7273221,HepG2|chr12:7280783-7280851,chr12,7280783,7280851,1,7623
HepG2|chr12:7273161-7273221,chr12,7273161,7273221,HepG2|chr12:7280783-7280883,chr12,7280783,7280883,1,7622
HepG2|chr12:7273162-7273221,chr12,7273162,7273221,HepG2|chr12:7280783-7280862,chr12,7280783,7280862,1,7621
HepG2|chr12:7273163-7273221,chr12,7273163,7273221,HepG2|chr12:7280783-7280872,chr12,7280783,7280872,1,7620
HepG2|chr12:7273163-7273201,chr12,7273163,7273201,HepG2|chr12:7280783-7280883,chr12,7280783,7280883,1,7620
HepG2|chr12:7273164-7273221,chr12,7273164,7273221,HepG2|chr12:7280783-7280854,chr12,7280783,7280854,1,7619
HepG2|chr12:7273165-7273221,chr12,7273165,7273221,HepG2|chr12:7280783-7280851,chr12,7280783,7280851,1,7618
HepG2|chr12:7273166-7273221,chr12,7273166,7273221,HepG2|chr12:7280783-7280878,chr12,7280783,7280878,1,7617
HepG2|chr12:7273167-7273221,chr12,7273167,7273221,HepG2|chr12:7280783-7280878,chr12,7280783,7280878,1,7616
HepG2|chr12:7273168-7273221,chr12,7273168,7273221,HepG2|chr12:7280783-7280878,chr12,7280783,7280878,1,7615
HepG2|chr12:7273168-7273219,chr12,7273168,7273219,HepG2|chr12:7280786-7280846,chr12,7280786,7280846,1,7618
HepG2|chr12:7273169-7273221,chr12,7273169,7273221,HepG2|chr12:7280783-7280878,chr12,7280783,7280878,1,7614
HepG2|chr12:7273171-7273221,chr12,7273171,7273221,HepG2|chr12:7280783-7280878,chr12,7280783,7280878,1,7612
HepG2|chr12:7273171-7273218,chr12,7273171,7273218,HepG2|chr12:7280781-7280883,chr12,7280781,7280883,1,7610
HepG2|chr12:7273172-7273221,chr12,7273172,7273221,HepG2|chr12:7280783-7280878,chr12,7280783,7280878,1,7611
HepG2|chr12:7273172-7273219,chr12,7273172,7273219,HepG2|chr12:7280786-7280846,chr12,7280786,7280846,1,7614
HepG2|chr12:7273173-7273221,chr12,7273173,7273221,HepG2|chr12:7280783-7280862,chr12,7280783,7280862,1,7610
HepG2|chr12:7273173-7273220,chr12,7273173,7273220,HepG2|chr12:7280782-7280881,chr12,7280782,7280881,1,7609
HepG2|chr12:7273173-7273218,chr12,7273173,7273218,HepG2|chr12:7280781-7280858,chr12,7280781,7280858,1,7608
HepG2|chr12:7273174-7273221,chr12,7273174,7273221,HepG2|chr12:7280783-7280883,chr12,7280783,7280883,1,7609
HepG2|chr12:7273174-7273218,chr12,7273174,7273218,HepG2|chr12:7280781-7280883,chr12,7280781,7280883,1,7607
HepG2|chr12:7273175-7273221,chr12,7273175,7273221,HepG2|chr12:7280783-7280884,chr12,7280783,7280884,1,7608
HepG2|chr12:7273175-7273218,chr12,7273175,7273218,HepG2|chr12:7280781-7280888,chr12,7280781,7280888,1,7606
HepG2|chr12:7273176-7273221,chr12,7273176,7273221,HepG2|chr12:7280783-7280878,chr12,7280783,7280878,1,7607
HepG2|chr12:7273177-7273221,chr12,7273177,7273221,HepG2|chr12:7280783-7280878,chr12,7280783,7280878,1,7606
HepG2|chr12:7273178-7273221,chr12,7273178,7273221,HepG2|chr12:7280783-7280884,chr12,7280783,7280884,1,7605
HepG2|chr12:7273180-7273229,chr12,7273180,7273229,HepG2|chr12:7280783-7280883,chr12,7280783,7280883,1,7603
HepG2|chr12:7273180-7273221,chr12,7273180,7273221,HepG2|chr12:7280783-7280853,chr12,7280783,7280853,1,7603
HepG2|chr12:7273181-7273221,chr12,7273181,7273221,HepG2|chr12:7280783-7280879,chr12,7280783,7280879,1,7602
HepG2|chr12:7273182-7273221,chr12,7273182,7273221,HepG2|chr12:7280783-7280854,chr12,7280783,7280854,1,7601
HepG2|chr12:7273183-7273221,chr12,7273183,7273221,HepG2|chr12:7280783-7280867,chr12,7280783,7280867,1,7600
HepG2|chr12:7273185-7273221,chr12,7273185,7273221,HepG2|chr12:7280783-7280886,chr12,7280783,7280886,1,7598
HepG2|chr12:7273187-7273221,chr12,7273187,7273221,HepG2|chr12:7280783-7280809,chr12,7280783,7280809,1,7596
HepG2|chr12:7273188-7273221,chr12,7273188,7273221,HepG2|chr12:7280783-7280878,chr12,7280783,7280878,1,7595
HepG2|chr12:7273189-7273221,chr12,7273189,7273221,HepG2|chr12:7280783-7280854,chr12,7280783,7280854,1,7594
HepG2|chr12:7273190-7273221,chr12,7273190,7273221,HepG2|chr12:7280244-7280373,chr12,7280244,7280373,1,7054
HepG2|chr12:7273191-7273222,chr12,7273191,7273222,HepG2|chr12:7280782-7280843,chr12,7280782,7280843,1,7591
HepG2|chr12:7273191-7273221,chr12,7273191,7273221,HepG2|chr12:7280783-7280843,chr12,7280783,7280843,1,7592
HepG2|chr12:7273192-7273221,chr12,7273192,7273221,HepG2|chr12:7280783-7280883,chr12,7280783,7280883,1,7591
HepG2|chr12:7273194-7273221,chr12,7273194,7273221,HepG2|chr12:7280783-7280884,chr12,7280783,7280884,1,7589
HepG2|chr12:7273195-7273221,chr12,7273195,7273221,HepG2|chr12:7280980-7281130,chr12,7280980,7281130,1,7785
HepG2|chr12:7273196-7273218,chr12,7273196,7273218,HepG2|chr12:7280781-7280824,chr12,7280781,7280824,1,7585
HepG2|chr12:7273197-7273221,chr12,7273197,7273221,HepG2|chr12:7280783-7280879,chr12,7280783,7280879,1,7586
HepG2|chr12:7273198-7273221,chr12,7273198,7273221,HepG2|chr12:7280783-7280882,chr12,7280783,7280882,1,7585
HepG2|chr12:7273200-7273221,chr12,7273200,7273221,HepG2|chr12:7280783-7280883,chr12,7280783,7280883,1,7583
HepG2|chr12:7273201-7273221,chr12,7273201,7273221,HepG2|chr12:7280783-7280818,chr12,7280783,7280818,1,7582
HepG2|chr12:7273202-7273221,chr12,7273202,7273221,HepG2|chr12:7280755-7280888,chr12,7280755,7280888,1,7553
HepG2|chr12:7273370-7273519,chr12,7273370,7273519,HepG2|chr12:7279525-7279630,chr12,7279525,7279630,1,6155
HepG2|chr12:7273474-7273519,chr12,7273474,7273519,HepG2|chr12:7279525-7279630,chr12,7279525,7279630,1,6051
HepG2|chr12:7273746-7273765,chr12,7273746,7273765,HepG2|chr12:7284140-7284228,chr12,7284140,7284228,1,10394
HepG2|chr12:7274445-7274464,chr12,7274445,7274464,HepG2|chr12:7284487-7284605,chr12,7284487,7284605,1,10042
HepG2|chr12:7274759-7274806,chr12,7274759,7274806,HepG2|chr12:7278377-7278480,chr12,7278377,7278480,1,3618
HepG2|chr12:7274763-7274848,chr12,7274763,7274848,HepG2|chr12:7278377-7278480,chr12,7278377,7278480,1,3614
HepG2|chr12:9437035-9437150,chr12,9437035,9437150,HepG2|chr12:31227657-31227729,chr12,31227657,31227729,1,21790622
HepG2|chr12:9437605-9437754,chr12,9437605,9437754,HepG2|chr12:31228083-31228233,chr12,31228083,31228233,1,21790478
HepG2|chr12:9437612-9437725,chr12,9437612,9437725,HepG2|chr12:31228007-31228152,chr12,31228007,31228152,1,21790395
HepG2|chr12:9567352-9567477,chr12,9567352,9567477,HepG2|chr12:31260514-31260539,chr12,31260514,31260539,1,21693162
HepG2|chr12:9567927-9568076,chr12,9567927,9568076,HepG2|chr12:31259982-31260132,chr12,31259982,31260132,1,21692055
HepG2|chr12:12692623-12692659,chr12,12692623,12692659,HepG2|chr12:12765944-12766094,chr12,12765944,12766094,1,73321
HepG2|chr12:14899573-14899717,chr12,14899573,14899717,HepG2|chr12:14922833-14922856,chr12,14922833,14922856,1,23260
HepG2|chr12:14899588-14899715,chr12,14899588,14899715,HepG2|chr12:14922833-14922856,chr12,14922833,14922856,1,23245
HepG2|chr12:14899639-14899715,chr12,14899639,14899715,HepG2|chr12:14922833-14922935,chr12,14922833,14922935,1,23194
HepG2|chr12:14899677-14899715,chr12,14899677,14899715,HepG2|chr12:14922833-14922935,chr12,14922833,14922935,1,23156
HepG2|chr12:14899693-14899715,chr12,14899693,14899715,HepG2|chr12:14921872-14921943,chr12,14921872,14921943,1,22179
HepG2|chr12:14903625-14903740,chr12,14903625,14903740,HepG2|chr12:14921872-14921938,chr12,14921872,14921938,1,18247
HepG2|chr12:14903649-14903717,chr12,14903649,14903717,HepG2|chr12:14922833-14922882,chr12,14922833,14922882,1,19184
HepG2|chr12:14903656-14903740,chr12,14903656,14903740,HepG2|chr12:14921872-14921938,chr12,14921872,14921938,1,18216
HepG2|chr12:14903667-14903717,chr12,14903667,14903717,HepG2|chr12:14921872-14921938,chr12,14921872,14921938,1,18205
HepG2|chr12:14903687-14903717,chr12,14903687,14903717,HepG2|chr12:14921872-14921943,chr12,14921872,14921943,1,18185
HepG2|chr12:46777960-46778054,chr12,46777960,46778054,HepG2|chr12:46763200-46763237,chr12,46763200,46763237,1,14760
HepG2|chr12:46777960-46778053,chr12,46777960,46778053,HepG2|chr12:46763200-46763237,chr12,46763200,46763237,1,14760
HepG2|chr12:46789077-46789178,chr12,46789077,46789178,HepG2|chr12:46761317-46761363,chr12,46761317,46761363,1,27760
HepG2|chr12:46789102-46789252,chr12,46789102,46789252,HepG2|chr12:46761317-46761363,chr12,46761317,46761363,1,27785
HepG2|chr12:46835799-46835850,chr12,46835799,46835850,HepG2|chr12:46761938-46762059,chr12,46761938,46762059,1,73861
HepG2|chr12:46835821-46835850,chr12,46835821,46835850,HepG2|chr12:46761938-46762059,chr12,46761938,46762059,1,73883
HepG2|chr12:48264790-48264927,chr12,48264790,48264927,HepG2|chr12:52444493-52444634,chr12,52444493,52444634,1,4179703
HepG2|chr12:49815723-49815786,chr12,49815723,49815786,HepG2|chr12:866223-866367,chr12,866223,866367,1,48949500
HepG2|chr12:51173010-51173059,chr12,51173010,51173059,HepG2|chr12:51418602-51418686,chr12,51418602,51418686,1,245592
HepG2|chr12:51174123-51174246,chr12,51174123,51174246,HepG2|chr12:51422204-51422226,chr12,51422204,51422226,1,248081
HepG2|chr12:51176045-51176165,chr12,51176045,51176165,HepG2|chr12:51156342-51156446,chr12,51156342,51156446,1,19703
HepG2|chr12:51176045-51176097,chr12,51176045,51176097,HepG2|chr12:51156342-51156446,chr12,51156342,51156446,1,19703
HepG2|chr12:51176049-51176165,chr12,51176049,51176165,HepG2|chr12:51156342-51156440,chr12,51156342,51156440,1,19707
HepG2|chr12:56297946-56298003,chr12,56297946,56298003,HepG2|chr12:56394821-56394868,chr12,56394821,56394868,1,96875
HepG2|chr12:56970732-56970839,chr12,56970732,56970839,HepG2|chr12:64234473-64234490,chr12,64234473,64234490,1,7263741
HepG2|chr12:56970775-56970839,chr12,56970775,56970839,HepG2|chr12:64234470-64234490,chr12,64234470,64234490,1,7263695
HepG2|chr12:57069908-57070031,chr12,57069908,57070031,HepG2|chr12:27672896-27672917,chr12,27672896,27672917,1,29397012
HepG2|chr12:57069929-57070030,chr12,57069929,57070030,HepG2|chr12:27672896-27672917,chr12,27672896,27672917,1,29397033
HepG2|chr12:64284895-64284925,chr12,64284895,64284925,HepG2|chr12:54392020-54392117,chr12,54392020,54392117,1,9892875
HepG2|chr12:69175373-69175510,chr12,69175373,69175510,HepG2|chr12:69201671-69201821,chr12,69201671,69201821,1,26298
HepG2|chr12:69176127-69176239,chr12,69176127,69176239,HepG2|chr12:69201622-69201660,chr12,69201622,69201660,1,25495
HepG2|chr12:69176222-69176239,chr12,69176222,69176239,HepG2|chr12:69201634-69201780,chr12,69201634,69201780,1,25412
HepG2|chr12:76432916-76432977,chr12,76432916,76432977,HepG2|chr12:76432623-76432773,chr12,76432623,76432773,1,293
HepG2|chr12:76433117-76433207,chr12,76433117,76433207,HepG2|chr12:76432093-76432121,chr12,76432093,76432121,1,1024
HepG2|chr12:76433117-76433206,chr12,76433117,76433206,HepG2|chr12:76432093-76432121,chr12,76432093,76432121,1,1024
HepG2|chr12:76433175-76433244,chr12,76433175,76433244,HepG2|chr12:76432429-76432509,chr12,76432429,76432509,1,746
HepG2|chr12:76433303-76433364,chr12,76433303,76433364,HepG2|chr12:76429392-76429462,chr12,76429392,76429462,1,3911
HepG2|chr12:76433306-76433419,chr12,76433306,76433419,HepG2|chr12:76429392-76429462,chr12,76429392,76429462,1,3914
HepG2|chr12:88949794-88949823,chr12,88949794,88949823,HepG2|chr12:54390378-54390522,chr12,54390378,54390522,1,34559416
HepG2|chr12:89759961-89760055,chr12,89759961,89760055,HepG2|chr12:89748812-89748906,chr12,89748812,89748906,1,11149
HepG2|chr12:89759999-89760055,chr12,89759999,89760055,HepG2|chr12:89748812-89748906,chr12,89748812,89748906,1,11187
HepG2|chr12:89762145-89762266,chr12,89762145,89762266,HepG2|chr12:89750717-89750746,chr12,89750717,89750746,1,11428
HepG2|chr12:89762167-89762313,chr12,89762167,89762313,HepG2|chr12:89750717-89750746,chr12,89750717,89750746,1,11450
HepG2|chr12:89762281-89762363,chr12,89762281,89762363,HepG2|chr12:89749678-89749739,chr12,89749678,89749739,1,12603
HepG2|chr12:89762350-89762459,chr12,89762350,89762459,HepG2|chr12:89749493-89749531,chr12,89749493,89749531,1,12857
HepG2|chr12:89762370-89762520,chr12,89762370,89762520,HepG2|chr12:89749493-89749531,chr12,89749493,89749531,1,12877
HepG2|chr12:89764159-89764266,chr12,89764159,89764266,HepG2|chr12:89750783-89750933,chr12,89750783,89750933,1,13376
HepG2|chr12:93477351-93477440,chr12,93477351,93477440,HepG2|chr12:56510579-56510613,chr12,56510579,56510613,1,36966772
HepG2|chr12:93477358-93477430,chr12,93477358,93477430,HepG2|chr12:56510569-56510647,chr12,56510569,56510647,1,36966789
HepG2|chr12:120126812-120126904,chr12,120126812,120126904,HepG2|chr12:53616208-53616266,chr12,53616208,53616266,1,66510604
HepG2|chr12:120127024-120127072,chr12,120127024,120127072,HepG2|chr12:53616208-53616266,chr12,53616208,53616266,1,66510816
HepG2|chr12:120729166-120729216,chr12,120729166,120729216,HepG2|chr12:53774610-53774728,chr12,53774610,53774728,1,66954556
HepG2|chr12:120729166-120729210,chr12,120729166,120729210,HepG2|chr12:53774614-53774718,chr12,53774614,53774718,1,66954552
HepG2|chr12:120729166-120729209,chr12,120729166,120729209,HepG2|chr12:53774590-53774728,chr12,53774590,53774728,1,66954576
HepG2|chr12:120729166-120729188,chr12,120729166,120729188,HepG2|chr12:53774610-53774724,chr12,53774610,53774724,1,66954556
HepG2|chr12:122503684-122503764,chr12,122503684,122503764,HepG2|chr12:122512935-122512990,chr12,122512935,122512990,1,9251
HepG2|chr12:122507057-122507203,chr12,122507057,122507203,HepG2|chr12:122513327-122513459,chr12,122513327,122513459,1,6270
HepG2|chr12:122507377-122507514,chr12,122507377,122507514,HepG2|chr12:122514211-122514290,chr12,122514211,122514290,1,6834
HepG2|chr12:122507467-122507535,chr12,122507467,122507535,HepG2|chr12:122514211-122514290,chr12,122514211,122514290,1,6744
HepG2|chr12:123587697-123587847,chr12,123587697,123587847,HepG2|chr12:123379344-123379395,chr12,123379344,123379395,1,208353
HepG2|chr12:123587749-123587848,chr12,123587749,123587848,HepG2|chr12:123379344-123379395,chr12,123379344,123379395,1,208405
HepG2|chr12:123954926-123955038,chr12,123954926,123955038,HepG2|chr12:31798282-31798324,chr12,31798282,31798324,1,92156644
HepG2|chr12:123954931-123955020,chr12,123954931,123955020,HepG2|chr12:31798282-31798323,chr12,31798282,31798323,1,92156649
HepG2|chr12:124078345-124078423,chr12,124078345,124078423,HepG2|chr12:124085659-124085809,chr12,124085659,124085809,1,7314
HepG2|chr12:124078989-124079110,chr12,124078989,124079110,HepG2|chr12:124085462-124085491,chr12,124085462,124085491,1,6473
HepG2|chr12:124079016-124079166,chr12,124079016,124079166,HepG2|chr12:124085462-124085491,chr12,124085462,124085491,1,6446
HepG2|chr12:124079070-124079159,chr12,124079070,124079159,HepG2|chr12:124085727-124085832,chr12,124085727,124085832,1,6657
HepG2|chr12:124079075-124079120,chr12,124079075,124079120,HepG2|chr12:124085727-124085832,chr12,124085727,124085832,1,6652
HepG2|chr12:124079834-124079905,chr12,124079834,124079905,HepG2|chr12:124084050-124084200,chr12,124084050,124084200,1,4216
HepG2|chr12:124316339-124316443,chr12,124316339,124316443,HepG2|chr12:124085916-124085947,chr12,124085916,124085947,1,230423
HepG2|chr12:124993883-124994032,chr12,124993883,124994032,HepG2|chr12:6492421-6492571,chr12,6492421,6492571,1,118501462
HepG2|chr13:20176059-20176190,chr13,20176059,20176190,HepG2|chr13:20207759-20207809,chr13,20207759,20207809,1,31700
HepG2|chr13:20176085-20176235,chr13,20176085,20176235,HepG2|chr13:20207759-20207809,chr13,20207759,20207809,1,31674
HepG2|chr13:20176134-20176278,chr13,20176134,20176278,HepG2|chr13:20207759-20207807,chr13,20207759,20207807,1,31625
HepG2|chr13:20176156-20176296,chr13,20176156,20176296,HepG2|chr13:20203697-20203752,chr13,20203697,20203752,1,27541
HepG2|chr13:20176165-20176295,chr13,20176165,20176295,HepG2|chr13:20207759-20207779,chr13,20207759,20207779,1,31594
HepG2|chr13:20176167-20176295,chr13,20176167,20176295,HepG2|chr13:20207759-20207809,chr13,20207759,20207809,1,31592
HepG2|chr13:20176168-20176295,chr13,20176168,20176295,HepG2|chr13:20207759-20207815,chr13,20207759,20207815,1,31591
HepG2|chr13:20176184-20176295,chr13,20176184,20176295,HepG2|chr13:20203697-20203757,chr13,20203697,20203757,1,27513
HepG2|chr13:20176190-20176295,chr13,20176190,20176295,HepG2|chr13:20207759-20207804,chr13,20207759,20207804,1,31569
HepG2|chr13:20176193-20176295,chr13,20176193,20176295,HepG2|chr13:20207759-20207807,chr13,20207759,20207807,1,31566
HepG2|chr13:20176198-20176295,chr13,20176198,20176295,HepG2|chr13:20207759-20207809,chr13,20207759,20207809,1,31561
HepG2|chr13:20176201-20176295,chr13,20176201,20176295,HepG2|chr13:20207759-20207815,chr13,20207759,20207815,1,31558
HepG2|chr13:20176211-20176295,chr13,20176211,20176295,HepG2|chr13:20203697-20203753,chr13,20203697,20203753,1,27486
HepG2|chr13:20176222-20176295,chr13,20176222,20176295,HepG2|chr13:20207759-20207811,chr13,20207759,20207811,1,31537
HepG2|chr13:20176227-20176295,chr13,20176227,20176295,HepG2|chr13:20207759-20207809,chr13,20207759,20207809,1,31532
HepG2|chr13:20176228-20176295,chr13,20176228,20176295,HepG2|chr13:20203696-20203834,chr13,20203696,20203834,1,27468
HepG2|chr13:20176245-20176295,chr13,20176245,20176295,HepG2|chr13:20203696-20203836,chr13,20203696,20203836,1,27451
HepG2|chr13:20176246-20176295,chr13,20176246,20176295,HepG2|chr13:20205629-20205688,chr13,20205629,20205688,1,29383
HepG2|chr13:76014370-76014431,chr13,76014370,76014431,HepG2|chr13:50656726-50656835,chr13,50656726,50656835,1,25357644
HepG2|chr13:76014390-76014431,chr13,76014390,76014431,HepG2|chr13:50656726-50656835,chr13,50656726,50656835,1,25357664
HepG2|chr13:76014409-76014431,chr13,76014409,76014431,HepG2|chr13:50656726-50656835,chr13,50656726,50656835,1,25357683
HepG2|chr13:113371635-113371687,chr13,113371635,113371687,HepG2|chr13:113344429-113344486,chr13,113344429,113344486,1,27206
HepG2|chr13:113371635-113371686,chr13,113371635,113371686,HepG2|chr13:113344429-113344486,chr13,113344429,113344486,1,27206
HepG2|chr13:113828959-113829040,chr13,113828959,113829040,HepG2|chr13:113819725-113819875,chr13,113819725,113819875,1,9234
HepG2|chr13:113830789-113830856,chr13,113830789,113830856,HepG2|chr13:113823106-113823167,chr13,113823106,113823167,1,7683
HepG2|chr13:113835053-113835155,chr13,113835053,113835155,HepG2|chr13:113819961-113820003,chr13,113819961,113820003,1,15092
HepG2|chr13:113835053-113835154,chr13,113835053,113835154,HepG2|chr13:113819961-113820003,chr13,113819961,113820003,1,15092
HepG2|chr14:21709893-21709915,chr14,21709893,21709915,HepG2|chr14:21924570-21924706,chr14,21924570,21924706,1,214677
HepG2|chr14:21715064-21715134,chr14,21715064,21715134,HepG2|chr14:21922461-21922547,chr14,21922461,21922547,1,207397
HepG2|chr14:21715070-21715134,chr14,21715070,21715134,HepG2|chr14:21922461-21922547,chr14,21922461,21922547,1,207391
HepG2|chr14:21721248-21721349,chr14,21721248,21721349,HepG2|chr14:21925862-21925880,chr14,21925862,21925880,1,204614
HepG2|chr14:24053107-24053189,chr14,24053107,24053189,HepG2|chr14:24052967-24053044,chr14,24052967,24053044,1,140
HepG2|chr14:24053116-24053191,chr14,24053116,24053191,HepG2|chr14:24052969-24053042,chr14,24052969,24053042,1,147
HepG2|chr14:24475978-24476127,chr14,24475978,24476127,HepG2|chr14:24438713-24438844,chr14,24438713,24438844,1,37265
HepG2|chr14:24475988-24476138,chr14,24475988,24476138,HepG2|chr14:24438712-24438862,chr14,24438712,24438862,1,37276
HepG2|chr14:24476479-24476629,chr14,24476479,24476629,HepG2|chr14:24456364-24456451,chr14,24456364,24456451,1,20115
HepG2|chr14:24476521-24476668,chr14,24476521,24476668,HepG2|chr14:24456364-24456421,chr14,24456364,24456421,1,20157
HepG2|chr14:24476528-24476670,chr14,24476528,24476670,HepG2|chr14:24456364-24456440,chr14,24456364,24456440,1,20164
HepG2|chr14:24476707-24476857,chr14,24476707,24476857,HepG2|chr14:24439764-24439797,chr14,24439764,24439797,1,36943
HepG2|chr14:24476708-24476804,chr14,24476708,24476804,HepG2|chr14:24439679-24439824,chr14,24439679,24439824,1,37029
HepG2|chr14:24494533-24494593,chr14,24494533,24494593,HepG2|chr14:24456363-24456448,chr14,24456363,24456448,1,38170
HepG2|chr14:24494537-24494594,chr14,24494537,24494594,HepG2|chr14:24456364-24456440,chr14,24456364,24456440,1,38173
HepG2|chr14:24503398-24503512,chr14,24503398,24503512,HepG2|chr14:24455998-24456148,chr14,24455998,24456148,1,47400
HepG2|chr14:24504437-24504567,chr14,24504437,24504567,HepG2|chr14:24456796-24456874,chr14,24456796,24456874,1,47641
HepG2|chr14:24504437-24504550,chr14,24504437,24504550,HepG2|chr14:24456835-24456874,chr14,24456835,24456874,1,47602
HepG2|chr14:24504437-24504545,chr14,24504437,24504545,HepG2|chr14:24456836-24456874,chr14,24456836,24456874,1,47601
HepG2|chr14:24504437-24504544,chr14,24504437,24504544,HepG2|chr14:24456839-24456874,chr14,24456839,24456874,1,47598
HepG2|chr14:24504437-24504540,chr14,24504437,24504540,HepG2|chr14:24456836-24456874,chr14,24456836,24456874,1,47601
HepG2|chr14:24504437-24504533,chr14,24504437,24504533,HepG2|chr14:24456820-24456874,chr14,24456820,24456874,1,47617
HepG2|chr14:24504437-24504519,chr14,24504437,24504519,HepG2|chr14:24456762-24456874,chr14,24456762,24456874,1,47675
HepG2|chr14:24504437-24504517,chr14,24504437,24504517,HepG2|chr14:24421522-24421672,chr14,24421522,24421672,1,82915
HepG2|chr14:24504437-24504505,chr14,24504437,24504505,HepG2|chr14:24456792-24456874,chr14,24456792,24456874,1,47645
HepG2|chr14:24504437-24504503,chr14,24504437,24504503,HepG2|chr14:24456790-24456874,chr14,24456790,24456874,1,47647
HepG2|chr14:24504437-24504477,chr14,24504437,24504477,HepG2|chr14:24421535-24421685,chr14,24421535,24421685,1,82902
HepG2|chr14:24504437-24504475,chr14,24504437,24504475,HepG2|chr14:24456762-24456874,chr14,24456762,24456874,1,47675
HepG2|chr14:24504661-24504808,chr14,24504661,24504808,HepG2|chr14:24421922-24422072,chr14,24421922,24422072,1,82739
HepG2|chr14:24504663-24504813,chr14,24504663,24504813,HepG2|chr14:24421924-24422071,chr14,24421924,24422071,1,82739
HepG2|chr14:24504671-24504821,chr14,24504671,24504821,HepG2|chr14:24421917-24422067,chr14,24421917,24422067,1,82754
HepG2|chr14:24504674-24504822,chr14,24504674,24504822,HepG2|chr14:24421917-24422067,chr14,24421917,24422067,1,82757
HepG2|chr14:24504679-24504825,chr14,24504679,24504825,HepG2|chr14:24421928-24422078,chr14,24421928,24422078,1,82751
HepG2|chr14:24504680-24504830,chr14,24504680,24504830,HepG2|chr14:24421939-24422084,chr14,24421939,24422084,1,82741
HepG2|chr14:24504688-24504838,chr14,24504688,24504838,HepG2|chr14:24421917-24422067,chr14,24421917,24422067,1,82771
HepG2|chr14:24504694-24504838,chr14,24504694,24504838,HepG2|chr14:24421917-24422067,chr14,24421917,24422067,1,82777
HepG2|chr14:24504701-24504851,chr14,24504701,24504851,HepG2|chr14:24421916-24422066,chr14,24421916,24422066,1,82785
HepG2|chr14:24504712-24504792,chr14,24504712,24504792,HepG2|chr14:24421833-24421983,chr14,24421833,24421983,1,82879
HepG2|chr14:24504714-24504864,chr14,24504714,24504864,HepG2|chr14:24421932-24422082,chr14,24421932,24422082,1,82782
HepG2|chr14:24504722-24504868,chr14,24504722,24504868,HepG2|chr14:24421818-24421968,chr14,24421818,24421968,1,82904
HepG2|chr14:24504722-24504808,chr14,24504722,24504808,HepG2|chr14:24421922-24422072,chr14,24421922,24422072,1,82800
HepG2|chr14:24504725-24504875,chr14,24504725,24504875,HepG2|chr14:24421937-24422084,chr14,24421937,24422084,1,82788
HepG2|chr14:24504729-24504879,chr14,24504729,24504879,HepG2|chr14:24421938-24422084,chr14,24421938,24422084,1,82791
HepG2|chr14:24504738-24504888,chr14,24504738,24504888,HepG2|chr14:24421935-24422084,chr14,24421935,24422084,1,82803
HepG2|chr14:24504747-24504897,chr14,24504747,24504897,HepG2|chr14:24421937-24422084,chr14,24421937,24422084,1,82810
HepG2|chr14:24504782-24504932,chr14,24504782,24504932,HepG2|chr14:24421928-24422078,chr14,24421928,24422078,1,82854
HepG2|chr14:24505375-24505525,chr14,24505375,24505525,HepG2|chr14:24422737-24422778,chr14,24422737,24422778,1,82638
HepG2|chr14:24505389-24505537,chr14,24505389,24505537,HepG2|chr14:24422582-24422732,chr14,24422582,24422732,1,82807
HepG2|chr14:24505423-24505485,chr14,24505423,24505485,HepG2|chr14:24422585-24422732,chr14,24422585,24422732,1,82838
HepG2|chr14:34912143-34912189,chr14,34912143,34912189,HepG2|chr14:34932122-34932156,chr14,34932122,34932156,1,19979
HepG2|chr14:34912144-34912207,chr14,34912144,34912207,HepG2|chr14:34932118-34932156,chr14,34932118,34932156,1,19974
HepG2|chr14:34912175-34912214,chr14,34912175,34912214,HepG2|chr14:34932120-34932156,chr14,34932120,34932156,1,19945
HepG2|chr14:34912188-34912324,chr14,34912188,34912324,HepG2|chr14:34932120-34932156,chr14,34932120,34932156,1,19932
HepG2|chr14:35193836-35193981,chr14,35193836,35193981,HepG2|chr14:35186424-35186505,chr14,35186424,35186505,1,7412
HepG2|chr14:35193836-35193905,chr14,35193836,35193905,HepG2|chr14:35186424-35186505,chr14,35186424,35186505,1,7412
HepG2|chr14:35199733-35199831,chr14,35199733,35199831,HepG2|chr14:35185974-35186042,chr14,35185974,35186042,1,13759
HepG2|chr14:35199752-35199831,chr14,35199752,35199831,HepG2|chr14:35185974-35186042,chr14,35185974,35186042,1,13778
HepG2|chr14:50107334-50107381,chr14,50107334,50107381,HepG2|chr14:50106776-50106827,chr14,50106776,50106827,1,558
HepG2|chr14:50107419-50107471,chr14,50107419,50107471,HepG2|chr14:50106580-50106730,chr14,50106580,50106730,1,839
HepG2|chr14:50107475-50107595,chr14,50107475,50107595,HepG2|chr14:50106165-50106197,chr14,50106165,50106197,1,1310
HepG2|chr14:50107478-50107596,chr14,50107478,50107596,HepG2|chr14:50106165-50106197,chr14,50106165,50106197,1,1313
HepG2|chr14:50107606-50107658,chr14,50107606,50107658,HepG2|chr14:50105666-50105750,chr14,50105666,50105750,1,1940
HepG2|chr14:50107716-50107770,chr14,50107716,50107770,HepG2|chr14:50106787-50106937,chr14,50106787,50106937,1,929
HepG2|chr14:50107747-50107770,chr14,50107747,50107770,HepG2|chr14:50105246-50105354,chr14,50105246,50105354,1,2501
HepG2|chr14:50107887-50107923,chr14,50107887,50107923,HepG2|chr14:50106648-50106737,chr14,50106648,50106737,1,1239
HepG2|chr14:50107887-50107922,chr14,50107887,50107922,HepG2|chr14:50106648-50106737,chr14,50106648,50106737,1,1239
HepG2|chr14:50107923-50108034,chr14,50107923,50108034,HepG2|chr14:50106907-50106964,chr14,50106907,50106964,1,1016
HepG2|chr14:50107923-50108016,chr14,50107923,50108016,HepG2|chr14:50106907-50106964,chr14,50106907,50106964,1,1016
HepG2|chr14:50107995-50108092,chr14,50107995,50108092,HepG2|chr14:50106698-50106840,chr14,50106698,50106840,1,1297
HepG2|chr14:50108249-50108276,chr14,50108249,50108276,HepG2|chr14:50106604-50106747,chr14,50106604,50106747,1,1645
HepG2|chr14:50108268-50108299,chr14,50108268,50108299,HepG2|chr14:50105976-50105998,chr14,50105976,50105998,1,2292
HepG2|chr14:50108325-50108416,chr14,50108325,50108416,HepG2|chr14:50103716-50103837,chr14,50103716,50103837,1,4609
HepG2|chr14:50108389-50108418,chr14,50108389,50108418,HepG2|chr14:50103716-50103837,chr14,50103716,50103837,1,4673
HepG2|chr14:50108442-50108508,chr14,50108442,50108508,HepG2|chr14:50106299-50106393,chr14,50106299,50106393,1,2143
HepG2|chr14:50108442-50108498,chr14,50108442,50108498,HepG2|chr14:50106299-50106393,chr14,50106299,50106393,1,2143
HepG2|chr14:50108481-50108575,chr14,50108481,50108575,HepG2|chr14:50102242-50102392,chr14,50102242,50102392,1,6239
HepG2|chr14:50108562-50108586,chr14,50108562,50108586,HepG2|chr14:50106656-50106790,chr14,50106656,50106790,1,1906
HepG2|chr14:50108653-50108758,chr14,50108653,50108758,HepG2|chr14:50106504-50106531,chr14,50106504,50106531,1,2149
HepG2|chr14:50108653-50108695,chr14,50108653,50108695,HepG2|chr14:50106423-50106531,chr14,50106423,50106531,1,2230
HepG2|chr14:50108753-50108903,chr14,50108753,50108903,HepG2|chr14:50103975-50104059,chr14,50103975,50104059,1,4778
HepG2|chr14:50108792-50108929,chr14,50108792,50108929,HepG2|chr14:50102369-50102414,chr14,50102369,50102414,1,6423
HepG2|chr14:50108824-50108929,chr14,50108824,50108929,HepG2|chr14:50102369-50102414,chr14,50102369,50102414,1,6455
HepG2|chr14:50108862-50108928,chr14,50108862,50108928,HepG2|chr14:50103975-50104059,chr14,50103975,50104059,1,4887
HepG2|chr14:50108929-50108968,chr14,50108929,50108968,HepG2|chr14:50102658-50102777,chr14,50102658,50102777,1,6271
HepG2|chr14:50108967-50109087,chr14,50108967,50109087,HepG2|chr14:50103478-50103497,chr14,50103478,50103497,1,5489
HepG2|chr14:50109047-50109085,chr14,50109047,50109085,HepG2|chr14:50103734-50103884,chr14,50103734,50103884,1,5313
HepG2|chr14:50109093-50109127,chr14,50109093,50109127,HepG2|chr14:50103498-50103580,chr14,50103498,50103580,1,5595
HepG2|chr14:50109100-50109129,chr14,50109100,50109129,HepG2|chr14:50105433-50105572,chr14,50105433,50105572,1,3667
HepG2|chr14:50109102-50109252,chr14,50109102,50109252,HepG2|chr14:50105562-50105587,chr14,50105562,50105587,1,3540
HepG2|chr14:50109144-50109269,chr14,50109144,50109269,HepG2|chr14:50105562-50105587,chr14,50105562,50105587,1,3582
HepG2|chr14:50109180-50109309,chr14,50109180,50109309,HepG2|chr14:50106676-50106697,chr14,50106676,50106697,1,2504
HepG2|chr14:50109210-50109240,chr14,50109210,50109240,HepG2|chr14:50105214-50105336,chr14,50105214,50105336,1,3996
HepG2|chr14:50109213-50109240,chr14,50109213,50109240,HepG2|chr14:50105214-50105336,chr14,50105214,50105336,1,3999
HepG2|chr14:50109223-50109354,chr14,50109223,50109354,HepG2|chr14:50103330-50103393,chr14,50103330,50103393,1,5893
HepG2|chr14:50109223-50109308,chr14,50109223,50109308,HepG2|chr14:50103330-50103393,chr14,50103330,50103393,1,5893
HepG2|chr14:50109251-50109354,chr14,50109251,50109354,HepG2|chr14:50104615-50104679,chr14,50104615,50104679,1,4636
HepG2|chr14:50109251-50109337,chr14,50109251,50109337,HepG2|chr14:50104615-50104679,chr14,50104615,50104679,1,4636
HepG2|chr14:50109275-50109425,chr14,50109275,50109425,HepG2|chr14:50106676-50106697,chr14,50106676,50106697,1,2599
HepG2|chr14:50109440-50109481,chr14,50109440,50109481,HepG2|chr14:50105976-50105998,chr14,50105976,50105998,1,3464
HepG2|chr14:50109442-50109521,chr14,50109442,50109521,HepG2|chr14:50105052-50105117,chr14,50105052,50105117,1,4390
HepG2|chr14:51422342-51422475,chr14,51422342,51422475,HepG2|chr14:51414855-51414899,chr14,51414855,51414899,1,7487
HepG2|chr14:51422342-51422448,chr14,51422342,51422448,HepG2|chr14:51414855-51414899,chr14,51414855,51414899,1,7487
HepG2|chr14:51422342-51422447,chr14,51422342,51422447,HepG2|chr14:51414855-51414899,chr14,51414855,51414899,1,7487
HepG2|chr14:51422342-51422415,chr14,51422342,51422415,HepG2|chr14:51414408-51414485,chr14,51414408,51414485,1,7934
HepG2|chr14:51422342-51422396,chr14,51422342,51422396,HepG2|chr14:51414759-51414900,chr14,51414759,51414900,1,7583
HepG2|chr14:51422342-51422394,chr14,51422342,51422394,HepG2|chr14:51414759-51414900,chr14,51414759,51414900,1,7583
HepG2|chr14:51422416-51422475,chr14,51422416,51422475,HepG2|chr14:51414855-51414899,chr14,51414855,51414899,1,7561
HepG2|chr14:51422571-51422703,chr14,51422571,51422703,HepG2|chr14:51414879-51414899,chr14,51414879,51414899,1,7692
HepG2|chr14:51422571-51422702,chr14,51422571,51422702,HepG2|chr14:51414880-51414899,chr14,51414880,51414899,1,7691
HepG2|chr14:51422571-51422700,chr14,51422571,51422700,HepG2|chr14:51414879-51414899,chr14,51414879,51414899,1,7692
HepG2|chr14:51422571-51422699,chr14,51422571,51422699,HepG2|chr14:51414858-51414899,chr14,51414858,51414899,1,7713
HepG2|chr14:51422571-51422697,chr14,51422571,51422697,HepG2|chr14:51414875-51414899,chr14,51414875,51414899,1,7696
HepG2|chr14:51422571-51422694,chr14,51422571,51422694,HepG2|chr14:51414405-51414485,chr14,51414405,51414485,1,8166
HepG2|chr14:51422571-51422684,chr14,51422571,51422684,HepG2|chr14:51414412-51414429,chr14,51414412,51414429,1,8159
HepG2|chr14:51422571-51422682,chr14,51422571,51422682,HepG2|chr14:51414880-51414899,chr14,51414880,51414899,1,7691
HepG2|chr14:51422571-51422680,chr14,51422571,51422680,HepG2|chr14:51414858-51414899,chr14,51414858,51414899,1,7713
HepG2|chr14:51422571-51422677,chr14,51422571,51422677,HepG2|chr14:51414855-51414899,chr14,51414855,51414899,1,7716
HepG2|chr14:51422571-51422675,chr14,51422571,51422675,HepG2|chr14:51414855-51414899,chr14,51414855,51414899,1,7716
HepG2|chr14:51422571-51422674,chr14,51422571,51422674,HepG2|chr14:51414853-51414899,chr14,51414853,51414899,1,7718
HepG2|chr14:51422571-51422673,chr14,51422571,51422673,HepG2|chr14:51414855-51414899,chr14,51414855,51414899,1,7716
HepG2|chr14:51422571-51422672,chr14,51422571,51422672,HepG2|chr14:51414708-51414858,chr14,51414708,51414858,1,7863
HepG2|chr14:51422571-51422667,chr14,51422571,51422667,HepG2|chr14:51414859-51414899,chr14,51414859,51414899,1,7712
HepG2|chr14:51422571-51422666,chr14,51422571,51422666,HepG2|chr14:51414857-51414899,chr14,51414857,51414899,1,7714
HepG2|chr14:51422571-51422664,chr14,51422571,51422664,HepG2|chr14:51414857-51414899,chr14,51414857,51414899,1,7714
HepG2|chr14:51422571-51422661,chr14,51422571,51422661,HepG2|chr14:51414417-51414485,chr14,51414417,51414485,1,8154
HepG2|chr14:51422571-51422660,chr14,51422571,51422660,HepG2|chr14:51414370-51414413,chr14,51414370,51414413,1,8201
HepG2|chr14:51422571-51422657,chr14,51422571,51422657,HepG2|chr14:51414424-51414485,chr14,51414424,51414485,1,8147
HepG2|chr14:51422571-51422656,chr14,51422571,51422656,HepG2|chr14:51414424-51414485,chr14,51414424,51414485,1,8147
HepG2|chr14:51422571-51422653,chr14,51422571,51422653,HepG2|chr14:51414428-51414485,chr14,51414428,51414485,1,8143
HepG2|chr14:51422571-51422652,chr14,51422571,51422652,HepG2|chr14:51414858-51414899,chr14,51414858,51414899,1,7713
HepG2|chr14:51422571-51422649,chr14,51422571,51422649,HepG2|chr14:51414430-51414485,chr14,51414430,51414485,1,8141
HepG2|chr14:51422571-51422641,chr14,51422571,51422641,HepG2|chr14:51414371-51414485,chr14,51414371,51414485,1,8200
HepG2|chr14:51422571-51422639,chr14,51422571,51422639,HepG2|chr14:51414408-51414485,chr14,51414408,51414485,1,8163
HepG2|chr14:51422571-51422629,chr14,51422571,51422629,HepG2|chr14:51414428-51414485,chr14,51414428,51414485,1,8143
HepG2|chr14:51422571-51422619,chr14,51422571,51422619,HepG2|chr14:51414852-51414899,chr14,51414852,51414899,1,7719
HepG2|chr14:51422571-51422617,chr14,51422571,51422617,HepG2|chr14:51414791-51414895,chr14,51414791,51414895,1,7780
HepG2|chr14:51422571-51422616,chr14,51422571,51422616,HepG2|chr14:51414771-51414899,chr14,51414771,51414899,1,7800
HepG2|chr14:51422571-51422615,chr14,51422571,51422615,HepG2|chr14:51414380-51414485,chr14,51414380,51414485,1,8191
HepG2|chr14:51422571-51422613,chr14,51422571,51422613,HepG2|chr14:51414791-51414899,chr14,51414791,51414899,1,7780
HepG2|chr14:51422571-51422611,chr14,51422571,51422611,HepG2|chr14:51414408-51414485,chr14,51414408,51414485,1,8163
HepG2|chr14:51422571-51422607,chr14,51422571,51422607,HepG2|chr14:51414371-51414485,chr14,51414371,51414485,1,8200
HepG2|chr14:51422571-51422598,chr14,51422571,51422598,HepG2|chr14:51414682-51414832,chr14,51414682,51414832,1,7889
HepG2|chr14:51422571-51422595,chr14,51422571,51422595,HepG2|chr14:51414880-51414899,chr14,51414880,51414899,1,7691
HepG2|chr14:51422571-51422593,chr14,51422571,51422593,HepG2|chr14:51414771-51414899,chr14,51414771,51414899,1,7800
HepG2|chr14:51422571-51422592,chr14,51422571,51422592,HepG2|chr14:51415074-51415221,chr14,51415074,51415221,1,7497
HepG2|chr14:51422571-51422588,chr14,51422571,51422588,HepG2|chr14:51413005-51413150,chr14,51413005,51413150,1,9566
HepG2|chr14:56060475-56060584,chr14,56060475,56060584,HepG2|chr14:61791725-61791828,chr14,61791725,61791828,1,5731250
HepG2|chr14:56060475-56060582,chr14,56060475,56060582,HepG2|chr14:61791725-61791828,chr14,61791725,61791828,1,5731250
HepG2|chr14:56060538-56060585,chr14,56060538,56060585,HepG2|chr14:61791725-61791828,chr14,61791725,61791828,1,5731187
HepG2|chr14:62174779-62174833,chr14,62174779,62174833,HepG2|chr14:31888320-31888470,chr14,31888320,31888470,1,30286459
HepG2|chr14:70046598-70046648,chr14,70046598,70046648,HepG2|chr14:70041355-70041450,chr14,70041355,70041450,1,5243
HepG2|chr14:73747300-73747326,chr14,73747300,73747326,HepG2|chr14:73730088-73730203,chr14,73730088,73730203,1,17212
HepG2|chr14:73747300-73747323,chr14,73747300,73747323,HepG2|chr14:73730088-73730203,chr14,73730088,73730203,1,17212
HepG2|chr14:73793050-73793080,chr14,73793050,73793080,HepG2|chr14:73496157-73496246,chr14,73496157,73496246,1,296893
HepG2|chr14:73793052-73793087,chr14,73793052,73793087,HepG2|chr14:73495321-73495390,chr14,73495321,73495390,1,297731
HepG2|chr14:73932111-73932184,chr14,73932111,73932184,HepG2|chr14:74082372-74082402,chr14,74082372,74082402,1,150261
HepG2|chr14:73956450-73956515,chr14,73956450,73956515,HepG2|chr14:74082193-74082343,chr14,74082193,74082343,1,125743
HepG2|chr14:75617874-75617930,chr14,75617874,75617930,HepG2|chr14:75510486-75510549,chr14,75510486,75510549,1,107388
HepG2|chr14:75627284-75627301,chr14,75627284,75627301,HepG2|chr14:75510675-75510804,chr14,75510675,75510804,1,116609
HepG2|chr14:102851567-102851642,chr14,102851567,102851642,HepG2|chr14:102790469-102790532,chr14,102790469,102790532,1,61098
HepG2|chr14:102851567-102851640,chr14,102851567,102851640,HepG2|chr14:102790467-102790542,chr14,102790467,102790542,1,61100
HepG2|chr14:103016766-103016845,chr14,103016766,103016845,HepG2|chr14:103055800-103055822,chr14,103055800,103055822,1,39034
HepG2|chr14:103021071-103021139,chr14,103021071,103021139,HepG2|chr14:103055506-103055622,chr14,103055506,103055622,1,34435
HepG2|chr14:103029686-103029783,chr14,103029686,103029783,HepG2|chr14:103055800-103055822,chr14,103055800,103055822,1,26114
HepG2|chr14:103046423-103046573,chr14,103046423,103046573,HepG2|chr14:103055800-103055839,chr14,103055800,103055839,1,9377
HepG2|chr14:103046432-103046582,chr14,103046432,103046582,HepG2|chr14:103055800-103055846,chr14,103055800,103055846,1,9368
HepG2|chr14:103046454-103046604,chr14,103046454,103046604,HepG2|chr14:103055800-103055825,chr14,103055800,103055825,1,9346
HepG2|chr14:103046512-103046637,chr14,103046512,103046637,HepG2|chr14:103055800-103055825,chr14,103055800,103055825,1,9288
HepG2|chr14:103046526-103046637,chr14,103046526,103046637,HepG2|chr14:103055800-103055839,chr14,103055800,103055839,1,9274
HepG2|chr14:103046536-103046637,chr14,103046536,103046637,HepG2|chr14:103055800-103055846,chr14,103055800,103055846,1,9264
HepG2|chr14:103047132-103047282,chr14,103047132,103047282,HepG2|chr14:103055800-103055846,chr14,103055800,103055846,1,8668
HepG2|chr14:103047165-103047315,chr14,103047165,103047315,HepG2|chr14:103055800-103055822,chr14,103055800,103055822,1,8635
HepG2|chr14:103047206-103047340,chr14,103047206,103047340,HepG2|chr14:103055806-103055956,chr14,103055806,103055956,1,8600
HepG2|chr14:103047208-103047340,chr14,103047208,103047340,HepG2|chr14:103055800-103055826,chr14,103055800,103055826,1,8592
HepG2|chr14:103047208-103047311,chr14,103047208,103047311,HepG2|chr14:103055797-103055826,chr14,103055797,103055826,1,8589
HepG2|chr14:103047212-103047340,chr14,103047212,103047340,HepG2|chr14:103055800-103055822,chr14,103055800,103055822,1,8588
HepG2|chr14:103047216-103047340,chr14,103047216,103047340,HepG2|chr14:103055800-103055826,chr14,103055800,103055826,1,8584
HepG2|chr14:103047238-103047340,chr14,103047238,103047340,HepG2|chr14:103055800-103055903,chr14,103055800,103055903,1,8562
HepG2|chr14:103047277-103047340,chr14,103047277,103047340,HepG2|chr14:103055803-103055953,chr14,103055803,103055953,1,8526
HepG2|chr14:103047293-103047340,chr14,103047293,103047340,HepG2|chr14:103055800-103055903,chr14,103055800,103055903,1,8507
HepG2|chr14:103047516-103047612,chr14,103047516,103047612,HepG2|chr14:103055800-103055846,chr14,103055800,103055846,1,8284
HepG2|chr14:103075564-103075681,chr14,103075564,103075681,HepG2|chr14:102775106-102775139,chr14,102775106,102775139,1,300458
HepG2|chr14:103075586-103075732,chr14,103075586,103075732,HepG2|chr14:102775106-102775139,chr14,102775106,102775139,1,300480
HepG2|chr14:103086022-103086112,chr14,103086022,103086112,HepG2|chr14:102772492-102772530,chr14,102772492,102772530,1,313530
HepG2|chr14:103529601-103529647,chr14,103529601,103529647,HepG2|chr14:103528038-103528116,chr14,103528038,103528116,1,1563
HepG2|chr14:103530457-103530512,chr14,103530457,103530512,HepG2|chr14:103527523-103527673,chr14,103527523,103527673,1,2934
HepG2|chr14:103530573-103530657,chr14,103530573,103530657,HepG2|chr14:103528050-103528115,chr14,103528050,103528115,1,2523
HepG2|chr14:103530573-103530626,chr14,103530573,103530626,HepG2|chr14:103527996-103528112,chr14,103527996,103528112,1,2577
HepG2|chr14:103530573-103530607,chr14,103530573,103530607,HepG2|chr14:103527996-103528112,chr14,103527996,103528112,1,2577
HepG2|chr14:103530575-103530681,chr14,103530575,103530681,HepG2|chr14:103527995-103528117,chr14,103527995,103528117,1,2580
HepG2|chr14:103530575-103530676,chr14,103530575,103530676,HepG2|chr14:103528070-103528117,chr14,103528070,103528117,1,2505
HepG2|chr14:103530575-103530674,chr14,103530575,103530674,HepG2|chr14:103528097-103528117,chr14,103528097,103528117,1,2478
HepG2|chr14:103530575-103530673,chr14,103530575,103530673,HepG2|chr14:103528092-103528117,chr14,103528092,103528117,1,2483
HepG2|chr14:103530575-103530672,chr14,103530575,103530672,HepG2|chr14:103528064-103528117,chr14,103528064,103528117,1,2511
HepG2|chr14:103530575-103530671,chr14,103530575,103530671,HepG2|chr14:103528063-103528117,chr14,103528063,103528117,1,2512
HepG2|chr14:103530575-103530670,chr14,103530575,103530670,HepG2|chr14:103528062-103528117,chr14,103528062,103528117,1,2513
HepG2|chr14:103530575-103530669,chr14,103530575,103530669,HepG2|chr14:103528061-103528117,chr14,103528061,103528117,1,2514
HepG2|chr14:103530575-103530668,chr14,103530575,103530668,HepG2|chr14:103528000-103528117,chr14,103528000,103528117,1,2575
HepG2|chr14:103530575-103530667,chr14,103530575,103530667,HepG2|chr14:103528061-103528117,chr14,103528061,103528117,1,2514
HepG2|chr14:103530575-103530666,chr14,103530575,103530666,HepG2|chr14:103527990-103528117,chr14,103527990,103528117,1,2585
HepG2|chr14:103530575-103530663,chr14,103530575,103530663,HepG2|chr14:103528075-103528117,chr14,103528075,103528117,1,2500
HepG2|chr14:103530575-103530659,chr14,103530575,103530659,HepG2|chr14:103527995-103528117,chr14,103527995,103528117,1,2580
HepG2|chr14:103530575-103530656,chr14,103530575,103530656,HepG2|chr14:103528061-103528117,chr14,103528061,103528117,1,2514
HepG2|chr14:103530575-103530655,chr14,103530575,103530655,HepG2|chr14:103528047-103528117,chr14,103528047,103528117,1,2528
HepG2|chr14:103530575-103530652,chr14,103530575,103530652,HepG2|chr14:103528059-103528117,chr14,103528059,103528117,1,2516
HepG2|chr14:103530575-103530651,chr14,103530575,103530651,HepG2|chr14:103528044-103528117,chr14,103528044,103528117,1,2531
HepG2|chr14:103530575-103530647,chr14,103530575,103530647,HepG2|chr14:103528001-103528117,chr14,103528001,103528117,1,2574
HepG2|chr14:103530575-103530643,chr14,103530575,103530643,HepG2|chr14:103527996-103528117,chr14,103527996,103528117,1,2579
HepG2|chr14:103530575-103530642,chr14,103530575,103530642,HepG2|chr14:103528061-103528117,chr14,103528061,103528117,1,2514
HepG2|chr14:103530575-103530641,chr14,103530575,103530641,HepG2|chr14:103527990-103528117,chr14,103527990,103528117,1,2585
HepG2|chr14:103530575-103530640,chr14,103530575,103530640,HepG2|chr14:103527996-103528117,chr14,103527996,103528117,1,2579
HepG2|chr14:103530575-103530636,chr14,103530575,103530636,HepG2|chr14:103528002-103528117,chr14,103528002,103528117,1,2573
HepG2|chr14:103530575-103530635,chr14,103530575,103530635,HepG2|chr14:103528000-103528117,chr14,103528000,103528117,1,2575
HepG2|chr14:103530575-103530634,chr14,103530575,103530634,HepG2|chr14:103527996-103528117,chr14,103527996,103528117,1,2579
HepG2|chr14:103530575-103530633,chr14,103530575,103530633,HepG2|chr14:103527995-103528117,chr14,103527995,103528117,1,2580
HepG2|chr14:103530575-103530630,chr14,103530575,103530630,HepG2|chr14:103528023-103528117,chr14,103528023,103528117,1,2552
HepG2|chr14:103530575-103530627,chr14,103530575,103530627,HepG2|chr14:103527996-103528117,chr14,103527996,103528117,1,2579
HepG2|chr14:103530575-103530626,chr14,103530575,103530626,HepG2|chr14:103528023-103528117,chr14,103528023,103528117,1,2552
HepG2|chr14:103530575-103530622,chr14,103530575,103530622,HepG2|chr14:103527996-103528117,chr14,103527996,103528117,1,2579
HepG2|chr14:103530575-103530619,chr14,103530575,103530619,HepG2|chr14:103528041-103528117,chr14,103528041,103528117,1,2534
HepG2|chr14:103530575-103530618,chr14,103530575,103530618,HepG2|chr14:103528040-103528117,chr14,103528040,103528117,1,2535
HepG2|chr14:103530575-103530617,chr14,103530575,103530617,HepG2|chr14:103528002-103528117,chr14,103528002,103528117,1,2573
HepG2|chr14:103530575-103530616,chr14,103530575,103530616,HepG2|chr14:103527992-103528117,chr14,103527992,103528117,1,2583
HepG2|chr14:103530575-103530615,chr14,103530575,103530615,HepG2|chr14:103527995-103528117,chr14,103527995,103528117,1,2580
HepG2|chr14:103530575-103530610,chr14,103530575,103530610,HepG2|chr14:103528002-103528117,chr14,103528002,103528117,1,2573
HepG2|chr14:103530575-103530609,chr14,103530575,103530609,HepG2|chr14:103528001-103528117,chr14,103528001,103528117,1,2574
HepG2|chr14:103530575-103530608,chr14,103530575,103530608,HepG2|chr14:103528002-103528117,chr14,103528002,103528117,1,2573
HepG2|chr14:103530575-103530603,chr14,103530575,103530603,HepG2|chr14:103527995-103528117,chr14,103527995,103528117,1,2580
HepG2|chr14:103530612-103530661,chr14,103530612,103530661,HepG2|chr14:103528013-103528116,chr14,103528013,103528116,1,2599
HepG2|chr14:103530619-103530666,chr14,103530619,103530666,HepG2|chr14:103528013-103528116,chr14,103528013,103528116,1,2606
HepG2|chr14:103531400-103531456,chr14,103531400,103531456,HepG2|chr14:103522997-103523059,chr14,103522997,103523059,1,8403
HepG2|chr14:103532446-103532506,chr14,103532446,103532506,HepG2|chr14:103525332-103525422,chr14,103525332,103525422,1,7114
HepG2|chr14:103538740-103538839,chr14,103538740,103538839,HepG2|chr14:103528089-103528117,chr14,103528089,103528117,1,10651
HepG2|chr14:103538740-103538794,chr14,103538740,103538794,HepG2|chr14:103527992-103528117,chr14,103527992,103528117,1,10748
HepG2|chr14:103538945-103539085,chr14,103538945,103539085,HepG2|chr14:103528090-103528117,chr14,103528090,103528117,1,10855
HepG2|chr14:103538946-103539005,chr14,103538946,103539005,HepG2|chr14:103528048-103528113,chr14,103528048,103528113,1,10898
HepG2|chr14:103538947-103538998,chr14,103538947,103538998,HepG2|chr14:103528022-103528057,chr14,103528022,103528057,1,10925
HepG2|chr14:103538948-103539080,chr14,103538948,103539080,HepG2|chr14:103527995-103528117,chr14,103527995,103528117,1,10953
HepG2|chr14:103538948-103539079,chr14,103538948,103539079,HepG2|chr14:103528089-103528117,chr14,103528089,103528117,1,10859
HepG2|chr14:103538948-103539071,chr14,103538948,103539071,HepG2|chr14:103528090-103528117,chr14,103528090,103528117,1,10858
HepG2|chr14:103538948-103539070,chr14,103538948,103539070,HepG2|chr14:103528056-103528117,chr14,103528056,103528117,1,10892
HepG2|chr14:103538948-103539069,chr14,103538948,103539069,HepG2|chr14:103528088-103528117,chr14,103528088,103528117,1,10860
HepG2|chr14:103538948-103539067,chr14,103538948,103539067,HepG2|chr14:103528064-103528117,chr14,103528064,103528117,1,10884
HepG2|chr14:103538948-103539065,chr14,103538948,103539065,HepG2|chr14:103527995-103528117,chr14,103527995,103528117,1,10953
HepG2|chr14:103538948-103539064,chr14,103538948,103539064,HepG2|chr14:103527994-103528117,chr14,103527994,103528117,1,10954
HepG2|chr14:103538948-103539060,chr14,103538948,103539060,HepG2|chr14:103527996-103528117,chr14,103527996,103528117,1,10952
HepG2|chr14:103538948-103539057,chr14,103538948,103539057,HepG2|chr14:103528088-103528117,chr14,103528088,103528117,1,10860
HepG2|chr14:103538948-103539056,chr14,103538948,103539056,HepG2|chr14:103528062-103528117,chr14,103528062,103528117,1,10886
HepG2|chr14:103538948-103539052,chr14,103538948,103539052,HepG2|chr14:103528041-103528117,chr14,103528041,103528117,1,10907
HepG2|chr14:103538948-103539049,chr14,103538948,103539049,HepG2|chr14:103528038-103528117,chr14,103528038,103528117,1,10910
HepG2|chr14:103538948-103539046,chr14,103538948,103539046,HepG2|chr14:103528065-103528117,chr14,103528065,103528117,1,10883
HepG2|chr14:103538948-103539044,chr14,103538948,103539044,HepG2|chr14:103528063-103528117,chr14,103528063,103528117,1,10885
HepG2|chr14:103538948-103539043,chr14,103538948,103539043,HepG2|chr14:103528062-103528117,chr14,103528062,103528117,1,10886
HepG2|chr14:103538948-103539041,chr14,103538948,103539041,HepG2|chr14:103528061-103528117,chr14,103528061,103528117,1,10887
HepG2|chr14:103538948-103539037,chr14,103538948,103539037,HepG2|chr14:103528056-103528117,chr14,103528056,103528117,1,10892
HepG2|chr14:103538948-103539036,chr14,103538948,103539036,HepG2|chr14:103528059-103528117,chr14,103528059,103528117,1,10889
HepG2|chr14:103538948-103539034,chr14,103538948,103539034,HepG2|chr14:103527996-103528117,chr14,103527996,103528117,1,10952
HepG2|chr14:103538948-103539029,chr14,103538948,103539029,HepG2|chr14:103528048-103528117,chr14,103528048,103528117,1,10900
HepG2|chr14:103538948-103539022,chr14,103538948,103539022,HepG2|chr14:103528041-103528117,chr14,103528041,103528117,1,10907
HepG2|chr14:103538948-103539019,chr14,103538948,103539019,HepG2|chr14:103528038-103528117,chr14,103528038,103528117,1,10910
HepG2|chr14:103538948-103539018,chr14,103538948,103539018,HepG2|chr14:103527990-103528117,chr14,103527990,103528117,1,10958
HepG2|chr14:103538948-103539017,chr14,103538948,103539017,HepG2|chr14:103528036-103528117,chr14,103528036,103528117,1,10912
HepG2|chr14:103538948-103539005,chr14,103538948,103539005,HepG2|chr14:103528002-103528117,chr14,103528002,103528117,1,10946
HepG2|chr14:103538948-103539003,chr14,103538948,103539003,HepG2|chr14:103528046-103528117,chr14,103528046,103528117,1,10902
HepG2|chr14:103538948-103539000,chr14,103538948,103539000,HepG2|chr14:103527996-103528117,chr14,103527996,103528117,1,10952
HepG2|chr14:103538948-103538997,chr14,103538948,103538997,HepG2|chr14:103528038-103528117,chr14,103528038,103528117,1,10910
HepG2|chr14:103538948-103538994,chr14,103538948,103538994,HepG2|chr14:103527996-103528117,chr14,103527996,103528117,1,10952
HepG2|chr14:103538948-103538987,chr14,103538948,103538987,HepG2|chr14:103528002-103528117,chr14,103528002,103528117,1,10946
HepG2|chr14:103538948-103538986,chr14,103538948,103538986,HepG2|chr14:103527996-103528117,chr14,103527996,103528117,1,10952
HepG2|chr14:103538948-103538983,chr14,103538948,103538983,HepG2|chr14:103528061-103528117,chr14,103528061,103528117,1,10887
HepG2|chr14:103538948-103538981,chr14,103538948,103538981,HepG2|chr14:103528006-103528117,chr14,103528006,103528117,1,10942
HepG2|chr14:103538948-103538979,chr14,103538948,103538979,HepG2|chr14:103528002-103528117,chr14,103528002,103528117,1,10946
HepG2|chr14:103538948-103538978,chr14,103538948,103538978,HepG2|chr14:103527998-103528117,chr14,103527998,103528117,1,10950
HepG2|chr14:103538948-103538977,chr14,103538948,103538977,HepG2|chr14:103528006-103528117,chr14,103528006,103528117,1,10942
HepG2|chr14:103538948-103538976,chr14,103538948,103538976,HepG2|chr14:103527995-103528117,chr14,103527995,103528117,1,10953
HepG2|chr14:103538948-103538975,chr14,103538948,103538975,HepG2|chr14:103528044-103528117,chr14,103528044,103528117,1,10904
HepG2|chr14:103538948-103538974,chr14,103538948,103538974,HepG2|chr14:103527996-103528117,chr14,103527996,103528117,1,10952
HepG2|chr14:103538948-103538973,chr14,103538948,103538973,HepG2|chr14:103527990-103528117,chr14,103527990,103528117,1,10958
HepG2|chr14:103538948-103538972,chr14,103538948,103538972,HepG2|chr14:103527996-103528117,chr14,103527996,103528117,1,10952
HepG2|chr14:103538948-103538971,chr14,103538948,103538971,HepG2|chr14:103528002-103528117,chr14,103528002,103528117,1,10946
HepG2|chr14:103538948-103538970,chr14,103538948,103538970,HepG2|chr14:103527990-103528117,chr14,103527990,103528117,1,10958
HepG2|chr14:103538948-103538969,chr14,103538948,103538969,HepG2|chr14:103528005-103528117,chr14,103528005,103528117,1,10943
HepG2|chr14:103538948-103538968,chr14,103538948,103538968,HepG2|chr14:103527996-103528117,chr14,103527996,103528117,1,10952
HepG2|chr14:103538948-103538967,chr14,103538948,103538967,HepG2|chr14:103527997-103528117,chr14,103527997,103528117,1,10951
HepG2|chr14:103538952-103539102,chr14,103538952,103539102,HepG2|chr14:103527996-103528117,chr14,103527996,103528117,1,10956
HepG2|chr14:103538962-103539014,chr14,103538962,103539014,HepG2|chr14:103528002-103528099,chr14,103528002,103528099,1,10960
HepG2|chr14:103538967-103539117,chr14,103538967,103539117,HepG2|chr14:103527996-103528117,chr14,103527996,103528117,1,10971
HepG2|chr14:103538971-103539121,chr14,103538971,103539121,HepG2|chr14:103527996-103528117,chr14,103527996,103528117,1,10975
HepG2|chr14:103538974-103539124,chr14,103538974,103539124,HepG2|chr14:103528065-103528117,chr14,103528065,103528117,1,10909
HepG2|chr14:103538976-103539126,chr14,103538976,103539126,HepG2|chr14:103528089-103528117,chr14,103528089,103528117,1,10887
HepG2|chr14:103538979-103539129,chr14,103538979,103539129,HepG2|chr14:103528000-103528117,chr14,103528000,103528117,1,10979
HepG2|chr14:103538980-103539130,chr14,103538980,103539130,HepG2|chr14:103527996-103528117,chr14,103527996,103528117,1,10984
HepG2|chr14:103538980-103539025,chr14,103538980,103539025,HepG2|chr14:103527997-103528117,chr14,103527997,103528117,1,10983
HepG2|chr14:103538987-103539137,chr14,103538987,103539137,HepG2|chr14:103528059-103528117,chr14,103528059,103528117,1,10928
HepG2|chr14:103538994-103539144,chr14,103538994,103539144,HepG2|chr14:103528062-103528117,chr14,103528062,103528117,1,10932
HepG2|chr14:103538997-103539147,chr14,103538997,103539147,HepG2|chr14:103528002-103528117,chr14,103528002,103528117,1,10995
HepG2|chr14:103538998-103539148,chr14,103538998,103539148,HepG2|chr14:103527999-103528117,chr14,103527999,103528117,1,10999
HepG2|chr14:103538998-103539147,chr14,103538998,103539147,HepG2|chr14:103528002-103528117,chr14,103528002,103528117,1,10996
HepG2|chr14:103539006-103539155,chr14,103539006,103539155,HepG2|chr14:103527996-103528117,chr14,103527996,103528117,1,11010
HepG2|chr14:103539012-103539162,chr14,103539012,103539162,HepG2|chr14:103528061-103528117,chr14,103528061,103528117,1,10951
HepG2|chr14:103539014-103539161,chr14,103539014,103539161,HepG2|chr14:103528088-103528117,chr14,103528088,103528117,1,10926
HepG2|chr15:23377355-23377505,chr15,23377355,23377505,HepG2|chr15:28566326-28566473,chr15,28566326,28566473,1,5188971
HepG2|chr15:23377357-23377496,chr15,23377357,23377496,HepG2|chr15:28566322-28566472,chr15,28566322,28566472,1,5188965
HepG2|chr15:28834974-28835118,chr15,28834974,28835118,HepG2|chr15:28566853-28567003,chr15,28566853,28567003,1,268121
HepG2|chr15:28834974-28835115,chr15,28834974,28835115,HepG2|chr15:28566896-28567046,chr15,28566896,28567046,1,268078
HepG2|chr15:28834975-28835125,chr15,28834975,28835125,HepG2|chr15:28566577-28566727,chr15,28566577,28566727,1,268398
HepG2|chr15:28834980-28835130,chr15,28834980,28835130,HepG2|chr15:28566878-28567028,chr15,28566878,28567028,1,268102
HepG2|chr15:28834984-28835134,chr15,28834984,28835134,HepG2|chr15:28566831-28566978,chr15,28566831,28566978,1,268153
HepG2|chr15:28834985-28835134,chr15,28834985,28835134,HepG2|chr15:28566820-28566970,chr15,28566820,28566970,1,268165
HepG2|chr15:28834985-28835132,chr15,28834985,28835132,HepG2|chr15:28566820-28566970,chr15,28566820,28566970,1,268165
HepG2|chr15:28834987-28835137,chr15,28834987,28835137,HepG2|chr15:28566883-28567033,chr15,28566883,28567033,1,268104
HepG2|chr15:28834989-28835139,chr15,28834989,28835139,HepG2|chr15:28566876-28567025,chr15,28566876,28567025,1,268113
HepG2|chr15:28834991-28835141,chr15,28834991,28835141,HepG2|chr15:28566823-28566973,chr15,28566823,28566973,1,268168
HepG2|chr15:28834995-28835145,chr15,28834995,28835145,HepG2|chr15:28566936-28567085,chr15,28566936,28567085,1,268059
HepG2|chr15:28834996-28835146,chr15,28834996,28835146,HepG2|chr15:28566831-28566978,chr15,28566831,28566978,1,268165
HepG2|chr15:28835000-28835150,chr15,28835000,28835150,HepG2|chr15:28566831-28566978,chr15,28566831,28566978,1,268169
HepG2|chr15:28835001-28835151,chr15,28835001,28835151,HepG2|chr15:28566878-28567028,chr15,28566878,28567028,1,268123
HepG2|chr15:28835002-28835152,chr15,28835002,28835152,HepG2|chr15:28566831-28566978,chr15,28566831,28566978,1,268171
HepG2|chr15:28835004-28835154,chr15,28835004,28835154,HepG2|chr15:28566818-28566968,chr15,28566818,28566968,1,268186
HepG2|chr15:28835004-28835115,chr15,28835004,28835115,HepG2|chr15:28566937-28567021,chr15,28566937,28567021,1,268067
HepG2|chr15:28835005-28835155,chr15,28835005,28835155,HepG2|chr15:28566917-28567067,chr15,28566917,28567067,1,268088
HepG2|chr15:28835005-28835154,chr15,28835005,28835154,HepG2|chr15:28566939-28567088,chr15,28566939,28567088,1,268066
HepG2|chr15:28835006-28835150,chr15,28835006,28835150,HepG2|chr15:28566836-28566986,chr15,28566836,28566986,1,268170
HepG2|chr15:28835007-28835157,chr15,28835007,28835157,HepG2|chr15:28566829-28566979,chr15,28566829,28566979,1,268178
HepG2|chr15:28835007-28835150,chr15,28835007,28835150,HepG2|chr15:28566831-28566976,chr15,28566831,28566976,1,268176
HepG2|chr15:28835011-28835161,chr15,28835011,28835161,HepG2|chr15:28566890-28567040,chr15,28566890,28567040,1,268121
HepG2|chr15:28835012-28835162,chr15,28835012,28835162,HepG2|chr15:28566833-28566980,chr15,28566833,28566980,1,268179
HepG2|chr15:28835012-28835158,chr15,28835012,28835158,HepG2|chr15:28566845-28566995,chr15,28566845,28566995,1,268167
HepG2|chr15:28835013-28835163,chr15,28835013,28835163,HepG2|chr15:28566831-28566978,chr15,28566831,28566978,1,268182
HepG2|chr15:28835013-28835160,chr15,28835013,28835160,HepG2|chr15:28566824-28566974,chr15,28566824,28566974,1,268189
HepG2|chr15:28835013-28835158,chr15,28835013,28835158,HepG2|chr15:28566817-28566967,chr15,28566817,28566967,1,268196
HepG2|chr15:28835013-28835156,chr15,28835013,28835156,HepG2|chr15:28566908-28567052,chr15,28566908,28567052,1,268105
HepG2|chr15:28835014-28835161,chr15,28835014,28835161,HepG2|chr15:28566845-28566994,chr15,28566845,28566994,1,268169
HepG2|chr15:28835015-28835164,chr15,28835015,28835164,HepG2|chr15:28566904-28567054,chr15,28566904,28567054,1,268111
HepG2|chr15:28835015-28835161,chr15,28835015,28835161,HepG2|chr15:28566818-28566968,chr15,28566818,28566968,1,268197
HepG2|chr15:28835015-28835156,chr15,28835015,28835156,HepG2|chr15:28566835-28566985,chr15,28566835,28566985,1,268180
HepG2|chr15:28835016-28835166,chr15,28835016,28835166,HepG2|chr15:28566819-28566969,chr15,28566819,28566969,1,268197
HepG2|chr15:28835017-28835161,chr15,28835017,28835161,HepG2|chr15:28566831-28566978,chr15,28566831,28566978,1,268186
HepG2|chr15:28835018-28835168,chr15,28835018,28835168,HepG2|chr15:28566829-28566979,chr15,28566829,28566979,1,268189
HepG2|chr15:28835019-28835169,chr15,28835019,28835169,HepG2|chr15:28566903-28567050,chr15,28566903,28567050,1,268116
HepG2|chr15:28835020-28835170,chr15,28835020,28835170,HepG2|chr15:28566831-28566978,chr15,28566831,28566978,1,268189
HepG2|chr15:28835020-28835167,chr15,28835020,28835167,HepG2|chr15:28566865-28567011,chr15,28566865,28567011,1,268155
HepG2|chr15:28835021-28835170,chr15,28835021,28835170,HepG2|chr15:28566840-28566990,chr15,28566840,28566990,1,268181
HepG2|chr15:28835023-28835173,chr15,28835023,28835173,HepG2|chr15:28566833-28566980,chr15,28566833,28566980,1,268190
HepG2|chr15:28835023-28835165,chr15,28835023,28835165,HepG2|chr15:28566831-28566978,chr15,28566831,28566978,1,268192
HepG2|chr15:28835024-28835171,chr15,28835024,28835171,HepG2|chr15:28566869-28567019,chr15,28566869,28567019,1,268155
HepG2|chr15:28835025-28835171,chr15,28835025,28835171,HepG2|chr15:28566831-28566978,chr15,28566831,28566978,1,268194
HepG2|chr15:28835028-28835178,chr15,28835028,28835178,HepG2|chr15:28566831-28566978,chr15,28566831,28566978,1,268197
HepG2|chr15:28835028-28835172,chr15,28835028,28835172,HepG2|chr15:28566814-28566963,chr15,28566814,28566963,1,268214
HepG2|chr15:28835028-28835171,chr15,28835028,28835171,HepG2|chr15:28566898-28567047,chr15,28566898,28567047,1,268130
HepG2|chr15:28835029-28835175,chr15,28835029,28835175,HepG2|chr15:28566888-28567038,chr15,28566888,28567038,1,268141
HepG2|chr15:28835030-28835180,chr15,28835030,28835180,HepG2|chr15:28566831-28566981,chr15,28566831,28566981,1,268199
HepG2|chr15:28835031-28835180,chr15,28835031,28835180,HepG2|chr15:28566631-28566781,chr15,28566631,28566781,1,268400
HepG2|chr15:28835033-28835183,chr15,28835033,28835183,HepG2|chr15:28566896-28567046,chr15,28566896,28567046,1,268137
HepG2|chr15:28835035-28835185,chr15,28835035,28835185,HepG2|chr15:28566881-28567031,chr15,28566881,28567031,1,268154
HepG2|chr15:28835036-28835186,chr15,28835036,28835186,HepG2|chr15:28566822-28566972,chr15,28566822,28566972,1,268214
HepG2|chr15:28835037-28835178,chr15,28835037,28835178,HepG2|chr15:28566831-28566978,chr15,28566831,28566978,1,268206
HepG2|chr15:28835038-28835188,chr15,28835038,28835188,HepG2|chr15:28566881-28567031,chr15,28566881,28567031,1,268157
HepG2|chr15:28835039-28835189,chr15,28835039,28835189,HepG2|chr15:28566883-28567033,chr15,28566883,28567033,1,268156
HepG2|chr15:28835040-28835190,chr15,28835040,28835190,HepG2|chr15:28566933-28567043,chr15,28566933,28567043,1,268107
HepG2|chr15:28835041-28835191,chr15,28835041,28835191,HepG2|chr15:28566896-28567046,chr15,28566896,28567046,1,268145
HepG2|chr15:28835041-28835187,chr15,28835041,28835187,HepG2|chr15:28566831-28566978,chr15,28566831,28566978,1,268210
HepG2|chr15:28835042-28835192,chr15,28835042,28835192,HepG2|chr15:28566643-28566790,chr15,28566643,28566790,1,268399
HepG2|chr15:28835043-28835193,chr15,28835043,28835193,HepG2|chr15:28566903-28567050,chr15,28566903,28567050,1,268140
HepG2|chr15:28835043-28835187,chr15,28835043,28835187,HepG2|chr15:28566823-28566972,chr15,28566823,28566972,1,268220
HepG2|chr15:28835044-28835194,chr15,28835044,28835194,HepG2|chr15:28566845-28566995,chr15,28566845,28566995,1,268199
HepG2|chr15:28835045-28835192,chr15,28835045,28835192,HepG2|chr15:28566917-28567067,chr15,28566917,28567067,1,268128
HepG2|chr15:28835046-28835194,chr15,28835046,28835194,HepG2|chr15:28566834-28566984,chr15,28566834,28566984,1,268212
HepG2|chr15:28835046-28835192,chr15,28835046,28835192,HepG2|chr15:28566834-28566984,chr15,28566834,28566984,1,268212
HepG2|chr15:28835047-28835197,chr15,28835047,28835197,HepG2|chr15:28566830-28566980,chr15,28566830,28566980,1,268217
HepG2|chr15:28835049-28835199,chr15,28835049,28835199,HepG2|chr15:28566876-28567023,chr15,28566876,28567023,1,268173
HepG2|chr15:28835049-28835198,chr15,28835049,28835198,HepG2|chr15:28566831-28566978,chr15,28566831,28566978,1,268218
HepG2|chr15:28835051-28835192,chr15,28835051,28835192,HepG2|chr15:28566661-28566811,chr15,28566661,28566811,1,268390
HepG2|chr15:28835055-28835204,chr15,28835055,28835204,HepG2|chr15:28566669-28566691,chr15,28566669,28566691,1,268386
HepG2|chr15:28835056-28835205,chr15,28835056,28835205,HepG2|chr15:28566670-28566820,chr15,28566670,28566820,1,268386
HepG2|chr15:28835071-28835215,chr15,28835071,28835215,HepG2|chr15:28566667-28566817,chr15,28566667,28566817,1,268404
HepG2|chr15:28835078-28835158,chr15,28835078,28835158,HepG2|chr15:28566879-28566937,chr15,28566879,28566937,1,268199
HepG2|chr15:37401926-37402014,chr15,37401926,37402014,HepG2|chr15:37394931-37394968,chr15,37394931,37394968,1,6995
HepG2|chr15:37401926-37401981,chr15,37401926,37401981,HepG2|chr15:37394907-37394968,chr15,37394907,37394968,1,7019
HepG2|chr15:37401926-37401978,chr15,37401926,37401978,HepG2|chr15:37393620-37393739,chr15,37393620,37393739,1,8306
HepG2|chr15:37401926-37401951,chr15,37401926,37401951,HepG2|chr15:37394752-37394889,chr15,37394752,37394889,1,7174
HepG2|chr15:37401926-37401948,chr15,37401926,37401948,HepG2|chr15:37394874-37394968,chr15,37394874,37394968,1,7052
HepG2|chr15:37401933-37401996,chr15,37401933,37401996,HepG2|chr15:37394907-37394963,chr15,37394907,37394963,1,7026
HepG2|chr15:37401936-37401987,chr15,37401936,37401987,HepG2|chr15:37394907-37394966,chr15,37394907,37394966,1,7029
HepG2|chr15:37402629-37402697,chr15,37402629,37402697,HepG2|chr15:37396775-37396822,chr15,37396775,37396822,1,5854
HepG2|chr15:37403634-37403724,chr15,37403634,37403724,HepG2|chr15:37397989-37398050,chr15,37397989,37398050,1,5645
HepG2|chr15:37403635-37403724,chr15,37403635,37403724,HepG2|chr15:37397989-37398050,chr15,37397989,37398050,1,5646
HepG2|chr15:41414892-41414936,chr15,41414892,41414936,HepG2|chr15:41408864-41408889,chr15,41408864,41408889,1,6028
HepG2|chr15:41423925-41423996,chr15,41423925,41423996,HepG2|chr15:41408756-41408889,chr15,41408756,41408889,1,15169
HepG2|chr15:41423925-41423956,chr15,41423925,41423956,HepG2|chr15:41408864-41408889,chr15,41408864,41408889,1,15061
HepG2|chr15:45152456-45152606,chr15,45152456,45152606,HepG2|chr15:45316972-45317121,chr15,45316972,45317121,1,164516
HepG2|chr15:45152457-45152607,chr15,45152457,45152607,HepG2|chr15:45316976-45317126,chr15,45316976,45317126,1,164519
HepG2|chr15:45152498-45152648,chr15,45152498,45152648,HepG2|chr15:45317075-45317225,chr15,45317075,45317225,1,164577
HepG2|chr15:45152527-45152677,chr15,45152527,45152677,HepG2|chr15:45316976-45317126,chr15,45316976,45317126,1,164449
HepG2|chr15:45152537-45152687,chr15,45152537,45152687,HepG2|chr15:45317030-45317126,chr15,45317030,45317126,1,164493
HepG2|chr15:45152554-45152704,chr15,45152554,45152704,HepG2|chr15:45316646-45316796,chr15,45316646,45316796,1,164092
HepG2|chr15:45152809-45152865,chr15,45152809,45152865,HepG2|chr15:45316567-45316659,chr15,45316567,45316659,1,163758
HepG2|chr15:51166804-51166923,chr15,51166804,51166923,HepG2|chr15:51200748-51200788,chr15,51200748,51200788,1,33944
HepG2|chr15:51166813-51166923,chr15,51166813,51166923,HepG2|chr15:51200748-51200788,chr15,51200748,51200788,1,33935
HepG2|chr15:51166859-51166923,chr15,51166859,51166923,HepG2|chr15:51200748-51200832,chr15,51200748,51200832,1,33889
HepG2|chr15:51166860-51166923,chr15,51166860,51166923,HepG2|chr15:51200748-51200832,chr15,51200748,51200832,1,33888
HepG2|chr15:51590274-51590358,chr15,51590274,51590358,HepG2|chr15:52473435-52473500,chr15,52473435,52473500,1,883161
HepG2|chr15:51590278-51590358,chr15,51590278,51590358,HepG2|chr15:52473435-52473500,chr15,52473435,52473500,1,883157
HepG2|chr15:72529731-72529803,chr15,72529731,72529803,HepG2|chr15:72525500-72525624,chr15,72525500,72525624,1,4231
HepG2|chr15:72529731-72529757,chr15,72529731,72529757,HepG2|chr15:72525500-72525624,chr15,72525500,72525624,1,4231
HepG2|chr15:72529839-72529862,chr15,72529839,72529862,HepG2|chr15:72524537-72524687,chr15,72524537,72524687,1,5302
HepG2|chr15:75542161-75542311,chr15,75542161,75542311,HepG2|chr15:85722540-85722689,chr15,85722540,85722689,1,10180379
HepG2|chr15:75542215-75542324,chr15,75542215,75542324,HepG2|chr15:85722513-85722622,chr15,85722513,85722622,1,10180298
HepG2|chr15:85269062-85269101,chr15,85269062,85269101,HepG2|chr15:85260677-85260785,chr15,85260677,85260785,1,8385
HepG2|chr15:85271894-85271916,chr15,85271894,85271916,HepG2|chr15:85262213-85262315,chr15,85262213,85262315,1,9681
HepG2|chr15:85275894-85275936,chr15,85275894,85275936,HepG2|chr15:85259914-85260063,chr15,85259914,85260063,1,15980
HepG2|chr15:85280668-85280714,chr15,85280668,85280714,HepG2|chr15:85259189-85259264,chr15,85259189,85259264,1,21479
HepG2|chr15:85284528-85284554,chr15,85284528,85284554,HepG2|chr15:85260661-85260785,chr15,85260661,85260785,1,23867
HepG2|chr15:89860962-89861010,chr15,89860962,89861010,HepG2|chr15:72522241-72522388,chr15,72522241,72522388,1,17338721
HepG2|chr15:89860962-89861006,chr15,89860962,89861006,HepG2|chr15:72522241-72522388,chr15,72522241,72522388,1,17338721
HepG2|chr15:99411413-99411502,chr15,99411413,99411502,HepG2|chr15:93445963-93446011,chr15,93445963,93446011,1,5965450
HepG2|chr15:99411414-99411502,chr15,99411414,99411502,HepG2|chr15:93445963-93446011,chr15,93445963,93446011,1,5965451
HepG2|chr15:101556668-101556762,chr15,101556668,101556762,HepG2|chr15:101816426-101816524,chr15,101816426,101816524,1,259758
HepG2|chr15:101556668-101556717,chr15,101556668,101556717,HepG2|chr15:101816426-101816524,chr15,101816426,101816524,1,259758
HepG2|chr15:102174626-102174665,chr15,102174626,102174665,HepG2|chr15:90439217-90439328,chr15,90439217,90439328,1,11735409
HepG2|chr16:554574-554621,chr16,554574,554621,HepG2|chr16:680863-680883,chr16,680863,680883,1,126289
HepG2|chr16:558540-558634,chr16,558540,558634,HepG2|chr16:686732-686781,chr16,686732,686781,1,128192
HepG2|chr16:1767806-1767863,chr16,1767806,1767863,HepG2|chr16:1873276-1873360,chr16,1873276,1873360,1,105470
HepG2|chr16:1767806-1767861,chr16,1767806,1767861,HepG2|chr16:1873276-1873348,chr16,1873276,1873348,1,105470
HepG2|chr16:1767807-1767863,chr16,1767807,1767863,HepG2|chr16:1873276-1873360,chr16,1873276,1873360,1,105469
HepG2|chr16:1767835-1767861,chr16,1767835,1767861,HepG2|chr16:1873276-1873358,chr16,1873276,1873358,1,105441
HepG2|chr16:2654027-2654173,chr16,2654027,2654173,HepG2|chr16:2733040-2733190,chr16,2733040,2733190,1,79013
HepG2|chr16:2654080-2654172,chr16,2654080,2654172,HepG2|chr16:2733051-2733200,chr16,2733051,2733200,1,78971
HepG2|chr16:2654792-2654942,chr16,2654792,2654942,HepG2|chr16:2734020-2734167,chr16,2734020,2734167,1,79228
HepG2|chr16:2654793-2654942,chr16,2654793,2654942,HepG2|chr16:2734021-2734167,chr16,2734021,2734167,1,79228
HepG2|chr16:2654977-2655055,chr16,2654977,2655055,HepG2|chr16:2733865-2733955,chr16,2733865,2733955,1,78888
HepG2|chr16:2654995-2655055,chr16,2654995,2655055,HepG2|chr16:2733865-2733955,chr16,2733865,2733955,1,78870
HepG2|chr16:2696914-2697064,chr16,2696914,2697064,HepG2|chr16:2603313-2603460,chr16,2603313,2603460,1,93601
HepG2|chr16:2697007-2697051,chr16,2697007,2697051,HepG2|chr16:2603162-2603282,chr16,2603162,2603282,1,93845
HepG2|chr16:2700335-2700459,chr16,2700335,2700459,HepG2|chr16:2601629-2601677,chr16,2601629,2601677,1,98706
HepG2|chr16:2700462-2700606,chr16,2700462,2700606,HepG2|chr16:2601680-2601782,chr16,2601680,2601782,1,98782
HepG2|chr16:2710098-2710248,chr16,2710098,2710248,HepG2|chr16:2591081-2591231,chr16,2591081,2591231,1,119017
HepG2|chr16:2710101-2710251,chr16,2710101,2710251,HepG2|chr16:2591235-2591385,chr16,2591235,2591385,1,118866
HepG2|chr16:2710102-2710249,chr16,2710102,2710249,HepG2|chr16:2591022-2591172,chr16,2591022,2591172,1,119080
HepG2|chr16:2710111-2710261,chr16,2710111,2710261,HepG2|chr16:2591099-2591249,chr16,2591099,2591249,1,119012
HepG2|chr16:2710207-2710329,chr16,2710207,2710329,HepG2|chr16:2725992-2726046,chr16,2725992,2726046,1,15785
HepG2|chr16:2710233-2710329,chr16,2710233,2710329,HepG2|chr16:2725992-2726046,chr16,2725992,2726046,1,15759
HepG2|chr16:2710798-2710839,chr16,2710798,2710839,HepG2|chr16:2957087-2957203,chr16,2957087,2957203,1,246289
HepG2|chr16:2713265-2713409,chr16,2713265,2713409,HepG2|chr16:2732140-2732196,chr16,2732140,2732196,1,18875
HepG2|chr16:2713358-2713408,chr16,2713358,2713408,HepG2|chr16:2732140-2732235,chr16,2732140,2732235,1,18782
HepG2|chr16:2713378-2713408,chr16,2713378,2713408,HepG2|chr16:2732178-2732328,chr16,2732178,2732328,1,18800
HepG2|chr16:2713383-2713408,chr16,2713383,2713408,HepG2|chr16:2732203-2732350,chr16,2732203,2732350,1,18820
HepG2|chr16:2713386-2713408,chr16,2713386,2713408,HepG2|chr16:2732140-2732196,chr16,2732140,2732196,1,18754
HepG2|chr16:2720013-2720111,chr16,2720013,2720111,HepG2|chr16:2957033-2957153,chr16,2957033,2957153,1,237020
HepG2|chr16:2720545-2720695,chr16,2720545,2720695,HepG2|chr16:2590838-2590954,chr16,2590838,2590954,1,129707
HepG2|chr16:2720700-2720849,chr16,2720700,2720849,HepG2|chr16:2590824-2590974,chr16,2590824,2590974,1,129876
HepG2|chr16:2720758-2720831,chr16,2720758,2720831,HepG2|chr16:2590840-2590990,chr16,2590840,2590990,1,129918
HepG2|chr16:2720765-2720906,chr16,2720765,2720906,HepG2|chr16:2590879-2590909,chr16,2590879,2590909,1,129886
HepG2|chr16:2720804-2720947,chr16,2720804,2720947,HepG2|chr16:2590840-2590990,chr16,2590840,2590990,1,129964
HepG2|chr16:2721074-2721224,chr16,2721074,2721224,HepG2|chr16:2590362-2590512,chr16,2590362,2590512,1,130712
HepG2|chr16:2721074-2721223,chr16,2721074,2721223,HepG2|chr16:2590513-2590663,chr16,2590513,2590663,1,130561
HepG2|chr16:2721102-2721165,chr16,2721102,2721165,HepG2|chr16:2590535-2590685,chr16,2590535,2590685,1,130567
HepG2|chr16:2721124-2721274,chr16,2721124,2721274,HepG2|chr16:2590420-2590570,chr16,2590420,2590570,1,130704
HepG2|chr16:2721146-2721296,chr16,2721146,2721296,HepG2|chr16:2590261-2590382,chr16,2590261,2590382,1,130885
HepG2|chr16:2721147-2721297,chr16,2721147,2721297,HepG2|chr16:2590293-2590329,chr16,2590293,2590329,1,130854
HepG2|chr16:2721372-2721522,chr16,2721372,2721522,HepG2|chr16:2590072-2590222,chr16,2590072,2590222,1,131300
HepG2|chr16:2721487-2721637,chr16,2721487,2721637,HepG2|chr16:2590052-2590202,chr16,2590052,2590202,1,131435
HepG2|chr16:2721487-2721636,chr16,2721487,2721636,HepG2|chr16:2590073-2590198,chr16,2590073,2590198,1,131414
HepG2|chr16:2721498-2721648,chr16,2721498,2721648,HepG2|chr16:2590048-2590198,chr16,2590048,2590198,1,131450
HepG2|chr16:2721500-2721650,chr16,2721500,2721650,HepG2|chr16:2590036-2590186,chr16,2590036,2590186,1,131464
HepG2|chr16:2721500-2721649,chr16,2721500,2721649,HepG2|chr16:2590099-2590202,chr16,2590099,2590202,1,131401
HepG2|chr16:2721504-2721648,chr16,2721504,2721648,HepG2|chr16:2590040-2590187,chr16,2590040,2590187,1,131464
HepG2|chr16:2721505-2721655,chr16,2721505,2721655,HepG2|chr16:2590053-2590203,chr16,2590053,2590203,1,131452
HepG2|chr16:2721506-2721656,chr16,2721506,2721656,HepG2|chr16:2590047-2590192,chr16,2590047,2590192,1,131459
HepG2|chr16:2721513-2721663,chr16,2721513,2721663,HepG2|chr16:2590053-2590203,chr16,2590053,2590203,1,131460
HepG2|chr16:2721521-2721671,chr16,2721521,2721671,HepG2|chr16:2590048-2590198,chr16,2590048,2590198,1,131473
HepG2|chr16:2721521-2721599,chr16,2721521,2721599,HepG2|chr16:2590054-2590201,chr16,2590054,2590201,1,131467
HepG2|chr16:2721531-2721681,chr16,2721531,2721681,HepG2|chr16:2590050-2590200,chr16,2590050,2590200,1,131481
HepG2|chr16:2721541-2721691,chr16,2721541,2721691,HepG2|chr16:2590051-2590201,chr16,2590051,2590201,1,131490
HepG2|chr16:2721545-2721690,chr16,2721545,2721690,HepG2|chr16:2590056-2590201,chr16,2590056,2590201,1,131489
HepG2|chr16:2721547-2721697,chr16,2721547,2721697,HepG2|chr16:2589880-2590030,chr16,2589880,2590030,1,131667
HepG2|chr16:2721549-2721699,chr16,2721549,2721699,HepG2|chr16:2589851-2590001,chr16,2589851,2590001,1,131698
HepG2|chr16:2721556-2721701,chr16,2721556,2721701,HepG2|chr16:2590048-2590198,chr16,2590048,2590198,1,131508
HepG2|chr16:2721557-2721707,chr16,2721557,2721707,HepG2|chr16:2590047-2590194,chr16,2590047,2590194,1,131510
HepG2|chr16:2721566-2721710,chr16,2721566,2721710,HepG2|chr16:2589784-2589934,chr16,2589784,2589934,1,131782
HepG2|chr16:2721567-2721717,chr16,2721567,2721717,HepG2|chr16:2590053-2590203,chr16,2590053,2590203,1,131514
HepG2|chr16:2721574-2721724,chr16,2721574,2721724,HepG2|chr16:2589854-2590001,chr16,2589854,2590001,1,131720
HepG2|chr16:2721575-2721725,chr16,2721575,2721725,HepG2|chr16:2589851-2590000,chr16,2589851,2590000,1,131724
HepG2|chr16:2721576-2721726,chr16,2721576,2721726,HepG2|chr16:2590048-2590198,chr16,2590048,2590198,1,131528
HepG2|chr16:2721577-2721727,chr16,2721577,2721727,HepG2|chr16:2590047-2590187,chr16,2590047,2590187,1,131530
HepG2|chr16:2721582-2721727,chr16,2721582,2721727,HepG2|chr16:2589901-2590017,chr16,2589901,2590017,1,131681
HepG2|chr16:2721586-2721732,chr16,2721586,2721732,HepG2|chr16:2589845-2589995,chr16,2589845,2589995,1,131741
HepG2|chr16:2721587-2721737,chr16,2721587,2721737,HepG2|chr16:2590052-2590202,chr16,2590052,2590202,1,131535
HepG2|chr16:2721591-2721739,chr16,2721591,2721739,HepG2|chr16:2590053-2590203,chr16,2590053,2590203,1,131538
HepG2|chr16:2721592-2721742,chr16,2721592,2721742,HepG2|chr16:2590053-2590203,chr16,2590053,2590203,1,131539
HepG2|chr16:2721610-2721760,chr16,2721610,2721760,HepG2|chr16:2589832-2589982,chr16,2589832,2589982,1,131778
HepG2|chr16:2721780-2721930,chr16,2721780,2721930,HepG2|chr16:2589868-2590018,chr16,2589868,2590018,1,131912
HepG2|chr16:2721788-2721938,chr16,2721788,2721938,HepG2|chr16:2589739-2589889,chr16,2589739,2589889,1,132049
HepG2|chr16:2721883-2722033,chr16,2721883,2722033,HepG2|chr16:2589739-2589886,chr16,2589739,2589886,1,132144
HepG2|chr16:2721893-2722043,chr16,2721893,2722043,HepG2|chr16:2589780-2589927,chr16,2589780,2589927,1,132113
HepG2|chr16:2722209-2722356,chr16,2722209,2722356,HepG2|chr16:2589804-2589882,chr16,2589804,2589882,1,132405
HepG2|chr16:2722412-2722562,chr16,2722412,2722562,HepG2|chr16:2732140-2732179,chr16,2732140,2732179,1,9728
HepG2|chr16:2722460-2722571,chr16,2722460,2722571,HepG2|chr16:2732140-2732179,chr16,2732140,2732179,1,9680
HepG2|chr16:2722841-2722860,chr16,2722841,2722860,HepG2|chr16:2732325-2732358,chr16,2732325,2732358,1,9484
HepG2|chr16:2949371-2949441,chr16,2949371,2949441,HepG2|chr16:2957684-2957791,chr16,2957684,2957791,1,8313
HepG2|chr16:2950275-2950423,chr16,2950275,2950423,HepG2|chr16:2957295-2957334,chr16,2957295,2957334,1,7020
HepG2|chr16:2950275-2950386,chr16,2950275,2950386,HepG2|chr16:2957295-2957334,chr16,2957295,2957334,1,7020
HepG2|chr16:2951068-2951188,chr16,2951068,2951188,HepG2|chr16:2933994-2934070,chr16,2933994,2934070,1,17074
HepG2|chr16:2951068-2951142,chr16,2951068,2951142,HepG2|chr16:2933994-2934070,chr16,2933994,2934070,1,17074
HepG2|chr16:2954882-2955016,chr16,2954882,2955016,HepG2|chr16:2934254-2934270,chr16,2934254,2934270,1,20628
HepG2|chr16:2955572-2955628,chr16,2955572,2955628,HepG2|chr16:2957524-2957598,chr16,2957524,2957598,1,1952
HepG2|chr16:2955845-2955888,chr16,2955845,2955888,HepG2|chr16:2957203-2957323,chr16,2957203,2957323,1,1358
HepG2|chr16:2955845-2955874,chr16,2955845,2955874,HepG2|chr16:2957203-2957323,chr16,2957203,2957323,1,1358
HepG2|chr16:2956168-2956286,chr16,2956168,2956286,HepG2|chr16:2957632-2957675,chr16,2957632,2957675,1,1464
HepG2|chr16:2956168-2956275,chr16,2956168,2956275,HepG2|chr16:2957632-2957675,chr16,2957632,2957675,1,1464
HepG2|chr16:2956252-2956291,chr16,2956252,2956291,HepG2|chr16:2957348-2957432,chr16,2957348,2957432,1,1096
HepG2|chr16:2956349-2956436,chr16,2956349,2956436,HepG2|chr16:2957414-2957525,chr16,2957414,2957525,1,1065
HepG2|chr16:3053122-3053199,chr16,3053122,3053199,HepG2|chr16:3032807-3032880,chr16,3032807,3032880,1,20315
HepG2|chr16:3053141-3053290,chr16,3053141,3053290,HepG2|chr16:3032807-3032880,chr16,3032807,3032880,1,20334
HepG2|chr16:3053182-3053290,chr16,3053182,3053290,HepG2|chr16:3032807-3032880,chr16,3032807,3032880,1,20375
HepG2|chr16:3053193-3053290,chr16,3053193,3053290,HepG2|chr16:3032807-3032880,chr16,3032807,3032880,1,20386
HepG2|chr16:4336497-4336556,chr16,4336497,4336556,HepG2|chr16:4326635-4326761,chr16,4326635,4326761,1,9862
HepG2|chr16:4509399-4509468,chr16,4509399,4509468,HepG2|chr16:4512185-4512259,chr16,4512185,4512259,1,2786
HepG2|chr16:4509404-4509468,chr16,4509404,4509468,HepG2|chr16:4512185-4512259,chr16,4512185,4512259,1,2781
HepG2|chr16:4510064-4510195,chr16,4510064,4510195,HepG2|chr16:4512488-4512595,chr16,4512488,4512595,1,2424
HepG2|chr16:4510152-4510195,chr16,4510152,4510195,HepG2|chr16:4512488-4512595,chr16,4512488,4512595,1,2336
HepG2|chr16:4510471-4510518,chr16,4510471,4510518,HepG2|chr16:4512282-4512305,chr16,4512282,4512305,1,1811
HepG2|chr16:10827069-10827199,chr16,10827069,10827199,HepG2|chr16:10835794-10835944,chr16,10835794,10835944,1,8725
HepG2|chr16:10827071-10827202,chr16,10827071,10827202,HepG2|chr16:10835795-10835862,chr16,10835795,10835862,1,8724
HepG2|chr16:10827119-10827202,chr16,10827119,10827202,HepG2|chr16:10835795-10835862,chr16,10835795,10835862,1,8676
HepG2|chr16:10827122-10827202,chr16,10827122,10827202,HepG2|chr16:10835795-10835862,chr16,10835795,10835862,1,8673
HepG2|chr16:10827124-10827202,chr16,10827124,10827202,HepG2|chr16:10835795-10835904,chr16,10835795,10835904,1,8671
HepG2|chr16:10827127-10827202,chr16,10827127,10827202,HepG2|chr16:10835795-10835851,chr16,10835795,10835851,1,8668
HepG2|chr16:10827137-10827202,chr16,10827137,10827202,HepG2|chr16:10835810-10835960,chr16,10835810,10835960,1,8673
HepG2|chr16:10827158-10827202,chr16,10827158,10827202,HepG2|chr16:10835795-10835905,chr16,10835795,10835905,1,8637
HepG2|chr16:10827161-10827202,chr16,10827161,10827202,HepG2|chr16:10835795-10835904,chr16,10835795,10835904,1,8634
HepG2|chr16:10827162-10827202,chr16,10827162,10827202,HepG2|chr16:10835795-10835905,chr16,10835795,10835905,1,8633
HepG2|chr16:10829812-10829835,chr16,10829812,10829835,HepG2|chr16:10834191-10834309,chr16,10834191,10834309,1,4379
HepG2|chr16:10831876-10831933,chr16,10831876,10831933,HepG2|chr16:10835795-10835933,chr16,10835795,10835933,1,3919
HepG2|chr16:11805768-11805795,chr16,11805768,11805795,HepG2|chr16:11890539-11890662,chr16,11890539,11890662,1,84771
HepG2|chr16:11805849-11805994,chr16,11805849,11805994,HepG2|chr16:11890539-11890662,chr16,11890539,11890662,1,84690
HepG2|chr16:11809675-11809791,chr16,11809675,11809791,HepG2|chr16:11892422-11892523,chr16,11892422,11892523,1,82747
HepG2|chr16:11820502-11820614,chr16,11820502,11820614,HepG2|chr16:11886267-11886305,chr16,11886267,11886305,1,65765
HepG2|chr16:11820636-11820786,chr16,11820636,11820786,HepG2|chr16:11886267-11886305,chr16,11886267,11886305,1,65631
HepG2|chr16:14580874-14580925,chr16,14580874,14580925,HepG2|chr16:33950338-33950416,chr16,33950338,33950416,1,19369464
HepG2|chr16:14580875-14580983,chr16,14580875,14580983,HepG2|chr16:33950337-33950371,chr16,33950337,33950371,1,19369462
HepG2|chr16:14580875-14580982,chr16,14580875,14580982,HepG2|chr16:33950337-33950379,chr16,33950337,33950379,1,19369462
HepG2|chr16:14580875-14580980,chr16,14580875,14580980,HepG2|chr16:33950176-33950205,chr16,33950176,33950205,1,19369301
HepG2|chr16:14580875-14580978,chr16,14580875,14580978,HepG2|chr16:33950176-33950208,chr16,33950176,33950208,1,19369301
HepG2|chr16:14580875-14580977,chr16,14580875,14580977,HepG2|chr16:33950176-33950218,chr16,33950176,33950218,1,19369301
HepG2|chr16:14580875-14580971,chr16,14580875,14580971,HepG2|chr16:33950337-33950382,chr16,33950337,33950382,1,19369462
HepG2|chr16:14580875-14580970,chr16,14580875,14580970,HepG2|chr16:33950176-33950211,chr16,33950176,33950211,1,19369301
HepG2|chr16:14580875-14580969,chr16,14580875,14580969,HepG2|chr16:33950337-33950381,chr16,33950337,33950381,1,19369462
HepG2|chr16:14580875-14580968,chr16,14580875,14580968,HepG2|chr16:33950176-33950207,chr16,33950176,33950207,1,19369301
HepG2|chr16:14580875-14580967,chr16,14580875,14580967,HepG2|chr16:33950176-33950205,chr16,33950176,33950205,1,19369301
HepG2|chr16:14580875-14580966,chr16,14580875,14580966,HepG2|chr16:33950176-33950217,chr16,33950176,33950217,1,19369301
HepG2|chr16:14580875-14580961,chr16,14580875,14580961,HepG2|chr16:33950176-33950206,chr16,33950176,33950206,1,19369301
HepG2|chr16:14580875-14580955,chr16,14580875,14580955,HepG2|chr16:33950337-33950383,chr16,33950337,33950383,1,19369462
HepG2|chr16:14580875-14580953,chr16,14580875,14580953,HepG2|chr16:33950176-33950211,chr16,33950176,33950211,1,19369301
HepG2|chr16:14580875-14580952,chr16,14580875,14580952,HepG2|chr16:33950337-33950379,chr16,33950337,33950379,1,19369462
HepG2|chr16:14580875-14580951,chr16,14580875,14580951,HepG2|chr16:33950176-33950205,chr16,33950176,33950205,1,19369301
HepG2|chr16:14580878-14580952,chr16,14580878,14580952,HepG2|chr16:33950177-33950213,chr16,33950177,33950213,1,19369299
HepG2|chr16:14580886-14580949,chr16,14580886,14580949,HepG2|chr16:33950169-33950256,chr16,33950169,33950256,1,19369283
HepG2|chr16:14580888-14580983,chr16,14580888,14580983,HepG2|chr16:33950163-33950214,chr16,33950163,33950214,1,19369275
HepG2|chr16:14580888-14580980,chr16,14580888,14580980,HepG2|chr16:33950163-33950218,chr16,33950163,33950218,1,19369275
HepG2|chr16:14580888-14580979,chr16,14580888,14580979,HepG2|chr16:33950163-33950218,chr16,33950163,33950218,1,19369275
HepG2|chr16:14580888-14580978,chr16,14580888,14580978,HepG2|chr16:33950163-33950222,chr16,33950163,33950222,1,19369275
HepG2|chr16:14580888-14580977,chr16,14580888,14580977,HepG2|chr16:33950163-33950218,chr16,33950163,33950218,1,19369275
HepG2|chr16:14580888-14580976,chr16,14580888,14580976,HepG2|chr16:33950163-33950218,chr16,33950163,33950218,1,19369275
HepG2|chr16:14580888-14580971,chr16,14580888,14580971,HepG2|chr16:33950176-33950206,chr16,33950176,33950206,1,19369288
HepG2|chr16:14580888-14580970,chr16,14580888,14580970,HepG2|chr16:33950176-33950205,chr16,33950176,33950205,1,19369288
HepG2|chr16:14580888-14580968,chr16,14580888,14580968,HepG2|chr16:33950176-33950207,chr16,33950176,33950207,1,19369288
HepG2|chr16:14580888-14580967,chr16,14580888,14580967,HepG2|chr16:33950176-33950205,chr16,33950176,33950205,1,19369288
HepG2|chr16:14580888-14580966,chr16,14580888,14580966,HepG2|chr16:33950176-33950217,chr16,33950176,33950217,1,19369288
HepG2|chr16:14580888-14580962,chr16,14580888,14580962,HepG2|chr16:33950163-33950218,chr16,33950163,33950218,1,19369275
HepG2|chr16:14580888-14580961,chr16,14580888,14580961,HepG2|chr16:33950176-33950206,chr16,33950176,33950206,1,19369288
HepG2|chr16:14580888-14580953,chr16,14580888,14580953,HepG2|chr16:33950176-33950211,chr16,33950176,33950211,1,19369288
HepG2|chr16:14580888-14580951,chr16,14580888,14580951,HepG2|chr16:33950163-33950214,chr16,33950163,33950214,1,19369275
HepG2|chr16:14580919-14580970,chr16,14580919,14580970,HepG2|chr16:33950133-33950227,chr16,33950133,33950227,1,19369214
HepG2|chr16:14580921-14580983,chr16,14580921,14580983,HepG2|chr16:33950143-33950227,chr16,33950143,33950227,1,19369222
HepG2|chr16:14642677-14642827,chr16,14642677,14642827,HepG2|chr16:4237007-4237106,chr16,4237007,4237106,1,10405670
HepG2|chr16:14642797-14642848,chr16,14642797,14642848,HepG2|chr16:4237007-4237106,chr16,4237007,4237106,1,10405790
HepG2|chr16:14918704-14918854,chr16,14918704,14918854,HepG2|chr16:16317399-16317548,chr16,16317399,16317548,1,1398695
HepG2|chr16:15243508-15243655,chr16,15243508,15243655,HepG2|chr16:2180902-2181052,chr16,2180902,2181052,1,13062606
HepG2|chr16:15244215-15244295,chr16,15244215,15244295,HepG2|chr16:15009697-15009731,chr16,15009697,15009731,1,234518
HepG2|chr16:15244278-15244416,chr16,15244278,15244416,HepG2|chr16:2181698-2181821,chr16,2181698,2181821,1,13062580
HepG2|chr16:15245188-15245281,chr16,15245188,15245281,HepG2|chr16:18492508-18492581,chr16,18492508,18492581,1,3247320
HepG2|chr16:15245239-15245310,chr16,15245239,15245310,HepG2|chr16:2182602-2182752,chr16,2182602,2182752,1,13062637
HepG2|chr16:15245268-15245411,chr16,15245268,15245411,HepG2|chr16:15008685-15008822,chr16,15008685,15008822,1,236583
HepG2|chr16:15245273-15245319,chr16,15245273,15245319,HepG2|chr16:15008690-15008840,chr16,15008690,15008840,1,236583
HepG2|chr16:15245278-15245385,chr16,15245278,15245385,HepG2|chr16:2182472-2182622,chr16,2182472,2182622,1,13062806
HepG2|chr16:15245280-15245396,chr16,15245280,15245396,HepG2|chr16:18492489-18492566,chr16,18492489,18492566,1,3247209
HepG2|chr16:15245657-15245787,chr16,15245657,15245787,HepG2|chr16:2183074-2183120,chr16,2183074,2183120,1,13062583
HepG2|chr16:15245790-15245851,chr16,15245790,15245851,HepG2|chr16:15008121-15008255,chr16,15008121,15008255,1,237669
HepG2|chr16:15245790-15245850,chr16,15245790,15245850,HepG2|chr16:15008119-15008264,chr16,15008119,15008264,1,237671
HepG2|chr16:15245818-15245921,chr16,15245818,15245921,HepG2|chr16:2183011-2183113,chr16,2183011,2183113,1,13062807
HepG2|chr16:15245821-15245946,chr16,15245821,15245946,HepG2|chr16:2183056-2183111,chr16,2183056,2183111,1,13062765
HepG2|chr16:15245835-15245897,chr16,15245835,15245897,HepG2|chr16:2183007-2183106,chr16,2183007,2183106,1,13062828
HepG2|chr16:15245849-15245966,chr16,15245849,15245966,HepG2|chr16:2183013-2183113,chr16,2183013,2183113,1,13062836
HepG2|chr16:15245852-15245944,chr16,15245852,15245944,HepG2|chr16:2183000-2183135,chr16,2183000,2183135,1,13062852
HepG2|chr16:19098146-19098243,chr16,19098146,19098243,HepG2|chr16:19124755-19124830,chr16,19124755,19124830,1,26609
HepG2|chr16:19098174-19098243,chr16,19098174,19098243,HepG2|chr16:19124755-19124830,chr16,19124755,19124830,1,26581
HepG2|chr16:19103697-19103847,chr16,19103697,19103847,HepG2|chr16:19122827-19122862,chr16,19122827,19122862,1,19130
HepG2|chr16:19103748-19103860,chr16,19103748,19103860,HepG2|chr16:19122827-19122862,chr16,19122827,19122862,1,19079
HepG2|chr16:19104691-19104799,chr16,19104691,19104799,HepG2|chr16:19124281-19124431,chr16,19124281,19124431,1,19590
HepG2|chr16:19104694-19104799,chr16,19104694,19104799,HepG2|chr16:19124234-19124384,chr16,19124234,19124384,1,19540
HepG2|chr16:19104720-19104799,chr16,19104720,19104799,HepG2|chr16:19124222-19124293,chr16,19124222,19124293,1,19502
HepG2|chr16:19104749-19104799,chr16,19104749,19104799,HepG2|chr16:19124222-19124298,chr16,19124222,19124298,1,19473
HepG2|chr16:19111614-19111704,chr16,19111614,19111704,HepG2|chr16:19124755-19124830,chr16,19124755,19124830,1,13141
HepG2|chr16:19111635-19111704,chr16,19111635,19111704,HepG2|chr16:19124755-19124830,chr16,19124755,19124830,1,13120
HepG2|chr16:19117595-19117627,chr16,19117595,19117627,HepG2|chr16:19124350-19124494,chr16,19124350,19124494,1,6755
HepG2|chr16:19119654-19119751,chr16,19119654,19119751,HepG2|chr16:19122860-19122913,chr16,19122860,19122913,1,3206
HepG2|chr16:19119816-19119866,chr16,19119816,19119866,HepG2|chr16:19123383-19123408,chr16,19123383,19123408,1,3567
HepG2|chr16:19120144-19120254,chr16,19120144,19120254,HepG2|chr16:19124717-19124832,chr16,19124717,19124832,1,4573
HepG2|chr16:21513502-21513652,chr16,21513502,21513652,HepG2|chr16:18937861-18937988,chr16,18937861,18937988,1,2575641
HepG2|chr16:21513504-21513649,chr16,21513504,21513649,HepG2|chr16:18937922-18937974,chr16,18937922,18937974,1,2575582
HepG2|chr16:21513507-21513657,chr16,21513507,21513657,HepG2|chr16:18937936-18937990,chr16,18937936,18937990,1,2575571
HepG2|chr16:21513513-21513560,chr16,21513513,21513560,HepG2|chr16:18937861-18937989,chr16,18937861,18937989,1,2575652
HepG2|chr16:21513526-21513676,chr16,21513526,21513676,HepG2|chr16:18937861-18937990,chr16,18937861,18937990,1,2575665
HepG2|chr16:21513535-21513685,chr16,21513535,21513685,HepG2|chr16:18937922-18937973,chr16,18937922,18937973,1,2575613
HepG2|chr16:21513570-21513720,chr16,21513570,21513720,HepG2|chr16:18937922-18937982,chr16,18937922,18937982,1,2575648
HepG2|chr16:21513597-21513747,chr16,21513597,21513747,HepG2|chr16:18937912-18938060,chr16,18937912,18938060,1,2575685
HepG2|chr16:21513608-21513758,chr16,21513608,21513758,HepG2|chr16:18937861-18937989,chr16,18937861,18937989,1,2575747
HepG2|chr16:21513610-21513759,chr16,21513610,21513759,HepG2|chr16:18937934-18937970,chr16,18937934,18937970,1,2575676
HepG2|chr16:21513633-21513732,chr16,21513633,21513732,HepG2|chr16:18937922-18937973,chr16,18937922,18937973,1,2575711
HepG2|chr16:21513634-21513732,chr16,21513634,21513732,HepG2|chr16:18937922-18937974,chr16,18937922,18937974,1,2575712
HepG2|chr16:21513635-21513766,chr16,21513635,21513766,HepG2|chr16:18937922-18937976,chr16,18937922,18937976,1,2575713
HepG2|chr16:21513636-21513732,chr16,21513636,21513732,HepG2|chr16:18937922-18937976,chr16,18937922,18937976,1,2575714
HepG2|chr16:21513642-21513732,chr16,21513642,21513732,HepG2|chr16:18937914-18938064,chr16,18937914,18938064,1,2575728
HepG2|chr16:21513645-21513732,chr16,21513645,21513732,HepG2|chr16:18937922-18937982,chr16,18937922,18937982,1,2575723
HepG2|chr16:21513645-21513715,chr16,21513645,21513715,HepG2|chr16:18937899-18937980,chr16,18937899,18937980,1,2575746
HepG2|chr16:21513646-21513732,chr16,21513646,21513732,HepG2|chr16:18937922-18937982,chr16,18937922,18937982,1,2575724
HepG2|chr16:21513647-21513732,chr16,21513647,21513732,HepG2|chr16:18937922-18937982,chr16,18937922,18937982,1,2575725
HepG2|chr16:21513650-21513732,chr16,21513650,21513732,HepG2|chr16:18937922-18937987,chr16,18937922,18937987,1,2575728
HepG2|chr16:21513653-21513732,chr16,21513653,21513732,HepG2|chr16:18937922-18937993,chr16,18937922,18937993,1,2575731
HepG2|chr16:21513655-21513763,chr16,21513655,21513763,HepG2|chr16:18937861-18937988,chr16,18937861,18937988,1,2575794
HepG2|chr16:21513658-21513763,chr16,21513658,21513763,HepG2|chr16:18937912-18938062,chr16,18937912,18938062,1,2575746
HepG2|chr16:21513658-21513715,chr16,21513658,21513715,HepG2|chr16:18937861-18937987,chr16,18937861,18937987,1,2575797
HepG2|chr16:21513687-21513763,chr16,21513687,21513763,HepG2|chr16:18937912-18938061,chr16,18937912,18938061,1,2575775
HepG2|chr16:21513872-21513949,chr16,21513872,21513949,HepG2|chr16:18938019-18938063,chr16,18938019,18938063,1,2575853
HepG2|chr16:21513893-21513971,chr16,21513893,21513971,HepG2|chr16:18937922-18938068,chr16,18937922,18938068,1,2575971
HepG2|chr16:21513893-21513953,chr16,21513893,21513953,HepG2|chr16:18938019-18938063,chr16,18938019,18938063,1,2575874
HepG2|chr16:21513894-21513955,chr16,21513894,21513955,HepG2|chr16:18937861-18937983,chr16,18937861,18937983,1,2576033
HepG2|chr16:21513895-21513988,chr16,21513895,21513988,HepG2|chr16:18937927-18938063,chr16,18937927,18938063,1,2575968
HepG2|chr16:21513896-21514017,chr16,21513896,21514017,HepG2|chr16:18937929-18938063,chr16,18937929,18938063,1,2575967
HepG2|chr16:21513898-21514008,chr16,21513898,21514008,HepG2|chr16:18937915-18938064,chr16,18937915,18938064,1,2575983
HepG2|chr16:21513898-21513955,chr16,21513898,21513955,HepG2|chr16:18937861-18937982,chr16,18937861,18937982,1,2576037
HepG2|chr16:21513907-21514039,chr16,21513907,21514039,HepG2|chr16:18937924-18938063,chr16,18937924,18938063,1,2575983
HepG2|chr16:21513909-21514039,chr16,21513909,21514039,HepG2|chr16:18937924-18938063,chr16,18937924,18938063,1,2575985
HepG2|chr16:21513916-21514019,chr16,21513916,21514019,HepG2|chr16:18937916-18938063,chr16,18937916,18938063,1,2576000
HepG2|chr16:21513940-21514045,chr16,21513940,21514045,HepG2|chr16:18937918-18938063,chr16,18937918,18938063,1,2576022
HepG2|chr16:21513966-21514001,chr16,21513966,21514001,HepG2|chr16:18937924-18938063,chr16,18937924,18938063,1,2576042
HepG2|chr16:21514326-21514476,chr16,21514326,21514476,HepG2|chr16:18937926-18937970,chr16,18937926,18937970,1,2576400
HepG2|chr16:21521299-21521415,chr16,21521299,21521415,HepG2|chr16:87892606-87892722,chr16,87892606,87892722,1,66371307
HepG2|chr16:21522339-21522489,chr16,21522339,21522489,HepG2|chr16:87893793-87893890,chr16,87893793,87893890,1,66371454
HepG2|chr16:21522613-21522744,chr16,21522613,21522744,HepG2|chr16:87893916-87893947,chr16,87893916,87893947,1,66371303
HepG2|chr16:21522624-21522740,chr16,21522624,21522740,HepG2|chr16:87893916-87893947,chr16,87893916,87893947,1,66371292
HepG2|chr16:21522624-21522681,chr16,21522624,21522681,HepG2|chr16:87893916-87893947,chr16,87893916,87893947,1,66371292
HepG2|chr16:21522627-21522708,chr16,21522627,21522708,HepG2|chr16:87893914-87893948,chr16,87893914,87893948,1,66371287
HepG2|chr16:21522627-21522662,chr16,21522627,21522662,HepG2|chr16:87893913-87893948,chr16,87893913,87893948,1,66371286
HepG2|chr16:21522916-21523036,chr16,21522916,21523036,HepG2|chr16:87894254-87894282,chr16,87894254,87894282,1,66371338
HepG2|chr16:21522925-21523036,chr16,21522925,21523036,HepG2|chr16:87894238-87894297,chr16,87894238,87894297,1,66371313
HepG2|chr16:21522965-21523045,chr16,21522965,21523045,HepG2|chr16:87894260-87894290,chr16,87894260,87894290,1,66371295
HepG2|chr16:21522983-21523098,chr16,21522983,21523098,HepG2|chr16:87894255-87894277,chr16,87894255,87894277,1,66371272
HepG2|chr16:21524290-21524426,chr16,21524290,21524426,HepG2|chr16:87895666-87895811,chr16,87895666,87895811,1,66371376
HepG2|chr16:21524366-21524401,chr16,21524366,21524401,HepG2|chr16:87895659-87895773,chr16,87895659,87895773,1,66371293
HepG2|chr16:21524378-21524527,chr16,21524378,21524527,HepG2|chr16:87895657-87895803,chr16,87895657,87895803,1,66371279
HepG2|chr16:21525057-21525177,chr16,21525057,21525177,HepG2|chr16:87893657-87893755,chr16,87893657,87893755,1,66368600
HepG2|chr16:21525728-21525760,chr16,21525728,21525760,HepG2|chr16:87896930-87897080,chr16,87896930,87897080,1,66371202
HepG2|chr16:21526321-21526471,chr16,21526321,21526471,HepG2|chr16:87897906-87898053,chr16,87897906,87898053,1,66371585
HepG2|chr16:21526515-21526665,chr16,21526515,21526665,HepG2|chr16:87897768-87897915,chr16,87897768,87897915,1,66371253
HepG2|chr16:21527366-21527445,chr16,21527366,21527445,HepG2|chr16:87898759-87898803,chr16,87898759,87898803,1,66371393
HepG2|chr16:21528236-21528386,chr16,21528236,21528386,HepG2|chr16:87899721-87899854,chr16,87899721,87899854,1,66371485
HepG2|chr16:21528333-21528473,chr16,21528333,21528473,HepG2|chr16:87899720-87899870,chr16,87899720,87899870,1,66371387
HepG2|chr16:21528348-21528481,chr16,21528348,21528481,HepG2|chr16:87899720-87899870,chr16,87899720,87899870,1,66371372
HepG2|chr16:21528356-21528481,chr16,21528356,21528481,HepG2|chr16:87899729-87899879,chr16,87899729,87899879,1,66371373
HepG2|chr16:21528356-21528474,chr16,21528356,21528474,HepG2|chr16:87899716-87899866,chr16,87899716,87899866,1,66371360
HepG2|chr16:21528365-21528444,chr16,21528365,21528444,HepG2|chr16:87899763-87899845,chr16,87899763,87899845,1,66371398
HepG2|chr16:21528371-21528521,chr16,21528371,21528521,HepG2|chr16:87899704-87899822,chr16,87899704,87899822,1,66371333
HepG2|chr16:21528371-21528519,chr16,21528371,21528519,HepG2|chr16:87899695-87899822,chr16,87899695,87899822,1,66371324
HepG2|chr16:21528376-21528526,chr16,21528376,21528526,HepG2|chr16:87899823-87899949,chr16,87899823,87899949,1,66371447
HepG2|chr16:21528434-21528481,chr16,21528434,21528481,HepG2|chr16:87899717-87899863,chr16,87899717,87899863,1,66371283
HepG2|chr16:21528525-21528675,chr16,21528525,21528675,HepG2|chr16:87899717-87899863,chr16,87899717,87899863,1,66371192
HepG2|chr16:21528715-21528865,chr16,21528715,21528865,HepG2|chr16:87900190-87900334,chr16,87900190,87900334,1,66371475
HepG2|chr16:21530080-21530210,chr16,21530080,21530210,HepG2|chr16:87901411-87901537,chr16,87901411,87901537,1,66371331
HepG2|chr16:21530805-21530955,chr16,21530805,21530955,HepG2|chr16:87902237-87902386,chr16,87902237,87902386,1,66371432
HepG2|chr16:21530809-21530958,chr16,21530809,21530958,HepG2|chr16:87902204-87902353,chr16,87902204,87902353,1,66371395
HepG2|chr16:21530809-21530956,chr16,21530809,21530956,HepG2|chr16:87902011-87902161,chr16,87902011,87902161,1,66371202
HepG2|chr16:21530810-21530956,chr16,21530810,21530956,HepG2|chr16:87901972-87902121,chr16,87901972,87902121,1,66371162
HepG2|chr16:21530811-21530956,chr16,21530811,21530956,HepG2|chr16:87902214-87902364,chr16,87902214,87902364,1,66371403
HepG2|chr16:21530821-21530968,chr16,21530821,21530968,HepG2|chr16:87902056-87902198,chr16,87902056,87902198,1,66371235
HepG2|chr16:21530823-21530973,chr16,21530823,21530973,HepG2|chr16:87902009-87902159,chr16,87902009,87902159,1,66371186
HepG2|chr16:21530826-21530976,chr16,21530826,21530976,HepG2|chr16:87902007-87902157,chr16,87902007,87902157,1,66371181
HepG2|chr16:21530827-21530976,chr16,21530827,21530976,HepG2|chr16:87902007-87902157,chr16,87902007,87902157,1,66371180
HepG2|chr16:21530828-21530975,chr16,21530828,21530975,HepG2|chr16:87902207-87902357,chr16,87902207,87902357,1,66371379
HepG2|chr16:21530840-21530990,chr16,21530840,21530990,HepG2|chr16:87902290-87902440,chr16,87902290,87902440,1,66371450
HepG2|chr16:21530845-21530991,chr16,21530845,21530991,HepG2|chr16:87902206-87902356,chr16,87902206,87902356,1,66371361
HepG2|chr16:21885804-21885936,chr16,21885804,21885936,HepG2|chr16:22553213-22553260,chr16,22553213,22553260,1,667409
HepG2|chr16:21885847-21885911,chr16,21885847,21885911,HepG2|chr16:22553244-22553370,chr16,22553244,22553370,1,667397
HepG2|chr16:21885912-21885951,chr16,21885912,21885951,HepG2|chr16:21453547-21453654,chr16,21453547,21453654,1,432365
HepG2|chr16:21885912-21885947,chr16,21885912,21885947,HepG2|chr16:22553238-22553378,chr16,22553238,22553378,1,667326
HepG2|chr16:21886555-21886606,chr16,21886555,21886606,HepG2|chr16:21454614-21454713,chr16,21454614,21454713,1,431941
HepG2|chr16:21887509-21887657,chr16,21887509,21887657,HepG2|chr16:21455187-21455250,chr16,21455187,21455250,1,432322
HepG2|chr16:21888379-21888405,chr16,21888379,21888405,HepG2|chr16:21456052-21456122,chr16,21456052,21456122,1,432327
HepG2|chr16:21888379-21888404,chr16,21888379,21888404,HepG2|chr16:21456003-21456122,chr16,21456003,21456122,1,432376
HepG2|chr16:21889472-21889557,chr16,21889472,21889557,HepG2|chr16:22448157-22448286,chr16,22448157,22448286,1,558685
HepG2|chr16:22372979-22373016,chr16,22372979,22373016,HepG2|chr16:69222722-69222870,chr16,69222722,69222870,1,46849743
HepG2|chr16:27290946-27290978,chr16,27290946,27290978,HepG2|chr16:28836138-28836288,chr16,28836138,28836288,1,1545192
HepG2|chr16:27290946-27290976,chr16,27290946,27290976,HepG2|chr16:28836231-28836378,chr16,28836231,28836378,1,1545285
HepG2|chr16:28814305-28814421,chr16,28814305,28814421,HepG2|chr16:28700229-28700262,chr16,28700229,28700262,1,114076
HepG2|chr16:28814306-28814421,chr16,28814306,28814421,HepG2|chr16:28700229-28700261,chr16,28700229,28700261,1,114077
HepG2|chr16:29086569-29086719,chr16,29086569,29086719,HepG2|chr16:15187544-15187691,chr16,15187544,15187691,1,13899025
HepG2|chr16:29086588-29086738,chr16,29086588,29086738,HepG2|chr16:15187589-15187739,chr16,15187589,15187739,1,13898999
HepG2|chr16:29086589-29086736,chr16,29086589,29086736,HepG2|chr16:15187544-15187691,chr16,15187544,15187691,1,13899045
HepG2|chr16:29086626-29086772,chr16,29086626,29086772,HepG2|chr16:15187811-15187959,chr16,15187811,15187959,1,13898815
HepG2|chr16:29086629-29086779,chr16,29086629,29086779,HepG2|chr16:15187589-15187739,chr16,15187589,15187739,1,13899040
HepG2|chr16:29086630-29086780,chr16,29086630,29086780,HepG2|chr16:15187532-15187679,chr16,15187532,15187679,1,13899098
HepG2|chr16:29106397-29106538,chr16,29106397,29106538,HepG2|chr16:22448138-22448227,chr16,22448138,22448227,1,6658259
HepG2|chr16:29106397-29106497,chr16,29106397,29106497,HepG2|chr16:22448198-22448227,chr16,22448198,22448227,1,6658199
HepG2|chr16:29106423-29106523,chr16,29106423,29106523,HepG2|chr16:22448135-22448274,chr16,22448135,22448274,1,6658288
HepG2|chr16:29106429-29106579,chr16,29106429,29106579,HepG2|chr16:22448135-22448270,chr16,22448135,22448270,1,6658294
HepG2|chr16:29106432-29106488,chr16,29106432,29106488,HepG2|chr16:22448157-22448219,chr16,22448157,22448219,1,6658275
HepG2|chr16:29106435-29106519,chr16,29106435,29106519,HepG2|chr16:22448233-22448320,chr16,22448233,22448320,1,6658202
HepG2|chr16:29106439-29106543,chr16,29106439,29106543,HepG2|chr16:22448198-22448227,chr16,22448198,22448227,1,6658241
HepG2|chr16:29432135-29432285,chr16,29432135,29432285,HepG2|chr16:22553196-22553261,chr16,22553196,22553261,1,6878939
HepG2|chr16:29432177-29432327,chr16,29432177,29432327,HepG2|chr16:22553168-22553279,chr16,22553168,22553279,1,6879009
HepG2|chr16:29432306-29432409,chr16,29432306,29432409,HepG2|chr16:22553220-22553260,chr16,22553220,22553260,1,6879086
HepG2|chr16:29432307-29432444,chr16,29432307,29432444,HepG2|chr16:22553211-22553265,chr16,22553211,22553265,1,6879096
HepG2|chr16:29432313-29432446,chr16,29432313,29432446,HepG2|chr16:22553131-22553276,chr16,22553131,22553276,1,6879182
HepG2|chr16:29432413-29432563,chr16,29432413,29432563,HepG2|chr16:22553245-22553359,chr16,22553245,22553359,1,6879168
HepG2|chr16:29532403-29532533,chr16,29532403,29532533,HepG2|chr16:66634026-66634147,chr16,66634026,66634147,1,37101623
HepG2|chr16:29532404-29532533,chr16,29532404,29532533,HepG2|chr16:66634026-66634147,chr16,66634026,66634147,1,37101622
HepG2|chr16:29534026-29534141,chr16,29534026,29534141,HepG2|chr16:22553154-22553264,chr16,22553154,22553264,1,6980872
HepG2|chr16:29534032-29534159,chr16,29534032,29534159,HepG2|chr16:22553108-22553245,chr16,22553108,22553245,1,6980924
HepG2|chr16:29589694-29589765,chr16,29589694,29589765,HepG2|chr16:87899129-87899279,chr16,87899129,87899279,1,58309435
HepG2|chr16:29590868-29590932,chr16,29590868,29590932,HepG2|chr16:29830398-29830464,chr16,29830398,29830464,1,239530
HepG2|chr16:29604649-29604799,chr16,29604649,29604799,HepG2|chr16:18935933-18936076,chr16,18935933,18936076,1,10668716
HepG2|chr16:29604776-29604917,chr16,29604776,29604917,HepG2|chr16:18935920-18936066,chr16,18935920,18936066,1,10668856
HepG2|chr16:29604805-29604917,chr16,29604805,29604917,HepG2|chr16:18935929-18936068,chr16,18935929,18936068,1,10668876
HepG2|chr16:29604809-29604917,chr16,29604809,29604917,HepG2|chr16:18935971-18936048,chr16,18935971,18936048,1,10668838
HepG2|chr16:29606788-29606925,chr16,29606788,29606925,HepG2|chr16:18937906-18938056,chr16,18937906,18938056,1,10668882
HepG2|chr16:29614575-29614724,chr16,29614575,29614724,HepG2|chr16:87892764-87892860,chr16,87892764,87892860,1,58278189
HepG2|chr16:29617849-29617999,chr16,29617849,29617999,HepG2|chr16:87896061-87896156,chr16,87896061,87896156,1,58278212
HepG2|chr16:29620774-29620924,chr16,29620774,29620924,HepG2|chr16:87899075-87899167,chr16,87899075,87899167,1,58278301
HepG2|chr16:29620845-29620995,chr16,29620845,29620995,HepG2|chr16:87899056-87899206,chr16,87899056,87899206,1,58278211
HepG2|chr16:29620853-29621003,chr16,29620853,29621003,HepG2|chr16:87899060-87899144,chr16,87899060,87899144,1,58278207
HepG2|chr16:29620927-29621074,chr16,29620927,29621074,HepG2|chr16:87899017-87899167,chr16,87899017,87899167,1,58278090
HepG2|chr16:29621079-29621224,chr16,29621079,29621224,HepG2|chr16:87899043-87899193,chr16,87899043,87899193,1,58277964
HepG2|chr16:29621989-29622139,chr16,29621989,29622139,HepG2|chr16:87899949-87900089,chr16,87899949,87900089,1,58277960
HepG2|chr16:29621991-29622138,chr16,29621991,29622138,HepG2|chr16:87900038-87900089,chr16,87900038,87900089,1,58278047
HepG2|chr16:29621991-29622129,chr16,29621991,29622129,HepG2|chr16:87900121-87900271,chr16,87900121,87900271,1,58278130
HepG2|chr16:29621993-29622098,chr16,29621993,29622098,HepG2|chr16:87900102-87900247,chr16,87900102,87900247,1,58278109
HepG2|chr16:29622133-29622282,chr16,29622133,29622282,HepG2|chr16:87900133-87900280,chr16,87900133,87900280,1,58278000
HepG2|chr16:29622143-29622293,chr16,29622143,29622293,HepG2|chr16:87900178-87900328,chr16,87900178,87900328,1,58278035
HepG2|chr16:29622493-29622619,chr16,29622493,29622619,HepG2|chr16:87900451-87900545,chr16,87900451,87900545,1,58277958
HepG2|chr16:29622557-29622622,chr16,29622557,29622622,HepG2|chr16:87900371-87900521,chr16,87900371,87900521,1,58277814
HepG2|chr16:29623735-29623789,chr16,29623735,29623789,HepG2|chr16:87901578-87901721,chr16,87901578,87901721,1,58277843
HepG2|chr16:30274083-30274223,chr16,30274083,30274223,HepG2|chr16:22553245-22553384,chr16,22553245,22553384,1,7720838
HepG2|chr16:30274083-30274219,chr16,30274083,30274219,HepG2|chr16:22553241-22553380,chr16,22553241,22553380,1,7720842
HepG2|chr16:30274090-30274221,chr16,30274090,30274221,HepG2|chr16:22553240-22553381,chr16,22553240,22553381,1,7720850
HepG2|chr16:30274090-30274218,chr16,30274090,30274218,HepG2|chr16:22553239-22553383,chr16,22553239,22553383,1,7720851
HepG2|chr16:30274093-30274211,chr16,30274093,30274211,HepG2|chr16:22553234-22553380,chr16,22553234,22553380,1,7720859
HepG2|chr16:30274093-30274191,chr16,30274093,30274191,HepG2|chr16:22553234-22553380,chr16,22553234,22553380,1,7720859
HepG2|chr16:30274093-30274149,chr16,30274093,30274149,HepG2|chr16:22553231-22553369,chr16,22553231,22553369,1,7720862
HepG2|chr16:30628391-30628452,chr16,30628391,30628452,HepG2|chr16:30763530-30763605,chr16,30763530,30763605,1,135139
HepG2|chr16:30628392-30628452,chr16,30628392,30628452,HepG2|chr16:30763530-30763605,chr16,30763530,30763605,1,135138
HepG2|chr16:30628394-30628452,chr16,30628394,30628452,HepG2|chr16:30763617-30763767,chr16,30763617,30763767,1,135223
HepG2|chr16:30812259-30812315,chr16,30812259,30812315,HepG2|chr16:30908977-30909018,chr16,30908977,30909018,1,96718
HepG2|chr16:30812267-30812315,chr16,30812267,30812315,HepG2|chr16:30908977-30909018,chr16,30908977,30909018,1,96710
HepG2|chr16:30820712-30820838,chr16,30820712,30820838,HepG2|chr16:30759404-30759436,chr16,30759404,30759436,1,61308
HepG2|chr16:30820712-30820830,chr16,30820712,30820830,HepG2|chr16:30759404-30759436,chr16,30759404,30759436,1,61308
HepG2|chr16:30860324-30860406,chr16,30860324,30860406,HepG2|chr16:30763468-30763536,chr16,30763468,30763536,1,96856
HepG2|chr16:30888215-30888303,chr16,30888215,30888303,HepG2|chr16:30963026-30963082,chr16,30963026,30963082,1,74811
HepG2|chr16:30888279-30888304,chr16,30888279,30888304,HepG2|chr16:30963026-30963082,chr16,30963026,30963082,1,74747
HepG2|chr16:30894390-30894463,chr16,30894390,30894463,HepG2|chr16:30963473-30963547,chr16,30963473,30963547,1,69083
HepG2|chr16:31028819-31028905,chr16,31028819,31028905,HepG2|chr16:31126625-31126669,chr16,31126625,31126669,1,97806
HepG2|chr16:31512614-31512645,chr16,31512614,31512645,HepG2|chr16:31121861-31121980,chr16,31121861,31121980,1,390753
HepG2|chr16:31512615-31512713,chr16,31512615,31512713,HepG2|chr16:31121861-31121980,chr16,31121861,31121980,1,390754
HepG2|chr16:56408655-56408756,chr16,56408655,56408756,HepG2|chr16:8957891-8957960,chr16,8957891,8957960,1,47450764
HepG2|chr16:56408655-56408736,chr16,56408655,56408736,HepG2|chr16:8957891-8957960,chr16,8957891,8957960,1,47450764
HepG2|chr16:57015655-57015756,chr16,57015655,57015756,HepG2|chr16:57022100-57022137,chr16,57022100,57022137,1,6445
HepG2|chr16:57016957-57017044,chr16,57016957,57017044,HepG2|chr16:57021741-57021804,chr16,57021741,57021804,1,4784
HepG2|chr16:57016958-57017070,chr16,57016958,57017070,HepG2|chr16:57021741-57021804,chr16,57021741,57021804,1,4783
HepG2|chr16:58647065-58647165,chr16,58647065,58647165,HepG2|chr16:31192170-31192320,chr16,31192170,31192320,1,27454895
HepG2|chr16:68256206-68256245,chr16,68256206,68256245,HepG2|chr16:68350418-68350449,chr16,68350418,68350449,1,94212
HepG2|chr16:69713919-69714007,chr16,69713919,69714007,HepG2|chr16:67145690-67145752,chr16,67145690,67145752,1,2568229
HepG2|chr16:69998376-69998494,chr16,69998376,69998494,HepG2|chr16:56899985-56900135,chr16,56899985,56900135,1,13098391
HepG2|chr16:69998376-69998483,chr16,69998376,69998483,HepG2|chr16:56899894-56900040,chr16,56899894,56900040,1,13098482
HepG2|chr16:69998376-69998478,chr16,69998376,69998478,HepG2|chr16:56900025-56900175,chr16,56900025,56900175,1,13098351
HepG2|chr16:69998376-69998470,chr16,69998376,69998470,HepG2|chr16:56900100-56900250,chr16,56900100,56900250,1,13098276
HepG2|chr16:69998376-69998427,chr16,69998376,69998427,HepG2|chr16:56899985-56900135,chr16,56899985,56900135,1,13098391
HepG2|chr16:69998379-69998462,chr16,69998379,69998462,HepG2|chr16:56899915-56900060,chr16,56899915,56900060,1,13098464
HepG2|chr16:69998379-69998454,chr16,69998379,69998454,HepG2|chr16:56899992-56900142,chr16,56899992,56900142,1,13098387
HepG2|chr16:69998379-69998428,chr16,69998379,69998428,HepG2|chr16:56899989-56900139,chr16,56899989,56900139,1,13098390
HepG2|chr16:69998382-69998462,chr16,69998382,69998462,HepG2|chr16:56899985-56900135,chr16,56899985,56900135,1,13098397
HepG2|chr16:69998382-69998461,chr16,69998382,69998461,HepG2|chr16:56899842-56899876,chr16,56899842,56899876,1,13098540
HepG2|chr16:69998382-69998458,chr16,69998382,69998458,HepG2|chr16:56900034-56900142,chr16,56900034,56900142,1,13098348
HepG2|chr16:69998382-69998432,chr16,69998382,69998432,HepG2|chr16:56899915-56900045,chr16,56899915,56900045,1,13098467
HepG2|chr16:69998382-69998429,chr16,69998382,69998429,HepG2|chr16:56899989-56900139,chr16,56899989,56900139,1,13098393
HepG2|chr16:70094479-70094511,chr16,70094479,70094511,HepG2|chr16:15074180-15074283,chr16,15074180,15074283,1,55020299
HepG2|chr16:70094479-70094510,chr16,70094479,70094510,HepG2|chr16:15074180-15074283,chr16,15074180,15074283,1,55020299
HepG2|chr16:70095121-70095271,chr16,70095121,70095271,HepG2|chr16:15073580-15073727,chr16,15073580,15073727,1,55021541
HepG2|chr16:70095402-70095512,chr16,70095402,70095512,HepG2|chr16:15073124-15073190,chr16,15073124,15073190,1,55022278
HepG2|chr16:70095419-70095569,chr16,70095419,70095569,HepG2|chr16:15073143-15073263,chr16,15073143,15073263,1,55022276
HepG2|chr16:70095420-70095570,chr16,70095420,70095570,HepG2|chr16:15073141-15073291,chr16,15073141,15073291,1,55022279
HepG2|chr16:70095464-70095614,chr16,70095464,70095614,HepG2|chr16:15073136-15073164,chr16,15073136,15073164,1,55022328
HepG2|chr16:70095506-70095583,chr16,70095506,70095583,HepG2|chr16:15073032-15073182,chr16,15073032,15073182,1,55022474
HepG2|chr16:70095546-70095696,chr16,70095546,70095696,HepG2|chr16:15073164-15073298,chr16,15073164,15073298,1,55022382
HepG2|chr16:70095571-70095629,chr16,70095571,70095629,HepG2|chr16:15073146-15073155,chr16,15073146,15073155,1,55022425
HepG2|chr16:70095573-70095716,chr16,70095573,70095716,HepG2|chr16:15073242-15073389,chr16,15073242,15073389,1,55022331
HepG2|chr16:70095584-70095709,chr16,70095584,70095709,HepG2|chr16:15073139-15073289,chr16,15073139,15073289,1,55022445
HepG2|chr16:70095584-70095653,chr16,70095584,70095653,HepG2|chr16:15073139-15073289,chr16,15073139,15073289,1,55022445
HepG2|chr16:70095584-70095642,chr16,70095584,70095642,HepG2|chr16:15073139-15073289,chr16,15073139,15073289,1,55022445
HepG2|chr16:70095584-70095624,chr16,70095584,70095624,HepG2|chr16:15073139-15073289,chr16,15073139,15073289,1,55022445
HepG2|chr16:70095584-70095617,chr16,70095584,70095617,HepG2|chr16:15073139-15073289,chr16,15073139,15073289,1,55022445
HepG2|chr16:70095584-70095614,chr16,70095584,70095614,HepG2|chr16:15073139-15073289,chr16,15073139,15073289,1,55022445
HepG2|chr16:70095712-70095751,chr16,70095712,70095751,HepG2|chr16:15073072-15073146,chr16,15073072,15073146,1,55022640
HepG2|chr16:70096468-70096618,chr16,70096468,70096618,HepG2|chr16:15072178-15072328,chr16,15072178,15072328,1,55024290
HepG2|chr16:70096482-70096632,chr16,70096482,70096632,HepG2|chr16:15072179-15072328,chr16,15072179,15072328,1,55024303
HepG2|chr16:70096561-70096685,chr16,70096561,70096685,HepG2|chr16:15072063-15072100,chr16,15072063,15072100,1,55024498
HepG2|chr16:70096567-70096717,chr16,70096567,70096717,HepG2|chr16:15071958-15072108,chr16,15071958,15072108,1,55024609
HepG2|chr16:70096567-70096716,chr16,70096567,70096716,HepG2|chr16:15071944-15072094,chr16,15071944,15072094,1,55024623
HepG2|chr16:70096568-70096718,chr16,70096568,70096718,HepG2|chr16:15071971-15072121,chr16,15071971,15072121,1,55024597
HepG2|chr16:70096572-70096722,chr16,70096572,70096722,HepG2|chr16:15071944-15072094,chr16,15071944,15072094,1,55024628
HepG2|chr16:70096572-70096721,chr16,70096572,70096721,HepG2|chr16:15072183-15072333,chr16,15072183,15072333,1,55024389
HepG2|chr16:70096771-70096921,chr16,70096771,70096921,HepG2|chr16:15071957-15072107,chr16,15071957,15072107,1,55024814
HepG2|chr16:70096793-70096943,chr16,70096793,70096943,HepG2|chr16:15071957-15072107,chr16,15071957,15072107,1,55024836
HepG2|chr16:70097489-70097594,chr16,70097489,70097594,HepG2|chr16:15071085-15071151,chr16,15071085,15071151,1,55026404
HepG2|chr16:70097609-70097759,chr16,70097609,70097759,HepG2|chr16:15071127-15071264,chr16,15071127,15071264,1,55026482
HepG2|chr16:70097609-70097747,chr16,70097609,70097747,HepG2|chr16:15071126-15071258,chr16,15071126,15071258,1,55026483
HepG2|chr16:70097609-70097725,chr16,70097609,70097725,HepG2|chr16:15071129-15071268,chr16,15071129,15071268,1,55026480
HepG2|chr16:70097609-70097689,chr16,70097609,70097689,HepG2|chr16:15071118-15071262,chr16,15071118,15071262,1,55026491
HepG2|chr16:70097609-70097671,chr16,70097609,70097671,HepG2|chr16:15071128-15071249,chr16,15071128,15071249,1,55026481
HepG2|chr16:70097609-70097663,chr16,70097609,70097663,HepG2|chr16:15071116-15071265,chr16,15071116,15071265,1,55026493
HepG2|chr16:70097609-70097656,chr16,70097609,70097656,HepG2|chr16:15071131-15071262,chr16,15071131,15071262,1,55026478
HepG2|chr16:70097613-70097738,chr16,70097613,70097738,HepG2|chr16:15071129-15071264,chr16,15071129,15071264,1,55026484
HepG2|chr16:70097613-70097729,chr16,70097613,70097729,HepG2|chr16:15071118-15071140,chr16,15071118,15071140,1,55026495
HepG2|chr16:70097613-70097728,chr16,70097613,70097728,HepG2|chr16:15071128-15071238,chr16,15071128,15071238,1,55026485
HepG2|chr16:70097613-70097712,chr16,70097613,70097712,HepG2|chr16:15071126-15071248,chr16,15071126,15071248,1,55026487
HepG2|chr16:70097613-70097706,chr16,70097613,70097706,HepG2|chr16:15071112-15071262,chr16,15071112,15071262,1,55026501
HepG2|chr16:70097613-70097697,chr16,70097613,70097697,HepG2|chr16:15071126-15071175,chr16,15071126,15071175,1,55026487
HepG2|chr16:70097613-70097690,chr16,70097613,70097690,HepG2|chr16:15071126-15071267,chr16,15071126,15071267,1,55026487
HepG2|chr16:70097613-70097675,chr16,70097613,70097675,HepG2|chr16:15071112-15071262,chr16,15071112,15071262,1,55026501
HepG2|chr16:70097613-70097674,chr16,70097613,70097674,HepG2|chr16:15071126-15071262,chr16,15071126,15071262,1,55026487
HepG2|chr16:70097613-70097671,chr16,70097613,70097671,HepG2|chr16:15071129-15071264,chr16,15071129,15071264,1,55026484
HepG2|chr16:70097613-70097663,chr16,70097613,70097663,HepG2|chr16:15071133-15071265,chr16,15071133,15071265,1,55026480
HepG2|chr16:70097616-70097766,chr16,70097616,70097766,HepG2|chr16:15071118-15071264,chr16,15071118,15071264,1,55026498
HepG2|chr16:70097643-70097789,chr16,70097643,70097789,HepG2|chr16:15071128-15071262,chr16,15071128,15071262,1,55026515
HepG2|chr16:70097670-70097820,chr16,70097670,70097820,HepG2|chr16:15071116-15071154,chr16,15071116,15071154,1,55026554
HepG2|chr16:70099272-70099422,chr16,70099272,70099422,HepG2|chr16:15069140-15069290,chr16,15069140,15069290,1,55030132
HepG2|chr16:70099297-70099446,chr16,70099297,70099446,HepG2|chr16:15069125-15069271,chr16,15069125,15069271,1,55030172
HepG2|chr16:70099304-70099454,chr16,70099304,70099454,HepG2|chr16:15069095-15069245,chr16,15069095,15069245,1,55030209
HepG2|chr16:70099354-70099504,chr16,70099354,70099504,HepG2|chr16:15069095-15069236,chr16,15069095,15069236,1,55030259
HepG2|chr16:70099360-70099510,chr16,70099360,70099510,HepG2|chr16:15069104-15069252,chr16,15069104,15069252,1,55030256
HepG2|chr16:70099397-70099547,chr16,70099397,70099547,HepG2|chr16:15069096-15069245,chr16,15069096,15069245,1,55030301
HepG2|chr16:70099411-70099561,chr16,70099411,70099561,HepG2|chr16:15069113-15069263,chr16,15069113,15069263,1,55030298
HepG2|chr16:70099429-70099471,chr16,70099429,70099471,HepG2|chr16:15069413-15069562,chr16,15069413,15069562,1,55030016
HepG2|chr16:70099575-70099725,chr16,70099575,70099725,HepG2|chr16:15069122-15069171,chr16,15069122,15069171,1,55030453
HepG2|chr16:70099585-70099735,chr16,70099585,70099735,HepG2|chr16:15069087-15069237,chr16,15069087,15069237,1,55030498
HepG2|chr16:70099611-70099761,chr16,70099611,70099761,HepG2|chr16:15069094-15069244,chr16,15069094,15069244,1,55030517
HepG2|chr16:70248854-70248985,chr16,70248854,70248985,HepG2|chr16:70284035-70284127,chr16,70284035,70284127,1,35181
HepG2|chr16:70248881-70248994,chr16,70248881,70248994,HepG2|chr16:70284091-70284152,chr16,70284091,70284152,1,35210
HepG2|chr16:70248889-70249010,chr16,70248889,70249010,HepG2|chr16:70284114-70284152,chr16,70284114,70284152,1,35225
HepG2|chr16:70248897-70248985,chr16,70248897,70248985,HepG2|chr16:70284035-70284062,chr16,70284035,70284062,1,35138
HepG2|chr16:70248920-70249033,chr16,70248920,70249033,HepG2|chr16:70284100-70284137,chr16,70284100,70284137,1,35180
HepG2|chr16:70248927-70248985,chr16,70248927,70248985,HepG2|chr16:70284035-70284127,chr16,70284035,70284127,1,35108
HepG2|chr16:70248992-70249079,chr16,70248992,70249079,HepG2|chr16:22553238-22553359,chr16,22553238,22553359,1,47695754
HepG2|chr16:70248997-70249144,chr16,70248997,70249144,HepG2|chr16:22553238-22553358,chr16,22553238,22553358,1,47695759
HepG2|chr16:70249121-70249214,chr16,70249121,70249214,HepG2|chr16:70281072-70281221,chr16,70281072,70281221,1,31951
HepG2|chr16:70460132-70460239,chr16,70460132,70460239,HepG2|chr16:70559075-70559103,chr16,70559075,70559103,1,98943
HepG2|chr16:70460133-70460239,chr16,70460133,70460239,HepG2|chr16:70559075-70559103,chr16,70559075,70559103,1,98942
HepG2|chr16:71849100-71849237,chr16,71849100,71849237,HepG2|chr16:71845090-71845158,chr16,71845090,71845158,1,4010
HepG2|chr16:71849155-71849237,chr16,71849155,71849237,HepG2|chr16:71845090-71845158,chr16,71845090,71845158,1,4065
HepG2|chr16:71849175-71849237,chr16,71849175,71849237,HepG2|chr16:71845090-71845157,chr16,71845090,71845157,1,4085
HepG2|chr16:71849175-71849231,chr16,71849175,71849231,HepG2|chr16:71845090-71845157,chr16,71845090,71845157,1,4085
HepG2|chr16:71850616-71850644,chr16,71850616,71850644,HepG2|chr16:71843772-71843810,chr16,71843772,71843810,1,6844
HepG2|chr16:73031846-73031929,chr16,73031846,73031929,HepG2|chr16:75281029-75281096,chr16,75281029,75281096,1,2249183
HepG2|chr16:73070865-73070903,chr16,73070865,73070903,HepG2|chr16:75274996-75275080,chr16,75274996,75275080,1,2204131
HepG2|chr16:73070867-73070903,chr16,73070867,73070903,HepG2|chr16:75274996-75275080,chr16,75274996,75275080,1,2204129
HepG2|chr16:74482653-74482778,chr16,74482653,74482778,HepG2|chr16:15189687-15189711,chr16,15189687,15189711,1,59292966
HepG2|chr16:74482653-74482750,chr16,74482653,74482750,HepG2|chr16:15189676-15189712,chr16,15189676,15189712,1,59292977
HepG2|chr16:74482653-74482689,chr16,74482653,74482689,HepG2|chr16:15189687-15189716,chr16,15189687,15189716,1,59292966
HepG2|chr16:74482667-74482796,chr16,74482667,74482796,HepG2|chr16:15189687-15189711,chr16,15189687,15189711,1,59292980
HepG2|chr16:74482667-74482750,chr16,74482667,74482750,HepG2|chr16:15189676-15189712,chr16,15189676,15189712,1,59292991
HepG2|chr16:74482670-74482818,chr16,74482670,74482818,HepG2|chr16:15189687-15189716,chr16,15189687,15189716,1,59292983
HepG2|chr16:74766492-74766574,chr16,74766492,74766574,HepG2|chr16:74736480-74736539,chr16,74736480,74736539,1,30012
HepG2|chr16:75456887-75456947,chr16,75456887,75456947,HepG2|chr16:75255733-75255804,chr16,75255733,75255804,1,201154
HepG2|chr16:75549798-75549938,chr16,75549798,75549938,HepG2|chr16:75497163-75497204,chr16,75497163,75497204,1,52635
HepG2|chr16:75549836-75549945,chr16,75549836,75549945,HepG2|chr16:75497163-75497204,chr16,75497163,75497204,1,52673
HepG2|chr16:75549857-75550007,chr16,75549857,75550007,HepG2|chr16:75497186-75497336,chr16,75497186,75497336,1,52671
HepG2|chr16:75549911-75550033,chr16,75549911,75550033,HepG2|chr16:75497196-75497250,chr16,75497196,75497250,1,52715
HepG2|chr16:75549920-75550070,chr16,75549920,75550070,HepG2|chr16:75497286-75497436,chr16,75497286,75497436,1,52634
HepG2|chr16:75549930-75550076,chr16,75549930,75550076,HepG2|chr16:75497162-75497311,chr16,75497162,75497311,1,52768
HepG2|chr16:75549931-75550081,chr16,75549931,75550081,HepG2|chr16:75497186-75497336,chr16,75497186,75497336,1,52745
HepG2|chr16:78770623-78770640,chr16,78770623,78770640,HepG2|chr16:11832518-11832613,chr16,11832518,11832613,1,66938105
HepG2|chr16:81002771-81002800,chr16,81002771,81002800,HepG2|chr16:81029386-81029533,chr16,81029386,81029533,1,26615
HepG2|chr16:81003313-81003433,chr16,81003313,81003433,HepG2|chr16:81031540-81031570,chr16,81031540,81031570,1,28227
HepG2|chr16:81003321-81003469,chr16,81003321,81003469,HepG2|chr16:81031540-81031570,chr16,81031540,81031570,1,28219
HepG2|chr16:81007798-81007935,chr16,81007798,81007935,HepG2|chr16:81031797-81031890,chr16,81031797,81031890,1,23999
HepG2|chr16:81007798-81007855,chr16,81007798,81007855,HepG2|chr16:81031797-81031890,chr16,81031797,81031890,1,23999
HepG2|chr16:84617070-84617096,chr16,84617070,84617096,HepG2|chr16:11678998-11679104,chr16,11678998,11679104,1,72938072
HepG2|chr16:85424554-85424704,chr16,85424554,85424704,HepG2|chr16:2389957-2390085,chr16,2389957,2390085,1,83034597
HepG2|chr16:85591858-85591955,chr16,85591858,85591955,HepG2|chr16:85641106-85641159,chr16,85641106,85641159,1,49248
HepG2|chr16:85591859-85591970,chr16,85591859,85591970,HepG2|chr16:85641106-85641159,chr16,85641106,85641159,1,49247
HepG2|chr16:85592107-85592253,chr16,85592107,85592253,HepG2|chr16:85647510-85647660,chr16,85647510,85647660,1,55403
HepG2|chr16:85595855-85595959,chr16,85595855,85595959,HepG2|chr16:85641310-85641356,chr16,85641310,85641356,1,45455
HepG2|chr16:85595856-85595959,chr16,85595856,85595959,HepG2|chr16:85641310-85641356,chr16,85641310,85641356,1,45454
HepG2|chr16:85595875-85595958,chr16,85595875,85595958,HepG2|chr16:85644584-85644651,chr16,85644584,85644651,1,48709
HepG2|chr16:85595876-85595964,chr16,85595876,85595964,HepG2|chr16:85644584-85644651,chr16,85644584,85644651,1,48708
HepG2|chr16:85603992-85604097,chr16,85603992,85604097,HepG2|chr16:85645585-85645657,chr16,85645585,85645657,1,41593
HepG2|chr16:85604019-85604097,chr16,85604019,85604097,HepG2|chr16:85645585-85645657,chr16,85645585,85645657,1,41566
HepG2|chr16:85608604-85608646,chr16,85608604,85608646,HepG2|chr16:85644407-85644492,chr16,85644407,85644492,1,35803
HepG2|chr16:85612741-85612812,chr16,85612741,85612812,HepG2|chr16:85641560-85641641,chr16,85641560,85641641,1,28819
HepG2|chr16:85612741-85612810,chr16,85612741,85612810,HepG2|chr16:85641560-85641641,chr16,85641560,85641641,1,28819
HepG2|chr16:85655275-85655422,chr16,85655275,85655422,HepG2|chr16:85644118-85644136,chr16,85644118,85644136,1,11157
HepG2|chr16:85655325-85655454,chr16,85655325,85655454,HepG2|chr16:85644118-85644136,chr16,85644118,85644136,1,11207
HepG2|chr16:85656863-85656977,chr16,85656863,85656977,HepG2|chr16:85641140-85641176,chr16,85641140,85641176,1,15723
HepG2|chr16:85656865-85657010,chr16,85656865,85657010,HepG2|chr16:85641140-85641176,chr16,85641140,85641176,1,15725
HepG2|chr16:85766533-85766634,chr16,85766533,85766634,HepG2|chr16:81029792-81029836,chr16,81029792,81029836,1,4736741
HepG2|chr16:85766534-85766634,chr16,85766534,85766634,HepG2|chr16:81029792-81029836,chr16,81029792,81029836,1,4736742
HepG2|chr16:87853249-87853270,chr16,87853249,87853270,HepG2|chr16:87985386-87985536,chr16,87985386,87985536,1,132137
HepG2|chr16:87891100-87891172,chr16,87891100,87891172,HepG2|chr16:87967905-87967975,chr16,87967905,87967975,1,76805
HepG2|chr16:88620658-88620677,chr16,88620658,88620677,HepG2|chr16:88634184-88634244,chr16,88634184,88634244,1,13526
HepG2|chr16:88626911-88626953,chr16,88626911,88626953,HepG2|chr16:88631910-88632018,chr16,88631910,88632018,1,4999
HepG2|chr16:89424250-89424323,chr16,89424250,89424323,HepG2|chr16:3696369-3696446,chr16,3696369,3696446,1,85727881
HepG2|chr16:89424250-89424285,chr16,89424250,89424285,HepG2|chr16:3696369-3696481,chr16,3696369,3696481,1,85727881
HepG2|chr16:89429409-89429518,chr16,89429409,89429518,HepG2|chr16:89626851-89626882,chr16,89626851,89626882,1,197442
HepG2|chr16:89429412-89429518,chr16,89429412,89429518,HepG2|chr16:89626851-89626882,chr16,89626851,89626882,1,197439
HepG2|chr16:89429412-89429454,chr16,89429412,89429454,HepG2|chr16:89626637-89626787,chr16,89626637,89626787,1,197225
HepG2|chr16:89536085-89536148,chr16,89536085,89536148,HepG2|chr16:89693524-89693611,chr16,89693524,89693611,1,157439
HepG2|chr16:89536087-89536148,chr16,89536087,89536148,HepG2|chr16:89693524-89693613,chr16,89693524,89693613,1,157437
HepG2|chr17:2471067-2471168,chr17,2471067,2471168,HepG2|chr17:6940680-6940807,chr17,6940680,6940807,1,4469613
HepG2|chr17:2471069-2471172,chr17,2471069,2471172,HepG2|chr17:6940732-6940754,chr17,6940732,6940754,1,4469663
HepG2|chr17:3577302-3577336,chr17,3577302,3577336,HepG2|chr17:40719993-40720130,chr17,40719993,40720130,1,37142691
HepG2|chr17:3577302-3577335,chr17,3577302,3577335,HepG2|chr17:40719994-40720130,chr17,40719994,40720130,1,37142692
HepG2|chr17:4213804-4213855,chr17,4213804,4213855,HepG2|chr17:38293577-38293727,chr17,38293577,38293727,1,34079773
HepG2|chr17:4758554-4758664,chr17,4758554,4758664,HepG2|chr17:4610971-4611011,chr17,4610971,4611011,1,147583
HepG2|chr17:4758554-4758654,chr17,4758554,4758654,HepG2|chr17:4610961-4611011,chr17,4610961,4611011,1,147593
HepG2|chr17:4811988-4812056,chr17,4811988,4812056,HepG2|chr17:4618837-4618899,chr17,4618837,4618899,1,193151
HepG2|chr17:4812104-4812129,chr17,4812104,4812129,HepG2|chr17:4618819-4618879,chr17,4618819,4618879,1,193285
HepG2|chr17:4812142-4812178,chr17,4812142,4812178,HepG2|chr17:4618786-4618847,chr17,4618786,4618847,1,193356
HepG2|chr17:4812143-4812172,chr17,4812143,4812172,HepG2|chr17:4618713-4618813,chr17,4618713,4618813,1,193430
HepG2|chr17:4812143-4812170,chr17,4812143,4812170,HepG2|chr17:4618690-4618793,chr17,4618690,4618793,1,193453
HepG2|chr17:4812143-4812169,chr17,4812143,4812169,HepG2|chr17:4618830-4618881,chr17,4618830,4618881,1,193313
HepG2|chr17:4812143-4812167,chr17,4812143,4812167,HepG2|chr17:4618671-4618811,chr17,4618671,4618811,1,193472
HepG2|chr17:4815646-4815685,chr17,4815646,4815685,HepG2|chr17:4616127-4616238,chr17,4616127,4616238,1,199519
HepG2|chr17:6569896-6569951,chr17,6569896,6569951,HepG2|chr17:6602978-6603045,chr17,6602978,6603045,1,33082
HepG2|chr17:6569901-6569951,chr17,6569901,6569951,HepG2|chr17:6602978-6603071,chr17,6602978,6603071,1,33077
HepG2|chr17:6569910-6569951,chr17,6569910,6569951,HepG2|chr17:6602978-6603067,chr17,6602978,6603067,1,33068
HepG2|chr17:6569913-6569951,chr17,6569913,6569951,HepG2|chr17:6602978-6603071,chr17,6602978,6603071,1,33065
HepG2|chr17:7958650-7958782,chr17,7958650,7958782,HepG2|chr17:7833642-7833681,chr17,7833642,7833681,1,125008
HepG2|chr17:7958654-7958804,chr17,7958654,7958804,HepG2|chr17:7833642-7833681,chr17,7833642,7833681,1,125012
HepG2|chr17:7958697-7958810,chr17,7958697,7958810,HepG2|chr17:7833639-7833676,chr17,7833639,7833676,1,125058
HepG2|chr17:7958702-7958813,chr17,7958702,7958813,HepG2|chr17:7833642-7833681,chr17,7833642,7833681,1,125060
HepG2|chr17:7958706-7958813,chr17,7958706,7958813,HepG2|chr17:7833642-7833681,chr17,7833642,7833681,1,125064
HepG2|chr17:7958706-7958810,chr17,7958706,7958810,HepG2|chr17:7833642-7833681,chr17,7833642,7833681,1,125064
HepG2|chr17:7958709-7958813,chr17,7958709,7958813,HepG2|chr17:7833642-7833679,chr17,7833642,7833679,1,125067
HepG2|chr17:7958709-7958810,chr17,7958709,7958810,HepG2|chr17:7833642-7833679,chr17,7833642,7833679,1,125067
HepG2|chr17:7958728-7958813,chr17,7958728,7958813,HepG2|chr17:7833642-7833664,chr17,7833642,7833664,1,125086
HepG2|chr17:8100623-8100773,chr17,8100623,8100773,HepG2|chr17:8096414-8096528,chr17,8096414,8096528,1,4209
HepG2|chr17:8102530-8102608,chr17,8102530,8102608,HepG2|chr17:8095755-8095818,chr17,8095755,8095818,1,6775
HepG2|chr17:8102530-8102606,chr17,8102530,8102606,HepG2|chr17:8095775-8095818,chr17,8095775,8095818,1,6755
HepG2|chr17:8102530-8102587,chr17,8102530,8102587,HepG2|chr17:8095701-8095818,chr17,8095701,8095818,1,6829
HepG2|chr17:8102530-8102563,chr17,8102530,8102563,HepG2|chr17:8095660-8095810,chr17,8095660,8095810,1,6870
HepG2|chr17:8102530-8102558,chr17,8102530,8102558,HepG2|chr17:8095649-8095799,chr17,8095649,8095799,1,6881
HepG2|chr17:8102530-8102556,chr17,8102530,8102556,HepG2|chr17:8095694-8095753,chr17,8095694,8095753,1,6836
HepG2|chr17:8103518-8103535,chr17,8103518,8103535,HepG2|chr17:8095775-8095818,chr17,8095775,8095818,1,7743
HepG2|chr17:16204415-16204565,chr17,16204415,16204565,HepG2|chr17:8105619-8105645,chr17,8105619,8105645,1,8098796
HepG2|chr17:16204415-16204473,chr17,16204415,16204473,HepG2|chr17:8105619-8105648,chr17,8105619,8105648,1,8098796
HepG2|chr17:16204527-16204615,chr17,16204527,16204615,HepG2|chr17:8105619-8105648,chr17,8105619,8105648,1,8098908
HepG2|chr17:16937256-16937346,chr17,16937256,16937346,HepG2|chr17:16942916-16942987,chr17,16942916,16942987,1,5660
HepG2|chr17:16937267-16937346,chr17,16937267,16937346,HepG2|chr17:16942916-16942987,chr17,16942916,16942987,1,5649
HepG2|chr17:16938128-16938275,chr17,16938128,16938275,HepG2|chr17:16942916-16942990,chr17,16942916,16942990,1,4788
HepG2|chr17:16938236-16938317,chr17,16938236,16938317,HepG2|chr17:16942916-16943004,chr17,16942916,16943004,1,4680
HepG2|chr17:16938244-16938317,chr17,16938244,16938317,HepG2|chr17:16942916-16942990,chr17,16942916,16942990,1,4672
HepG2|chr17:16938255-16938317,chr17,16938255,16938317,HepG2|chr17:16942916-16943004,chr17,16942916,16943004,1,4661
HepG2|chr17:16938258-16938317,chr17,16938258,16938317,HepG2|chr17:16942916-16943026,chr17,16942916,16943026,1,4658
HepG2|chr17:16938277-16938317,chr17,16938277,16938317,HepG2|chr17:16942916-16943026,chr17,16942916,16943026,1,4639
HepG2|chr17:16980131-16980250,chr17,16980131,16980250,HepG2|chr17:17203927-17204004,chr17,17203927,17204004,1,223796
HepG2|chr17:16980333-16980406,chr17,16980333,16980406,HepG2|chr17:17203927-17204004,chr17,17203927,17204004,1,223594
HepG2|chr17:17604224-17604343,chr17,17604224,17604343,HepG2|chr17:17584695-17584724,chr17,17584695,17584724,1,19529
HepG2|chr17:17604225-17604343,chr17,17604225,17604343,HepG2|chr17:17584695-17584725,chr17,17584695,17584725,1,19530
HepG2|chr17:19532610-19532681,chr17,19532610,19532681,HepG2|chr17:19549874-19549923,chr17,19549874,19549923,1,17264
HepG2|chr17:19533186-19533247,chr17,19533186,19533247,HepG2|chr17:19549541-19549628,chr17,19549541,19549628,1,16355
HepG2|chr17:19533338-19533397,chr17,19533338,19533397,HepG2|chr17:19549541-19549628,chr17,19549541,19549628,1,16203
HepG2|chr17:28928451-28928568,chr17,28928451,28928568,HepG2|chr17:29336284-29336325,chr17,29336284,29336325,1,407833
HepG2|chr17:28928459-28928568,chr17,28928459,28928568,HepG2|chr17:29336284-29336325,chr17,29336284,29336325,1,407825
HepG2|chr17:28928570-28928720,chr17,28928570,28928720,HepG2|chr17:29336385-29336535,chr17,29336385,29336535,1,407815
HepG2|chr17:28928626-28928766,chr17,28928626,28928766,HepG2|chr17:29336387-29336537,chr17,29336387,29336537,1,407761
HepG2|chr17:29887791-29887804,chr17,29887791,29887804,HepG2|chr17:29898000-29898025,chr17,29898000,29898025,1,10209
HepG2|chr17:29887835-29887886,chr17,29887835,29887886,HepG2|chr17:29897401-29897508,chr17,29897401,29897508,1,9566
HepG2|chr17:29887843-29887886,chr17,29887843,29887886,HepG2|chr17:29897401-29897508,chr17,29897401,29897508,1,9558
HepG2|chr17:30171982-30172023,chr17,30171982,30172023,HepG2|chr17:30409660-30409769,chr17,30409660,30409769,1,237678
HepG2|chr17:35393642-35393709,chr17,35393642,35393709,HepG2|chr17:35851219-35851340,chr17,35851219,35851340,1,457577
HepG2|chr17:35393680-35393709,chr17,35393680,35393709,HepG2|chr17:35851219-35851340,chr17,35851219,35851340,1,457539
HepG2|chr17:35836483-35836613,chr17,35836483,35836613,HepG2|chr17:7382014-7382053,chr17,7382014,7382053,1,28454469
HepG2|chr17:35836483-35836603,chr17,35836483,35836603,HepG2|chr17:7382014-7382053,chr17,7382014,7382053,1,28454469
HepG2|chr17:35836503-35836614,chr17,35836503,35836614,HepG2|chr17:7382014-7382053,chr17,7382014,7382053,1,28454489
HepG2|chr17:35836563-35836614,chr17,35836563,35836614,HepG2|chr17:7382014-7382053,chr17,7382014,7382053,1,28454549
HepG2|chr17:38269255-38269307,chr17,38269255,38269307,HepG2|chr17:38277477-38277627,chr17,38277477,38277627,1,8222
HepG2|chr17:38270780-38270910,chr17,38270780,38270910,HepG2|chr17:38274577-38274610,chr17,38274577,38274610,1,3797
HepG2|chr17:38270793-38270910,chr17,38270793,38270910,HepG2|chr17:38274577-38274610,chr17,38274577,38274610,1,3784
HepG2|chr17:38271545-38271569,chr17,38271545,38271569,HepG2|chr17:38277503-38277629,chr17,38277503,38277629,1,5958
HepG2|chr17:38271546-38271623,chr17,38271546,38271623,HepG2|chr17:38277503-38277629,chr17,38277503,38277629,1,5957
HepG2|chr17:38705957-38706020,chr17,38705957,38706020,HepG2|chr17:38221511-38221604,chr17,38221511,38221604,1,484446
HepG2|chr17:38705968-38706025,chr17,38705968,38706025,HepG2|chr17:38221511-38221604,chr17,38221511,38221604,1,484457
HepG2|chr17:38705969-38706025,chr17,38705969,38706025,HepG2|chr17:38221511-38221604,chr17,38221511,38221604,1,484458
HepG2|chr17:40027283-40027406,chr17,40027283,40027406,HepG2|chr17:76722982-76723132,chr17,76722982,76723132,1,36695699
HepG2|chr17:40027283-40027404,chr17,40027283,40027404,HepG2|chr17:76722982-76723132,chr17,76722982,76723132,1,36695699
HepG2|chr17:40059703-40059749,chr17,40059703,40059749,HepG2|chr17:39932722-39932855,chr17,39932722,39932855,1,126981
HepG2|chr17:40062541-40062630,chr17,40062541,40062630,HepG2|chr17:41003143-41003161,chr17,41003143,41003161,1,940602
HepG2|chr17:40421187-40421337,chr17,40421187,40421337,HepG2|chr17:76491738-76491861,chr17,76491738,76491861,1,36070551
HepG2|chr17:40502436-40502548,chr17,40502436,40502548,HepG2|chr17:39931016-39931054,chr17,39931016,39931054,1,571420
HepG2|chr17:40502462-40502612,chr17,40502462,40502612,HepG2|chr17:39931016-39931054,chr17,39931016,39931054,1,571446
HepG2|chr17:40517718-40517789,chr17,40517718,40517789,HepG2|chr17:39930555-39930630,chr17,39930555,39930630,1,587163
HepG2|chr17:40583552-40583572,chr17,40583552,40583572,HepG2|chr17:40580341-40580471,chr17,40580341,40580471,1,3211
HepG2|chr17:40583655-40583725,chr17,40583655,40583725,HepG2|chr17:40580341-40580471,chr17,40580341,40580471,1,3314
HepG2|chr17:40588283-40588410,chr17,40588283,40588410,HepG2|chr17:40577035-40577080,chr17,40577035,40577080,1,11248
HepG2|chr17:40588283-40588407,chr17,40588283,40588407,HepG2|chr17:40576999-40577080,chr17,40576999,40577080,1,11284
HepG2|chr17:40588283-40588393,chr17,40588283,40588393,HepG2|chr17:40576934-40577080,chr17,40576934,40577080,1,11349
HepG2|chr17:40588283-40588392,chr17,40588283,40588392,HepG2|chr17:40577024-40577080,chr17,40577024,40577080,1,11259
HepG2|chr17:40588283-40588390,chr17,40588283,40588390,HepG2|chr17:40577055-40577080,chr17,40577055,40577080,1,11228
HepG2|chr17:40588283-40588385,chr17,40588283,40588385,HepG2|chr17:40577035-40577080,chr17,40577035,40577080,1,11248
HepG2|chr17:40588283-40588382,chr17,40588283,40588382,HepG2|chr17:40577029-40577080,chr17,40577029,40577080,1,11254
HepG2|chr17:40588283-40588380,chr17,40588283,40588380,HepG2|chr17:40577040-40577080,chr17,40577040,40577080,1,11243
HepG2|chr17:40588283-40588378,chr17,40588283,40588378,HepG2|chr17:40576968-40577080,chr17,40576968,40577080,1,11315
HepG2|chr17:40588283-40588377,chr17,40588283,40588377,HepG2|chr17:40577024-40577080,chr17,40577024,40577080,1,11259
HepG2|chr17:40588283-40588375,chr17,40588283,40588375,HepG2|chr17:40577023-40577080,chr17,40577023,40577080,1,11260
HepG2|chr17:40588283-40588374,chr17,40588283,40588374,HepG2|chr17:40577023-40577080,chr17,40577023,40577080,1,11260
HepG2|chr17:40588283-40588373,chr17,40588283,40588373,HepG2|chr17:40576982-40577080,chr17,40576982,40577080,1,11301
HepG2|chr17:40588283-40588366,chr17,40588283,40588366,HepG2|chr17:40577013-40577080,chr17,40577013,40577080,1,11270
HepG2|chr17:40588283-40588352,chr17,40588283,40588352,HepG2|chr17:40576999-40577080,chr17,40576999,40577080,1,11284
HepG2|chr17:40588283-40588343,chr17,40588283,40588343,HepG2|chr17:40575671-40575760,chr17,40575671,40575760,1,12612
HepG2|chr17:40588283-40588342,chr17,40588283,40588342,HepG2|chr17:40575678-40575760,chr17,40575678,40575760,1,12605
HepG2|chr17:40588283-40588340,chr17,40588283,40588340,HepG2|chr17:40575671-40575760,chr17,40575671,40575760,1,12612
HepG2|chr17:40588283-40588338,chr17,40588283,40588338,HepG2|chr17:40576999-40577080,chr17,40576999,40577080,1,11284
HepG2|chr17:40588283-40588335,chr17,40588283,40588335,HepG2|chr17:40576982-40577080,chr17,40576982,40577080,1,11301
HepG2|chr17:40588283-40588333,chr17,40588283,40588333,HepG2|chr17:40576990-40577080,chr17,40576990,40577080,1,11293
HepG2|chr17:40588283-40588332,chr17,40588283,40588332,HepG2|chr17:40575719-40575760,chr17,40575719,40575760,1,12564
HepG2|chr17:40588283-40588321,chr17,40588283,40588321,HepG2|chr17:40576968-40577080,chr17,40576968,40577080,1,11315
HepG2|chr17:40588283-40588312,chr17,40588283,40588312,HepG2|chr17:40577023-40577080,chr17,40577023,40577080,1,11260
HepG2|chr17:40588283-40588311,chr17,40588283,40588311,HepG2|chr17:40580073-40580195,chr17,40580073,40580195,1,8210
HepG2|chr17:40588302-40588373,chr17,40588302,40588373,HepG2|chr17:40575719-40575760,chr17,40575719,40575760,1,12583
HepG2|chr17:40588310-40588390,chr17,40588310,40588390,HepG2|chr17:40576940-40577008,chr17,40576940,40577008,1,11370
HepG2|chr17:41070584-41070627,chr17,41070584,41070627,HepG2|chr17:41129340-41129403,chr17,41129340,41129403,1,58756
HepG2|chr17:41070585-41070627,chr17,41070585,41070627,HepG2|chr17:41129340-41129417,chr17,41129340,41129417,1,58755
HepG2|chr17:41070586-41070627,chr17,41070586,41070627,HepG2|chr17:41129340-41129419,chr17,41129340,41129419,1,58754
HepG2|chr17:41070587-41070627,chr17,41070587,41070627,HepG2|chr17:41129340-41129419,chr17,41129340,41129419,1,58753
HepG2|chr17:41070588-41070627,chr17,41070588,41070627,HepG2|chr17:41129340-41129417,chr17,41129340,41129417,1,58752
HepG2|chr17:41265620-41265747,chr17,41265620,41265747,HepG2|chr17:40167162-40167298,chr17,40167162,40167298,1,1098458
HepG2|chr17:41375366-41375446,chr17,41375366,41375446,HepG2|chr17:41324497-41324550,chr17,41324497,41324550,1,50869
HepG2|chr17:41379205-41379350,chr17,41379205,41379350,HepG2|chr17:41320976-41321001,chr17,41320976,41321001,1,58229
HepG2|chr17:41379255-41379377,chr17,41379255,41379377,HepG2|chr17:41320976-41321001,chr17,41320976,41321001,1,58279
HepG2|chr17:41387732-41387813,chr17,41387732,41387813,HepG2|chr17:41326896-41326965,chr17,41326896,41326965,1,60836
HepG2|chr17:41399918-41400068,chr17,41399918,41400068,HepG2|chr17:42832587-42832617,chr17,42832587,42832617,1,1432669
HepG2|chr17:41399932-41400082,chr17,41399932,41400082,HepG2|chr17:42832580-42832617,chr17,42832580,42832617,1,1432648
HepG2|chr17:41399937-41400086,chr17,41399937,41400086,HepG2|chr17:42832587-42832617,chr17,42832587,42832617,1,1432650
HepG2|chr17:41399937-41400081,chr17,41399937,41400081,HepG2|chr17:42832580-42832617,chr17,42832580,42832617,1,1432643
HepG2|chr17:41966660-41966699,chr17,41966660,41966699,HepG2|chr17:77005132-77005243,chr17,77005132,77005243,1,35038472
HepG2|chr17:41966661-41966725,chr17,41966661,41966725,HepG2|chr17:77005132-77005243,chr17,77005132,77005243,1,35038471
HepG2|chr17:41966662-41966748,chr17,41966662,41966748,HepG2|chr17:77005132-77005243,chr17,77005132,77005243,1,35038470
HepG2|chr17:41966725-41966800,chr17,41966725,41966800,HepG2|chr17:77005132-77005243,chr17,77005132,77005243,1,35038407
HepG2|chr17:41966730-41966800,chr17,41966730,41966800,HepG2|chr17:77005132-77005243,chr17,77005132,77005243,1,35038402
HepG2|chr17:43660057-43660207,chr17,43660057,43660207,HepG2|chr17:62915436-62915570,chr17,62915436,62915570,1,19255379
HepG2|chr17:43661892-43662037,chr17,43661892,43662037,HepG2|chr17:62915432-62915570,chr17,62915432,62915570,1,19253540
HepG2|chr17:43662079-43662133,chr17,43662079,43662133,HepG2|chr17:62915291-62915333,chr17,62915291,62915333,1,19253212
HepG2|chr17:43662092-43662164,chr17,43662092,43662164,HepG2|chr17:62915431-62915519,chr17,62915431,62915519,1,19253339
HepG2|chr17:43662109-43662164,chr17,43662109,43662164,HepG2|chr17:62915431-62915538,chr17,62915431,62915538,1,19253322
HepG2|chr17:43662167-43662300,chr17,43662167,43662300,HepG2|chr17:62915431-62915575,chr17,62915431,62915575,1,19253264
HepG2|chr17:43662194-43662344,chr17,43662194,43662344,HepG2|chr17:62915389-62915539,chr17,62915389,62915539,1,19253195
HepG2|chr17:43662213-43662363,chr17,43662213,43662363,HepG2|chr17:62915431-62915514,chr17,62915431,62915514,1,19253218
HepG2|chr17:43662232-43662381,chr17,43662232,43662381,HepG2|chr17:62915431-62915575,chr17,62915431,62915575,1,19253199
HepG2|chr17:43662234-43662384,chr17,43662234,43662384,HepG2|chr17:62915431-62915576,chr17,62915431,62915576,1,19253197
HepG2|chr17:43662237-43662387,chr17,43662237,43662387,HepG2|chr17:62915431-62915531,chr17,62915431,62915531,1,19253194
HepG2|chr17:43662241-43662387,chr17,43662241,43662387,HepG2|chr17:62915431-62915570,chr17,62915431,62915570,1,19253190
HepG2|chr17:43662242-43662387,chr17,43662242,43662387,HepG2|chr17:62915431-62915523,chr17,62915431,62915523,1,19253189
HepG2|chr17:43662295-43662395,chr17,43662295,43662395,HepG2|chr17:62915431-62915544,chr17,62915431,62915544,1,19253136
HepG2|chr17:43662303-43662380,chr17,43662303,43662380,HepG2|chr17:62915431-62915514,chr17,62915431,62915514,1,19253128
HepG2|chr17:43662389-43662486,chr17,43662389,43662486,HepG2|chr17:62915310-62915422,chr17,62915310,62915422,1,19252921
HepG2|chr17:43662389-43662448,chr17,43662389,43662448,HepG2|chr17:62915309-62915422,chr17,62915309,62915422,1,19252920
HepG2|chr17:43662408-43662522,chr17,43662408,43662522,HepG2|chr17:62915431-62915538,chr17,62915431,62915538,1,19253023
HepG2|chr17:43662414-43662524,chr17,43662414,43662524,HepG2|chr17:62915395-62915538,chr17,62915395,62915538,1,19252981
HepG2|chr17:43662414-43662518,chr17,43662414,43662518,HepG2|chr17:62915431-62915538,chr17,62915431,62915538,1,19253017
HepG2|chr17:43662432-43662518,chr17,43662432,43662518,HepG2|chr17:62915431-62915518,chr17,62915431,62915518,1,19252999
HepG2|chr17:43662434-43662518,chr17,43662434,43662518,HepG2|chr17:62915431-62915529,chr17,62915431,62915529,1,19252997
HepG2|chr17:43662456-43662516,chr17,43662456,43662516,HepG2|chr17:62915431-62915538,chr17,62915431,62915538,1,19252975
HepG2|chr17:43662624-43662774,chr17,43662624,43662774,HepG2|chr17:62915801-62915951,chr17,62915801,62915951,1,19253177
HepG2|chr17:43662657-43662807,chr17,43662657,43662807,HepG2|chr17:62915593-62915741,chr17,62915593,62915741,1,19252936
HepG2|chr17:43662661-43662811,chr17,43662661,43662811,HepG2|chr17:62915752-62915902,chr17,62915752,62915902,1,19253091
HepG2|chr17:43662669-43662819,chr17,43662669,43662819,HepG2|chr17:62915752-62915902,chr17,62915752,62915902,1,19253083
HepG2|chr17:43662670-43662820,chr17,43662670,43662820,HepG2|chr17:62915635-62915782,chr17,62915635,62915782,1,19252965
HepG2|chr17:43662687-43662837,chr17,43662687,43662837,HepG2|chr17:62915754-62915900,chr17,62915754,62915900,1,19253067
HepG2|chr17:43662688-43662838,chr17,43662688,43662838,HepG2|chr17:62915825-62915975,chr17,62915825,62915975,1,19253137
HepG2|chr17:43662691-43662841,chr17,43662691,43662841,HepG2|chr17:62915765-62915912,chr17,62915765,62915912,1,19253074
HepG2|chr17:43662694-43662844,chr17,43662694,43662844,HepG2|chr17:62915753-62915900,chr17,62915753,62915900,1,19253059
HepG2|chr17:43662698-43662848,chr17,43662698,43662848,HepG2|chr17:62915765-62915912,chr17,62915765,62915912,1,19253067
HepG2|chr17:43662885-43663019,chr17,43662885,43663019,HepG2|chr17:62915925-62915968,chr17,62915925,62915968,1,19253040
HepG2|chr17:43662907-43663019,chr17,43662907,43663019,HepG2|chr17:62915864-62915968,chr17,62915864,62915968,1,19252957
HepG2|chr17:43662907-43663015,chr17,43662907,43663015,HepG2|chr17:62915890-62915968,chr17,62915890,62915968,1,19252983
HepG2|chr17:43662913-43663058,chr17,43662913,43663058,HepG2|chr17:62916003-62916153,chr17,62916003,62916153,1,19253090
HepG2|chr17:43663128-43663178,chr17,43663128,43663178,HepG2|chr17:62916023-62916152,chr17,62916023,62916152,1,19252895
HepG2|chr17:45569068-45569203,chr17,45569068,45569203,HepG2|chr17:36453770-36453913,chr17,36453770,36453913,1,9115298
HepG2|chr17:45569158-45569272,chr17,45569158,45569272,HepG2|chr17:36453701-36453815,chr17,36453701,36453815,1,9115457
HepG2|chr17:45570301-45570451,chr17,45570301,45570451,HepG2|chr17:36452432-36452518,chr17,36452432,36452518,1,9117869
HepG2|chr17:48969842-48969891,chr17,48969842,48969891,HepG2|chr17:48799355-48799505,chr17,48799355,48799505,1,170487
HepG2|chr17:49061216-49061255,chr17,49061216,49061255,HepG2|chr17:48799789-48799904,chr17,48799789,48799904,1,261427
HepG2|chr17:49061216-49061250,chr17,49061216,49061250,HepG2|chr17:48799789-48799904,chr17,48799789,48799904,1,261427
HepG2|chr17:49217660-49217782,chr17,49217660,49217782,HepG2|chr17:62491962-62491990,chr17,62491962,62491990,1,13274302
HepG2|chr17:55399191-55399321,chr17,55399191,55399321,HepG2|chr17:3601635-3601653,chr17,3601635,3601653,1,51797556
HepG2|chr17:55399191-55399308,chr17,55399191,55399308,HepG2|chr17:3601635-3601653,chr17,3601635,3601653,1,51797556
HepG2|chr17:55487387-55487421,chr17,55487387,55487421,HepG2|chr17:8278245-8278283,chr17,8278245,8278283,1,47209142
HepG2|chr17:55487387-55487415,chr17,55487387,55487415,HepG2|chr17:8278246-8278283,chr17,8278246,8278283,1,47209141
HepG2|chr17:55487387-55487411,chr17,55487387,55487411,HepG2|chr17:8278247-8278283,chr17,8278247,8278283,1,47209140
HepG2|chr17:55488800-55488873,chr17,55488800,55488873,HepG2|chr17:71188310-71188361,chr17,71188310,71188361,1,15699510
HepG2|chr17:55488800-55488871,chr17,55488800,55488871,HepG2|chr17:71188310-71188361,chr17,71188310,71188361,1,15699510
HepG2|chr17:55592117-55592156,chr17,55592117,55592156,HepG2|chr17:80198990-80199012,chr17,80198990,80199012,1,24606873
HepG2|chr17:55592207-55592331,chr17,55592207,55592331,HepG2|chr17:80198990-80199012,chr17,80198990,80199012,1,24606783
HepG2|chr17:55660800-55660839,chr17,55660800,55660839,HepG2|chr17:80194728-80194839,chr17,80194728,80194839,1,24533928
HepG2|chr17:55660868-55660990,chr17,55660868,55660990,HepG2|chr17:80194728-80194839,chr17,80194728,80194839,1,24533860
HepG2|chr17:57904276-57904362,chr17,57904276,57904362,HepG2|chr17:79848098-79848135,chr17,79848098,79848135,1,21943822
HepG2|chr17:57911820-57911963,chr17,57911820,57911963,HepG2|chr17:75317356-75317418,chr17,75317356,75317418,1,17405536
HepG2|chr17:57911821-57911963,chr17,57911821,57911963,HepG2|chr17:75317356-75317418,chr17,75317356,75317418,1,17405535
HepG2|chr17:57915511-57915661,chr17,57915511,57915661,HepG2|chr17:57969931-57970038,chr17,57969931,57970038,1,54420
HepG2|chr17:57915555-57915573,chr17,57915555,57915573,HepG2|chr17:57969931-57970053,chr17,57969931,57970053,1,54376
HepG2|chr17:57916149-57916237,chr17,57916149,57916237,HepG2|chr17:57969354-57969400,chr17,57969354,57969400,1,53205
HepG2|chr17:57916643-57916714,chr17,57916643,57916714,HepG2|chr17:73107426-73107505,chr17,73107426,73107505,1,15190783
HepG2|chr17:57920123-57920141,chr17,57920123,57920141,HepG2|chr17:57971614-57971716,chr17,57971614,57971716,1,51491
HepG2|chr17:57920936-57921003,chr17,57920936,57921003,HepG2|chr17:57969663-57969736,chr17,57969663,57969736,1,48727
HepG2|chr17:57920936-57920965,chr17,57920936,57920965,HepG2|chr17:57969663-57969736,chr17,57969663,57969736,1,48727
HepG2|chr17:57922789-57922875,chr17,57922789,57922875,HepG2|chr17:57971859-57971939,chr17,57971859,57971939,1,49070
HepG2|chr17:57922812-57922875,chr17,57922812,57922875,HepG2|chr17:57971859-57971939,chr17,57971859,57971939,1,49047
HepG2|chr17:57924570-57924622,chr17,57924570,57924622,HepG2|chr17:57969479-57969629,chr17,57969479,57969629,1,44909
HepG2|chr17:57925767-57925855,chr17,57925767,57925855,HepG2|chr17:79874666-79874774,chr17,79874666,79874774,1,21948899
HepG2|chr17:57926025-57926140,chr17,57926025,57926140,HepG2|chr17:57969931-57970013,chr17,57969931,57970013,1,43906
HepG2|chr17:57926029-57926140,chr17,57926029,57926140,HepG2|chr17:57969931-57969970,chr17,57969931,57969970,1,43902
HepG2|chr17:57926030-57926140,chr17,57926030,57926140,HepG2|chr17:57969931-57969971,chr17,57969931,57969971,1,43901
HepG2|chr17:57926034-57926140,chr17,57926034,57926140,HepG2|chr17:57969931-57969970,chr17,57969931,57969970,1,43897
HepG2|chr17:57926036-57926140,chr17,57926036,57926140,HepG2|chr17:57969931-57969974,chr17,57969931,57969974,1,43895
HepG2|chr17:57926037-57926140,chr17,57926037,57926140,HepG2|chr17:57969931-57969973,chr17,57969931,57969973,1,43894
HepG2|chr17:57926050-57926140,chr17,57926050,57926140,HepG2|chr17:57969931-57969991,chr17,57969931,57969991,1,43881
HepG2|chr17:57926051-57926140,chr17,57926051,57926140,HepG2|chr17:57969931-57970017,chr17,57969931,57970017,1,43880
HepG2|chr17:57926052-57926140,chr17,57926052,57926140,HepG2|chr17:57969931-57969978,chr17,57969931,57969978,1,43879
HepG2|chr17:57926057-57926140,chr17,57926057,57926140,HepG2|chr17:57969931-57969998,chr17,57969931,57969998,1,43874
HepG2|chr17:57926059-57926140,chr17,57926059,57926140,HepG2|chr17:57969930-57970076,chr17,57969930,57970076,1,43871
HepG2|chr17:57926062-57926140,chr17,57926062,57926140,HepG2|chr17:57969931-57970038,chr17,57969931,57970038,1,43869
HepG2|chr17:57926067-57926140,chr17,57926067,57926140,HepG2|chr17:57969931-57969978,chr17,57969931,57969978,1,43864
HepG2|chr17:57926072-57926140,chr17,57926072,57926140,HepG2|chr17:57969931-57970013,chr17,57969931,57970013,1,43859
HepG2|chr17:57926073-57926140,chr17,57926073,57926140,HepG2|chr17:57969931-57969993,chr17,57969931,57969993,1,43858
HepG2|chr17:57926076-57926140,chr17,57926076,57926140,HepG2|chr17:57969931-57970017,chr17,57969931,57970017,1,43855
HepG2|chr17:57926079-57926140,chr17,57926079,57926140,HepG2|chr17:57969931-57970020,chr17,57969931,57970020,1,43852
HepG2|chr17:57926089-57926140,chr17,57926089,57926140,HepG2|chr17:57969931-57970022,chr17,57969931,57970022,1,43842
HepG2|chr17:57926093-57926140,chr17,57926093,57926140,HepG2|chr17:57969931-57970036,chr17,57969931,57970036,1,43838
HepG2|chr17:57926095-57926140,chr17,57926095,57926140,HepG2|chr17:57969931-57970040,chr17,57969931,57970040,1,43836
HepG2|chr17:57926097-57926140,chr17,57926097,57926140,HepG2|chr17:57969931-57970038,chr17,57969931,57970038,1,43834
HepG2|chr17:57926100-57926140,chr17,57926100,57926140,HepG2|chr17:57969931-57970041,chr17,57969931,57970041,1,43831
HepG2|chr17:57926102-57926140,chr17,57926102,57926140,HepG2|chr17:57969931-57970040,chr17,57969931,57970040,1,43829
HepG2|chr17:57926141-57926199,chr17,57926141,57926199,HepG2|chr17:79886333-79886355,chr17,79886333,79886355,1,21960192
HepG2|chr17:57926185-57926313,chr17,57926185,57926313,HepG2|chr17:79886333-79886355,chr17,79886333,79886355,1,21960148
HepG2|chr17:57929490-57929538,chr17,57929490,57929538,HepG2|chr17:57969663-57969736,chr17,57969663,57969736,1,40173
HepG2|chr17:57930473-57930586,chr17,57930473,57930586,HepG2|chr17:57968929-57968948,chr17,57968929,57968948,1,38456
HepG2|chr17:57930921-57931071,chr17,57930921,57931071,HepG2|chr17:57970945-57971074,chr17,57970945,57971074,1,40024
HepG2|chr17:57932742-57932806,chr17,57932742,57932806,HepG2|chr17:75317414-75317478,chr17,75317414,75317478,1,17384672
HepG2|chr17:57934408-57934494,chr17,57934408,57934494,HepG2|chr17:57969366-57969408,chr17,57969366,57969408,1,34958
HepG2|chr17:57934494-57934598,chr17,57934494,57934598,HepG2|chr17:57970982-57971009,chr17,57970982,57971009,1,36488
HepG2|chr17:57934908-57935040,chr17,57934908,57935040,HepG2|chr17:57969979-57969998,chr17,57969979,57969998,1,35071
HepG2|chr17:57934909-57935040,chr17,57934909,57935040,HepG2|chr17:57969979-57969998,chr17,57969979,57969998,1,35070
HepG2|chr17:60695266-60695336,chr17,60695266,60695336,HepG2|chr17:60700097-60700161,chr17,60700097,60700161,1,4831
HepG2|chr17:60695780-60695810,chr17,60695780,60695810,HepG2|chr17:60700530-60700667,chr17,60700530,60700667,1,4750
HepG2|chr17:61649587-61649737,chr17,61649587,61649737,HepG2|chr17:60142725-60142752,chr17,60142725,60142752,1,1506862
HepG2|chr17:61649641-61649764,chr17,61649641,61649764,HepG2|chr17:60142725-60142752,chr17,60142725,60142752,1,1506916
HepG2|chr17:62765521-62765642,chr17,62765521,62765642,HepG2|chr17:62488938-62488975,chr17,62488938,62488975,1,276583
HepG2|chr17:62765521-62765641,chr17,62765521,62765641,HepG2|chr17:62488938-62488975,chr17,62488938,62488975,1,276583
HepG2|chr17:62765529-62765642,chr17,62765529,62765642,HepG2|chr17:62488938-62488975,chr17,62488938,62488975,1,276591
HepG2|chr17:62832993-62833030,chr17,62832993,62833030,HepG2|chr17:43567663-43567813,chr17,43567663,43567813,1,19265330
HepG2|chr17:62835537-62835595,chr17,62835537,62835595,HepG2|chr17:43570304-43570373,chr17,43570304,43570373,1,19265233
HepG2|chr17:62835537-62835588,chr17,62835537,62835588,HepG2|chr17:43570304-43570373,chr17,43570304,43570373,1,19265233
HepG2|chr17:62835545-62835635,chr17,62835545,62835635,HepG2|chr17:43570440-43570590,chr17,43570440,43570590,1,19265105
HepG2|chr17:62837715-62837844,chr17,62837715,62837844,HepG2|chr17:43572642-43572732,chr17,43572642,43572732,1,19265073
HepG2|chr17:62837718-62837831,chr17,62837718,62837831,HepG2|chr17:43572704-43572851,chr17,43572704,43572851,1,19265014
HepG2|chr17:62837749-62837874,chr17,62837749,62837874,HepG2|chr17:43572737-43572887,chr17,43572737,43572887,1,19265012
HepG2|chr17:62837760-62837831,chr17,62837760,62837831,HepG2|chr17:43572502-43572617,chr17,43572502,43572617,1,19265258
HepG2|chr17:62925004-62925153,chr17,62925004,62925153,HepG2|chr17:62917327-62917410,chr17,62917327,62917410,1,7677
HepG2|chr17:62925570-62925668,chr17,62925570,62925668,HepG2|chr17:62916110-62916170,chr17,62916110,62916170,1,9460
HepG2|chr17:62925571-62925653,chr17,62925571,62925653,HepG2|chr17:62916191-62916250,chr17,62916191,62916250,1,9380
HepG2|chr17:62925571-62925640,chr17,62925571,62925640,HepG2|chr17:62916169-62916250,chr17,62916169,62916250,1,9402
HepG2|chr17:62925577-62925727,chr17,62925577,62925727,HepG2|chr17:62916169-62916250,chr17,62916169,62916250,1,9408
HepG2|chr17:62926031-62926107,chr17,62926031,62926107,HepG2|chr17:62916130-62916250,chr17,62916130,62916250,1,9901
HepG2|chr17:62926031-62926097,chr17,62926031,62926097,HepG2|chr17:62916166-62916250,chr17,62916166,62916250,1,9865
HepG2|chr17:62926835-62926913,chr17,62926835,62926913,HepG2|chr17:62917246-62917315,chr17,62917246,62917315,1,9589
HepG2|chr17:62927320-62927355,chr17,62927320,62927355,HepG2|chr17:62917246-62917315,chr17,62917246,62917315,1,10074
HepG2|chr17:62929725-62929870,chr17,62929725,62929870,HepG2|chr17:62918768-62918883,chr17,62918768,62918883,1,10957
HepG2|chr17:63711238-63711259,chr17,63711238,63711259,HepG2|chr17:63556481-63556501,chr17,63556481,63556501,1,154757
HepG2|chr17:64408235-64408321,chr17,64408235,64408321,HepG2|chr17:79822988-79823135,chr17,79822988,79823135,1,15414753
HepG2|chr17:66098348-66098416,chr17,66098348,66098416,HepG2|chr17:62657518-62657647,chr17,62657518,62657647,1,3440830
HepG2|chr17:66098355-66098438,chr17,66098355,66098438,HepG2|chr17:62657504-62657654,chr17,62657504,62657654,1,3440851
HepG2|chr17:66098363-66098449,chr17,66098363,66098449,HepG2|chr17:62657607-62657756,chr17,62657607,62657756,1,3440756
HepG2|chr17:66098386-66098442,chr17,66098386,66098442,HepG2|chr17:62657708-62657858,chr17,62657708,62657858,1,3440678
HepG2|chr17:66098404-66098530,chr17,66098404,66098530,HepG2|chr17:62657641-62657750,chr17,62657641,62657750,1,3440763
HepG2|chr17:66170084-66170200,chr17,66170084,66170200,HepG2|chr17:66193037-66193085,chr17,66193037,66193085,1,22953
HepG2|chr17:66170098-66170200,chr17,66170098,66170200,HepG2|chr17:66193037-66193085,chr17,66193037,66193085,1,22939
HepG2|chr17:66177722-66177813,chr17,66177722,66177813,HepG2|chr17:66193034-66193174,chr17,66193034,66193174,1,15312
HepG2|chr17:66202521-66202626,chr17,66202521,66202626,HepG2|chr17:65823086-65823149,chr17,65823086,65823149,1,379435
HepG2|chr17:66202521-66202592,chr17,66202521,66202592,HepG2|chr17:65823086-65823149,chr17,65823086,65823149,1,379435
HepG2|chr17:66202530-66202590,chr17,66202530,66202590,HepG2|chr17:65822575-65822605,chr17,65822575,65822605,1,379955
HepG2|chr17:66220647-66220701,chr17,66220647,66220701,HepG2|chr17:42297808-42297873,chr17,42297808,42297873,1,23922839
HepG2|chr17:66220758-66220832,chr17,66220758,66220832,HepG2|chr17:42297808-42297873,chr17,42297808,42297873,1,23922950
HepG2|chr17:70148147-70148164,chr17,70148147,70148164,HepG2|chr17:34100241-34100350,chr17,34100241,34100350,1,36047906
HepG2|chr17:70840688-70840834,chr17,70840688,70840834,HepG2|chr17:3631919-3632011,chr17,3631919,3632011,1,67208769
HepG2|chr17:70840707-70840765,chr17,70840707,70840765,HepG2|chr17:3631919-3632011,chr17,3631919,3632011,1,67208788
HepG2|chr17:71298420-71298570,chr17,71298420,71298570,HepG2|chr17:1550430-1550471,chr17,1550430,1550471,1,69747990
HepG2|chr17:71298500-71298612,chr17,71298500,71298612,HepG2|chr17:1550429-1550467,chr17,1550429,1550467,1,69748071
HepG2|chr17:71298531-71298612,chr17,71298531,71298612,HepG2|chr17:1550429-1550470,chr17,1550429,1550470,1,69748102
HepG2|chr17:72977274-72977348,chr17,72977274,72977348,HepG2|chr17:72980668-72980745,chr17,72980668,72980745,1,3394
HepG2|chr17:72977813-72977875,chr17,72977813,72977875,HepG2|chr17:72978819-72978907,chr17,72978819,72978907,1,1006
HepG2|chr17:72977814-72977964,chr17,72977814,72977964,HepG2|chr17:72978819-72978907,chr17,72978819,72978907,1,1005
HepG2|chr17:72977830-72977947,chr17,72977830,72977947,HepG2|chr17:72980242-72980277,chr17,72980242,72980277,1,2412
HepG2|chr17:72977832-72977947,chr17,72977832,72977947,HepG2|chr17:72980242-72980277,chr17,72980242,72980277,1,2410
HepG2|chr17:72977877-72978006,chr17,72977877,72978006,HepG2|chr17:72980566-72980707,chr17,72980566,72980707,1,2689
HepG2|chr17:72977949-72977978,chr17,72977949,72977978,HepG2|chr17:72980696-72980846,chr17,72980696,72980846,1,2747
HepG2|chr17:73075164-73075215,chr17,73075164,73075215,HepG2|chr17:73081842-73081989,chr17,73081842,73081989,1,6678
HepG2|chr17:73075175-73075215,chr17,73075175,73075215,HepG2|chr17:73081829-73081937,chr17,73081829,73081937,1,6654
HepG2|chr17:73075191-73075215,chr17,73075191,73075215,HepG2|chr17:73083354-73083499,chr17,73083354,73083499,1,8163
HepG2|chr17:73351205-73351250,chr17,73351205,73351250,HepG2|chr17:73455569-73455718,chr17,73455569,73455718,1,104364
HepG2|chr17:73355147-73355233,chr17,73355147,73355233,HepG2|chr17:73455220-73455370,chr17,73455220,73455370,1,100073
HepG2|chr17:73414768-73414832,chr17,73414768,73414832,HepG2|chr17:73452030-73452130,chr17,73452030,73452130,1,37262
HepG2|chr17:73414785-73414832,chr17,73414785,73414832,HepG2|chr17:73452030-73452130,chr17,73452030,73452130,1,37245
HepG2|chr17:73431381-73431515,chr17,73431381,73431515,HepG2|chr17:73454368-73454433,chr17,73454368,73454433,1,22987
HepG2|chr17:73431429-73431514,chr17,73431429,73431514,HepG2|chr17:73454368-73454433,chr17,73454368,73454433,1,22939
HepG2|chr17:73961247-73961397,chr17,73961247,73961397,HepG2|chr17:79955352-79955392,chr17,79955352,79955392,1,5994105
HepG2|chr17:73961325-73961436,chr17,73961325,73961436,HepG2|chr17:79955347-79955395,chr17,79955347,79955395,1,5994022
HepG2|chr17:74602206-74602265,chr17,74602206,74602265,HepG2|chr17:28256726-28256817,chr17,28256726,28256817,1,46345480
HepG2|chr17:74602206-74602262,chr17,74602206,74602262,HepG2|chr17:28256726-28256817,chr17,28256726,28256817,1,46345480
HepG2|chr17:74602211-74602330,chr17,74602211,74602330,HepG2|chr17:38803125-38803167,chr17,38803125,38803167,1,35799086
HepG2|chr17:74602227-74602332,chr17,74602227,74602332,HepG2|chr17:38803125-38803167,chr17,38803125,38803167,1,35799102
HepG2|chr17:74603597-74603714,chr17,74603597,74603714,HepG2|chr17:28256546-28256579,chr17,28256546,28256579,1,46347051
HepG2|chr17:74603623-74603773,chr17,74603623,74603773,HepG2|chr17:28256546-28256579,chr17,28256546,28256579,1,46347077
HepG2|chr17:74609999-74610085,chr17,74609999,74610085,HepG2|chr17:74705629-74705753,chr17,74705629,74705753,1,95630
HepG2|chr17:75352079-75352191,chr17,75352079,75352191,HepG2|chr17:8203079-8203163,chr17,8203079,8203163,1,67149000
HepG2|chr17:75352083-75352191,chr17,75352083,75352191,HepG2|chr17:8203079-8203163,chr17,8203079,8203163,1,67149004
HepG2|chr17:75388996-75389041,chr17,75388996,75389041,HepG2|chr17:76974353-76974496,chr17,76974353,76974496,1,1585357
HepG2|chr17:75407946-75408093,chr17,75407946,75408093,HepG2|chr17:33899360-33899507,chr17,33899360,33899507,1,41508586
HepG2|chr17:75408244-75408302,chr17,75408244,75408302,HepG2|chr17:33896999-33897128,chr17,33896999,33897128,1,41511245
HepG2|chr17:76362125-76362193,chr17,76362125,76362193,HepG2|chr17:76370443-76370465,chr17,76370443,76370465,1,8318
HepG2|chr17:76362155-76362193,chr17,76362155,76362193,HepG2|chr17:76370443-76370506,chr17,76370443,76370506,1,8288
HepG2|chr17:76653258-76653302,chr17,76653258,76653302,HepG2|chr17:76491430-76491535,chr17,76491430,76491535,1,161828
HepG2|chr17:76653258-76653299,chr17,76653258,76653299,HepG2|chr17:76491426-76491534,chr17,76491426,76491534,1,161832
HepG2|chr17:76929803-76929878,chr17,76929803,76929878,HepG2|chr17:76925161-76925236,chr17,76925161,76925236,1,4642
HepG2|chr17:76929815-76929965,chr17,76929815,76929965,HepG2|chr17:76925161-76925236,chr17,76925161,76925236,1,4654
HepG2|chr17:76929978-76930024,chr17,76929978,76930024,HepG2|chr17:76926315-76926347,chr17,76926315,76926347,1,3663
HepG2|chr17:77732640-77732687,chr17,77732640,77732687,HepG2|chr17:77706730-77706830,chr17,77706730,77706830,1,25910
HepG2|chr17:77732640-77732667,chr17,77732640,77732667,HepG2|chr17:77706759-77706830,chr17,77706759,77706830,1,25881
HepG2|chr17:77732669-77732725,chr17,77732669,77732725,HepG2|chr17:77706759-77706830,chr17,77706759,77706830,1,25910
HepG2|chr17:77732680-77732827,chr17,77732680,77732827,HepG2|chr17:77706730-77706830,chr17,77706730,77706830,1,25950
HepG2|chr17:77741290-77741325,chr17,77741290,77741325,HepG2|chr17:60549413-60549558,chr17,60549413,60549558,1,17191877
HepG2|chr17:77741391-77741538,chr17,77741391,77741538,HepG2|chr17:60549417-60549563,chr17,60549417,60549563,1,17191974
HepG2|chr17:77741459-77741606,chr17,77741459,77741606,HepG2|chr17:60549426-60549563,chr17,60549426,60549563,1,17192033
HepG2|chr17:78066814-78066831,chr17,78066814,78066831,HepG2|chr17:79921808-79921910,chr17,79921808,79921910,1,1854994
HepG2|chr17:78643429-78643480,chr17,78643429,78643480,HepG2|chr17:4456397-4456490,chr17,4456397,4456490,1,74187032
HepG2|chr17:78643434-78643519,chr17,78643434,78643519,HepG2|chr17:4456392-4456491,chr17,4456392,4456491,1,74187042
HepG2|chr17:79279765-79279895,chr17,79279765,79279895,HepG2|chr17:79305556-79305573,chr17,79305556,79305573,1,25791
HepG2|chr17:79701705-79701821,chr17,79701705,79701821,HepG2|chr17:79759465-79759507,chr17,79759465,79759507,1,57760
HepG2|chr17:79701772-79701880,chr17,79701772,79701880,HepG2|chr17:79759465-79759507,chr17,79759465,79759507,1,57693
HepG2|chr17:79701810-79701880,chr17,79701810,79701880,HepG2|chr17:79759461-79759572,chr17,79759461,79759572,1,57651
HepG2|chr17:79701828-79701880,chr17,79701828,79701880,HepG2|chr17:79759465-79759584,chr17,79759465,79759584,1,57637
HepG2|chr17:79701841-79701880,chr17,79701841,79701880,HepG2|chr17:79759461-79759572,chr17,79759461,79759572,1,57620
HepG2|chr17:79701844-79701880,chr17,79701844,79701880,HepG2|chr17:79759465-79759500,chr17,79759465,79759500,1,57621
HepG2|chr17:79701845-79701880,chr17,79701845,79701880,HepG2|chr17:79759465-79759587,chr17,79759465,79759587,1,57620
HepG2|chr17:79701849-79701880,chr17,79701849,79701880,HepG2|chr17:79759465-79759584,chr17,79759465,79759584,1,57616
HepG2|chr17:79701852-79701880,chr17,79701852,79701880,HepG2|chr17:79759465-79759587,chr17,79759465,79759587,1,57613
HepG2|chr17:79701853-79701880,chr17,79701853,79701880,HepG2|chr17:79759461-79759525,chr17,79759461,79759525,1,57608
HepG2|chr17:79701862-79701880,chr17,79701862,79701880,HepG2|chr17:79759465-79759584,chr17,79759465,79759584,1,57603
HepG2|chr17:79707595-79707744,chr17,79707595,79707744,HepG2|chr17:79759465-79759514,chr17,79759465,79759514,1,51870
HepG2|chr17:79707595-79707660,chr17,79707595,79707660,HepG2|chr17:79759461-79759488,chr17,79759461,79759488,1,51866
HepG2|chr17:79707623-79707773,chr17,79707623,79707773,HepG2|chr17:79759465-79759539,chr17,79759465,79759539,1,51842
HepG2|chr17:79707635-79707773,chr17,79707635,79707773,HepG2|chr17:79759547-79759582,chr17,79759547,79759582,1,51912
HepG2|chr17:79707636-79707773,chr17,79707636,79707773,HepG2|chr17:79759461-79759486,chr17,79759461,79759486,1,51825
HepG2|chr17:79707644-79707772,chr17,79707644,79707772,HepG2|chr17:79759482-79759632,chr17,79759482,79759632,1,51838
HepG2|chr17:79707647-79707772,chr17,79707647,79707772,HepG2|chr17:79759461-79759486,chr17,79759461,79759486,1,51814
HepG2|chr17:79707651-79707772,chr17,79707651,79707772,HepG2|chr17:79759465-79759584,chr17,79759465,79759584,1,51814
HepG2|chr17:79707652-79707767,chr17,79707652,79707767,HepG2|chr17:79759461-79759523,chr17,79759461,79759523,1,51809
HepG2|chr17:79707657-79707772,chr17,79707657,79707772,HepG2|chr17:79759465-79759500,chr17,79759465,79759500,1,51808
HepG2|chr17:79707657-79707734,chr17,79707657,79707734,HepG2|chr17:79759461-79759548,chr17,79759461,79759548,1,51804
HepG2|chr17:79707661-79707772,chr17,79707661,79707772,HepG2|chr17:79759461-79759537,chr17,79759461,79759537,1,51800
HepG2|chr17:79707662-79707772,chr17,79707662,79707772,HepG2|chr17:79759461-79759523,chr17,79759461,79759523,1,51799
HepG2|chr17:79707666-79707781,chr17,79707666,79707781,HepG2|chr17:79759547-79759582,chr17,79759547,79759582,1,51881
HepG2|chr17:79707668-79707772,chr17,79707668,79707772,HepG2|chr17:79759461-79759507,chr17,79759461,79759507,1,51793
HepG2|chr17:79707670-79707772,chr17,79707670,79707772,HepG2|chr17:79759461-79759488,chr17,79759461,79759488,1,51791
HepG2|chr17:79707671-79707772,chr17,79707671,79707772,HepG2|chr17:79759465-79759514,chr17,79759465,79759514,1,51794
HepG2|chr17:79707672-79707772,chr17,79707672,79707772,HepG2|chr17:79759461-79759537,chr17,79759461,79759537,1,51789
HepG2|chr17:79707673-79707772,chr17,79707673,79707772,HepG2|chr17:79759461-79759480,chr17,79759461,79759480,1,51788
HepG2|chr17:79707679-79707772,chr17,79707679,79707772,HepG2|chr17:79759461-79759518,chr17,79759461,79759518,1,51782
HepG2|chr17:79707680-79707772,chr17,79707680,79707772,HepG2|chr17:79759461-79759509,chr17,79759461,79759509,1,51781
HepG2|chr17:79707681-79707772,chr17,79707681,79707772,HepG2|chr17:79759461-79759520,chr17,79759461,79759520,1,51780
HepG2|chr17:79707684-79707772,chr17,79707684,79707772,HepG2|chr17:79759461-79759523,chr17,79759461,79759523,1,51777
HepG2|chr17:79707686-79707772,chr17,79707686,79707772,HepG2|chr17:79759461-79759525,chr17,79759461,79759525,1,51775
HepG2|chr17:79707693-79707754,chr17,79707693,79707754,HepG2|chr17:79759460-79759507,chr17,79759460,79759507,1,51767
HepG2|chr17:79707701-79707772,chr17,79707701,79707772,HepG2|chr17:79759461-79759537,chr17,79759461,79759537,1,51760
HepG2|chr17:79707702-79707772,chr17,79707702,79707772,HepG2|chr17:79759461-79759541,chr17,79759461,79759541,1,51759
HepG2|chr17:79707712-79707772,chr17,79707712,79707772,HepG2|chr17:79759465-79759524,chr17,79759465,79759524,1,51753
HepG2|chr17:79707722-79707772,chr17,79707722,79707772,HepG2|chr17:79759465-79759537,chr17,79759465,79759537,1,51743
HepG2|chr17:79707732-79707772,chr17,79707732,79707772,HepG2|chr17:79759461-79759584,chr17,79759461,79759584,1,51729
HepG2|chr17:79707735-79707772,chr17,79707735,79707772,HepG2|chr17:79759461-79759548,chr17,79759461,79759548,1,51726
HepG2|chr17:79707737-79707772,chr17,79707737,79707772,HepG2|chr17:79759465-79759584,chr17,79759465,79759584,1,51728
HepG2|chr17:79707741-79707772,chr17,79707741,79707772,HepG2|chr17:79759465-79759584,chr17,79759465,79759584,1,51724
HepG2|chr17:79707745-79707772,chr17,79707745,79707772,HepG2|chr17:79759464-79759603,chr17,79759464,79759603,1,51719
HepG2|chr17:79708365-79708515,chr17,79708365,79708515,HepG2|chr17:79759542-79759585,chr17,79759542,79759585,1,51177
HepG2|chr17:79708381-79708519,chr17,79708381,79708519,HepG2|chr17:79759481-79759631,chr17,79759481,79759631,1,51100
HepG2|chr17:79708414-79708518,chr17,79708414,79708518,HepG2|chr17:79759542-79759585,chr17,79759542,79759585,1,51128
HepG2|chr17:79708415-79708518,chr17,79708415,79708518,HepG2|chr17:79759465-79759537,chr17,79759465,79759537,1,51050
HepG2|chr17:79708443-79708518,chr17,79708443,79708518,HepG2|chr17:79759465-79759537,chr17,79759465,79759537,1,51022
HepG2|chr17:79708460-79708518,chr17,79708460,79708518,HepG2|chr17:79759461-79759527,chr17,79759461,79759527,1,51001
HepG2|chr17:79708463-79708518,chr17,79708463,79708518,HepG2|chr17:79759465-79759548,chr17,79759465,79759548,1,51002
HepG2|chr17:79708499-79708517,chr17,79708499,79708517,HepG2|chr17:79759537-79759626,chr17,79759537,79759626,1,51038
HepG2|chr17:79708677-79708727,chr17,79708677,79708727,HepG2|chr17:79759507-79759656,chr17,79759507,79759656,1,50830
HepG2|chr17:80251783-80251892,chr17,80251783,80251892,HepG2|chr17:35853859-35853926,chr17,35853859,35853926,1,44397924
HepG2|chr17:80251784-80251860,chr17,80251784,80251860,HepG2|chr17:35853859-35853926,chr17,35853859,35853926,1,44397925
HepG2|chr17:80251811-80251894,chr17,80251811,80251894,HepG2|chr17:35853859-35853926,chr17,35853859,35853926,1,44397952
HepG2|chr17:80299802-80299822,chr17,80299802,80299822,HepG2|chr17:80290466-80290580,chr17,80290466,80290580,1,9336
HepG2|chr17:80309230-80309346,chr17,80309230,80309346,HepG2|chr17:80290460-80290571,chr17,80290460,80290571,1,18770
HepG2|chr17:80309230-80309269,chr17,80309230,80309269,HepG2|chr17:80290460-80290571,chr17,80290460,80290571,1,18770
HepG2|chr17:80309232-80309266,chr17,80309232,80309266,HepG2|chr17:80290495-80290580,chr17,80290495,80290580,1,18737
HepG2|chr17:80309234-80309355,chr17,80309234,80309355,HepG2|chr17:80290426-80290567,chr17,80290426,80290567,1,18808
HepG2|chr17:80309234-80309354,chr17,80309234,80309354,HepG2|chr17:80290553-80290580,chr17,80290553,80290580,1,18681
HepG2|chr17:80309234-80309346,chr17,80309234,80309346,HepG2|chr17:80290517-80290580,chr17,80290517,80290580,1,18717
HepG2|chr17:80309234-80309339,chr17,80309234,80309339,HepG2|chr17:80290535-80290580,chr17,80290535,80290580,1,18699
HepG2|chr17:80309234-80309318,chr17,80309234,80309318,HepG2|chr17:80290517-80290580,chr17,80290517,80290580,1,18717
HepG2|chr17:80309234-80309314,chr17,80309234,80309314,HepG2|chr17:80290507-80290580,chr17,80290507,80290580,1,18727
HepG2|chr17:80309234-80309311,chr17,80309234,80309311,HepG2|chr17:80290507-80290580,chr17,80290507,80290580,1,18727
HepG2|chr17:80309234-80309309,chr17,80309234,80309309,HepG2|chr17:80290303-80290453,chr17,80290303,80290453,1,18931
HepG2|chr17:80309234-80309293,chr17,80309234,80309293,HepG2|chr17:80290489-80290580,chr17,80290489,80290580,1,18745
HepG2|chr17:80309234-80309292,chr17,80309234,80309292,HepG2|chr17:80290489-80290580,chr17,80290489,80290580,1,18745
HepG2|chr17:80309234-80309289,chr17,80309234,80309289,HepG2|chr17:80290518-80290580,chr17,80290518,80290580,1,18716
HepG2|chr17:80309234-80309278,chr17,80309234,80309278,HepG2|chr17:80290506-80290580,chr17,80290506,80290580,1,18728
HepG2|chr17:80309234-80309277,chr17,80309234,80309277,HepG2|chr17:80290493-80290580,chr17,80290493,80290580,1,18741
HepG2|chr17:80309234-80309275,chr17,80309234,80309275,HepG2|chr17:80290505-80290580,chr17,80290505,80290580,1,18729
HepG2|chr17:80309234-80309255,chr17,80309234,80309255,HepG2|chr17:80290451-80290580,chr17,80290451,80290580,1,18783
HepG2|chr17:80309234-80309252,chr17,80309234,80309252,HepG2|chr17:80290448-80290580,chr17,80290448,80290580,1,18786
HepG2|chr17:80309237-80309346,chr17,80309237,80309346,HepG2|chr17:80290533-80290580,chr17,80290533,80290580,1,18704
HepG2|chr17:80309237-80309340,chr17,80309237,80309340,HepG2|chr17:80290533-80290580,chr17,80290533,80290580,1,18704
HepG2|chr17:80309237-80309267,chr17,80309237,80309267,HepG2|chr17:80290460-80290580,chr17,80290460,80290580,1,18777
HepG2|chr17:80309237-80309262,chr17,80309237,80309262,HepG2|chr17:80290451-80290580,chr17,80290451,80290580,1,18786
HepG2|chr17:80309237-80309258,chr17,80309237,80309258,HepG2|chr17:80290451-80290580,chr17,80290451,80290580,1,18786
HepG2|chr17:80309270-80309420,chr17,80309270,80309420,HepG2|chr17:80290451-80290580,chr17,80290451,80290580,1,18819
HepG2|chr17:80309280-80309430,chr17,80309280,80309430,HepG2|chr17:80290535-80290580,chr17,80290535,80290580,1,18745
HepG2|chr17:80309287-80309437,chr17,80309287,80309437,HepG2|chr17:80290535-80290580,chr17,80290535,80290580,1,18752
HepG2|chr17:80309298-80309448,chr17,80309298,80309448,HepG2|chr17:80290489-80290580,chr17,80290489,80290580,1,18809
HepG2|chr17:80309320-80309470,chr17,80309320,80309470,HepG2|chr17:80290553-80290580,chr17,80290553,80290580,1,18767
HepG2|chr17:80309322-80309467,chr17,80309322,80309467,HepG2|chr17:80290461-80290580,chr17,80290461,80290580,1,18861
HepG2|chr17:80309327-80309467,chr17,80309327,80309467,HepG2|chr17:80290460-80290580,chr17,80290460,80290580,1,18867
HepG2|chr17:80309845-80309878,chr17,80309845,80309878,HepG2|chr17:80290427-80290574,chr17,80290427,80290574,1,19418
HepG2|chr17:80636582-80636727,chr17,80636582,80636727,HepG2|chr17:65273802-65273892,chr17,65273802,65273892,1,15362780
HepG2|chr17:80636645-80636776,chr17,80636645,80636776,HepG2|chr17:65273799-65273893,chr17,65273799,65273893,1,15362846
HepG2|chr18:3039809-3039898,chr18,3039809,3039898,HepG2|chr18:2845809-2845857,chr18,2845809,2845857,1,194000
HepG2|chr18:3095353-3095439,chr18,3095353,3095439,HepG2|chr18:2842263-2842307,chr18,2842263,2842307,1,253090
HepG2|chr18:8725080-8725164,chr18,8725080,8725164,HepG2|chr18:11888335-11888381,chr18,11888335,11888381,1,3163255
HepG2|chr18:9093826-9093906,chr18,9093826,9093906,HepG2|chr18:9102401-9102503,chr18,9102401,9102503,1,8575
HepG2|chr18:9093856-9093906,chr18,9093856,9093906,HepG2|chr18:9102401-9102501,chr18,9102401,9102501,1,8545
HepG2|chr18:9093858-9093906,chr18,9093858,9093906,HepG2|chr18:9102401-9102513,chr18,9102401,9102513,1,8543
HepG2|chr18:9093871-9093906,chr18,9093871,9093906,HepG2|chr18:9102401-9102513,chr18,9102401,9102513,1,8530
HepG2|chr18:12019969-12020036,chr18,12019969,12020036,HepG2|chr18:11978621-11978771,chr18,11978621,11978771,1,41348
HepG2|chr18:12033629-12033656,chr18,12033629,12033656,HepG2|chr18:11983725-11983763,chr18,11983725,11983763,1,49904
HepG2|chr18:20970484-20970634,chr18,20970484,20970634,HepG2|chr18:12992706-12992741,chr18,12992706,12992741,1,7977778
HepG2|chr18:20970533-20970648,chr18,20970533,20970648,HepG2|chr18:12992706-12992741,chr18,12992706,12992741,1,7977827
HepG2|chr18:33090907-33090971,chr18,33090907,33090971,HepG2|chr18:33079904-33080054,chr18,33079904,33080054,1,11003
HepG2|chr18:33093120-33093164,chr18,33093120,33093164,HepG2|chr18:33079617-33079767,chr18,33079617,33079767,1,13503
HepG2|chr18:43776305-43776377,chr18,43776305,43776377,HepG2|chr18:43655878-43655953,chr18,43655878,43655953,1,120427
HepG2|chr18:55435489-55435604,chr18,55435489,55435604,HepG2|chr18:33876274-33876297,chr18,33876274,33876297,1,21559215
HepG2|chr18:55435492-55435604,chr18,55435492,55435604,HepG2|chr18:33876274-33876297,chr18,33876274,33876297,1,21559218
HepG2|chr18:60169420-60169487,chr18,60169420,60169487,HepG2|chr18:60189544-60189621,chr18,60189544,60189621,1,20124
HepG2|chr18:60175981-60176126,chr18,60175981,60176126,HepG2|chr18:60185861-60185887,chr18,60185861,60185887,1,9880
HepG2|chr18:60175991-60176115,chr18,60175991,60176115,HepG2|chr18:60185861-60185887,chr18,60185861,60185887,1,9870
HepG2|chr19:744748-744783,chr19,744748,744783,HepG2|chr19:830150-830196,chr19,830150,830196,1,85402
HepG2|chr19:783278-783330,chr19,783278,783330,HepG2|chr19:795189-795287,chr19,795189,795287,1,11911
HepG2|chr19:788357-788493,chr19,788357,788493,HepG2|chr19:792365-792391,chr19,792365,792391,1,4008
HepG2|chr19:788357-788480,chr19,788357,788480,HepG2|chr19:792365-792391,chr19,792365,792391,1,4008
HepG2|chr19:789979-790085,chr19,789979,790085,HepG2|chr19:795103-795135,chr19,795103,795135,1,5124
HepG2|chr19:789979-790084,chr19,789979,790084,HepG2|chr19:795103-795135,chr19,795103,795135,1,5124
HepG2|chr19:790354-790431,chr19,790354,790431,HepG2|chr19:793303-793453,chr19,793303,793453,1,2949
HepG2|chr19:1372645-1372691,chr19,1372645,1372691,HepG2|chr19:1595795-1595945,chr19,1595795,1595945,1,223150
HepG2|chr19:1372647-1372691,chr19,1372647,1372691,HepG2|chr19:1595765-1595884,chr19,1595765,1595884,1,223118
HepG2|chr19:1871253-1871321,chr19,1871253,1871321,HepG2|chr19:1864364-1864408,chr19,1864364,1864408,1,6889
HepG2|chr19:1873181-1873196,chr19,1873181,1873196,HepG2|chr19:1868479-1868606,chr19,1868479,1868606,1,4702
HepG2|chr19:3441794-3441889,chr19,3441794,3441889,HepG2|chr19:3500431-3500449,chr19,3500431,3500449,1,58637
HepG2|chr19:3447431-3447475,chr19,3447431,3447475,HepG2|chr19:3499593-3499674,chr19,3499593,3499674,1,52162
HepG2|chr19:3686905-3686942,chr19,3686905,3686942,HepG2|chr19:3553376-3553484,chr19,3553376,3553484,1,133529
HepG2|chr19:3686906-3686950,chr19,3686906,3686950,HepG2|chr19:3553378-3553484,chr19,3553378,3553484,1,133528
HepG2|chr19:3686906-3686945,chr19,3686906,3686945,HepG2|chr19:3553370-3553481,chr19,3553370,3553481,1,133536
HepG2|chr19:4589242-4589329,chr19,4589242,4589329,HepG2|chr19:4393520-4393562,chr19,4393520,4393562,1,195722
HepG2|chr19:4614849-4614928,chr19,4614849,4614928,HepG2|chr19:4634986-4635022,chr19,4634986,4635022,1,20137
HepG2|chr19:4614856-4614928,chr19,4614856,4614928,HepG2|chr19:4634987-4635137,chr19,4634987,4635137,1,20131
HepG2|chr19:4614857-4614928,chr19,4614857,4614928,HepG2|chr19:4634986-4635063,chr19,4634986,4635063,1,20129
HepG2|chr19:4614858-4614928,chr19,4614858,4614928,HepG2|chr19:4634986-4635063,chr19,4634986,4635063,1,20128
HepG2|chr19:4614863-4614928,chr19,4614863,4614928,HepG2|chr19:4634988-4635124,chr19,4634988,4635124,1,20125
HepG2|chr19:4614872-4614928,chr19,4614872,4614928,HepG2|chr19:4635066-4635216,chr19,4635066,4635216,1,20194
HepG2|chr19:4614879-4614928,chr19,4614879,4614928,HepG2|chr19:4634984-4635117,chr19,4634984,4635117,1,20105
HepG2|chr19:4614885-4614928,chr19,4614885,4614928,HepG2|chr19:4635750-4635856,chr19,4635750,4635856,1,20865
HepG2|chr19:4614899-4614928,chr19,4614899,4614928,HepG2|chr19:4634986-4635116,chr19,4634986,4635116,1,20087
HepG2|chr19:4614900-4614928,chr19,4614900,4614928,HepG2|chr19:4634986-4635065,chr19,4634986,4635065,1,20086
HepG2|chr19:4614911-4614928,chr19,4614911,4614928,HepG2|chr19:4634986-4635116,chr19,4634986,4635116,1,20075
HepG2|chr19:4615272-4615312,chr19,4615272,4615312,HepG2|chr19:4634986-4635037,chr19,4634986,4635037,1,19714
HepG2|chr19:4615675-4615692,chr19,4615675,4615692,HepG2|chr19:4637026-4637140,chr19,4637026,4637140,1,21351
HepG2|chr19:4617502-4617570,chr19,4617502,4617570,HepG2|chr19:4634944-4635094,chr19,4634944,4635094,1,17442
HepG2|chr19:4617851-4618001,chr19,4617851,4618001,HepG2|chr19:9251948-9252026,chr19,9251948,9252026,1,4634097
HepG2|chr19:4619580-4619616,chr19,4619580,4619616,HepG2|chr19:4637318-4637416,chr19,4637318,4637416,1,17738
HepG2|chr19:4619581-4619616,chr19,4619581,4619616,HepG2|chr19:4637318-4637433,chr19,4637318,4637433,1,17737
HepG2|chr19:4620646-4620674,chr19,4620646,4620674,HepG2|chr19:4387711-4387858,chr19,4387711,4387858,1,232935
HepG2|chr19:4625352-4625502,chr19,4625352,4625502,HepG2|chr19:4634986-4635038,chr19,4634986,4635038,1,9634
HepG2|chr19:4625456-4625587,chr19,4625456,4625587,HepG2|chr19:4634986-4635035,chr19,4634986,4635035,1,9530
HepG2|chr19:4625462-4625587,chr19,4625462,4625587,HepG2|chr19:4634986-4635035,chr19,4634986,4635035,1,9524
HepG2|chr19:4625465-4625587,chr19,4625465,4625587,HepG2|chr19:4634980-4635114,chr19,4634980,4635114,1,9515
HepG2|chr19:4625475-4625555,chr19,4625475,4625555,HepG2|chr19:4634985-4635127,chr19,4634985,4635127,1,9510
HepG2|chr19:4625486-4625587,chr19,4625486,4625587,HepG2|chr19:4634986-4635035,chr19,4634986,4635035,1,9500
HepG2|chr19:4625488-4625587,chr19,4625488,4625587,HepG2|chr19:4634986-4635066,chr19,4634986,4635066,1,9498
HepG2|chr19:4625489-4625587,chr19,4625489,4625587,HepG2|chr19:4634986-4635038,chr19,4634986,4635038,1,9497
HepG2|chr19:4625498-4625587,chr19,4625498,4625587,HepG2|chr19:4634990-4635090,chr19,4634990,4635090,1,9492
HepG2|chr19:4625511-4625587,chr19,4625511,4625587,HepG2|chr19:4634980-4635126,chr19,4634980,4635126,1,9469
HepG2|chr19:4625518-4625587,chr19,4625518,4625587,HepG2|chr19:4634986-4635066,chr19,4634986,4635066,1,9468
HepG2|chr19:4625528-4625587,chr19,4625528,4625587,HepG2|chr19:4634986-4635081,chr19,4634986,4635081,1,9458
HepG2|chr19:4625529-4625587,chr19,4625529,4625587,HepG2|chr19:4634986-4635075,chr19,4634986,4635075,1,9457
HepG2|chr19:4625529-4625577,chr19,4625529,4625577,HepG2|chr19:4634986-4635103,chr19,4634986,4635103,1,9457
HepG2|chr19:4625530-4625587,chr19,4625530,4625587,HepG2|chr19:4634986-4635075,chr19,4634986,4635075,1,9456
HepG2|chr19:4625531-4625587,chr19,4625531,4625587,HepG2|chr19:4634990-4635084,chr19,4634990,4635084,1,9459
HepG2|chr19:4625751-4625815,chr19,4625751,4625815,HepG2|chr19:4638081-4638201,chr19,4638081,4638201,1,12330
HepG2|chr19:4626130-4626266,chr19,4626130,4626266,HepG2|chr19:4634611-4634633,chr19,4634611,4634633,1,8481
HepG2|chr19:4626467-4626566,chr19,4626467,4626566,HepG2|chr19:4635764-4635852,chr19,4635764,4635852,1,9297
HepG2|chr19:4626467-4626536,chr19,4626467,4626536,HepG2|chr19:4635764-4635852,chr19,4635764,4635852,1,9297
HepG2|chr19:4626504-4626566,chr19,4626504,4626566,HepG2|chr19:4635764-4635852,chr19,4635764,4635852,1,9260
HepG2|chr19:4626813-4626870,chr19,4626813,4626870,HepG2|chr19:4635205-4635298,chr19,4635205,4635298,1,8392
HepG2|chr19:4628585-4628735,chr19,4628585,4628735,HepG2|chr19:4635381-4635495,chr19,4635381,4635495,1,6796
HepG2|chr19:4628708-4628744,chr19,4628708,4628744,HepG2|chr19:4635381-4635495,chr19,4635381,4635495,1,6673
HepG2|chr19:4629944-4629973,chr19,4629944,4629973,HepG2|chr19:4634657-4634802,chr19,4634657,4634802,1,4713
HepG2|chr19:4631146-4631156,chr19,4631146,4631156,HepG2|chr19:4634986-4635114,chr19,4634986,4635114,1,3840
HepG2|chr19:4631192-4631214,chr19,4631192,4631214,HepG2|chr19:4634986-4635114,chr19,4634986,4635114,1,3794
HepG2|chr19:4632256-4632329,chr19,4632256,4632329,HepG2|chr19:4634601-4634659,chr19,4634601,4634659,1,2345
HepG2|chr19:4632355-4632418,chr19,4632355,4632418,HepG2|chr19:4637525-4637672,chr19,4637525,4637672,1,5170
HepG2|chr19:4633139-4633224,chr19,4633139,4633224,HepG2|chr19:4637028-4637054,chr19,4637028,4637054,1,3889
HepG2|chr19:4633299-4633437,chr19,4633299,4633437,HepG2|chr19:4639119-4639164,chr19,4639119,4639164,1,5820
HepG2|chr19:4633302-4633403,chr19,4633302,4633403,HepG2|chr19:4639119-4639164,chr19,4639119,4639164,1,5817
HepG2|chr19:4633427-4633485,chr19,4633427,4633485,HepG2|chr19:4637060-4637175,chr19,4637060,4637175,1,3633
HepG2|chr19:4633512-4633662,chr19,4633512,4633662,HepG2|chr19:4634990-4635111,chr19,4634990,4635111,1,1478
HepG2|chr19:4633517-4633667,chr19,4633517,4633667,HepG2|chr19:4639317-4639374,chr19,4639317,4639374,1,5800
HepG2|chr19:4633527-4633550,chr19,4633527,4633550,HepG2|chr19:4635121-4635271,chr19,4635121,4635271,1,1594
HepG2|chr19:4633549-4633699,chr19,4633549,4633699,HepG2|chr19:4634986-4635118,chr19,4634986,4635118,1,1437
HepG2|chr19:4633566-4633715,chr19,4633566,4633715,HepG2|chr19:4634990-4635022,chr19,4634990,4635022,1,1424
HepG2|chr19:4633583-4633733,chr19,4633583,4633733,HepG2|chr19:4634986-4635051,chr19,4634986,4635051,1,1403
HepG2|chr19:4633584-4633733,chr19,4633584,4633733,HepG2|chr19:4634986-4635073,chr19,4634986,4635073,1,1402
HepG2|chr19:4633592-4633733,chr19,4633592,4633733,HepG2|chr19:4634986-4635114,chr19,4634986,4635114,1,1394
HepG2|chr19:4633597-4633628,chr19,4633597,4633628,HepG2|chr19:4634986-4635114,chr19,4634986,4635114,1,1389
HepG2|chr19:4633609-4633733,chr19,4633609,4633733,HepG2|chr19:4634985-4635122,chr19,4634985,4635122,1,1376
HepG2|chr19:4633611-4633733,chr19,4633611,4633733,HepG2|chr19:4634986-4635026,chr19,4634986,4635026,1,1375
HepG2|chr19:4633614-4633733,chr19,4633614,4633733,HepG2|chr19:4634986-4635066,chr19,4634986,4635066,1,1372
HepG2|chr19:4633623-4633733,chr19,4633623,4633733,HepG2|chr19:4634986-4635026,chr19,4634986,4635026,1,1363
HepG2|chr19:4633627-4633733,chr19,4633627,4633733,HepG2|chr19:4634985-4635124,chr19,4634985,4635124,1,1358
HepG2|chr19:4633630-4633733,chr19,4633630,4633733,HepG2|chr19:4634986-4635111,chr19,4634986,4635111,1,1356
HepG2|chr19:4633630-4633657,chr19,4633630,4633657,HepG2|chr19:4634985-4635127,chr19,4634985,4635127,1,1355
HepG2|chr19:4633634-4633733,chr19,4633634,4633733,HepG2|chr19:4634986-4635088,chr19,4634986,4635088,1,1352
HepG2|chr19:4633635-4633733,chr19,4633635,4633733,HepG2|chr19:4634986-4635050,chr19,4634986,4635050,1,1351
HepG2|chr19:4633635-4633725,chr19,4633635,4633725,HepG2|chr19:4635502-4635523,chr19,4635502,4635523,1,1867
HepG2|chr19:4633635-4633666,chr19,4633635,4633666,HepG2|chr19:4635037-4635082,chr19,4635037,4635082,1,1402
HepG2|chr19:4633636-4633733,chr19,4633636,4633733,HepG2|chr19:4634990-4635063,chr19,4634990,4635063,1,1354
HepG2|chr19:4633636-4633665,chr19,4633636,4633665,HepG2|chr19:4635039-4635189,chr19,4635039,4635189,1,1403
HepG2|chr19:4633637-4633733,chr19,4633637,4633733,HepG2|chr19:4634986-4635080,chr19,4634986,4635080,1,1349
HepG2|chr19:4633638-4633733,chr19,4633638,4633733,HepG2|chr19:4634986-4635035,chr19,4634986,4635035,1,1348
HepG2|chr19:4633639-4633733,chr19,4633639,4633733,HepG2|chr19:4634986-4635037,chr19,4634986,4635037,1,1347
HepG2|chr19:4633640-4633733,chr19,4633640,4633733,HepG2|chr19:4634986-4635115,chr19,4634986,4635115,1,1346
HepG2|chr19:4633641-4633733,chr19,4633641,4633733,HepG2|chr19:4634986-4635059,chr19,4634986,4635059,1,1345
HepG2|chr19:4633642-4633733,chr19,4633642,4633733,HepG2|chr19:4634985-4635135,chr19,4634985,4635135,1,1343
HepG2|chr19:4633644-4633733,chr19,4633644,4633733,HepG2|chr19:4634985-4635124,chr19,4634985,4635124,1,1341
HepG2|chr19:4633646-4633733,chr19,4633646,4633733,HepG2|chr19:4634986-4635114,chr19,4634986,4635114,1,1340
HepG2|chr19:4633648-4633733,chr19,4633648,4633733,HepG2|chr19:4634986-4635051,chr19,4634986,4635051,1,1338
HepG2|chr19:4633648-4633711,chr19,4633648,4633711,HepG2|chr19:4635750-4635856,chr19,4635750,4635856,1,2102
HepG2|chr19:4633649-4633733,chr19,4633649,4633733,HepG2|chr19:4634986-4635115,chr19,4634986,4635115,1,1337
HepG2|chr19:4633654-4633733,chr19,4633654,4633733,HepG2|chr19:4634986-4635119,chr19,4634986,4635119,1,1332
HepG2|chr19:4633656-4633733,chr19,4633656,4633733,HepG2|chr19:4634986-4635059,chr19,4634986,4635059,1,1330
HepG2|chr19:4633657-4633733,chr19,4633657,4633733,HepG2|chr19:4634985-4635118,chr19,4634985,4635118,1,1328
HepG2|chr19:4633658-4633733,chr19,4633658,4633733,HepG2|chr19:4634986-4635035,chr19,4634986,4635035,1,1328
HepG2|chr19:4633659-4633733,chr19,4633659,4633733,HepG2|chr19:4634985-4635124,chr19,4634985,4635124,1,1326
HepG2|chr19:4633661-4633733,chr19,4633661,4633733,HepG2|chr19:4634986-4635064,chr19,4634986,4635064,1,1325
HepG2|chr19:4633662-4633733,chr19,4633662,4633733,HepG2|chr19:4634986-4635065,chr19,4634986,4635065,1,1324
HepG2|chr19:4633663-4633756,chr19,4633663,4633756,HepG2|chr19:4639317-4639374,chr19,4639317,4639374,1,5654
HepG2|chr19:4633663-4633733,chr19,4633663,4633733,HepG2|chr19:4634985-4635124,chr19,4634985,4635124,1,1322
HepG2|chr19:4633664-4633733,chr19,4633664,4633733,HepG2|chr19:4634985-4635127,chr19,4634985,4635127,1,1321
HepG2|chr19:4633667-4633733,chr19,4633667,4633733,HepG2|chr19:4634986-4635026,chr19,4634986,4635026,1,1319
HepG2|chr19:4633668-4633733,chr19,4633668,4633733,HepG2|chr19:4634986-4635066,chr19,4634986,4635066,1,1318
HepG2|chr19:4633670-4633733,chr19,4633670,4633733,HepG2|chr19:4634986-4635073,chr19,4634986,4635073,1,1316
HepG2|chr19:4633671-4633733,chr19,4633671,4633733,HepG2|chr19:4634986-4635074,chr19,4634986,4635074,1,1315
HepG2|chr19:4633673-4633733,chr19,4633673,4633733,HepG2|chr19:4634986-4635076,chr19,4634986,4635076,1,1313
HepG2|chr19:4633675-4633733,chr19,4633675,4633733,HepG2|chr19:4635782-4635925,chr19,4635782,4635925,1,2107
HepG2|chr19:4633676-4633733,chr19,4633676,4633733,HepG2|chr19:4634986-4635072,chr19,4634986,4635072,1,1310
HepG2|chr19:4633678-4633733,chr19,4633678,4633733,HepG2|chr19:4634983-4635130,chr19,4634983,4635130,1,1305
HepG2|chr19:4633679-4633733,chr19,4633679,4633733,HepG2|chr19:4634986-4635082,chr19,4634986,4635082,1,1307
HepG2|chr19:4633680-4633733,chr19,4633680,4633733,HepG2|chr19:4634986-4635080,chr19,4634986,4635080,1,1306
HepG2|chr19:4633681-4633733,chr19,4633681,4633733,HepG2|chr19:4634986-4635084,chr19,4634986,4635084,1,1305
HepG2|chr19:4633683-4633733,chr19,4633683,4633733,HepG2|chr19:4634985-4635117,chr19,4634985,4635117,1,1302
HepG2|chr19:4633683-4633732,chr19,4633683,4633732,HepG2|chr19:4634985-4635086,chr19,4634985,4635086,1,1302
HepG2|chr19:4633684-4633733,chr19,4633684,4633733,HepG2|chr19:4634986-4635107,chr19,4634986,4635107,1,1302
HepG2|chr19:4633685-4633733,chr19,4633685,4633733,HepG2|chr19:4634985-4635122,chr19,4634985,4635122,1,1300
HepG2|chr19:4633686-4633733,chr19,4633686,4633733,HepG2|chr19:4634986-4635116,chr19,4634986,4635116,1,1300
HepG2|chr19:4633687-4633733,chr19,4633687,4633733,HepG2|chr19:4634986-4635117,chr19,4634986,4635117,1,1299
HepG2|chr19:4633688-4633733,chr19,4633688,4633733,HepG2|chr19:4635750-4635843,chr19,4635750,4635843,1,2062
HepG2|chr19:4633689-4633733,chr19,4633689,4633733,HepG2|chr19:4634986-4635092,chr19,4634986,4635092,1,1297
HepG2|chr19:4633689-4633732,chr19,4633689,4633732,HepG2|chr19:4634985-4635125,chr19,4634985,4635125,1,1296
HepG2|chr19:4633690-4633733,chr19,4633690,4633733,HepG2|chr19:4634985-4635135,chr19,4634985,4635135,1,1295
HepG2|chr19:4633691-4633733,chr19,4633691,4633733,HepG2|chr19:4634986-4635114,chr19,4634986,4635114,1,1295
HepG2|chr19:4633692-4633733,chr19,4633692,4633733,HepG2|chr19:4634986-4635074,chr19,4634986,4635074,1,1294
HepG2|chr19:4633696-4633733,chr19,4633696,4633733,HepG2|chr19:4634990-4635111,chr19,4634990,4635111,1,1294
HepG2|chr19:4633698-4633733,chr19,4633698,4633733,HepG2|chr19:4634986-4635119,chr19,4634986,4635119,1,1288
HepG2|chr19:4633699-4633733,chr19,4633699,4633733,HepG2|chr19:4634986-4635111,chr19,4634986,4635111,1,1287
HepG2|chr19:4633700-4633733,chr19,4633700,4633733,HepG2|chr19:4634986-4635099,chr19,4634986,4635099,1,1286
HepG2|chr19:4633701-4633733,chr19,4633701,4633733,HepG2|chr19:4634985-4635130,chr19,4634985,4635130,1,1284
HepG2|chr19:4633702-4633733,chr19,4633702,4633733,HepG2|chr19:4634986-4635112,chr19,4634986,4635112,1,1284
HepG2|chr19:4633704-4633733,chr19,4633704,4633733,HepG2|chr19:4634990-4635111,chr19,4634990,4635111,1,1286
HepG2|chr19:4633705-4633733,chr19,4633705,4633733,HepG2|chr19:4634987-4635137,chr19,4634987,4635137,1,1282
HepG2|chr19:4633706-4633733,chr19,4633706,4633733,HepG2|chr19:4634986-4635111,chr19,4634986,4635111,1,1280
HepG2|chr19:4633707-4633733,chr19,4633707,4633733,HepG2|chr19:4634990-4635117,chr19,4634990,4635117,1,1283
HepG2|chr19:4633708-4633733,chr19,4633708,4633733,HepG2|chr19:4634986-4635111,chr19,4634986,4635111,1,1278
HepG2|chr19:4633709-4633733,chr19,4633709,4633733,HepG2|chr19:4634986-4635112,chr19,4634986,4635112,1,1277
HepG2|chr19:4633710-4633733,chr19,4633710,4633733,HepG2|chr19:4634999-4635122,chr19,4634999,4635122,1,1289
HepG2|chr19:4633711-4633733,chr19,4633711,4633733,HepG2|chr19:4634986-4635114,chr19,4634986,4635114,1,1275
HepG2|chr19:4633712-4633733,chr19,4633712,4633733,HepG2|chr19:4634986-4635115,chr19,4634986,4635115,1,1274
HepG2|chr19:4633713-4633733,chr19,4633713,4633733,HepG2|chr19:4634986-4635116,chr19,4634986,4635116,1,1273
HepG2|chr19:4633714-4633733,chr19,4633714,4633733,HepG2|chr19:4634986-4635114,chr19,4634986,4635114,1,1272
HepG2|chr19:4633715-4633733,chr19,4633715,4633733,HepG2|chr19:4634986-4635118,chr19,4634986,4635118,1,1271
HepG2|chr19:4633716-4633733,chr19,4633716,4633733,HepG2|chr19:4634986-4635119,chr19,4634986,4635119,1,1270
HepG2|chr19:4633717-4633733,chr19,4633717,4633733,HepG2|chr19:4634986-4635117,chr19,4634986,4635117,1,1269
HepG2|chr19:4633795-4633814,chr19,4633795,4633814,HepG2|chr19:4636046-4636183,chr19,4636046,4636183,1,2251
HepG2|chr19:4633882-4633924,chr19,4633882,4633924,HepG2|chr19:4637955-4638105,chr19,4637955,4638105,1,4073
HepG2|chr19:4633909-4633957,chr19,4633909,4633957,HepG2|chr19:4634487-4634590,chr19,4634487,4634590,1,578
HepG2|chr19:4633912-4633957,chr19,4633912,4633957,HepG2|chr19:4634487-4634590,chr19,4634487,4634590,1,575
HepG2|chr19:4895843-4895884,chr19,4895843,4895884,HepG2|chr19:4399463-4399578,chr19,4399463,4399578,1,496380
HepG2|chr19:4895847-4895903,chr19,4895847,4895903,HepG2|chr19:4399455-4399549,chr19,4399455,4399549,1,496392
HepG2|chr19:5954629-5954663,chr19,5954629,5954663,HepG2|chr19:4831150-4831261,chr19,4831150,4831261,1,1123479
HepG2|chr19:5954631-5954682,chr19,5954631,5954682,HepG2|chr19:4831150-4831261,chr19,4831150,4831261,1,1123481
HepG2|chr19:6233321-6233430,chr19,6233321,6233430,HepG2|chr19:15447129-15447174,chr19,15447129,15447174,1,9213808
HepG2|chr19:6233321-6233426,chr19,6233321,6233426,HepG2|chr19:15447129-15447174,chr19,15447129,15447174,1,9213808
HepG2|chr19:6233321-6233425,chr19,6233321,6233425,HepG2|chr19:15447129-15447174,chr19,15447129,15447174,1,9213808
HepG2|chr19:6584770-6584851,chr19,6584770,6584851,HepG2|chr19:6741298-6741355,chr19,6741298,6741355,1,156528
HepG2|chr19:6585780-6585858,chr19,6585780,6585858,HepG2|chr19:6741295-6741369,chr19,6741295,6741369,1,155515
HepG2|chr19:6585785-6585858,chr19,6585785,6585858,HepG2|chr19:6741295-6741369,chr19,6741295,6741369,1,155510
HepG2|chr19:8586723-8586816,chr19,8586723,8586816,HepG2|chr19:8583568-8583597,chr19,8583568,8583597,1,3155
HepG2|chr19:8591254-8591327,chr19,8591254,8591327,HepG2|chr19:8583568-8583597,chr19,8583568,8583597,1,7686
HepG2|chr19:9555546-9555615,chr19,9555546,9555615,HepG2|chr19:9546834-9546897,chr19,9546834,9546897,1,8712
HepG2|chr19:9556682-9556730,chr19,9556682,9556730,HepG2|chr19:9546478-9546558,chr19,9546478,9546558,1,10204
HepG2|chr19:9557490-9557564,chr19,9557490,9557564,HepG2|chr19:9549047-9549106,chr19,9549047,9549106,1,8443
HepG2|chr19:9557490-9557563,chr19,9557490,9557563,HepG2|chr19:9549047-9549106,chr19,9549047,9549106,1,8443
HepG2|chr19:9565026-9565146,chr19,9565026,9565146,HepG2|chr19:9546418-9546448,chr19,9546418,9546448,1,18608
HepG2|chr19:9565071-9565221,chr19,9565071,9565221,HepG2|chr19:9546418-9546448,chr19,9546418,9546448,1,18653
HepG2|chr19:10349804-10349945,chr19,10349804,10349945,HepG2|chr19:10361611-10361687,chr19,10361611,10361687,1,11807
HepG2|chr19:10349820-10349943,chr19,10349820,10349943,HepG2|chr19:10361611-10361720,chr19,10361611,10361720,1,11791
HepG2|chr19:10349825-10349943,chr19,10349825,10349943,HepG2|chr19:10361611-10361668,chr19,10361611,10361668,1,11786
HepG2|chr19:10349831-10349943,chr19,10349831,10349943,HepG2|chr19:10361611-10361735,chr19,10361611,10361735,1,11780
HepG2|chr19:10349833-10349943,chr19,10349833,10349943,HepG2|chr19:10361611-10361694,chr19,10361611,10361694,1,11778
HepG2|chr19:10349869-10349943,chr19,10349869,10349943,HepG2|chr19:10361611-10361687,chr19,10361611,10361687,1,11742
HepG2|chr19:10349874-10349943,chr19,10349874,10349943,HepG2|chr19:10361611-10361684,chr19,10361611,10361684,1,11737
HepG2|chr19:10349876-10349943,chr19,10349876,10349943,HepG2|chr19:10361611-10361694,chr19,10361611,10361694,1,11735
HepG2|chr19:10349902-10349943,chr19,10349902,10349943,HepG2|chr19:10361611-10361720,chr19,10361611,10361720,1,11709
HepG2|chr19:10349920-10349943,chr19,10349920,10349943,HepG2|chr19:10361611-10361735,chr19,10361611,10361735,1,11691
HepG2|chr19:10350611-10350634,chr19,10350611,10350634,HepG2|chr19:10358085-10358235,chr19,10358085,10358235,1,7474
HepG2|chr19:10352788-10352881,chr19,10352788,10352881,HepG2|chr19:10361611-10361668,chr19,10361611,10361668,1,8823
HepG2|chr19:11183658-11183761,chr19,11183658,11183761,HepG2|chr19:11195735-11195760,chr19,11195735,11195760,1,12077
HepG2|chr19:11183665-11183761,chr19,11183665,11183761,HepG2|chr19:11195735-11195760,chr19,11195735,11195760,1,12070
HepG2|chr19:13945303-13945344,chr19,13945303,13945344,HepG2|chr19:13261789-13261864,chr19,13261789,13261864,1,683514
HepG2|chr19:13948732-13948882,chr19,13948732,13948882,HepG2|chr19:52488992-52489030,chr19,52488992,52489030,1,38540260
HepG2|chr19:13948975-13949026,chr19,13948975,13949026,HepG2|chr19:52488987-52489090,chr19,52488987,52489090,1,38540012
HepG2|chr19:14467580-14467647,chr19,14467580,14467647,HepG2|chr19:14531426-14531509,chr19,14531426,14531509,1,63846
HepG2|chr19:14470740-14470805,chr19,14470740,14470805,HepG2|chr19:14176357-14176421,chr19,14176357,14176421,1,294383
HepG2|chr19:14471436-14471473,chr19,14471436,14471473,HepG2|chr19:14534762-14534793,chr19,14534762,14534793,1,63326
HepG2|chr19:14666026-14666103,chr19,14666026,14666103,HepG2|chr19:47352234-47352267,chr19,47352234,47352267,1,32686208
HepG2|chr19:15421790-15421874,chr19,15421790,15421874,HepG2|chr19:15616687-15616728,chr19,15616687,15616728,1,194897
HepG2|chr19:15424418-15424462,chr19,15424418,15424462,HepG2|chr19:15616763-15616786,chr19,15616763,15616786,1,192345
HepG2|chr19:16198531-16198626,chr19,16198531,16198626,HepG2|chr19:16298211-16298266,chr19,16298211,16298266,1,99680
HepG2|chr19:16198542-16198626,chr19,16198542,16198626,HepG2|chr19:16298211-16298270,chr19,16298211,16298270,1,99669
HepG2|chr19:18404549-18404669,chr19,18404549,18404669,HepG2|chr19:3573798-3573857,chr19,3573798,3573857,1,14830751
HepG2|chr19:18404584-18404675,chr19,18404584,18404675,HepG2|chr19:3573798-3573857,chr19,3573798,3573857,1,14830786
HepG2|chr19:33774030-33774098,chr19,33774030,33774098,HepG2|chr19:33789414-33789533,chr19,33789414,33789533,1,15384
HepG2|chr19:33774030-33774061,chr19,33774030,33774061,HepG2|chr19:33789414-33789533,chr19,33789414,33789533,1,15384
HepG2|chr19:33774030-33774060,chr19,33774030,33774060,HepG2|chr19:33789414-33789533,chr19,33789414,33789533,1,15384
HepG2|chr19:33774031-33774098,chr19,33774031,33774098,HepG2|chr19:33789414-33789533,chr19,33789414,33789533,1,15383
HepG2|chr19:34864830-34864979,chr19,34864830,34864979,HepG2|chr19:1070525-1070591,chr19,1070525,1070591,1,33794305
HepG2|chr19:34864897-34865035,chr19,34864897,34865035,HepG2|chr19:1070469-1070589,chr19,1070469,1070589,1,33794428
HepG2|chr19:35581651-35581685,chr19,35581651,35581685,HepG2|chr19:35604250-35604298,chr19,35604250,35604298,1,22599
HepG2|chr19:35581869-35582019,chr19,35581869,35582019,HepG2|chr19:35604250-35604299,chr19,35604250,35604299,1,22381
HepG2|chr19:35581920-35582024,chr19,35581920,35582024,HepG2|chr19:35604250-35604269,chr19,35604250,35604269,1,22330
HepG2|chr19:35581923-35582024,chr19,35581923,35582024,HepG2|chr19:35604250-35604299,chr19,35604250,35604299,1,22327
HepG2|chr19:35581925-35582024,chr19,35581925,35582024,HepG2|chr19:35604250-35604298,chr19,35604250,35604298,1,22325
HepG2|chr19:35581943-35582024,chr19,35581943,35582024,HepG2|chr19:35604250-35604268,chr19,35604250,35604268,1,22307
HepG2|chr19:38447097-38447220,chr19,38447097,38447220,HepG2|chr19:3574259-3574317,chr19,3574259,3574317,1,34872838
HepG2|chr19:38447097-38447127,chr19,38447097,38447127,HepG2|chr19:3574259-3574317,chr19,3574259,3574317,1,34872838
HepG2|chr19:38447142-38447222,chr19,38447142,38447222,HepG2|chr19:3574259-3574317,chr19,3574259,3574317,1,34872883
HepG2|chr19:39166904-39167010,chr19,39166904,39167010,HepG2|chr19:53193226-53193367,chr19,53193226,53193367,1,14026322
HepG2|chr19:39536095-39536158,chr19,39536095,39536158,HepG2|chr19:39615716-39615782,chr19,39615716,39615782,1,79621
HepG2|chr19:39558601-39558661,chr19,39558601,39558661,HepG2|chr19:39612589-39612679,chr19,39612589,39612679,1,53988
HepG2|chr19:42733865-42733895,chr19,42733865,42733895,HepG2|chr19:42746196-42746325,chr19,42746196,42746325,1,12331
HepG2|chr19:42737735-42737754,chr19,42737735,42737754,HepG2|chr19:42757339-42757447,chr19,42757339,42757447,1,19604
HepG2|chr19:45222893-45222993,chr19,45222893,45222993,HepG2|chr19:58893949-58893994,chr19,58893949,58893994,1,13671056
HepG2|chr19:45222893-45222981,chr19,45222893,45222981,HepG2|chr19:58893949-58893994,chr19,58893949,58893994,1,13671056
HepG2|chr19:45222894-45222981,chr19,45222894,45222981,HepG2|chr19:58893949-58893994,chr19,58893949,58893994,1,13671055
HepG2|chr19:45222894-45222976,chr19,45222894,45222976,HepG2|chr19:58893949-58893994,chr19,58893949,58893994,1,13671055
HepG2|chr19:45228080-45228212,chr19,45228080,45228212,HepG2|chr19:45248327-45248477,chr19,45248327,45248477,1,20247
HepG2|chr19:45228100-45228149,chr19,45228100,45228149,HepG2|chr19:45202246-45202396,chr19,45202246,45202396,1,25854
HepG2|chr19:45228100-45228140,chr19,45228100,45228140,HepG2|chr19:45202176-45202325,chr19,45202176,45202325,1,25924
HepG2|chr19:45229130-45229196,chr19,45229130,45229196,HepG2|chr19:45250180-45250246,chr19,45250180,45250246,1,21050
HepG2|chr19:45244815-45244931,chr19,45244815,45244931,HepG2|chr19:45248301-45248405,chr19,45248301,45248405,1,3486
HepG2|chr19:45244885-45244931,chr19,45244885,45244931,HepG2|chr19:45248301-45248405,chr19,45248301,45248405,1,3416
HepG2|chr19:45244887-45244931,chr19,45244887,45244931,HepG2|chr19:45248300-45248446,chr19,45248300,45248446,1,3413
HepG2|chr19:45244896-45244931,chr19,45244896,45244931,HepG2|chr19:45248301-45248394,chr19,45248301,45248394,1,3405
HepG2|chr19:45244900-45244931,chr19,45244900,45244931,HepG2|chr19:45251062-45251212,chr19,45251062,45251212,1,6162
HepG2|chr19:45245880-45246028,chr19,45245880,45246028,HepG2|chr19:45249840-45249859,chr19,45249840,45249859,1,3960
HepG2|chr19:45245888-45246027,chr19,45245888,45246027,HepG2|chr19:45248320-45248470,chr19,45248320,45248470,1,2432
HepG2|chr19:45245947-45246027,chr19,45245947,45246027,HepG2|chr19:45248301-45248322,chr19,45248301,45248322,1,2354
HepG2|chr19:45245961-45246027,chr19,45245961,45246027,HepG2|chr19:45248300-45248446,chr19,45248300,45248446,1,2339
HepG2|chr19:45245965-45246027,chr19,45245965,45246027,HepG2|chr19:45248301-45248394,chr19,45248301,45248394,1,2336
HepG2|chr19:45245968-45246027,chr19,45245968,45246027,HepG2|chr19:45248301-45248337,chr19,45248301,45248337,1,2333
HepG2|chr19:45245970-45246027,chr19,45245970,45246027,HepG2|chr19:45248301-45248394,chr19,45248301,45248394,1,2331
HepG2|chr19:45245971-45246027,chr19,45245971,45246027,HepG2|chr19:45248299-45248447,chr19,45248299,45248447,1,2328
HepG2|chr19:45245978-45246027,chr19,45245978,45246027,HepG2|chr19:45248301-45248391,chr19,45248301,45248391,1,2323
HepG2|chr19:45245978-45246021,chr19,45245978,45246021,HepG2|chr19:45251094-45251170,chr19,45251094,45251170,1,5116
HepG2|chr19:45245980-45246027,chr19,45245980,45246027,HepG2|chr19:45248301-45248359,chr19,45248301,45248359,1,2321
HepG2|chr19:45245982-45246027,chr19,45245982,45246027,HepG2|chr19:45249869-45249898,chr19,45249869,45249898,1,3887
HepG2|chr19:45245984-45246027,chr19,45245984,45246027,HepG2|chr19:45248301-45248419,chr19,45248301,45248419,1,2317
HepG2|chr19:45245985-45246027,chr19,45245985,45246027,HepG2|chr19:45248301-45248349,chr19,45248301,45248349,1,2316
HepG2|chr19:45245989-45246027,chr19,45245989,45246027,HepG2|chr19:45248300-45248448,chr19,45248300,45248448,1,2311
HepG2|chr19:45245990-45246140,chr19,45245990,45246140,HepG2|chr19:45248301-45248370,chr19,45248301,45248370,1,2311
HepG2|chr19:45245990-45246027,chr19,45245990,45246027,HepG2|chr19:45248344-45248491,chr19,45248344,45248491,1,2354
HepG2|chr19:45245995-45246027,chr19,45245995,45246027,HepG2|chr19:45251094-45251215,chr19,45251094,45251215,1,5099
HepG2|chr19:45245996-45246027,chr19,45245996,45246027,HepG2|chr19:45248301-45248326,chr19,45248301,45248326,1,2305
HepG2|chr19:45246002-45246027,chr19,45246002,45246027,HepG2|chr19:45248301-45248353,chr19,45248301,45248353,1,2299
HepG2|chr19:45246011-45246161,chr19,45246011,45246161,HepG2|chr19:45248294-45248443,chr19,45248294,45248443,1,2283
HepG2|chr19:45246035-45246078,chr19,45246035,45246078,HepG2|chr19:45249493-45249643,chr19,45249493,45249643,1,3458
HepG2|chr19:45246071-45246181,chr19,45246071,45246181,HepG2|chr19:45248328-45248478,chr19,45248328,45248478,1,2257
HepG2|chr19:45246072-45246181,chr19,45246072,45246181,HepG2|chr19:45248301-45248415,chr19,45248301,45248415,1,2229
HepG2|chr19:45246089-45246181,chr19,45246089,45246181,HepG2|chr19:45248327-45248477,chr19,45248327,45248477,1,2238
HepG2|chr19:45246103-45246181,chr19,45246103,45246181,HepG2|chr19:45248301-45248349,chr19,45248301,45248349,1,2198
HepG2|chr19:45246106-45246181,chr19,45246106,45246181,HepG2|chr19:45248301-45248370,chr19,45248301,45248370,1,2195
HepG2|chr19:45246110-45246181,chr19,45246110,45246181,HepG2|chr19:45248301-45248326,chr19,45248301,45248326,1,2191
HepG2|chr19:45246112-45246181,chr19,45246112,45246181,HepG2|chr19:45249869-45249906,chr19,45249869,45249906,1,3757
HepG2|chr19:45246113-45246181,chr19,45246113,45246181,HepG2|chr19:45251094-45251164,chr19,45251094,45251164,1,4981
HepG2|chr19:45246118-45246181,chr19,45246118,45246181,HepG2|chr19:45248332-45248480,chr19,45248332,45248480,1,2214
HepG2|chr19:45246120-45246181,chr19,45246120,45246181,HepG2|chr19:45248294-45248443,chr19,45248294,45248443,1,2174
HepG2|chr19:45246121-45246259,chr19,45246121,45246259,HepG2|chr19:45251094-45251164,chr19,45251094,45251164,1,4973
HepG2|chr19:45246121-45246181,chr19,45246121,45246181,HepG2|chr19:45248328-45248478,chr19,45248328,45248478,1,2207
HepG2|chr19:45246122-45246181,chr19,45246122,45246181,HepG2|chr19:45248301-45248392,chr19,45248301,45248392,1,2179
HepG2|chr19:45246124-45246181,chr19,45246124,45246181,HepG2|chr19:45248294-45248443,chr19,45248294,45248443,1,2170
HepG2|chr19:45246125-45246259,chr19,45246125,45246259,HepG2|chr19:45248343-45248493,chr19,45248343,45248493,1,2218
HepG2|chr19:45246125-45246181,chr19,45246125,45246181,HepG2|chr19:45248301-45248395,chr19,45248301,45248395,1,2176
HepG2|chr19:45246126-45246181,chr19,45246126,45246181,HepG2|chr19:45249840-45249901,chr19,45249840,45249901,1,3714
HepG2|chr19:45246127-45246181,chr19,45246127,45246181,HepG2|chr19:45248301-45248395,chr19,45248301,45248395,1,2174
HepG2|chr19:45246128-45246181,chr19,45246128,45246181,HepG2|chr19:45248303-45248450,chr19,45248303,45248450,1,2175
HepG2|chr19:45246130-45246259,chr19,45246130,45246259,HepG2|chr19:45248301-45248322,chr19,45248301,45248322,1,2171
HepG2|chr19:45246133-45246181,chr19,45246133,45246181,HepG2|chr19:45248301-45248395,chr19,45248301,45248395,1,2168
HepG2|chr19:45246134-45246181,chr19,45246134,45246181,HepG2|chr19:45248301-45248395,chr19,45248301,45248395,1,2167
HepG2|chr19:45246139-45246259,chr19,45246139,45246259,HepG2|chr19:45248301-45248395,chr19,45248301,45248395,1,2162
HepG2|chr19:45246139-45246181,chr19,45246139,45246181,HepG2|chr19:45248294-45248443,chr19,45248294,45248443,1,2155
HepG2|chr19:45246141-45246181,chr19,45246141,45246181,HepG2|chr19:45251094-45251164,chr19,45251094,45251164,1,4953
HepG2|chr19:45246142-45246181,chr19,45246142,45246181,HepG2|chr19:45251094-45251195,chr19,45251094,45251195,1,4952
HepG2|chr19:45246143-45246181,chr19,45246143,45246181,HepG2|chr19:45248301-45248395,chr19,45248301,45248395,1,2158
HepG2|chr19:45246145-45246181,chr19,45246145,45246181,HepG2|chr19:45248301-45248395,chr19,45248301,45248395,1,2156
HepG2|chr19:45246146-45246181,chr19,45246146,45246181,HepG2|chr19:45249883-45250033,chr19,45249883,45250033,1,3737
HepG2|chr19:45246148-45246181,chr19,45246148,45246181,HepG2|chr19:45251094-45251217,chr19,45251094,45251217,1,4946
HepG2|chr19:45246149-45246259,chr19,45246149,45246259,HepG2|chr19:45248301-45248443,chr19,45248301,45248443,1,2152
HepG2|chr19:45246153-45246181,chr19,45246153,45246181,HepG2|chr19:45248301-45248395,chr19,45248301,45248395,1,2148
HepG2|chr19:45246155-45246181,chr19,45246155,45246181,HepG2|chr19:45249866-45249896,chr19,45249866,45249896,1,3711
HepG2|chr19:45246156-45246181,chr19,45246156,45246181,HepG2|chr19:45248331-45248481,chr19,45248331,45248481,1,2175
HepG2|chr19:45246157-45246181,chr19,45246157,45246181,HepG2|chr19:45248301-45248394,chr19,45248301,45248394,1,2144
HepG2|chr19:45246161-45246259,chr19,45246161,45246259,HepG2|chr19:45248301-45248446,chr19,45248301,45248446,1,2140
HepG2|chr19:45246161-45246181,chr19,45246161,45246181,HepG2|chr19:45248344-45248491,chr19,45248344,45248491,1,2183
HepG2|chr19:45246162-45246181,chr19,45246162,45246181,HepG2|chr19:45248301-45248429,chr19,45248301,45248429,1,2139
HepG2|chr19:45246163-45246181,chr19,45246163,45246181,HepG2|chr19:45251094-45251195,chr19,45251094,45251195,1,4931
HepG2|chr19:45246167-45246259,chr19,45246167,45246259,HepG2|chr19:45248301-45248395,chr19,45248301,45248395,1,2134
HepG2|chr19:45246171-45246259,chr19,45246171,45246259,HepG2|chr19:45248301-45248394,chr19,45248301,45248394,1,2130
HepG2|chr19:45246181-45246259,chr19,45246181,45246259,HepG2|chr19:45248301-45248337,chr19,45248301,45248337,1,2120
HepG2|chr19:45246186-45246259,chr19,45246186,45246259,HepG2|chr19:45248301-45248322,chr19,45248301,45248322,1,2115
HepG2|chr19:45246190-45246259,chr19,45246190,45246259,HepG2|chr19:45248407-45248557,chr19,45248407,45248557,1,2217
HepG2|chr19:45246202-45246259,chr19,45246202,45246259,HepG2|chr19:45248301-45248404,chr19,45248301,45248404,1,2099
HepG2|chr19:45246203-45246259,chr19,45246203,45246259,HepG2|chr19:45248301-45248395,chr19,45248301,45248395,1,2098
HepG2|chr19:45246212-45246259,chr19,45246212,45246259,HepG2|chr19:45248301-45248404,chr19,45248301,45248404,1,2089
HepG2|chr19:45246213-45246259,chr19,45246213,45246259,HepG2|chr19:45248301-45248395,chr19,45248301,45248395,1,2088
HepG2|chr19:45246221-45246259,chr19,45246221,45246259,HepG2|chr19:45248333-45248480,chr19,45248333,45248480,1,2112
HepG2|chr19:45246226-45246259,chr19,45246226,45246259,HepG2|chr19:45248301-45248439,chr19,45248301,45248439,1,2075
HepG2|chr19:45246233-45246259,chr19,45246233,45246259,HepG2|chr19:45251094-45251195,chr19,45251094,45251195,1,4861
HepG2|chr19:45246534-45246677,chr19,45246534,45246677,HepG2|chr19:45248172-45248238,chr19,45248172,45248238,1,1638
HepG2|chr19:45246534-45246618,chr19,45246534,45246618,HepG2|chr19:45248172-45248238,chr19,45248172,45248238,1,1638
HepG2|chr19:45246550-45246633,chr19,45246550,45246633,HepG2|chr19:45247433-45247529,chr19,45247433,45247529,1,883
HepG2|chr19:45246552-45246618,chr19,45246552,45246618,HepG2|chr19:45247435-45247529,chr19,45247435,45247529,1,883
HepG2|chr19:45246560-45246699,chr19,45246560,45246699,HepG2|chr19:45248924-45248966,chr19,45248924,45248966,1,2364
HepG2|chr19:45246560-45246668,chr19,45246560,45246668,HepG2|chr19:45248924-45248966,chr19,45248924,45248966,1,2364
HepG2|chr19:45246577-45246631,chr19,45246577,45246631,HepG2|chr19:45247433-45247529,chr19,45247433,45247529,1,856
HepG2|chr19:45608765-45608794,chr19,45608765,45608794,HepG2|chr19:16736048-16736198,chr19,16736048,16736198,1,28872717
HepG2|chr19:47333718-47333842,chr19,47333718,47333842,HepG2|chr19:3553382-3553484,chr19,3553382,3553484,1,43780336
HepG2|chr19:47333720-47333845,chr19,47333720,47333845,HepG2|chr19:3553381-3553484,chr19,3553381,3553484,1,43780339
HepG2|chr19:47333720-47333842,chr19,47333720,47333842,HepG2|chr19:3553378-3553484,chr19,3553378,3553484,1,43780342
HepG2|chr19:47333791-47333845,chr19,47333791,47333845,HepG2|chr19:3553336-3553468,chr19,3553336,3553468,1,43780455
HepG2|chr19:47333792-47333845,chr19,47333792,47333845,HepG2|chr19:3553380-3553484,chr19,3553380,3553484,1,43780412
HepG2|chr19:47333795-47333845,chr19,47333795,47333845,HepG2|chr19:3553386-3553484,chr19,3553386,3553484,1,43780409
HepG2|chr19:47333795-47333842,chr19,47333795,47333842,HepG2|chr19:3553375-3553484,chr19,3553375,3553484,1,43780420
HepG2|chr19:47333797-47333845,chr19,47333797,47333845,HepG2|chr19:3553396-3553484,chr19,3553396,3553484,1,43780401
HepG2|chr19:47333799-47333842,chr19,47333799,47333842,HepG2|chr19:3553377-3553484,chr19,3553377,3553484,1,43780422
HepG2|chr19:47333801-47333845,chr19,47333801,47333845,HepG2|chr19:3553380-3553484,chr19,3553380,3553484,1,43780421
HepG2|chr19:47333801-47333842,chr19,47333801,47333842,HepG2|chr19:3553369-3553468,chr19,3553369,3553468,1,43780432
HepG2|chr19:47446107-47446213,chr19,47446107,47446213,HepG2|chr19:47293690-47293725,chr19,47293690,47293725,1,152417
HepG2|chr19:47454379-47454492,chr19,47454379,47454492,HepG2|chr19:47289822-47289859,chr19,47289822,47289859,1,164557
HepG2|chr19:47745395-47745450,chr19,47745395,47745450,HepG2|chr19:3569261-3569331,chr19,3569261,3569331,1,44176134
HepG2|chr19:48125343-48125390,chr19,48125343,48125390,HepG2|chr19:48388066-48388161,chr19,48388066,48388161,1,262723
HepG2|chr19:48125442-48125545,chr19,48125442,48125545,HepG2|chr19:48393725-48393746,chr19,48393725,48393746,1,268283
HepG2|chr19:48136722-48136771,chr19,48136722,48136771,HepG2|chr19:44599830-44599900,chr19,44599830,44599900,1,3536892
HepG2|chr19:48136722-48136769,chr19,48136722,48136769,HepG2|chr19:44599830-44599900,chr19,44599830,44599900,1,3536892
HepG2|chr19:49264561-49264594,chr19,49264561,49264594,HepG2|chr19:49864295-49864336,chr19,49864295,49864336,1,599734
HepG2|chr19:49264585-49264661,chr19,49264585,49264661,HepG2|chr19:49864204-49864354,chr19,49864204,49864354,1,599619
HepG2|chr19:49264586-49264660,chr19,49264586,49264660,HepG2|chr19:49864292-49864424,chr19,49864292,49864424,1,599706
HepG2|chr19:49264655-49264701,chr19,49264655,49264701,HepG2|chr19:49864556-49864706,chr19,49864556,49864706,1,599901
HepG2|chr19:49264675-49264700,chr19,49264675,49264700,HepG2|chr19:49864169-49864265,chr19,49864169,49864265,1,599494
HepG2|chr19:49264802-49264824,chr19,49264802,49264824,HepG2|chr19:49864463-49864575,chr19,49864463,49864575,1,599661
HepG2|chr19:49265047-49265074,chr19,49265047,49265074,HepG2|chr19:49864286-49864397,chr19,49864286,49864397,1,599239
HepG2|chr19:49265234-49265263,chr19,49265234,49265263,HepG2|chr19:49863817-49863967,chr19,49863817,49863967,1,598583
HepG2|chr19:49265234-49265261,chr19,49265234,49265261,HepG2|chr19:49863920-49863986,chr19,49863920,49863986,1,598686
HepG2|chr19:49265501-49265545,chr19,49265501,49265545,HepG2|chr19:49864508-49864572,chr19,49864508,49864572,1,599007
HepG2|chr19:49265696-49265730,chr19,49265696,49265730,HepG2|chr19:49864203-49864265,chr19,49864203,49864265,1,598507
HepG2|chr19:53935245-53935391,chr19,53935245,53935391,HepG2|chr19:53971127-53971178,chr19,53971127,53971178,1,35882
HepG2|chr19:53935254-53935404,chr19,53935254,53935404,HepG2|chr19:53971127-53971179,chr19,53971127,53971179,1,35873
HepG2|chr19:53935256-53935322,chr19,53935256,53935322,HepG2|chr19:53971127-53971179,chr19,53971127,53971179,1,35871
HepG2|chr19:53935266-53935364,chr19,53935266,53935364,HepG2|chr19:53971127-53971179,chr19,53971127,53971179,1,35861
HepG2|chr19:53935267-53935364,chr19,53935267,53935364,HepG2|chr19:53971127-53971179,chr19,53971127,53971179,1,35860
HepG2|chr19:53935268-53935364,chr19,53935268,53935364,HepG2|chr19:53971127-53971181,chr19,53971127,53971181,1,35859
HepG2|chr19:53935270-53935364,chr19,53935270,53935364,HepG2|chr19:53971127-53971183,chr19,53971127,53971183,1,35857
HepG2|chr19:53935271-53935364,chr19,53935271,53935364,HepG2|chr19:53971127-53971183,chr19,53971127,53971183,1,35856
HepG2|chr19:53935272-53935364,chr19,53935272,53935364,HepG2|chr19:53971127-53971185,chr19,53971127,53971185,1,35855
HepG2|chr19:53935285-53935364,chr19,53935285,53935364,HepG2|chr19:53971127-53971183,chr19,53971127,53971183,1,35842
HepG2|chr19:53935292-53935364,chr19,53935292,53935364,HepG2|chr19:53971127-53971179,chr19,53971127,53971179,1,35835
HepG2|chr19:53935415-53935561,chr19,53935415,53935561,HepG2|chr19:53971113-53971158,chr19,53971113,53971158,1,35698
HepG2|chr19:53935573-53935699,chr19,53935573,53935699,HepG2|chr19:53898571-53898595,chr19,53898571,53898595,1,37002
HepG2|chr19:53935573-53935681,chr19,53935573,53935681,HepG2|chr19:53898568-53898595,chr19,53898568,53898595,1,37005
HepG2|chr19:53935778-53935917,chr19,53935778,53935917,HepG2|chr19:53193113-53193165,chr19,53193113,53193165,1,742665
HepG2|chr19:53935799-53935899,chr19,53935799,53935899,HepG2|chr19:53899403-53899490,chr19,53899403,53899490,1,36396
HepG2|chr19:53935799-53935862,chr19,53935799,53935862,HepG2|chr19:53899403-53899490,chr19,53899403,53899490,1,36396
HepG2|chr19:53935862-53936009,chr19,53935862,53936009,HepG2|chr19:53192876-53192963,chr19,53192876,53192963,1,742986
HepG2|chr19:53935922-53936033,chr19,53935922,53936033,HepG2|chr19:53869718-53869792,chr19,53869718,53869792,1,66204
HepG2|chr19:53935922-53935998,chr19,53935922,53935998,HepG2|chr19:53869718-53869792,chr19,53869718,53869792,1,66204
HepG2|chr19:53935931-53935961,chr19,53935931,53935961,HepG2|chr19:53192905-53193055,chr19,53192905,53193055,1,743026
HepG2|chr19:53935934-53935983,chr19,53935934,53935983,HepG2|chr19:53869726-53869780,chr19,53869726,53869780,1,66208
HepG2|chr19:53935953-53936014,chr19,53935953,53936014,HepG2|chr19:53899140-53899229,chr19,53899140,53899229,1,36813
HepG2|chr19:53935975-53936113,chr19,53935975,53936113,HepG2|chr19:53192878-53192972,chr19,53192878,53192972,1,743097
HepG2|chr19:53935987-53936134,chr19,53935987,53936134,HepG2|chr19:53192674-53192821,chr19,53192674,53192821,1,743313
HepG2|chr19:53935989-53936139,chr19,53935989,53936139,HepG2|chr19:53192879-53192964,chr19,53192879,53192964,1,743110
HepG2|chr19:53936016-53936133,chr19,53936016,53936133,HepG2|chr19:53192814-53192930,chr19,53192814,53192930,1,743202
HepG2|chr19:53936073-53936134,chr19,53936073,53936134,HepG2|chr19:53869861-53869947,chr19,53869861,53869947,1,66212
HepG2|chr19:53936074-53936139,chr19,53936074,53936139,HepG2|chr19:53869851-53869947,chr19,53869851,53869947,1,66223
HepG2|chr19:53936074-53936128,chr19,53936074,53936128,HepG2|chr19:53869851-53869947,chr19,53869851,53869947,1,66223
HepG2|chr19:53936082-53936127,chr19,53936082,53936127,HepG2|chr19:53869854-53869959,chr19,53869854,53869959,1,66228
HepG2|chr19:53936136-53936224,chr19,53936136,53936224,HepG2|chr19:53899518-53899580,chr19,53899518,53899580,1,36618
HepG2|chr19:53936138-53936288,chr19,53936138,53936288,HepG2|chr19:53899373-53899520,chr19,53899373,53899520,1,36765
HepG2|chr19:53936141-53936291,chr19,53936141,53936291,HepG2|chr19:53899382-53899532,chr19,53899382,53899532,1,36759
HepG2|chr19:53936144-53936290,chr19,53936144,53936290,HepG2|chr19:53899145-53899277,chr19,53899145,53899277,1,36999
HepG2|chr19:53936144-53936287,chr19,53936144,53936287,HepG2|chr19:53192667-53192817,chr19,53192667,53192817,1,743477
HepG2|chr19:53936175-53936296,chr19,53936175,53936296,HepG2|chr19:53899396-53899546,chr19,53899396,53899546,1,36779
HepG2|chr19:53936225-53936296,chr19,53936225,53936296,HepG2|chr19:53899387-53899512,chr19,53899387,53899512,1,36838
HepG2|chr19:53936311-53936438,chr19,53936311,53936438,HepG2|chr19:53192675-53192825,chr19,53192675,53192825,1,743636
HepG2|chr19:53936311-53936430,chr19,53936311,53936430,HepG2|chr19:53899391-53899504,chr19,53899391,53899504,1,36920
HepG2|chr19:53936311-53936429,chr19,53936311,53936429,HepG2|chr19:53899412-53899504,chr19,53899412,53899504,1,36899
HepG2|chr19:53936311-53936426,chr19,53936311,53936426,HepG2|chr19:53899414-53899504,chr19,53899414,53899504,1,36897
HepG2|chr19:53936311-53936425,chr19,53936311,53936425,HepG2|chr19:53899391-53899504,chr19,53899391,53899504,1,36920
HepG2|chr19:53936313-53936424,chr19,53936313,53936424,HepG2|chr19:53192673-53192821,chr19,53192673,53192821,1,743640
HepG2|chr19:53936313-53936421,chr19,53936313,53936421,HepG2|chr19:53899417-53899504,chr19,53899417,53899504,1,36896
HepG2|chr19:53936313-53936419,chr19,53936313,53936419,HepG2|chr19:53899391-53899504,chr19,53899391,53899504,1,36922
HepG2|chr19:53936324-53936474,chr19,53936324,53936474,HepG2|chr19:53899391-53899504,chr19,53899391,53899504,1,36933
HepG2|chr19:53936325-53936472,chr19,53936325,53936472,HepG2|chr19:53899391-53899504,chr19,53899391,53899504,1,36934
HepG2|chr19:53936327-53936476,chr19,53936327,53936476,HepG2|chr19:53192674-53192820,chr19,53192674,53192820,1,743653
HepG2|chr19:53936330-53936480,chr19,53936330,53936480,HepG2|chr19:53899391-53899504,chr19,53899391,53899504,1,36939
HepG2|chr19:53936332-53936479,chr19,53936332,53936479,HepG2|chr19:53192667-53192817,chr19,53192667,53192817,1,743665
HepG2|chr19:53936332-53936478,chr19,53936332,53936478,HepG2|chr19:53899393-53899504,chr19,53899393,53899504,1,36939
HepG2|chr19:53936333-53936479,chr19,53936333,53936479,HepG2|chr19:53899408-53899504,chr19,53899408,53899504,1,36925
HepG2|chr19:53936340-53936482,chr19,53936340,53936482,HepG2|chr19:53899405-53899504,chr19,53899405,53899504,1,36935
HepG2|chr19:53936368-53936514,chr19,53936368,53936514,HepG2|chr19:53899403-53899504,chr19,53899403,53899504,1,36965
HepG2|chr19:53936380-53936530,chr19,53936380,53936530,HepG2|chr19:53899398-53899504,chr19,53899398,53899504,1,36982
HepG2|chr19:53943079-53943185,chr19,53943079,53943185,HepG2|chr19:53898527-53898595,chr19,53898527,53898595,1,44552
HepG2|chr19:53943080-53943174,chr19,53943080,53943174,HepG2|chr19:53971136-53971192,chr19,53971136,53971192,1,28056
HepG2|chr19:53943080-53943160,chr19,53943080,53943160,HepG2|chr19:53898527-53898595,chr19,53898527,53898595,1,44553
HepG2|chr19:53945048-53945089,chr19,53945048,53945089,HepG2|chr19:53971136-53971192,chr19,53971136,53971192,1,26088
HepG2|chr19:53946761-53946825,chr19,53946761,53946825,HepG2|chr19:53867806-53867859,chr19,53867806,53867859,1,78955
HepG2|chr19:54078401-54078470,chr19,54078401,54078470,HepG2|chr19:53236735-53236816,chr19,53236735,53236816,1,841666
HepG2|chr19:56064033-56064163,chr19,56064033,56064163,HepG2|chr19:56058898-56058959,chr19,56058898,56058959,1,5135
HepG2|chr19:56064035-56064163,chr19,56064035,56064163,HepG2|chr19:56058665-56058687,chr19,56058665,56058687,1,5370
HepG2|chr19:56064035-56064146,chr19,56064035,56064146,HepG2|chr19:56058930-56058959,chr19,56058930,56058959,1,5105
HepG2|chr19:56064035-56064124,chr19,56064035,56064124,HepG2|chr19:56058898-56058959,chr19,56058898,56058959,1,5137
HepG2|chr19:56064035-56064096,chr19,56064035,56064096,HepG2|chr19:56058870-56058959,chr19,56058870,56058959,1,5165
HepG2|chr19:56064035-56064067,chr19,56064035,56064067,HepG2|chr19:56058934-56058959,chr19,56058934,56058959,1,5101
HepG2|chr19:56064035-56064058,chr19,56064035,56064058,HepG2|chr19:56058862-56058959,chr19,56058862,56058959,1,5173
HepG2|chr19:56064045-56064195,chr19,56064045,56064195,HepG2|chr19:56058870-56058959,chr19,56058870,56058959,1,5175
HepG2|chr19:56064058-56064208,chr19,56064058,56064208,HepG2|chr19:56058898-56058959,chr19,56058898,56058959,1,5160
HepG2|chr19:56064072-56064165,chr19,56064072,56064165,HepG2|chr19:56058898-56058959,chr19,56058898,56058959,1,5174
HepG2|chr19:56065029-56065055,chr19,56065029,56065055,HepG2|chr19:56058862-56058959,chr19,56058862,56058959,1,6167
HepG2|chr20:3960294-3960381,chr20,3960294,3960381,HepG2|chr20:3751714-3751777,chr20,3751714,3751777,1,208580
HepG2|chr20:3960294-3960376,chr20,3960294,3960376,HepG2|chr20:3751714-3751777,chr20,3751714,3751777,1,208580
HepG2|chr20:5183375-5183417,chr20,5183375,5183417,HepG2|chr20:25840076-25840202,chr20,25840076,25840202,1,20656701
HepG2|chr20:5183375-5183396,chr20,5183375,5183396,HepG2|chr20:25840076-25840204,chr20,25840076,25840204,1,20656701
HepG2|chr20:8106098-8106177,chr20,8106098,8106177,HepG2|chr20:8111366-8111489,chr20,8111366,8111489,1,5268
HepG2|chr20:8106157-8106177,chr20,8106157,8106177,HepG2|chr20:8111366-8111489,chr20,8111366,8111489,1,5209
HepG2|chr20:8106230-8106319,chr20,8106230,8106319,HepG2|chr20:8109223-8109288,chr20,8109223,8109288,1,2993
HepG2|chr20:8106230-8106315,chr20,8106230,8106315,HepG2|chr20:8109223-8109288,chr20,8109223,8109288,1,2993
HepG2|chr20:19989617-19989689,chr20,19989617,19989689,HepG2|chr20:19993228-19993365,chr20,19993228,19993365,1,3611
HepG2|chr20:19991729-19991794,chr20,19991729,19991794,HepG2|chr20:19993168-19993318,chr20,19993168,19993318,1,1439
HepG2|chr20:25651310-25651386,chr20,25651310,25651386,HepG2|chr20:25569481-25569538,chr20,25569481,25569538,1,81829
HepG2|chr20:25651313-25651400,chr20,25651313,25651400,HepG2|chr20:25569497-25569540,chr20,25569497,25569540,1,81816
HepG2|chr20:30936196-30936346,chr20,30936196,30936346,HepG2|chr20:30944720-30944782,chr20,30944720,30944782,1,8524
HepG2|chr20:30936403-30936491,chr20,30936403,30936491,HepG2|chr20:30944720-30944782,chr20,30944720,30944782,1,8317
HepG2|chr20:30936816-30936893,chr20,30936816,30936893,HepG2|chr20:30941160-30941250,chr20,30941160,30941250,1,4344
HepG2|chr20:30936833-30936893,chr20,30936833,30936893,HepG2|chr20:30941160-30941250,chr20,30941160,30941250,1,4327
HepG2|chr20:30938244-30938339,chr20,30938244,30938339,HepG2|chr20:30941104-30941254,chr20,30941104,30941254,1,2860
HepG2|chr20:30960796-30960847,chr20,30960796,30960847,HepG2|chr20:46616024-46616100,chr20,46616024,46616100,1,15655228
HepG2|chr20:30960827-30960882,chr20,30960827,30960882,HepG2|chr20:46616025-46616093,chr20,46616025,46616093,1,15655198
HepG2|chr20:32958469-32958591,chr20,32958469,32958591,HepG2|chr20:34333592-34333626,chr20,34333592,34333626,1,1375123
HepG2|chr20:32958514-32958664,chr20,32958514,32958664,HepG2|chr20:34333592-34333629,chr20,34333592,34333629,1,1375078
HepG2|chr20:33234589-33234629,chr20,33234589,33234629,HepG2|chr20:33265259-33265409,chr20,33265259,33265409,1,30670
HepG2|chr20:34191728-34191796,chr20,34191728,34191796,HepG2|chr20:34205644-34205707,chr20,34205644,34205707,1,13916
HepG2|chr20:35510026-35510175,chr20,35510026,35510175,HepG2|chr20:35500798-35500912,chr20,35500798,35500912,1,9228
HepG2|chr20:35510223-35510259,chr20,35510223,35510259,HepG2|chr20:35500798-35500912,chr20,35500798,35500912,1,9425
HepG2|chr20:35909676-35909700,chr20,35909676,35909700,HepG2|chr20:35917220-35917261,chr20,35917220,35917261,1,7544
HepG2|chr20:35911008-35911106,chr20,35911008,35911106,HepG2|chr20:35917220-35917261,chr20,35917220,35917261,1,6212
HepG2|chr20:35911047-35911106,chr20,35911047,35911106,HepG2|chr20:35917220-35917261,chr20,35917220,35917261,1,6173
HepG2|chr20:35934551-35934573,chr20,35934551,35934573,HepG2|chr20:36660989-36661102,chr20,36660989,36661102,1,726438
HepG2|chr20:35934551-35934572,chr20,35934551,35934572,HepG2|chr20:36660989-36661056,chr20,36660989,36661056,1,726438
HepG2|chr20:39670406-39670434,chr20,39670406,39670434,HepG2|chr20:17946974-17947124,chr20,17946974,17947124,1,21723432
HepG2|chr20:42948382-42948494,chr20,42948382,42948494,HepG2|chr20:42939954-42940104,chr20,42939954,42940104,1,8428
HepG2|chr20:42948382-42948462,chr20,42948382,42948462,HepG2|chr20:42940113-42940202,chr20,42940113,42940202,1,8269
HepG2|chr20:42948382-42948443,chr20,42948382,42948443,HepG2|chr20:42940113-42940202,chr20,42940113,42940202,1,8269
HepG2|chr20:44554752-44554775,chr20,44554752,44554775,HepG2|chr20:44558881-44559021,chr20,44558881,44559021,1,4129
HepG2|chr20:44556350-44556448,chr20,44556350,44556448,HepG2|chr20:44558549-44558634,chr20,44558549,44558634,1,2199
HepG2|chr20:44556888-44556951,chr20,44556888,44556951,HepG2|chr20:44558402-44558552,chr20,44558402,44558552,1,1514
HepG2|chr20:45409944-45410006,chr20,45409944,45410006,HepG2|chr20:45147126-45147174,chr20,45147126,45147174,1,262818
HepG2|chr20:45409944-45410005,chr20,45409944,45410005,HepG2|chr20:45147096-45147174,chr20,45147096,45147174,1,262848
HepG2|chr20:45854277-45854346,chr20,45854277,45854346,HepG2|chr20:43972926-43972991,chr20,43972926,43972991,1,1881351
HepG2|chr20:50424546-50424651,chr20,50424546,50424651,HepG2|chr20:50422980-50423083,chr20,50422980,50423083,1,1566
HepG2|chr20:50424607-50424652,chr20,50424607,50424652,HepG2|chr20:50422980-50423083,chr20,50422980,50423083,1,1627
HepG2|chr20:50424680-50424708,chr20,50424680,50424708,HepG2|chr20:50419485-50419584,chr20,50419485,50419584,1,5195
HepG2|chr20:50424741-50424824,chr20,50424741,50424824,HepG2|chr20:50422913-50423008,chr20,50422913,50423008,1,1828
HepG2|chr20:50424741-50424796,chr20,50424741,50424796,HepG2|chr20:50422913-50423008,chr20,50422913,50423008,1,1828
HepG2|chr20:50424910-50424961,chr20,50424910,50424961,HepG2|chr20:50423611-50423671,chr20,50423611,50423671,1,1299
HepG2|chr20:50425008-50425103,chr20,50425008,50425103,HepG2|chr20:50418466-50418530,chr20,50418466,50418530,1,6542
HepG2|chr20:50425008-50425091,chr20,50425008,50425091,HepG2|chr20:50418466-50418530,chr20,50418466,50418530,1,6542
HepG2|chr20:50425021-50425103,chr20,50425021,50425103,HepG2|chr20:50418466-50418530,chr20,50418466,50418530,1,6555
HepG2|chr20:50425184-50425273,chr20,50425184,50425273,HepG2|chr20:50423714-50423775,chr20,50423714,50423775,1,1470
HepG2|chr20:50425184-50425240,chr20,50425184,50425240,HepG2|chr20:50418562-50418641,chr20,50418562,50418641,1,6622
HepG2|chr20:50425245-50425395,chr20,50425245,50425395,HepG2|chr20:50423714-50423775,chr20,50423714,50423775,1,1531
HepG2|chr20:50426261-50426318,chr20,50426261,50426318,HepG2|chr20:50423582-50423673,chr20,50423582,50423673,1,2679
HepG2|chr20:50426369-50426428,chr20,50426369,50426428,HepG2|chr20:50423582-50423673,chr20,50423582,50423673,1,2787
HepG2|chr20:50426564-50426711,chr20,50426564,50426711,HepG2|chr20:50419818-50419940,chr20,50419818,50419940,1,6746
HepG2|chr20:50426718-50426832,chr20,50426718,50426832,HepG2|chr20:50421962-50422081,chr20,50421962,50422081,1,4756
HepG2|chr20:50426718-50426749,chr20,50426718,50426749,HepG2|chr20:50421962-50422081,chr20,50421962,50422081,1,4756
HepG2|chr20:50426950-50426971,chr20,50426950,50426971,HepG2|chr20:50423296-50423440,chr20,50423296,50423440,1,3654
HepG2|chr20:50427148-50427231,chr20,50427148,50427231,HepG2|chr20:50419564-50419678,chr20,50419564,50419678,1,7584
HepG2|chr20:50427199-50427232,chr20,50427199,50427232,HepG2|chr20:50419564-50419678,chr20,50419564,50419678,1,7635
HepG2|chr20:50427677-50427738,chr20,50427677,50427738,HepG2|chr20:50420271-50420421,chr20,50420271,50420421,1,7406
HepG2|chr20:50428971-50429030,chr20,50428971,50429030,HepG2|chr20:50423067-50423131,chr20,50423067,50423131,1,5904
HepG2|chr20:50429468-50429495,chr20,50429468,50429495,HepG2|chr20:50422471-50422559,chr20,50422471,50422559,1,6997
HepG2|chr20:50429733-50429782,chr20,50429733,50429782,HepG2|chr20:50423777-50423852,chr20,50423777,50423852,1,5956
HepG2|chr20:50429733-50429781,chr20,50429733,50429781,HepG2|chr20:50423777-50423852,chr20,50423777,50423852,1,5956
HepG2|chr20:50431932-50431969,chr20,50431932,50431969,HepG2|chr20:50422723-50422847,chr20,50422723,50422847,1,9209
HepG2|chr20:60594377-60594398,chr20,60594377,60594398,HepG2|chr20:60732176-60732258,chr20,60732176,60732258,1,137799
HepG2|chr20:60949900-60950030,chr20,60949900,60950030,HepG2|chr20:60958862-60958887,chr20,60958862,60958887,1,8962
HepG2|chr20:60949900-60950021,chr20,60949900,60950021,HepG2|chr20:60958862-60958887,chr20,60958862,60958887,1,8962
HepG2|chr20:60949920-60950004,chr20,60949920,60950004,HepG2|chr20:60960557-60960609,chr20,60960557,60960609,1,10637
HepG2|chr20:60951641-60951701,chr20,60951641,60951701,HepG2|chr20:60960498-60960591,chr20,60960498,60960591,1,8857
HepG2|chr20:60951641-60951695,chr20,60951641,60951695,HepG2|chr20:60960498-60960591,chr20,60960498,60960591,1,8857
HepG2|chr20:60952200-60952269,chr20,60952200,60952269,HepG2|chr20:60959758-60959839,chr20,60959758,60959839,1,7558
HepG2|chr20:60952294-60952444,chr20,60952294,60952444,HepG2|chr20:60959758-60959839,chr20,60959758,60959839,1,7464
HepG2|chr20:60952368-60952501,chr20,60952368,60952501,HepG2|chr20:60960877-60961014,chr20,60960877,60961014,1,8509
HepG2|chr20:61415165-61415181,chr20,61415165,61415181,HepG2|chr20:61424930-61425007,chr20,61424930,61425007,1,9765
HepG2|chr20:61418295-61418431,chr20,61418295,61418431,HepG2|chr20:61423257-61423407,chr20,61423257,61423407,1,4962
HepG2|chr20:61420514-61420570,chr20,61420514,61420570,HepG2|chr20:61424878-61424954,chr20,61424878,61424954,1,4364
HepG2|chr20:62750113-62750132,chr20,62750113,62750132,HepG2|chr20:62579991-62580029,chr20,62579991,62580029,1,170122
HepG2|chr21:18872973-18873083,chr21,18872973,18873083,HepG2|chr21:18884652-18884721,chr21,18884652,18884721,1,11679
HepG2|chr21:18873003-18873122,chr21,18873003,18873122,HepG2|chr21:18884652-18884720,chr21,18884652,18884720,1,11649
HepG2|chr21:18873024-18873122,chr21,18873024,18873122,HepG2|chr21:18884652-18884720,chr21,18884652,18884720,1,11628
HepG2|chr21:18873040-18873122,chr21,18873040,18873122,HepG2|chr21:18884652-18884720,chr21,18884652,18884720,1,11612
HepG2|chr21:18873043-18873122,chr21,18873043,18873122,HepG2|chr21:18884652-18884707,chr21,18884652,18884707,1,11609
HepG2|chr21:18873054-18873122,chr21,18873054,18873122,HepG2|chr21:18884652-18884721,chr21,18884652,18884721,1,11598
HepG2|chr21:18873056-18873122,chr21,18873056,18873122,HepG2|chr21:18884652-18884715,chr21,18884652,18884715,1,11596
HepG2|chr21:18873085-18873122,chr21,18873085,18873122,HepG2|chr21:18884652-18884737,chr21,18884652,18884737,1,11567
HepG2|chr21:18873239-18873325,chr21,18873239,18873325,HepG2|chr21:18884652-18884711,chr21,18884652,18884711,1,11413
HepG2|chr21:44553147-44553228,chr21,44553147,44553228,HepG2|chr21:44529557-44529626,chr21,44529557,44529626,1,23590
HepG2|chr21:44553147-44553197,chr21,44553147,44553197,HepG2|chr21:44529461-44529611,chr21,44529461,44529611,1,23686
HepG2|chr21:44553193-44553343,chr21,44553193,44553343,HepG2|chr21:44529557-44529626,chr21,44529557,44529626,1,23636
HepG2|chr21:44564456-44564487,chr21,44564456,44564487,HepG2|chr21:44529458-44529608,chr21,44529458,44529608,1,34998
HepG2|chr21:44907419-44907488,chr21,44907419,44907488,HepG2|chr21:44843752-44843825,chr21,44843752,44843825,1,63667
HepG2|chr21:44907419-44907468,chr21,44907419,44907468,HepG2|chr21:44843752-44843825,chr21,44843752,44843825,1,63667
HepG2|chr21:45005637-45005718,chr21,45005637,45005718,HepG2|chr21:44842928-44843066,chr21,44842928,44843066,1,162709
HepG2|chr21:45007353-45007460,chr21,45007353,45007460,HepG2|chr21:44846605-44846638,chr21,44846605,44846638,1,160748
HepG2|chr21:45093238-45093352,chr21,45093238,45093352,HepG2|chr21:44842514-44842541,chr21,44842514,44842541,1,250724
HepG2|chr21:45093240-45093352,chr21,45093240,45093352,HepG2|chr21:44842514-44842541,chr21,44842514,44842541,1,250726
HepG2|chr21:45118725-45118875,chr21,45118725,45118875,HepG2|chr21:45158817-45158927,chr21,45158817,45158927,1,40092
HepG2|chr21:45118726-45118876,chr21,45118726,45118876,HepG2|chr21:45158805-45158888,chr21,45158805,45158888,1,40079
HepG2|chr21:45118726-45118848,chr21,45118726,45118848,HepG2|chr21:45158831-45158968,chr21,45158831,45158968,1,40105
HepG2|chr21:45118727-45118877,chr21,45118727,45118877,HepG2|chr21:45158712-45158831,chr21,45158712,45158831,1,39985
HepG2|chr21:45118745-45118875,chr21,45118745,45118875,HepG2|chr21:45158831-45158974,chr21,45158831,45158974,1,40086
HepG2|chr21:45118747-45118875,chr21,45118747,45118875,HepG2|chr21:45158817-45158935,chr21,45158817,45158935,1,40070
HepG2|chr21:45118750-45118875,chr21,45118750,45118875,HepG2|chr21:45158781-45158931,chr21,45158781,45158931,1,40031
HepG2|chr21:45118752-45118875,chr21,45118752,45118875,HepG2|chr21:45158817-45158916,chr21,45158817,45158916,1,40065
HepG2|chr21:45118753-45118876,chr21,45118753,45118876,HepG2|chr21:45158786-45158825,chr21,45158786,45158825,1,40033
HepG2|chr21:45118753-45118875,chr21,45118753,45118875,HepG2|chr21:45158783-45158831,chr21,45158783,45158831,1,40030
HepG2|chr21:45118754-45118875,chr21,45118754,45118875,HepG2|chr21:45158783-45158831,chr21,45158783,45158831,1,40029
HepG2|chr21:45118754-45118801,chr21,45118754,45118801,HepG2|chr21:45158831-45158972,chr21,45158831,45158972,1,40077
HepG2|chr21:45118756-45118873,chr21,45118756,45118873,HepG2|chr21:45158831-45158974,chr21,45158831,45158974,1,40075
HepG2|chr21:45118758-45118846,chr21,45118758,45118846,HepG2|chr21:45159495-45159557,chr21,45159495,45159557,1,40737
HepG2|chr21:45119028-45119175,chr21,45119028,45119175,HepG2|chr21:45159015-45159066,chr21,45159015,45159066,1,39987
HepG2|chr21:45119239-45119337,chr21,45119239,45119337,HepG2|chr21:45159015-45159066,chr21,45159015,45159066,1,39776
HepG2|chr21:45129948-45129994,chr21,45129948,45129994,HepG2|chr21:45136944-45136983,chr21,45136944,45136983,1,6996
HepG2|chr21:45130743-45130858,chr21,45130743,45130858,HepG2|chr21:45134992-45135058,chr21,45134992,45135058,1,4249
HepG2|chr21:45130773-45130856,chr21,45130773,45130856,HepG2|chr21:45134992-45135058,chr21,45134992,45135058,1,4219
HepG2|chr21:45130809-45130919,chr21,45130809,45130919,HepG2|chr21:45136944-45136983,chr21,45136944,45136983,1,6135
HepG2|chr21:45130822-45130919,chr21,45130822,45130919,HepG2|chr21:45136941-45137084,chr21,45136941,45137084,1,6119
HepG2|chr21:45132202-45132273,chr21,45132202,45132273,HepG2|chr21:45135095-45135159,chr21,45135095,45135159,1,2893
HepG2|chr21:47867903-47867955,chr21,47867903,47867955,HepG2|chr21:47875324-47875421,chr21,47875324,47875421,1,7421
HepG2|chr21:47868402-47868512,chr21,47868402,47868512,HepG2|chr21:47878264-47878345,chr21,47878264,47878345,1,9862
HepG2|chr21:47868414-47868512,chr21,47868414,47868512,HepG2|chr21:47878239-47878272,chr21,47878239,47878272,1,9825
HepG2|chr21:47868614-47868714,chr21,47868614,47868714,HepG2|chr21:47875243-47875274,chr21,47875243,47875274,1,6629
HepG2|chr22:20423781-20423931,chr22,20423781,20423931,HepG2|chr22:21775824-21775974,chr22,21775824,21775974,1,1352043
HepG2|chr22:20423782-20423931,chr22,20423782,20423931,HepG2|chr22:21775824-21775974,chr22,21775824,21775974,1,1352042
HepG2|chr22:23857150-23857281,chr22,23857150,23857281,HepG2|chr22:24098515-24098593,chr22,24098515,24098593,1,241365
HepG2|chr22:23857213-23857285,chr22,23857213,23857285,HepG2|chr22:24098515-24098593,chr22,24098515,24098593,1,241302
HepG2|chr22:23857214-23857286,chr22,23857214,23857286,HepG2|chr22:24098515-24098593,chr22,24098515,24098593,1,241301
HepG2|chr22:24013961-24014110,chr22,24013961,24014110,HepG2|chr22:25002547-25002697,chr22,25002547,25002697,1,988586
HepG2|chr22:24013965-24014112,chr22,24013965,24014112,HepG2|chr22:25002581-25002731,chr22,25002581,25002731,1,988616
HepG2|chr22:24013972-24014122,chr22,24013972,24014122,HepG2|chr22:25002509-25002659,chr22,25002509,25002659,1,988537
HepG2|chr22:24014079-24014201,chr22,24014079,24014201,HepG2|chr22:25002745-25002895,chr22,25002745,25002895,1,988666
HepG2|chr22:24014095-24014242,chr22,24014095,24014242,HepG2|chr22:25002746-25002896,chr22,25002746,25002896,1,988651
HepG2|chr22:24014097-24014247,chr22,24014097,24014247,HepG2|chr22:25002768-25002918,chr22,25002768,25002918,1,988671
HepG2|chr22:24014151-24014297,chr22,24014151,24014297,HepG2|chr22:25002741-25002891,chr22,25002741,25002891,1,988590
HepG2|chr22:24016494-24016535,chr22,24016494,24016535,HepG2|chr22:24998801-24998910,chr22,24998801,24998910,1,982307
HepG2|chr22:24016665-24016813,chr22,24016665,24016813,HepG2|chr22:24998822-24998972,chr22,24998822,24998972,1,982157
HepG2|chr22:24016677-24016827,chr22,24016677,24016827,HepG2|chr22:24998820-24998967,chr22,24998820,24998967,1,982143
HepG2|chr22:24016679-24016825,chr22,24016679,24016825,HepG2|chr22:24998785-24998932,chr22,24998785,24998932,1,982106
HepG2|chr22:24016696-24016843,chr22,24016696,24016843,HepG2|chr22:24998795-24998942,chr22,24998795,24998942,1,982099
HepG2|chr22:24016718-24016868,chr22,24016718,24016868,HepG2|chr22:24998795-24998939,chr22,24998795,24998939,1,982077
HepG2|chr22:24016721-24016871,chr22,24016721,24016871,HepG2|chr22:24998746-24998896,chr22,24998746,24998896,1,982025
HepG2|chr22:24016723-24016815,chr22,24016723,24016815,HepG2|chr22:24998719-24998869,chr22,24998719,24998869,1,981996
HepG2|chr22:24016727-24016877,chr22,24016727,24016877,HepG2|chr22:24998765-24998915,chr22,24998765,24998915,1,982038
HepG2|chr22:24016729-24016879,chr22,24016729,24016879,HepG2|chr22:24998823-24998973,chr22,24998823,24998973,1,982094
HepG2|chr22:24016746-24016896,chr22,24016746,24016896,HepG2|chr22:24998819-24998969,chr22,24998819,24998969,1,982073
HepG2|chr22:24016747-24016894,chr22,24016747,24016894,HepG2|chr22:24998781-24998920,chr22,24998781,24998920,1,982034
HepG2|chr22:24016750-24016897,chr22,24016750,24016897,HepG2|chr22:24998772-24998922,chr22,24998772,24998922,1,982022
HepG2|chr22:24016751-24016897,chr22,24016751,24016897,HepG2|chr22:24998774-24998920,chr22,24998774,24998920,1,982023
HepG2|chr22:24016752-24016902,chr22,24016752,24016902,HepG2|chr22:24998822-24998972,chr22,24998822,24998972,1,982070
HepG2|chr22:24016754-24016904,chr22,24016754,24016904,HepG2|chr22:24998785-24998932,chr22,24998785,24998932,1,982031
HepG2|chr22:24016758-24016908,chr22,24016758,24016908,HepG2|chr22:24998756-24998906,chr22,24998756,24998906,1,981998
HepG2|chr22:24016771-24016921,chr22,24016771,24016921,HepG2|chr22:24998798-24998948,chr22,24998798,24998948,1,982027
HepG2|chr22:24016981-24017131,chr22,24016981,24017131,HepG2|chr22:24998749-24998899,chr22,24998749,24998899,1,981768
HepG2|chr22:24017071-24017221,chr22,24017071,24017221,HepG2|chr22:24998760-24998910,chr22,24998760,24998910,1,981689
HepG2|chr22:24655231-24655381,chr22,24655231,24655381,HepG2|chr22:21474736-21474881,chr22,21474736,21474881,1,3180495
HepG2|chr22:24655235-24655385,chr22,24655235,24655385,HepG2|chr22:21474734-21474884,chr22,21474734,21474884,1,3180501
HepG2|chr22:25385032-25385161,chr22,25385032,25385161,HepG2|chr22:39092810-39092960,chr22,39092810,39092960,1,13707778
HepG2|chr22:30650930-30651044,chr22,30650930,30651044,HepG2|chr22:30643813-30643848,chr22,30643813,30643848,1,7117
HepG2|chr22:30653057-30653099,chr22,30653057,30653099,HepG2|chr22:30644472-30644622,chr22,30644472,30644622,1,8585
HepG2|chr22:36797666-36797731,chr22,36797666,36797731,HepG2|chr22:36879531-36879681,chr22,36879531,36879681,1,81865
HepG2|chr22:38630939-38631089,chr22,38630939,38631089,HepG2|chr22:38144566-38144583,chr22,38144566,38144583,1,486373
HepG2|chr22:38630983-38631104,chr22,38630983,38631104,HepG2|chr22:38144566-38144583,chr22,38144566,38144583,1,486417
HepG2|chr22:40447202-40447312,chr22,40447202,40447312,HepG2|chr22:38205134-38205191,chr22,38205134,38205191,1,2242068
HepG2|chr22:40447220-40447313,chr22,40447220,40447313,HepG2|chr22:38205134-38205191,chr22,38205134,38205191,1,2242086
HepG2|chr22:40447221-40447313,chr22,40447221,40447313,HepG2|chr22:38205134-38205191,chr22,38205134,38205191,1,2242087
HepG2|chr22:41875054-41875122,chr22,41875054,41875122,HepG2|chr22:41983965-41984047,chr22,41983965,41984047,1,108911
HepG2|chr22:41875055-41875127,chr22,41875055,41875127,HepG2|chr22:41983964-41984042,chr22,41983964,41984042,1,108909
HepG2|chr22:41881329-41881465,chr22,41881329,41881465,HepG2|chr22:41984068-41984139,chr22,41984068,41984139,1,102739
HepG2|chr22:41881379-41881456,chr22,41881379,41881456,HepG2|chr22:41984068-41984139,chr22,41984068,41984139,1,102689
HepG2|chr22:41947761-41947892,chr22,41947761,41947892,HepG2|chr22:41956723-41956742,chr22,41956723,41956742,1,8962
HepG2|chr22:41947799-41947892,chr22,41947799,41947892,HepG2|chr22:41956723-41956746,chr22,41956723,41956746,1,8924
HepG2|chr22:41947817-41947892,chr22,41947817,41947892,HepG2|chr22:41956723-41956783,chr22,41956723,41956783,1,8906
HepG2|chr22:41947820-41947892,chr22,41947820,41947892,HepG2|chr22:41956723-41956801,chr22,41956723,41956801,1,8903
HepG2|chr22:41947855-41947892,chr22,41947855,41947892,HepG2|chr22:41953302-41953416,chr22,41953302,41953416,1,5447
HepG2|chr22:41947859-41947892,chr22,41947859,41947892,HepG2|chr22:41953302-41953416,chr22,41953302,41953416,1,5443
HepG2|chr22:42236211-42236299,chr22,42236211,42236299,HepG2|chr22:42081561-42081604,chr22,42081561,42081604,1,154650
HepG2|chr22:42250330-42250382,chr22,42250330,42250382,HepG2|chr22:42088521-42088580,chr22,42088521,42088580,1,161809
HepG2|chr22:42540043-42540172,chr22,42540043,42540172,HepG2|chr22:42526898-42526982,chr22,42526898,42526982,1,13145
HepG2|chr22:42540131-42540195,chr22,42540131,42540195,HepG2|chr22:42526924-42527008,chr22,42526924,42527008,1,13207
HepG2|chr22:42540131-42540194,chr22,42540131,42540194,HepG2|chr22:42526924-42527008,chr22,42526924,42527008,1,13207
HepG2|chr22:42540448-42540518,chr22,42540448,42540518,HepG2|chr22:42526940-42527015,chr22,42526940,42527015,1,13508
HepG2|chr22:42540839-42540949,chr22,42540839,42540949,HepG2|chr22:42528347-42528399,chr22,42528347,42528399,1,12492
HepG2|chr22:42540839-42540934,chr22,42540839,42540934,HepG2|chr22:42528347-42528399,chr22,42528347,42528399,1,12492
HepG2|chr22:42541078-42541205,chr22,42541078,42541205,HepG2|chr22:42528199-42528222,chr22,42528199,42528222,1,12879
HepG2|chr22:42541108-42541218,chr22,42541108,42541218,HepG2|chr22:42527691-42527824,chr22,42527691,42527824,1,13417
HepG2|chr22:42976962-42977093,chr22,42976962,42977093,HepG2|chr22:42915384-42915469,chr22,42915384,42915469,1,61578
HepG2|chr22:42977121-42977267,chr22,42977121,42977267,HepG2|chr22:42914806-42914956,chr22,42914806,42914956,1,62315
HepG2|chr22:42977121-42977237,chr22,42977121,42977237,HepG2|chr22:42914836-42914986,chr22,42914836,42914986,1,62285
HepG2|chr22:42977121-42977222,chr22,42977121,42977222,HepG2|chr22:42914694-42914841,chr22,42914694,42914841,1,62427
HepG2|chr22:42977121-42977216,chr22,42977121,42977216,HepG2|chr22:42914754-42914904,chr22,42914754,42914904,1,62367
HepG2|chr22:42977174-42977323,chr22,42977174,42977323,HepG2|chr22:42914801-42914949,chr22,42914801,42914949,1,62373
HepG2|chr22:42977178-42977220,chr22,42977178,42977220,HepG2|chr22:42915443-42915591,chr22,42915443,42915591,1,61735
HepG2|chr22:42977547-42977629,chr22,42977547,42977629,HepG2|chr22:42915410-42915478,chr22,42915410,42915478,1,62137
HepG2|chr22:42977569-42977629,chr22,42977569,42977629,HepG2|chr22:42915419-42915509,chr22,42915419,42915509,1,62150
HepG2|chr22:42977604-42977700,chr22,42977604,42977700,HepG2|chr22:42915415-42915469,chr22,42915415,42915469,1,62189
HepG2|chr22:42977652-42977778,chr22,42977652,42977778,HepG2|chr22:42915436-42915562,chr22,42915436,42915562,1,62216
HepG2|chr22:46403726-46403824,chr22,46403726,46403824,HepG2|chr22:46440735-46440786,chr22,46440735,46440786,1,37009
HepG2|chr22:46403726-46403822,chr22,46403726,46403822,HepG2|chr22:46440734-46440786,chr22,46440734,46440786,1,37008
HepG2|chr22:46873411-46873523,chr22,46873411,46873523,HepG2|chr22:46664558-46664595,chr22,46664558,46664595,1,208853
HepG2|chr22:46873411-46873519,chr22,46873411,46873519,HepG2|chr22:46664559-46664593,chr22,46664559,46664593,1,208852
HepG2|chr22:50239716-50239749,chr22,50239716,50239749,HepG2|chr22:50244729-50244812,chr22,50244729,50244812,1,5013
HepG2|chr22:50239917-50240045,chr22,50239917,50240045,HepG2|chr22:50246083-50246137,chr22,50246083,50246137,1,6166
HepG2|chr22:50239980-50240045,chr22,50239980,50240045,HepG2|chr22:50244729-50244812,chr22,50244729,50244812,1,4749
HepG2|chr22:50240011-50240045,chr22,50240011,50240045,HepG2|chr22:50244729-50244812,chr22,50244729,50244812,1,4718
HepG2|chr1:3929-4078,chr1,3929,4078,HepG2|chr1:148556914-148557064,chr1,148556914,148557064,0,148552985
HepG2|chr1:87963-88063,chr1,87963,88063,HepG2|chr1:25561671-25561785,chr1,25561671,25561785,0,25473708
HepG2|chr1:988179-988229,chr1,988179,988229,HepG2|chr1:247497791-247497830,chr1,247497791,247497830,0,246509612
HepG2|chr1:1326004-1326154,chr1,1326004,1326154,HepG2|chr1:16862401-16862551,chr1,16862401,16862551,0,15536397
HepG2|chr1:1366294-1366380,chr1,1366294,1366380,HepG2|chr1:120190693-120190752,chr1,120190693,120190752,0,118824399
HepG2|chr1:1574073-1574158,chr1,1574073,1574158,HepG2|chr1:148556249-148556366,chr1,148556249,148556366,0,146982176
HepG2|chr1:1946628-1946714,chr1,1946628,1946714,HepG2|chr1:33170116-33170180,chr1,33170116,33170180,0,31223488
HepG2|chr1:2132872-2132918,chr1,2132872,2132918,HepG2|chr1:153964687-153964721,chr1,153964687,153964721,0,151831815
HepG2|chr1:2143389-2143509,chr1,2143389,2143509,HepG2|chr1:173445770-173445907,chr1,173445770,173445907,0,171302381
HepG2|chr1:2470196-2470343,chr1,2470196,2470343,HepG2|chr1:148556474-148556623,chr1,148556474,148556623,0,146086278
HepG2|chr1:2777223-2777259,chr1,2777223,2777259,HepG2|chr1:6507200-6507255,chr1,6507200,6507255,0,3729977
HepG2|chr1:2979101-2979251,chr1,2979101,2979251,HepG2|chr1:148556889-148557039,chr1,148556889,148557039,0,145577788
HepG2|chr1:3077327-3077365,chr1,3077327,3077365,HepG2|chr1:148556143-148556180,chr1,148556143,148556180,0,145478816
HepG2|chr1:3332640-3332710,chr1,3332640,3332710,HepG2|chr1:178991081-178991188,chr1,178991081,178991188,0,175658441
HepG2|chr1:4186016-4186166,chr1,4186016,4186166,HepG2|chr1:149685007-149685157,chr1,149685007,149685157,0,145498991
HepG2|chr1:4190370-4190497,chr1,4190370,4190497,HepG2|chr1:148556134-148556180,chr1,148556134,148556180,0,144365764
HepG2|chr1:4196806-4196885,chr1,4196806,4196885,HepG2|chr1:47875353-47875478,chr1,47875353,47875478,0,43678547
HepG2|chr1:4215500-4215526,chr1,4215500,4215526,HepG2|chr1:148556648-148556798,chr1,148556648,148556798,0,144341148
HepG2|chr1:4344059-4344209,chr1,4344059,4344209,HepG2|chr1:247497284-247497302,chr1,247497284,247497302,0,243153225
HepG2|chr1:4395227-4395376,chr1,4395227,4395376,HepG2|chr1:148558160-148558305,chr1,148558160,148558305,0,144162933
HepG2|chr1:4578583-4578629,chr1,4578583,4578629,HepG2|chr1:148556135-148556180,chr1,148556135,148556180,0,143977552
HepG2|chr1:4617816-4617872,chr1,4617816,4617872,HepG2|chr1:153964689-153964721,chr1,153964689,153964721,0,149346873
HepG2|chr1:4706926-4707072,chr1,4706926,4707072,HepG2|chr1:148557625-148557689,chr1,148557625,148557689,0,143850699
HepG2|chr1:4844986-4845118,chr1,4844986,4845118,HepG2|chr1:247497284-247497302,chr1,247497284,247497302,0,242652298
HepG2|chr1:5089536-5089676,chr1,5089536,5089676,HepG2|chr1:148555903-148556027,chr1,148555903,148556027,0,143466367
HepG2|chr1:5099322-5099445,chr1,5099322,5099445,HepG2|chr1:208429975-208429992,chr1,208429975,208429992,0,203330653
HepG2|chr1:5209532-5209586,chr1,5209532,5209586,HepG2|chr1:148556876-148556965,chr1,148556876,148556965,0,143347344
HepG2|chr1:5521068-5521094,chr1,5521068,5521094,HepG2|chr1:153964630-153964721,chr1,153964630,153964721,0,148443562
HepG2|chr1:5658105-5658220,chr1,5658105,5658220,HepG2|chr1:63154356-63154395,chr1,63154356,63154395,0,57496251
HepG2|chr1:5768963-5769044,chr1,5768963,5769044,HepG2|chr1:247496594-247496689,chr1,247496594,247496689,0,241727631
HepG2|chr1:6128326-6128476,chr1,6128326,6128476,HepG2|chr1:148556476-148556626,chr1,148556476,148556626,0,142428150
HepG2|chr1:6143060-6143210,chr1,6143060,6143210,HepG2|chr1:148556579-148556728,chr1,148556579,148556728,0,142413519
HepG2|chr1:6287152-6287301,chr1,6287152,6287301,HepG2|chr1:148556651-148556800,chr1,148556651,148556800,0,142269499
HepG2|chr1:6381340-6381490,chr1,6381340,6381490,HepG2|chr1:40237903-40238050,chr1,40237903,40238050,0,33856563
HepG2|chr1:6803701-6803850,chr1,6803701,6803850,HepG2|chr1:148558204-148558354,chr1,148558204,148558354,0,141754503
HepG2|chr1:6891664-6891788,chr1,6891664,6891788,HepG2|chr1:247497893-247497913,chr1,247497893,247497913,0,240606229
HepG2|chr1:6922131-6922183,chr1,6922131,6922183,HepG2|chr1:148558160-148558297,chr1,148558160,148558297,0,141636029
HepG2|chr1:7020992-7021020,chr1,7020992,7021020,HepG2|chr1:153964645-153964721,chr1,153964645,153964721,0,146943653
HepG2|chr1:7079837-7079982,chr1,7079837,7079982,HepG2|chr1:148556504-148556654,chr1,148556504,148556654,0,141476667
HepG2|chr1:7238513-7238533,chr1,7238513,7238533,HepG2|chr1:235321999-235322035,chr1,235321999,235322035,0,228083486
HepG2|chr1:7384022-7384172,chr1,7384022,7384172,HepG2|chr1:148558185-148558332,chr1,148558185,148558332,0,141174163
HepG2|chr1:8050956-8051099,chr1,8050956,8051099,HepG2|chr1:148556286-148556366,chr1,148556286,148556366,0,140505330
HepG2|chr1:8057029-8057146,chr1,8057029,8057146,HepG2|chr1:148556214-148556357,chr1,148556214,148556357,0,140499185
HepG2|chr1:8079756-8079785,chr1,8079756,8079785,HepG2|chr1:173445776-173445815,chr1,173445776,173445815,0,165366020
HepG2|chr1:8133369-8133512,chr1,8133369,8133512,HepG2|chr1:148556286-148556366,chr1,148556286,148556366,0,140422917
HepG2|chr1:8374184-8374329,chr1,8374184,8374329,HepG2|chr1:148557625-148557655,chr1,148557625,148557655,0,140183441
HepG2|chr1:8661880-8661994,chr1,8661880,8661994,HepG2|chr1:245024858-245024898,chr1,245024858,245024898,0,236362978
HepG2|chr1:8739478-8739526,chr1,8739478,8739526,HepG2|chr1:153964694-153964721,chr1,153964694,153964721,0,145225216
HepG2|chr1:8844273-8844367,chr1,8844273,8844367,HepG2|chr1:148556155-148556180,chr1,148556155,148556180,0,139711882
HepG2|chr1:9381231-9381293,chr1,9381231,9381293,HepG2|chr1:33170050-33170200,chr1,33170050,33170200,0,23788819
HepG2|chr1:9397151-9397301,chr1,9397151,9397301,HepG2|chr1:31383170-31383204,chr1,31383170,31383204,0,21986019
HepG2|chr1:9754104-9754170,chr1,9754104,9754170,HepG2|chr1:120190693-120190774,chr1,120190693,120190774,0,110436589
HepG2|chr1:9761156-9761303,chr1,9761156,9761303,HepG2|chr1:148557628-148557683,chr1,148557628,148557683,0,138796472
HepG2|chr1:9824845-9824865,chr1,9824845,9824865,HepG2|chr1:153964658-153964721,chr1,153964658,153964721,0,144139813
HepG2|chr1:9913301-9913320,chr1,9913301,9913320,HepG2|chr1:247498107-247498257,chr1,247498107,247498257,0,237584806
HepG2|chr1:10285968-10286113,chr1,10285968,10286113,HepG2|chr1:148556133-148556180,chr1,148556133,148556180,0,138270165
HepG2|chr1:10429980-10430076,chr1,10429980,10430076,HepG2|chr1:148556122-148556180,chr1,148556122,148556180,0,138126142
HepG2|chr1:10479710-10479860,chr1,10479710,10479860,HepG2|chr1:148556567-148556717,chr1,148556567,148556717,0,138076857
HepG2|chr1:10529579-10529726,chr1,10529579,10529726,HepG2|chr1:145611429-145611579,chr1,145611429,145611579,0,135081850
HepG2|chr1:10987719-10987868,chr1,10987719,10987868,HepG2|chr1:40237084-40237234,chr1,40237084,40237234,0,29249365
HepG2|chr1:11066729-11066794,chr1,11066729,11066794,HepG2|chr1:160258611-160258757,chr1,160258611,160258757,0,149191882
HepG2|chr1:11125950-11126100,chr1,11125950,11126100,HepG2|chr1:148558193-148558343,chr1,148558193,148558343,0,137432243
HepG2|chr1:11162659-11162809,chr1,11162659,11162809,HepG2|chr1:16862400-16862549,chr1,16862400,16862549,0,5699741
HepG2|chr1:11378217-11378343,chr1,11378217,11378343,HepG2|chr1:148556202-148556349,chr1,148556202,148556349,0,137177985
HepG2|chr1:11434633-11434671,chr1,11434633,11434671,HepG2|chr1:245025641-245025697,chr1,245025641,245025697,0,233591008
HepG2|chr1:11881332-11881482,chr1,11881332,11881482,HepG2|chr1:6508384-6508421,chr1,6508384,6508421,0,5372948
HepG2|chr1:12156671-12156769,chr1,12156671,12156769,HepG2|chr1:173836015-173836066,chr1,173836015,173836066,0,161679344
HepG2|chr1:12202781-12202828,chr1,12202781,12202828,HepG2|chr1:148557504-148557624,chr1,148557504,148557624,0,136354723
HepG2|chr1:12570649-12570741,chr1,12570649,12570741,HepG2|chr1:33170116-33170180,chr1,33170116,33170180,0,20599467
HepG2|chr1:12614023-12614074,chr1,12614023,12614074,HepG2|chr1:120190693-120190815,chr1,120190693,120190815,0,107576670
HepG2|chr1:12910097-12910166,chr1,12910097,12910166,HepG2|chr1:148556133-148556180,chr1,148556133,148556180,0,135646036
HepG2|chr1:12927314-12927396,chr1,12927314,12927396,HepG2|chr1:148556143-148556180,chr1,148556143,148556180,0,135628829
HepG2|chr1:13413231-13413344,chr1,13413231,13413344,HepG2|chr1:148556154-148556180,chr1,148556154,148556180,0,135142923
HepG2|chr1:14442366-14442469,chr1,14442366,14442469,HepG2|chr1:148556134-148556180,chr1,148556134,148556180,0,134113768
HepG2|chr1:14613491-14613614,chr1,14613491,14613614,HepG2|chr1:148557625-148557712,chr1,148557625,148557712,0,133944134
HepG2|chr1:15092392-15092542,chr1,15092392,15092542,HepG2|chr1:148556562-148556709,chr1,148556562,148556709,0,133464170
HepG2|chr1:15114081-15114231,chr1,15114081,15114231,HepG2|chr1:148556140-148556180,chr1,148556140,148556180,0,133442059
HepG2|chr1:15213206-15213326,chr1,15213206,15213326,HepG2|chr1:148556267-148556416,chr1,148556267,148556416,0,133343061
HepG2|chr1:15372097-15372209,chr1,15372097,15372209,HepG2|chr1:148557625-148557669,chr1,148557625,148557669,0,133185528
HepG2|chr1:15429612-15429686,chr1,15429612,15429686,HepG2|chr1:247498152-247498228,chr1,247498152,247498228,0,232068540
HepG2|chr1:15536999-15537023,chr1,15536999,15537023,HepG2|chr1:148556690-148556810,chr1,148556690,148556810,0,133019691
HepG2|chr1:15828769-15828814,chr1,15828769,15828814,HepG2|chr1:155176366-155176484,chr1,155176366,155176484,0,139347597
HepG2|chr1:16024668-16024818,chr1,16024668,16024818,HepG2|chr1:40237903-40238050,chr1,40237903,40238050,0,24213235
HepG2|chr1:16097050-16097164,chr1,16097050,16097164,HepG2|chr1:148556180-148556318,chr1,148556180,148556318,0,132459130
HepG2|chr1:16177060-16177180,chr1,16177060,16177180,HepG2|chr1:148557600-148557661,chr1,148557600,148557661,0,132380540
HepG2|chr1:16272614-16272683,chr1,16272614,16272683,HepG2|chr1:26561669-26561748,chr1,26561669,26561748,0,10289055
HepG2|chr1:16475846-16475953,chr1,16475846,16475953,HepG2|chr1:63154356-63154395,chr1,63154356,63154395,0,46678510
HepG2|chr1:16823447-16823597,chr1,16823447,16823597,HepG2|chr1:148556132-148556180,chr1,148556132,148556180,0,131732685
HepG2|chr1:16989869-16989936,chr1,16989869,16989936,HepG2|chr1:228608345-228608397,chr1,228608345,228608397,0,211618476
HepG2|chr1:17315778-17315867,chr1,17315778,17315867,HepG2|chr1:247499340-247499401,chr1,247499340,247499401,0,230183562
HepG2|chr1:17615632-17615724,chr1,17615632,17615724,HepG2|chr1:78149986-78150012,chr1,78149986,78150012,0,60534354
HepG2|chr1:17823372-17823470,chr1,17823372,17823470,HepG2|chr1:173836015-173836066,chr1,173836015,173836066,0,156012643
HepG2|chr1:17895321-17895355,chr1,17895321,17895355,HepG2|chr1:148556601-148556751,chr1,148556601,148556751,0,130661280
HepG2|chr1:18262769-18262802,chr1,18262769,18262802,HepG2|chr1:148557504-148557621,chr1,148557504,148557621,0,130294735
HepG2|chr1:18559837-18559987,chr1,18559837,18559987,HepG2|chr1:54410614-54410657,chr1,54410614,54410657,0,35850777
HepG2|chr1:18723800-18723841,chr1,18723800,18723841,HepG2|chr1:201924301-201924417,chr1,201924301,201924417,0,183200501
HepG2|chr1:18958622-18958772,chr1,18958622,18958772,HepG2|chr1:167690855-167690892,chr1,167690855,167690892,0,148732233
HepG2|chr1:19072478-19072542,chr1,19072478,19072542,HepG2|chr1:148556132-148556180,chr1,148556132,148556180,0,129483654
HepG2|chr1:19426855-19426971,chr1,19426855,19426971,HepG2|chr1:54406651-54406801,chr1,54406651,54406801,0,34979796
HepG2|chr1:19473522-19473562,chr1,19473522,19473562,HepG2|chr1:36686019-36686091,chr1,36686019,36686091,0,17212497
HepG2|chr1:19602378-19602419,chr1,19602378,19602419,HepG2|chr1:201924301-201924417,chr1,201924301,201924417,0,182321923
HepG2|chr1:19820778-19820928,chr1,19820778,19820928,HepG2|chr1:149685009-149685156,chr1,149685009,149685156,0,129864231
HepG2|chr1:19968666-19968813,chr1,19968666,19968813,HepG2|chr1:16862336-16862486,chr1,16862336,16862486,0,3106330
HepG2|chr1:20408436-20408586,chr1,20408436,20408586,HepG2|chr1:148558185-148558332,chr1,148558185,148558332,0,128149749
HepG2|chr1:20776521-20776652,chr1,20776521,20776652,HepG2|chr1:148556133-148556180,chr1,148556133,148556180,0,127779612
HepG2|chr1:20796005-20796041,chr1,20796005,20796041,HepG2|chr1:153964660-153964721,chr1,153964660,153964721,0,133168655
HepG2|chr1:21081078-21081228,chr1,21081078,21081228,HepG2|chr1:31383174-31383204,chr1,31383174,31383204,0,10302096
HepG2|chr1:21083602-21083649,chr1,21083602,21083649,HepG2|chr1:156022645-156022745,chr1,156022645,156022745,0,134939043
HepG2|chr1:21305751-21305785,chr1,21305751,21305785,HepG2|chr1:148556180-148556325,chr1,148556180,148556325,0,127250429
HepG2|chr1:21472514-21472628,chr1,21472514,21472628,HepG2|chr1:245024858-245024898,chr1,245024858,245024898,0,223552344
HepG2|chr1:21783506-21783613,chr1,21783506,21783613,HepG2|chr1:54410614-54410657,chr1,54410614,54410657,0,32627108
HepG2|chr1:22035065-22035188,chr1,22035065,22035188,HepG2|chr1:148557625-148557712,chr1,148557625,148557712,0,126522560
HepG2|chr1:22232150-22232179,chr1,22232150,22232179,HepG2|chr1:153964694-153964721,chr1,153964694,153964721,0,131732544
HepG2|chr1:22266061-22266211,chr1,22266061,22266211,HepG2|chr1:148556502-148556644,chr1,148556502,148556644,0,126290441
HepG2|chr1:22317987-22318024,chr1,22317987,22318024,HepG2|chr1:225961476-225961626,chr1,225961476,225961626,0,203643489
HepG2|chr1:22467318-22467393,chr1,22467318,22467393,HepG2|chr1:148556691-148556783,chr1,148556691,148556783,0,126089373
HepG2|chr1:22571562-22571655,chr1,22571562,22571655,HepG2|chr1:100805718-100805865,chr1,100805718,100805865,0,78234156
HepG2|chr1:22578662-22578748,chr1,22578662,22578748,HepG2|chr1:120190693-120190752,chr1,120190693,120190752,0,97612031
HepG2|chr1:22774642-22774792,chr1,22774642,22774792,HepG2|chr1:149685005-149685155,chr1,149685005,149685155,0,126910363
HepG2|chr1:22804318-22804390,chr1,22804318,22804390,HepG2|chr1:148556203-148556353,chr1,148556203,148556353,0,125751885
HepG2|chr1:23132246-23132396,chr1,23132246,23132396,HepG2|chr1:148558267-148558318,chr1,148558267,148558318,0,125426021
HepG2|chr1:23477270-23477417,chr1,23477270,23477417,HepG2|chr1:148556579-148556729,chr1,148556579,148556729,0,125079309
HepG2|chr1:23569232-23569295,chr1,23569232,23569295,HepG2|chr1:148558084-148558229,chr1,148558084,148558229,0,124988852
HepG2|chr1:23589157-23589237,chr1,23589157,23589237,HepG2|chr1:247496606-247496632,chr1,247496606,247496632,0,223907449
HepG2|chr1:23896364-23896507,chr1,23896364,23896507,HepG2|chr1:148556603-148556751,chr1,148556603,148556751,0,124660239
HepG2|chr1:23969354-23969504,chr1,23969354,23969504,HepG2|chr1:148556655-148556763,chr1,148556655,148556763,0,124587301
HepG2|chr1:24149106-24149202,chr1,24149106,24149202,HepG2|chr1:226251053-226251104,chr1,226251053,226251104,0,202101947
HepG2|chr1:24194932-24195021,chr1,24194932,24195021,HepG2|chr1:148556276-148556426,chr1,148556276,148556426,0,124361344
HepG2|chr1:24199772-24199899,chr1,24199772,24199899,HepG2|chr1:235323075-235323119,chr1,235323075,235323119,0,211123303
HepG2|chr1:25728473-25728585,chr1,25728473,25728585,HepG2|chr1:148558068-148558218,chr1,148558068,148558218,0,122829595
HepG2|chr1:25750961-25750998,chr1,25750961,25750998,HepG2|chr1:36686019-36686091,chr1,36686019,36686091,0,10935058
HepG2|chr1:25780262-25780305,chr1,25780262,25780305,HepG2|chr1:150460059-150460131,chr1,150460059,150460131,0,124679797
HepG2|chr1:25820723-25820801,chr1,25820723,25820801,HepG2|chr1:148557628-148557689,chr1,148557628,148557689,0,122736905
HepG2|chr1:25991124-25991267,chr1,25991124,25991267,HepG2|chr1:148556603-148556751,chr1,148556603,148556751,0,122565479
HepG2|chr1:26012677-26012806,chr1,26012677,26012806,HepG2|chr1:148557607-148557658,chr1,148557607,148557658,0,122544930
HepG2|chr1:26418166-26418192,chr1,26418166,26418192,HepG2|chr1:153964630-153964721,chr1,153964630,153964721,0,127546464
HepG2|chr1:26454193-26454343,chr1,26454193,26454343,HepG2|chr1:148558235-148558384,chr1,148558235,148558384,0,122104042
HepG2|chr1:26485785-26485932,chr1,26485785,26485932,HepG2|chr1:148557628-148557658,chr1,148557628,148557658,0,122071843
HepG2|chr1:26647100-26647250,chr1,26647100,26647250,HepG2|chr1:120190693-120190764,chr1,120190693,120190764,0,93543593
HepG2|chr1:26912464-26912481,chr1,26912464,26912481,HepG2|chr1:148556364-148556420,chr1,148556364,148556420,0,121643900
HepG2|chr1:26977119-26977244,chr1,26977119,26977244,HepG2|chr1:148558080-148558230,chr1,148558080,148558230,0,121580961
HepG2|chr1:27070834-27070919,chr1,27070834,27070919,HepG2|chr1:174966720-174966831,chr1,174966720,174966831,0,147895886
HepG2|chr1:27213843-27213956,chr1,27213843,27213956,HepG2|chr1:33171400-33171466,chr1,33171400,33171466,0,5957557
HepG2|chr1:27373828-27373978,chr1,27373828,27373978,HepG2|chr1:149684997-149685143,chr1,149684997,149685143,0,122311169
HepG2|chr1:27395871-27395893,chr1,27395871,27395893,HepG2|chr1:148556690-148556797,chr1,148556690,148556797,0,121160819
HepG2|chr1:27451795-27451945,chr1,27451795,27451945,HepG2|chr1:40237007-40237154,chr1,40237007,40237154,0,12785212
HepG2|chr1:27698101-27698186,chr1,27698101,27698186,HepG2|chr1:167690828-167690893,chr1,167690828,167690893,0,139992727
HepG2|chr1:27852365-27852411,chr1,27852365,27852411,HepG2|chr1:148556135-148556180,chr1,148556135,148556180,0,120703770
HepG2|chr1:27900273-27900374,chr1,27900273,27900374,HepG2|chr1:148556135-148556269,chr1,148556135,148556269,0,120655862
HepG2|chr1:28193035-28193116,chr1,28193035,28193116,HepG2|chr1:148556202-148556349,chr1,148556202,148556349,0,120363167
HepG2|chr1:28343373-28343442,chr1,28343373,28343442,HepG2|chr1:26561669-26561748,chr1,26561669,26561748,0,1781704
HepG2|chr1:28402931-28403050,chr1,28402931,28403050,HepG2|chr1:148558119-148558262,chr1,148558119,148558262,0,120155188
HepG2|chr1:28524940-28525063,chr1,28524940,28525063,HepG2|chr1:224179579-224179667,chr1,224179579,224179667,0,195654639
HepG2|chr1:28850916-28851020,chr1,28850916,28851020,HepG2|chr1:148557501-148557628,chr1,148557501,148557628,0,119706585
HepG2|chr1:28880624-28880644,chr1,28880624,28880644,HepG2|chr1:173446958-173446985,chr1,173446958,173446985,0,144566334
HepG2|chr1:28982683-28982752,chr1,28982683,28982752,HepG2|chr1:148556208-148556354,chr1,148556208,148556354,0,119573525
HepG2|chr1:29131742-29131878,chr1,29131742,29131878,HepG2|chr1:247498777-247498875,chr1,247498777,247498875,0,218367035
HepG2|chr1:29141812-29141962,chr1,29141812,29141962,HepG2|chr1:148558160-148558286,chr1,148558160,148558286,0,119416348
HepG2|chr1:29161190-29161340,chr1,29161190,29161340,HepG2|chr1:149685009-149685156,chr1,149685009,149685156,0,120523819
HepG2|chr1:29277745-29277861,chr1,29277745,29277861,HepG2|chr1:148556183-148556333,chr1,148556183,148556333,0,119278438
HepG2|chr1:29378897-29378918,chr1,29378897,29378918,HepG2|chr1:148556210-148556360,chr1,148556210,148556360,0,119177313
HepG2|chr1:29537835-29537985,chr1,29537835,29537985,HepG2|chr1:148556895-148557045,chr1,148556895,148557045,0,119019060
HepG2|chr1:29604807-29604905,chr1,29604807,29604905,HepG2|chr1:148556180-148556314,chr1,148556180,148556314,0,118951373
HepG2|chr1:29870967-29871064,chr1,29870967,29871064,HepG2|chr1:148556691-148556777,chr1,148556691,148556777,0,118685724
HepG2|chr1:30057877-30058022,chr1,30057877,30058022,HepG2|chr1:148556216-148556353,chr1,148556216,148556353,0,118498339
HepG2|chr1:30123700-30123831,chr1,30123700,30123831,HepG2|chr1:148558114-148558253,chr1,148558114,148558253,0,118434414
HepG2|chr1:30192895-30192997,chr1,30192895,30192997,HepG2|chr1:22777902-22778052,chr1,22777902,22778052,0,7414993
HepG2|chr1:30206102-30206252,chr1,30206102,30206252,HepG2|chr1:148556623-148556773,chr1,148556623,148556773,0,118350521
HepG2|chr1:30880696-30880788,chr1,30880696,30880788,HepG2|chr1:78149986-78150012,chr1,78149986,78150012,0,47269290
HepG2|chr1:30932339-30932427,chr1,30932339,30932427,HepG2|chr1:109851507-109851569,chr1,109851507,109851569,0,78919168
HepG2|chr1:31004988-31005118,chr1,31004988,31005118,HepG2|chr1:33171355-33171466,chr1,33171355,33171466,0,2166367
HepG2|chr1:31081379-31081525,chr1,31081379,31081525,HepG2|chr1:148558235-148558384,chr1,148558235,148558384,0,117476856
HepG2|chr1:31120746-31120896,chr1,31120746,31120896,HepG2|chr1:16862926-16863076,chr1,16862926,16863076,0,14257820
HepG2|chr1:31564495-31564642,chr1,31564495,31564642,HepG2|chr1:148558086-148558232,chr1,148558086,148558232,0,116993591
HepG2|chr1:31624982-31625130,chr1,31624982,31625130,HepG2|chr1:224179593-224179669,chr1,224179593,224179669,0,192554611
HepG2|chr1:31656115-31656262,chr1,31656115,31656262,HepG2|chr1:148558086-148558232,chr1,148558086,148558232,0,116901971
HepG2|chr1:31783895-31784018,chr1,31783895,31784018,HepG2|chr1:247497893-247497913,chr1,247497893,247497913,0,215713998
HepG2|chr1:32061224-32061374,chr1,32061224,32061374,HepG2|chr1:148558160-148558286,chr1,148558160,148558286,0,116496936
HepG2|chr1:32144897-32144932,chr1,32144897,32144932,HepG2|chr1:174966720-174966831,chr1,174966720,174966831,0,142821823
HepG2|chr1:32263965-32264112,chr1,32263965,32264112,HepG2|chr1:148556464-148556614,chr1,148556464,148556614,0,116292499
HepG2|chr1:32292811-32292876,chr1,32292811,32292876,HepG2|chr1:160258611-160258757,chr1,160258611,160258757,0,127965800
HepG2|chr1:32676694-32676839,chr1,32676694,32676839,HepG2|chr1:148557625-148557655,chr1,148557625,148557655,0,115880931
HepG2|chr1:32908760-32908849,chr1,32908760,32908849,HepG2|chr1:12677891-12677952,chr1,12677891,12677952,0,20230869
HepG2|chr1:33078650-33078699,chr1,33078650,33078699,HepG2|chr1:205652586-205652703,chr1,205652586,205652703,0,172573936
HepG2|chr1:33251993-33252071,chr1,33251993,33252071,HepG2|chr1:148556132-148556180,chr1,148556132,148556180,0,115304139
HepG2|chr1:33314162-33314243,chr1,33314162,33314243,HepG2|chr1:148556212-148556358,chr1,148556212,148556358,0,115242050
HepG2|chr1:33593441-33593511,chr1,33593441,33593511,HepG2|chr1:148556204-148556354,chr1,148556204,148556354,0,114962763
HepG2|chr1:33603637-33603773,chr1,33603637,33603773,HepG2|chr1:148556180-148556330,chr1,148556180,148556330,0,114952543
HepG2|chr1:33670412-33670449,chr1,33670412,33670449,HepG2|chr1:33170057-33170180,chr1,33170057,33170180,0,500355
HepG2|chr1:33947301-33947352,chr1,33947301,33947352,HepG2|chr1:153964676-153964721,chr1,153964676,153964721,0,120017375
HepG2|chr1:34240727-34240873,chr1,34240727,34240873,HepG2|chr1:148556476-148556626,chr1,148556476,148556626,0,114315749
HepG2|chr1:34329014-34329141,chr1,34329014,34329141,HepG2|chr1:148556232-148556373,chr1,148556232,148556373,0,114227218
HepG2|chr1:34520365-34520412,chr1,34520365,34520412,HepG2|chr1:156022645-156022745,chr1,156022645,156022745,0,121502280
HepG2|chr1:34587306-34587423,chr1,34587306,34587423,HepG2|chr1:228608345-228608396,chr1,228608345,228608396,0,194021039
HepG2|chr1:34704185-34704267,chr1,34704185,34704267,HepG2|chr1:247497829-247497876,chr1,247497829,247497876,0,212793644
HepG2|chr1:34742314-34742461,chr1,34742314,34742461,HepG2|chr1:247499555-247499581,chr1,247499555,247499581,0,212757241
HepG2|chr1:34864008-34864063,chr1,34864008,34864063,HepG2|chr1:225963524-225963631,chr1,225963524,225963631,0,191099516
HepG2|chr1:35064856-35064936,chr1,35064856,35064936,HepG2|chr1:247496606-247496632,chr1,247496606,247496632,0,212431750
HepG2|chr1:35397278-35397326,chr1,35397278,35397326,HepG2|chr1:228603863-228603984,chr1,228603863,228603984,0,193206585
HepG2|chr1:35788104-35788251,chr1,35788104,35788251,HepG2|chr1:148556628-148556778,chr1,148556628,148556778,0,112768524
HepG2|chr1:35994269-35994419,chr1,35994269,35994419,HepG2|chr1:28992994-28993050,chr1,28992994,28993050,0,7001275
HepG2|chr1:36253372-36253522,chr1,36253372,36253522,HepG2|chr1:148558235-148558384,chr1,148558235,148558384,0,112304863
HepG2|chr1:36309568-36309667,chr1,36309568,36309667,HepG2|chr1:148556136-148556180,chr1,148556136,148556180,0,112246568
HepG2|chr1:36390333-36390352,chr1,36390333,36390352,HepG2|chr1:247499342-247499492,chr1,247499342,247499492,0,211109009
HepG2|chr1:36762062-36762169,chr1,36762062,36762169,HepG2|chr1:148556876-148556962,chr1,148556876,148556962,0,111794814
HepG2|chr1:36779085-36779235,chr1,36779085,36779235,HepG2|chr1:148556908-148556999,chr1,148556908,148556999,0,111777823
HepG2|chr1:36806321-36806358,chr1,36806321,36806358,HepG2|chr1:245025596-245025697,chr1,245025596,245025697,0,208219275
HepG2|chr1:36915013-36915163,chr1,36915013,36915163,HepG2|chr1:148556503-148556650,chr1,148556503,148556650,0,111641490
HepG2|chr1:36959506-36959574,chr1,36959506,36959574,HepG2|chr1:205599369-205599436,chr1,205599369,205599436,0,168639863
HepG2|chr1:37559217-37559296,chr1,37559217,37559296,HepG2|chr1:148556691-148556738,chr1,148556691,148556738,0,110997474
HepG2|chr1:38050850-38051000,chr1,38050850,38051000,HepG2|chr1:148558185-148558332,chr1,148558185,148558332,0,110507335
HepG2|chr1:38201101-38201238,chr1,38201101,38201238,HepG2|chr1:70669737-70669760,chr1,70669737,70669760,0,32468636
HepG2|chr1:38216372-38216522,chr1,38216372,38216522,HepG2|chr1:148556571-148556721,chr1,148556571,148556721,0,110340199
HepG2|chr1:38393444-38393503,chr1,38393444,38393503,HepG2|chr1:148557508-148557623,chr1,148557508,148557623,0,110164064
HepG2|chr1:38882801-38882822,chr1,38882801,38882822,HepG2|chr1:148556210-148556360,chr1,148556210,148556360,0,109673409
HepG2|chr1:39059945-39060009,chr1,39059945,39060009,HepG2|chr1:220441237-220441314,chr1,220441237,220441314,0,181381292
HepG2|chr1:39270179-39270223,chr1,39270179,39270223,HepG2|chr1:153964695-153964721,chr1,153964695,153964721,0,114694516
HepG2|chr1:39435725-39435875,chr1,39435725,39435875,HepG2|chr1:12677891-12677952,chr1,12677891,12677952,0,26757834
HepG2|chr1:39451854-39452000,chr1,39451854,39452000,HepG2|chr1:148557625-148557689,chr1,148557625,148557689,0,109105771
HepG2|chr1:39523689-39523771,chr1,39523689,39523771,HepG2|chr1:173836015-173836065,chr1,173836015,173836065,0,134312326
HepG2|chr1:39662067-39662214,chr1,39662067,39662214,HepG2|chr1:40237931-40238081,chr1,40237931,40238081,0,575864
HepG2|chr1:40166682-40166764,chr1,40166682,40166764,HepG2|chr1:225964643-225964711,chr1,225964643,225964711,0,185797961
HepG2|chr1:40203648-40203735,chr1,40203648,40203735,HepG2|chr1:225964812-225964857,chr1,225964812,225964857,0,185761164
HepG2|chr1:40487139-40487289,chr1,40487139,40487289,HepG2|chr1:148556885-148557035,chr1,148556885,148557035,0,108069746
HepG2|chr1:40527879-40528028,chr1,40527879,40528028,HepG2|chr1:148556917-148557067,chr1,148556917,148557067,0,108029038
HepG2|chr1:40656236-40656386,chr1,40656236,40656386,HepG2|chr1:148558202-148558352,chr1,148558202,148558352,0,107901966
HepG2|chr1:41015721-41015867,chr1,41015721,41015867,HepG2|chr1:148556561-148556711,chr1,148556561,148556711,0,107540840
HepG2|chr1:41121056-41121154,chr1,41121056,41121154,HepG2|chr1:148556134-148556180,chr1,148556134,148556180,0,107435078
HepG2|chr1:41189124-41189148,chr1,41189124,41189148,HepG2|chr1:148556138-148556180,chr1,148556138,148556180,0,107367014
HepG2|chr1:41286696-41286845,chr1,41286696,41286845,HepG2|chr1:148557628-148557704,chr1,148557628,148557704,0,107270932
HepG2|chr1:41306645-41306698,chr1,41306645,41306698,HepG2|chr1:153964686-153964721,chr1,153964686,153964721,0,112658041
HepG2|chr1:41498907-41499010,chr1,41498907,41499010,HepG2|chr1:235323075-235323119,chr1,235323075,235323119,0,193824168
HepG2|chr1:41528486-41528542,chr1,41528486,41528542,HepG2|chr1:153964689-153964721,chr1,153964689,153964721,0,112436203
HepG2|chr1:41602118-41602223,chr1,41602118,41602223,HepG2|chr1:26631979-26632024,chr1,26631979,26632024,0,14970139
HepG2|chr1:41701273-41701378,chr1,41701273,41701378,HepG2|chr1:26631979-26632024,chr1,26631979,26632024,0,15069294
HepG2|chr1:41733547-41733585,chr1,41733547,41733585,HepG2|chr1:173446955-173447104,chr1,173446955,173447104,0,131713408
HepG2|chr1:41741527-41741656,chr1,41741527,41741656,HepG2|chr1:204042325-204042449,chr1,204042325,204042449,0,162300798
HepG2|chr1:41945980-41946115,chr1,41945980,41946115,HepG2|chr1:148556217-148556367,chr1,148556217,148556367,0,106610237
HepG2|chr1:41964433-41964525,chr1,41964433,41964525,HepG2|chr1:100805718-100805865,chr1,100805718,100805865,0,58841285
HepG2|chr1:41991530-41991679,chr1,41991530,41991679,HepG2|chr1:148556134-148556180,chr1,148556134,148556180,0,106564604
HepG2|chr1:42317040-42317189,chr1,42317040,42317189,HepG2|chr1:148556562-148556709,chr1,148556562,148556709,0,106239522
HepG2|chr1:42585358-42585452,chr1,42585358,42585452,HepG2|chr1:63156650-63156800,chr1,63156650,63156800,0,20571292
HepG2|chr1:42689340-42689395,chr1,42689340,42689395,HepG2|chr1:247496594-247496689,chr1,247496594,247496689,0,204807254
HepG2|chr1:42752790-42752940,chr1,42752790,42752940,HepG2|chr1:154537266-154537328,chr1,154537266,154537328,0,111784476
HepG2|chr1:42929160-42929307,chr1,42929160,42929307,HepG2|chr1:148556600-148556750,chr1,148556600,148556750,0,105627440
HepG2|chr1:42968985-42969121,chr1,42968985,42969121,HepG2|chr1:148558141-148558219,chr1,148558141,148558219,0,105589156
HepG2|chr1:43169963-43170113,chr1,43169963,43170113,HepG2|chr1:148558200-148558318,chr1,148558200,148558318,0,105388237
HepG2|chr1:43605718-43605830,chr1,43605718,43605830,HepG2|chr1:245025570-245025608,chr1,245025570,245025608,0,201419852
HepG2|chr1:43606394-43606476,chr1,43606394,43606476,HepG2|chr1:148556143-148556180,chr1,148556143,148556180,0,104949749
HepG2|chr1:43951652-43951717,chr1,43951652,43951717,HepG2|chr1:120190693-120190823,chr1,120190693,120190823,0,76239041
HepG2|chr1:44128665-44128702,chr1,44128665,44128702,HepG2|chr1:205600116-205600263,chr1,205600116,205600263,0,161471451
HepG2|chr1:44649559-44649709,chr1,44649559,44649709,HepG2|chr1:148558160-148558286,chr1,148558160,148558286,0,103908601
HepG2|chr1:44771567-44771585,chr1,44771567,44771585,HepG2|chr1:148556204-148556354,chr1,148556204,148556354,0,103784637
HepG2|chr1:44829843-44829993,chr1,44829843,44829993,HepG2|chr1:148556869-148557004,chr1,148556869,148557004,0,103727026
HepG2|chr1:45101358-45101507,chr1,45101358,45101507,HepG2|chr1:148557628-148557707,chr1,148557628,148557707,0,103456270
HepG2|chr1:45295849-45295999,chr1,45295849,45295999,HepG2|chr1:148556510-148556660,chr1,148556510,148556660,0,103260661
HepG2|chr1:45629448-45629590,chr1,45629448,45629590,HepG2|chr1:148556915-148557065,chr1,148556915,148557065,0,102927467
HepG2|chr1:46463217-46463367,chr1,46463217,46463367,HepG2|chr1:148558193-148558343,chr1,148558193,148558343,0,102094976
HepG2|chr1:46767066-46767115,chr1,46767066,46767115,HepG2|chr1:148558160-148558306,chr1,148558160,148558306,0,101791094
HepG2|chr1:46845036-46845085,chr1,46845036,46845085,HepG2|chr1:205652586-205652703,chr1,205652586,205652703,0,158807550
HepG2|chr1:46948876-46948975,chr1,46948876,46948975,HepG2|chr1:178990498-178990546,chr1,178990498,178990546,0,132041622
HepG2|chr1:47026604-47026754,chr1,47026604,47026754,HepG2|chr1:148556577-148556725,chr1,148556577,148556725,0,101529973
HepG2|chr1:47230564-47230708,chr1,47230564,47230708,HepG2|chr1:148556230-148556380,chr1,148556230,148556380,0,101325666
HepG2|chr1:47235407-47235557,chr1,47235407,47235557,HepG2|chr1:247497612-247497694,chr1,247497612,247497694,0,200262205
HepG2|chr1:47365723-47365862,chr1,47365723,47365862,HepG2|chr1:148556180-148556314,chr1,148556180,148556314,0,101190457
HepG2|chr1:47399632-47399750,chr1,47399632,47399750,HepG2|chr1:67520773-67520846,chr1,67520773,67520846,0,20121141
HepG2|chr1:47443750-47443800,chr1,47443750,47443800,HepG2|chr1:3447363-3447490,chr1,3447363,3447490,0,43996387
HepG2|chr1:48094259-48094305,chr1,48094259,48094305,HepG2|chr1:153964687-153964721,chr1,153964687,153964721,0,105870428
HepG2|chr1:48150940-48151044,chr1,48150940,48151044,HepG2|chr1:28992994-28993050,chr1,28992994,28993050,0,19157946
HepG2|chr1:48561107-48561198,chr1,48561107,48561198,HepG2|chr1:245001128-245001159,chr1,245001128,245001159,0,196440021
HepG2|chr1:48789685-48789738,chr1,48789685,48789738,HepG2|chr1:94345865-94345974,chr1,94345865,94345974,0,45556180
HepG2|chr1:48885833-48885981,chr1,48885833,48885981,HepG2|chr1:148556230-148556380,chr1,148556230,148556380,0,99670397
HepG2|chr1:49045933-49045969,chr1,49045933,49045969,HepG2|chr1:25561671-25561785,chr1,25561671,25561785,0,23484262
HepG2|chr1:49425952-49426062,chr1,49425952,49426062,HepG2|chr1:245001128-245001159,chr1,245001128,245001159,0,195575176
HepG2|chr1:49426662-49426812,chr1,49426662,49426812,HepG2|chr1:148556466-148556616,chr1,148556466,148556616,0,99129804
HepG2|chr1:50163816-50163966,chr1,50163816,50163966,HepG2|chr1:16862336-16862479,chr1,16862336,16862479,0,33301480
HepG2|chr1:50293803-50293842,chr1,50293803,50293842,HepG2|chr1:153964692-153964721,chr1,153964692,153964721,0,103670889
HepG2|chr1:50373464-50373613,chr1,50373464,50373613,HepG2|chr1:40237084-40237234,chr1,40237084,40237234,0,10136380
HepG2|chr1:50786876-50787026,chr1,50786876,50787026,HepG2|chr1:16862401-16862551,chr1,16862401,16862551,0,33924475
HepG2|chr1:50842467-50842617,chr1,50842467,50842617,HepG2|chr1:148556478-148556628,chr1,148556478,148556628,0,97714011
HepG2|chr1:50937934-50938084,chr1,50937934,50938084,HepG2|chr1:247498919-247498955,chr1,247498919,247498955,0,196560985
HepG2|chr1:51152783-51152932,chr1,51152783,51152932,HepG2|chr1:148556135-148556180,chr1,148556135,148556180,0,97403352
HepG2|chr1:51174121-51174232,chr1,51174121,51174232,HepG2|chr1:148556133-148556180,chr1,148556133,148556180,0,97382012
HepG2|chr1:51311756-51311868,chr1,51311756,51311868,HepG2|chr1:148557628-148557689,chr1,148557628,148557689,0,97245872
HepG2|chr1:51350776-51350850,chr1,51350776,51350850,HepG2|chr1:148556132-148556180,chr1,148556132,148556180,0,97205356
HepG2|chr1:51471859-51471885,chr1,51471859,51471885,HepG2|chr1:148556648-148556798,chr1,148556648,148556798,0,97084789
HepG2|chr1:51901133-51901283,chr1,51901133,51901283,HepG2|chr1:148556569-148556718,chr1,148556569,148556718,0,96655436
HepG2|chr1:51923669-51923819,chr1,51923669,51923819,HepG2|chr1:148556345-148556391,chr1,148556345,148556391,0,96632676
HepG2|chr1:52081293-52081409,chr1,52081293,52081409,HepG2|chr1:94345883-94345915,chr1,94345883,94345915,0,42264590
HepG2|chr1:52222793-52222863,chr1,52222793,52222863,HepG2|chr1:178991081-178991188,chr1,178991081,178991188,0,126768288
HepG2|chr1:52462759-52462886,chr1,52462759,52462886,HepG2|chr1:247499533-247499552,chr1,247499533,247499552,0,195036774
HepG2|chr1:52507138-52507288,chr1,52507138,52507288,HepG2|chr1:167690855-167690892,chr1,167690855,167690892,0,115183717
HepG2|chr1:52757735-52757753,chr1,52757735,52757753,HepG2|chr1:108229196-108229315,chr1,108229196,108229315,0,55471461
HepG2|chr1:52921722-52921742,chr1,52921722,52921742,HepG2|chr1:33170071-33170180,chr1,33170071,33170180,0,19751651
HepG2|chr1:53048417-53048505,chr1,53048417,53048505,HepG2|chr1:247497977-247498127,chr1,247497977,247498127,0,194449560
HepG2|chr1:53450995-53451068,chr1,53450995,53451068,HepG2|chr1:148556465-148556515,chr1,148556465,148556515,0,95105470
HepG2|chr1:53647201-53647351,chr1,53647201,53647351,HepG2|chr1:148556895-148557045,chr1,148556895,148557045,0,94909694
HepG2|chr1:53797835-53797982,chr1,53797835,53797982,HepG2|chr1:149685052-149685202,chr1,149685052,149685202,0,95887217
HepG2|chr1:53917865-53918014,chr1,53917865,53918014,HepG2|chr1:148556930-148557080,chr1,148556930,148557080,0,94639065
HepG2|chr1:54117575-54117652,chr1,54117575,54117652,HepG2|chr1:148556132-148556180,chr1,148556132,148556180,0,94438557
HepG2|chr1:54308458-54308608,chr1,54308458,54308608,HepG2|chr1:148556562-148556709,chr1,148556562,148556709,0,94248104
HepG2|chr1:54319165-54319315,chr1,54319165,54319315,HepG2|chr1:148558202-148558352,chr1,148558202,148558352,0,94239037
HepG2|chr1:54462884-54462912,chr1,54462884,54462912,HepG2|chr1:228298913-228299056,chr1,228298913,228299056,0,173836029
HepG2|chr1:54625636-54625786,chr1,54625636,54625786,HepG2|chr1:148556655-148556763,chr1,148556655,148556763,0,93931019
HepG2|chr1:54645805-54645890,chr1,54645805,54645890,HepG2|chr1:228656169-228656231,chr1,228656169,228656231,0,174010364
HepG2|chr1:55050513-55050663,chr1,55050513,55050663,HepG2|chr1:148556869-148557014,chr1,148556869,148557014,0,93506356
HepG2|chr1:55274568-55274696,chr1,55274568,55274696,HepG2|chr1:148556130-148556180,chr1,148556130,148556180,0,93281562
HepG2|chr1:55345417-55345489,chr1,55345417,55345489,HepG2|chr1:46154048-46154134,chr1,46154048,46154134,0,9191369
HepG2|chr1:55582996-55583025,chr1,55582996,55583025,HepG2|chr1:148556876-148556958,chr1,148556876,148556958,0,92973880
HepG2|chr1:55701554-55701629,chr1,55701554,55701629,HepG2|chr1:205601761-205601832,chr1,205601761,205601832,0,149900207
HepG2|chr1:55844863-55844972,chr1,55844863,55844972,HepG2|chr1:173444013-173444054,chr1,173444013,173444054,0,117599150
HepG2|chr1:56224288-56224438,chr1,56224288,56224438,HepG2|chr1:22775780-22775919,chr1,22775780,22775919,0,33448508
HepG2|chr1:56251907-56252057,chr1,56251907,56252057,HepG2|chr1:148556141-148556180,chr1,148556141,148556180,0,92304234
HepG2|chr1:56349219-56349266,chr1,56349219,56349266,HepG2|chr1:148557504-148557624,chr1,148557504,148557624,0,92208285
HepG2|chr1:56403340-56403412,chr1,56403340,56403412,HepG2|chr1:156113494-156113571,chr1,156113494,156113571,0,99710154
HepG2|chr1:56433896-56433995,chr1,56433896,56433995,HepG2|chr1:148556136-148556180,chr1,148556136,148556180,0,92122240
HepG2|chr1:56513675-56513815,chr1,56513675,56513815,HepG2|chr1:245025570-245025608,chr1,245025570,245025608,0,188511895
HepG2|chr1:57425942-57425960,chr1,57425942,57425960,HepG2|chr1:148556910-148557060,chr1,148556910,148557060,0,91130968
HepG2|chr1:57710275-57710402,chr1,57710275,57710402,HepG2|chr1:148556232-148556373,chr1,148556232,148556373,0,90845957
HepG2|chr1:57739377-57739413,chr1,57739377,57739413,HepG2|chr1:1444584-1444699,chr1,1444584,1444699,0,56294793
HepG2|chr1:57923086-57923106,chr1,57923086,57923106,HepG2|chr1:173446958-173446985,chr1,173446958,173446985,0,115523872
HepG2|chr1:58278625-58278774,chr1,58278625,58278774,HepG2|chr1:148556296-148556443,chr1,148556296,148556443,0,90277671
HepG2|chr1:58424720-58424795,chr1,58424720,58424795,HepG2|chr1:220443804-220443954,chr1,220443804,220443954,0,162019084
HepG2|chr1:58510202-58510351,chr1,58510202,58510351,HepG2|chr1:148556561-148556711,chr1,148556561,148556711,0,90046359
HepG2|chr1:58601759-58601909,chr1,58601759,58601909,HepG2|chr1:148556889-148557039,chr1,148556889,148557039,0,89955130
HepG2|chr1:58654984-58655083,chr1,58654984,58655083,HepG2|chr1:31539734-31539777,chr1,31539734,31539777,0,27115250
HepG2|chr1:58934007-58934157,chr1,58934007,58934157,HepG2|chr1:148556634-148556776,chr1,148556634,148556776,0,89622627
HepG2|chr1:58934605-58934736,chr1,58934605,58934736,HepG2|chr1:40236986-40237117,chr1,40236986,40237117,0,18697619
HepG2|chr1:59345562-59345613,chr1,59345562,59345613,HepG2|chr1:153964676-153964721,chr1,153964676,153964721,0,94619114
HepG2|chr1:59369619-59369763,chr1,59369619,59369763,HepG2|chr1:145611408-145611558,chr1,145611408,145611558,0,86241789
HepG2|chr1:59439483-59439623,chr1,59439483,59439623,HepG2|chr1:33171343-33171466,chr1,33171343,33171466,0,26268140
HepG2|chr1:59779974-59780016,chr1,59779974,59780016,HepG2|chr1:247497791-247497830,chr1,247497791,247497830,0,187717817
HepG2|chr1:59792150-59792274,chr1,59792150,59792274,HepG2|chr1:148556345-148556369,chr1,148556345,148556369,0,88764195
HepG2|chr1:59852778-59852928,chr1,59852778,59852928,HepG2|chr1:148556908-148556999,chr1,148556908,148556999,0,88704130
HepG2|chr1:59948921-59948962,chr1,59948921,59948962,HepG2|chr1:245019122-245019148,chr1,245019122,245019148,0,185070201
HepG2|chr1:60018584-60018617,chr1,60018584,60018617,HepG2|chr1:153964641-153964721,chr1,153964641,153964721,0,93946057
HepG2|chr1:60058754-60058826,chr1,60058754,60058826,HepG2|chr1:228297829-228297930,chr1,228297829,228297930,0,168239075
HepG2|chr1:60184027-60184157,chr1,60184027,60184157,HepG2|chr1:33171355-33171466,chr1,33171355,33171466,0,27012672
HepG2|chr1:60426001-60426036,chr1,60426001,60426036,HepG2|chr1:148557536-148557625,chr1,148557536,148557625,0,88131535
HepG2|chr1:60525656-60525796,chr1,60525656,60525796,HepG2|chr1:148556571-148556721,chr1,148556571,148556721,0,88030915
HepG2|chr1:60541037-60541056,chr1,60541037,60541056,HepG2|chr1:247499342-247499492,chr1,247499342,247499492,0,186958305
HepG2|chr1:61016963-61017110,chr1,61016963,61017110,HepG2|chr1:145611429-145611579,chr1,145611429,145611579,0,84594466
HepG2|chr1:61216127-61216223,chr1,61216127,61216223,HepG2|chr1:148556581-148556731,chr1,148556581,148556731,0,87340454
HepG2|chr1:61402223-61402368,chr1,61402223,61402368,HepG2|chr1:148558160-148558286,chr1,148558160,148558286,0,87155937
HepG2|chr1:61538218-61538367,chr1,61538218,61538367,HepG2|chr1:148556917-148557067,chr1,148556917,148557067,0,87018699
HepG2|chr1:61800248-61800398,chr1,61800248,61800398,HepG2|chr1:148558160-148558294,chr1,148558160,148558294,0,86757912
HepG2|chr1:61992109-61992180,chr1,61992109,61992180,HepG2|chr1:148556132-148556180,chr1,148556132,148556180,0,86564023
HepG2|chr1:62214529-62214672,chr1,62214529,62214672,HepG2|chr1:148557625-148557655,chr1,148557625,148557655,0,86343096
HepG2|chr1:62234676-62234752,chr1,62234676,62234752,HepG2|chr1:148556153-148556180,chr1,148556153,148556180,0,86321477
HepG2|chr1:62346399-62346506,chr1,62346399,62346506,HepG2|chr1:148556132-148556180,chr1,148556132,148556180,0,86209733
HepG2|chr1:62350232-62350280,chr1,62350232,62350280,HepG2|chr1:153964694-153964721,chr1,153964694,153964721,0,91614462
HepG2|chr1:62376868-62377007,chr1,62376868,62377007,HepG2|chr1:148556180-148556314,chr1,148556180,148556314,0,86179312
HepG2|chr1:62429395-62429540,chr1,62429395,62429540,HepG2|chr1:148556503-148556650,chr1,148556503,148556650,0,86127108
HepG2|chr1:63059219-63059305,chr1,63059219,63059305,HepG2|chr1:33170116-33170180,chr1,33170116,33170180,0,29889103
HepG2|chr1:63170857-63170902,chr1,63170857,63170902,HepG2|chr1:155176366-155176484,chr1,155176366,155176484,0,92005509
HepG2|chr1:63657223-63657360,chr1,63657223,63657360,HepG2|chr1:70669737-70669760,chr1,70669737,70669760,0,7012514
HepG2|chr1:63781310-63781397,chr1,63781310,63781397,HepG2|chr1:225964812-225964857,chr1,225964812,225964857,0,162183502
HepG2|chr1:63834424-63834569,chr1,63834424,63834569,HepG2|chr1:148556270-148556377,chr1,148556270,148556377,0,84721846
HepG2|chr1:64031648-64031690,chr1,64031648,64031690,HepG2|chr1:148556202-148556273,chr1,148556202,148556273,0,84524554
HepG2|chr1:64550941-64551071,chr1,64550941,64551071,HepG2|chr1:148558202-148558319,chr1,148558202,148558319,0,84007261
HepG2|chr1:65057919-65058069,chr1,65057919,65058069,HepG2|chr1:148557625-148557659,chr1,148557625,148557659,0,83499706
HepG2|chr1:65192787-65192924,chr1,65192787,65192924,HepG2|chr1:40237931-40238081,chr1,40237931,40238081,0,24954856
HepG2|chr1:65273351-65273493,chr1,65273351,65273493,HepG2|chr1:148556130-148556180,chr1,148556130,148556180,0,83282779
HepG2|chr1:65327975-65328125,chr1,65327975,65328125,HepG2|chr1:149684821-149684968,chr1,149684821,149684968,0,84356846
HepG2|chr1:65827027-65827096,chr1,65827027,65827096,HepG2|chr1:148556133-148556180,chr1,148556133,148556180,0,82729106
HepG2|chr1:65959435-65959458,chr1,65959435,65959458,HepG2|chr1:148556206-148556353,chr1,148556206,148556353,0,82596771
HepG2|chr1:66545294-66545371,chr1,66545294,66545371,HepG2|chr1:148556206-148556353,chr1,148556206,148556353,0,82010912
HepG2|chr1:66619224-66619369,chr1,66619224,66619369,HepG2|chr1:148558160-148558286,chr1,148558160,148558286,0,81938936
HepG2|chr1:66818277-66818427,chr1,66818277,66818427,HepG2|chr1:16864537-16864687,chr1,16864537,16864687,0,49953740
HepG2|chr1:66839620-66839675,chr1,66839620,66839675,HepG2|chr1:247497320-247497447,chr1,247497320,247497447,0,180657700
HepG2|chr1:66968280-66968318,chr1,66968280,66968318,HepG2|chr1:173446955-173447104,chr1,173446955,173447104,0,106478675
HepG2|chr1:66981613-66981668,chr1,66981613,66981668,HepG2|chr1:225963524-225963631,chr1,225963524,225963631,0,158981911
HepG2|chr1:67462361-67462492,chr1,67462361,67462492,HepG2|chr1:148558114-148558253,chr1,148558114,148558253,0,81095753
HepG2|chr1:67563926-67564013,chr1,67563926,67564013,HepG2|chr1:148556180-148556325,chr1,148556180,148556325,0,80992254
HepG2|chr1:67699559-67699709,chr1,67699559,67699709,HepG2|chr1:148556885-148557035,chr1,148556885,148557035,0,80857326
HepG2|chr1:67715394-67715488,chr1,67715394,67715488,HepG2|chr1:63156650-63156800,chr1,63156650,63156800,0,4558744
HepG2|chr1:67802778-67802928,chr1,67802778,67802928,HepG2|chr1:148556577-148556725,chr1,148556577,148556725,0,80753799
HepG2|chr1:68321512-68321656,chr1,68321512,68321656,HepG2|chr1:148558062-148558212,chr1,148558062,148558212,0,80236550
HepG2|chr1:68722379-68722528,chr1,68722379,68722528,HepG2|chr1:148558160-148558287,chr1,148558160,148558287,0,79835781
HepG2|chr1:69133440-69133530,chr1,69133440,69133530,HepG2|chr1:155108716-155108772,chr1,155108716,155108772,0,85975276
HepG2|chr1:69170957-69171050,chr1,69170957,69171050,HepG2|chr1:174966482-174966539,chr1,174966482,174966539,0,105795525
HepG2|chr1:69419279-69419389,chr1,69419279,69419389,HepG2|chr1:245024858-245024898,chr1,245024858,245024898,0,175605579
HepG2|chr1:69849328-69849369,chr1,69849328,69849369,HepG2|chr1:245019122-245019148,chr1,245019122,245019148,0,175169794
HepG2|chr1:70136423-70136573,chr1,70136423,70136573,HepG2|chr1:1282518-1282592,chr1,1282518,1282592,0,68853905
HepG2|chr1:70169672-70169729,chr1,70169672,70169729,HepG2|chr1:245022842-245022941,chr1,245022842,245022941,0,174853170
HepG2|chr1:70329089-70329210,chr1,70329089,70329210,HepG2|chr1:148557625-148557707,chr1,148557625,148557707,0,78228536
HepG2|chr1:70363895-70363920,chr1,70363895,70363920,HepG2|chr1:1444584-1444691,chr1,1444584,1444691,0,68919311
HepG2|chr1:70435685-70435773,chr1,70435685,70435773,HepG2|chr1:109851507-109851569,chr1,109851507,109851569,0,39415822
HepG2|chr1:70565569-70565719,chr1,70565569,70565719,HepG2|chr1:148556481-148556631,chr1,148556481,148556631,0,77990912
HepG2|chr1:70719995-70720063,chr1,70719995,70720063,HepG2|chr1:205599369-205599436,chr1,205599369,205599436,0,134879374
HepG2|chr1:71014286-71014308,chr1,71014286,71014308,HepG2|chr1:152008220-152008370,chr1,152008220,152008370,0,80993934
HepG2|chr1:71247418-71247488,chr1,71247418,71247488,HepG2|chr1:26561669-26561748,chr1,26561669,26561748,0,44685749
HepG2|chr1:71363966-71364116,chr1,71363966,71364116,HepG2|chr1:148558160-148558299,chr1,148558160,148558299,0,77194194
HepG2|chr1:71376971-71377111,chr1,71376971,71377111,HepG2|chr1:148558086-148558236,chr1,148558086,148558236,0,77181115
HepG2|chr1:71421288-71421380,chr1,71421288,71421380,HepG2|chr1:148556144-148556180,chr1,148556144,148556180,0,77134856
HepG2|chr1:71555876-71556002,chr1,71555876,71556002,HepG2|chr1:148556202-148556349,chr1,148556202,148556349,0,77000326
HepG2|chr1:71590449-71590595,chr1,71590449,71590595,HepG2|chr1:148558040-148558189,chr1,148558040,148558189,0,76967591
HepG2|chr1:71741503-71741594,chr1,71741503,71741594,HepG2|chr1:148557628-148557689,chr1,148557628,148557689,0,76816125
HepG2|chr1:72224298-72224448,chr1,72224298,72224448,HepG2|chr1:148558013-148558163,chr1,148558013,148558163,0,76333715
HepG2|chr1:73051985-73052134,chr1,73051985,73052134,HepG2|chr1:148556562-148556709,chr1,148556562,148556709,0,75504577
HepG2|chr1:73456921-73457054,chr1,73456921,73457054,HepG2|chr1:148557630-148557689,chr1,148557630,148557689,0,75100709
HepG2|chr1:73460851-73460964,chr1,73460851,73460964,HepG2|chr1:148557628-148557658,chr1,148557628,148557658,0,75096777
HepG2|chr1:73682774-73682833,chr1,73682774,73682833,HepG2|chr1:224179579-224179667,chr1,224179579,224179667,0,150496805
HepG2|chr1:74170171-74170210,chr1,74170171,74170210,HepG2|chr1:178991081-178991188,chr1,178991081,178991188,0,104820910
HepG2|chr1:74193945-74193969,chr1,74193945,74193969,HepG2|chr1:148556138-148556180,chr1,148556138,148556180,0,74362193
HepG2|chr1:74222997-74223032,chr1,74222997,74223032,HepG2|chr1:1444584-1444699,chr1,1444584,1444699,0,72778413
HepG2|chr1:74503286-74503306,chr1,74503286,74503306,HepG2|chr1:148556195-148556345,chr1,148556195,148556345,0,74052909
HepG2|chr1:75036015-75036050,chr1,75036015,75036050,HepG2|chr1:148557509-148557623,chr1,148557509,148557623,0,73521494
HepG2|chr1:75798646-75798753,chr1,75798646,75798753,HepG2|chr1:63154356-63154395,chr1,63154356,63154395,0,12644290
HepG2|chr1:75816540-75816627,chr1,75816540,75816627,HepG2|chr1:33171403-33171466,chr1,33171403,33171466,0,42645137
HepG2|chr1:75852400-75852416,chr1,75852400,75852416,HepG2|chr1:235321462-235321521,chr1,235321462,235321521,0,159469062
HepG2|chr1:75973375-75973525,chr1,75973375,75973525,HepG2|chr1:224179571-224179669,chr1,224179571,224179669,0,148206196
HepG2|chr1:76013084-76013180,chr1,76013084,76013180,HepG2|chr1:179197937-179198050,chr1,179197937,179198050,0,103184853
HepG2|chr1:76821773-76821883,chr1,76821773,76821883,HepG2|chr1:245024858-245024898,chr1,245024858,245024898,0,168203085
HepG2|chr1:77396190-77396235,chr1,77396190,77396235,HepG2|chr1:153964697-153964721,chr1,153964697,153964721,0,76568507
HepG2|chr1:77483330-77483480,chr1,77483330,77483480,HepG2|chr1:148558202-148558352,chr1,148558202,148558352,0,71074872
HepG2|chr1:77565220-77565246,chr1,77565220,77565246,HepG2|chr1:47875353-47875426,chr1,47875353,47875426,0,29689867
HepG2|chr1:77760645-77760794,chr1,77760645,77760794,HepG2|chr1:148557628-148557707,chr1,148557628,148557707,0,70796983
HepG2|chr1:78142851-78142879,chr1,78142851,78142879,HepG2|chr1:228298913-228299056,chr1,228298913,228299056,0,150156062
HepG2|chr1:78298062-78298195,chr1,78298062,78298195,HepG2|chr1:148556130-148556180,chr1,148556130,148556180,0,70258068
HepG2|chr1:78304528-78304674,chr1,78304528,78304674,HepG2|chr1:149684996-149685146,chr1,149684996,149685146,0,71380468
HepG2|chr1:78421662-78421725,chr1,78421662,78421725,HepG2|chr1:205652616-205652703,chr1,205652616,205652703,0,127230954
HepG2|chr1:78540973-78541054,chr1,78540973,78541054,HepG2|chr1:148558181-148558331,chr1,148558181,148558331,0,70017208
HepG2|chr1:78719225-78719332,chr1,78719225,78719332,HepG2|chr1:148556132-148556180,chr1,148556132,148556180,0,69836907
HepG2|chr1:78733350-78733370,chr1,78733350,78733370,HepG2|chr1:235321999-235322035,chr1,235321999,235322035,0,156588649
HepG2|chr1:78739185-78739330,chr1,78739185,78739330,HepG2|chr1:148556270-148556420,chr1,148556270,148556420,0,69817085
HepG2|chr1:79098127-79098159,chr1,79098127,79098159,HepG2|chr1:153964668-153964721,chr1,153964668,153964721,0,74866541
HepG2|chr1:79151310-79151460,chr1,79151310,79151460,HepG2|chr1:148558185-148558332,chr1,148558185,148558332,0,69406875
HepG2|chr1:79311179-79311329,chr1,79311179,79311329,HepG2|chr1:148556562-148556709,chr1,148556562,148556709,0,69245383
HepG2|chr1:79411465-79411498,chr1,79411465,79411498,HepG2|chr1:148557504-148557621,chr1,148557504,148557621,0,69146039
HepG2|chr1:79665052-79665202,chr1,79665052,79665202,HepG2|chr1:148556510-148556660,chr1,148556510,148556660,0,68891458
HepG2|chr1:79823460-79823553,chr1,79823460,79823553,HepG2|chr1:148556691-148556777,chr1,148556691,148556777,0,68733231
HepG2|chr1:80627156-80627305,chr1,80627156,80627305,HepG2|chr1:16862318-16862468,chr1,16862318,16862468,0,63764838
HepG2|chr1:80656377-80656506,chr1,80656377,80656506,HepG2|chr1:6507209-6507238,chr1,6507209,6507238,0,74149168
HepG2|chr1:80660188-80660338,chr1,80660188,80660338,HepG2|chr1:148556921-148557071,chr1,148556921,148557071,0,67896733
HepG2|chr1:80756202-80756337,chr1,80756202,80756337,HepG2|chr1:148556217-148556367,chr1,148556217,148556367,0,67800015
HepG2|chr1:80810089-80810239,chr1,80810089,80810239,HepG2|chr1:148556215-148556365,chr1,148556215,148556365,0,67746126
HepG2|chr1:80942484-80942596,chr1,80942484,80942596,HepG2|chr1:148558068-148558218,chr1,148558068,148558218,0,67615584
HepG2|chr1:81030039-81030186,chr1,81030039,81030186,HepG2|chr1:148556264-148556413,chr1,148556264,148556413,0,67526225
HepG2|chr1:81057335-81057435,chr1,81057335,81057435,HepG2|chr1:25560216-25560254,chr1,25560216,25560254,0,55497119
HepG2|chr1:81080511-81080624,chr1,81080511,81080624,HepG2|chr1:148557628-148557658,chr1,148557628,148557658,0,67477117
HepG2|chr1:81385021-81385171,chr1,81385021,81385171,HepG2|chr1:148558152-148558302,chr1,148558152,148558302,0,67173131
HepG2|chr1:81457089-81457151,chr1,81457089,81457151,HepG2|chr1:228300737-228300850,chr1,228300737,228300850,0,146843648
HepG2|chr1:81536298-81536443,chr1,81536298,81536443,HepG2|chr1:148557625-148557661,chr1,148557625,148557661,0,67021327
HepG2|chr1:81579536-81579568,chr1,81579536,81579568,HepG2|chr1:148556149-148556180,chr1,148556149,148556180,0,66976613
HepG2|chr1:81726734-81726880,chr1,81726734,81726880,HepG2|chr1:145611429-145611579,chr1,145611429,145611579,0,63884695
HepG2|chr1:81798483-81798633,chr1,81798483,81798633,HepG2|chr1:16862926-16863076,chr1,16862926,16863076,0,64935557
HepG2|chr1:81907784-81907815,chr1,81907784,81907815,HepG2|chr1:201924301-201924417,chr1,201924301,201924417,0,120016517
HepG2|chr1:82195143-82195174,chr1,82195143,82195174,HepG2|chr1:153964580-153964722,chr1,153964580,153964722,0,71769437
HepG2|chr1:82203461-82203564,chr1,82203461,82203564,HepG2|chr1:86043986-86044033,chr1,86043986,86044033,0,3840525
HepG2|chr1:82245338-82245485,chr1,82245338,82245485,HepG2|chr1:6510867-6510920,chr1,6510867,6510920,0,75734471
HepG2|chr1:82602632-82602779,chr1,82602632,82602779,HepG2|chr1:148558152-148558302,chr1,148558152,148558302,0,65955520
HepG2|chr1:82716399-82716436,chr1,82716399,82716436,HepG2|chr1:148558145-148558287,chr1,148558145,148558287,0,65841746
HepG2|chr1:83009573-83009686,chr1,83009573,83009686,HepG2|chr1:154537265-154537321,chr1,154537265,154537321,0,71527692
HepG2|chr1:83054891-83055040,chr1,83054891,83055040,HepG2|chr1:148556914-148557064,chr1,148556914,148557064,0,65502023
HepG2|chr1:83154308-83154458,chr1,83154308,83154458,HepG2|chr1:148556122-148556180,chr1,148556122,148556180,0,65401814
HepG2|chr1:83424894-83425044,chr1,83424894,83425044,HepG2|chr1:148558013-148558163,chr1,148558013,148558163,0,65133119
HepG2|chr1:83946116-83946258,chr1,83946116,83946258,HepG2|chr1:148556216-148556366,chr1,148556216,148556366,0,64610100
HepG2|chr1:83948228-83948378,chr1,83948228,83948378,HepG2|chr1:148560503-148560539,chr1,148560503,148560539,0,64612275
HepG2|chr1:84117794-84117833,chr1,84117794,84117833,HepG2|chr1:225963524-225963631,chr1,225963524,225963631,0,141845730
HepG2|chr1:84129550-84129700,chr1,84129550,84129700,HepG2|chr1:148558160-148558300,chr1,148558160,148558300,0,64428610
HepG2|chr1:84430202-84430348,chr1,84430202,84430348,HepG2|chr1:148556288-148556366,chr1,148556288,148556366,0,64126086
HepG2|chr1:84515605-84515698,chr1,84515605,84515698,HepG2|chr1:178990498-178990546,chr1,178990498,178990546,0,94474893
HepG2|chr1:84583614-84583764,chr1,84583614,84583764,HepG2|chr1:148558202-148558352,chr1,148558202,148558352,0,63974588
HepG2|chr1:84636227-84636377,chr1,84636227,84636377,HepG2|chr1:145611376-145611526,chr1,145611376,145611526,0,60975149
HepG2|chr1:84718148-84718293,chr1,84718148,84718293,HepG2|chr1:148558185-148558331,chr1,148558185,148558331,0,63840037
HepG2|chr1:84734612-84734667,chr1,84734612,84734667,HepG2|chr1:247496594-247496689,chr1,247496594,247496689,0,162761982
HepG2|chr1:84924221-84924329,chr1,84924221,84924329,HepG2|chr1:8762439-8762459,chr1,8762439,8762459,0,76161782
HepG2|chr1:85126403-85126513,chr1,85126403,85126513,HepG2|chr1:245001128-245001159,chr1,245001128,245001159,0,159874725
HepG2|chr1:85373633-85373782,chr1,85373633,85373782,HepG2|chr1:148558221-148558370,chr1,148558221,148558370,0,63184588
HepG2|chr1:85388672-85388822,chr1,85388672,85388822,HepG2|chr1:148556502-148556644,chr1,148556502,148556644,0,63167830
HepG2|chr1:85401107-85401248,chr1,85401107,85401248,HepG2|chr1:148556262-148556412,chr1,148556262,148556412,0,63155155
HepG2|chr1:85666495-85666595,chr1,85666495,85666595,HepG2|chr1:25560216-25560254,chr1,25560216,25560254,0,60106279
HepG2|chr1:85711534-85711626,chr1,85711534,85711626,HepG2|chr1:100805718-100805865,chr1,100805718,100805865,0,15094184
HepG2|chr1:85971393-85971474,chr1,85971393,85971474,HepG2|chr1:148556191-148556341,chr1,148556191,148556341,0,62584798
HepG2|chr1:85979065-85979215,chr1,85979065,85979215,HepG2|chr1:149685005-149685155,chr1,149685005,149685155,0,63705940
HepG2|chr1:85996852-85996999,chr1,85996852,85996999,HepG2|chr1:247499555-247499581,chr1,247499555,247499581,0,161502703
HepG2|chr1:86031003-86031150,chr1,86031003,86031150,HepG2|chr1:148558040-148558189,chr1,148558040,148558189,0,62527037
HepG2|chr1:86302673-86302722,chr1,86302673,86302722,HepG2|chr1:148556364-148556407,chr1,148556364,148556407,0,62253691
HepG2|chr1:86315312-86315416,chr1,86315312,86315416,HepG2|chr1:148557501-148557628,chr1,148557501,148557628,0,62242189
HepG2|chr1:86694979-86695080,chr1,86694979,86695080,HepG2|chr1:247499026-247499161,chr1,247499026,247499161,0,160804047
HepG2|chr1:87038954-87038981,chr1,87038954,87038981,HepG2|chr1:148556876-148556962,chr1,148556876,148556962,0,61517922
HepG2|chr1:87121299-87121449,chr1,87121299,87121449,HepG2|chr1:148558160-148558294,chr1,148558160,148558294,0,61436861
HepG2|chr1:87693092-87693159,chr1,87693092,87693159,HepG2|chr1:148556180-148556293,chr1,148556180,148556293,0,60863088
HepG2|chr1:87938486-87938588,chr1,87938486,87938588,HepG2|chr1:86043986-86044033,chr1,86043986,86044033,0,1894500
HepG2|chr1:87942432-87942526,chr1,87942432,87942526,HepG2|chr1:120190693-120190749,chr1,120190693,120190749,0,32248261
HepG2|chr1:88336502-88336604,chr1,88336502,88336604,HepG2|chr1:148556272-148556421,chr1,148556272,148556421,0,60219770
HepG2|chr1:88465999-88466146,chr1,88465999,88466146,HepG2|chr1:148556287-148556434,chr1,148556287,148556434,0,60090288
HepG2|chr1:88809243-88809322,chr1,88809243,88809322,HepG2|chr1:148556135-148556180,chr1,148556135,148556180,0,59746892
HepG2|chr1:88953090-88953240,chr1,88953090,88953240,HepG2|chr1:148556215-148556365,chr1,148556215,148556365,0,59603125
HepG2|chr1:89374743-89374774,chr1,89374743,89374774,HepG2|chr1:148558206-148558356,chr1,148558206,148558356,0,59183463
HepG2|chr1:89734624-89734744,chr1,89734624,89734744,HepG2|chr1:148557628-148557658,chr1,148557628,148557658,0,58823004
HepG2|chr1:89775731-89775881,chr1,89775731,89775881,HepG2|chr1:31383174-31383204,chr1,31383174,31383204,0,58392557
HepG2|chr1:89862253-89862290,chr1,89862253,89862290,HepG2|chr1:225961476-225961626,chr1,225961476,225961626,0,136099223
HepG2|chr1:89907524-89907642,chr1,89907524,89907642,HepG2|chr1:67520773-67520846,chr1,67520773,67520846,0,22386751
HepG2|chr1:90205841-90205926,chr1,90205841,90205926,HepG2|chr1:228609515-228609580,chr1,228609515,228609580,0,138403674
HepG2|chr1:90311605-90311679,chr1,90311605,90311679,HepG2|chr1:148556132-148556180,chr1,148556132,148556180,0,58244527
HepG2|chr1:90595689-90595839,chr1,90595689,90595839,HepG2|chr1:148556286-148556366,chr1,148556286,148556366,0,57960597
HepG2|chr1:90730807-90730951,chr1,90730807,90730951,HepG2|chr1:148557625-148557656,chr1,148557625,148557656,0,57826818
HepG2|chr1:90921136-90921286,chr1,90921136,90921286,HepG2|chr1:148558185-148558331,chr1,148558185,148558331,0,57637049
HepG2|chr1:91031577-91031613,chr1,91031577,91031613,HepG2|chr1:148556132-148556180,chr1,148556132,148556180,0,57524555
HepG2|chr1:91157392-91157457,chr1,91157392,91157457,HepG2|chr1:148557508-148557623,chr1,148557508,148557623,0,57400116
HepG2|chr1:91581900-91581920,chr1,91581900,91581920,HepG2|chr1:148556195-148556345,chr1,148556195,148556345,0,56974295
HepG2|chr1:92021685-92021715,chr1,92021685,92021715,HepG2|chr1:200634577-200634722,chr1,200634577,200634722,0,108612892
HepG2|chr1:92126331-92126363,chr1,92126331,92126363,HepG2|chr1:148557536-148557625,chr1,148557536,148557625,0,56431205
HepG2|chr1:92132802-92132912,chr1,92132802,92132912,HepG2|chr1:148555906-148556027,chr1,148555906,148556027,0,56423104
HepG2|chr1:92254268-92254338,chr1,92254268,92254338,HepG2|chr1:156113494-156113571,chr1,156113494,156113571,0,63859226
HepG2|chr1:92273141-92273291,chr1,92273141,92273291,HepG2|chr1:22262450-22262469,chr1,22262450,22262469,0,70010691
HepG2|chr1:92761275-92761374,chr1,92761275,92761374,HepG2|chr1:31539734-31539777,chr1,31539734,31539777,0,61221541
HepG2|chr1:93014270-93014293,chr1,93014270,93014293,HepG2|chr1:148556134-148556180,chr1,148556134,148556180,0,55541864
HepG2|chr1:93298232-93298301,chr1,93298232,93298301,HepG2|chr1:31539734-31539777,chr1,31539734,31539777,0,61758498
HepG2|chr1:93815881-93815905,chr1,93815881,93815905,HepG2|chr1:148556690-148556810,chr1,148556690,148556810,0,54740809
HepG2|chr1:94260640-94260716,chr1,94260640,94260716,HepG2|chr1:45255492-45255566,chr1,45255492,45255566,0,49005148
HepG2|chr1:94350152-94350174,chr1,94350152,94350174,HepG2|chr1:148556690-148556797,chr1,148556690,148556797,0,54206538
HepG2|chr1:94525187-94525213,chr1,94525187,94525213,HepG2|chr1:247498985-247499135,chr1,247498985,247499135,0,152973798
HepG2|chr1:94619528-94619677,chr1,94619528,94619677,HepG2|chr1:148556180-148556323,chr1,148556180,148556323,0,53936652
HepG2|chr1:95265358-95265508,chr1,95265358,95265508,HepG2|chr1:148558202-148558352,chr1,148558202,148558352,0,53292844
HepG2|chr1:95324179-95324239,chr1,95324179,95324239,HepG2|chr1:148556581-148556731,chr1,148556581,148556731,0,53232402
HepG2|chr1:95551943-95552093,chr1,95551943,95552093,HepG2|chr1:149684993-149685143,chr1,149684993,149685143,0,54133050
HepG2|chr1:96349471-96349604,chr1,96349471,96349604,HepG2|chr1:225961309-225961351,chr1,225961309,225961351,0,129611838
HepG2|chr1:96794945-96795095,chr1,96794945,96795095,HepG2|chr1:148556880-148556942,chr1,148556880,148556942,0,51761935
HepG2|chr1:97342355-97342484,chr1,97342355,97342484,HepG2|chr1:12678743-12678803,chr1,12678743,12678803,0,84663612
HepG2|chr1:97579649-97579742,chr1,97579649,97579742,HepG2|chr1:148556691-148556777,chr1,148556691,148556777,0,50977042
HepG2|chr1:97723970-97724105,chr1,97723970,97724105,HepG2|chr1:148556691-148556711,chr1,148556691,148556711,0,50832721
HepG2|chr1:97767242-97767342,chr1,97767242,97767342,HepG2|chr1:45255492-45255566,chr1,45255492,45255566,0,52511750
HepG2|chr1:98116813-98116930,chr1,98116813,98116930,HepG2|chr1:228608345-228608396,chr1,228608345,228608396,0,130491532
HepG2|chr1:98387038-98387188,chr1,98387038,98387188,HepG2|chr1:148556869-148557014,chr1,148556869,148557014,0,50169831
HepG2|chr1:98498463-98498610,chr1,98498463,98498610,HepG2|chr1:148556478-148556628,chr1,148556478,148556628,0,50058015
HepG2|chr1:98618963-98619020,chr1,98618963,98619020,HepG2|chr1:150456166-150456316,chr1,150456166,150456316,0,51837203
HepG2|chr1:98793583-98793657,chr1,98793583,98793657,HepG2|chr1:247499555-247499581,chr1,247499555,247499581,0,148705972
HepG2|chr1:99342320-99342470,chr1,99342320,99342470,HepG2|chr1:148558202-148558352,chr1,148558202,148558352,0,49215882
HepG2|chr1:99446494-99446545,chr1,99446494,99446545,HepG2|chr1:167690874-167691024,chr1,167690874,167691024,0,68244380
HepG2|chr1:99598962-99599025,chr1,99598962,99599025,HepG2|chr1:245000045-245000132,chr1,245000045,245000132,0,145401083
HepG2|chr1:99784517-99784616,chr1,99784517,99784616,HepG2|chr1:148556180-148556314,chr1,148556180,148556314,0,48771663
HepG2|chr1:99904323-99904470,chr1,99904323,99904470,HepG2|chr1:145611378-145611528,chr1,145611378,145611528,0,45707055
HepG2|chr1:100046930-100047009,chr1,100046930,100047009,HepG2|chr1:205601761-205601832,chr1,205601761,205601832,0,105554831
HepG2|chr1:100282665-100282743,chr1,100282665,100282743,HepG2|chr1:148556249-148556399,chr1,148556249,148556399,0,48273584
HepG2|chr1:100302676-100302755,chr1,100302676,100302755,HepG2|chr1:148556135-148556180,chr1,148556135,148556180,0,48253459
HepG2|chr1:100407979-100408071,chr1,100407979,100408071,HepG2|chr1:174966482-174966539,chr1,174966482,174966539,0,74558503
HepG2|chr1:101293399-101293549,chr1,101293399,101293549,HepG2|chr1:148556279-148556429,chr1,148556279,148556429,0,47262880
HepG2|chr1:101448185-101448217,chr1,101448185,101448217,HepG2|chr1:200634597-200634722,chr1,200634597,200634722,0,99186412
HepG2|chr1:101557281-101557343,chr1,101557281,101557343,HepG2|chr1:3370591-3370675,chr1,3370591,3370675,0,98186690
HepG2|chr1:101596220-101596370,chr1,101596220,101596370,HepG2|chr1:148556478-148556628,chr1,148556478,148556628,0,46960258
HepG2|chr1:101781089-101781183,chr1,101781089,101781183,HepG2|chr1:120190693-120190749,chr1,120190693,120190749,0,18409604
HepG2|chr1:101953567-101953699,chr1,101953567,101953699,HepG2|chr1:247497284-247497302,chr1,247497284,247497302,0,145543717
HepG2|chr1:101979467-101979617,chr1,101979467,101979617,HepG2|chr1:148556885-148557035,chr1,148556885,148557035,0,46577418
HepG2|chr1:102386818-102386967,chr1,102386818,102386967,HepG2|chr1:148556651-148556800,chr1,148556651,148556800,0,46169833
HepG2|chr1:102926263-102926413,chr1,102926263,102926413,HepG2|chr1:148556615-148556765,chr1,148556615,148556765,0,45630352
HepG2|chr1:103244927-103245056,chr1,103244927,103245056,HepG2|chr1:6507209-6507238,chr1,6507209,6507238,0,96737718
HepG2|chr1:103612007-103612114,chr1,103612007,103612114,HepG2|chr1:235531154-235531189,chr1,235531154,235531189,0,131919147
HepG2|chr1:103649956-103650106,chr1,103649956,103650106,HepG2|chr1:148556921-148557071,chr1,148556921,148557071,0,44906965
HepG2|chr1:103700075-103700109,chr1,103700075,103700109,HepG2|chr1:153964655-153964721,chr1,153964655,153964721,0,50264580
HepG2|chr1:103769131-103769229,chr1,103769131,103769229,HepG2|chr1:148556134-148556180,chr1,148556134,148556180,0,44787003
HepG2|chr1:103888836-103888899,chr1,103888836,103888899,HepG2|chr1:220441237-220441314,chr1,220441237,220441314,0,116552401
HepG2|chr1:103943049-103943081,chr1,103943049,103943081,HepG2|chr1:1444629-1444776,chr1,1444629,1444776,0,102498420
HepG2|chr1:104130633-104130780,chr1,104130633,104130780,HepG2|chr1:16862336-16862486,chr1,16862336,16862486,0,87268297
HepG2|chr1:104159913-104159979,chr1,104159913,104159979,HepG2|chr1:33171977-33172061,chr1,33171977,33172061,0,70987936
HepG2|chr1:104484645-104484790,chr1,104484645,104484790,HepG2|chr1:148556319-148556398,chr1,148556319,148556398,0,44071674
HepG2|chr1:104733379-104733413,chr1,104733379,104733413,HepG2|chr1:148556180-148556325,chr1,148556180,148556325,0,43822801
HepG2|chr1:104733882-104734008,chr1,104733882,104734008,HepG2|chr1:78224041-78224079,chr1,78224041,78224079,0,26509841
HepG2|chr1:105437862-105438011,chr1,105437862,105438011,HepG2|chr1:148557600-148557652,chr1,148557600,148557652,0,43119738
HepG2|chr1:105548334-105548484,chr1,105548334,105548484,HepG2|chr1:148556869-148557014,chr1,148556869,148557014,0,43008535
HepG2|chr1:105843465-105843494,chr1,105843465,105843494,HepG2|chr1:173445776-173445815,chr1,173445776,173445815,0,67602311
HepG2|chr1:106598933-106599027,chr1,106598933,106599027,HepG2|chr1:148556155-148556180,chr1,148556155,148556180,0,41957222
HepG2|chr1:106700354-106700503,chr1,106700354,106700503,HepG2|chr1:16862318-16862468,chr1,16862318,16862468,0,89838036
HepG2|chr1:106867013-106867055,chr1,106867013,106867055,HepG2|chr1:148556202-148556273,chr1,148556202,148556273,0,41689189
HepG2|chr1:106913543-106913616,chr1,106913543,106913616,HepG2|chr1:167690855-167690928,chr1,167690855,167690928,0,60777312
HepG2|chr1:107011017-107011119,chr1,107011017,107011119,HepG2|chr1:148556272-148556421,chr1,148556272,148556421,0,41545255
HepG2|chr1:107284344-107284380,chr1,107284344,107284380,HepG2|chr1:153964660-153964721,chr1,153964660,153964721,0,46680316
HepG2|chr1:107287384-107287406,chr1,107287384,107287406,HepG2|chr1:245024999-245025063,chr1,245024999,245025063,0,137737615
HepG2|chr1:107619573-107619723,chr1,107619573,107619723,HepG2|chr1:148556370-148556423,chr1,148556370,148556423,0,40936797
HepG2|chr1:107840999-107841086,chr1,107840999,107841086,HepG2|chr1:33171403-33171466,chr1,33171403,33171466,0,74669596
HepG2|chr1:108142069-108142108,chr1,108142069,108142108,HepG2|chr1:150456425-150456447,chr1,150456425,150456447,0,42314356
HepG2|chr1:108518662-108518680,chr1,108518662,108518680,HepG2|chr1:148556910-148557060,chr1,148556910,148557060,0,40038248
HepG2|chr1:108706288-108706438,chr1,108706288,108706438,HepG2|chr1:40237097-40237243,chr1,40237097,40237243,0,68469191
HepG2|chr1:109070184-109070246,chr1,109070184,109070246,HepG2|chr1:228300737-228300850,chr1,228300737,228300850,0,119230553
HepG2|chr1:109082803-109082848,chr1,109082803,109082848,HepG2|chr1:153964697-153964721,chr1,153964697,153964721,0,44881894
HepG2|chr1:109155185-109155317,chr1,109155185,109155317,HepG2|chr1:148557625-148557704,chr1,148557625,148557704,0,39402440
HepG2|chr1:109158740-109158884,chr1,109158740,109158884,HepG2|chr1:167690828-167690893,chr1,167690828,167690893,0,58532088
HepG2|chr1:109538764-109538836,chr1,109538764,109538836,HepG2|chr1:228297829-228297930,chr1,228297829,228297930,0,118759065
HepG2|chr1:110171310-110171403,chr1,110171310,110171403,HepG2|chr1:178990498-178990546,chr1,178990498,178990546,0,68819188
HepG2|chr1:110254950-110254970,chr1,110254950,110254970,HepG2|chr1:153964658-153964721,chr1,153964658,153964721,0,43709708
HepG2|chr1:110454783-110454932,chr1,110454783,110454932,HepG2|chr1:148556045-148556170,chr1,148556045,148556170,0,38101262
HepG2|chr1:110751166-110751316,chr1,110751166,110751316,HepG2|chr1:86043986-86044033,chr1,86043986,86044033,0,24707180
HepG2|chr1:110936132-110936221,chr1,110936132,110936221,HepG2|chr1:247499340-247499401,chr1,247499340,247499401,0,136563208
HepG2|chr1:111351990-111352050,chr1,111351990,111352050,HepG2|chr1:148556581-148556731,chr1,148556581,148556731,0,37204591
HepG2|chr1:111508056-111508085,chr1,111508056,111508085,HepG2|chr1:228603863-228603984,chr1,228603863,228603984,0,117095807
HepG2|chr1:111681620-111681721,chr1,111681620,111681721,HepG2|chr1:148556135-148556269,chr1,148556135,148556269,0,36874515
HepG2|chr1:111685305-111685455,chr1,111685305,111685455,HepG2|chr1:247498919-247498955,chr1,247498919,247498955,0,135813614
HepG2|chr1:111703619-111703713,chr1,111703619,111703713,HepG2|chr1:148556350-148556382,chr1,148556350,148556382,0,36852731
HepG2|chr1:111746664-111746745,chr1,111746664,111746745,HepG2|chr1:37982296-37982365,chr1,37982296,37982365,0,73764368
HepG2|chr1:111919569-111919654,chr1,111919569,111919654,HepG2|chr1:148556249-148556366,chr1,148556249,148556366,0,36636680
HepG2|chr1:111968002-111968024,chr1,111968002,111968024,HepG2|chr1:245024999-245025063,chr1,245024999,245025063,0,133056997
HepG2|chr1:112069124-112069274,chr1,112069124,112069274,HepG2|chr1:154537266-154537328,chr1,154537266,154537328,0,42468142
HepG2|chr1:112134286-112134377,chr1,112134286,112134377,HepG2|chr1:148557628-148557689,chr1,148557628,148557689,0,36423342
HepG2|chr1:112192076-112192226,chr1,112192076,112192226,HepG2|chr1:40237007-40237154,chr1,40237007,40237154,0,71955069
HepG2|chr1:112216606-112216702,chr1,112216606,112216702,HepG2|chr1:148556122-148556180,chr1,148556122,148556180,0,36339516
HepG2|chr1:112457596-112457746,chr1,112457596,112457746,HepG2|chr1:86043986-86044033,chr1,86043986,86044033,0,26413610
HepG2|chr1:112541074-112541204,chr1,112541074,112541204,HepG2|chr1:148556363-148556407,chr1,148556363,148556407,0,36015289
HepG2|chr1:112943976-112944028,chr1,112943976,112944028,HepG2|chr1:148558160-148558297,chr1,148558160,148558297,0,35614184
HepG2|chr1:112957640-112957755,chr1,112957640,112957755,HepG2|chr1:63154356-63154395,chr1,63154356,63154395,0,49803284
HepG2|chr1:113064138-113064218,chr1,113064138,113064218,HepG2|chr1:148558588-148558700,chr1,148558588,148558700,0,35494450
HepG2|chr1:113255568-113255695,chr1,113255568,113255695,HepG2|chr1:70669737-70669760,chr1,70669737,70669760,0,42585831
HepG2|chr1:113432683-113432833,chr1,113432683,113432833,HepG2|chr1:40237097-40237243,chr1,40237097,40237243,0,73195586
HepG2|chr1:113653915-113654022,chr1,113653915,113654022,HepG2|chr1:16352026-16352069,chr1,16352026,16352069,0,97301889
HepG2|chr1:113776564-113776714,chr1,113776564,113776714,HepG2|chr1:145611439-145611589,chr1,145611439,145611589,0,31834875
HepG2|chr1:113872916-113873062,chr1,113872916,113873062,HepG2|chr1:148556288-148556366,chr1,148556288,148556366,0,34683372
HepG2|chr1:113933288-113933432,chr1,113933288,113933432,HepG2|chr1:148556895-148556995,chr1,148556895,148556995,0,34623607
HepG2|chr1:114116726-114116828,chr1,114116726,114116828,HepG2|chr1:78149986-78150012,chr1,78149986,78150012,0,35966740
HepG2|chr1:114173516-114173666,chr1,114173516,114173666,HepG2|chr1:120190693-120190764,chr1,120190693,120190764,0,6017177
HepG2|chr1:114448977-114449003,chr1,114448977,114449003,HepG2|chr1:38467676-38467806,chr1,38467676,38467806,0,75981301
HepG2|chr1:114635484-114635629,chr1,114635484,114635629,HepG2|chr1:148558185-148558331,chr1,148558185,148558331,0,33922701
HepG2|chr1:114857371-114857456,chr1,114857371,114857456,HepG2|chr1:167690828-167690893,chr1,167690828,167690893,0,52833457
HepG2|chr1:114911334-114911361,chr1,114911334,114911361,HepG2|chr1:148556876-148556962,chr1,148556876,148556962,0,33645542
HepG2|chr1:115667855-115667996,chr1,115667855,115667996,HepG2|chr1:148556201-148556351,chr1,148556201,148556351,0,32888346
HepG2|chr1:115712315-115712442,chr1,115712315,115712442,HepG2|chr1:148556134-148556180,chr1,148556134,148556180,0,32843819
HepG2|chr1:115719740-115719889,chr1,115719740,115719889,HepG2|chr1:148556296-148556443,chr1,148556296,148556443,0,32836556
HepG2|chr1:116321967-116322113,chr1,116321967,116322113,HepG2|chr1:16862446-16862593,chr1,16862446,16862593,0,99459521
HepG2|chr1:116428327-116428366,chr1,116428327,116428366,HepG2|chr1:33171355-33171466,chr1,33171355,33171466,0,83256972
HepG2|chr1:116576922-116577072,chr1,116576922,116577072,HepG2|chr1:148556319-148556377,chr1,148556319,148556377,0,31979397
HepG2|chr1:116589418-116589478,chr1,116589418,116589478,HepG2|chr1:15939163-15939229,chr1,15939163,15939229,0,100650255
HepG2|chr1:116604455-116604604,chr1,116604455,116604604,HepG2|chr1:148556593-148556743,chr1,148556593,148556743,0,31952138
HepG2|chr1:116827899-116828044,chr1,116827899,116828044,HepG2|chr1:8481219-8481269,chr1,8481219,8481269,0,108346680
HepG2|chr1:116988456-116988520,chr1,116988456,116988520,HepG2|chr1:220441237-220441314,chr1,220441237,220441314,0,103452781
HepG2|chr1:117289966-117290104,chr1,117289966,117290104,HepG2|chr1:148556294-148556444,chr1,148556294,148556444,0,31266328
HepG2|chr1:117345577-117345722,chr1,117345577,117345722,HepG2|chr1:225964643-225964711,chr1,225964643,225964711,0,108619066
HepG2|chr1:117407804-117407894,chr1,117407804,117407894,HepG2|chr1:12678743-12678803,chr1,12678743,12678803,0,104729061
HepG2|chr1:117466356-117466392,chr1,117466356,117466392,HepG2|chr1:89488300-89488389,chr1,89488300,89488389,0,27978056
HepG2|chr1:117534620-117534750,chr1,117534620,117534750,HepG2|chr1:148556363-148556407,chr1,148556363,148556407,0,31021743
HepG2|chr1:118087848-118087995,chr1,118087848,118087995,HepG2|chr1:145611378-145611528,chr1,145611378,145611528,0,27523530
HepG2|chr1:118214840-118214937,chr1,118214840,118214937,HepG2|chr1:148556134-148556180,chr1,148556134,148556180,0,30341294
HepG2|chr1:118255976-118256093,chr1,118255976,118256093,HepG2|chr1:228656174-228656230,chr1,228656174,228656230,0,110400198
HepG2|chr1:118256710-118256854,chr1,118256710,118256854,HepG2|chr1:148558062-148558212,chr1,148558062,148558212,0,30301352
HepG2|chr1:118292500-118292643,chr1,118292500,118292643,HepG2|chr1:148557628-148557689,chr1,148557628,148557689,0,30265128
HepG2|chr1:118447940-118448090,chr1,118447940,118448090,HepG2|chr1:148556279-148556429,chr1,148556279,148556429,0,30108339
HepG2|chr1:118598071-118598101,chr1,118598071,118598101,HepG2|chr1:153964655-153964721,chr1,153964655,153964721,0,35366584
HepG2|chr1:118787012-118787082,chr1,118787012,118787082,HepG2|chr1:148556204-148556354,chr1,148556204,148556354,0,29769192
HepG2|chr1:119090323-119090349,chr1,119090323,119090349,HepG2|chr1:38467676-38467806,chr1,38467676,38467806,0,80622647
HepG2|chr1:119231711-119231857,chr1,119231711,119231857,HepG2|chr1:145611429-145611579,chr1,145611429,145611579,0,26379718
HepG2|chr1:119242320-119242408,chr1,119242320,119242408,HepG2|chr1:148556209-148556359,chr1,148556209,148556359,0,29313889
HepG2|chr1:119473293-119473353,chr1,119473293,119473353,HepG2|chr1:15939163-15939229,chr1,15939163,15939229,0,103534130
HepG2|chr1:119616970-119617090,chr1,119616970,119617090,HepG2|chr1:173445770-173445907,chr1,173445770,173445907,0,53828800
HepG2|chr1:119656332-119656482,chr1,119656332,119656482,HepG2|chr1:148556577-148556725,chr1,148556577,148556725,0,28900245
HepG2|chr1:119703650-119703691,chr1,119703650,119703691,HepG2|chr1:120190693-120190802,chr1,120190693,120190802,0,487043
HepG2|chr1:119703911-119704058,chr1,119703911,119704058,HepG2|chr1:148556464-148556614,chr1,148556464,148556614,0,28852553
HepG2|chr1:119734967-119735117,chr1,119734967,119735117,HepG2|chr1:148557625-148557656,chr1,148557625,148557656,0,28822658
HepG2|chr1:119772052-119772133,chr1,119772052,119772133,HepG2|chr1:148558181-148558331,chr1,148558181,148558331,0,28786129
HepG2|chr1:120329939-120330042,chr1,120329939,120330042,HepG2|chr1:235323075-235323119,chr1,235323075,235323119,0,114993136
HepG2|chr1:120481141-120481178,chr1,120481141,120481178,HepG2|chr1:1444611-1444761,chr1,1444611,1444761,0,119036530
HepG2|chr1:120500718-120500834,chr1,120500718,120500834,HepG2|chr1:94345883-94345915,chr1,94345883,94345915,0,26154835
HepG2|chr1:120653294-120653443,chr1,120653294,120653443,HepG2|chr1:148558238-148558388,chr1,148558238,148558388,0,27904944
HepG2|chr1:121210151-121210253,chr1,121210151,121210253,HepG2|chr1:86043986-86044033,chr1,86043986,86044033,0,35166165
HepG2|chr1:121259391-121259444,chr1,121259391,121259444,HepG2|chr1:94345865-94345974,chr1,94345865,94345974,0,26913526
HepG2|chr1:121407138-121407170,chr1,121407138,121407170,HepG2|chr1:148557536-148557625,chr1,148557536,148557625,0,27150398
HepG2|chr1:121488848-121488981,chr1,121488848,121488981,HepG2|chr1:28992994-28993050,chr1,28992994,28993050,0,92495854
HepG2|chr1:121567961-121568111,chr1,121567961,121568111,HepG2|chr1:149685007-149685157,chr1,149685007,149685157,0,28117046
HepG2|chr1:121747695-121747761,chr1,121747695,121747761,HepG2|chr1:148556132-148556180,chr1,148556132,148556180,0,26808437
HepG2|chr1:122231844-122231922,chr1,122231844,122231922,HepG2|chr1:148556132-148556180,chr1,148556132,148556180,0,26324288
HepG2|chr1:122606507-122606655,chr1,122606507,122606655,HepG2|chr1:148556183-148556331,chr1,148556183,148556331,0,25949676
HepG2|chr1:122754982-122755007,chr1,122754982,122755007,HepG2|chr1:1444584-1444691,chr1,1444584,1444691,0,121310398
HepG2|chr1:122787604-122787742,chr1,122787604,122787742,HepG2|chr1:148556123-148556180,chr1,148556123,148556180,0,25768519
HepG2|chr1:122911352-122911479,chr1,122911352,122911479,HepG2|chr1:70669737-70669760,chr1,70669737,70669760,0,52241615
HepG2|chr1:123102418-123102514,chr1,123102418,123102514,HepG2|chr1:148556180-148556316,chr1,148556180,148556316,0,25453762
HepG2|chr1:123142432-123142578,chr1,123142432,123142578,HepG2|chr1:16862446-16862593,chr1,16862446,16862593,0,106279986
HepG2|chr1:123314809-123314838,chr1,123314809,123314838,HepG2|chr1:148556138-148556180,chr1,148556138,148556180,0,25241329
HepG2|chr1:123356936-123357086,chr1,123356936,123357086,HepG2|chr1:148556476-148556626,chr1,148556476,148556626,0,25199540
HepG2|chr1:123500045-123500194,chr1,123500045,123500194,HepG2|chr1:148556134-148556180,chr1,148556134,148556180,0,25056089
HepG2|chr1:123865668-123865818,chr1,123865668,123865818,HepG2|chr1:40237007-40237154,chr1,40237007,40237154,0,83628661
HepG2|chr1:124166157-124166307,chr1,124166157,124166307,HepG2|chr1:148556464-148556614,chr1,148556464,148556614,0,24390307
HepG2|chr1:124352652-124352718,chr1,124352652,124352718,HepG2|chr1:120190693-120190774,chr1,120190693,120190774,0,4161959
HepG2|chr1:124704651-124704679,chr1,124704651,124704679,HepG2|chr1:153964645-153964721,chr1,153964645,153964721,0,29259994
HepG2|chr1:124803025-124803175,chr1,124803025,124803175,HepG2|chr1:148557521-148557622,chr1,148557521,148557622,0,23754496
HepG2|chr1:124804331-124804425,chr1,124804331,124804425,HepG2|chr1:33170035-33170182,chr1,33170035,33170182,0,91634296
HepG2|chr1:124887987-124888069,chr1,124887987,124888069,HepG2|chr1:148557628-148557689,chr1,148557628,148557689,0,23669641
HepG2|chr1:124897149-124897215,chr1,124897149,124897215,HepG2|chr1:148556132-148556180,chr1,148556132,148556180,0,23658983
HepG2|chr1:125006871-125007017,chr1,125006871,125007017,HepG2|chr1:148556272-148556422,chr1,148556272,148556422,0,23549401
HepG2|chr1:125009979-125010123,chr1,125009979,125010123,HepG2|chr1:145611408-145611558,chr1,145611408,145611558,0,20601429
HepG2|chr1:125071182-125071290,chr1,125071182,125071290,HepG2|chr1:63154356-63154395,chr1,63154356,63154395,0,61916826
HepG2|chr1:125317688-125317773,chr1,125317688,125317773,HepG2|chr1:148557625-148557689,chr1,148557625,148557689,0,23239937
HepG2|chr1:125381013-125381163,chr1,125381013,125381163,HepG2|chr1:148556294-148556444,chr1,148556294,148556444,0,23175281
HepG2|chr1:125656585-125656730,chr1,125656585,125656730,HepG2|chr1:148556270-148556377,chr1,148556270,148556377,0,22899685
HepG2|chr1:125986299-125986401,chr1,125986299,125986401,HepG2|chr1:78149986-78150012,chr1,78149986,78150012,0,47836313
HepG2|chr1:126061093-126061132,chr1,126061093,126061132,HepG2|chr1:156112102-156112252,chr1,156112102,156112252,0,30051009
HepG2|chr1:126110135-126110171,chr1,126110135,126110171,HepG2|chr1:89488300-89488389,chr1,89488300,89488389,0,36621835
HepG2|chr1:126192813-126192849,chr1,126192813,126192849,HepG2|chr1:148556132-148556180,chr1,148556132,148556180,0,22363319
HepG2|chr1:126364403-126364462,chr1,126364403,126364462,HepG2|chr1:224179579-224179667,chr1,224179579,224179667,0,97815176
HepG2|chr1:126376293-126376443,chr1,126376293,126376443,HepG2|chr1:145611370-145611514,chr1,145611370,145611514,0,19235077
HepG2|chr1:126392917-126393067,chr1,126392917,126393067,HepG2|chr1:16862336-16862479,chr1,16862336,16862479,0,109530581
HepG2|chr1:126460751-126460901,chr1,126460751,126460901,HepG2|chr1:148556562-148556709,chr1,148556562,148556709,0,22095811
HepG2|chr1:126849448-126849515,chr1,126849448,126849515,HepG2|chr1:245000232-245000265,chr1,245000232,245000265,0,118150784
HepG2|chr1:126915751-126915892,chr1,126915751,126915892,HepG2|chr1:148556201-148556351,chr1,148556201,148556351,0,21640450
HepG2|chr1:127100593-127100706,chr1,127100593,127100706,HepG2|chr1:148556133-148556180,chr1,148556133,148556180,0,21455540
HepG2|chr1:127186794-127186929,chr1,127186794,127186929,HepG2|chr1:148556147-148556180,chr1,148556147,148556180,0,21369353
HepG2|chr1:127320953-127321103,chr1,127320953,127321103,HepG2|chr1:148556503-148556650,chr1,148556503,148556650,0,21235550
HepG2|chr1:127364618-127364655,chr1,127364618,127364655,HepG2|chr1:179197937-179198050,chr1,179197937,179198050,0,51833319
HepG2|chr1:127503856-127504006,chr1,127503856,127504006,HepG2|chr1:148556286-148556366,chr1,148556286,148556366,0,21052430
HepG2|chr1:127540996-127541146,chr1,127540996,127541146,HepG2|chr1:149684820-149684967,chr1,149684820,149684967,0,22143824
HepG2|chr1:127600554-127600608,chr1,127600554,127600608,HepG2|chr1:148556876-148556965,chr1,148556876,148556965,0,20956322
HepG2|chr1:127606494-127606644,chr1,127606494,127606644,HepG2|chr1:247497612-247497694,chr1,247497612,247497694,0,119891118
HepG2|chr1:127607296-127607345,chr1,127607296,127607345,HepG2|chr1:148556364-148556437,chr1,148556364,148556437,0,20949068
HepG2|chr1:127882541-127882604,chr1,127882541,127882604,HepG2|chr1:205652616-205652703,chr1,205652616,205652703,0,77770075
HepG2|chr1:128650276-128650387,chr1,128650276,128650387,HepG2|chr1:148556133-148556180,chr1,148556133,148556180,0,19905857
HepG2|chr1:128731148-128731185,chr1,128731148,128731185,HepG2|chr1:205600116-205600263,chr1,205600116,205600263,0,76868968
HepG2|chr1:128767781-128767928,chr1,128767781,128767928,HepG2|chr1:148556216-148556366,chr1,148556216,148556366,0,19788435
HepG2|chr1:128870283-128870370,chr1,128870283,128870370,HepG2|chr1:148556135-148556180,chr1,148556135,148556180,0,19685852
HepG2|chr1:128971986-128972126,chr1,128971986,128972126,HepG2|chr1:148558086-148558236,chr1,148558086,148558236,0,19586100
HepG2|chr1:129225321-129225465,chr1,129225321,129225465,HepG2|chr1:148557625-148557656,chr1,148557625,148557656,0,19332304
HepG2|chr1:129517554-129517604,chr1,129517554,129517604,HepG2|chr1:205652566-205652700,chr1,205652566,205652700,0,76135012
HepG2|chr1:129547886-129547905,chr1,129547886,129547905,HepG2|chr1:148556198-148556348,chr1,148556198,148556348,0,19008312
HepG2|chr1:129648423-129648520,chr1,129648423,129648520,HepG2|chr1:148556143-148556180,chr1,148556143,148556180,0,18907720
HepG2|chr1:129781322-129781472,chr1,129781322,129781472,HepG2|chr1:148557521-148557622,chr1,148557521,148557622,0,18776199
HepG2|chr1:129975203-129975339,chr1,129975203,129975339,HepG2|chr1:226252827-226252953,chr1,226252827,226252953,0,96277624
HepG2|chr1:130104476-130104515,chr1,130104476,130104515,HepG2|chr1:225963524-225963631,chr1,225963524,225963631,0,95859048
HepG2|chr1:130217469-130217619,chr1,130217469,130217619,HepG2|chr1:148556468-148556618,chr1,148556468,148556618,0,18338999
HepG2|chr1:130306794-130306935,chr1,130306794,130306935,HepG2|chr1:148556262-148556412,chr1,148556262,148556412,0,18249468
HepG2|chr1:130428564-130428693,chr1,130428564,130428693,HepG2|chr1:204042325-204042449,chr1,204042325,204042449,0,73613761
HepG2|chr1:130661588-130661609,chr1,130661588,130661609,HepG2|chr1:245019113-245019216,chr1,245019113,245019216,0,114357525
HepG2|chr1:130678910-130679026,chr1,130678910,130679026,HepG2|chr1:54406651-54406801,chr1,54406651,54406801,0,76272259
HepG2|chr1:130734707-130734796,chr1,130734707,130734796,HepG2|chr1:120190693-120190752,chr1,120190693,120190752,0,10544014
HepG2|chr1:130838356-130838463,chr1,130838356,130838463,HepG2|chr1:16352026-16352069,chr1,16352026,16352069,0,114486330
HepG2|chr1:131124424-131124571,chr1,131124424,131124571,HepG2|chr1:148556691-148556710,chr1,148556691,148556710,0,17432267
HepG2|chr1:131377049-131377088,chr1,131377049,131377088,HepG2|chr1:156112102-156112252,chr1,156112102,156112252,0,24735053
HepG2|chr1:131437654-131437680,chr1,131437654,131437680,HepG2|chr1:47875353-47875426,chr1,47875353,47875426,0,83562301
HepG2|chr1:131456105-131456185,chr1,131456105,131456185,HepG2|chr1:148556154-148556180,chr1,148556154,148556180,0,17100049
HepG2|chr1:131502398-131502545,chr1,131502398,131502545,HepG2|chr1:149685087-149685212,chr1,149685087,149685212,0,18182689
HepG2|chr1:131581616-131581694,chr1,131581616,131581694,HepG2|chr1:148555857-148556007,chr1,148555857,148556007,0,16974241
HepG2|chr1:131694434-131694546,chr1,131694434,131694546,HepG2|chr1:247499397-247499515,chr1,247499397,247499515,0,115804963
HepG2|chr1:131779244-131779394,chr1,131779244,131779394,HepG2|chr1:148558278-148558331,chr1,148558278,148558331,0,16779034
HepG2|chr1:131785890-131785996,chr1,131785890,131785996,HepG2|chr1:28992994-28993052,chr1,28992994,28993052,0,102792896
HepG2|chr1:132032235-132032267,chr1,132032235,132032267,HepG2|chr1:1444629-1444776,chr1,1444629,1444776,0,130587606
HepG2|chr1:132230975-132231122,chr1,132230975,132231122,HepG2|chr1:148557625-148557658,chr1,148557625,148557658,0,16326650
HepG2|chr1:132465395-132465493,chr1,132465395,132465493,HepG2|chr1:148556180-148556314,chr1,148556180,148556314,0,16090785
HepG2|chr1:132699342-132699492,chr1,132699342,132699492,HepG2|chr1:148558117-148558262,chr1,148558117,148558262,0,15858775
HepG2|chr1:132719666-132719816,chr1,132719666,132719816,HepG2|chr1:224179571-224179669,chr1,224179571,224179669,0,91459905
HepG2|chr1:132812553-132812686,chr1,132812553,132812686,HepG2|chr1:148556130-148556180,chr1,148556130,148556180,0,15743577
HepG2|chr1:133032466-133032569,chr1,133032466,133032569,HepG2|chr1:86043986-86044033,chr1,86043986,86044033,0,46988480
HepG2|chr1:133203727-133203756,chr1,133203727,133203756,HepG2|chr1:153964694-153964721,chr1,153964694,153964721,0,20760967
HepG2|chr1:133250002-133250149,chr1,133250002,133250149,HepG2|chr1:40237931-40238081,chr1,40237931,40238081,0,93012071
HepG2|chr1:133293526-133293673,chr1,133293526,133293673,HepG2|chr1:148557625-148557658,chr1,148557625,148557658,0,15264099
HepG2|chr1:133718337-133718399,chr1,133718337,133718399,HepG2|chr1:3370591-3370675,chr1,3370591,3370675,0,130347746
HepG2|chr1:133789954-133790092,chr1,133789954,133790092,HepG2|chr1:148556635-148556741,chr1,148556635,148556741,0,14766681
HepG2|chr1:133838173-133838221,chr1,133838173,133838221,HepG2|chr1:228603863-228603984,chr1,228603863,228603984,0,94765690
HepG2|chr1:133896117-133896194,chr1,133896117,133896194,HepG2|chr1:148556132-148556180,chr1,148556132,148556180,0,14660015
HepG2|chr1:133979057-133979190,chr1,133979057,133979190,HepG2|chr1:28992994-28993050,chr1,28992994,28993050,0,104986063
HepG2|chr1:133996527-133996677,chr1,133996527,133996677,HepG2|chr1:148557600-148557652,chr1,148557600,148557652,0,14561073
HepG2|chr1:134145756-134145795,chr1,134145756,134145795,HepG2|chr1:178991081-178991188,chr1,178991081,178991188,0,44845325
HepG2|chr1:134228925-134229010,chr1,134228925,134229010,HepG2|chr1:228609515-228609580,chr1,228609515,228609580,0,94380590
HepG2|chr1:134306637-134306699,chr1,134306637,134306699,HepG2|chr1:33170050-33170200,chr1,33170050,33170200,0,101136587
HepG2|chr1:134614550-134614640,chr1,134614550,134614640,HepG2|chr1:12678743-12678803,chr1,12678743,12678803,0,121935807
HepG2|chr1:134736650-134736795,chr1,134736650,134736795,HepG2|chr1:148558160-148558286,chr1,148558160,148558286,0,13821510
HepG2|chr1:134796303-134796453,chr1,134796303,134796453,HepG2|chr1:148556615-148556765,chr1,148556615,148556765,0,13760312
HepG2|chr1:134858427-134858577,chr1,134858427,134858577,HepG2|chr1:145611370-145611514,chr1,145611370,145611514,0,10752943
HepG2|chr1:135042711-135042861,chr1,135042711,135042861,HepG2|chr1:148556140-148556180,chr1,148556140,148556180,0,13513429
HepG2|chr1:135078844-135078926,chr1,135078844,135078926,HepG2|chr1:148557628-148557689,chr1,148557628,148557689,0,13478784
HepG2|chr1:135394583-135394694,chr1,135394583,135394694,HepG2|chr1:174966681-174966809,chr1,174966681,174966809,0,39572098
HepG2|chr1:135406239-135406389,chr1,135406239,135406389,HepG2|chr1:148558219-148558369,chr1,148558219,148558369,0,13151980
HepG2|chr1:135428119-135428269,chr1,135428119,135428269,HepG2|chr1:148556466-148556616,chr1,148556466,148556616,0,13128347
HepG2|chr1:135803883-135804033,chr1,135803883,135804033,HepG2|chr1:149684821-149684968,chr1,149684821,149684968,0,13880938
HepG2|chr1:135810971-135811102,chr1,135810971,135811102,HepG2|chr1:22262450-22262469,chr1,22262450,22262469,0,113548521
HepG2|chr1:135968354-135968501,chr1,135968354,135968501,HepG2|chr1:148558040-148558189,chr1,148558040,148558189,0,12589686
HepG2|chr1:136099992-136100075,chr1,136099992,136100075,HepG2|chr1:44174051-44174084,chr1,44174051,44174084,0,91925941
HepG2|chr1:136483398-136483541,chr1,136483398,136483541,HepG2|chr1:148557628-148557689,chr1,148557628,148557689,0,12074230
HepG2|chr1:136543298-136543335,chr1,136543298,136543335,HepG2|chr1:33170057-33170180,chr1,33170057,33170180,0,103373241
HepG2|chr1:136565222-136565308,chr1,136565222,136565308,HepG2|chr1:37982301-37982365,chr1,37982301,37982365,0,98582921
HepG2|chr1:136644600-136644750,chr1,136644600,136644750,HepG2|chr1:148558117-148558262,chr1,148558117,148558262,0,11913517
HepG2|chr1:136885359-136885485,chr1,136885359,136885485,HepG2|chr1:78224041-78224079,chr1,78224041,78224079,0,58661318
HepG2|chr1:136917489-136917612,chr1,136917489,136917612,HepG2|chr1:208429975-208429992,chr1,208429975,208429992,0,71512486
HepG2|chr1:137403046-137403186,chr1,137403046,137403186,HepG2|chr1:33171343-33171466,chr1,33171343,33171466,0,104231703
HepG2|chr1:137713406-137713440,chr1,137713406,137713440,HepG2|chr1:153964655-153964721,chr1,153964655,153964721,0,16251249
HepG2|chr1:137916968-137917062,chr1,137916968,137917062,HepG2|chr1:148556350-148556382,chr1,148556350,148556382,0,10639382
HepG2|chr1:137947830-137947975,chr1,137947830,137947975,HepG2|chr1:148557625-148557661,chr1,148557625,148557661,0,10609795
HepG2|chr1:138145524-138145654,chr1,138145524,138145654,HepG2|chr1:148558202-148558319,chr1,148558202,148558319,0,10412678
HepG2|chr1:138866409-138866428,chr1,138866409,138866428,HepG2|chr1:148556198-148556348,chr1,148556198,148556348,0,9689789
HepG2|chr1:138966975-138967055,chr1,138966975,138967055,HepG2|chr1:148558588-148558700,chr1,148558588,148558700,0,9591613
HepG2|chr1:138991632-138991656,chr1,138991632,138991656,HepG2|chr1:226252827-226252953,chr1,226252827,226252953,0,87261195
HepG2|chr1:139067374-139067505,chr1,139067374,139067505,HepG2|chr1:148556133-148556180,chr1,148556133,148556180,0,9488759
HepG2|chr1:139413807-139413829,chr1,139413807,139413829,HepG2|chr1:152008220-152008370,chr1,152008220,152008370,0,12594413
HepG2|chr1:139453544-139453694,chr1,139453544,139453694,HepG2|chr1:148556567-148556717,chr1,148556567,148556717,0,9103023
HepG2|chr1:139906901-139907030,chr1,139906901,139907030,HepG2|chr1:12678743-12678803,chr1,12678743,12678803,0,127228158
HepG2|chr1:139985228-139985300,chr1,139985228,139985300,HepG2|chr1:148556203-148556353,chr1,148556203,148556353,0,8570975
HepG2|chr1:140427015-140427042,chr1,140427015,140427042,HepG2|chr1:33171343-33171466,chr1,33171343,33171466,0,107255672
HepG2|chr1:140555976-140556026,chr1,140555976,140556026,HepG2|chr1:153964669-153964721,chr1,153964669,153964721,0,13408693
HepG2|chr1:140743243-140743393,chr1,140743243,140743393,HepG2|chr1:28992994-28993050,chr1,28992994,28993050,0,111750249
HepG2|chr1:141154072-141154222,chr1,141154072,141154222,HepG2|chr1:148556464-148556614,chr1,148556464,148556614,0,7402392
HepG2|chr1:141231194-141231321,chr1,141231194,141231321,HepG2|chr1:148556272-148556422,chr1,148556272,148556422,0,7325078
HepG2|chr1:141632373-141632454,chr1,141632373,141632454,HepG2|chr1:37982296-37982365,chr1,37982296,37982365,0,103650077
HepG2|chr1:141718435-141718558,chr1,141718435,141718558,HepG2|chr1:148557510-148557628,chr1,148557510,148557628,0,6839075
HepG2|chr1:141759277-141759312,chr1,141759277,141759312,HepG2|chr1:174966720-174966831,chr1,174966720,174966831,0,33207443
HepG2|chr1:141862772-141862871,chr1,141862772,141862871,HepG2|chr1:148556180-148556314,chr1,148556180,148556314,0,6693408
HepG2|chr1:141926869-141927016,chr1,141926869,141927016,HepG2|chr1:148556286-148556436,chr1,148556286,148556436,0,6629417
HepG2|chr1:142004201-142004288,chr1,142004201,142004288,HepG2|chr1:109851507-109851569,chr1,109851507,109851569,0,32152694
HepG2|chr1:142038254-142038404,chr1,142038254,142038404,HepG2|chr1:148556122-148556180,chr1,148556122,148556180,0,6517868
HepG2|chr1:142041629-142041777,chr1,142041629,142041777,HepG2|chr1:224179593-224179669,chr1,224179593,224179669,0,82137964
HepG2|chr1:142060365-142060515,chr1,142060365,142060515,HepG2|chr1:148556908-148557058,chr1,148556908,148557058,0,6496543
HepG2|chr1:142130853-142130916,chr1,142130853,142130916,HepG2|chr1:148556132-148556180,chr1,148556132,148556180,0,6425279
HepG2|chr1:142289505-142289655,chr1,142289505,142289655,HepG2|chr1:40237903-40238050,chr1,40237903,40238050,0,102051602
HepG2|chr1:142419683-142419828,chr1,142419683,142419828,HepG2|chr1:148556133-148556180,chr1,148556133,148556180,0,6136450
HepG2|chr1:142442880-142443030,chr1,142442880,142443030,HepG2|chr1:148556895-148557045,chr1,148556895,148557045,0,6114015
HepG2|chr1:142656605-142656717,chr1,142656605,142656717,HepG2|chr1:148557628-148557689,chr1,148557628,148557689,0,5901023
HepG2|chr1:142995028-142995051,chr1,142995028,142995051,HepG2|chr1:3447363-3447490,chr1,3447363,3447490,0,139547665
HepG2|chr1:143329771-143329820,chr1,143329771,143329820,HepG2|chr1:153964657-153964721,chr1,153964657,153964721,0,10634886
HepG2|chr1:143368160-143368310,chr1,143368160,143368310,HepG2|chr1:148556464-148556614,chr1,148556464,148556614,0,5188304
HepG2|chr1:143941774-143941806,chr1,143941774,143941806,HepG2|chr1:153964668-153964721,chr1,153964668,153964721,0,10022894
HepG2|chr1:144126090-144126234,chr1,144126090,144126234,HepG2|chr1:148556230-148556380,chr1,148556230,148556380,0,4430140
HepG2|chr1:144156910-144156997,chr1,144156910,144156997,HepG2|chr1:148556153-148556180,chr1,148556153,148556180,0,4399243
HepG2|chr1:144185234-144185363,chr1,144185234,144185363,HepG2|chr1:148557607-148557658,chr1,148557607,148557658,0,4372373
HepG2|chr1:144694998-144695116,chr1,144694998,144695116,HepG2|chr1:148556061-148556120,chr1,148556061,148556120,0,3861063
HepG2|chr1:144769957-144770102,chr1,144769957,144770102,HepG2|chr1:148556216-148556353,chr1,148556216,148556353,0,3786259
HepG2|chr1:144829428-144829574,chr1,144829428,144829574,HepG2|chr1:148556561-148556711,chr1,148556561,148556711,0,3727133
HepG2|chr1:144835698-144835848,chr1,144835698,144835848,HepG2|chr1:148558185-148558332,chr1,148558185,148558332,0,3722487
HepG2|chr1:145096811-145096939,chr1,145096811,145096939,HepG2|chr1:148556130-148556180,chr1,148556130,148556180,0,3459319
HepG2|chr1:145174865-145175010,chr1,145174865,145175010,HepG2|chr1:148556466-148556616,chr1,148556466,148556616,0,3381601
HepG2|chr1:145372588-145372728,chr1,145372588,145372728,HepG2|chr1:148555903-148556027,chr1,148555903,148556027,0,3183315
HepG2|chr1:145538639-145538784,chr1,145538639,145538784,HepG2|chr1:148556270-148556420,chr1,148556270,148556420,0,3017631
HepG2|chr1:145587663-145587813,chr1,145587663,145587813,HepG2|chr1:148556579-148556728,chr1,148556579,148556728,0,2968916
HepG2|chr1:146562194-146562283,chr1,146562194,146562283,HepG2|chr1:148556691-148556733,chr1,148556691,148556733,0,1994497
HepG2|chr1:146578176-146578202,chr1,146578176,146578202,HepG2|chr1:247498985-247499135,chr1,247498985,247499135,0,100920809
HepG2|chr1:146621223-146621250,chr1,146621223,146621250,HepG2|chr1:33171343-33171466,chr1,33171343,33171466,0,113449880
HepG2|chr1:146644882-146645032,chr1,146644882,146645032,HepG2|chr1:148556577-148556725,chr1,148556577,148556725,0,1911695
HepG2|chr1:146742068-146742100,chr1,146742068,146742100,HepG2|chr1:247499397-247499515,chr1,247499397,247499515,0,100757329
HepG2|chr1:147086008-147086158,chr1,147086008,147086158,HepG2|chr1:40237007-40237154,chr1,40237007,40237154,0,106849001
HepG2|chr1:147113985-147114007,chr1,147113985,147114007,HepG2|chr1:153964695-153964721,chr1,153964695,153964721,0,6850710
HepG2|chr1:147235295-147235391,chr1,147235295,147235391,HepG2|chr1:173836015-173836066,chr1,173836015,173836066,0,26600720
HepG2|chr1:147478696-147478809,chr1,147478696,147478809,HepG2|chr1:154537265-154537321,chr1,154537265,154537321,0,7058569
HepG2|chr1:147600700-147600736,chr1,147600700,147600736,HepG2|chr1:25561671-25561785,chr1,25561671,25561785,0,122039029
HepG2|chr1:147826479-147826587,chr1,147826479,147826587,HepG2|chr1:148556153-148556180,chr1,148556153,148556180,0,729674
HepG2|chr1:147906100-147906231,chr1,147906100,147906231,HepG2|chr1:148557625-148557655,chr1,148557625,148557655,0,651525
HepG2|chr1:148166685-148166834,chr1,148166685,148166834,HepG2|chr1:148556180-148556323,chr1,148556180,148556323,0,389495
HepG2|chr1:148227649-148227796,chr1,148227649,148227796,HepG2|chr1:148556090-148556240,chr1,148556090,148556240,0,328441
HepG2|chr1:148427411-148427558,chr1,148427411,148427558,HepG2|chr1:148556474-148556623,chr1,148556474,148556623,0,129063
HepG2|chr1:148742830-148742896,chr1,148742830,148742896,HepG2|chr1:245000232-245000265,chr1,245000232,245000265,0,96257402
HepG2|chr1:149017891-149017940,chr1,149017891,149017940,HepG2|chr1:173445770-173445787,chr1,173445770,173445787,0,24427879
HepG2|chr1:149063193-149063305,chr1,149063193,149063305,HepG2|chr1:78224041-78224079,chr1,78224041,78224079,0,70839152
HepG2|chr1:149090289-149090315,chr1,149090289,149090315,HepG2|chr1:204042325-204042449,chr1,204042325,204042449,0,54952036
HepG2|chr1:149247573-149247723,chr1,149247573,149247723,HepG2|chr1:16862452-16862602,chr1,16862452,16862602,0,132385121
HepG2|chr1:149404092-149404219,chr1,149404092,149404219,HepG2|chr1:247499533-247499552,chr1,247499533,247499552,0,98095441
HepG2|chr1:149646805-149646885,chr1,149646805,149646885,HepG2|chr1:148556133-148556180,chr1,148556133,148556180,0,1090672
HepG2|chr1:149893020-149893136,chr1,149893020,149893136,HepG2|chr1:235531154-235531187,chr1,235531154,235531187,0,85638134
HepG2|chr1:149917944-149918094,chr1,149917944,149918094,HepG2|chr1:148558202-148558352,chr1,148558202,148558352,0,1359742
HepG2|chr1:150079034-150079053,chr1,150079034,150079053,HepG2|chr1:247498107-247498257,chr1,247498107,247498257,0,97419073
HepG2|chr1:150108825-150108892,chr1,150108825,150108892,HepG2|chr1:148556180-148556293,chr1,148556180,148556293,0,1552645
HepG2|chr1:150154762-150154801,chr1,150154762,150154801,HepG2|chr1:148557625-148557732,chr1,148557625,148557732,0,1597137
HepG2|chr1:150357115-150357262,chr1,150357115,150357262,HepG2|chr1:148556628-148556778,chr1,148556628,148556778,0,1800487
HepG2|chr1:150418974-150419071,chr1,150418974,150419071,HepG2|chr1:226251053-226251104,chr1,226251053,226251104,0,75832079
HepG2|chr1:150493744-150493894,chr1,150493744,150493894,HepG2|chr1:148557625-148557698,chr1,148557625,148557698,0,1936119
HepG2|chr1:150524816-150524957,chr1,150524816,150524957,HepG2|chr1:148558133-148558281,chr1,148558133,148558281,0,1966683
HepG2|chr1:150625116-150625224,chr1,150625116,150625224,HepG2|chr1:225961309-225961351,chr1,225961309,225961351,0,75336193
HepG2|chr1:150775431-150775581,chr1,150775431,150775581,HepG2|chr1:148558235-148558384,chr1,148558235,148558384,0,2217196
HepG2|chr1:150804393-150804543,chr1,150804393,150804543,HepG2|chr1:148556249-148556398,chr1,148556249,148556398,0,2248144
HepG2|chr1:150860382-150860529,chr1,150860382,150860529,HepG2|chr1:148556478-148556628,chr1,148556478,148556628,0,2303904
HepG2|chr1:150872571-150872691,chr1,150872571,150872691,HepG2|chr1:148557628-148557658,chr1,148557628,148557658,0,2314943
HepG2|chr1:151010170-151010255,chr1,151010170,151010255,HepG2|chr1:148557625-148557689,chr1,148557625,148557689,0,2452545
HepG2|chr1:151014688-151014795,chr1,151014688,151014795,HepG2|chr1:235531154-235531189,chr1,235531154,235531189,0,84516466
HepG2|chr1:151078621-151078771,chr1,151078621,151078771,HepG2|chr1:148556296-148556443,chr1,148556296,148556443,0,2522325
HepG2|chr1:151383182-151383266,chr1,151383182,151383266,HepG2|chr1:173445770-173445788,chr1,173445770,173445788,0,22062588
HepG2|chr1:151509642-151509786,chr1,151509642,151509786,HepG2|chr1:40241541-40241691,chr1,40241541,40241691,0,111268101
HepG2|chr1:151977423-151977520,chr1,151977423,151977520,HepG2|chr1:148556691-148556777,chr1,148556691,148556777,0,3420732
HepG2|chr1:152559616-152559758,chr1,152559616,152559758,HepG2|chr1:148558082-148558228,chr1,148558082,148558228,0,4001534
HepG2|chr1:152666112-152666211,chr1,152666112,152666211,HepG2|chr1:178990498-178990546,chr1,178990498,178990546,0,26324386
HepG2|chr1:152698575-152698669,chr1,152698575,152698669,HepG2|chr1:148556276-148556426,chr1,148556276,148556426,0,4142299
HepG2|chr1:152833404-152833551,chr1,152833404,152833551,HepG2|chr1:149685087-149685212,chr1,149685087,149685212,0,3148317
HepG2|chr1:152853523-152853668,chr1,152853523,152853668,HepG2|chr1:148556504-148556654,chr1,148556504,148556654,0,4297019
HepG2|chr1:153009264-153009340,chr1,153009264,153009340,HepG2|chr1:148556153-148556180,chr1,148556153,148556180,0,4453111
HepG2|chr1:153084052-153084201,chr1,153084052,153084201,HepG2|chr1:148558238-148558388,chr1,148558238,148558388,0,4525814
HepG2|chr1:153440551-153440667,chr1,153440551,153440667,HepG2|chr1:235531154-235531187,chr1,235531154,235531187,0,82090603
HepG2|chr1:153495273-153495311,chr1,153495273,153495311,HepG2|chr1:148556143-148556180,chr1,148556143,148556180,0,4939130
HepG2|chr1:153521800-153521874,chr1,153521800,153521874,HepG2|chr1:247498152-247498228,chr1,247498152,247498228,0,93976352
HepG2|chr1:154053918-154054068,chr1,154053918,154054068,HepG2|chr1:148556571-148556721,chr1,148556571,148556721,0,5497347
HepG2|chr1:154606794-154606881,chr1,154606794,154606881,HepG2|chr1:148556180-148556325,chr1,148556180,148556325,0,6050614
HepG2|chr1:154821445-154821537,chr1,154821445,154821537,HepG2|chr1:33170116-33170180,chr1,33170116,33170180,0,121651329
HepG2|chr1:154912529-154912570,chr1,154912529,154912570,HepG2|chr1:120190693-120190802,chr1,120190693,120190802,0,34721836
HepG2|chr1:154971892-154971955,chr1,154971892,154971955,HepG2|chr1:148556132-148556180,chr1,148556132,148556180,0,6415760
HepG2|chr1:155090903-155091012,chr1,155090903,155091012,HepG2|chr1:235531154-235531187,chr1,235531154,235531187,0,80440251
HepG2|chr1:155209368-155209485,chr1,155209368,155209485,HepG2|chr1:148556214-148556357,chr1,148556214,148556357,0,6653154
HepG2|chr1:155223400-155223547,chr1,155223400,155223547,HepG2|chr1:148556264-148556413,chr1,148556264,148556413,0,6667136
HepG2|chr1:155327113-155327261,chr1,155327113,155327261,HepG2|chr1:148556230-148556380,chr1,148556230,148556380,0,6770883
HepG2|chr1:155427418-155427563,chr1,155427418,155427563,HepG2|chr1:148558160-148558286,chr1,148558160,148558286,0,6869258
HepG2|chr1:155523876-155524026,chr1,155523876,155524026,HepG2|chr1:148556502-148556644,chr1,148556502,148556644,0,6967374
HepG2|chr1:155715194-155715318,chr1,155715194,155715318,HepG2|chr1:148556345-148556369,chr1,148556345,148556369,0,7158849
HepG2|chr1:155938507-155938585,chr1,155938507,155938585,HepG2|chr1:148555857-148556007,chr1,148555857,148556007,0,7382650
HepG2|chr1:155952412-155952528,chr1,155952412,155952528,HepG2|chr1:148556183-148556333,chr1,148556183,148556333,0,7396229
HepG2|chr1:156199440-156199491,chr1,156199440,156199491,HepG2|chr1:120190693-120190815,chr1,120190693,120190815,0,36008747
HepG2|chr1:156508872-156509021,chr1,156508872,156509021,HepG2|chr1:148557628-148557704,chr1,148557628,148557704,0,7951244
HepG2|chr1:156590768-156590793,chr1,156590768,156590793,HepG2|chr1:153964644-153964715,chr1,153964644,153964715,0,2626124
HepG2|chr1:156692573-156692624,chr1,156692573,156692624,HepG2|chr1:167690874-167691024,chr1,167690874,167691024,0,10998301
HepG2|chr1:156778844-156778919,chr1,156778844,156778919,HepG2|chr1:148557625-148557709,chr1,148557625,148557709,0,8221219
HepG2|chr1:156789043-156789193,chr1,156789043,156789193,HepG2|chr1:12677891-12677952,chr1,12677891,12677952,0,144111152
HepG2|chr1:157108369-157108519,chr1,157108369,157108519,HepG2|chr1:247499340-247499401,chr1,247499340,247499401,0,90390971
HepG2|chr1:157577966-157578055,chr1,157577966,157578055,HepG2|chr1:12677891-12677952,chr1,12677891,12677952,0,144900075
HepG2|chr1:157631291-157631391,chr1,157631291,157631391,HepG2|chr1:245000045-245000132,chr1,245000045,245000132,0,87368754
HepG2|chr1:157876601-157876682,chr1,157876601,157876682,HepG2|chr1:247497795-247497855,chr1,247497795,247497855,0,89621194
HepG2|chr1:157977437-157977587,chr1,157977437,157977587,HepG2|chr1:148558160-148558299,chr1,148558160,148558299,0,9419277
HepG2|chr1:158310377-158310474,chr1,158310377,158310474,HepG2|chr1:148556134-148556180,chr1,148556134,148556180,0,9754243
HepG2|chr1:158487440-158487587,chr1,158487440,158487587,HepG2|chr1:40238414-40238466,chr1,40238414,40238466,0,118249026
HepG2|chr1:158543264-158543414,chr1,158543264,158543414,HepG2|chr1:148558238-148558388,chr1,148558238,148558388,0,9985026
HepG2|chr1:158566615-158566719,chr1,158566615,158566719,HepG2|chr1:28992994-28993050,chr1,28992994,28993050,0,129573621
HepG2|chr1:158614012-158614062,chr1,158614012,158614062,HepG2|chr1:3447363-3447490,chr1,3447363,3447490,0,155166649
HepG2|chr1:158755132-158755240,chr1,158755132,158755240,HepG2|chr1:225961309-225961351,chr1,225961309,225961351,0,67206177
HepG2|chr1:158859229-158859367,chr1,158859229,158859367,HepG2|chr1:205652616-205652703,chr1,205652616,205652703,0,46793387
HepG2|chr1:158924862-158925012,chr1,158924862,158925012,HepG2|chr1:148558152-148558302,chr1,148558152,148558302,0,10366710
HepG2|chr1:159246545-159246635,chr1,159246545,159246635,HepG2|chr1:148556135-148556180,chr1,148556135,148556180,0,10690410
HepG2|chr1:159247253-159247355,chr1,159247253,159247355,HepG2|chr1:148556130-148556180,chr1,148556130,148556180,0,10691123
HepG2|chr1:159263138-159263163,chr1,159263138,159263163,HepG2|chr1:148556210-148556360,chr1,148556210,148556360,0,10706928
HepG2|chr1:159549580-159549657,chr1,159549580,159549657,HepG2|chr1:148556206-148556353,chr1,148556206,148556353,0,10993374
HepG2|chr1:159750166-159750316,chr1,159750166,159750316,HepG2|chr1:148556468-148556618,chr1,148556468,148556618,0,11193698
HepG2|chr1:159750643-159750702,chr1,159750643,159750702,HepG2|chr1:15939163-15939229,chr1,15939163,15939229,0,143811480
HepG2|chr1:160118271-160118420,chr1,160118271,160118420,HepG2|chr1:148557600-148557652,chr1,148557600,148557652,0,11560671
HepG2|chr1:160387566-160387610,chr1,160387566,160387610,HepG2|chr1:247499946-247500049,chr1,247499946,247500049,0,87112380
HepG2|chr1:160432673-160432725,chr1,160432673,160432725,HepG2|chr1:153964601-153964721,chr1,153964601,153964721,0,6468072
HepG2|chr1:160736577-160736645,chr1,160736577,160736645,HepG2|chr1:148556141-148556180,chr1,148556141,148556180,0,12180436
HepG2|chr1:160904479-160904599,chr1,160904479,160904599,HepG2|chr1:148556267-148556416,chr1,148556267,148556416,0,12348212
HepG2|chr1:160913283-160913353,chr1,160913283,160913353,HepG2|chr1:26561669-26561748,chr1,26561669,26561748,0,134351614
HepG2|chr1:160971788-160971842,chr1,160971788,160971842,HepG2|chr1:153964654-153964721,chr1,153964654,153964721,0,7007134
HepG2|chr1:161377460-161377493,chr1,161377460,161377493,HepG2|chr1:33171928-33172064,chr1,33171928,33172064,0,128205532
HepG2|chr1:161465423-161465571,chr1,161465423,161465571,HepG2|chr1:33171403-33171466,chr1,33171403,33171466,0,128294020
HepG2|chr1:161489308-161489394,chr1,161489308,161489394,HepG2|chr1:148556202-148556349,chr1,148556202,148556349,0,12933106
HepG2|chr1:161561932-161562010,chr1,161561932,161562010,HepG2|chr1:37982293-37982365,chr1,37982293,37982365,0,123579639
HepG2|chr1:161858254-161858404,chr1,161858254,161858404,HepG2|chr1:148556569-148556718,chr1,148556569,148556718,0,13301685
HepG2|chr1:161926155-161926293,chr1,161926155,161926293,HepG2|chr1:148556123-148556180,chr1,148556123,148556180,0,13370032
HepG2|chr1:162060144-162060247,chr1,162060144,162060247,HepG2|chr1:148556134-148556180,chr1,148556134,148556180,0,13504010
HepG2|chr1:162231620-162231708,chr1,162231620,162231708,HepG2|chr1:148555829-148555979,chr1,148555829,148555979,0,13675791
HepG2|chr1:162255412-162255465,chr1,162255412,162255465,HepG2|chr1:153964686-153964721,chr1,153964686,153964721,0,8290726
HepG2|chr1:162354782-162354932,chr1,162354782,162354932,HepG2|chr1:148556869-148557004,chr1,148556869,148557004,0,13797913
HepG2|chr1:162452547-162452614,chr1,162452547,162452614,HepG2|chr1:148556148-148556180,chr1,148556148,148556180,0,13896399
HepG2|chr1:162534596-162534739,chr1,162534596,162534739,HepG2|chr1:148556249-148556399,chr1,148556249,148556399,0,13978347
HepG2|chr1:162568441-162568541,chr1,162568441,162568541,HepG2|chr1:245000045-245000132,chr1,245000045,245000132,0,82431604
HepG2|chr1:162799879-162800029,chr1,162799879,162800029,HepG2|chr1:148556370-148556423,chr1,148556370,148556423,0,14243509
HepG2|chr1:162906269-162906419,chr1,162906269,162906419,HepG2|chr1:148560503-148560539,chr1,148560503,148560539,0,14345766
HepG2|chr1:163269254-163269317,chr1,163269254,163269317,HepG2|chr1:220441237-220441314,chr1,220441237,220441314,0,57171983
HepG2|chr1:163275660-163275810,chr1,163275660,163275810,HepG2|chr1:148556562-148556709,chr1,148556562,148556709,0,14719098
HepG2|chr1:163682004-163682106,chr1,163682004,163682106,HepG2|chr1:22777902-22778052,chr1,22777902,22778052,0,140904102
HepG2|chr1:163994178-163994260,chr1,163994178,163994260,HepG2|chr1:148556229-148556379,chr1,148556229,148556379,0,15437949
HepG2|chr1:164374515-164374603,chr1,164374515,164374603,HepG2|chr1:247497977-247498127,chr1,247497977,247498127,0,83123462
HepG2|chr1:164695443-164695593,chr1,164695443,164695593,HepG2|chr1:148556296-148556443,chr1,148556296,148556443,0,16139147
HepG2|chr1:164859753-164859862,chr1,164859753,164859862,HepG2|chr1:100805718-100805865,chr1,100805718,100805865,0,64054035
HepG2|chr1:164899454-164899567,chr1,164899454,164899567,HepG2|chr1:148556154-148556180,chr1,148556154,148556180,0,16343300
HepG2|chr1:166149110-166149197,chr1,166149110,166149197,HepG2|chr1:148556153-148556180,chr1,148556153,148556180,0,17592957
HepG2|chr1:166182107-166182150,chr1,166182107,166182150,HepG2|chr1:153964666-153964721,chr1,153964666,153964721,0,12217441
HepG2|chr1:166374083-166374177,chr1,166374083,166374177,HepG2|chr1:33170035-33170182,chr1,33170035,33170182,0,133204048
HepG2|chr1:166440163-166440310,chr1,166440163,166440310,HepG2|chr1:148556143-148556180,chr1,148556143,148556180,0,17884020
HepG2|chr1:166505150-166505214,chr1,166505150,166505214,HepG2|chr1:148556132-148556180,chr1,148556132,148556180,0,17949018
HepG2|chr1:166618424-166618556,chr1,166618424,166618556,HepG2|chr1:148557625-148557704,chr1,148557625,148557704,0,18060799
HepG2|chr1:166909406-166909553,chr1,166909406,166909553,HepG2|chr1:148556600-148556750,chr1,148556600,148556750,0,18352806
HepG2|chr1:167040643-167040774,chr1,167040643,167040774,HepG2|chr1:148557625-148557655,chr1,148557625,148557655,0,18483018
HepG2|chr1:167248394-167248540,chr1,167248394,167248540,HepG2|chr1:148558040-148558189,chr1,148558040,148558189,0,18690354
HepG2|chr1:167449807-167449930,chr1,167449807,167449930,HepG2|chr1:247497893-247497913,chr1,247497893,247497913,0,80048086
HepG2|chr1:167657321-167657459,chr1,167657321,167657459,HepG2|chr1:148556635-148556741,chr1,148556635,148556741,0,19100686
HepG2|chr1:167946797-167946937,chr1,167946797,167946937,HepG2|chr1:245025570-245025608,chr1,245025570,245025608,0,77078773
HepG2|chr1:168182389-168182500,chr1,168182389,168182500,HepG2|chr1:247498919-247498955,chr1,247498919,247498955,0,79316530
HepG2|chr1:168325760-168325907,chr1,168325760,168325907,HepG2|chr1:148556691-148556710,chr1,148556691,148556710,0,19769069
HepG2|chr1:168647862-168647891,chr1,168647862,168647891,HepG2|chr1:148556153-148556180,chr1,148556153,148556180,0,20091709
HepG2|chr1:168837648-168837795,chr1,168837648,168837795,HepG2|chr1:40238414-40238466,chr1,40238414,40238466,0,128599234
HepG2|chr1:168871350-168871430,chr1,168871350,168871430,HepG2|chr1:148556133-148556180,chr1,148556133,148556180,0,20315217
HepG2|chr1:169105395-169105545,chr1,169105395,169105545,HepG2|chr1:148558160-148558286,chr1,148558160,148558286,0,20547235
HepG2|chr1:169135118-169135140,chr1,169135118,169135140,HepG2|chr1:247497320-247497447,chr1,247497320,247497447,0,78362202
HepG2|chr1:169148639-169148727,chr1,169148639,169148727,HepG2|chr1:148555829-148555979,chr1,148555829,148555979,0,20592810
HepG2|chr1:169226904-169227054,chr1,169226904,169227054,HepG2|chr1:148558202-148558352,chr1,148558202,148558352,0,20668702
HepG2|chr1:169284823-169284866,chr1,169284823,169284866,HepG2|chr1:150460059-150460131,chr1,150460059,150460131,0,18824764
HepG2|chr1:169491875-169491912,chr1,169491875,169491912,HepG2|chr1:179197937-179198050,chr1,179197937,179198050,0,9706062
HepG2|chr1:169574637-169574787,chr1,169574637,169574787,HepG2|chr1:22262450-22262469,chr1,22262450,22262469,0,147312187
HepG2|chr1:170138403-170138425,chr1,170138403,170138425,HepG2|chr1:174966681-174966809,chr1,174966681,174966809,0,4828278
HepG2|chr1:170442894-170443044,chr1,170442894,170443044,HepG2|chr1:247499340-247499401,chr1,247499340,247499401,0,77056446
HepG2|chr1:170495344-170495475,chr1,170495344,170495475,HepG2|chr1:22262450-22262469,chr1,22262450,22262469,0,148232894
HepG2|chr1:170825963-170826110,chr1,170825963,170826110,HepG2|chr1:148556579-148556729,chr1,148556579,148556729,0,22269384
HepG2|chr1:170866635-170866716,chr1,170866635,170866716,HepG2|chr1:148556212-148556358,chr1,148556212,148556358,0,22310423
HepG2|chr1:170893640-170893774,chr1,170893640,170893774,HepG2|chr1:156022645-156022745,chr1,156022645,156022745,0,14870995
HepG2|chr1:171062292-171062385,chr1,171062292,171062385,HepG2|chr1:100805718-100805865,chr1,100805718,100805865,0,70256574
HepG2|chr1:171280760-171280868,chr1,171280760,171280868,HepG2|chr1:148556153-148556180,chr1,148556153,148556180,0,22724607
HepG2|chr1:172092968-172093064,chr1,172092968,172093064,HepG2|chr1:226251053-226251104,chr1,226251053,226251104,0,54158085
HepG2|chr1:172333831-172333941,chr1,172333831,172333941,HepG2|chr1:31383170-31383203,chr1,31383170,31383203,0,140950661
HepG2|chr1:172445226-172445376,chr1,172445226,172445376,HepG2|chr1:148556294-148556444,chr1,148556294,148556444,0,23888932
HepG2|chr1:172445706-172445853,chr1,172445706,172445853,HepG2|chr1:148556286-148556436,chr1,148556286,148556436,0,23889420
HepG2|chr1:172474091-172474127,chr1,172474091,172474127,HepG2|chr1:148556876-148556958,chr1,148556876,148556958,0,23917215
HepG2|chr1:172729990-172730008,chr1,172729990,172730008,HepG2|chr1:108229196-108229315,chr1,108229196,108229315,0,64500794
HepG2|chr1:172974216-172974252,chr1,172974216,172974252,HepG2|chr1:6507200-6507255,chr1,6507200,6507255,0,166467016
HepG2|chr1:173060903-173060958,chr1,173060903,173060958,HepG2|chr1:247497320-247497447,chr1,247497320,247497447,0,74436417
HepG2|chr1:173133305-173133455,chr1,173133305,173133455,HepG2|chr1:148556908-148557058,chr1,148556908,148557058,0,24576397
HepG2|chr1:173334766-173334799,chr1,173334766,173334799,HepG2|chr1:33171928-33172064,chr1,33171928,33172064,0,140162838
HepG2|chr1:173511352-173511498,chr1,173511352,173511498,HepG2|chr1:148558235-148558384,chr1,148558235,148558384,0,24953117
HepG2|chr1:173999320-173999466,chr1,173999320,173999466,HepG2|chr1:173444013-173444054,chr1,173444013,173444054,0,555307
HepG2|chr1:174046195-174046345,chr1,174046195,174046345,HepG2|chr1:247499533-247499552,chr1,247499533,247499552,0,73453338
HepG2|chr1:174703253-174703399,chr1,174703253,174703399,HepG2|chr1:149684996-149685146,chr1,149684996,149685146,0,25018257
HepG2|chr1:174767743-174767765,chr1,174767743,174767765,HepG2|chr1:174966681-174966809,chr1,174966681,174966809,0,198938
HepG2|chr1:174805963-174805980,chr1,174805963,174805980,HepG2|chr1:148556364-148556420,chr1,148556364,148556420,0,26249599
HepG2|chr1:174841817-174841887,chr1,174841817,174841887,HepG2|chr1:156113494-156113571,chr1,156113494,156113571,0,18728323
HepG2|chr1:174889815-174889964,chr1,174889815,174889964,HepG2|chr1:148556593-148556743,chr1,148556593,148556743,0,26333222
HepG2|chr1:175026457-175026546,chr1,175026457,175026546,HepG2|chr1:120190693-120190752,chr1,120190693,120190752,0,54835764
HepG2|chr1:175528984-175529097,chr1,175528984,175529097,HepG2|chr1:167690855-167690892,chr1,167690855,167690892,0,7838129
HepG2|chr1:176126797-176126841,chr1,176126797,176126841,HepG2|chr1:153964695-153964721,chr1,153964695,153964721,0,22162102
HepG2|chr1:176240207-176240357,chr1,176240207,176240357,HepG2|chr1:148558235-148558384,chr1,148558235,148558384,0,27681972
HepG2|chr1:176268646-176268796,chr1,176268646,176268796,HepG2|chr1:16862452-16862602,chr1,16862452,16862602,0,159406194
HepG2|chr1:176409663-176409685,chr1,176409663,176409685,HepG2|chr1:153964695-153964721,chr1,153964695,153964721,0,22444968
HepG2|chr1:176570870-176570924,chr1,176570870,176570924,HepG2|chr1:153964654-153964721,chr1,153964654,153964721,0,22606216
HepG2|chr1:177112607-177112734,chr1,177112607,177112734,HepG2|chr1:235323075-235323119,chr1,235323075,235323119,0,58210468
HepG2|chr1:177451570-177451717,chr1,177451570,177451717,HepG2|chr1:148556576-148556725,chr1,148556576,148556725,0,28894994
HepG2|chr1:178197811-178197923,chr1,178197811,178197923,HepG2|chr1:247499397-247499515,chr1,247499397,247499515,0,69301586
HepG2|chr1:178252226-178252360,chr1,178252226,178252360,HepG2|chr1:148556130-148556180,chr1,148556130,148556180,0,29696096
HepG2|chr1:178565167-178565197,chr1,178565167,178565197,HepG2|chr1:153964655-153964721,chr1,153964655,153964721,0,24600512
HepG2|chr1:178754009-178754159,chr1,178754009,178754159,HepG2|chr1:148556466-148556616,chr1,148556466,148556616,0,30197543
HepG2|chr1:178761119-178761269,chr1,178761119,178761269,HepG2|chr1:1282518-1282592,chr1,1282518,1282592,0,177478601
HepG2|chr1:178935031-178935131,chr1,178935031,178935131,HepG2|chr1:25561671-25561785,chr1,25561671,25561785,0,153373360
HepG2|chr1:179859529-179859679,chr1,179859529,179859679,HepG2|chr1:167690855-167690928,chr1,167690855,167690928,0,12168674
HepG2|chr1:179925302-179925442,chr1,179925302,179925442,HepG2|chr1:148556571-148556721,chr1,148556571,148556721,0,31368731
HepG2|chr1:180012645-180012729,chr1,180012645,180012729,HepG2|chr1:148556209-148556359,chr1,148556209,148556359,0,31456436
HepG2|chr1:180586644-180586710,chr1,180586644,180586710,HepG2|chr1:245000232-245000265,chr1,245000232,245000265,0,64413588
HepG2|chr1:180693692-180693816,chr1,180693692,180693816,HepG2|chr1:247497893-247497913,chr1,247497893,247497913,0,66804201
HepG2|chr1:181154429-181154543,chr1,181154429,181154543,HepG2|chr1:148556180-148556318,chr1,148556180,148556318,0,32598249
HepG2|chr1:181238286-181238424,chr1,181238286,181238424,HepG2|chr1:205652616-205652703,chr1,205652616,205652703,0,24414330
HepG2|chr1:181328888-181328909,chr1,181328888,181328909,HepG2|chr1:245019113-245019216,chr1,245019113,245019216,0,63690225
HepG2|chr1:181467415-181467442,chr1,181467415,181467442,HepG2|chr1:205652586-205652703,chr1,205652586,205652703,0,24185171
HepG2|chr1:181499375-181499525,chr1,181499375,181499525,HepG2|chr1:148556294-148556444,chr1,148556294,148556444,0,32943081
HepG2|chr1:181553354-181553504,chr1,181553354,181553504,HepG2|chr1:148556921-148557071,chr1,148556921,148557071,0,32996433
HepG2|chr1:182245394-182245476,chr1,182245394,182245476,HepG2|chr1:173836015-173836065,chr1,173836015,173836065,0,8409379
HepG2|chr1:182659144-182659180,chr1,182659144,182659180,HepG2|chr1:148556876-148556958,chr1,148556876,148556958,0,34102268
HepG2|chr1:183086420-183086570,chr1,183086420,183086570,HepG2|chr1:148556905-148557055,chr1,148556905,148557055,0,34529515
HepG2|chr1:183157664-183157814,chr1,183157664,183157814,HepG2|chr1:31383170-31383204,chr1,31383170,31383204,0,151774494
HepG2|chr1:183282656-183282743,chr1,183282656,183282743,HepG2|chr1:148556135-148556180,chr1,148556135,148556180,0,34726521
HepG2|chr1:183536226-183536275,chr1,183536226,183536275,HepG2|chr1:173445770-173445787,chr1,173445770,173445787,0,10090456
HepG2|chr1:183610804-183610879,chr1,183610804,183610879,HepG2|chr1:205601761-205601832,chr1,205601761,205601832,0,21990957
HepG2|chr1:183768135-183768285,chr1,183768135,183768285,HepG2|chr1:148556319-148556377,chr1,148556319,148556377,0,35211816
HepG2|chr1:183812861-183813009,chr1,183812861,183813009,HepG2|chr1:148556183-148556331,chr1,148556183,148556331,0,35256678
HepG2|chr1:184009380-184009530,chr1,184009380,184009530,HepG2|chr1:145611439-145611589,chr1,145611439,145611589,0,38397941
HepG2|chr1:184093338-184093390,chr1,184093338,184093390,HepG2|chr1:245020750-245020900,chr1,245020750,245020900,0,60927412
HepG2|chr1:184222645-184222695,chr1,184222645,184222695,HepG2|chr1:247497791-247497830,chr1,247497791,247497830,0,63275146
HepG2|chr1:184244878-184244974,chr1,184244878,184244974,HepG2|chr1:179197937-179198050,chr1,179197937,179198050,0,5046941
HepG2|chr1:184256100-184256169,chr1,184256100,184256169,HepG2|chr1:148556208-148556354,chr1,148556208,148556354,0,35699892
HepG2|chr1:184350524-184350603,chr1,184350524,184350603,HepG2|chr1:205601761-205601832,chr1,205601761,205601832,0,21251237
HepG2|chr1:184615252-184615402,chr1,184615252,184615402,HepG2|chr1:148556345-148556391,chr1,148556345,148556391,0,36058907
HepG2|chr1:184693992-184694094,chr1,184693992,184694094,HepG2|chr1:148556130-148556180,chr1,148556130,148556180,0,36137862
HepG2|chr1:184726591-184726738,chr1,184726591,184726738,HepG2|chr1:148556576-148556725,chr1,148556576,148556725,0,36170015
HepG2|chr1:184896079-184896213,chr1,184896079,184896213,HepG2|chr1:156022645-156022745,chr1,156022645,156022745,0,28873434
HepG2|chr1:185061712-185061862,chr1,185061712,185061862,HepG2|chr1:148556816-148556867,chr1,148556816,148556867,0,36504896
HepG2|chr1:185335205-185335232,chr1,185335205,185335232,HepG2|chr1:205652586-205652703,chr1,205652586,205652703,0,20317381
HepG2|chr1:185878176-185878323,chr1,185878176,185878323,HepG2|chr1:148557628-148557658,chr1,148557628,148557658,0,37320548
HepG2|chr1:186046840-186046949,chr1,186046840,186046949,HepG2|chr1:173444013-173444054,chr1,173444013,173444054,0,12602827
HepG2|chr1:186062937-186063069,chr1,186062937,186063069,HepG2|chr1:148556217-148556367,chr1,148556217,148556367,0,37506720
HepG2|chr1:186065997-186066062,chr1,186065997,186066062,HepG2|chr1:120190693-120190823,chr1,120190693,120190823,0,65875304
HepG2|chr1:186097686-186097719,chr1,186097686,186097719,HepG2|chr1:153964641-153964721,chr1,153964641,153964721,0,32133045
HepG2|chr1:186293941-186293963,chr1,186293941,186293963,HepG2|chr1:247497320-247497447,chr1,247497320,247497447,0,61203379
HepG2|chr1:186436263-186436413,chr1,186436263,186436413,HepG2|chr1:148556294-148556444,chr1,148556294,148556444,0,37879969
HepG2|chr1:186785062-186785158,chr1,186785062,186785158,HepG2|chr1:148556180-148556316,chr1,148556180,148556316,0,38228882
HepG2|chr1:187017555-187017705,chr1,187017555,187017705,HepG2|chr1:148558086-148558235,chr1,148558086,148558235,0,38459469
HepG2|chr1:187253419-187253499,chr1,187253419,187253499,HepG2|chr1:228595215-228595285,chr1,228595215,228595285,0,41341796
HepG2|chr1:187355135-187355224,chr1,187355135,187355224,HepG2|chr1:148556691-148556733,chr1,148556691,148556733,0,38798444
HepG2|chr1:187977055-187977128,chr1,187977055,187977128,HepG2|chr1:148556465-148556515,chr1,148556465,148556515,0,39420590
HepG2|chr1:188002164-188002194,chr1,188002164,188002194,HepG2|chr1:200634577-200634722,chr1,200634577,200634722,0,12632413
HepG2|chr1:188092518-188092606,chr1,188092518,188092606,HepG2|chr1:148556209-148556359,chr1,148556209,148556359,0,39536309
HepG2|chr1:188144051-188144076,chr1,188144051,188144076,HepG2|chr1:148555829-148555979,chr1,148555829,148555979,0,39588222
HepG2|chr1:188220552-188220633,chr1,188220552,188220633,HepG2|chr1:247497795-247497855,chr1,247497795,247497855,0,59277243
HepG2|chr1:188367377-188367459,chr1,188367377,188367459,HepG2|chr1:148556135-148556180,chr1,148556135,148556180,0,39811242
HepG2|chr1:188446470-188446588,chr1,188446470,188446588,HepG2|chr1:148556061-148556120,chr1,148556061,148556120,0,39890409
HepG2|chr1:188529606-188529624,chr1,188529606,188529624,HepG2|chr1:148556204-148556354,chr1,148556204,148556354,0,39973402
HepG2|chr1:188559035-188559128,chr1,188559035,188559128,HepG2|chr1:225964812-225964857,chr1,225964812,225964857,0,37405777
HepG2|chr1:189301033-189301053,chr1,189301033,189301053,HepG2|chr1:33170071-33170180,chr1,33170071,33170180,0,156130962
HepG2|chr1:189334415-189334549,chr1,189334415,189334549,HepG2|chr1:148556135-148556180,chr1,148556135,148556180,0,40778280
HepG2|chr1:189400657-189400804,chr1,189400657,189400804,HepG2|chr1:109851507-109851569,chr1,109851507,109851569,0,79549150
HepG2|chr1:189661004-189661153,chr1,189661004,189661153,HepG2|chr1:148558160-148558287,chr1,148558160,148558287,0,41102844
HepG2|chr1:189998213-189998338,chr1,189998213,189998338,HepG2|chr1:148558080-148558230,chr1,148558080,148558230,0,41440133
HepG2|chr1:190272543-190272643,chr1,190272543,190272643,HepG2|chr1:45255492-45255566,chr1,45255492,45255566,0,145017051
HepG2|chr1:190705527-190705677,chr1,190705527,190705677,HepG2|chr1:148556885-148557035,chr1,148556885,148557035,0,42148642
HepG2|chr1:190822305-190822374,chr1,190822305,190822374,HepG2|chr1:31539734-31539777,chr1,31539734,31539777,0,159282571
HepG2|chr1:191145968-191146054,chr1,191145968,191146054,HepG2|chr1:37982301-37982365,chr1,37982301,37982365,0,153163667
HepG2|chr1:191356160-191356310,chr1,191356160,191356310,HepG2|chr1:148556132-148556180,chr1,148556132,148556180,0,42800028
HepG2|chr1:191412084-191412109,chr1,191412084,191412109,HepG2|chr1:148555829-148555979,chr1,148555829,148555979,0,42856255
HepG2|chr1:191634178-191634271,chr1,191634178,191634271,HepG2|chr1:225964812-225964857,chr1,225964812,225964857,0,34330634
HepG2|chr1:191820452-191820585,chr1,191820452,191820585,HepG2|chr1:225961309-225961351,chr1,225961309,225961351,0,34140857
HepG2|chr1:192218597-192218635,chr1,192218597,192218635,HepG2|chr1:245025641-245025697,chr1,245025641,245025697,0,52807044
HepG2|chr1:192332931-192333081,chr1,192332931,192333081,HepG2|chr1:148558200-148558318,chr1,148558200,148558318,0,43774731
HepG2|chr1:192432746-192432887,chr1,192432746,192432887,HepG2|chr1:148558133-148558281,chr1,148558133,148558281,0,43874613
HepG2|chr1:192479837-192479861,chr1,192479837,192479861,HepG2|chr1:226252827-226252953,chr1,226252827,226252953,0,33772990
HepG2|chr1:192506809-192506959,chr1,192506809,192506959,HepG2|chr1:22775780-22775919,chr1,22775780,22775919,0,169731029
HepG2|chr1:192637969-192638104,chr1,192637969,192638104,HepG2|chr1:148556147-148556180,chr1,148556147,148556180,0,44081822
HepG2|chr1:193067832-193067917,chr1,193067832,193067917,HepG2|chr1:174966720-174966831,chr1,174966720,174966831,0,18101112
HepG2|chr1:193078149-193078210,chr1,193078149,193078210,HepG2|chr1:148558085-148558232,chr1,148558085,148558232,0,44520064
HepG2|chr1:193377907-193378052,chr1,193377907,193378052,HepG2|chr1:225964643-225964711,chr1,225964643,225964711,0,32586736
HepG2|chr1:193415840-193415949,chr1,193415840,193415949,HepG2|chr1:235531154-235531187,chr1,235531154,235531187,0,42115314
HepG2|chr1:193732358-193732508,chr1,193732358,193732508,HepG2|chr1:149684993-149685143,chr1,149684993,149685143,0,44047365
HepG2|chr1:194165501-194165573,chr1,194165501,194165573,HepG2|chr1:46154048-46154134,chr1,46154048,46154134,0,148011453
HepG2|chr1:194288467-194288614,chr1,194288467,194288614,HepG2|chr1:6510867-6510920,chr1,6510867,6510920,0,187777600
HepG2|chr1:195036180-195036330,chr1,195036180,195036330,HepG2|chr1:148558185-148558332,chr1,148558185,148558332,0,46477995
HepG2|chr1:195332726-195332871,chr1,195332726,195332871,HepG2|chr1:148556466-148556616,chr1,148556466,148556616,0,46776260
HepG2|chr1:195693426-195693576,chr1,195693426,195693576,HepG2|chr1:148556628-148556778,chr1,148556628,148556778,0,47136798
HepG2|chr1:196371873-196371953,chr1,196371873,196371953,HepG2|chr1:228595215-228595285,chr1,228595215,228595285,0,32223342
HepG2|chr1:196517184-196517212,chr1,196517184,196517212,HepG2|chr1:120190693-120190815,chr1,120190693,120190815,0,76326491
HepG2|chr1:196540234-196540379,chr1,196540234,196540379,HepG2|chr1:148556319-148556398,chr1,148556319,148556398,0,47983915
HepG2|chr1:196820633-196820686,chr1,196820633,196820686,HepG2|chr1:148557509-148557628,chr1,148557509,148557628,0,48263124
HepG2|chr1:197111012-197111109,chr1,197111012,197111109,HepG2|chr1:226251053-226251104,chr1,226251053,226251104,0,29140041
HepG2|chr1:197277415-197277495,chr1,197277415,197277495,HepG2|chr1:228595215-228595285,chr1,228595215,228595285,0,31317800
HepG2|chr1:197658847-197658929,chr1,197658847,197658929,HepG2|chr1:148556135-148556180,chr1,148556135,148556180,0,49102712
HepG2|chr1:197809136-197809179,chr1,197809136,197809179,HepG2|chr1:153964666-153964721,chr1,153964666,153964721,0,43844470
HepG2|chr1:198243943-198243971,chr1,198243943,198243971,HepG2|chr1:120190693-120190815,chr1,120190693,120190815,0,78053250
HepG2|chr1:198385945-198385972,chr1,198385945,198385972,HepG2|chr1:153964701-153964721,chr1,153964701,153964721,0,44421244
HepG2|chr1:198398141-198398251,chr1,198398141,198398251,HepG2|chr1:31383170-31383203,chr1,31383170,31383203,0,167014971
HepG2|chr1:198473817-198473848,chr1,198473817,198473848,HepG2|chr1:201924301-201924417,chr1,201924301,201924417,0,3450484
HepG2|chr1:198507296-198507374,chr1,198507296,198507374,HepG2|chr1:148557628-148557689,chr1,148557628,148557689,0,49949668
HepG2|chr1:198644537-198644656,chr1,198644537,198644656,HepG2|chr1:148558119-148558262,chr1,148558119,148558262,0,50086418
HepG2|chr1:198791117-198791265,chr1,198791117,198791265,HepG2|chr1:33171403-33171466,chr1,33171403,33171466,0,165619714
HepG2|chr1:199101867-199101930,chr1,199101867,199101930,HepG2|chr1:148558084-148558229,chr1,148558084,148558229,0,50543783
HepG2|chr1:199252019-199252050,chr1,199252019,199252050,HepG2|chr1:153964580-153964722,chr1,153964580,153964722,0,45287439
HepG2|chr1:199278052-199278202,chr1,199278052,199278202,HepG2|chr1:148556481-148556631,chr1,148556481,148556631,0,50721571
HepG2|chr1:199326682-199326832,chr1,199326682,199326832,HepG2|chr1:148558202-148558352,chr1,148558202,148558352,0,50768480
HepG2|chr1:199355272-199355418,chr1,199355272,199355418,HepG2|chr1:148556272-148556422,chr1,148556272,148556422,0,50799000
HepG2|chr1:199406347-199406497,chr1,199406347,199406497,HepG2|chr1:148556628-148556778,chr1,148556628,148556778,0,50849719
HepG2|chr1:199425803-199425953,chr1,199425803,199425953,HepG2|chr1:148558160-148558305,chr1,148558160,148558305,0,50867643
HepG2|chr1:199547269-199547419,chr1,199547269,199547419,HepG2|chr1:148558278-148558331,chr1,148558278,148558331,0,50988991
HepG2|chr1:199842636-199842773,chr1,199842636,199842773,HepG2|chr1:40237931-40238081,chr1,40237931,40238081,0,159604705
HepG2|chr1:199856379-199856442,chr1,199856379,199856442,HepG2|chr1:245000045-245000132,chr1,245000045,245000132,0,45143666
HepG2|chr1:199990803-199990953,chr1,199990803,199990953,HepG2|chr1:148556634-148556776,chr1,148556634,148556776,0,51434169
HepG2|chr1:200776962-200777044,chr1,200776962,200777044,HepG2|chr1:148556229-148556379,chr1,148556229,148556379,0,52220733
HepG2|chr1:200888907-200889057,chr1,200888907,200889057,HepG2|chr1:148558066-148558216,chr1,148558066,148558216,0,52330841
HepG2|chr1:200989112-200989218,chr1,200989112,200989218,HepG2|chr1:28992994-28993052,chr1,28992994,28993052,0,171996118
HepG2|chr1:201088450-201088563,chr1,201088450,201088563,HepG2|chr1:167690855-167690892,chr1,167690855,167690892,0,33397595
HepG2|chr1:201113713-201113794,chr1,201113713,201113794,HepG2|chr1:247496594-247496689,chr1,247496594,247496689,0,46382881
HepG2|chr1:201374442-201374592,chr1,201374442,201374592,HepG2|chr1:148558259-148558409,chr1,148558259,148558409,0,52816183
HepG2|chr1:201532933-201533082,chr1,201532933,201533082,HepG2|chr1:148556135-148556180,chr1,148556135,148556180,0,52976798
HepG2|chr1:202003765-202003915,chr1,202003765,202003915,HepG2|chr1:148556880-148556942,chr1,148556880,148556942,0,53446885
HepG2|chr1:202082482-202082629,chr1,202082482,202082629,HepG2|chr1:148556090-148556240,chr1,148556090,148556240,0,53526392
HepG2|chr1:202629248-202629314,chr1,202629248,202629314,HepG2|chr1:31539734-31539777,chr1,31539734,31539777,0,171089514
HepG2|chr1:203203179-203203260,chr1,203203179,203203260,HepG2|chr1:247496606-247496632,chr1,247496606,247496632,0,44293427
HepG2|chr1:203783631-203783769,chr1,203783631,203783769,HepG2|chr1:148556294-148556444,chr1,148556294,148556444,0,55227337
HepG2|chr1:204078254-204078293,chr1,204078254,204078293,HepG2|chr1:148557625-148557732,chr1,148557625,148557732,0,55520629
HepG2|chr1:204466322-204466378,chr1,204466322,204466378,HepG2|chr1:148556591-148556741,chr1,148556591,148556741,0,55909731
HepG2|chr1:204943356-204943498,chr1,204943356,204943498,HepG2|chr1:148556915-148557065,chr1,148556915,148557065,0,56386441
HepG2|chr1:205569580-205569655,chr1,205569580,205569655,HepG2|chr1:220443804-220443954,chr1,220443804,220443954,0,14874224
HepG2|chr1:205738030-205738151,chr1,205738030,205738151,HepG2|chr1:148557625-148557707,chr1,148557625,148557707,0,57180405
HepG2|chr1:205867707-205867736,chr1,205867707,205867736,HepG2|chr1:228603863-228603984,chr1,228603863,228603984,0,22736156
HepG2|chr1:206124445-206124482,chr1,206124445,206124482,HepG2|chr1:36686019-36686091,chr1,36686019,36686091,0,169438426
HepG2|chr1:206285904-206285925,chr1,206285904,206285925,HepG2|chr1:148556690-148556716,chr1,148556690,148556716,0,57729214
HepG2|chr1:206308399-206308549,chr1,206308399,206308549,HepG2|chr1:148558259-148558409,chr1,148558259,148558409,0,57750140
HepG2|chr1:206359272-206359323,chr1,206359272,206359323,HepG2|chr1:245022842-245022941,chr1,245022842,245022941,0,38663570
HepG2|chr1:206400660-206400809,chr1,206400660,206400809,HepG2|chr1:148556930-148557080,chr1,148556930,148557080,0,57843730
HepG2|chr1:206414221-206414333,chr1,206414221,206414333,HepG2|chr1:245025570-245025608,chr1,245025570,245025608,0,38611349
HepG2|chr1:206569869-206569976,chr1,206569869,206569976,HepG2|chr1:148556876-148556962,chr1,148556876,148556962,0,58012993
HepG2|chr1:206626476-206626596,chr1,206626476,206626596,HepG2|chr1:148557600-148557661,chr1,148557600,148557661,0,58068876
HepG2|chr1:206697288-206697438,chr1,206697288,206697438,HepG2|chr1:148558160-148558305,chr1,148558160,148558305,0,58139128
HepG2|chr1:206736150-206736233,chr1,206736150,206736233,HepG2|chr1:33171400-33171466,chr1,33171400,33171466,0,173564750
HepG2|chr1:206945540-206945682,chr1,206945540,206945682,HepG2|chr1:148556130-148556180,chr1,148556130,148556180,0,58389410
HepG2|chr1:207063554-207063627,chr1,207063554,207063627,HepG2|chr1:167690855-167690928,chr1,167690855,167690928,0,39372699
HepG2|chr1:207342488-207342573,chr1,207342488,207342573,HepG2|chr1:228656169-228656231,chr1,228656169,228656231,0,21313681
HepG2|chr1:207445423-207445573,chr1,207445423,207445573,HepG2|chr1:148557600-148557652,chr1,148557600,148557652,0,58887823
HepG2|chr1:207449815-207449965,chr1,207449815,207449965,HepG2|chr1:148558086-148558235,chr1,148558086,148558235,0,58891729
HepG2|chr1:207584280-207584430,chr1,207584280,207584430,HepG2|chr1:149684820-149684967,chr1,149684820,149684967,0,57899460
HepG2|chr1:207626207-207626250,chr1,207626207,207626250,HepG2|chr1:148556691-148556773,chr1,148556691,148556773,0,59069516
HepG2|chr1:208329496-208329646,chr1,208329496,208329646,HepG2|chr1:148558219-148558369,chr1,148558219,148558369,0,59771277
HepG2|chr1:208402020-208402166,chr1,208402020,208402166,HepG2|chr1:148556476-148556626,chr1,148556476,148556626,0,59845544
HepG2|chr1:208416948-208417098,chr1,208416948,208417098,HepG2|chr1:148558066-148558216,chr1,148558066,148558216,0,59858882
HepG2|chr1:208554560-208554671,chr1,208554560,208554671,HepG2|chr1:174966681-174966809,chr1,174966681,174966809,0,33587879
HepG2|chr1:208709723-208709836,chr1,208709723,208709836,HepG2|chr1:148556133-148556180,chr1,148556133,148556180,0,60153590
HepG2|chr1:208863681-208863831,chr1,208863681,208863831,HepG2|chr1:54410614-54410657,chr1,54410614,54410657,0,154453067
HepG2|chr1:208867317-208867346,chr1,208867317,208867346,HepG2|chr1:148556138-148556180,chr1,148556138,148556180,0,60311179
HepG2|chr1:208938172-208938321,chr1,208938172,208938321,HepG2|chr1:148556045-148556170,chr1,148556045,148556170,0,60382127
HepG2|chr1:209198723-209198838,chr1,209198723,209198838,HepG2|chr1:148556143-148556180,chr1,148556143,148556180,0,60642580
HepG2|chr1:209721395-209721507,chr1,209721395,209721507,HepG2|chr1:148557625-148557669,chr1,148557625,148557669,0,61163770
HepG2|chr1:209733973-209734090,chr1,209733973,209734090,HepG2|chr1:228656174-228656230,chr1,228656174,228656230,0,18922201
HepG2|chr1:209939068-209939218,chr1,209939068,209939218,HepG2|chr1:148558160-148558300,chr1,148558160,148558300,0,61380908
HepG2|chr1:209958620-209958765,chr1,209958620,209958765,HepG2|chr1:8481219-8481269,chr1,8481219,8481269,0,201477401
HepG2|chr1:210001742-210001892,chr1,210001742,210001892,HepG2|chr1:148558202-148558352,chr1,148558202,148558352,0,61443540
HepG2|chr1:210166863-210166946,chr1,210166863,210166946,HepG2|chr1:33171400-33171466,chr1,33171400,33171466,0,176995463
HepG2|chr1:210181226-210181360,chr1,210181226,210181360,HepG2|chr1:148556130-148556180,chr1,148556130,148556180,0,61625096
HepG2|chr1:210301639-210301775,chr1,210301639,210301775,HepG2|chr1:247498777-247498875,chr1,247498777,247498875,0,37197138
HepG2|chr1:210549564-210549595,chr1,210549564,210549595,HepG2|chr1:148558206-148558356,chr1,148558206,148558356,0,61991358
HepG2|chr1:210575064-210575136,chr1,210575064,210575136,HepG2|chr1:156113494-156113571,chr1,156113494,156113571,0,54461570
HepG2|chr1:210661598-210661647,chr1,210661598,210661647,HepG2|chr1:148556364-148556407,chr1,148556364,148556407,0,62105234
HepG2|chr1:210712500-210712650,chr1,210712500,210712650,HepG2|chr1:40241552-40241702,chr1,40241552,40241702,0,170470948
HepG2|chr1:211237358-211237508,chr1,211237358,211237508,HepG2|chr1:167690855-167690928,chr1,167690855,167690928,0,43546503
HepG2|chr1:211800821-211800971,chr1,211800821,211800971,HepG2|chr1:247499533-247499552,chr1,247499533,247499552,0,35698712
HepG2|chr1:212199055-212199205,chr1,212199055,212199205,HepG2|chr1:148556869-148557014,chr1,148556869,148557014,0,63642186
HepG2|chr1:212297963-212298107,chr1,212297963,212298107,HepG2|chr1:167690828-167690893,chr1,167690828,167690893,0,44607135
HepG2|chr1:212360772-212360809,chr1,212360772,212360809,HepG2|chr1:245025596-245025697,chr1,245025596,245025697,0,32664824
HepG2|chr1:212577396-212577546,chr1,212577396,212577546,HepG2|chr1:148556502-148556644,chr1,148556502,148556644,0,64020894
HepG2|chr1:212593990-212594137,chr1,212593990,212594137,HepG2|chr1:148556287-148556434,chr1,148556287,148556434,0,64037703
HepG2|chr1:212617927-212618035,chr1,212617927,212618035,HepG2|chr1:63154356-63154395,chr1,63154356,63154395,0,149463571
HepG2|chr1:212704991-212705141,chr1,212704991,212705141,HepG2|chr1:148557625-148557698,chr1,148557625,148557698,0,64147366
HepG2|chr1:213191758-213191844,chr1,213191758,213191844,HepG2|chr1:148556202-148556349,chr1,148556202,148556349,0,64635556
HepG2|chr1:213362133-213362226,chr1,213362133,213362226,HepG2|chr1:174966482-174966539,chr1,174966482,174966539,0,38395651
HepG2|chr1:213465946-213465975,chr1,213465946,213465975,HepG2|chr1:148556153-148556180,chr1,148556153,148556180,0,64909793
HepG2|chr1:213691791-213691928,chr1,213691791,213691928,HepG2|chr1:148557627-148557701,chr1,148557627,148557701,0,65134164
HepG2|chr1:213711611-213711648,chr1,213711611,213711648,HepG2|chr1:148558145-148558287,chr1,148558145,148558287,0,65153466
HepG2|chr1:213859460-213859536,chr1,213859460,213859536,HepG2|chr1:45255492-45255566,chr1,45255492,45255566,0,168603968
HepG2|chr1:214017696-214017730,chr1,214017696,214017730,HepG2|chr1:228300737-228300850,chr1,228300737,228300850,0,14283041
HepG2|chr1:214281701-214281788,chr1,214281701,214281788,HepG2|chr1:109851507-109851569,chr1,109851507,109851569,0,104430194
HepG2|chr1:214405205-214405350,chr1,214405205,214405350,HepG2|chr1:148556503-148556650,chr1,148556503,148556650,0,65848702
HepG2|chr1:214683032-214683179,chr1,214683032,214683179,HepG2|chr1:148556216-148556366,chr1,148556216,148556366,0,66126816
HepG2|chr1:214833837-214833984,chr1,214833837,214833984,HepG2|chr1:148558152-148558302,chr1,148558152,148558302,0,66275685
HepG2|chr1:214974089-214974170,chr1,214974089,214974170,HepG2|chr1:247496606-247496632,chr1,247496606,247496632,0,32522517
HepG2|chr1:215047480-215047539,chr1,215047480,215047539,HepG2|chr1:15939163-15939229,chr1,15939163,15939229,0,199108317
HepG2|chr1:215125574-215125721,chr1,215125574,215125721,HepG2|chr1:109851507-109851569,chr1,109851507,109851569,0,105274067
HepG2|chr1:215406044-215406194,chr1,215406044,215406194,HepG2|chr1:247497284-247497302,chr1,247497284,247497302,0,32091240
HepG2|chr1:215432257-215432354,chr1,215432257,215432354,HepG2|chr1:148556143-148556180,chr1,148556143,148556180,0,66876114
HepG2|chr1:215502578-215502653,chr1,215502578,215502653,HepG2|chr1:148557625-148557709,chr1,148557625,148557709,0,66944953
HepG2|chr1:215773183-215773333,chr1,215773183,215773333,HepG2|chr1:148556562-148556709,chr1,148556562,148556709,0,67216621
HepG2|chr1:216119126-216119237,chr1,216119126,216119237,HepG2|chr1:247498919-247498955,chr1,247498919,247498955,0,31379793
HepG2|chr1:216417809-216417844,chr1,216417809,216417844,HepG2|chr1:1444584-1444699,chr1,1444584,1444699,0,214973225
HepG2|chr1:216443935-216444043,chr1,216443935,216444043,HepG2|chr1:153581802-153581844,chr1,153581802,153581844,0,62862133
HepG2|chr1:216972889-216972959,chr1,216972889,216972959,HepG2|chr1:148555862-148556009,chr1,148555862,148556009,0,68417027
HepG2|chr1:217306196-217306221,chr1,217306196,217306221,HepG2|chr1:153964644-153964715,chr1,153964644,153964715,0,63341552
HepG2|chr1:217493405-217493515,chr1,217493405,217493515,HepG2|chr1:148555906-148556027,chr1,148555906,148556027,0,68937499
HepG2|chr1:218056187-218056219,chr1,218056187,218056219,HepG2|chr1:148556149-148556180,chr1,148556149,148556180,0,69500038
HepG2|chr1:218366807-218366920,chr1,218366807,218366920,HepG2|chr1:33171400-33171466,chr1,33171400,33171466,0,185195407
HepG2|chr1:218436788-218436863,chr1,218436788,218436863,HepG2|chr1:148556691-148556783,chr1,148556691,148556783,0,69880097
HepG2|chr1:218483685-218483746,chr1,218483685,218483746,HepG2|chr1:120190751-120190897,chr1,120190751,120190897,0,98292934
HepG2|chr1:218529360-218529461,chr1,218529360,218529461,HepG2|chr1:247499026-247499161,chr1,247499026,247499161,0,28969666
HepG2|chr1:218579092-218579228,chr1,218579092,218579228,HepG2|chr1:148558141-148558219,chr1,148558141,148558219,0,70020951
HepG2|chr1:218613551-218613594,chr1,218613551,218613594,HepG2|chr1:148556691-148556773,chr1,148556691,148556773,0,70056860
HepG2|chr1:218891287-218891369,chr1,218891287,218891369,HepG2|chr1:225964643-225964711,chr1,225964643,225964711,0,7073356
HepG2|chr1:219206294-219206444,chr1,219206294,219206444,HepG2|chr1:40241552-40241702,chr1,40241552,40241702,0,178964742
HepG2|chr1:219446883-219447032,chr1,219446883,219447032,HepG2|chr1:148560538-148560562,chr1,148560538,148560562,0,70886345
HepG2|chr1:219885555-219885621,chr1,219885555,219885621,HepG2|chr1:33171977-33172061,chr1,33171977,33172061,0,186713578
HepG2|chr1:220014233-220014364,chr1,220014233,220014364,HepG2|chr1:40236986-40237117,chr1,40236986,40237117,0,179777247
HepG2|chr1:220110283-220110332,chr1,220110283,220110332,HepG2|chr1:148558160-148558306,chr1,148558160,148558306,0,71552123
HepG2|chr1:220467194-220467286,chr1,220467194,220467286,HepG2|chr1:148556144-148556180,chr1,148556144,148556180,0,71911050
HepG2|chr1:220524121-220524171,chr1,220524121,220524171,HepG2|chr1:205652566-205652700,chr1,205652566,205652700,0,14871555
HepG2|chr1:220757480-220757580,chr1,220757480,220757580,HepG2|chr1:148556691-148556711,chr1,148556691,148556711,0,72200789
HepG2|chr1:221064404-221064554,chr1,221064404,221064554,HepG2|chr1:149684997-149685143,chr1,149684997,149685143,0,71379407
HepG2|chr1:221304146-221304296,chr1,221304146,221304296,HepG2|chr1:16862660-16862810,chr1,16862660,16862810,0,204441486
HepG2|chr1:221308356-221308396,chr1,221308356,221308396,HepG2|chr1:36686019-36686091,chr1,36686019,36686091,0,184622337
HepG2|chr1:221385673-221385807,chr1,221385673,221385807,HepG2|chr1:148556135-148556180,chr1,148556135,148556180,0,72829538
HepG2|chr1:221657192-221657229,chr1,221657192,221657229,HepG2|chr1:1444611-1444761,chr1,1444611,1444761,0,220212581
HepG2|chr1:221762946-221763042,chr1,221762946,221763042,HepG2|chr1:78149986-78150012,chr1,78149986,78150012,0,143612960
HepG2|chr1:222126037-222126116,chr1,222126037,222126116,HepG2|chr1:148556691-148556738,chr1,148556691,148556738,0,73569346
HepG2|chr1:222343553-222343685,chr1,222343553,222343685,HepG2|chr1:148556217-148556367,chr1,148556217,148556367,0,73787336
HepG2|chr1:222660919-222661068,chr1,222660919,222661068,HepG2|chr1:148558204-148558354,chr1,148558204,148558354,0,74102715
HepG2|chr1:222772988-222773138,chr1,222772988,222773138,HepG2|chr1:148556895-148557045,chr1,148556895,148557045,0,74216093
HepG2|chr1:222875095-222875245,chr1,222875095,222875245,HepG2|chr1:148558160-148558300,chr1,148558160,148558300,0,74316935
HepG2|chr1:223128438-223128585,chr1,223128438,223128585,HepG2|chr1:148557628-148557683,chr1,148557628,148557683,0,74570810
HepG2|chr1:223141109-223141187,chr1,223141109,223141187,HepG2|chr1:37982293-37982365,chr1,37982293,37982365,0,185158816
HepG2|chr1:223275253-223275395,chr1,223275253,223275395,HepG2|chr1:148558082-148558228,chr1,148558082,148558228,0,74717171
HepG2|chr1:223318075-223318193,chr1,223318075,223318193,HepG2|chr1:148556232-148556374,chr1,148556232,148556374,0,74761843
HepG2|chr1:223361310-223361447,chr1,223361310,223361447,HepG2|chr1:148557627-148557701,chr1,148557627,148557701,0,74803683
HepG2|chr1:224140977-224141127,chr1,224140977,224141127,HepG2|chr1:148556562-148556709,chr1,148556562,148556709,0,75584415
HepG2|chr1:224155048-224155144,chr1,224155048,224155144,HepG2|chr1:148556581-148556731,chr1,148556581,148556731,0,75598467
HepG2|chr1:224171437-224171584,chr1,224171437,224171584,HepG2|chr1:148557600-148557656,chr1,148557600,148557656,0,75613837
HepG2|chr1:224447048-224447087,chr1,224447048,224447087,HepG2|chr1:150456425-150456447,chr1,150456425,150456447,0,73990623
HepG2|chr1:224748148-224748298,chr1,224748148,224748298,HepG2|chr1:40237903-40238050,chr1,40237903,40238050,0,184510245
HepG2|chr1:224896192-224896336,chr1,224896192,224896336,HepG2|chr1:148556895-148556995,chr1,148556895,148556995,0,76339297
HepG2|chr1:225220667-225220774,chr1,225220667,225220774,HepG2|chr1:54410614-54410657,chr1,54410614,54410657,0,170810053
HepG2|chr1:225252245-225252395,chr1,225252245,225252395,HepG2|chr1:148556905-148557055,chr1,148556905,148557055,0,76695340
HepG2|chr1:225782698-225782759,chr1,225782698,225782759,HepG2|chr1:120190751-120190897,chr1,120190751,120190897,0,105591947
HepG2|chr1:225862237-225862326,chr1,225862237,225862326,HepG2|chr1:148556153-148556180,chr1,148556153,148556180,0,77306084
HepG2|chr1:225993336-225993410,chr1,225993336,225993410,HepG2|chr1:247499555-247499581,chr1,247499555,247499581,0,21506219
HepG2|chr1:225995632-225995671,chr1,225995632,225995671,HepG2|chr1:33171355-33171466,chr1,33171355,33171466,0,192824277
HepG2|chr1:226385654-226385734,chr1,226385654,226385734,HepG2|chr1:148556154-148556180,chr1,148556154,148556180,0,77829500
HepG2|chr1:226941337-226941386,chr1,226941337,226941386,HepG2|chr1:148556364-148556437,chr1,148556364,148556437,0,78384973
HepG2|chr1:227249228-227249251,chr1,227249228,227249251,HepG2|chr1:3447363-3447490,chr1,3447363,3447490,0,223801865
HepG2|chr1:227289199-227289343,chr1,227289199,227289343,HepG2|chr1:40241541-40241691,chr1,40241541,40241691,0,187047658
HepG2|chr1:228116018-228116164,chr1,228116018,228116164,HepG2|chr1:173444013-173444054,chr1,173444013,173444054,0,54672005
HepG2|chr1:228299141-228299291,chr1,228299141,228299291,HepG2|chr1:16864537-16864687,chr1,16864537,16864687,0,211434604
HepG2|chr1:228519768-228519857,chr1,228519768,228519857,HepG2|chr1:148556276-148556426,chr1,148556276,148556426,0,79963492
HepG2|chr1:228620403-228620482,chr1,228620403,228620482,HepG2|chr1:47875353-47875478,chr1,47875353,47875478,0,180745050
HepG2|chr1:228752671-228752821,chr1,228752671,228752821,HepG2|chr1:148557625-148557656,chr1,148557625,148557656,0,80195046
HepG2|chr1:228873448-228873504,chr1,228873448,228873504,HepG2|chr1:148556591-148556741,chr1,148556591,148556741,0,80316857
HepG2|chr1:229295303-229295397,chr1,229295303,229295397,HepG2|chr1:148556276-148556426,chr1,148556276,148556426,0,80739027
HepG2|chr1:229419312-229419462,chr1,229419312,229419462,HepG2|chr1:148558267-148558318,chr1,148558267,148558318,0,80861045
HepG2|chr1:229722923-229722990,chr1,229722923,229722990,HepG2|chr1:245000232-245000265,chr1,245000232,245000265,0,15277309
HepG2|chr1:229727482-229727590,chr1,229727482,229727590,HepG2|chr1:153581802-153581844,chr1,153581802,153581844,0,76145680
HepG2|chr1:229864849-229864939,chr1,229864849,229864939,HepG2|chr1:155108716-155108772,chr1,155108716,155108772,0,74756133
HepG2|chr1:230195708-230195858,chr1,230195708,230195858,HepG2|chr1:148558160-148558294,chr1,148558160,148558294,0,81637548
HepG2|chr1:230263371-230263521,chr1,230263371,230263521,HepG2|chr1:148556623-148556773,chr1,148556623,148556773,0,81706748
HepG2|chr1:230325849-230325972,chr1,230325849,230325972,HepG2|chr1:148557510-148557628,chr1,148557510,148557628,0,81768339
HepG2|chr1:230776447-230776597,chr1,230776447,230776597,HepG2|chr1:145611376-145611526,chr1,145611376,145611526,0,85165071
HepG2|chr1:230816282-230816432,chr1,230816282,230816432,HepG2|chr1:16862395-16862545,chr1,16862395,16862545,0,213953887
HepG2|chr1:231055128-231055199,chr1,231055128,231055199,HepG2|chr1:148556132-148556180,chr1,148556132,148556180,0,82498996
HepG2|chr1:231147172-231147315,chr1,231147172,231147315,HepG2|chr1:148557625-148557655,chr1,148557625,148557655,0,82589547
HepG2|chr1:231408697-231408717,chr1,231408697,231408717,HepG2|chr1:148556876-148556962,chr1,148556876,148556962,0,82851821
HepG2|chr1:231777385-231777474,chr1,231777385,231777474,HepG2|chr1:148556180-148556325,chr1,148556180,148556325,0,83221205
HepG2|chr1:231862213-231862336,chr1,231862213,231862336,HepG2|chr1:224179579-224179667,chr1,224179579,224179667,0,7682634
HepG2|chr1:232108661-232108808,chr1,232108661,232108808,HepG2|chr1:148556143-148556180,chr1,148556143,148556180,0,83552518
HepG2|chr1:233178194-233178238,chr1,233178194,233178238,HepG2|chr1:247499946-247500049,chr1,247499946,247500049,0,14321752
HepG2|chr1:233402230-233402380,chr1,233402230,233402380,HepG2|chr1:148557625-148557659,chr1,148557625,148557659,0,84844605
HepG2|chr1:233958588-233958647,chr1,233958588,233958647,HepG2|chr1:148557508-148557623,chr1,148557508,148557623,0,85401080
HepG2|chr1:234037128-234037180,chr1,234037128,234037180,HepG2|chr1:153964601-153964721,chr1,153964601,153964721,0,80072527
HepG2|chr1:234056103-234056187,chr1,234056103,234056187,HepG2|chr1:148556209-148556359,chr1,148556209,148556359,0,85499894
HepG2|chr1:234360214-234360243,chr1,234360214,234360243,HepG2|chr1:148556876-148556958,chr1,148556876,148556958,0,85803338
HepG2|chr1:234559747-234559897,chr1,234559747,234559897,HepG2|chr1:148556249-148556398,chr1,148556249,148556398,0,86003498
HepG2|chr1:234590032-234590123,chr1,234590032,234590123,HepG2|chr1:245001128-245001159,chr1,245001128,245001159,0,10411096
HepG2|chr1:234615464-234615613,chr1,234615464,234615613,HepG2|chr1:148558221-148558370,chr1,148558221,148558370,0,86057243
HepG2|chr1:234876421-234876530,chr1,234876421,234876530,HepG2|chr1:100805718-100805865,chr1,100805718,100805865,0,134070703
HepG2|chr1:234930605-234930631,chr1,234930605,234930631,HepG2|chr1:204042325-204042449,chr1,204042325,204042449,0,30888280
HepG2|chr1:235770497-235770646,chr1,235770497,235770646,HepG2|chr1:148558160-148558305,chr1,148558160,148558305,0,87212337
HepG2|chr1:235889872-235889954,chr1,235889872,235889954,HepG2|chr1:247497829-247497876,chr1,247497829,247497876,0,11607957
HepG2|chr1:235896439-235896492,chr1,235896439,235896492,HepG2|chr1:148557509-148557628,chr1,148557509,148557628,0,87338930
HepG2|chr1:235907976-235908008,chr1,235907976,235908008,HepG2|chr1:200634597-200634722,chr1,200634597,200634722,0,35273379
HepG2|chr1:236120504-236120617,chr1,236120504,236120617,HepG2|chr1:148556466-148556616,chr1,148556466,148556616,0,87564038
HepG2|chr1:236346603-236346637,chr1,236346603,236346637,HepG2|chr1:228300737-228300850,chr1,228300737,228300850,0,8045866
HepG2|chr1:236651906-236652056,chr1,236651906,236652056,HepG2|chr1:16862400-16862549,chr1,16862400,16862549,0,219789506
HepG2|chr1:237107787-237107855,chr1,237107787,237107855,HepG2|chr1:148556141-148556180,chr1,148556141,148556180,0,88551646
HepG2|chr1:237613716-237613843,chr1,237613716,237613843,HepG2|chr1:148556272-148556422,chr1,148556272,148556422,0,89057444
HepG2|chr1:237772806-237772956,chr1,237772806,237772956,HepG2|chr1:148556510-148556660,chr1,148556510,148556660,0,89216296
HepG2|chr1:237966083-237966233,chr1,237966083,237966233,HepG2|chr1:148558238-148558388,chr1,148558238,148558388,0,89407845
HepG2|chr1:238351219-238351369,chr1,238351219,238351369,HepG2|chr1:148556510-148556660,chr1,148556510,148556660,0,89794709
HepG2|chr1:238552910-238553053,chr1,238552910,238553053,HepG2|chr1:148556249-148556399,chr1,148556249,148556399,0,89996661
HepG2|chr1:238577209-238577287,chr1,238577209,238577287,HepG2|chr1:148556249-148556399,chr1,148556249,148556399,0,90020960
HepG2|chr1:239034549-239034583,chr1,239034549,239034583,HepG2|chr1:148556601-148556751,chr1,148556601,148556751,0,90477948
HepG2|chr1:239190776-239190926,chr1,239190776,239190926,HepG2|chr1:148558160-148558294,chr1,148558160,148558294,0,90632616
HepG2|chr1:239244698-239244758,chr1,239244698,239244758,HepG2|chr1:120190693-120190802,chr1,120190693,120190802,0,119054005
HepG2|chr1:239265027-239265087,chr1,239265027,239265087,HepG2|chr1:120190693-120190802,chr1,120190693,120190802,0,119074334
HepG2|chr1:239679243-239679310,chr1,239679243,239679310,HepG2|chr1:228608345-228608397,chr1,228608345,228608397,0,11070898
HepG2|chr1:240124479-240124536,chr1,240124479,240124536,HepG2|chr1:245022842-245022941,chr1,245022842,245022941,0,4898363
HepG2|chr1:240210368-240210504,chr1,240210368,240210504,HepG2|chr1:226252827-226252953,chr1,226252827,226252953,0,13957541
HepG2|chr1:240395763-240395859,chr1,240395763,240395859,HepG2|chr1:78149986-78150012,chr1,78149986,78150012,0,162245777
HepG2|chr1:240807979-240808075,chr1,240807979,240808075,HepG2|chr1:173836015-173836066,chr1,173836015,173836066,0,66971964
HepG2|chr1:240837630-240837710,chr1,240837630,240837710,HepG2|chr1:228595215-228595285,chr1,228595215,228595285,0,12242415
HepG2|chr1:240853914-240853964,chr1,240853914,240853964,HepG2|chr1:153964669-153964721,chr1,153964669,153964721,0,86889245
HepG2|chr1:240913801-240913844,chr1,240913801,240913844,HepG2|chr1:148556691-148556777,chr1,148556691,148556777,0,92357110
HepG2|chr1:241005385-241005534,chr1,241005385,241005534,HepG2|chr1:148556561-148556711,chr1,148556561,148556711,0,92448824
HepG2|chr1:241241106-241241173,chr1,241241106,241241173,HepG2|chr1:148556148-148556180,chr1,148556148,148556180,0,92684958
HepG2|chr1:241272648-241272748,chr1,241272648,241272748,HepG2|chr1:148556691-148556711,chr1,148556691,148556711,0,92715957
HepG2|chr1:241278230-241278281,chr1,241278230,241278281,HepG2|chr1:245022842-245022941,chr1,245022842,245022941,0,3744612
HepG2|chr1:241406080-241406096,chr1,241406080,241406096,HepG2|chr1:235321462-235321521,chr1,235321462,235321521,0,6084618
HepG2|chr1:241418430-241418538,chr1,241418430,241418538,HepG2|chr1:8762439-8762459,chr1,8762439,8762459,0,232655991
HepG2|chr1:241476282-241476432,chr1,241476282,241476432,HepG2|chr1:148558185-148558331,chr1,148558185,148558331,0,92918097
HepG2|chr1:241845900-241846050,chr1,241845900,241846050,HepG2|chr1:6508384-6508421,chr1,6508384,6508421,0,235337516
HepG2|chr1:241865030-241865119,chr1,241865030,241865119,HepG2|chr1:148556153-148556180,chr1,148556153,148556180,0,93308877
HepG2|chr1:242010413-242010531,chr1,242010413,242010531,HepG2|chr1:148556232-148556374,chr1,148556232,148556374,0,93454181
HepG2|chr1:242017283-242017348,chr1,242017283,242017348,HepG2|chr1:148557508-148557623,chr1,148557508,148557623,0,93459775
HepG2|chr1:242113132-242113213,chr1,242113132,242113213,HepG2|chr1:148556191-148556341,chr1,148556191,148556341,0,93556941
HepG2|chr1:242257564-242257625,chr1,242257564,242257625,HepG2|chr1:148558085-148558232,chr1,148558085,148558232,0,93699479
HepG2|chr1:242519489-242519601,chr1,242519489,242519601,HepG2|chr1:78224041-78224079,chr1,78224041,78224079,0,164295448
HepG2|chr1:242542707-242542742,chr1,242542707,242542742,HepG2|chr1:148557536-148557625,chr1,148557536,148557625,0,93985171
HepG2|chr1:242595373-242595508,chr1,242595373,242595508,HepG2|chr1:148556691-148556711,chr1,148556691,148556711,0,94038682
HepG2|chr1:242851015-242851058,chr1,242851015,242851058,HepG2|chr1:148556691-148556777,chr1,148556691,148556777,0,94294324
HepG2|chr1:242977461-242977484,chr1,242977461,242977484,HepG2|chr1:148556134-148556180,chr1,148556134,148556180,0,94421327
HepG2|chr1:243203444-243203559,chr1,243203444,243203559,HepG2|chr1:148556143-148556180,chr1,148556143,148556180,0,94647301
HepG2|chr1:243219491-243219574,chr1,243219491,243219574,HepG2|chr1:44174051-44174084,chr1,44174051,44174084,0,199045440
HepG2|chr1:243338111-243338261,chr1,243338111,243338261,HepG2|chr1:16862660-16862810,chr1,16862660,16862810,0,226475451
HepG2|chr1:243531202-243531229,chr1,243531202,243531229,HepG2|chr1:153964701-153964721,chr1,153964701,153964721,0,89566501
HepG2|chr1:243941230-243941269,chr1,243941230,243941269,HepG2|chr1:153964692-153964721,chr1,153964692,153964721,0,89976538
HepG2|chr1:244207557-244207593,chr1,244207557,244207593,HepG2|chr1:1444584-1444699,chr1,1444584,1444699,0,242762973
HepG2|chr1:244340093-244340243,chr1,244340093,244340243,HepG2|chr1:148556466-148556616,chr1,148556466,148556616,0,95783627
HepG2|chr1:244377030-244377122,chr1,244377030,244377122,HepG2|chr1:174966482-174966539,chr1,174966482,174966539,0,69410548
HepG2|chr1:244569738-244569827,chr1,244569738,244569827,HepG2|chr1:148556180-148556325,chr1,148556180,148556325,0,96013558
HepG2|chr1:244775102-244775252,chr1,244775102,244775252,HepG2|chr1:148556562-148556709,chr1,148556562,148556709,0,96218540
HepG2|chr1:244920076-244920125,chr1,244920076,244920125,HepG2|chr1:153964657-153964721,chr1,153964657,153964721,0,90955419
HepG2|chr1:245039050-245039200,chr1,245039050,245039200,HepG2|chr1:148556816-148556867,chr1,148556816,148556867,0,96482234
HepG2|chr1:245189885-245189920,chr1,245189885,245189920,HepG2|chr1:148557509-148557623,chr1,148557509,148557623,0,96632376
HepG2|chr1:245315806-245315872,chr1,245315806,245315872,HepG2|chr1:31539734-31539777,chr1,31539734,31539777,0,213776072
HepG2|chr1:245512239-245512323,chr1,245512239,245512323,HepG2|chr1:173445770-173445788,chr1,173445770,173445788,0,72066469
HepG2|chr1:245748215-245748305,chr1,245748215,245748305,HepG2|chr1:148556135-148556180,chr1,148556135,148556180,0,97192080
HepG2|chr1:246080224-246080371,chr1,246080224,246080371,HepG2|chr1:149685052-149685202,chr1,149685052,149685202,0,96395172
HepG2|chr1:246123333-246123403,chr1,246123333,246123403,HepG2|chr1:148555862-148556009,chr1,148555862,148556009,0,97567471
HepG2|chr1:246228984-246229036,chr1,246228984,246229036,HepG2|chr1:245020750-245020900,chr1,245020750,245020900,0,1208234
HepG2|chr1:246244327-246244474,chr1,246244327,246244474,HepG2|chr1:148557600-148557656,chr1,148557600,148557656,0,97686727
HepG2|chr1:246489952-246490102,chr1,246489952,246490102,HepG2|chr1:148558160-148558300,chr1,148558160,148558300,0,97931792
HepG2|chr1:246636253-246636403,chr1,246636253,246636403,HepG2|chr1:148556921-148557071,chr1,148556921,148557071,0,98079332
HepG2|chr1:246638911-246639061,chr1,246638911,246639061,HepG2|chr1:148556141-148556180,chr1,148556141,148556180,0,98082770
HepG2|chr1:247229523-247229672,chr1,247229523,247229672,HepG2|chr1:148560538-148560562,chr1,148560538,148560562,0,98668985
HepG2|chr1:247249471-247249607,chr1,247249471,247249607,HepG2|chr1:148556180-148556330,chr1,148556180,148556330,0,98693291
HepG2|chr1:247276241-247276374,chr1,247276241,247276374,HepG2|chr1:148557630-148557689,chr1,148557630,148557689,0,98718611
HepG2|chr1:247342402-247342425,chr1,247342402,247342425,HepG2|chr1:148556206-148556353,chr1,148556206,148556353,0,98786196
HepG2|chr1:247682775-247682832,chr1,247682775,247682832,HepG2|chr1:150456166-150456316,chr1,150456166,150456316,0,97226609
HepG2|chr1:247698485-247698506,chr1,247698485,247698506,HepG2|chr1:148556690-148556716,chr1,148556690,148556716,0,99141795
HepG2|chr1:248116098-248116248,chr1,248116098,248116248,HepG2|chr1:16862395-16862545,chr1,16862395,16862545,0,231253703
HepG2|chr1:248314966-248315008,chr1,248314966,248315008,HepG2|chr1:247497791-247497830,chr1,247497791,247497830,0,817175
HepG2|chr1:248350962-248351075,chr1,248350962,248351075,HepG2|chr1:148556466-148556616,chr1,148556466,148556616,0,99794496
HepG2|chr1:248449350-248449492,chr1,248449350,248449492,HepG2|chr1:148556216-148556366,chr1,148556216,148556366,0,99893134
HepG2|chr1:248718937-248719087,chr1,248718937,248719087,HepG2|chr1:148556464-148556614,chr1,148556464,148556614,0,100162473
HepG2|chr1:248825542-248825567,chr1,248825542,248825567,HepG2|chr1:148556210-148556360,chr1,148556210,148556360,0,100269332
HepG2|chr1:248858830-248858862,chr1,248858830,248858862,HepG2|chr1:247499397-247499515,chr1,247499397,247499515,0,1359433
HepG2|chr1:249019043-249019124,chr1,249019043,249019124,HepG2|chr1:148556202-148556349,chr1,148556202,148556349,0,100462841
HepG2|chr1:249194697-249194717,chr1,249194697,249194717,HepG2|chr1:148556876-148556962,chr1,148556876,148556962,0,100637821
HepG2|chr2:818217-818282,chr2,818217,818282,HepG2|chr2:201979664-201979803,chr2,201979664,201979803,0,201161447
HepG2|chr2:2330497-2330553,chr2,2330497,2330553,HepG2|chr2:11610310-11610411,chr2,11610310,11610411,0,9279813
HepG2|chr2:2977790-2977855,chr2,2977790,2977855,HepG2|chr2:127982581-127982662,chr2,127982581,127982662,0,125004791
HepG2|chr2:3001548-3001616,chr2,3001548,3001616,HepG2|chr2:216175480-216175630,chr2,216175480,216175630,0,213173932
HepG2|chr2:3190232-3190259,chr2,3190232,3190259,HepG2|chr2:220091642-220091765,chr2,220091642,220091765,0,216901410
HepG2|chr2:3329812-3329949,chr2,3329812,3329949,HepG2|chr2:203133596-203133659,chr2,203133596,203133659,0,199803784
HepG2|chr2:3478594-3478652,chr2,3478594,3478652,HepG2|chr2:232514181-232514273,chr2,232514181,232514273,0,229035587
HepG2|chr2:5470601-5470685,chr2,5470601,5470685,HepG2|chr2:55496965-55496983,chr2,55496965,55496983,0,50026364
HepG2|chr2:5640769-5640879,chr2,5640769,5640879,HepG2|chr2:27990010-27990047,chr2,27990010,27990047,0,22349241
HepG2|chr2:5878733-5878845,chr2,5878733,5878845,HepG2|chr2:190305748-190305786,chr2,190305748,190305786,0,184427015
HepG2|chr2:6239201-6239340,chr2,6239201,6239340,HepG2|chr2:130886784-130886817,chr2,130886784,130886817,0,124647583
HepG2|chr2:7906576-7906612,chr2,7906576,7906612,HepG2|chr2:11606405-11606519,chr2,11606405,11606519,0,3699829
HepG2|chr2:8483402-8483443,chr2,8483402,8483443,HepG2|chr2:85193944-85194004,chr2,85193944,85194004,0,76710542
HepG2|chr2:8672880-8672927,chr2,8672880,8672927,HepG2|chr2:198366363-198366509,chr2,198366363,198366509,0,189693483
HepG2|chr2:8709895-8709960,chr2,8709895,8709960,HepG2|chr2:233200041-233200190,chr2,233200041,233200190,0,224490146
HepG2|chr2:9069307-9069371,chr2,9069307,9069371,HepG2|chr2:208494090-208494129,chr2,208494090,208494129,0,199424783
HepG2|chr2:9120294-9120334,chr2,9120294,9120334,HepG2|chr2:233197732-233197812,chr2,233197732,233197812,0,224077438
HepG2|chr2:9193754-9193855,chr2,9193754,9193855,HepG2|chr2:85193944-85193993,chr2,85193944,85193993,0,76000190
HepG2|chr2:9675775-9675920,chr2,9675775,9675920,HepG2|chr2:233197094-233197241,chr2,233197094,233197241,0,223521319
HepG2|chr2:10782168-10782188,chr2,10782168,10782188,HepG2|chr2:69970375-69970525,chr2,69970375,69970525,0,59188207
HepG2|chr2:11320848-11320903,chr2,11320848,11320903,HepG2|chr2:233197393-233197488,chr2,233197393,233197488,0,221876545
HepG2|chr2:12710129-12710278,chr2,12710129,12710278,HepG2|chr2:233199830-233199980,chr2,233199830,233199980,0,220489701
HepG2|chr2:13545102-13545138,chr2,13545102,13545138,HepG2|chr2:191746758-191746872,chr2,191746758,191746872,0,178201656
HepG2|chr2:13940983-13941011,chr2,13940983,13941011,HepG2|chr2:85196263-85196376,chr2,85196263,85196376,0,71255280
HepG2|chr2:14411714-14411744,chr2,14411714,14411744,HepG2|chr2:85193944-85194042,chr2,85193944,85194042,0,70782230
HepG2|chr2:14529953-14530065,chr2,14529953,14530065,HepG2|chr2:233199818-233199902,chr2,233199818,233199902,0,218669865
HepG2|chr2:14742028-14742081,chr2,14742028,14742081,HepG2|chr2:74230262-74230412,chr2,74230262,74230412,0,59488234
HepG2|chr2:14839074-14839224,chr2,14839074,14839224,HepG2|chr2:86948605-86948753,chr2,86948605,86948753,0,72109531
HepG2|chr2:15126310-15126460,chr2,15126310,15126460,HepG2|chr2:233200018-233200168,chr2,233200018,233200168,0,218073708
HepG2|chr2:15343606-15343756,chr2,15343606,15343756,HepG2|chr2:97779792-97779826,chr2,97779792,97779826,0,82436186
HepG2|chr2:15876558-15876676,chr2,15876558,15876676,HepG2|chr2:85193944-85193976,chr2,85193944,85193976,0,69317386
HepG2|chr2:16244142-16244265,chr2,16244142,16244265,HepG2|chr2:190305748-190305766,chr2,190305748,190305766,0,174061606
HepG2|chr2:16572080-16572121,chr2,16572080,16572121,HepG2|chr2:85193944-85194004,chr2,85193944,85194004,0,68621864
HepG2|chr2:16587274-16587334,chr2,16587274,16587334,HepG2|chr2:191746758-191746872,chr2,191746758,191746872,0,175159484
HepG2|chr2:17440841-17440926,chr2,17440841,17440926,HepG2|chr2:43019463-43019528,chr2,43019463,43019528,0,25578622
HepG2|chr2:17747636-17747724,chr2,17747636,17747724,HepG2|chr2:74230320-74230351,chr2,74230320,74230351,0,56482684
HepG2|chr2:17901191-17901341,chr2,17901191,17901341,HepG2|chr2:233197065-233197215,chr2,233197065,233197215,0,215295874
HepG2|chr2:18147375-18147465,chr2,18147375,18147465,HepG2|chr2:85193944-85194020,chr2,85193944,85194020,0,67046569
HepG2|chr2:19163870-19163900,chr2,19163870,19163900,HepG2|chr2:74230236-74230358,chr2,74230236,74230358,0,55066366
HepG2|chr2:19469118-19469237,chr2,19469118,19469237,HepG2|chr2:219860990-219861012,chr2,219860990,219861012,0,200391872
HepG2|chr2:19548171-19548267,chr2,19548171,19548267,HepG2|chr2:171781001-171781055,chr2,171781001,171781055,0,152232830
HepG2|chr2:20143571-20143592,chr2,20143571,20143592,HepG2|chr2:233384906-233385044,chr2,233384906,233385044,0,213241335
HepG2|chr2:20843240-20843262,chr2,20843240,20843262,HepG2|chr2:11606341-11606444,chr2,11606341,11606444,0,9236899
HepG2|chr2:20947664-20947814,chr2,20947664,20947814,HepG2|chr2:11603328-11603350,chr2,11603328,11603350,0,9344336
HepG2|chr2:21201957-21202107,chr2,21201957,21202107,HepG2|chr2:233200016-233200166,chr2,233200016,233200166,0,211998059
HepG2|chr2:21574250-21574400,chr2,21574250,21574400,HepG2|chr2:233200022-233200172,chr2,233200022,233200172,0,211625772
HepG2|chr2:21734649-21734795,chr2,21734649,21734795,HepG2|chr2:233200056-233200206,chr2,233200056,233200206,0,211465407
HepG2|chr2:21806513-21806600,chr2,21806513,21806600,HepG2|chr2:74230266-74230416,chr2,74230266,74230416,0,52423753
HepG2|chr2:21934636-21934718,chr2,21934636,21934718,HepG2|chr2:85194004-85194058,chr2,85194004,85194058,0,63259368
HepG2|chr2:22253034-22253184,chr2,22253034,22253184,HepG2|chr2:233200050-233200200,chr2,233200050,233200200,0,210947016
HepG2|chr2:22670897-22670927,chr2,22670897,22670927,HepG2|chr2:85193499-85193649,chr2,85193499,85193649,0,62522602
HepG2|chr2:23720998-23721020,chr2,23720998,23721020,HepG2|chr2:174829046-174829166,chr2,174829046,174829166,0,151108048
HepG2|chr2:23861354-23861376,chr2,23861354,23861376,HepG2|chr2:85128896-85129002,chr2,85128896,85129002,0,61267542
HepG2|chr2:24085409-24085450,chr2,24085409,24085450,HepG2|chr2:233197732-233197812,chr2,233197732,233197812,0,209112323
HepG2|chr2:24494705-24494725,chr2,24494705,24494725,HepG2|chr2:11606412-11606519,chr2,11606412,11606519,0,12888293
HepG2|chr2:24829211-24829312,chr2,24829211,24829312,HepG2|chr2:85193944-85193993,chr2,85193944,85193993,0,60364733
HepG2|chr2:25586580-25586668,chr2,25586580,25586668,HepG2|chr2:218804150-218804209,chr2,218804150,218804209,0,193217570
HepG2|chr2:27617783-27617828,chr2,27617783,27617828,HepG2|chr2:97779754-97779904,chr2,97779754,97779904,0,70161971
HepG2|chr2:27704116-27704144,chr2,27704116,27704144,HepG2|chr2:74230268-74230418,chr2,74230268,74230418,0,46526152
HepG2|chr2:27987091-27987217,chr2,27987091,27987217,HepG2|chr2:11609567-11609713,chr2,11609567,11609713,0,16377524
HepG2|chr2:28183736-28183886,chr2,28183736,28183886,HepG2|chr2:233199824-233199974,chr2,233199824,233199974,0,205016088
HepG2|chr2:28188036-28188074,chr2,28188036,28188074,HepG2|chr2:85195869-85195998,chr2,85195869,85195998,0,57007833
HepG2|chr2:28985626-28985776,chr2,28985626,28985776,HepG2|chr2:233200057-233200207,chr2,233200057,233200207,0,204214431
HepG2|chr2:29364268-29364415,chr2,29364268,29364415,HepG2|chr2:233200037-233200187,chr2,233200037,233200187,0,203835769
HepG2|chr2:29385894-29386044,chr2,29385894,29386044,HepG2|chr2:74230320-74230369,chr2,74230320,74230369,0,44844426
HepG2|chr2:30649880-30649945,chr2,30649880,30649945,HepG2|chr2:201979664-201979803,chr2,201979664,201979803,0,171329784
HepG2|chr2:30734802-30734885,chr2,30734802,30734885,HepG2|chr2:85195624-85195668,chr2,85195624,85195668,0,54460822
HepG2|chr2:31139524-31139673,chr2,31139524,31139673,HepG2|chr2:233200058-233200208,chr2,233200058,233200208,0,202060534
HepG2|chr2:31185386-31185419,chr2,31185386,31185419,HepG2|chr2:75184773-75184890,chr2,75184773,75184890,0,43999387
HepG2|chr2:31344747-31344769,chr2,31344747,31344769,HepG2|chr2:85194638-85194774,chr2,85194638,85194774,0,53849891
HepG2|chr2:31737033-31737137,chr2,31737033,31737137,HepG2|chr2:85193944-85193963,chr2,85193944,85193963,0,53456911
HepG2|chr2:32283455-32283604,chr2,32283455,32283604,HepG2|chr2:233199807-233199957,chr2,233199807,233199957,0,200916352
HepG2|chr2:32588682-32588752,chr2,32588682,32588752,HepG2|chr2:74230418-74230463,chr2,74230418,74230463,0,41641736
HepG2|chr2:33054552-33054591,chr2,33054552,33054591,HepG2|chr2:11606405-11606519,chr2,11606405,11606519,0,21448147
HepG2|chr2:33210117-33210257,chr2,33210117,33210257,HepG2|chr2:233199941-233200091,chr2,233199941,233200091,0,199989824
HepG2|chr2:33364502-33364552,chr2,33364502,33364552,HepG2|chr2:216175401-216175501,chr2,216175401,216175501,0,182810899
HepG2|chr2:33469263-33469283,chr2,33469263,33469283,HepG2|chr2:85193392-85193531,chr2,85193392,85193531,0,51724129
HepG2|chr2:33517624-33517666,chr2,33517624,33517666,HepG2|chr2:216175400-216175533,chr2,216175400,216175533,0,182657776
HepG2|chr2:34696348-34696494,chr2,34696348,34696494,HepG2|chr2:190305748-190305798,chr2,190305748,190305798,0,155609400
HepG2|chr2:36005735-36005832,chr2,36005735,36005832,HepG2|chr2:201978401-201978423,chr2,201978401,201978423,0,165972666
HepG2|chr2:36149991-36150141,chr2,36149991,36150141,HepG2|chr2:86948601-86948747,chr2,86948601,86948747,0,50798610
HepG2|chr2:36372042-36372101,chr2,36372042,36372101,HepG2|chr2:74226167-74226317,chr2,74226167,74226317,0,37854125
HepG2|chr2:36384862-36384917,chr2,36384862,36384917,HepG2|chr2:85193448-85193542,chr2,85193448,85193542,0,48808586
HepG2|chr2:38388505-38388600,chr2,38388505,38388600,HepG2|chr2:48540828-48540888,chr2,48540828,48540888,0,10152323
HepG2|chr2:38480043-38480068,chr2,38480043,38480068,HepG2|chr2:85128877-85129002,chr2,85128877,85129002,0,46648834
HepG2|chr2:39269664-39269814,chr2,39269664,39269814,HepG2|chr2:233199832-233199982,chr2,233199832,233199982,0,193930168
HepG2|chr2:39475441-39475590,chr2,39475441,39475590,HepG2|chr2:233199922-233200069,chr2,233199922,233200069,0,193724481
HepG2|chr2:39489586-39489626,chr2,39489586,39489626,HepG2|chr2:85193179-85193326,chr2,85193179,85193326,0,45703593
HepG2|chr2:39874452-39874557,chr2,39874452,39874557,HepG2|chr2:85194034-85194075,chr2,85194034,85194075,0,45319582
HepG2|chr2:39903566-39903697,chr2,39903566,39903697,HepG2|chr2:219860990-219861007,chr2,219860990,219861007,0,179957424
HepG2|chr2:40003518-40003557,chr2,40003518,40003557,HepG2|chr2:230784261-230784384,chr2,230784261,230784384,0,190780743
HepG2|chr2:40153411-40153519,chr2,40153411,40153519,HepG2|chr2:96677704-96677854,chr2,96677704,96677854,0,56524293
HepG2|chr2:40214112-40214215,chr2,40214112,40214215,HepG2|chr2:32850874-32850920,chr2,32850874,32850920,0,7363238
HepG2|chr2:40672684-40672834,chr2,40672684,40672834,HepG2|chr2:233199824-233199974,chr2,233199824,233199974,0,192527140
HepG2|chr2:40760452-40760487,chr2,40760452,40760487,HepG2|chr2:85197055-85197140,chr2,85197055,85197140,0,44436603
HepG2|chr2:41047422-41047540,chr2,41047422,41047540,HepG2|chr2:85193865-85193885,chr2,85193865,85193885,0,44146443
HepG2|chr2:41442280-41442430,chr2,41442280,41442430,HepG2|chr2:85196491-85196588,chr2,85196491,85196588,0,43754211
HepG2|chr2:41899107-41899128,chr2,41899107,41899128,HepG2|chr2:233384914-233385041,chr2,233384914,233385041,0,191485807
HepG2|chr2:42081354-42081504,chr2,42081354,42081504,HepG2|chr2:233199992-233200142,chr2,233199992,233200142,0,191118638
HepG2|chr2:42505981-42506057,chr2,42505981,42506057,HepG2|chr2:114518058-114518093,chr2,114518058,114518093,0,72012077
HepG2|chr2:42616439-42616547,chr2,42616439,42616547,HepG2|chr2:85193944-85193986,chr2,85193944,85193986,0,42577505
HepG2|chr2:43143502-43143567,chr2,43143502,43143567,HepG2|chr2:233200041-233200190,chr2,233200041,233200190,0,190056539
HepG2|chr2:43150041-43150090,chr2,43150041,43150090,HepG2|chr2:11610310-11610411,chr2,11610310,11610411,0,31539731
HepG2|chr2:43560719-43560800,chr2,43560719,43560800,HepG2|chr2:75183823-75183869,chr2,75183823,75183869,0,31623104
HepG2|chr2:43583173-43583262,chr2,43583173,43583262,HepG2|chr2:242848595-242848625,chr2,242848595,242848625,0,199265422
HepG2|chr2:43690698-43690763,chr2,43690698,43690763,HepG2|chr2:85197480-85197630,chr2,85197480,85197630,0,41506782
HepG2|chr2:43731851-43731997,chr2,43731851,43731997,HepG2|chr2:242293913-242293962,chr2,242293913,242293962,0,198562062
HepG2|chr2:43752851-43752902,chr2,43752851,43752902,HepG2|chr2:101435710-101435805,chr2,101435710,101435805,0,57682859
HepG2|chr2:43874408-43874558,chr2,43874408,43874558,HepG2|chr2:75181364-75181402,chr2,75181364,75181402,0,31306956
HepG2|chr2:44530965-44531111,chr2,44530965,44531111,HepG2|chr2:233200056-233200206,chr2,233200056,233200206,0,188669091
HepG2|chr2:45970568-45970638,chr2,45970568,45970638,HepG2|chr2:219860990-219861007,chr2,219860990,219861007,0,173890422
HepG2|chr2:45997322-45997349,chr2,45997322,45997349,HepG2|chr2:230784261-230784384,chr2,230784261,230784384,0,184786939
HepG2|chr2:46813408-46813492,chr2,46813408,46813492,HepG2|chr2:233199994-233200141,chr2,233199994,233200141,0,186386586
HepG2|chr2:47578607-47578733,chr2,47578607,47578733,HepG2|chr2:11609567-11609713,chr2,11609567,11609713,0,35969040
HepG2|chr2:47581255-47581281,chr2,47581255,47581281,HepG2|chr2:74230320-74230363,chr2,74230320,74230363,0,26649065
HepG2|chr2:47715589-47715646,chr2,47715589,47715646,HepG2|chr2:114518058-114518093,chr2,114518058,114518093,0,66802469
HepG2|chr2:48291524-48291674,chr2,48291524,48291674,HepG2|chr2:85195625-85195669,chr2,85195625,85195669,0,36904101
HepG2|chr2:48565592-48565618,chr2,48565592,48565618,HepG2|chr2:74230320-74230363,chr2,74230320,74230363,0,25664728
HepG2|chr2:48676398-48676518,chr2,48676398,48676518,HepG2|chr2:27631687-27631717,chr2,27631687,27631717,0,21044711
HepG2|chr2:48972851-48972884,chr2,48972851,48972884,HepG2|chr2:75184773-75184890,chr2,75184773,75184890,0,26211922
HepG2|chr2:49000571-49000609,chr2,49000571,49000609,HepG2|chr2:85195869-85195998,chr2,85195869,85195998,0,36195298
HepG2|chr2:49472240-49472320,chr2,49472240,49472320,HepG2|chr2:85194273-85194343,chr2,85194273,85194343,0,35722033
HepG2|chr2:49972358-49972503,chr2,49972358,49972503,HepG2|chr2:233196981-233197124,chr2,233196981,233197124,0,183224623
HepG2|chr2:50210751-50210821,chr2,50210751,50210821,HepG2|chr2:219860990-219861007,chr2,219860990,219861007,0,169650239
HepG2|chr2:50338718-50338739,chr2,50338718,50338739,HepG2|chr2:233384906-233385044,chr2,233384906,233385044,0,183046188
HepG2|chr2:51245957-51246081,chr2,51245957,51246081,HepG2|chr2:85194100-85194126,chr2,85194100,85194126,0,33948143
HepG2|chr2:51417020-51417040,chr2,51417020,51417040,HepG2|chr2:85193392-85193531,chr2,85193392,85193531,0,33776372
HepG2|chr2:51804701-51804804,chr2,51804701,51804804,HepG2|chr2:233197073-233197223,chr2,233197073,233197223,0,181392372
HepG2|chr2:52076543-52076596,chr2,52076543,52076596,HepG2|chr2:11606790-11606940,chr2,11606790,11606940,0,40469753
HepG2|chr2:52355718-52355855,chr2,52355718,52355855,HepG2|chr2:203133596-203133659,chr2,203133596,203133659,0,150777878
HepG2|chr2:52593608-52593698,chr2,52593608,52593698,HepG2|chr2:48540828-48540888,chr2,48540828,48540888,0,4052780
HepG2|chr2:53154418-53154528,chr2,53154418,53154528,HepG2|chr2:27990010-27990047,chr2,27990010,27990047,0,25164408
HepG2|chr2:53594323-53594422,chr2,53594323,53594422,HepG2|chr2:190305748-190305798,chr2,190305748,190305798,0,136711425
HepG2|chr2:54384585-54384638,chr2,54384585,54384638,HepG2|chr2:85128905-85129002,chr2,85128905,85129002,0,30744320
HepG2|chr2:57185935-57185985,chr2,57185935,57185985,HepG2|chr2:85196491-85196588,chr2,85196491,85196588,0,28010556
HepG2|chr2:58268190-58268257,chr2,58268190,58268257,HepG2|chr2:216175401-216175501,chr2,216175401,216175501,0,157907211
HepG2|chr2:59200608-59200652,chr2,59200608,59200652,HepG2|chr2:74230236-74230363,chr2,74230236,74230363,0,15029628
HepG2|chr2:60403163-60403313,chr2,60403163,60403313,HepG2|chr2:233197428-233197578,chr2,233197428,233197578,0,172794265
HepG2|chr2:61033445-61033509,chr2,61033445,61033509,HepG2|chr2:233199818-233199902,chr2,233199818,233199902,0,172166373
HepG2|chr2:61365971-61366046,chr2,61365971,61366046,HepG2|chr2:85193435-85193542,chr2,85193435,85193542,0,23827464
HepG2|chr2:61905846-61905933,chr2,61905846,61905933,HepG2|chr2:203133596-203133659,chr2,203133596,203133659,0,141227750
HepG2|chr2:62240920-62241027,chr2,62240920,62241027,HepG2|chr2:85193944-85194017,chr2,85193944,85194017,0,22953024
HepG2|chr2:62523987-62524133,chr2,62523987,62524133,HepG2|chr2:127982625-127982662,chr2,127982625,127982662,0,65458638
HepG2|chr2:62594808-62594916,chr2,62594808,62594916,HepG2|chr2:96677704-96677854,chr2,96677704,96677854,0,34082896
HepG2|chr2:62665319-62665469,chr2,62665319,62665469,HepG2|chr2:86948769-86948919,chr2,86948769,86948919,0,24283450
HepG2|chr2:62730734-62730865,chr2,62730734,62730865,HepG2|chr2:219860990-219861007,chr2,219860990,219861007,0,157130256
HepG2|chr2:62959671-62959690,chr2,62959671,62959690,HepG2|chr2:242290454-242290585,chr2,242290454,242290585,0,179330783
HepG2|chr2:62981935-62982085,chr2,62981935,62982085,HepG2|chr2:43019463-43019528,chr2,43019463,43019528,0,19962472
HepG2|chr2:63692777-63692905,chr2,63692777,63692905,HepG2|chr2:11611126-11611276,chr2,11611126,11611276,0,52081651
HepG2|chr2:63979202-63979297,chr2,63979202,63979297,HepG2|chr2:188417302-188417363,chr2,188417302,188417363,0,124438100
HepG2|chr2:65087188-65087231,chr2,65087188,65087231,HepG2|chr2:85193435-85193542,chr2,85193435,85193542,0,20106247
HepG2|chr2:65160701-65160720,chr2,65160701,65160720,HepG2|chr2:75183726-75183811,chr2,75183726,75183811,0,10023025
HepG2|chr2:65517698-65517769,chr2,65517698,65517769,HepG2|chr2:201991921-201991997,chr2,201991921,201991997,0,136474223
HepG2|chr2:65650295-65650375,chr2,65650295,65650375,HepG2|chr2:85197055-85197101,chr2,85197055,85197101,0,19546760
HepG2|chr2:65680922-65681035,chr2,65680922,65681035,HepG2|chr2:75800353-75800386,chr2,75800353,75800386,0,10119431
HepG2|chr2:65974975-65975008,chr2,65974975,65975008,HepG2|chr2:75184773-75184890,chr2,75184773,75184890,0,9209798
HepG2|chr2:66482641-66482678,chr2,66482641,66482678,HepG2|chr2:239334372-239334461,chr2,239334372,239334461,0,172851731
HepG2|chr2:66575580-66575705,chr2,66575580,66575705,HepG2|chr2:85194273-85194343,chr2,85194273,85194343,0,18618693
HepG2|chr2:66760626-66760776,chr2,66760626,66760776,HepG2|chr2:97779646-97779792,chr2,97779646,97779792,0,31019020
HepG2|chr2:66840147-66840297,chr2,66840147,66840297,HepG2|chr2:233199830-233199980,chr2,233199830,233199980,0,166359683
HepG2|chr2:67085604-67085645,chr2,67085604,67085645,HepG2|chr2:233197732-233197812,chr2,233197732,233197812,0,166112128
HepG2|chr2:68571824-68571879,chr2,68571824,68571879,HepG2|chr2:85193435-85193529,chr2,85193435,85193529,0,16621611
HepG2|chr2:69103009-69103040,chr2,69103009,69103040,HepG2|chr2:74230236-74230355,chr2,74230236,74230355,0,5127227
HepG2|chr2:69339431-69339554,chr2,69339431,69339554,HepG2|chr2:190305748-190305766,chr2,190305748,190305766,0,120966317
HepG2|chr2:69573620-69573648,chr2,69573620,69573648,HepG2|chr2:85196263-85196376,chr2,85196263,85196376,0,15622643
HepG2|chr2:69580679-69580751,chr2,69580679,69580751,HepG2|chr2:191511084-191511128,chr2,191511084,191511128,0,121930405
HepG2|chr2:70055679-70055826,chr2,70055679,70055826,HepG2|chr2:242290454-242290585,chr2,242290454,242290585,0,172234775
HepG2|chr2:70247847-70247997,chr2,70247847,70247997,HepG2|chr2:11603328-11603350,chr2,11603328,11603350,0,58644519
HepG2|chr2:70409581-70409731,chr2,70409581,70409731,HepG2|chr2:233196960-233197110,chr2,233196960,233197110,0,162787379
HepG2|chr2:70434952-70435097,chr2,70434952,70435097,HepG2|chr2:233197094-233197241,chr2,233197094,233197241,0,162762142
HepG2|chr2:70485568-70485593,chr2,70485568,70485593,HepG2|chr2:85128877-85129002,chr2,85128877,85129002,0,14643309
HepG2|chr2:70980734-70980882,chr2,70980734,70980882,HepG2|chr2:233200018-233200168,chr2,233200018,233200168,0,162219284
HepG2|chr2:71221707-71221805,chr2,71221707,71221805,HepG2|chr2:218804150-218804210,chr2,218804150,218804210,0,147582443
HepG2|chr2:71392146-71392292,chr2,71392146,71392292,HepG2|chr2:190305748-190305798,chr2,190305748,190305798,0,118913602
HepG2|chr2:71392175-71392263,chr2,71392175,71392263,HepG2|chr2:74230320-74230351,chr2,74230320,74230351,0,2838145
HepG2|chr2:71519589-71519614,chr2,71519589,71519614,HepG2|chr2:74230320-74230353,chr2,74230320,74230353,0,2710731
HepG2|chr2:72661316-72661466,chr2,72661316,72661466,HepG2|chr2:97779789-97779850,chr2,97779789,97779850,0,25118473
HepG2|chr2:73347235-73347385,chr2,73347235,73347385,HepG2|chr2:75181364-75181402,chr2,75181364,75181402,0,1834129
HepG2|chr2:73522005-73522076,chr2,73522005,73522076,HepG2|chr2:201991921-201991997,chr2,201991921,201991997,0,128469916
HepG2|chr2:73724358-73724508,chr2,73724358,73724508,HepG2|chr2:30370162-30370262,chr2,30370162,30370262,0,43354196
HepG2|chr2:74235735-74235882,chr2,74235735,74235882,HepG2|chr2:233197088-233197238,chr2,233197088,233197238,0,158961353
HepG2|chr2:74360500-74360526,chr2,74360500,74360526,HepG2|chr2:114517955-114518098,chr2,114517955,114518098,0,40157455
HepG2|chr2:74467290-74467365,chr2,74467290,74467365,HepG2|chr2:85193435-85193542,chr2,85193435,85193542,0,10726145
HepG2|chr2:74765323-74765363,chr2,74765323,74765363,HepG2|chr2:85193179-85193326,chr2,85193179,85193326,0,10427856
HepG2|chr2:74912278-74912384,chr2,74912278,74912384,HepG2|chr2:74230317-74230467,chr2,74230317,74230467,0,681961
HepG2|chr2:75498317-75498444,chr2,75498317,75498444,HepG2|chr2:44296282-44296299,chr2,44296282,44296299,0,31202035
HepG2|chr2:76713830-76713849,chr2,76713830,76713849,HepG2|chr2:242290454-242290585,chr2,242290454,242290585,0,165576624
HepG2|chr2:77023595-77023725,chr2,77023595,77023725,HepG2|chr2:85193944-85193993,chr2,85193944,85193993,0,8170349
HepG2|chr2:77458891-77458966,chr2,77458891,77458966,HepG2|chr2:74230262-74230412,chr2,74230262,74230412,0,3228629
HepG2|chr2:77740979-77741053,chr2,77740979,77741053,HepG2|chr2:85193944-85194020,chr2,85193944,85194020,0,7452965
HepG2|chr2:78957984-78958134,chr2,78957984,78958134,HepG2|chr2:233200050-233200200,chr2,233200050,233200200,0,154242066
HepG2|chr2:79550217-79550242,chr2,79550217,79550242,HepG2|chr2:220091642-220091767,chr2,220091642,220091767,0,140541425
HepG2|chr2:79645741-79645891,chr2,79645741,79645891,HepG2|chr2:43019463-43019528,chr2,43019463,43019528,0,36626278
HepG2|chr2:80396587-80396631,chr2,80396587,80396631,HepG2|chr2:74230236-74230363,chr2,74230236,74230363,0,6166351
HepG2|chr2:80522429-80522550,chr2,80522429,80522550,HepG2|chr2:233200051-233200189,chr2,233200051,233200189,0,152677622
HepG2|chr2:80539755-80539803,chr2,80539755,80539803,HepG2|chr2:74230236-74230353,chr2,74230236,74230353,0,6309519
HepG2|chr2:80663913-80663997,chr2,80663913,80663997,HepG2|chr2:233199916-233200066,chr2,233199916,233200066,0,152536003
HepG2|chr2:80978994-80979139,chr2,80978994,80979139,HepG2|chr2:86946823-86946966,chr2,86946823,86946966,0,5967829
HepG2|chr2:82178495-82178623,chr2,82178495,82178623,HepG2|chr2:11611126-11611276,chr2,11611126,11611276,0,70567369
HepG2|chr2:82553720-82553828,chr2,82553720,82553828,HepG2|chr2:85193944-85193986,chr2,85193944,85193986,0,2640224
HepG2|chr2:82670642-82670681,chr2,82670642,82670681,HepG2|chr2:75797518-75797665,chr2,75797518,75797665,0,6873124
HepG2|chr2:82816733-82816883,chr2,82816733,82816883,HepG2|chr2:30370162-30370262,chr2,30370162,30370262,0,52446571
HepG2|chr2:83005550-83005600,chr2,83005550,83005600,HepG2|chr2:216175401-216175501,chr2,216175401,216175501,0,133169851
HepG2|chr2:83083001-83083151,chr2,83083001,83083151,HepG2|chr2:85196491-85196588,chr2,85196491,85196588,0,2113490
HepG2|chr2:83644729-83644762,chr2,83644729,83644762,HepG2|chr2:74230236-74230353,chr2,74230236,74230353,0,9414493
HepG2|chr2:84025287-84025437,chr2,84025287,84025437,HepG2|chr2:27631687-27631717,chr2,27631687,27631717,0,56393600
HepG2|chr2:84068095-84068245,chr2,84068095,84068245,HepG2|chr2:233199829-233199979,chr2,233199829,233199979,0,149131734
HepG2|chr2:84315649-84315671,chr2,84315649,84315671,HepG2|chr2:85128896-85129002,chr2,85128896,85129002,0,813247
HepG2|chr2:84391343-84391414,chr2,84391343,84391414,HepG2|chr2:74230254-74230404,chr2,74230254,74230404,0,10161089
HepG2|chr2:84466813-84466877,chr2,84466813,84466877,HepG2|chr2:3644008-3644074,chr2,3644008,3644074,0,80822805
HepG2|chr2:84616863-84616973,chr2,84616863,84616973,HepG2|chr2:75800352-75800386,chr2,75800352,75800386,0,8816511
HepG2|chr2:84642567-84642687,chr2,84642567,84642687,HepG2|chr2:233197010-233197117,chr2,233197010,233197117,0,148554443
HepG2|chr2:85097876-85098026,chr2,85097876,85098026,HepG2|chr2:233197088-233197238,chr2,233197088,233197238,0,148099212
HepG2|chr2:86580026-86580153,chr2,86580026,86580153,HepG2|chr2:11611126-11611276,chr2,11611126,11611276,0,74968900
HepG2|chr2:87093244-87093381,chr2,87093244,87093381,HepG2|chr2:233197078-233197215,chr2,233197078,233197215,0,146103834
HepG2|chr2:87244052-87244122,chr2,87244052,87244122,HepG2|chr2:85128905-85129002,chr2,85128905,85129002,0,2115147
HepG2|chr2:87486665-87486710,chr2,87486665,87486710,HepG2|chr2:201724865-201725015,chr2,201724865,201725015,0,114238200
HepG2|chr2:88217290-88217436,chr2,88217290,88217436,HepG2|chr2:242293913-242293962,chr2,242293913,242293962,0,154076623
HepG2|chr2:88893910-88894060,chr2,88893910,88894060,HepG2|chr2:11610428-11610456,chr2,11610428,11610456,0,77283482
HepG2|chr2:89145648-89145798,chr2,89145648,89145798,HepG2|chr2:233199830-233199980,chr2,233199830,233199980,0,144054182
HepG2|chr2:89223794-89223899,chr2,89223794,89223899,HepG2|chr2:85193944-85193986,chr2,85193944,85193986,0,4029850
HepG2|chr2:89637353-89637466,chr2,89637353,89637466,HepG2|chr2:101435710-101435805,chr2,101435710,101435805,0,11798357
HepG2|chr2:90157372-90157442,chr2,90157372,90157442,HepG2|chr2:85128905-85129002,chr2,85128905,85129002,0,5028467
HepG2|chr2:90179468-90179493,chr2,90179468,90179493,HepG2|chr2:32850912-32851025,chr2,32850912,32851025,0,57328556
HepG2|chr2:90737266-90737326,chr2,90737266,90737326,HepG2|chr2:75788934-75789024,chr2,75788934,75789024,0,14948332
HepG2|chr2:90832931-90833080,chr2,90832931,90833080,HepG2|chr2:233200058-233200208,chr2,233200058,233200208,0,142367127
HepG2|chr2:90879720-90879760,chr2,90879720,90879760,HepG2|chr2:97779776-97779923,chr2,97779776,97779923,0,6900056
HepG2|chr2:90961816-90961906,chr2,90961816,90961906,HepG2|chr2:218804150-218804210,chr2,218804150,218804210,0,127842334
HepG2|chr2:91106663-91106750,chr2,91106663,91106750,HepG2|chr2:171783605-171783668,chr2,171783605,171783668,0,80676942
HepG2|chr2:91389023-91389067,chr2,91389023,91389067,HepG2|chr2:239333123-239333223,chr2,239333123,239333223,0,147944100
HepG2|chr2:91399368-91399419,chr2,91399368,91399419,HepG2|chr2:101435710-101435805,chr2,101435710,101435805,0,10036342
HepG2|chr2:91675284-91675431,chr2,91675284,91675431,HepG2|chr2:85193944-85193976,chr2,85193944,85193976,0,6481340
HepG2|chr2:92392456-92392477,chr2,92392456,92392477,HepG2|chr2:11606412-11606519,chr2,11606412,11606519,0,80786044
HepG2|chr2:92783976-92784001,chr2,92783976,92784001,HepG2|chr2:220091642-220091767,chr2,220091642,220091767,0,127307666
HepG2|chr2:93216209-93216252,chr2,93216209,93216252,HepG2|chr2:85193547-85193638,chr2,85193547,85193638,0,8022662
HepG2|chr2:93588981-93589077,chr2,93588981,93589077,HepG2|chr2:171781001-171781055,chr2,171781001,171781055,0,78192020
HepG2|chr2:93899438-93899545,chr2,93899438,93899545,HepG2|chr2:75183230-75183262,chr2,75183230,75183262,0,18716208
HepG2|chr2:94039709-94039808,chr2,94039709,94039808,HepG2|chr2:96677688-96677739,chr2,96677688,96677739,0,2637979
HepG2|chr2:94672081-94672136,chr2,94672081,94672136,HepG2|chr2:11606855-11606950,chr2,11606855,11606950,0,83065226
HepG2|chr2:94899732-94899801,chr2,94899732,94899801,HepG2|chr2:74230414-74230463,chr2,74230414,74230463,0,20669318
HepG2|chr2:95046774-95046831,chr2,95046774,95046831,HepG2|chr2:86948788-86948919,chr2,86948788,86948919,0,8097986
HepG2|chr2:95461315-95461389,chr2,95461315,95461389,HepG2|chr2:85193944-85194020,chr2,85193944,85194020,0,10267371
HepG2|chr2:95950916-95950938,chr2,95950916,95950938,HepG2|chr2:191511084-191511128,chr2,191511084,191511128,0,95560168
HepG2|chr2:96086319-96086400,chr2,96086319,96086400,HepG2|chr2:75183823-75183869,chr2,75183823,75183869,0,20902496
HepG2|chr2:96315621-96315662,chr2,96315621,96315662,HepG2|chr2:32853850-32854000,chr2,32853850,32854000,0,63461771
HepG2|chr2:97839641-97839744,chr2,97839641,97839744,HepG2|chr2:190305748-190305773,chr2,190305748,190305773,0,92466107
HepG2|chr2:99398164-99398283,chr2,99398164,99398283,HepG2|chr2:201979665-201979693,chr2,201979665,201979693,0,102581501
HepG2|chr2:99430691-99430816,chr2,99430691,99430816,HepG2|chr2:219860990-219861012,chr2,219860990,219861012,0,120430299
HepG2|chr2:100023466-100023594,chr2,100023466,100023594,HepG2|chr2:85193448-85193542,chr2,85193448,85193542,0,14830018
HepG2|chr2:101124467-101124511,chr2,101124467,101124511,HepG2|chr2:239333123-239333223,chr2,239333123,239333223,0,138208656
HepG2|chr2:101574477-101574627,chr2,101574477,101574627,HepG2|chr2:233200030-233200180,chr2,233200030,233200180,0,131625553
HepG2|chr2:102392603-102392647,chr2,102392603,102392647,HepG2|chr2:75181289-75181423,chr2,75181289,75181423,0,27211314
HepG2|chr2:102484517-102484666,chr2,102484517,102484666,HepG2|chr2:233200008-233200155,chr2,233200008,233200155,0,130715491
HepG2|chr2:103001256-103001406,chr2,103001256,103001406,HepG2|chr2:130886862-130886896,chr2,130886862,130886896,0,27885606
HepG2|chr2:103308717-103308867,chr2,103308717,103308867,HepG2|chr2:130886774-130886817,chr2,130886774,130886817,0,27578057
HepG2|chr2:104178696-104178839,chr2,104178696,104178839,HepG2|chr2:85193944-85193979,chr2,85193944,85193979,0,18984752
HepG2|chr2:104227626-104227675,chr2,104227626,104227675,HepG2|chr2:55496857-55496983,chr2,55496857,55496983,0,48730769
HepG2|chr2:104389700-104389850,chr2,104389700,104389850,HepG2|chr2:233199807-233199957,chr2,233199807,233199957,0,128810107
HepG2|chr2:104615720-104615816,chr2,104615720,104615816,HepG2|chr2:11607210-11607264,chr2,11607210,11607264,0,93008510
HepG2|chr2:105001906-105002047,chr2,105001906,105002047,HepG2|chr2:85193944-85193986,chr2,85193944,85193986,0,19807962
HepG2|chr2:105286817-105286967,chr2,105286817,105286967,HepG2|chr2:233200018-233200168,chr2,233200018,233200168,0,127913201
HepG2|chr2:105870787-105870809,chr2,105870787,105870809,HepG2|chr2:85194638-85194774,chr2,85194638,85194774,0,20676149
HepG2|chr2:106064240-106064329,chr2,106064240,106064329,HepG2|chr2:188417302-188417363,chr2,188417302,188417363,0,82353062
HepG2|chr2:106522884-106522920,chr2,106522884,106522920,HepG2|chr2:191746758-191746872,chr2,191746758,191746872,0,85223874
HepG2|chr2:106658175-106658192,chr2,106658175,106658192,HepG2|chr2:85193162-85193312,chr2,85193162,85193312,0,21465013
HepG2|chr2:106747865-106747965,chr2,106747865,106747965,HepG2|chr2:190305748-190305798,chr2,190305748,190305798,0,83557883
HepG2|chr2:106832526-106832676,chr2,106832526,106832676,HepG2|chr2:233200057-233200207,chr2,233200057,233200207,0,126367531
HepG2|chr2:107384478-107384628,chr2,107384478,107384628,HepG2|chr2:130886862-130886896,chr2,130886862,130886896,0,23502384
HepG2|chr2:107425200-107425289,chr2,107425200,107425289,HepG2|chr2:75788934-75789024,chr2,75788934,75789024,0,31636266
HepG2|chr2:107506083-107506155,chr2,107506083,107506155,HepG2|chr2:85194418-85194568,chr2,85194418,85194568,0,22311665
HepG2|chr2:107686305-107686350,chr2,107686305,107686350,HepG2|chr2:201724865-201725015,chr2,201724865,201725015,0,94038560
HepG2|chr2:107771619-107771675,chr2,107771619,107771675,HepG2|chr2:11610310-11610411,chr2,11610310,11610411,0,96161309
HepG2|chr2:108015366-108015515,chr2,108015366,108015515,HepG2|chr2:11603328-11603349,chr2,11603328,11603349,0,96412038
HepG2|chr2:108290092-108290141,chr2,108290092,108290141,HepG2|chr2:11610310-11610411,chr2,11610310,11610411,0,96679782
HepG2|chr2:109554048-109554158,chr2,109554048,109554158,HepG2|chr2:75800352-75800386,chr2,75800352,75800386,0,33753696
HepG2|chr2:110323039-110323189,chr2,110323039,110323189,HepG2|chr2:74230236-74230355,chr2,74230236,74230355,0,36092803
HepG2|chr2:110471438-110471525,chr2,110471438,110471525,HepG2|chr2:75874486-75874521,chr2,75874486,75874521,0,34596952
HepG2|chr2:110483014-110483089,chr2,110483014,110483089,HepG2|chr2:143637279-143637353,chr2,143637279,143637353,0,33154265
HepG2|chr2:110761466-110761606,chr2,110761466,110761606,HepG2|chr2:233199941-233200091,chr2,233199941,233200091,0,122438475
HepG2|chr2:112166275-112166425,chr2,112166275,112166425,HepG2|chr2:233197061-233197211,chr2,233197061,233197211,0,121030786
HepG2|chr2:112369594-112369694,chr2,112369594,112369694,HepG2|chr2:233200037-233200062,chr2,233200037,233200062,0,120830443
HepG2|chr2:112788046-112788193,chr2,112788046,112788193,HepG2|chr2:233197088-233197238,chr2,233197088,233197238,0,120409042
HepG2|chr2:112861847-112861902,chr2,112861847,112861902,HepG2|chr2:233197393-233197488,chr2,233197393,233197488,0,120335546
HepG2|chr2:112894611-112894669,chr2,112894611,112894669,HepG2|chr2:232514181-232514273,chr2,232514181,232514273,0,119619570
HepG2|chr2:113292286-113292329,chr2,113292286,113292329,HepG2|chr2:216175401-216175468,chr2,216175401,216175468,0,102883115
HepG2|chr2:113617798-113617948,chr2,113617798,113617948,HepG2|chr2:97779792-97779826,chr2,97779792,97779826,0,15838006
HepG2|chr2:113742143-113742166,chr2,113742143,113742166,HepG2|chr2:219432757-219432878,chr2,219432757,219432878,0,105690614
HepG2|chr2:113924665-113924743,chr2,113924665,113924743,HepG2|chr2:85194005-85194058,chr2,85194005,85194058,0,28730660
HepG2|chr2:113938375-113938487,chr2,113938375,113938487,HepG2|chr2:85193944-85193982,chr2,85193944,85193982,0,28744431
HepG2|chr2:114090280-114090299,chr2,114090280,114090299,HepG2|chr2:85194010-85194109,chr2,85194010,85194109,0,28896270
HepG2|chr2:114291169-114291228,chr2,114291169,114291228,HepG2|chr2:127982581-127982662,chr2,127982581,127982662,0,13691412
HepG2|chr2:114508231-114508319,chr2,114508231,114508319,HepG2|chr2:11610132-11610173,chr2,11610132,11610173,0,102898099
HepG2|chr2:114877614-114877764,chr2,114877614,114877764,HepG2|chr2:97779756-97779801,chr2,97779756,97779801,0,17097858
HepG2|chr2:115643178-115643328,chr2,115643178,115643328,HepG2|chr2:233199803-233199953,chr2,233199803,233199953,0,117556625
HepG2|chr2:115667084-115667125,chr2,115667084,115667125,HepG2|chr2:239333123-239333223,chr2,239333123,239333223,0,123666039
HepG2|chr2:115793958-115794105,chr2,115793958,115794105,HepG2|chr2:11607210-11607264,chr2,11607210,11607264,0,104186748
HepG2|chr2:117396411-117396456,chr2,117396411,117396456,HepG2|chr2:85194005-85194058,chr2,85194005,85194058,0,32202406
HepG2|chr2:117662589-117662611,chr2,117662589,117662611,HepG2|chr2:11606341-11606444,chr2,11606341,11606444,0,106056248
HepG2|chr2:118074910-118074930,chr2,118074910,118074930,HepG2|chr2:11606412-11606519,chr2,11606412,11606519,0,106468498
HepG2|chr2:118181427-118181555,chr2,118181427,118181555,HepG2|chr2:85193448-85193542,chr2,85193448,85193542,0,32987979
HepG2|chr2:118212960-118213044,chr2,118212960,118213044,HepG2|chr2:55496965-55496983,chr2,55496965,55496983,0,62715995
HepG2|chr2:119045705-119045836,chr2,119045705,119045836,HepG2|chr2:220091642-220091765,chr2,220091642,220091765,0,101045937
HepG2|chr2:119163880-119163960,chr2,119163880,119163960,HepG2|chr2:85197055-85197101,chr2,85197055,85197101,0,33966825
HepG2|chr2:119170999-119171127,chr2,119170999,119171127,HepG2|chr2:11603328-11603350,chr2,11603328,11603350,0,107567671
HepG2|chr2:119470362-119470512,chr2,119470362,119470512,HepG2|chr2:130886773-130886817,chr2,130886773,130886817,0,11416411
HepG2|chr2:119944529-119944556,chr2,119944529,119944556,HepG2|chr2:230784261-230784384,chr2,230784261,230784384,0,110839732
HepG2|chr2:119950680-119950745,chr2,119950680,119950745,HepG2|chr2:101435628-101435763,chr2,101435628,101435763,0,18515052
HepG2|chr2:120081578-120081697,chr2,120081578,120081697,HepG2|chr2:201979665-201979693,chr2,201979665,201979693,0,81898087
HepG2|chr2:121680737-121680887,chr2,121680737,121680887,HepG2|chr2:86948605-86948753,chr2,86948605,86948753,0,34732132
HepG2|chr2:122570617-122570645,chr2,122570617,122570645,HepG2|chr2:74230268-74230418,chr2,74230268,74230418,0,48340349
HepG2|chr2:122758814-122758939,chr2,122758814,122758939,HepG2|chr2:85194273-85194343,chr2,85194273,85194343,0,37564541
HepG2|chr2:123133190-123133220,chr2,123133190,123133220,HepG2|chr2:27807868-27807975,chr2,27807868,27807975,0,95325322
HepG2|chr2:123272357-123272456,chr2,123272357,123272456,HepG2|chr2:96677688-96677739,chr2,96677688,96677739,0,26594669
HepG2|chr2:123372597-123372719,chr2,123372597,123372719,HepG2|chr2:11610428-11610456,chr2,11610428,11610456,0,111762169
HepG2|chr2:125076101-125076158,chr2,125076101,125076158,HepG2|chr2:85193435-85193529,chr2,85193435,85193529,0,39882666
HepG2|chr2:125779485-125779521,chr2,125779485,125779521,HepG2|chr2:11606405-11606519,chr2,11606405,11606519,0,114173080
HepG2|chr2:125810453-125810523,chr2,125810453,125810523,HepG2|chr2:74230418-74230463,chr2,74230418,74230463,0,51580035
HepG2|chr2:126430129-126430177,chr2,126430129,126430177,HepG2|chr2:233200318-233200444,chr2,233200318,233200444,0,106770189
HepG2|chr2:126733438-126733526,chr2,126733438,126733526,HepG2|chr2:218804150-218804209,chr2,218804150,218804209,0,92070712
HepG2|chr2:127321065-127321096,chr2,127321065,127321096,HepG2|chr2:74230236-74230355,chr2,74230236,74230355,0,53090829
HepG2|chr2:127762635-127762678,chr2,127762635,127762678,HepG2|chr2:233200306-233200413,chr2,233200306,233200413,0,105437671
HepG2|chr2:127956245-127956361,chr2,127956245,127956361,HepG2|chr2:74230236-74230369,chr2,74230236,74230369,0,53726009
HepG2|chr2:128599896-128599994,chr2,128599896,128599994,HepG2|chr2:218804150-218804210,chr2,218804150,218804210,0,90204254
HepG2|chr2:128702671-128702791,chr2,128702671,128702791,HepG2|chr2:27631687-27631717,chr2,27631687,27631717,0,101070984
HepG2|chr2:128763603-128763721,chr2,128763603,128763721,HepG2|chr2:85193944-85193976,chr2,85193944,85193976,0,43569659
HepG2|chr2:128921796-128921946,chr2,128921796,128921946,HepG2|chr2:97779789-97779850,chr2,97779789,97779850,0,31142007
HepG2|chr2:129388987-129389134,chr2,129388987,129389134,HepG2|chr2:233200037-233200187,chr2,233200037,233200187,0,103811050
HepG2|chr2:130146602-130146627,chr2,130146602,130146627,HepG2|chr2:32850912-32851025,chr2,32850912,32851025,0,97295690
HepG2|chr2:130432770-130432830,chr2,130432770,130432830,HepG2|chr2:32852094-32852181,chr2,32852094,32852181,0,97580676
HepG2|chr2:130505954-130506103,chr2,130505954,130506103,HepG2|chr2:85197527-85197589,chr2,85197527,85197589,0,45308427
HepG2|chr2:130557114-130557189,chr2,130557114,130557189,HepG2|chr2:143637279-143637353,chr2,143637279,143637353,0,13080165
HepG2|chr2:131915352-131915452,chr2,131915352,131915452,HepG2|chr2:190305748-190305798,chr2,190305748,190305798,0,58390396
HepG2|chr2:132034018-132034049,chr2,132034018,132034049,HepG2|chr2:27807868-27807975,chr2,27807868,27807975,0,104226150
HepG2|chr2:132104666-132104794,chr2,132104666,132104794,HepG2|chr2:201978401-201978423,chr2,201978401,201978423,0,69873735
HepG2|chr2:132285467-132285608,chr2,132285467,132285608,HepG2|chr2:85193944-85193986,chr2,85193944,85193986,0,47091523
HepG2|chr2:132876016-132876102,chr2,132876016,132876102,HepG2|chr2:48540828-48540888,chr2,48540828,48540888,0,84335188
HepG2|chr2:133603839-133603989,chr2,133603839,133603989,HepG2|chr2:85193944-85194003,chr2,85193944,85194003,0,48409895
HepG2|chr2:133694595-133694745,chr2,133694595,133694745,HepG2|chr2:130886831-130886896,chr2,130886831,130886896,0,2807764
HepG2|chr2:133711767-133711911,chr2,133711767,133711911,HepG2|chr2:201979665-201979693,chr2,201979665,201979693,0,68267898
HepG2|chr2:133738178-133738303,chr2,133738178,133738303,HepG2|chr2:219860990-219861012,chr2,219860990,219861012,0,86122812
HepG2|chr2:134425785-134425872,chr2,134425785,134425872,HepG2|chr2:171783605-171783668,chr2,171783605,171783668,0,37357820
HepG2|chr2:134581404-134581554,chr2,134581404,134581554,HepG2|chr2:27631687-27631717,chr2,27631687,27631717,0,106949717
HepG2|chr2:134778950-134779037,chr2,134778950,134779037,HepG2|chr2:74230266-74230416,chr2,74230266,74230416,0,60548684
HepG2|chr2:134893142-134893164,chr2,134893142,134893164,HepG2|chr2:191511084-191511128,chr2,191511084,191511128,0,56617942
HepG2|chr2:135147404-135147459,chr2,135147404,135147459,HepG2|chr2:85193448-85193542,chr2,85193448,85193542,0,49953956
HepG2|chr2:135418920-135418963,chr2,135418920,135418963,HepG2|chr2:216175401-216175468,chr2,216175401,216175468,0,80756481
HepG2|chr2:135596115-135596227,chr2,135596115,135596227,HepG2|chr2:75184082-75184232,chr2,75184082,75184232,0,60412033
HepG2|chr2:136015219-136015365,chr2,136015219,136015365,HepG2|chr2:86948714-86948759,chr2,86948714,86948759,0,49066505
HepG2|chr2:136640519-136640665,chr2,136640519,136640665,HepG2|chr2:171781001-171781055,chr2,171781001,171781055,0,35140482
HepG2|chr2:136829610-136829667,chr2,136829610,136829667,HepG2|chr2:143636505-143636655,chr2,143636505,143636655,0,6806895
HepG2|chr2:136972846-136972889,chr2,136972846,136972889,HepG2|chr2:85128877-85129002,chr2,85128877,85129002,0,51843969
HepG2|chr2:138480768-138480914,chr2,138480768,138480914,HepG2|chr2:171781001-171781055,chr2,171781001,171781055,0,33300233
HepG2|chr2:138698805-138698833,chr2,138698805,138698833,HepG2|chr2:85193802-85193952,chr2,85193802,85193952,0,53505003
HepG2|chr2:138869470-138869503,chr2,138869470,138869503,HepG2|chr2:74230236-74230353,chr2,74230236,74230353,0,64639234
HepG2|chr2:139580313-139580373,chr2,139580313,139580373,HepG2|chr2:75788934-75789024,chr2,75788934,75789024,0,63791379
HepG2|chr2:140661319-140661408,chr2,140661319,140661408,HepG2|chr2:11610132-11610173,chr2,11610132,11610173,0,129051187
HepG2|chr2:140948446-140948596,chr2,140948446,140948596,HepG2|chr2:233199836-233199986,chr2,233199836,233199986,0,92251390
HepG2|chr2:141464691-141464746,chr2,141464691,141464746,HepG2|chr2:11606855-11606950,chr2,11606855,11606950,0,129857836
HepG2|chr2:141819415-141819565,chr2,141819415,141819565,HepG2|chr2:233200030-233200180,chr2,233200030,233200180,0,91380615
HepG2|chr2:142301559-142301580,chr2,142301559,142301580,HepG2|chr2:11606412-11606519,chr2,11606412,11606519,0,130695147
HepG2|chr2:142395541-142395644,chr2,142395541,142395644,HepG2|chr2:233197073-233197223,chr2,233197073,233197223,0,90801532
HepG2|chr2:142596684-142596834,chr2,142596684,142596834,HepG2|chr2:130886831-130886896,chr2,130886831,130886896,0,11709853
HepG2|chr2:142782759-142782816,chr2,142782759,142782816,HepG2|chr2:86948788-86948919,chr2,86948788,86948919,0,55833971
HepG2|chr2:142799931-142800067,chr2,142799931,142800067,HepG2|chr2:201978401-201978423,chr2,201978401,201978423,0,59178470
HepG2|chr2:142991880-142991987,chr2,142991880,142991987,HepG2|chr2:85193944-85194017,chr2,85193944,85194017,0,57797936
HepG2|chr2:143071661-143071767,chr2,143071661,143071767,HepG2|chr2:74230317-74230467,chr2,74230317,74230467,0,68841344
HepG2|chr2:143175317-143175422,chr2,143175317,143175422,HepG2|chr2:85194034-85194075,chr2,85194034,85194075,0,57981283
HepG2|chr2:143180182-143180329,chr2,143180182,143180329,HepG2|chr2:233197080-233197230,chr2,233197080,233197230,0,90016898
HepG2|chr2:143633789-143633876,chr2,143633789,143633876,HepG2|chr2:203133596-203133659,chr2,203133596,203133659,0,59499807
HepG2|chr2:144383169-144383201,chr2,144383169,144383201,HepG2|chr2:85193944-85194017,chr2,85193944,85194017,0,59189225
HepG2|chr2:144749828-144749937,chr2,144749828,144749937,HepG2|chr2:85128899-85129002,chr2,85128899,85129002,0,59620929
HepG2|chr2:145214114-145214158,chr2,145214114,145214158,HepG2|chr2:75181289-75181423,chr2,75181289,75181423,0,70032825
HepG2|chr2:145537637-145537787,chr2,145537637,145537787,HepG2|chr2:233200018-233200168,chr2,233200018,233200168,0,87662381
HepG2|chr2:146083301-146083410,chr2,146083301,146083410,HepG2|chr2:85128899-85129002,chr2,85128899,85129002,0,60954402
HepG2|chr2:146318687-146318837,chr2,146318687,146318837,HepG2|chr2:130886775-130886817,chr2,130886775,130886817,0,15431912
HepG2|chr2:146372556-146372686,chr2,146372556,146372686,HepG2|chr2:85193944-85193993,chr2,85193944,85193993,0,61178612
HepG2|chr2:146522340-146522455,chr2,146522340,146522455,HepG2|chr2:85193944-85193979,chr2,85193944,85193979,0,61328396
HepG2|chr2:147058067-147058214,chr2,147058067,147058214,HepG2|chr2:85193944-85193976,chr2,85193944,85193976,0,61864123
HepG2|chr2:147279654-147279687,chr2,147279654,147279687,HepG2|chr2:75184773-75184890,chr2,75184773,75184890,0,72094881
HepG2|chr2:147408373-147408485,chr2,147408373,147408485,HepG2|chr2:75181364-75181402,chr2,75181364,75181402,0,72227009
HepG2|chr2:147426640-147426790,chr2,147426640,147426790,HepG2|chr2:97779792-97779825,chr2,97779792,97779825,0,49646848
HepG2|chr2:147492262-147492326,chr2,147492262,147492326,HepG2|chr2:3644008-3644074,chr2,3644008,3644074,0,143848254
HepG2|chr2:147544822-147544857,chr2,147544822,147544857,HepG2|chr2:85197055-85197140,chr2,85197055,85197140,0,62347767
HepG2|chr2:149057976-149058088,chr2,149057976,149058088,HepG2|chr2:85193944-85193982,chr2,85193944,85193982,0,63864032
HepG2|chr2:149431506-149431553,chr2,149431506,149431553,HepG2|chr2:85128899-85129002,chr2,85128899,85129002,0,64302607
HepG2|chr2:149611703-149611806,chr2,149611703,149611806,HepG2|chr2:32850874-32850920,chr2,32850874,32850920,0,116760829
HepG2|chr2:150054584-150054690,chr2,150054584,150054690,HepG2|chr2:75183230-75183262,chr2,75183230,75183262,0,74871354
HepG2|chr2:151461140-151461183,chr2,151461140,151461183,HepG2|chr2:85193547-85193638,chr2,85193547,85193638,0,66267593
HepG2|chr2:152226878-152226931,chr2,152226878,152226931,HepG2|chr2:85128905-85129002,chr2,85128905,85129002,0,67097973
HepG2|chr2:152611940-152611989,chr2,152611940,152611989,HepG2|chr2:208493988-208494083,chr2,208493988,208494083,0,55882048
HepG2|chr2:152778713-152778761,chr2,152778713,152778761,HepG2|chr2:74230236-74230353,chr2,74230236,74230353,0,78548477
HepG2|chr2:152819882-152819986,chr2,152819882,152819986,HepG2|chr2:32850874-32850920,chr2,32850874,32850920,0,119969008
HepG2|chr2:153227793-153227860,chr2,153227793,153227860,HepG2|chr2:216175401-216175501,chr2,216175401,216175501,0,62947608
HepG2|chr2:153427961-153428043,chr2,153427961,153428043,HepG2|chr2:85194004-85194058,chr2,85194004,85194058,0,68233957
HepG2|chr2:153530345-153530399,chr2,153530345,153530399,HepG2|chr2:75184076-75184226,chr2,75184076,75184226,0,78346269
HepG2|chr2:153767674-153767824,chr2,153767674,153767824,HepG2|chr2:130886774-130886817,chr2,130886774,130886817,0,22880900
HepG2|chr2:154233538-154233643,chr2,154233538,154233643,HepG2|chr2:85195625-85195669,chr2,85195625,85195669,0,69037913
HepG2|chr2:154496736-154496782,chr2,154496736,154496782,HepG2|chr2:201979666-201979715,chr2,201979666,201979715,0,47482930
HepG2|chr2:154895902-154895985,chr2,154895902,154895985,HepG2|chr2:85195624-85195668,chr2,85195624,85195668,0,69700278
HepG2|chr2:155476097-155476244,chr2,155476097,155476244,HepG2|chr2:201991921-201991997,chr2,201991921,201991997,0,46515824
HepG2|chr2:156215948-156216038,chr2,156215948,156216038,HepG2|chr2:85193944-85194020,chr2,85193944,85194020,0,71022004
HepG2|chr2:156373824-156373916,chr2,156373824,156373916,HepG2|chr2:32850326-32850384,chr2,32850326,32850384,0,123523498
HepG2|chr2:156415637-156415696,chr2,156415637,156415696,HepG2|chr2:127982581-127982662,chr2,127982581,127982662,0,28433056
HepG2|chr2:156512207-156512329,chr2,156512207,156512329,HepG2|chr2:11610428-11610456,chr2,11610428,11610456,0,144901779
HepG2|chr2:156528723-156528859,chr2,156528723,156528859,HepG2|chr2:203133596-203133659,chr2,203133596,203133659,0,46604873
HepG2|chr2:156576109-156576194,chr2,156576109,156576194,HepG2|chr2:242848595-242848625,chr2,242848595,242848625,0,86272486
HepG2|chr2:156577927-156577948,chr2,156577927,156577948,HepG2|chr2:233384914-233385041,chr2,233384914,233385041,0,76806987
HepG2|chr2:156825421-156825476,chr2,156825421,156825476,HepG2|chr2:85193435-85193529,chr2,85193435,85193529,0,71631986
HepG2|chr2:156835986-156836029,chr2,156835986,156836029,HepG2|chr2:85128877-85129002,chr2,85128877,85129002,0,71707109
HepG2|chr2:157000798-157000934,chr2,157000798,157000934,HepG2|chr2:203133596-203133659,chr2,203133596,203133659,0,46132798
HepG2|chr2:157540599-157540706,chr2,157540599,157540706,HepG2|chr2:75183230-75183262,chr2,75183230,75183262,0,82357369
HepG2|chr2:157609838-157609988,chr2,157609838,157609988,HepG2|chr2:27990010-27990046,chr2,27990010,27990046,0,129619828
HepG2|chr2:158217724-158217874,chr2,158217724,158217874,HepG2|chr2:74230320-74230369,chr2,74230320,74230369,0,83987404
HepG2|chr2:158274430-158274557,chr2,158274430,158274557,HepG2|chr2:44296282-44296299,chr2,44296282,44296299,0,113978148
HepG2|chr2:158619881-158620026,chr2,158619881,158620026,HepG2|chr2:233196981-233197124,chr2,233196981,233197124,0,74577100
HepG2|chr2:159102084-159102137,chr2,159102084,159102137,HepG2|chr2:11606790-11606940,chr2,11606790,11606940,0,147495294
HepG2|chr2:159148752-159148785,chr2,159148752,159148785,HepG2|chr2:65139293-65139343,chr2,65139293,65139343,0,94009459
HepG2|chr2:160370909-160371056,chr2,160370909,160371056,HepG2|chr2:233200018-233200168,chr2,233200018,233200168,0,72829109
HepG2|chr2:160829265-160829300,chr2,160829265,160829300,HepG2|chr2:114518013-114518093,chr2,114518013,114518093,0,46311252
HepG2|chr2:161206994-161207043,chr2,161206994,161207043,HepG2|chr2:208493988-208494083,chr2,208493988,208494083,0,47286994
HepG2|chr2:161851926-161851975,chr2,161851926,161851975,HepG2|chr2:55496857-55496983,chr2,55496857,55496983,0,106355069
HepG2|chr2:161959011-161959158,chr2,161959011,161959158,HepG2|chr2:233197080-233197230,chr2,233197080,233197230,0,71238069
HepG2|chr2:161970826-161970844,chr2,161970826,161970844,HepG2|chr2:172779820-172779949,chr2,172779820,172779949,0,10808994
HepG2|chr2:162505822-162505972,chr2,162505822,162505972,HepG2|chr2:233199987-233200130,chr2,233199987,233200130,0,70694165
HepG2|chr2:162986795-162986855,chr2,162986795,162986855,HepG2|chr2:191746758-191746872,chr2,191746758,191746872,0,28759963
HepG2|chr2:163271677-163271719,chr2,163271677,163271719,HepG2|chr2:216175400-216175533,chr2,216175400,216175533,0,52903723
HepG2|chr2:164037084-164037151,chr2,164037084,164037151,HepG2|chr2:74230243-74230390,chr2,74230243,74230390,0,89806841
HepG2|chr2:164689200-164689350,chr2,164689200,164689350,HepG2|chr2:233200033-233200183,chr2,233200033,233200183,0,68510833
HepG2|chr2:164880436-164880563,chr2,164880436,164880563,HepG2|chr2:11611126-11611276,chr2,11611126,11611276,0,153269310
HepG2|chr2:165155544-165155633,chr2,165155544,165155633,HepG2|chr2:11610132-11610173,chr2,11610132,11610173,0,153545412
HepG2|chr2:165261416-165261463,chr2,165261416,165261463,HepG2|chr2:198366363-198366509,chr2,198366363,198366509,0,33104947
HepG2|chr2:165282371-165282489,chr2,165282371,165282489,HepG2|chr2:219860990-219861012,chr2,219860990,219861012,0,54578619
HepG2|chr2:165387398-165387548,chr2,165387398,165387548,HepG2|chr2:11610428-11610456,chr2,11610428,11610456,0,153776970
HepG2|chr2:165725692-165725779,chr2,165725692,165725779,HepG2|chr2:219860990-219861012,chr2,219860990,219861012,0,54135298
HepG2|chr2:165785112-165785262,chr2,165785112,165785262,HepG2|chr2:233200033-233200183,chr2,233200033,233200183,0,67414921
HepG2|chr2:165790149-165790246,chr2,165790149,165790246,HepG2|chr2:232514160-232514204,chr2,232514160,232514204,0,66724011
HepG2|chr2:166743017-166743164,chr2,166743017,166743164,HepG2|chr2:11607210-11607264,chr2,11607210,11607264,0,155135807
HepG2|chr2:167879432-167879582,chr2,167879432,167879582,HepG2|chr2:27990010-27990046,chr2,27990010,27990046,0,139889422
HepG2|chr2:167885492-167885628,chr2,167885492,167885628,HepG2|chr2:201978401-201978423,chr2,201978401,201978423,0,34092909
HepG2|chr2:168411382-168411532,chr2,168411382,168411532,HepG2|chr2:97779792-97779825,chr2,97779792,97779825,0,70631590
HepG2|chr2:168741775-168741822,chr2,168741775,168741822,HepG2|chr2:85128899-85129002,chr2,85128899,85129002,0,83612876
HepG2|chr2:168798958-168799101,chr2,168798958,168799101,HepG2|chr2:85193944-85193979,chr2,85193944,85193979,0,83605014
HepG2|chr2:168935113-168935225,chr2,168935113,168935225,HepG2|chr2:75184082-75184232,chr2,75184082,75184232,0,93751031
HepG2|chr2:169012132-169012230,chr2,169012132,169012230,HepG2|chr2:85194632-85194659,chr2,85194632,85194659,0,83817500
HepG2|chr2:170049797-170049947,chr2,170049797,170049947,HepG2|chr2:130886773-130886817,chr2,130886773,130886817,0,39163024
HepG2|chr2:170408955-170409033,chr2,170408955,170409033,HepG2|chr2:85194005-85194058,chr2,85194005,85194058,0,85214950
HepG2|chr2:170997301-170997391,chr2,170997301,170997391,HepG2|chr2:48540828-48540888,chr2,48540828,48540888,0,122456473
HepG2|chr2:171406176-171406233,chr2,171406176,171406233,HepG2|chr2:85193435-85193529,chr2,85193435,85193529,0,86212741
HepG2|chr2:171496528-171496675,chr2,171496528,171496675,HepG2|chr2:201991921-201991997,chr2,201991921,201991997,0,30495393
HepG2|chr2:171548874-171548959,chr2,171548874,171548959,HepG2|chr2:43019463-43019528,chr2,43019463,43019528,0,128529411
HepG2|chr2:171575337-171575484,chr2,171575337,171575484,HepG2|chr2:85194100-85194126,chr2,85194100,85194126,0,86381237
HepG2|chr2:172185200-172185345,chr2,172185200,172185345,HepG2|chr2:86946823-86946966,chr2,86946823,86946966,0,85238377
HepG2|chr2:172372421-172372542,chr2,172372421,172372542,HepG2|chr2:233200051-233200189,chr2,233200051,233200189,0,60827630
HepG2|chr2:173075495-173075645,chr2,173075495,173075645,HepG2|chr2:85193944-85194003,chr2,85193944,85194003,0,87881551
HepG2|chr2:173965367-173965517,chr2,173965367,173965517,HepG2|chr2:233199829-233199979,chr2,233199829,233199979,0,59234462
HepG2|chr2:174059773-174059815,chr2,174059773,174059815,HepG2|chr2:85193547-85193638,chr2,85193547,85193638,0,88866226
HepG2|chr2:174124693-174124837,chr2,174124693,174124837,HepG2|chr2:201979665-201979693,chr2,201979665,201979693,0,27854972
HepG2|chr2:174598946-174599001,chr2,174598946,174599001,HepG2|chr2:74230320-74230351,chr2,74230320,74230351,0,100368626
HepG2|chr2:175005258-175005327,chr2,175005258,175005327,HepG2|chr2:74230414-74230463,chr2,74230414,74230463,0,100774844
HepG2|chr2:175281449-175281494,chr2,175281449,175281494,HepG2|chr2:85194005-85194058,chr2,85194005,85194058,0,90087444
HepG2|chr2:175651555-175651683,chr2,175651555,175651683,HepG2|chr2:201978401-201978423,chr2,201978401,201978423,0,26326846
HepG2|chr2:176490249-176490377,chr2,176490249,176490377,HepG2|chr2:11603328-11603350,chr2,11603328,11603350,0,164886921
HepG2|chr2:177308086-177308140,chr2,177308086,177308140,HepG2|chr2:233200048-233200198,chr2,233200048,233200198,0,55891962
HepG2|chr2:177443961-177444109,chr2,177443961,177444109,HepG2|chr2:233199926-233200076,chr2,233199926,233200076,0,55755965
HepG2|chr2:177586603-177586663,chr2,177586603,177586663,HepG2|chr2:32852094-32852181,chr2,32852094,32852181,0,144734509
HepG2|chr2:178150584-178150731,chr2,178150584,178150731,HepG2|chr2:85194100-85194126,chr2,85194100,85194126,0,92956484
HepG2|chr2:178746675-178746732,chr2,178746675,178746732,HepG2|chr2:143636505-143636655,chr2,143636505,143636655,0,35110170
HepG2|chr2:179718462-179718533,chr2,179718462,179718533,HepG2|chr2:74230254-74230404,chr2,74230254,74230404,0,105488208
HepG2|chr2:180233205-180233290,chr2,180233205,180233290,HepG2|chr2:242848595-242848625,chr2,242848595,242848625,0,62615390
HepG2|chr2:180366909-180366939,chr2,180366909,180366939,HepG2|chr2:27807868-27807975,chr2,27807868,27807975,0,152559041
HepG2|chr2:180405960-180406048,chr2,180405960,180406048,HepG2|chr2:11610132-11610173,chr2,11610132,11610173,0,168795828
HepG2|chr2:180485321-180485471,chr2,180485321,180485471,HepG2|chr2:74230236-74230355,chr2,74230236,74230355,0,106255085
HepG2|chr2:180555320-180555469,chr2,180555320,180555469,HepG2|chr2:233199922-233200069,chr2,233199922,233200069,0,52644602
HepG2|chr2:180755165-180755233,chr2,180755165,180755233,HepG2|chr2:216175480-216175630,chr2,216175480,216175630,0,35420315
HepG2|chr2:181910618-181910765,chr2,181910618,181910765,HepG2|chr2:242290454-242290585,chr2,242290454,242290585,0,60379836
HepG2|chr2:182003708-182003770,chr2,182003708,182003770,HepG2|chr2:101435208-101435358,chr2,101435208,101435358,0,80568500
HepG2|chr2:182234043-182234107,chr2,182234043,182234107,HepG2|chr2:233199818-233199902,chr2,233199818,233199902,0,50965775
HepG2|chr2:183044161-183044281,chr2,183044161,183044281,HepG2|chr2:233197010-233197117,chr2,233197010,233197117,0,50152849
HepG2|chr2:183046706-183046830,chr2,183046706,183046830,HepG2|chr2:85194100-85194126,chr2,85194100,85194126,0,97852606
HepG2|chr2:183064891-183065038,chr2,183064891,183065038,HepG2|chr2:233200018-233200168,chr2,233200018,233200168,0,50135127
HepG2|chr2:183092510-183092598,chr2,183092510,183092598,HepG2|chr2:85197480-85197630,chr2,85197480,85197630,0,97895030
HepG2|chr2:184624213-184624243,chr2,184624213,184624243,HepG2|chr2:74230236-74230358,chr2,74230236,74230358,0,110393977
HepG2|chr2:184849796-184849901,chr2,184849796,184849901,HepG2|chr2:85195625-85195669,chr2,85195625,85195669,0,99654171
HepG2|chr2:184994631-184994671,chr2,184994631,184994671,HepG2|chr2:97779776-97779923,chr2,97779776,97779923,0,87214855
HepG2|chr2:186337179-186337276,chr2,186337179,186337276,HepG2|chr2:232514160-232514204,chr2,232514160,232514204,0,46176981
HepG2|chr2:186343324-186343474,chr2,186343324,186343474,HepG2|chr2:233197088-233197238,chr2,233197088,233197238,0,46853764
HepG2|chr2:186933905-186934018,chr2,186933905,186934018,HepG2|chr2:101435710-101435805,chr2,101435710,101435805,0,85498195
HepG2|chr2:187253963-187254039,chr2,187253963,187254039,HepG2|chr2:114518058-114518093,chr2,114518058,114518093,0,72735905
HepG2|chr2:188175727-188175877,chr2,188175727,188175877,HepG2|chr2:233196960-233197110,chr2,233196960,233197110,0,45021233
HepG2|chr2:188226831-188226981,chr2,188226831,188226981,HepG2|chr2:233200016-233200166,chr2,233200016,233200166,0,44973185
HepG2|chr2:188397770-188397920,chr2,188397770,188397920,HepG2|chr2:97779646-97779792,chr2,97779646,97779792,0,90618124
HepG2|chr2:188492916-188493003,chr2,188492916,188493003,HepG2|chr2:85197527-85197589,chr2,85197527,85197589,0,103295389
HepG2|chr2:189614487-189614519,chr2,189614487,189614519,HepG2|chr2:85193944-85194017,chr2,85193944,85194017,0,104420543
HepG2|chr2:190250406-190250498,chr2,190250406,190250498,HepG2|chr2:32850326-32850384,chr2,32850326,32850384,0,157400080
HepG2|chr2:190863112-190863172,chr2,190863112,190863172,HepG2|chr2:74230236-74230353,chr2,74230236,74230353,0,116632876
HepG2|chr2:191091715-191091780,chr2,191091715,191091780,HepG2|chr2:127982581-127982662,chr2,127982581,127982662,0,63109134
HepG2|chr2:191215044-191215131,chr2,191215044,191215131,HepG2|chr2:75874486-75874521,chr2,75874486,75874521,0,115340558
HepG2|chr2:191295856-191296002,chr2,191295856,191296002,HepG2|chr2:127982625-127982662,chr2,127982625,127982662,0,63313231
HepG2|chr2:191665644-191665674,chr2,191665644,191665674,HepG2|chr2:85193499-85193649,chr2,85193499,85193649,0,106472145
HepG2|chr2:192607413-192607526,chr2,192607413,192607526,HepG2|chr2:127982625-127982662,chr2,127982625,127982662,0,64624788
HepG2|chr2:192948797-192948934,chr2,192948797,192948934,HepG2|chr2:233197078-233197215,chr2,233197078,233197215,0,40248281
HepG2|chr2:193552747-193552897,chr2,193552747,193552897,HepG2|chr2:233197061-233197211,chr2,233197061,233197211,0,39644314
HepG2|chr2:193570986-193571053,chr2,193570986,193571053,HepG2|chr2:85193944-85194017,chr2,85193944,85194017,0,108377042
HepG2|chr2:193624116-193624266,chr2,193624116,193624266,HepG2|chr2:233199992-233200142,chr2,233199992,233200142,0,39575876
HepG2|chr2:193872660-193872810,chr2,193872660,193872810,HepG2|chr2:233199836-233199986,chr2,233199836,233199986,0,39327176
HepG2|chr2:194669316-194669402,chr2,194669316,194669402,HepG2|chr2:48540828-48540888,chr2,48540828,48540888,0,146128488
HepG2|chr2:194738533-194738579,chr2,194738533,194738579,HepG2|chr2:201979666-201979715,chr2,201979666,201979715,0,7241133
HepG2|chr2:194993990-194994139,chr2,194993990,194994139,HepG2|chr2:85197527-85197589,chr2,85197527,85197589,0,109796463
HepG2|chr2:195373128-195373243,chr2,195373128,195373243,HepG2|chr2:85193944-85193979,chr2,85193944,85193979,0,110179184
HepG2|chr2:195828344-195828392,chr2,195828344,195828392,HepG2|chr2:233200318-233200444,chr2,233200318,233200444,0,37371974
HepG2|chr2:196062775-196062837,chr2,196062775,196062837,HepG2|chr2:101435208-101435358,chr2,101435208,101435358,0,94627567
HepG2|chr2:196152093-196152242,chr2,196152093,196152242,HepG2|chr2:233200008-233200155,chr2,233200008,233200155,0,37047915
HepG2|chr2:196962707-196962855,chr2,196962707,196962855,HepG2|chr2:233199926-233200076,chr2,233199926,233200076,0,36237219
HepG2|chr2:197201285-197201391,chr2,197201285,197201391,HepG2|chr2:75183230-75183262,chr2,75183230,75183262,0,122018055
HepG2|chr2:198222203-198222220,chr2,198222203,198222220,HepG2|chr2:85193162-85193312,chr2,85193162,85193312,0,113029041
HepG2|chr2:198429985-198430024,chr2,198429985,198430024,HepG2|chr2:11606405-11606519,chr2,11606405,11606519,0,186823580
HepG2|chr2:199042395-199042483,chr2,199042395,199042483,HepG2|chr2:85197480-85197630,chr2,85197480,85197630,0,113844915
HepG2|chr2:199935969-199936036,chr2,199935969,199936036,HepG2|chr2:85193944-85194017,chr2,85193944,85194017,0,114742025
HepG2|chr2:200486498-200486610,chr2,200486498,200486610,HepG2|chr2:233199818-233199902,chr2,233199818,233199902,0,32713320
HepG2|chr2:200493711-200493861,chr2,200493711,200493861,HepG2|chr2:233200022-233200172,chr2,233200022,233200172,0,32706311
HepG2|chr2:200577107-200577187,chr2,200577107,200577187,HepG2|chr2:85194273-85194343,chr2,85194273,85194343,0,115382834
HepG2|chr2:201089549-201089586,chr2,201089549,201089586,HepG2|chr2:239334372-239334461,chr2,239334372,239334461,0,38244823
HepG2|chr2:201308770-201308830,chr2,201308770,201308830,HepG2|chr2:74230236-74230353,chr2,74230236,74230353,0,127078534
HepG2|chr2:201424377-201424442,chr2,201424377,201424442,HepG2|chr2:85197480-85197630,chr2,85197480,85197630,0,116226897
HepG2|chr2:202347308-202347372,chr2,202347308,202347372,HepG2|chr2:208494090-208494129,chr2,208494090,208494129,0,6146782
HepG2|chr2:203098743-203098786,chr2,203098743,203098786,HepG2|chr2:85193435-85193542,chr2,85193435,85193542,0,117905308
HepG2|chr2:203335394-203335491,chr2,203335394,203335491,HepG2|chr2:201978401-201978423,chr2,201978401,201978423,0,1356993
HepG2|chr2:203820392-203820479,chr2,203820392,203820479,HepG2|chr2:219860990-219861012,chr2,219860990,219861012,0,16040598
HepG2|chr2:204246118-204246266,chr2,204246118,204246266,HepG2|chr2:233200018-233200168,chr2,233200018,233200168,0,28953900
HepG2|chr2:204416641-204416791,chr2,204416641,204416791,HepG2|chr2:233197428-233197578,chr2,233197428,233197578,0,28780787
HepG2|chr2:205023679-205023829,chr2,205023679,205023829,HepG2|chr2:86948601-86948747,chr2,86948601,86948747,0,118075078
HepG2|chr2:205345048-205345123,chr2,205345048,205345123,HepG2|chr2:74230262-74230412,chr2,74230262,74230412,0,131114786
HepG2|chr2:206364458-206364547,chr2,206364458,206364547,HepG2|chr2:188417302-188417363,chr2,188417302,188417363,0,17947156
HepG2|chr2:206640627-206640666,chr2,206640627,206640666,HepG2|chr2:230784261-230784384,chr2,230784261,230784384,0,24143634
HepG2|chr2:207098272-207098422,chr2,207098272,207098422,HepG2|chr2:85195625-85195669,chr2,85195625,85195669,0,121902647
HepG2|chr2:207286506-207286595,chr2,207286506,207286595,HepG2|chr2:242848595-242848625,chr2,242848595,242848625,0,35562089
HepG2|chr2:207418189-207418339,chr2,207418189,207418339,HepG2|chr2:233199832-233199982,chr2,233199832,233199982,0,25781643
HepG2|chr2:208126185-208126298,chr2,208126185,208126298,HepG2|chr2:75800353-75800386,chr2,75800353,75800386,0,132325832
HepG2|chr2:208711369-208711430,chr2,208711369,208711430,HepG2|chr2:32852094-32852181,chr2,32852094,32852181,0,175859275
HepG2|chr2:208999898-208999938,chr2,208999898,208999938,HepG2|chr2:233197732-233197812,chr2,233197732,233197812,0,24197834
HepG2|chr2:209046636-209046748,chr2,209046636,209046748,HepG2|chr2:75181364-75181402,chr2,75181364,75181402,0,133865272
HepG2|chr2:209062961-209063111,chr2,209062961,209063111,HepG2|chr2:86946797-86946947,chr2,86946797,86946947,0,122116164
HepG2|chr2:209077341-209077364,chr2,209077341,209077364,HepG2|chr2:219432757-219432878,chr2,219432757,219432878,0,10355416
HepG2|chr2:209094517-209094635,chr2,209094517,209094635,HepG2|chr2:85193865-85193885,chr2,85193865,85193885,0,123900652
HepG2|chr2:209298987-209299078,chr2,209298987,209299078,HepG2|chr2:85193944-85194003,chr2,85193944,85194003,0,124105043
HepG2|chr2:209337651-209337797,chr2,209337651,209337797,HepG2|chr2:86948714-86948759,chr2,86948714,86948759,0,122388937
HepG2|chr2:210492871-210493021,chr2,210492871,210493021,HepG2|chr2:130886775-130886817,chr2,130886775,130886817,0,79606096
HepG2|chr2:210671985-210672050,chr2,210671985,210672050,HepG2|chr2:101435628-101435763,chr2,101435628,101435763,0,109236357
HepG2|chr2:211447635-211447730,chr2,211447635,211447730,HepG2|chr2:188417302-188417363,chr2,188417302,188417363,0,23030333
HepG2|chr2:211809035-211809088,chr2,211809035,211809088,HepG2|chr2:74230262-74230412,chr2,74230262,74230412,0,137578773
HepG2|chr2:212251399-212251530,chr2,212251399,212251530,HepG2|chr2:220091642-220091765,chr2,220091642,220091765,0,7840243
HepG2|chr2:212434002-212434047,chr2,212434002,212434047,HepG2|chr2:97779754-97779904,chr2,97779754,97779904,0,114654248
HepG2|chr2:212539825-212539929,chr2,212539825,212539929,HepG2|chr2:85193944-85193963,chr2,85193944,85193963,0,127345881
HepG2|chr2:213004112-213004136,chr2,213004112,213004136,HepG2|chr2:85195596-85195732,chr2,85195596,85195732,0,127808516
HepG2|chr2:213948721-213948826,chr2,213948721,213948826,HepG2|chr2:85193944-85193986,chr2,85193944,85193986,0,128754777
HepG2|chr2:214887832-214887850,chr2,214887832,214887850,HepG2|chr2:172779820-172779949,chr2,172779820,172779949,0,42108012
HepG2|chr2:214913316-214913371,chr2,214913316,214913371,HepG2|chr2:74230320-74230351,chr2,74230320,74230351,0,140682996
HepG2|chr2:214940411-214940524,chr2,214940411,214940524,HepG2|chr2:127982625-127982662,chr2,127982625,127982662,0,86957786
HepG2|chr2:215359015-215359057,chr2,215359015,215359057,HepG2|chr2:85193547-85193638,chr2,85193547,85193638,0,130165468
HepG2|chr2:215575777-215575896,chr2,215575777,215575896,HepG2|chr2:219860990-219861012,chr2,219860990,219861012,0,4285213
HepG2|chr2:216147240-216147389,chr2,216147240,216147389,HepG2|chr2:11603328-11603349,chr2,11603328,11603349,0,204543912
HepG2|chr2:216328622-216328711,chr2,216328622,216328711,HepG2|chr2:75788934-75789024,chr2,75788934,75789024,0,140539688
HepG2|chr2:217094732-217094760,chr2,217094732,217094760,HepG2|chr2:85193802-85193952,chr2,85193802,85193952,0,131900930
HepG2|chr2:217321292-217321381,chr2,217321292,217321381,HepG2|chr2:85193423-85193568,chr2,85193423,85193568,0,132127869
HepG2|chr2:218357770-218357920,chr2,218357770,218357920,HepG2|chr2:86948769-86948919,chr2,86948769,86948919,0,131409001
HepG2|chr2:219131043-219131062,chr2,219131043,219131062,HepG2|chr2:85194010-85194109,chr2,85194010,85194109,0,133937033
HepG2|chr2:219682038-219682186,chr2,219682038,219682186,HepG2|chr2:171783605-171783668,chr2,171783605,171783668,0,47898433
HepG2|chr2:219988813-219988963,chr2,219988813,219988963,HepG2|chr2:86946797-86946947,chr2,86946797,86946947,0,133042016
HepG2|chr2:220751187-220751241,chr2,220751187,220751241,HepG2|chr2:75184076-75184226,chr2,75184076,75184226,0,145567111
HepG2|chr2:220827305-220827344,chr2,220827305,220827344,HepG2|chr2:75797518-75797665,chr2,75797518,75797665,0,145029787
HepG2|chr2:221708064-221708212,chr2,221708064,221708212,HepG2|chr2:171783605-171783668,chr2,171783605,171783668,0,49924459
HepG2|chr2:222545000-222545150,chr2,222545000,222545150,HepG2|chr2:233199803-233199953,chr2,233199803,233199953,0,10654803
HepG2|chr2:223185119-223185191,chr2,223185119,223185191,HepG2|chr2:85194418-85194568,chr2,85194418,85194568,0,137990701
HepG2|chr2:223260982-223261132,chr2,223260982,223261132,HepG2|chr2:233197065-233197215,chr2,233197065,233197215,0,9936083
HepG2|chr2:224922520-224922636,chr2,224922520,224922636,HepG2|chr2:75801251-75801340,chr2,75801251,75801340,0,149121269
HepG2|chr2:224954166-224954256,chr2,224954166,224954256,HepG2|chr2:218804150-218804210,chr2,218804150,218804210,0,6150016
HepG2|chr2:225543548-225543607,chr2,225543548,225543607,HepG2|chr2:74226167-74226317,chr2,74226167,74226317,0,151317381
HepG2|chr2:225886557-225886587,chr2,225886557,225886587,HepG2|chr2:85193944-85194042,chr2,85193944,85194042,0,140692613
HepG2|chr2:226199581-226199730,chr2,226199581,226199730,HepG2|chr2:130886774-130886817,chr2,130886774,130886817,0,95312807
HepG2|chr2:227509290-227509379,chr2,227509290,227509379,HepG2|chr2:85193423-85193568,chr2,85193423,85193568,0,142315867
HepG2|chr2:227555072-227555144,chr2,227555072,227555144,HepG2|chr2:191511084-191511128,chr2,191511084,191511128,0,36043988
HepG2|chr2:228336158-228336193,chr2,228336158,228336193,HepG2|chr2:114518013-114518093,chr2,114518013,114518093,0,113818145
HepG2|chr2:228793620-228793681,chr2,228793620,228793681,HepG2|chr2:32852094-32852181,chr2,32852094,32852181,0,195941526
HepG2|chr2:229002094-229002198,chr2,229002094,229002198,HepG2|chr2:32850874-32850920,chr2,32850874,32850920,0,196151220
HepG2|chr2:229264735-229264760,chr2,229264735,229264760,HepG2|chr2:74230320-74230353,chr2,74230320,74230353,0,155034415
HepG2|chr2:229583667-229583766,chr2,229583667,229583766,HepG2|chr2:190305748-190305798,chr2,190305748,190305798,0,39277919
HepG2|chr2:231228130-231228214,chr2,231228130,231228214,HepG2|chr2:233199994-233200141,chr2,233199994,233200141,0,1971864
HepG2|chr2:231245708-231245732,chr2,231245708,231245732,HepG2|chr2:85195596-85195732,chr2,85195596,85195732,0,146050112
HepG2|chr2:232111789-232111885,chr2,232111789,232111885,HepG2|chr2:11607210-11607264,chr2,11607210,11607264,0,220504579
HepG2|chr2:232630296-232630445,chr2,232630296,232630445,HepG2|chr2:233199807-233199957,chr2,233199807,233199957,0,569511
HepG2|chr2:232761678-232761711,chr2,232761678,232761711,HepG2|chr2:65139293-65139343,chr2,65139293,65139343,0,167622385
HepG2|chr2:232939745-232939895,chr2,232939745,232939895,HepG2|chr2:233200018-233200168,chr2,233200018,233200168,0,260273
HepG2|chr2:233092371-233092455,chr2,233092371,233092455,HepG2|chr2:233199916-233200066,chr2,233199916,233200066,0,107545
HepG2|chr2:233114152-233114171,chr2,233114152,233114171,HepG2|chr2:75183726-75183811,chr2,75183726,75183811,0,157930426
HepG2|chr2:233666812-233666899,chr2,233666812,233666899,HepG2|chr2:85197527-85197589,chr2,85197527,85197589,0,148469285
HepG2|chr2:233876178-233876328,chr2,233876178,233876328,HepG2|chr2:233199807-233199957,chr2,233199807,233199957,0,676371
HepG2|chr2:234111208-234111347,chr2,234111208,234111347,HepG2|chr2:130886784-130886817,chr2,130886784,130886817,0,103224424
HepG2|chr2:234230876-234230896,chr2,234230876,234230896,HepG2|chr2:69970375-69970525,chr2,69970375,69970525,0,164260501
HepG2|chr2:234637285-234637326,chr2,234637285,234637326,HepG2|chr2:32853850-32854000,chr2,32853850,32854000,0,201783435
HepG2|chr2:234667165-234667256,chr2,234667165,234667256,HepG2|chr2:85193944-85194003,chr2,85193944,85194003,0,149473221
HepG2|chr2:235024099-235024126,chr2,235024099,235024126,HepG2|chr2:220091642-220091765,chr2,220091642,220091765,0,14932457
HepG2|chr2:235092175-235092197,chr2,235092175,235092197,HepG2|chr2:174829046-174829166,chr2,174829046,174829166,0,60263129
HepG2|chr2:235178309-235178350,chr2,235178309,235178350,HepG2|chr2:239333123-239333223,chr2,239333123,239333223,0,4154814
HepG2|chr2:235211186-235211229,chr2,235211186,235211229,HepG2|chr2:233200306-233200413,chr2,233200306,233200413,0,2010880
HepG2|chr2:235434156-235434256,chr2,235434156,235434256,HepG2|chr2:233200037-233200062,chr2,233200037,233200062,0,2234119
HepG2|chr2:235545487-235545544,chr2,235545487,235545544,HepG2|chr2:114518058-114518093,chr2,114518058,114518093,0,121027429
HepG2|chr2:236696101-236696219,chr2,236696101,236696219,HepG2|chr2:219860990-219861012,chr2,219860990,219861012,0,16835111
HepG2|chr2:236836322-236836425,chr2,236836322,236836425,HepG2|chr2:190305748-190305773,chr2,190305748,190305773,0,46530574
HepG2|chr2:237237552-237237664,chr2,237237552,237237664,HepG2|chr2:190305748-190305786,chr2,190305748,190305786,0,46931804
HepG2|chr2:238100930-238101046,chr2,238100930,238101046,HepG2|chr2:74230236-74230369,chr2,74230236,74230369,0,163870694
HepG2|chr2:238477407-238477461,chr2,238477407,238477461,HepG2|chr2:233200048-233200198,chr2,233200048,233200198,0,5277359
HepG2|chr2:238498824-238498940,chr2,238498824,238498940,HepG2|chr2:75801251-75801340,chr2,75801251,75801340,0,162697573
HepG2|chr2:239297098-239297124,chr2,239297098,239297124,HepG2|chr2:114517955-114518098,chr2,114517955,114518098,0,124779143
HepG2|chr2:239959437-239959586,chr2,239959437,239959586,HepG2|chr2:233199830-233199980,chr2,233199830,233199980,0,6759607
HepG2|chr2:240717054-240717204,chr2,240717054,240717204,HepG2|chr2:97779756-97779801,chr2,97779756,97779801,0,142937298
HepG2|chr2:240814552-240814583,chr2,240814552,240814583,HepG2|chr2:27807868-27807975,chr2,27807868,27807975,0,213006684
HepG2|chr2:240832812-240832910,chr2,240832812,240832910,HepG2|chr2:85194632-85194659,chr2,85194632,85194659,0,155638180
HepG2|chr2:240844469-240844519,chr2,240844469,240844519,HepG2|chr2:85196491-85196588,chr2,85196491,85196588,0,155647978
HepG2|chr2:241151099-241151248,chr2,241151099,241151248,HepG2|chr2:130886774-130886817,chr2,130886774,130886817,0,110264325
HepG2|chr2:241796721-241796816,chr2,241796721,241796816,HepG2|chr2:48540828-48540888,chr2,48540828,48540888,0,193255893
HepG2|chr2:241866866-241867016,chr2,241866866,241867016,HepG2|chr2:233199987-233200130,chr2,233199987,233200130,0,8666879
HepG2|chr2:242700397-242700464,chr2,242700397,242700464,HepG2|chr2:74230243-74230390,chr2,74230243,74230390,0,168470154
HepG2|chr3:167423-167538,chr3,167423,167538,HepG2|chr3:178866104-178866209,chr3,178866104,178866209,0,178698681
HepG2|chr3:2000824-2000864,chr3,2000824,2000864,HepG2|chr3:195682111-195682249,chr3,195682111,195682249,0,193681287
HepG2|chr3:2360829-2360880,chr3,2360829,2360880,HepG2|chr3:185047873-185047933,chr3,185047873,185047933,0,182687044
HepG2|chr3:3235760-3235814,chr3,3235760,3235814,HepG2|chr3:40542500-40542519,chr3,40542500,40542519,0,37306740
HepG2|chr3:7184132-7184229,chr3,7184132,7184229,HepG2|chr3:195682105-195682249,chr3,195682105,195682249,0,188497973
HepG2|chr3:8216323-8216364,chr3,8216323,8216364,HepG2|chr3:195682154-195682249,chr3,195682154,195682249,0,187465831
HepG2|chr3:10167047-10167136,chr3,10167047,10167136,HepG2|chr3:139064677-139064738,chr3,139064677,139064738,0,128897630
HepG2|chr3:10234597-10234648,chr3,10234597,10234648,HepG2|chr3:185047873-185047933,chr3,185047873,185047933,0,174813276
HepG2|chr3:11712196-11712345,chr3,11712196,11712345,HepG2|chr3:39449710-39449841,chr3,39449710,39449841,0,27737514
HepG2|chr3:13047629-13047715,chr3,13047629,13047715,HepG2|chr3:53168804-53168869,chr3,53168804,53168869,0,40121175
HepG2|chr3:13069606-13069664,chr3,13069606,13069664,HepG2|chr3:40542504-40542560,chr3,40542504,40542560,0,27472898
HepG2|chr3:14436644-14436741,chr3,14436644,14436741,HepG2|chr3:195682105-195682249,chr3,195682105,195682249,0,181245461
HepG2|chr3:15355893-15355956,chr3,15355893,15355956,HepG2|chr3:187455926-187456005,chr3,187455926,187456005,0,172100033
HepG2|chr3:17370666-17370743,chr3,17370666,17370743,HepG2|chr3:57529710-57529782,chr3,57529710,57529782,0,40159044
HepG2|chr3:23397525-23397574,chr3,23397525,23397574,HepG2|chr3:194346170-194346308,chr3,194346170,194346308,0,170948645
HepG2|chr3:26692259-26692293,chr3,26692259,26692293,HepG2|chr3:12525855-12526005,chr3,12525855,12526005,0,14166404
HepG2|chr3:26871140-26871248,chr3,26871140,26871248,HepG2|chr3:178866126-178866168,chr3,178866126,178866168,0,151994986
HepG2|chr3:26976814-26976852,chr3,26976814,26976852,HepG2|chr3:100429966-100430074,chr3,100429966,100430074,0,73453152
HepG2|chr3:27746388-27746406,chr3,27746388,27746406,HepG2|chr3:128887381-128887472,chr3,128887381,128887472,0,101140993
HepG2|chr3:28832156-28832304,chr3,28832156,28832304,HepG2|chr3:39449710-39449778,chr3,39449710,39449778,0,10617554
HepG2|chr3:29686285-29686362,chr3,29686285,29686362,HepG2|chr3:57529710-57529782,chr3,57529710,57529782,0,27843425
HepG2|chr3:30418229-30418267,chr3,30418229,30418267,HepG2|chr3:100429966-100430074,chr3,100429966,100430074,0,70011737
HepG2|chr3:32129255-32129348,chr3,32129255,32129348,HepG2|chr3:195682154-195682249,chr3,195682154,195682249,0,163552899
HepG2|chr3:32929696-32929736,chr3,32929696,32929736,HepG2|chr3:5228205-5228315,chr3,5228205,5228315,0,27701491
HepG2|chr3:34465272-34465308,chr3,34465272,34465308,HepG2|chr3:100429966-100430074,chr3,100429966,100430074,0,65964694
HepG2|chr3:38489819-38489913,chr3,38489819,38489913,HepG2|chr3:195682158-195682217,chr3,195682158,195682217,0,157192339
HepG2|chr3:40949069-40949141,chr3,40949069,40949141,HepG2|chr3:185047873-185047933,chr3,185047873,185047933,0,144098804
HepG2|chr3:41116493-41116604,chr3,41116493,41116604,HepG2|chr3:113464310-113464349,chr3,113464310,113464349,0,72347817
HepG2|chr3:41446842-41446989,chr3,41446842,41446989,HepG2|chr3:195683323-195683471,chr3,195683323,195683471,0,154236481
HepG2|chr3:42585848-42585927,chr3,42585848,42585927,HepG2|chr3:12525756-12525900,chr3,12525756,12525900,0,30060092
HepG2|chr3:45787473-45787531,chr3,45787473,45787531,HepG2|chr3:40542504-40542560,chr3,40542504,40542560,0,5244969
HepG2|chr3:46596734-46596776,chr3,46596734,46596776,HepG2|chr3:195682045-195682195,chr3,195682045,195682195,0,149085311
HepG2|chr3:47474185-47474231,chr3,47474185,47474231,HepG2|chr3:194346170-194346308,chr3,194346170,194346308,0,146871985
HepG2|chr3:48586917-48586989,chr3,48586917,48586989,HepG2|chr3:121552870-121552922,chr3,121552870,121552922,0,72965953
HepG2|chr3:48835666-48835702,chr3,48835666,48835702,HepG2|chr3:100429966-100430074,chr3,100429966,100430074,0,51594300
HepG2|chr3:49536622-49536685,chr3,49536622,49536685,HepG2|chr3:187455926-187456005,chr3,187455926,187456005,0,137919304
HepG2|chr3:49676535-49676597,chr3,49676535,49676597,HepG2|chr3:178866121-178866209,chr3,178866121,178866209,0,129189586
HepG2|chr3:50699739-50699880,chr3,50699739,50699880,HepG2|chr3:195682149-195682249,chr3,195682149,195682249,0,144982410
HepG2|chr3:55402819-55402969,chr3,55402819,55402969,HepG2|chr3:5228205-5228315,chr3,5228205,5228315,0,50174614
HepG2|chr3:56325184-56325226,chr3,56325184,56325226,HepG2|chr3:195682045-195682195,chr3,195682045,195682195,0,139356861
HepG2|chr3:57037455-57037596,chr3,57037455,57037596,HepG2|chr3:195682149-195682249,chr3,195682149,195682249,0,138644694
HepG2|chr3:57925497-57925639,chr3,57925497,57925639,HepG2|chr3:122921516-122921645,chr3,122921516,122921645,0,64996019
HepG2|chr3:58749617-58749663,chr3,58749617,58749663,HepG2|chr3:194346170-194346308,chr3,194346170,194346308,0,135596553
HepG2|chr3:59995051-59995201,chr3,59995051,59995201,HepG2|chr3:195683318-195683468,chr3,195683318,195683468,0,135688267
HepG2|chr3:60183571-60183721,chr3,60183571,60183721,HepG2|chr3:195683319-195683469,chr3,195683319,195683469,0,135499748
HepG2|chr3:60591130-60591164,chr3,60591130,60591164,HepG2|chr3:12525855-12526005,chr3,12525855,12526005,0,48065275
HepG2|chr3:62929396-62929501,chr3,62929396,62929501,HepG2|chr3:139064677-139064738,chr3,139064677,139064738,0,76135281
HepG2|chr3:63023561-63023601,chr3,63023561,63023601,HepG2|chr3:195682111-195682249,chr3,195682111,195682249,0,132658550
HepG2|chr3:63674152-63674302,chr3,63674152,63674302,HepG2|chr3:195683319-195683469,chr3,195683319,195683469,0,132009167
HepG2|chr3:64586707-64586765,chr3,64586707,64586765,HepG2|chr3:187455926-187456012,chr3,187455926,187456012,0,122869219
HepG2|chr3:66082264-66082323,chr3,66082264,66082323,HepG2|chr3:187455926-187456013,chr3,187455926,187456013,0,121373662
HepG2|chr3:68749652-68749745,chr3,68749652,68749745,HepG2|chr3:195682154-195682249,chr3,195682154,195682249,0,126932502
HepG2|chr3:70024181-70024266,chr3,70024181,70024266,HepG2|chr3:53168804-53168869,chr3,53168804,53168869,0,16855377
HepG2|chr3:71051215-71051365,chr3,71051215,71051365,HepG2|chr3:195683319-195683469,chr3,195683319,195683469,0,124632104
HepG2|chr3:72841708-72841793,chr3,72841708,72841793,HepG2|chr3:53168804-53168869,chr3,53168804,53168869,0,19672904
HepG2|chr3:73004078-73004191,chr3,73004078,73004191,HepG2|chr3:129159623-129159664,chr3,129159623,129159664,0,56155545
HepG2|chr3:75011051-75011193,chr3,75011051,75011193,HepG2|chr3:122921516-122921645,chr3,122921516,122921645,0,47910465
HepG2|chr3:76138547-76138695,chr3,76138547,76138695,HepG2|chr3:39449710-39449778,chr3,39449710,39449778,0,36688837
HepG2|chr3:81383137-81383162,chr3,81383137,81383162,HepG2|chr3:128887367-128887473,chr3,128887367,128887473,0,47504230
HepG2|chr3:82159919-82160066,chr3,82159919,82160066,HepG2|chr3:195683068-195683218,chr3,195683068,195683218,0,113523149
HepG2|chr3:82416594-82416624,chr3,82416594,82416624,HepG2|chr3:49824672-49824780,chr3,49824672,49824780,0,32591922
HepG2|chr3:83275448-83275490,chr3,83275448,83275490,HepG2|chr3:37286556-37286667,chr3,37286556,37286667,0,45988892
HepG2|chr3:84927204-84927354,chr3,84927204,84927354,HepG2|chr3:195683319-195683469,chr3,195683319,195683469,0,110756115
HepG2|chr3:86073684-86073773,chr3,86073684,86073773,HepG2|chr3:139064677-139064738,chr3,139064677,139064738,0,52990993
HepG2|chr3:87082798-87082819,chr3,87082798,87082819,HepG2|chr3:57537925-57537983,chr3,57537925,57537983,0,29544873
HepG2|chr3:87223767-87223871,chr3,87223767,87223871,HepG2|chr3:179322873-179322936,chr3,179322873,179322936,0,92099106
HepG2|chr3:87381272-87381422,chr3,87381272,87381422,HepG2|chr3:5228205-5228315,chr3,5228205,5228315,0,82153067
HepG2|chr3:87407282-87407335,chr3,87407282,87407335,HepG2|chr3:195682058-195682208,chr3,195682058,195682208,0,108274776
HepG2|chr3:90477431-90477510,chr3,90477431,90477510,HepG2|chr3:33137287-33137376,chr3,33137287,33137376,0,57340144
HepG2|chr3:93402031-93402157,chr3,93402031,93402157,HepG2|chr3:5230376-5230414,chr3,5230376,5230414,0,88171655
HepG2|chr3:94235963-94236113,chr3,94235963,94236113,HepG2|chr3:195683319-195683469,chr3,195683319,195683469,0,101447356
HepG2|chr3:94799060-94799098,chr3,94799060,94799098,HepG2|chr3:37286556-37286667,chr3,37286556,37286667,0,57512504
HepG2|chr3:95056402-95056503,chr3,95056402,95056503,HepG2|chr3:129159623-129159664,chr3,129159623,129159664,0,34103221
HepG2|chr3:95082882-95083027,chr3,95082882,95083027,HepG2|chr3:195682141-195682249,chr3,195682141,195682249,0,100599259
HepG2|chr3:95928019-95928123,chr3,95928019,95928123,HepG2|chr3:179322873-179322936,chr3,179322873,179322936,0,83394854
HepG2|chr3:97719016-97719127,chr3,97719016,97719127,HepG2|chr3:113464310-113464349,chr3,113464310,113464349,0,15745294
HepG2|chr3:99921162-99921312,chr3,99921162,99921312,HepG2|chr3:113464310-113464349,chr3,113464310,113464349,0,13543148
HepG2|chr3:103345598-103345748,chr3,103345598,103345748,HepG2|chr3:57582325-57582475,chr3,57582325,57582475,0,45763273
HepG2|chr3:104662107-104662186,chr3,104662107,104662186,HepG2|chr3:12525756-12525900,chr3,12525756,12525900,0,92136351
HepG2|chr3:105833324-105833396,chr3,105833324,105833396,HepG2|chr3:185047873-185047933,chr3,185047873,185047933,0,79214549
HepG2|chr3:106291008-106291109,chr3,106291008,106291109,HepG2|chr3:129159623-129159664,chr3,129159623,129159664,0,22868615
HepG2|chr3:106567622-106567697,chr3,106567622,106567697,HepG2|chr3:121552870-121552922,chr3,121552870,121552922,0,14985248
HepG2|chr3:111807900-111808046,chr3,111807900,111808046,HepG2|chr3:195683319-195683469,chr3,195683319,195683469,0,83875419
HepG2|chr3:116582508-116582529,chr3,116582508,116582529,HepG2|chr3:57537925-57537983,chr3,57537925,57537983,0,59044583
HepG2|chr3:121873037-121873163,chr3,121873037,121873163,HepG2|chr3:5230376-5230414,chr3,5230376,5230414,0,116642661
HepG2|chr3:122319287-122319325,chr3,122319287,122319325,HepG2|chr3:37286556-37286667,chr3,37286556,37286667,0,85032731
HepG2|chr3:131597213-131597288,chr3,131597213,131597288,HepG2|chr3:121552870-121552922,chr3,121552870,121552922,0,10044343
HepG2|chr3:131995185-131995227,chr3,131995185,131995227,HepG2|chr3:37286556-37286667,chr3,37286556,37286667,0,94708629
HepG2|chr3:133214483-133214569,chr3,133214483,133214569,HepG2|chr3:53168804-53168869,chr3,53168804,53168869,0,80045679
HepG2|chr3:133243883-133243995,chr3,133243883,133243995,HepG2|chr3:5230376-5230414,chr3,5230376,5230414,0,128013507
HepG2|chr3:133520521-133520546,chr3,133520521,133520546,HepG2|chr3:128887367-128887473,chr3,128887367,128887473,0,4633154
HepG2|chr3:134300994-134301051,chr3,134300994,134301051,HepG2|chr3:33137287-33137376,chr3,33137287,33137376,0,101163707
HepG2|chr3:135132341-135132395,chr3,135132341,135132395,HepG2|chr3:40542500-40542519,chr3,40542500,40542519,0,94589841
HepG2|chr3:136320527-136320643,chr3,136320527,136320643,HepG2|chr3:195682066-195682216,chr3,195682066,195682216,0,59361539
HepG2|chr3:136993721-136993803,chr3,136993721,136993803,HepG2|chr3:57537050-57537118,chr3,57537050,57537118,0,79456671
HepG2|chr3:139707718-139707830,chr3,139707718,139707830,HepG2|chr3:5230376-5230414,chr3,5230376,5230414,0,134477342
HepG2|chr3:140215136-140215166,chr3,140215136,140215166,HepG2|chr3:49824672-49824780,chr3,49824672,49824780,0,90390464
HepG2|chr3:140289850-140289955,chr3,140289850,140289955,HepG2|chr3:139064677-139064738,chr3,139064677,139064738,0,1225173
HepG2|chr3:142130070-142130110,chr3,142130070,142130110,HepG2|chr3:5228205-5228315,chr3,5228205,5228315,0,136901865
HepG2|chr3:143251985-143252135,chr3,143251985,143252135,HepG2|chr3:57582325-57582475,chr3,57582325,57582475,0,85669660
HepG2|chr3:144074599-144074681,chr3,144074599,144074681,HepG2|chr3:57537050-57537118,chr3,57537050,57537118,0,86537549
HepG2|chr3:145057441-145057494,chr3,145057441,145057494,HepG2|chr3:195682058-195682208,chr3,195682058,195682208,0,50624617
HepG2|chr3:145106430-145106503,chr3,145106430,145106503,HepG2|chr3:121552870-121552922,chr3,121552870,121552922,0,23553560
HepG2|chr3:145147178-145147219,chr3,145147178,145147219,HepG2|chr3:195682154-195682249,chr3,195682154,195682249,0,50534976
HepG2|chr3:145376571-145376717,chr3,145376571,145376717,HepG2|chr3:195683319-195683469,chr3,195683319,195683469,0,50306748
HepG2|chr3:145801694-145801733,chr3,145801694,145801733,HepG2|chr3:37286556-37286667,chr3,37286556,37286667,0,108515138
HepG2|chr3:147267928-147267967,chr3,147267928,147267967,HepG2|chr3:37286556-37286667,chr3,37286556,37286667,0,109981372
HepG2|chr3:153832499-153832593,chr3,153832499,153832593,HepG2|chr3:195682158-195682217,chr3,195682158,195682217,0,41849659
HepG2|chr3:157728456-157728514,chr3,157728456,157728514,HepG2|chr3:187455926-187456012,chr3,187455926,187456012,0,29727470
HepG2|chr3:158671795-158671874,chr3,158671795,158671874,HepG2|chr3:33137287-33137376,chr3,33137287,33137376,0,125534508
HepG2|chr3:159210493-159210601,chr3,159210493,159210601,HepG2|chr3:178866126-178866168,chr3,178866126,178866168,0,19655633
HepG2|chr3:159292722-159292869,chr3,159292722,159292869,HepG2|chr3:195683068-195683218,chr3,195683068,195683218,0,36390346
HepG2|chr3:162402003-162402116,chr3,162402003,162402116,HepG2|chr3:129159623-129159664,chr3,129159623,129159664,0,33242380
HepG2|chr3:163599841-163599988,chr3,163599841,163599988,HepG2|chr3:195683323-195683471,chr3,195683323,195683471,0,32083482
HepG2|chr3:169445091-169445241,chr3,169445091,169445241,HepG2|chr3:195683318-195683468,chr3,195683318,195683468,0,26238227
HepG2|chr3:176374406-176374522,chr3,176374406,176374522,HepG2|chr3:195682066-195682216,chr3,195682066,195682216,0,19307660
HepG2|chr3:177766383-177766533,chr3,177766383,177766533,HepG2|chr3:113464310-113464349,chr3,113464310,113464349,0,64302073
HepG2|chr3:179451945-179452094,chr3,179451945,179452094,HepG2|chr3:39449710-39449841,chr3,39449710,39449841,0,140002235
HepG2|chr3:184341031-184341080,chr3,184341031,184341080,HepG2|chr3:194346170-194346308,chr3,194346170,194346308,0,10005139
HepG2|chr3:186731823-186731882,chr3,186731823,186731882,HepG2|chr3:187455926-187456013,chr3,187455926,187456013,0,724103
HepG2|chr3:188784552-188784609,chr3,188784552,188784609,HepG2|chr3:33137287-33137376,chr3,33137287,33137376,0,155647265
HepG2|chr3:189038064-189038209,chr3,189038064,189038209,HepG2|chr3:195682141-195682249,chr3,195682141,195682249,0,6644077
HepG2|chr3:189908122-189908237,chr3,189908122,189908237,HepG2|chr3:178866104-178866209,chr3,178866104,178866209,0,11042018
HepG2|chr3:190716988-190717006,chr3,190716988,190717006,HepG2|chr3:128887381-128887472,chr3,128887381,128887472,0,61829607
HepG2|chr3:191455277-191455350,chr3,191455277,191455350,HepG2|chr3:121552870-121552922,chr3,121552870,121552922,0,69902407
HepG2|chr3:192337231-192337293,chr3,192337231,192337293,HepG2|chr3:178866121-178866209,chr3,178866121,178866209,0,13471110
HepG2|chr3:192839122-192839194,chr3,192839122,192839194,HepG2|chr3:121552870-121552922,chr3,121552870,121552922,0,71286252
HepG2|chr3:197177292-197177442,chr3,197177292,197177442,HepG2|chr3:195683319-195683469,chr3,195683319,195683469,0,1493973
HepG2|chr4:2745985-2746047,chr4,2745985,2746047,HepG2|chr4:57327746-57327867,chr4,57327746,57327867,0,54581761
HepG2|chr4:12233375-12233404,chr4,12233375,12233404,HepG2|chr4:57327746-57327867,chr4,57327746,57327867,0,45094371
HepG2|chr4:12581077-12581162,chr4,12581077,12581162,HepG2|chr4:129525231-129525265,chr4,129525231,129525265,0,116944154
HepG2|chr4:17129359-17129459,chr4,17129359,17129459,HepG2|chr4:152021768-152021818,chr4,152021768,152021818,0,134892409
HepG2|chr4:19538572-19538644,chr4,19538572,19538644,HepG2|chr4:40059023-40059079,chr4,40059023,40059079,0,20520451
HepG2|chr4:21115990-21116140,chr4,21115990,21116140,HepG2|chr4:40059023-40059083,chr4,40059023,40059083,0,18943033
HepG2|chr4:27668855-27668945,chr4,27668855,27668945,HepG2|chr4:40059023-40059083,chr4,40059023,40059083,0,12390168
HepG2|chr4:29113878-29113963,chr4,29113878,29113963,HepG2|chr4:129525231-129525265,chr4,129525231,129525265,0,100411353
HepG2|chr4:33639622-33639772,chr4,33639622,33639772,HepG2|chr4:6637614-6637687,chr4,6637614,6637687,0,27002008
HepG2|chr4:37665973-37666123,chr4,37665973,37666123,HepG2|chr4:40059023-40059083,chr4,40059023,40059083,0,2393050
HepG2|chr4:46059537-46059623,chr4,46059537,46059623,HepG2|chr4:129525231-129525292,chr4,129525231,129525292,0,83465694
HepG2|chr4:52148253-52148361,chr4,52148253,52148361,HepG2|chr4:129734215-129734243,chr4,129734215,129734243,0,77585962
HepG2|chr4:53895648-53895762,chr4,53895648,53895762,HepG2|chr4:129734215-129734243,chr4,129734215,129734243,0,75838567
HepG2|chr4:55831564-55831650,chr4,55831564,55831650,HepG2|chr4:129525231-129525292,chr4,129525231,129525292,0,73693667
HepG2|chr4:56936139-56936216,chr4,56936139,56936216,HepG2|chr4:6637614-6637687,chr4,6637614,6637687,0,50298525
HepG2|chr4:57928819-57928896,chr4,57928819,57928896,HepG2|chr4:6637614-6637687,chr4,6637614,6637687,0,51291205
HepG2|chr4:75289981-75290010,chr4,75289981,75290010,HepG2|chr4:57327746-57327867,chr4,57327746,57327867,0,17962235
HepG2|chr4:81114757-81114848,chr4,81114757,81114848,HepG2|chr4:6640434-6640516,chr4,6640434,6640516,0,74474323
HepG2|chr4:86481201-86481292,chr4,86481201,86481292,HepG2|chr4:6640434-6640516,chr4,6640434,6640516,0,79840767
HepG2|chr4:91081490-91081598,chr4,91081490,91081598,HepG2|chr4:129734215-129734243,chr4,129734215,129734243,0,38652725
HepG2|chr4:94455649-94455764,chr4,94455649,94455764,HepG2|chr4:152021768-152021818,chr4,152021768,152021818,0,57566119
HepG2|chr4:95367656-95367770,chr4,95367656,95367770,HepG2|chr4:129734215-129734243,chr4,129734215,129734243,0,34366559
HepG2|chr4:100176023-100176109,chr4,100176023,100176109,HepG2|chr4:40059023-40059108,chr4,40059023,40059108,0,60117000
HepG2|chr4:110648860-110648932,chr4,110648860,110648932,HepG2|chr4:40059023-40059079,chr4,40059023,40059079,0,70589837
HepG2|chr4:116627958-116628017,chr4,116627958,116628017,HepG2|chr4:140098561-140098691,chr4,140098561,140098691,0,23470603
HepG2|chr4:118851637-118851699,chr4,118851637,118851699,HepG2|chr4:6640434-6640516,chr4,6640434,6640516,0,112211203
HepG2|chr4:119728178-119728264,chr4,119728178,119728264,HepG2|chr4:40059023-40059108,chr4,40059023,40059108,0,79669155
HepG2|chr4:126733689-126733779,chr4,126733689,126733779,HepG2|chr4:40059023-40059083,chr4,40059023,40059083,0,86674666
HepG2|chr4:131220853-131220941,chr4,131220853,131220941,HepG2|chr4:40059023-40059081,chr4,40059023,40059081,0,91161830
HepG2|chr4:133242024-133242096,chr4,133242024,133242096,HepG2|chr4:140098632-140098659,chr4,140098632,140098659,0,6856608
HepG2|chr4:136007238-136007295,chr4,136007238,136007295,HepG2|chr4:492504-492538,chr4,492504,492538,0,135514734
HepG2|chr4:141145361-141145433,chr4,141145361,141145433,HepG2|chr4:140098632-140098659,chr4,140098632,140098659,0,1046729
HepG2|chr4:149209860-149209919,chr4,149209860,149209919,HepG2|chr4:140098561-140098691,chr4,140098561,140098691,0,9111299
HepG2|chr4:152844512-152844577,chr4,152844512,152844577,HepG2|chr4:40059023-40059108,chr4,40059023,40059108,0,112785489
HepG2|chr4:154026141-154026203,chr4,154026141,154026203,HepG2|chr4:6640434-6640516,chr4,6640434,6640516,0,147385707
HepG2|chr4:160106083-160106140,chr4,160106083,160106140,HepG2|chr4:492504-492538,chr4,492504,492538,0,159613579
HepG2|chr4:167922452-167922514,chr4,167922452,167922514,HepG2|chr4:57327746-57327867,chr4,57327746,57327867,0,110594706
HepG2|chr4:172202392-172202457,chr4,172202392,172202457,HepG2|chr4:40059023-40059108,chr4,40059023,40059108,0,132143369
HepG2|chr4:174732493-174732643,chr4,174732493,174732643,HepG2|chr4:6637614-6637687,chr4,6637614,6637687,0,168094879
HepG2|chr4:176797510-176797598,chr4,176797510,176797598,HepG2|chr4:40059023-40059081,chr4,40059023,40059081,0,136738487
HepG2|chr4:183049073-183049188,chr4,183049073,183049188,HepG2|chr4:152021768-152021818,chr4,152021768,152021818,0,31027305
HepG2|chr4:189573647-189573747,chr4,189573647,189573747,HepG2|chr4:152021768-152021818,chr4,152021768,152021818,0,37551879
HepG2|chr5:228846-228987,chr5,228846,228987,HepG2|chr5:272161-272307,chr5,272161,272307,0,43315
HepG2|chr5:230462-230612,chr5,230462,230612,HepG2|chr5:272413-272561,chr5,272413,272561,0,41951
HepG2|chr5:240200-240350,chr5,240200,240350,HepG2|chr5:272148-272291,chr5,272148,272291,0,31948
HepG2|chr5:409251-409401,chr5,409251,409401,HepG2|chr5:272427-272571,chr5,272427,272571,0,136824
HepG2|chr5:1238383-1238479,chr5,1238383,1238479,HepG2|chr5:236101-236141,chr5,236101,236141,0,1002282
HepG2|chr5:1969971-1970121,chr5,1969971,1970121,HepG2|chr5:272819-272969,chr5,272819,272969,0,1697152
HepG2|chr5:1987212-1987293,chr5,1987212,1987293,HepG2|chr5:148724734-148724759,chr5,148724734,148724759,0,146737522
HepG2|chr5:2199725-2199875,chr5,2199725,2199875,HepG2|chr5:273077-273227,chr5,273077,273227,0,1926648
HepG2|chr5:2337438-2337483,chr5,2337438,2337483,HepG2|chr5:236152-236257,chr5,236152,236257,0,2101286
HepG2|chr5:2576403-2576550,chr5,2576403,2576550,HepG2|chr5:175394476-175394626,chr5,175394476,175394626,0,172818073
HepG2|chr5:3362636-3362754,chr5,3362636,3362754,HepG2|chr5:53974-53993,chr5,53974,53993,0,3308662
HepG2|chr5:3413418-3413549,chr5,3413418,3413549,HepG2|chr5:236152-236257,chr5,236152,236257,0,3177266
HepG2|chr5:3507722-3507856,chr5,3507722,3507856,HepG2|chr5:176743246-176743289,chr5,176743246,176743289,0,173235524
HepG2|chr5:4183622-4183647,chr5,4183622,4183647,HepG2|chr5:176742934-176743073,chr5,176742934,176743073,0,172559312
HepG2|chr5:4421761-4421791,chr5,4421761,4421791,HepG2|chr5:76502414-76502506,chr5,76502414,76502506,0,72080653
HepG2|chr5:4753328-4753478,chr5,4753328,4753478,HepG2|chr5:272398-272548,chr5,272398,272548,0,4480930
HepG2|chr5:4838927-4839067,chr5,4838927,4839067,HepG2|chr5:175394453-175394603,chr5,175394453,175394603,0,170555526
HepG2|chr5:5042846-5042996,chr5,5042846,5042996,HepG2|chr5:272189-272339,chr5,272189,272339,0,4770657
HepG2|chr5:5455046-5455194,chr5,5455046,5455194,HepG2|chr5:273077-273227,chr5,273077,273227,0,5181969
HepG2|chr5:5578369-5578429,chr5,5578369,5578429,HepG2|chr5:96143956-96143999,chr5,96143956,96143999,0,90565587
HepG2|chr5:5907623-5907773,chr5,5907623,5907773,HepG2|chr5:217724-217871,chr5,217724,217871,0,5689899
HepG2|chr5:6606742-6606887,chr5,6606742,6606887,HepG2|chr5:76503028-76503128,chr5,76503028,76503128,0,69896286
HepG2|chr5:6813758-6813908,chr5,6813758,6813908,HepG2|chr5:273037-273187,chr5,273037,273187,0,6540721
HepG2|chr5:7547585-7547732,chr5,7547585,7547732,HepG2|chr5:273075-273192,chr5,273075,273192,0,7274510
HepG2|chr5:7845267-7845328,chr5,7845267,7845328,HepG2|chr5:173111839-173111902,chr5,173111839,173111902,0,165266572
HepG2|chr5:8646139-8646289,chr5,8646139,8646289,HepG2|chr5:272442-272592,chr5,272442,272592,0,8373697
HepG2|chr5:8793501-8793650,chr5,8793501,8793650,HepG2|chr5:272416-272566,chr5,272416,272566,0,8521085
HepG2|chr5:8874986-8875036,chr5,8874986,8875036,HepG2|chr5:5421515-5421566,chr5,5421515,5421566,0,3453471
HepG2|chr5:8982280-8982430,chr5,8982280,8982430,HepG2|chr5:272427-272571,chr5,272427,272571,0,8709853
HepG2|chr5:9317395-9317545,chr5,9317395,9317545,HepG2|chr5:217490-217639,chr5,217490,217639,0,9099905
HepG2|chr5:9474972-9475106,chr5,9474972,9475106,HepG2|chr5:176743246-176743289,chr5,176743246,176743289,0,167268274
HepG2|chr5:9839652-9839756,chr5,9839652,9839756,HepG2|chr5:176741673-176741719,chr5,176741673,176741719,0,166902021
HepG2|chr5:9845859-9845944,chr5,9845859,9845944,HepG2|chr5:154089077-154089128,chr5,154089077,154089128,0,144243218
HepG2|chr5:9945270-9945352,chr5,9945270,9945352,HepG2|chr5:96143956-96143999,chr5,96143956,96143999,0,86198686
HepG2|chr5:10511623-10511688,chr5,10511623,10511688,HepG2|chr5:273815-273895,chr5,273815,273895,0,10237808
HepG2|chr5:10769923-10769979,chr5,10769923,10769979,HepG2|chr5:273812-273892,chr5,273812,273892,0,10496111
HepG2|chr5:10818267-10818297,chr5,10818267,10818297,HepG2|chr5:76502414-76502506,chr5,76502414,76502506,0,65684147
HepG2|chr5:11083725-11083750,chr5,11083725,11083750,HepG2|chr5:176744069-176744219,chr5,176744069,176744219,0,165660344
HepG2|chr5:11459943-11460093,chr5,11459943,11460093,HepG2|chr5:272149-272291,chr5,272149,272291,0,11187794
HepG2|chr5:11687848-11687925,chr5,11687848,11687925,HepG2|chr5:43067341-43067441,chr5,43067341,43067441,0,31379493
HepG2|chr5:11902398-11902543,chr5,11902398,11902543,HepG2|chr5:176743449-176743494,chr5,176743449,176743494,0,164841051
HepG2|chr5:12826400-12826440,chr5,12826400,12826440,HepG2|chr5:180236419-180236510,chr5,180236419,180236510,0,167410019
HepG2|chr5:13073700-13073849,chr5,13073700,13073849,HepG2|chr5:217791-217941,chr5,217791,217941,0,12855909
HepG2|chr5:14634517-14634570,chr5,14634517,14634570,HepG2|chr5:176742610-176742707,chr5,176742610,176742707,0,162108093
HepG2|chr5:15387810-15387866,chr5,15387810,15387866,HepG2|chr5:148724734-148724822,chr5,148724734,148724822,0,133336924
HepG2|chr5:15739552-15739699,chr5,15739552,15739699,HepG2|chr5:272212-272362,chr5,272212,272362,0,15467340
HepG2|chr5:16008040-16008117,chr5,16008040,16008117,HepG2|chr5:178988929-178989079,chr5,178988929,178989079,0,162980889
HepG2|chr5:16730694-16730725,chr5,16730694,16730725,HepG2|chr5:175970596-175970746,chr5,175970596,175970746,0,159239902
HepG2|chr5:16980405-16980555,chr5,16980405,16980555,HepG2|chr5:272210-272360,chr5,272210,272360,0,16708195
HepG2|chr5:17271041-17271191,chr5,17271041,17271191,HepG2|chr5:176740291-176740382,chr5,176740291,176740382,0,159469250
HepG2|chr5:17283216-17283356,chr5,17283216,17283356,HepG2|chr5:272416-272566,chr5,272416,272566,0,17010800
HepG2|chr5:17392045-17392195,chr5,17392045,17392195,HepG2|chr5:272416-272566,chr5,272416,272566,0,17119629
HepG2|chr5:17501845-17501993,chr5,17501845,17501993,HepG2|chr5:272383-272529,chr5,272383,272529,0,17229462
HepG2|chr5:17674775-17674925,chr5,17674775,17674925,HepG2|chr5:217759-217853,chr5,217759,217853,0,17457016
HepG2|chr5:18269052-18269202,chr5,18269052,18269202,HepG2|chr5:272413-272561,chr5,272413,272561,0,17996639
HepG2|chr5:18562250-18562395,chr5,18562250,18562395,HepG2|chr5:175631751-175631842,chr5,175631751,175631842,0,157069501
HepG2|chr5:19130827-19130977,chr5,19130827,19130977,HepG2|chr5:217766-217803,chr5,217766,217803,0,18913061
HepG2|chr5:19305714-19305864,chr5,19305714,19305864,HepG2|chr5:217833-217983,chr5,217833,217983,0,19087881
HepG2|chr5:19383129-19383259,chr5,19383129,19383259,HepG2|chr5:613754-613872,chr5,613754,613872,0,18769375
HepG2|chr5:20068518-20068611,chr5,20068518,20068611,HepG2|chr5:98264402-98264455,chr5,98264402,98264455,0,78195884
HepG2|chr5:20122552-20122636,chr5,20122552,20122636,HepG2|chr5:273037-273159,chr5,273037,273159,0,19849515
HepG2|chr5:20252309-20252459,chr5,20252309,20252459,HepG2|chr5:272377-272527,chr5,272377,272527,0,19979932
HepG2|chr5:20620556-20620706,chr5,20620556,20620706,HepG2|chr5:272648-272798,chr5,272648,272798,0,20347908
HepG2|chr5:21654632-21654679,chr5,21654632,21654679,HepG2|chr5:236153-236299,chr5,236153,236299,0,21418479
HepG2|chr5:21934467-21934616,chr5,21934467,21934616,HepG2|chr5:217752-217902,chr5,217752,217902,0,21716715
HepG2|chr5:22214255-22214405,chr5,22214255,22214405,HepG2|chr5:273034-273184,chr5,273034,273184,0,21941221
HepG2|chr5:22256267-22256287,chr5,22256267,22256287,HepG2|chr5:154134201-154134300,chr5,154134201,154134300,0,131877934
HepG2|chr5:22544724-22544801,chr5,22544724,22544801,HepG2|chr5:43067341-43067441,chr5,43067341,43067441,0,20522617
HepG2|chr5:22611895-22612005,chr5,22611895,22612005,HepG2|chr5:133855244-133855289,chr5,133855244,133855289,0,111243349
HepG2|chr5:22627157-22627241,chr5,22627157,22627241,HepG2|chr5:154089077-154089128,chr5,154089077,154089128,0,131461920
HepG2|chr5:23013509-23013623,chr5,23013509,23013623,HepG2|chr5:217928-217964,chr5,217928,217964,0,22795581
HepG2|chr5:23155305-23155383,chr5,23155305,23155383,HepG2|chr5:236108-236258,chr5,236108,236258,0,22919197
HepG2|chr5:23865406-23865458,chr5,23865406,23865458,HepG2|chr5:236181-236328,chr5,236181,236328,0,23629225
HepG2|chr5:24324229-24324363,chr5,24324229,24324363,HepG2|chr5:613754-613872,chr5,613754,613872,0,23710475
HepG2|chr5:25574250-25574391,chr5,25574250,25574391,HepG2|chr5:236104-236141,chr5,236104,236141,0,25338146
HepG2|chr5:25625684-25625704,chr5,25625684,25625704,HepG2|chr5:76502237-76502367,chr5,76502237,76502367,0,50876553
HepG2|chr5:25761618-25761675,chr5,25761618,25761675,HepG2|chr5:175394517-175394567,chr5,175394517,175394567,0,149632899
HepG2|chr5:25958696-25958761,chr5,25958696,25958761,HepG2|chr5:273815-273895,chr5,273815,273895,0,25684881
HepG2|chr5:26265698-26265848,chr5,26265698,26265848,HepG2|chr5:217724-217871,chr5,217724,217871,0,26047974
HepG2|chr5:26585292-26585378,chr5,26585292,26585378,HepG2|chr5:154134232-154134382,chr5,154134232,154134382,0,127548940
HepG2|chr5:26767071-26767221,chr5,26767071,26767221,HepG2|chr5:272177-272324,chr5,272177,272324,0,26494894
HepG2|chr5:27522606-27522692,chr5,27522606,27522692,HepG2|chr5:154134232-154134382,chr5,154134232,154134382,0,126611626
HepG2|chr5:27690829-27690934,chr5,27690829,27690934,HepG2|chr5:68483072-68483101,chr5,68483072,68483101,0,40792243
HepG2|chr5:28266287-28266437,chr5,28266287,28266437,HepG2|chr5:272416-272565,chr5,272416,272565,0,27993871
HepG2|chr5:28316601-28316751,chr5,28316601,28316751,HepG2|chr5:272416-272566,chr5,272416,272566,0,28044185
HepG2|chr5:29004508-29004658,chr5,29004508,29004658,HepG2|chr5:272189-272339,chr5,272189,272339,0,28732319
HepG2|chr5:29990525-29990675,chr5,29990525,29990675,HepG2|chr5:272416-272566,chr5,272416,272566,0,29718109
HepG2|chr5:30000222-30000312,chr5,30000222,30000312,HepG2|chr5:133857603-133857634,chr5,133857603,133857634,0,103857381
HepG2|chr5:30318009-30318119,chr5,30318009,30318119,HepG2|chr5:133855244-133855289,chr5,133855244,133855289,0,103537235
HepG2|chr5:30758046-30758177,chr5,30758046,30758177,HepG2|chr5:139035319-139035345,chr5,139035319,139035345,0,108277273
HepG2|chr5:30802055-30802201,chr5,30802055,30802201,HepG2|chr5:175394527-175394590,chr5,175394527,175394590,0,144592472
HepG2|chr5:30819681-30819831,chr5,30819681,30819831,HepG2|chr5:272416-272566,chr5,272416,272566,0,30547265
HepG2|chr5:31112981-31113131,chr5,31112981,31113131,HepG2|chr5:272641-272791,chr5,272641,272791,0,30840340
HepG2|chr5:31217150-31217300,chr5,31217150,31217300,HepG2|chr5:272416-272566,chr5,272416,272566,0,30944734
HepG2|chr5:31641797-31641937,chr5,31641797,31641937,HepG2|chr5:272416-272566,chr5,272416,272566,0,31369381
HepG2|chr5:32213132-32213237,chr5,32213132,32213237,HepG2|chr5:150019651-150019696,chr5,150019651,150019696,0,117806519
HepG2|chr5:32997682-32997832,chr5,32997682,32997832,HepG2|chr5:272413-272561,chr5,272413,272561,0,32725269
HepG2|chr5:34475395-34475415,chr5,34475395,34475415,HepG2|chr5:5417816-5417958,chr5,5417816,5417958,0,29057579
HepG2|chr5:34857946-34858013,chr5,34857946,34858013,HepG2|chr5:133856945-133857004,chr5,133856945,133857004,0,98998999
HepG2|chr5:35179807-35179899,chr5,35179807,35179899,HepG2|chr5:98264282-98264307,chr5,98264282,98264307,0,63084475
HepG2|chr5:35182118-35182268,chr5,35182118,35182268,HepG2|chr5:217733-217883,chr5,217733,217883,0,34964385
HepG2|chr5:35254653-35254803,chr5,35254653,35254803,HepG2|chr5:273034-273184,chr5,273034,273184,0,34981619
HepG2|chr5:35289784-35289934,chr5,35289784,35289934,HepG2|chr5:217796-217946,chr5,217796,217946,0,35071988
HepG2|chr5:35693716-35693736,chr5,35693716,35693736,HepG2|chr5:154134201-154134300,chr5,154134201,154134300,0,118440485
HepG2|chr5:36220266-36220362,chr5,36220266,36220362,HepG2|chr5:236101-236141,chr5,236101,236141,0,35984165
HepG2|chr5:36370796-36370946,chr5,36370796,36370946,HepG2|chr5:273054-273204,chr5,273054,273204,0,36097742
HepG2|chr5:36733422-36733481,chr5,36733422,36733481,HepG2|chr5:176744515-176744665,chr5,176744515,176744665,0,140011093
HepG2|chr5:36929386-36929536,chr5,36929386,36929536,HepG2|chr5:272207-272357,chr5,272207,272357,0,36657179
HepG2|chr5:36952222-36952303,chr5,36952222,36952303,HepG2|chr5:148724734-148724759,chr5,148724734,148724759,0,111772512
HepG2|chr5:37071390-37071429,chr5,37071390,37071429,HepG2|chr5:180236419-180236510,chr5,180236419,180236510,0,143165029
HepG2|chr5:37787615-37787692,chr5,37787615,37787692,HepG2|chr5:178988929-178989079,chr5,178988929,178989079,0,141201314
HepG2|chr5:38687968-38688118,chr5,38687968,38688118,HepG2|chr5:272212-272362,chr5,272212,272362,0,38415756
HepG2|chr5:38808411-38808561,chr5,38808411,38808561,HepG2|chr5:217724-217871,chr5,217724,217871,0,38590687
HepG2|chr5:40043928-40044077,chr5,40043928,40044077,HepG2|chr5:217791-217941,chr5,217791,217941,0,39826137
HepG2|chr5:40276515-40276565,chr5,40276515,40276565,HepG2|chr5:236103-236141,chr5,236103,236141,0,40040412
HepG2|chr5:40414586-40414657,chr5,40414586,40414657,HepG2|chr5:176742931-176743047,chr5,176742931,176743047,0,136328345
HepG2|chr5:41159409-41159559,chr5,41159409,41159559,HepG2|chr5:273065-273215,chr5,273065,273215,0,40886344
HepG2|chr5:41825073-41825131,chr5,41825073,41825131,HepG2|chr5:179049011-179049103,chr5,179049011,179049103,0,137223938
HepG2|chr5:41825722-41825872,chr5,41825722,41825872,HepG2|chr5:273077-273227,chr5,273077,273227,0,41552645
HepG2|chr5:41966227-41966377,chr5,41966227,41966377,HepG2|chr5:272641-272791,chr5,272641,272791,0,41693586
HepG2|chr5:42004492-42004642,chr5,42004492,42004642,HepG2|chr5:273041-273187,chr5,273041,273187,0,41731451
HepG2|chr5:42109279-42109338,chr5,42109279,42109338,HepG2|chr5:175631751-175631842,chr5,175631751,175631842,0,133522472
HepG2|chr5:42205152-42205203,chr5,42205152,42205203,HepG2|chr5:176744544-176744643,chr5,176744544,176744643,0,134539392
HepG2|chr5:43027071-43027221,chr5,43027071,43027221,HepG2|chr5:176742610-176742707,chr5,176742610,176742707,0,133715539
HepG2|chr5:43144410-43144483,chr5,43144410,43144483,HepG2|chr5:179049011-179049103,chr5,179049011,179049103,0,135904601
HepG2|chr5:43540400-43540550,chr5,43540400,43540550,HepG2|chr5:217838-217987,chr5,217838,217987,0,43322562
HepG2|chr5:43693402-43693552,chr5,43693402,43693552,HepG2|chr5:235872-236018,chr5,235872,236018,0,43457530
HepG2|chr5:43988748-43988895,chr5,43988748,43988895,HepG2|chr5:217831-217981,chr5,217831,217981,0,43770917
HepG2|chr5:45117022-45117072,chr5,45117022,45117072,HepG2|chr5:236103-236141,chr5,236103,236141,0,44880919
HepG2|chr5:45408732-45408882,chr5,45408732,45408882,HepG2|chr5:272431-272581,chr5,272431,272581,0,45136301
HepG2|chr5:45982114-45982152,chr5,45982114,45982152,HepG2|chr5:40756239-40756272,chr5,40756239,40756272,0,5225875
HepG2|chr5:46324721-46324741,chr5,46324721,46324741,HepG2|chr5:5417816-5417958,chr5,5417816,5417958,0,40906905
HepG2|chr5:46338611-46338758,chr5,46338611,46338758,HepG2|chr5:272414-272564,chr5,272414,272564,0,46066197
HepG2|chr5:46357452-46357602,chr5,46357452,46357602,HepG2|chr5:272383-272530,chr5,272383,272530,0,46085069
HepG2|chr5:46597652-46597802,chr5,46597652,46597802,HepG2|chr5:272377-272527,chr5,272377,272527,0,46325275
HepG2|chr5:46907238-46907388,chr5,46907238,46907388,HepG2|chr5:175394492-175394590,chr5,175394492,175394590,0,128487254
HepG2|chr5:47487833-47487983,chr5,47487833,47487983,HepG2|chr5:235882-236032,chr5,235882,236032,0,47251951
HepG2|chr5:48323852-48324002,chr5,48323852,48324002,HepG2|chr5:68484817-68484884,chr5,68484817,68484884,0,20160965
HepG2|chr5:48564052-48564135,chr5,48564052,48564135,HepG2|chr5:68484817-68484884,chr5,68484817,68484884,0,19920765
HepG2|chr5:48779973-48780123,chr5,48779973,48780123,HepG2|chr5:272376-272526,chr5,272376,272526,0,48507597
HepG2|chr5:48959346-48959496,chr5,48959346,48959496,HepG2|chr5:272148-272291,chr5,272148,272291,0,48687198
HepG2|chr5:49382033-49382183,chr5,49382033,49382183,HepG2|chr5:272383-272529,chr5,272383,272529,0,49109650
HepG2|chr5:49384612-49384630,chr5,49384612,49384630,HepG2|chr5:173113059-173113098,chr5,173113059,173113098,0,123728447
HepG2|chr5:49484173-49484226,chr5,49484173,49484226,HepG2|chr5:176742610-176742707,chr5,176742610,176742707,0,127258437
HepG2|chr5:49545174-49545233,chr5,49545174,49545233,HepG2|chr5:236142-236244,chr5,236142,236244,0,49309032
HepG2|chr5:49773315-49773425,chr5,49773315,49773425,HepG2|chr5:273807-273847,chr5,273807,273847,0,49499508
HepG2|chr5:50328233-50328322,chr5,50328233,50328322,HepG2|chr5:176740213-176740250,chr5,176740213,176740250,0,126411980
HepG2|chr5:51025632-51025782,chr5,51025632,51025782,HepG2|chr5:272147-272291,chr5,272147,272291,0,50753485
HepG2|chr5:51422847-51422920,chr5,51422847,51422920,HepG2|chr5:133855516-133855559,chr5,133855516,133855559,0,82432669
HepG2|chr5:51904889-51904933,chr5,51904889,51904933,HepG2|chr5:76505720-76505870,chr5,76505720,76505870,0,24600831
HepG2|chr5:51912556-51912706,chr5,51912556,51912706,HepG2|chr5:68483746-68483889,chr5,68483746,68483889,0,16571190
HepG2|chr5:51996571-51996721,chr5,51996571,51996721,HepG2|chr5:272210-272360,chr5,272210,272360,0,51724361
HepG2|chr5:52351296-52351446,chr5,52351296,52351446,HepG2|chr5:272115-272264,chr5,272115,272264,0,52079181
HepG2|chr5:52579284-52579429,chr5,52579284,52579429,HepG2|chr5:175631751-175631842,chr5,175631751,175631842,0,123052467
HepG2|chr5:52740498-52740648,chr5,52740498,52740648,HepG2|chr5:272418-272567,chr5,272418,272567,0,52468080
HepG2|chr5:53384196-53384263,chr5,53384196,53384263,HepG2|chr5:5420404-5420477,chr5,5420404,5420477,0,47963792
HepG2|chr5:54353798-54353945,chr5,54353798,54353945,HepG2|chr5:175394476-175394626,chr5,175394476,175394626,0,121040678
HepG2|chr5:55083672-55083822,chr5,55083672,55083822,HepG2|chr5:272212-272362,chr5,272212,272362,0,54811460
HepG2|chr5:55263577-55263600,chr5,55263577,55263600,HepG2|chr5:76502237-76502367,chr5,76502237,76502367,0,21238660
HepG2|chr5:55359450-55359519,chr5,55359450,55359519,HepG2|chr5:148724734-148724764,chr5,148724734,148724764,0,93365284
HepG2|chr5:55579932-55580080,chr5,55579932,55580080,HepG2|chr5:272414-272564,chr5,272414,272564,0,55307518
HepG2|chr5:55667187-55667308,chr5,55667187,55667308,HepG2|chr5:217723-217871,chr5,217723,217871,0,55449464
HepG2|chr5:55926715-55926744,chr5,55926715,55926744,HepG2|chr5:40756222-40756272,chr5,40756222,40756272,0,15170493
HepG2|chr5:56247404-56247536,chr5,56247404,56247536,HepG2|chr5:217791-217941,chr5,217791,217941,0,56029613
HepG2|chr5:56428451-56428551,chr5,56428451,56428551,HepG2|chr5:217828-217885,chr5,217828,217885,0,56210623
HepG2|chr5:56666910-56667058,chr5,56666910,56667058,HepG2|chr5:272427-272571,chr5,272427,272571,0,56394483
HepG2|chr5:57057980-57058129,chr5,57057980,57058129,HepG2|chr5:272416-272566,chr5,272416,272566,0,56785564
HepG2|chr5:57628820-57628937,chr5,57628820,57628937,HepG2|chr5:154084787-154084895,chr5,154084787,154084895,0,96455967
HepG2|chr5:57806964-57807082,chr5,57806964,57807082,HepG2|chr5:53974-53993,chr5,53974,53993,0,57752990
HepG2|chr5:57856133-57856263,chr5,57856133,57856263,HepG2|chr5:613754-613872,chr5,613754,613872,0,57242379
HepG2|chr5:58826324-58826471,chr5,58826324,58826471,HepG2|chr5:217896-218042,chr5,217896,218042,0,58608428
HepG2|chr5:58882118-58882262,chr5,58882118,58882262,HepG2|chr5:272383-272529,chr5,272383,272529,0,58609735
HepG2|chr5:59102455-59102605,chr5,59102455,59102605,HepG2|chr5:273037-273187,chr5,273037,273187,0,58829418
HepG2|chr5:59443267-59443417,chr5,59443267,59443417,HepG2|chr5:272377-272527,chr5,272377,272527,0,59170890
HepG2|chr5:60085901-60086030,chr5,60085901,60086030,HepG2|chr5:272383-272529,chr5,272383,272529,0,59813518
HepG2|chr5:60158980-60159027,chr5,60158980,60159027,HepG2|chr5:273082-273232,chr5,273082,273232,0,59885898
HepG2|chr5:60421522-60421671,chr5,60421522,60421671,HepG2|chr5:272415-272565,chr5,272415,272565,0,60149107
HepG2|chr5:60651985-60652135,chr5,60651985,60652135,HepG2|chr5:272210-272360,chr5,272210,272360,0,60379775
HepG2|chr5:61168490-61168635,chr5,61168490,61168635,HepG2|chr5:176743449-176743494,chr5,176743449,176743494,0,115574959
HepG2|chr5:61232468-61232493,chr5,61232468,61232493,HepG2|chr5:176742934-176743073,chr5,176742934,176743073,0,115510466
HepG2|chr5:61773333-61773483,chr5,61773333,61773483,HepG2|chr5:272730-272880,chr5,272730,272880,0,61500603
HepG2|chr5:62838871-62838968,chr5,62838871,62838968,HepG2|chr5:273807-273850,chr5,273807,273850,0,62565064
HepG2|chr5:63122153-63122303,chr5,63122153,63122303,HepG2|chr5:273065-273215,chr5,273065,273215,0,62849088
HepG2|chr5:63607938-63608076,chr5,63607938,63608076,HepG2|chr5:5421856-5421887,chr5,5421856,5421887,0,58186082
HepG2|chr5:63811239-63811389,chr5,63811239,63811389,HepG2|chr5:272078-272222,chr5,272078,272222,0,63539161
HepG2|chr5:64242580-64242719,chr5,64242580,64242719,HepG2|chr5:272647-272797,chr5,272647,272797,0,63969933
HepG2|chr5:65024344-65024494,chr5,65024344,65024494,HepG2|chr5:217825-217950,chr5,217825,217950,0,64806519
HepG2|chr5:65498068-65498215,chr5,65498068,65498215,HepG2|chr5:217701-217851,chr5,217701,217851,0,65280367
HepG2|chr5:66117193-66117331,chr5,66117193,66117331,HepG2|chr5:5421856-5421887,chr5,5421856,5421887,0,60695337
HepG2|chr5:66347655-66347786,chr5,66347655,66347786,HepG2|chr5:139035319-139035345,chr5,139035319,139035345,0,72687664
HepG2|chr5:66598086-66598217,chr5,66598086,66598217,HepG2|chr5:236152-236257,chr5,236152,236257,0,66361934
HepG2|chr5:66926803-66926853,chr5,66926803,66926853,HepG2|chr5:76503028-76503128,chr5,76503028,76503128,0,9576225
HepG2|chr5:67641466-67641510,chr5,67641466,67641510,HepG2|chr5:76505720-76505870,chr5,76505720,76505870,0,8864254
HepG2|chr5:68646713-68646863,chr5,68646713,68646863,HepG2|chr5:272405-272555,chr5,272405,272555,0,68374308
HepG2|chr5:69416520-69416654,chr5,69416520,69416654,HepG2|chr5:272383-272529,chr5,272383,272529,0,69144137
HepG2|chr5:69531219-69531369,chr5,69531219,69531369,HepG2|chr5:176743246-176743289,chr5,176743246,176743289,0,107212027
HepG2|chr5:70249247-70249279,chr5,70249247,70249279,HepG2|chr5:613754-613872,chr5,613754,613872,0,69635493
HepG2|chr5:70321838-70321982,chr5,70321838,70321982,HepG2|chr5:236104-236141,chr5,236104,236141,0,70085734
HepG2|chr5:71082021-71082085,chr5,71082021,71082085,HepG2|chr5:236153-236299,chr5,236153,236299,0,70845868
HepG2|chr5:71740440-71740529,chr5,71740440,71740529,HepG2|chr5:176740213-176740250,chr5,176740213,176740250,0,104999773
HepG2|chr5:71825295-71825356,chr5,71825295,71825356,HepG2|chr5:173111839-173111902,chr5,173111839,173111902,0,101286544
HepG2|chr5:71829086-71829236,chr5,71829086,71829236,HepG2|chr5:273054-273204,chr5,273054,273204,0,71556032
HepG2|chr5:72556960-72557110,chr5,72556960,72557110,HepG2|chr5:273036-273186,chr5,273036,273186,0,72283924
HepG2|chr5:72794234-72794276,chr5,72794234,72794276,HepG2|chr5:154084787-154084895,chr5,154084787,154084895,0,81290553
HepG2|chr5:73043721-73043830,chr5,73043721,73043830,HepG2|chr5:272377-272527,chr5,272377,272527,0,72771344
HepG2|chr5:73188254-73188404,chr5,73188254,73188404,HepG2|chr5:217766-217803,chr5,217766,217803,0,72970488
HepG2|chr5:73426883-73427033,chr5,73426883,73427033,HepG2|chr5:217726-217872,chr5,217726,217872,0,73209157
HepG2|chr5:73774173-73774240,chr5,73774173,73774240,HepG2|chr5:236126-236244,chr5,236126,236244,0,73538047
HepG2|chr5:74085261-74085408,chr5,74085261,74085408,HepG2|chr5:272383-272529,chr5,272383,272529,0,73812878
HepG2|chr5:74090852-74090909,chr5,74090852,74090909,HepG2|chr5:175394517-175394567,chr5,175394517,175394567,0,101303665
HepG2|chr5:74459366-74459516,chr5,74459366,74459516,HepG2|chr5:272161-272305,chr5,272161,272305,0,74187205
HepG2|chr5:74639800-74639829,chr5,74639800,74639829,HepG2|chr5:40756222-40756272,chr5,40756222,40756272,0,33883578
HepG2|chr5:74754203-74754338,chr5,74754203,74754338,HepG2|chr5:272383-272529,chr5,272383,272529,0,74481820
HepG2|chr5:75048704-75048735,chr5,75048704,75048735,HepG2|chr5:175970596-175970746,chr5,175970596,175970746,0,100921892
HepG2|chr5:75088436-75088586,chr5,75088436,75088586,HepG2|chr5:272383-272530,chr5,272383,272530,0,74816053
HepG2|chr5:75460471-75460621,chr5,75460471,75460621,HepG2|chr5:272177-272324,chr5,272177,272324,0,75188294
HepG2|chr5:75495433-75495567,chr5,75495433,75495567,HepG2|chr5:613754-613872,chr5,613754,613872,0,74881679
HepG2|chr5:75656523-75656673,chr5,75656523,75656673,HepG2|chr5:176740291-176740382,chr5,176740291,176740382,0,101083768
HepG2|chr5:76074954-76075101,chr5,76074954,76075101,HepG2|chr5:173114844-173114866,chr5,173114844,173114866,0,97039890
HepG2|chr5:76105737-76105887,chr5,76105737,76105887,HepG2|chr5:272207-272357,chr5,272207,272357,0,75833530
HepG2|chr5:76235622-76235754,chr5,76235622,76235754,HepG2|chr5:272433-272566,chr5,272433,272566,0,75963189
HepG2|chr5:76483598-76483647,chr5,76483598,76483647,HepG2|chr5:43067341-43067441,chr5,43067341,43067441,0,33416257
HepG2|chr5:76692100-76692145,chr5,76692100,76692145,HepG2|chr5:236152-236257,chr5,236152,236257,0,76455948
HepG2|chr5:77203805-77203907,chr5,77203805,77203907,HepG2|chr5:235872-236018,chr5,235872,236018,0,76967933
HepG2|chr5:77228366-77228516,chr5,77228366,77228516,HepG2|chr5:236100-236250,chr5,236100,236250,0,76992266
HepG2|chr5:77391573-77391640,chr5,77391573,77391640,HepG2|chr5:150019651-150019696,chr5,150019651,150019696,0,72628078
HepG2|chr5:77641893-77641963,chr5,77641893,77641963,HepG2|chr5:148724734-148724764,chr5,148724734,148724764,0,71082841
HepG2|chr5:78255376-78255524,chr5,78255376,78255524,HepG2|chr5:272384-272534,chr5,272384,272534,0,77982992
HepG2|chr5:79178412-79178558,chr5,79178412,79178558,HepG2|chr5:218040-218140,chr5,218040,218140,0,78960372
HepG2|chr5:79526613-79526665,chr5,79526613,79526665,HepG2|chr5:36149710-36149860,chr5,36149710,36149860,0,43376903
HepG2|chr5:79854519-79854624,chr5,79854519,79854624,HepG2|chr5:217797-217871,chr5,217797,217871,0,79636722
HepG2|chr5:80051874-80052021,chr5,80051874,80052021,HepG2|chr5:272383-272529,chr5,272383,272529,0,79779491
HepG2|chr5:80057578-80057702,chr5,80057578,80057702,HepG2|chr5:139035319-139035345,chr5,139035319,139035345,0,58977741
HepG2|chr5:80191047-80191151,chr5,80191047,80191151,HepG2|chr5:176741673-176741719,chr5,176741673,176741719,0,96550626
HepG2|chr5:80868810-80868860,chr5,80868810,80868860,HepG2|chr5:76503028-76503128,chr5,76503028,76503128,0,4365782
HepG2|chr5:81053404-81053538,chr5,81053404,81053538,HepG2|chr5:272383-272529,chr5,272383,272529,0,80781021
HepG2|chr5:81657125-81657219,chr5,81657125,81657219,HepG2|chr5:176744544-176744643,chr5,176744544,176744643,0,95087419
HepG2|chr5:81904538-81904688,chr5,81904538,81904688,HepG2|chr5:176743246-176743289,chr5,176743246,176743289,0,94838708
HepG2|chr5:82140017-82140167,chr5,82140017,82140167,HepG2|chr5:272819-272969,chr5,272819,272969,0,81867198
HepG2|chr5:82548104-82548205,chr5,82548104,82548205,HepG2|chr5:76508226-76508275,chr5,76508226,76508275,0,6039878
HepG2|chr5:83233110-83233256,chr5,83233110,83233256,HepG2|chr5:175394527-175394590,chr5,175394527,175394590,0,92161417
HepG2|chr5:83351990-83352140,chr5,83351990,83352140,HepG2|chr5:272398-272548,chr5,272398,272548,0,83079592
HepG2|chr5:83383805-83383955,chr5,83383805,83383955,HepG2|chr5:272422-272572,chr5,272422,272572,0,83111383
HepG2|chr5:83612501-83612585,chr5,83612501,83612585,HepG2|chr5:154089077-154089128,chr5,154089077,154089128,0,70476576
HepG2|chr5:83859625-83859732,chr5,83859625,83859732,HepG2|chr5:176743246-176743289,chr5,176743246,176743289,0,92883621
HepG2|chr5:84242559-84242633,chr5,84242559,84242633,HepG2|chr5:175628481-175628556,chr5,175628481,175628556,0,91385922
HepG2|chr5:84846463-84846612,chr5,84846463,84846612,HepG2|chr5:272415-272565,chr5,272415,272565,0,84574048
HepG2|chr5:85074282-85074392,chr5,85074282,85074392,HepG2|chr5:273807-273847,chr5,273807,273847,0,84800475
HepG2|chr5:85310780-85310930,chr5,85310780,85310930,HepG2|chr5:272377-272527,chr5,272377,272527,0,85038403
HepG2|chr5:85341292-85341332,chr5,85341292,85341332,HepG2|chr5:180236419-180236510,chr5,180236419,180236510,0,94895127
HepG2|chr5:85362775-85362877,chr5,85362775,85362877,HepG2|chr5:217761-217907,chr5,217761,217907,0,85145014
HepG2|chr5:86078821-86078971,chr5,86078821,86078971,HepG2|chr5:272416-272566,chr5,272416,272566,0,85806405
HepG2|chr5:86682591-86682665,chr5,86682591,86682665,HepG2|chr5:175628481-175628556,chr5,175628481,175628556,0,88945890
HepG2|chr5:86750954-86751104,chr5,86750954,86751104,HepG2|chr5:235872-236018,chr5,235872,236018,0,86515082
HepG2|chr5:87346348-87346419,chr5,87346348,87346419,HepG2|chr5:176742931-176743047,chr5,176742931,176743047,0,89396583
HepG2|chr5:87540591-87540641,chr5,87540591,87540641,HepG2|chr5:5421515-5421566,chr5,5421515,5421566,0,82119076
HepG2|chr5:89414913-89415063,chr5,89414913,89415063,HepG2|chr5:272391-272541,chr5,272391,272541,0,89142522
HepG2|chr5:89478569-89478719,chr5,89478569,89478719,HepG2|chr5:236100-236250,chr5,236100,236250,0,89242469
HepG2|chr5:89570861-89571000,chr5,89570861,89571000,HepG2|chr5:272647-272797,chr5,272647,272797,0,89298214
HepG2|chr5:91190060-91190165,chr5,91190060,91190165,HepG2|chr5:68483072-68483101,chr5,68483072,68483101,0,22706988
HepG2|chr5:91497174-91497221,chr5,91497174,91497221,HepG2|chr5:273082-273232,chr5,273082,273232,0,91224092
HepG2|chr5:91587107-91587216,chr5,91587107,91587216,HepG2|chr5:272377-272527,chr5,272377,272527,0,91314730
HepG2|chr5:91649172-91649262,chr5,91649172,91649262,HepG2|chr5:133857603-133857634,chr5,133857603,133857634,0,42208431
HepG2|chr5:91832857-91833007,chr5,91832857,91833007,HepG2|chr5:273054-273204,chr5,273054,273204,0,91559803
HepG2|chr5:91851412-91851562,chr5,91851412,91851562,HepG2|chr5:272207-272357,chr5,272207,272357,0,91579205
HepG2|chr5:92145491-92145641,chr5,92145491,92145641,HepG2|chr5:272377-272527,chr5,272377,272527,0,91873114
HepG2|chr5:92558158-92558225,chr5,92558158,92558225,HepG2|chr5:154089077-154089128,chr5,154089077,154089128,0,61530919
HepG2|chr5:92822756-92822902,chr5,92822756,92822902,HepG2|chr5:218040-218140,chr5,218040,218140,0,92604716
HepG2|chr5:92977198-92977348,chr5,92977198,92977348,HepG2|chr5:273074-273224,chr5,273074,273224,0,92704124
HepG2|chr5:93300311-93300461,chr5,93300311,93300461,HepG2|chr5:217776-217926,chr5,217776,217926,0,93082535
HepG2|chr5:93468015-93468033,chr5,93468015,93468033,HepG2|chr5:173113059-173113098,chr5,173113059,173113098,0,79645044
HepG2|chr5:93864073-93864124,chr5,93864073,93864124,HepG2|chr5:36149710-36149860,chr5,36149710,36149860,0,57714363
HepG2|chr5:94510941-94511091,chr5,94510941,94511091,HepG2|chr5:272431-272581,chr5,272431,272581,0,94238510
HepG2|chr5:94702886-94703036,chr5,94702886,94703036,HepG2|chr5:272416-272565,chr5,272416,272565,0,94430470
HepG2|chr5:95173902-95174049,chr5,95173902,95174049,HepG2|chr5:272675-272825,chr5,272675,272825,0,94901227
HepG2|chr5:95463767-95463856,chr5,95463767,95463856,HepG2|chr5:76508226-76508287,chr5,76508226,76508287,0,18955541
HepG2|chr5:95468861-95469011,chr5,95468861,95469011,HepG2|chr5:272207-272357,chr5,272207,272357,0,95196654
HepG2|chr5:95692614-95692670,chr5,95692614,95692670,HepG2|chr5:76505948-76506093,chr5,76505948,76506093,0,19186666
HepG2|chr5:96393782-96393887,chr5,96393782,96393887,HepG2|chr5:150019651-150019696,chr5,150019651,150019696,0,53625869
HepG2|chr5:96542345-96542495,chr5,96542345,96542495,HepG2|chr5:272416-272566,chr5,272416,272566,0,96269929
HepG2|chr5:97111355-97111413,chr5,97111355,97111413,HepG2|chr5:179049011-179049103,chr5,179049011,179049103,0,81937656
HepG2|chr5:97564602-97564710,chr5,97564602,97564710,HepG2|chr5:176741673-176741719,chr5,176741673,176741719,0,79177071
HepG2|chr5:97570086-97570236,chr5,97570086,97570236,HepG2|chr5:272147-272291,chr5,272147,272291,0,97297939
HepG2|chr5:98229611-98229720,chr5,98229611,98229720,HepG2|chr5:76501934-76501959,chr5,76501934,76501959,0,21727677
HepG2|chr5:98463382-98463532,chr5,98463382,98463532,HepG2|chr5:272383-272529,chr5,272383,272529,0,98190999
HepG2|chr5:98553141-98553291,chr5,98553141,98553291,HepG2|chr5:272416-272566,chr5,272416,272566,0,98280725
HepG2|chr5:98645703-98645757,chr5,98645703,98645757,HepG2|chr5:37248904-37248971,chr5,37248904,37248971,0,61396799
HepG2|chr5:98802479-98802581,chr5,98802479,98802581,HepG2|chr5:235872-236018,chr5,235872,236018,0,98566607
HepG2|chr5:99052590-99052740,chr5,99052590,99052740,HepG2|chr5:217668-217818,chr5,217668,217818,0,98834922
HepG2|chr5:99226779-99226929,chr5,99226779,99226929,HepG2|chr5:217721-217871,chr5,217721,217871,0,99009058
HepG2|chr5:99981411-99981467,chr5,99981411,99981467,HepG2|chr5:76505948-76506093,chr5,76505948,76506093,0,23475463
HepG2|chr5:100066129-100066231,chr5,100066129,100066231,HepG2|chr5:217761-217907,chr5,217761,217907,0,99848368
HepG2|chr5:100665394-100665486,chr5,100665394,100665486,HepG2|chr5:98264282-98264307,chr5,98264282,98264307,0,2401112
HepG2|chr5:100830816-100830966,chr5,100830816,100830966,HepG2|chr5:273060-273210,chr5,273060,273210,0,100557756
HepG2|chr5:101050333-101050483,chr5,101050333,101050483,HepG2|chr5:272418-272567,chr5,272418,272567,0,100777915
HepG2|chr5:101585901-101586051,chr5,101585901,101586051,HepG2|chr5:218038-218167,chr5,218038,218167,0,101367863
HepG2|chr5:101599342-101599415,chr5,101599342,101599415,HepG2|chr5:133855516-133855559,chr5,133855516,133855559,0,32256174
HepG2|chr5:102038082-102038100,chr5,102038082,102038100,HepG2|chr5:133857533-133857683,chr5,133857533,133857683,0,31819451
HepG2|chr5:102116862-102116971,chr5,102116862,102116971,HepG2|chr5:76501934-76501959,chr5,76501934,76501959,0,25614928
HepG2|chr5:102265854-102266004,chr5,102265854,102266004,HepG2|chr5:273077-273227,chr5,273077,273227,0,101992777
HepG2|chr5:102351811-102351908,chr5,102351811,102351908,HepG2|chr5:273807-273850,chr5,273807,273850,0,102078004
HepG2|chr5:102543176-102543326,chr5,102543176,102543326,HepG2|chr5:272383-272530,chr5,272383,272530,0,102270793
HepG2|chr5:102876550-102876700,chr5,102876550,102876700,HepG2|chr5:175394492-175394590,chr5,175394492,175394590,0,72517942
HepG2|chr5:103059227-103059377,chr5,103059227,103059377,HepG2|chr5:272383-272530,chr5,272383,272530,0,102786844
HepG2|chr5:103367112-103367262,chr5,103367112,103367262,HepG2|chr5:217806-217956,chr5,217806,217956,0,103149306
HepG2|chr5:103717472-103717539,chr5,103717472,103717539,HepG2|chr5:236126-236244,chr5,236126,236244,0,103481346
HepG2|chr5:104111457-104111607,chr5,104111457,104111607,HepG2|chr5:217739-217871,chr5,217739,217871,0,103893718
HepG2|chr5:104675053-104675161,chr5,104675053,104675161,HepG2|chr5:176741673-176741719,chr5,176741673,176741719,0,72066620
HepG2|chr5:104957809-104957827,chr5,104957809,104957827,HepG2|chr5:133857533-133857683,chr5,133857533,133857683,0,28899724
HepG2|chr5:105277127-105277233,chr5,105277127,105277233,HepG2|chr5:272415-272565,chr5,272415,272565,0,105004712
HepG2|chr5:105428769-105428891,chr5,105428769,105428891,HepG2|chr5:217679-217829,chr5,217679,217829,0,105211090
HepG2|chr5:105503956-105504103,chr5,105503956,105504103,HepG2|chr5:217796-217946,chr5,217796,217946,0,105286160
HepG2|chr5:106088813-106088963,chr5,106088813,106088963,HepG2|chr5:68483746-68483889,chr5,68483746,68483889,0,37605067
HepG2|chr5:106254089-106254162,chr5,106254089,106254162,HepG2|chr5:178988929-178989000,chr5,178988929,178989000,0,72734840
HepG2|chr5:106610900-106611050,chr5,106610900,106611050,HepG2|chr5:217796-217946,chr5,217796,217946,0,106393104
HepG2|chr5:107154853-107154997,chr5,107154853,107154997,HepG2|chr5:236104-236141,chr5,236104,236141,0,106918749
HepG2|chr5:107282679-107282828,chr5,107282679,107282828,HepG2|chr5:272405-272555,chr5,272405,272555,0,107010274
HepG2|chr5:108133432-108133479,chr5,108133432,108133479,HepG2|chr5:236153-236299,chr5,236153,236299,0,107897279
HepG2|chr5:108169554-108169603,chr5,108169554,108169603,HepG2|chr5:43067341-43067441,chr5,43067341,43067441,0,65102213
HepG2|chr5:108456455-108456579,chr5,108456455,108456579,HepG2|chr5:148724734-148724759,chr5,148724734,148724759,0,40268279
HepG2|chr5:108562571-108562627,chr5,108562571,108562627,HepG2|chr5:273812-273892,chr5,273812,273892,0,108288759
HepG2|chr5:108716751-108716901,chr5,108716751,108716901,HepG2|chr5:272422-272572,chr5,272422,272572,0,108444329
HepG2|chr5:109632827-109632969,chr5,109632827,109632969,HepG2|chr5:98264402-98264455,chr5,98264402,98264455,0,11368425
HepG2|chr5:109652731-109652765,chr5,109652731,109652765,HepG2|chr5:176742931-176743047,chr5,176742931,176743047,0,67090200
HepG2|chr5:109906651-109906733,chr5,109906651,109906733,HepG2|chr5:96143956-96143999,chr5,96143956,96143999,0,13762695
HepG2|chr5:111010167-111010226,chr5,111010167,111010226,HepG2|chr5:236142-236244,chr5,236142,236244,0,110774025
HepG2|chr5:111295595-111295702,chr5,111295595,111295702,HepG2|chr5:176743246-176743289,chr5,176743246,176743289,0,65447651
HepG2|chr5:111306023-111306173,chr5,111306023,111306173,HepG2|chr5:272405-272555,chr5,272405,272555,0,111033618
HepG2|chr5:111807938-111808062,chr5,111807938,111808062,HepG2|chr5:148724734-148724759,chr5,148724734,148724759,0,36916796
HepG2|chr5:111819905-111819974,chr5,111819905,111819974,HepG2|chr5:148724734-148724764,chr5,148724734,148724764,0,36904829
HepG2|chr5:111872877-111872935,chr5,111872877,111872935,HepG2|chr5:40756195-40756272,chr5,40756195,40756272,0,71116682
HepG2|chr5:111941287-111941326,chr5,111941287,111941326,HepG2|chr5:180236419-180236510,chr5,180236419,180236510,0,68295132
HepG2|chr5:112304647-112304797,chr5,112304647,112304797,HepG2|chr5:176742610-176742707,chr5,176742610,176742707,0,64437963
HepG2|chr5:112682542-112682629,chr5,112682542,112682629,HepG2|chr5:154089077-154089128,chr5,154089077,154089128,0,41406535
HepG2|chr5:113286010-113286131,chr5,113286010,113286131,HepG2|chr5:217723-217871,chr5,217723,217871,0,113068287
HepG2|chr5:113510029-113510177,chr5,113510029,113510177,HepG2|chr5:272416-272535,chr5,272416,272535,0,113237613
HepG2|chr5:113818102-113818252,chr5,113818102,113818252,HepG2|chr5:217723-217872,chr5,217723,217872,0,113600379
HepG2|chr5:113878735-113878885,chr5,113878735,113878885,HepG2|chr5:273077-273227,chr5,273077,273227,0,113605658
HepG2|chr5:114254698-114254776,chr5,114254698,114254776,HepG2|chr5:236108-236258,chr5,236108,236258,0,114018590
HepG2|chr5:115529557-115529692,chr5,115529557,115529692,HepG2|chr5:272383-272529,chr5,272383,272529,0,115257174
HepG2|chr5:116097360-116097507,chr5,116097360,116097507,HepG2|chr5:273221-273367,chr5,273221,273367,0,115824139
HepG2|chr5:116562526-116562613,chr5,116562526,116562613,HepG2|chr5:154089077-154089128,chr5,154089077,154089128,0,37526551
HepG2|chr5:116791172-116791322,chr5,116791172,116791322,HepG2|chr5:217723-217872,chr5,217723,217872,0,116573449
HepG2|chr5:117250467-117250615,chr5,117250467,117250615,HepG2|chr5:272414-272564,chr5,272414,272564,0,116978053
HepG2|chr5:117402564-117402714,chr5,117402564,117402714,HepG2|chr5:217724-217871,chr5,217724,217871,0,117184840
HepG2|chr5:118069404-118069471,chr5,118069404,118069471,HepG2|chr5:5420404-5420477,chr5,5420404,5420477,0,112649000
HepG2|chr5:118332661-118332811,chr5,118332661,118332811,HepG2|chr5:272391-272541,chr5,272391,272541,0,118060270
HepG2|chr5:118365810-118365951,chr5,118365810,118365951,HepG2|chr5:272161-272307,chr5,272161,272307,0,118093649
HepG2|chr5:118661177-118661260,chr5,118661177,118661260,HepG2|chr5:76502355-76502420,chr5,76502355,76502420,0,42158822
HepG2|chr5:119559387-119559445,chr5,119559387,119559445,HepG2|chr5:40756195-40756272,chr5,40756195,40756272,0,78803192
HepG2|chr5:119565352-119565502,chr5,119565352,119565502,HepG2|chr5:175394468-175394590,chr5,175394468,175394590,0,55829116
HepG2|chr5:119922538-119922688,chr5,119922538,119922688,HepG2|chr5:273060-273210,chr5,273060,273210,0,119649478
HepG2|chr5:120040615-120040765,chr5,120040615,120040765,HepG2|chr5:272648-272798,chr5,272648,272798,0,119767967
HepG2|chr5:120114967-120115018,chr5,120114967,120115018,HepG2|chr5:36149710-36149860,chr5,36149710,36149860,0,83965257
HepG2|chr5:120127333-120127392,chr5,120127333,120127392,HepG2|chr5:176744515-176744665,chr5,176744515,176744665,0,56617182
HepG2|chr5:120136530-120136680,chr5,120136530,120136680,HepG2|chr5:273026-273176,chr5,273026,273176,0,119863504
HepG2|chr5:120215194-120215222,chr5,120215194,120215222,HepG2|chr5:76501934-76501959,chr5,76501934,76501959,0,43713260
HepG2|chr5:120643284-120643434,chr5,120643284,120643434,HepG2|chr5:272416-272566,chr5,272416,272566,0,120370868
HepG2|chr5:122744434-122744584,chr5,122744434,122744584,HepG2|chr5:217759-217853,chr5,217759,217853,0,122526675
HepG2|chr5:122788799-122788949,chr5,122788799,122788949,HepG2|chr5:273074-273224,chr5,273074,273224,0,122515725
HepG2|chr5:123051286-123051345,chr5,123051286,123051345,HepG2|chr5:176740291-176740382,chr5,176740291,176740382,0,53689005
HepG2|chr5:123278394-123278518,chr5,123278394,123278518,HepG2|chr5:139035319-139035345,chr5,139035319,139035345,0,15756925
HepG2|chr5:123419580-123419636,chr5,123419580,123419636,HepG2|chr5:148724734-148724822,chr5,148724734,148724822,0,25305154
HepG2|chr5:123452205-123452257,chr5,123452205,123452257,HepG2|chr5:236181-236328,chr5,236181,236328,0,123216024
HepG2|chr5:123825100-123825168,chr5,123825100,123825168,HepG2|chr5:236103-236252,chr5,236103,236252,0,123588997
HepG2|chr5:124240097-124240247,chr5,124240097,124240247,HepG2|chr5:272376-272526,chr5,272376,272526,0,123967721
HepG2|chr5:124271462-124271567,chr5,124271462,124271567,HepG2|chr5:236110-236153,chr5,236110,236153,0,124035352
HepG2|chr5:124332516-124332666,chr5,124332516,124332666,HepG2|chr5:217838-217987,chr5,217838,217987,0,124114678
HepG2|chr5:124565896-124566046,chr5,124565896,124566046,HepG2|chr5:272413-272561,chr5,272413,272561,0,124293483
HepG2|chr5:124634802-124634952,chr5,124634802,124634952,HepG2|chr5:148724734-148724813,chr5,148724734,148724813,0,24089932
HepG2|chr5:124701420-124701570,chr5,124701420,124701570,HepG2|chr5:217776-217926,chr5,217776,217926,0,124483644
HepG2|chr5:125080404-125080554,chr5,125080404,125080554,HepG2|chr5:272405-272555,chr5,272405,272555,0,124807999
HepG2|chr5:125181911-125182053,chr5,125181911,125182053,HepG2|chr5:98264402-98264455,chr5,98264402,98264455,0,26917509
HepG2|chr5:126004453-126004602,chr5,126004453,126004602,HepG2|chr5:272405-272555,chr5,272405,272555,0,125732048
HepG2|chr5:126117178-126117324,chr5,126117178,126117324,HepG2|chr5:217654-217804,chr5,217654,217804,0,125899524
HepG2|chr5:126124163-126124313,chr5,126124163,126124313,HepG2|chr5:217725-217871,chr5,217725,217871,0,125906438
HepG2|chr5:126377520-126377660,chr5,126377520,126377660,HepG2|chr5:175394453-175394603,chr5,175394453,175394603,0,49016933
HepG2|chr5:126590676-126590826,chr5,126590676,126590826,HepG2|chr5:273060-273210,chr5,273060,273210,0,126317616
HepG2|chr5:126946033-126946117,chr5,126946033,126946117,HepG2|chr5:273037-273159,chr5,273037,273159,0,126672996
HepG2|chr5:126979019-126979169,chr5,126979019,126979169,HepG2|chr5:217962-218112,chr5,217962,218112,0,126761057
HepG2|chr5:127380298-127380316,chr5,127380298,127380316,HepG2|chr5:43067341-43067441,chr5,43067341,43067441,0,84312957
HepG2|chr5:127422811-127422958,chr5,127422811,127422958,HepG2|chr5:217896-218042,chr5,217896,218042,0,127204915
HepG2|chr5:127431987-127432134,chr5,127431987,127432134,HepG2|chr5:217796-217946,chr5,217796,217946,0,127214191
HepG2|chr5:127509230-127509380,chr5,127509230,127509380,HepG2|chr5:68484817-68484884,chr5,68484817,68484884,0,59024413
HepG2|chr5:127543022-127543123,chr5,127543022,127543123,HepG2|chr5:76508226-76508275,chr5,76508226,76508275,0,51034796
HepG2|chr5:128031722-128031798,chr5,128031722,128031798,HepG2|chr5:40756225-40756272,chr5,40756225,40756272,0,87275497
HepG2|chr5:128067072-128067217,chr5,128067072,128067217,HepG2|chr5:76503028-76503128,chr5,76503028,76503128,0,51564044
HepG2|chr5:128093160-128093227,chr5,128093160,128093227,HepG2|chr5:150019651-150019696,chr5,150019651,150019696,0,21926491
HepG2|chr5:128108933-128109083,chr5,128108933,128109083,HepG2|chr5:272706-272856,chr5,272706,272856,0,127836227
HepG2|chr5:128224964-128225114,chr5,128224964,128225114,HepG2|chr5:217710-217860,chr5,217710,217860,0,128007254
HepG2|chr5:128244200-128244348,chr5,128244200,128244348,HepG2|chr5:272427-272571,chr5,272427,272571,0,127971773
HepG2|chr5:128890785-128890935,chr5,128890785,128890935,HepG2|chr5:272730-272880,chr5,272730,272880,0,128618055
HepG2|chr5:130090023-130090173,chr5,130090023,130090173,HepG2|chr5:272078-272222,chr5,272078,272222,0,129817945
HepG2|chr5:130241812-130241962,chr5,130241812,130241962,HepG2|chr5:217664-217814,chr5,217664,217814,0,130024148
HepG2|chr5:130389990-130390048,chr5,130389990,130390048,HepG2|chr5:76503244-76503321,chr5,76503244,76503321,0,53886746
HepG2|chr5:131452660-131452733,chr5,131452660,131452733,HepG2|chr5:179049011-179049103,chr5,179049011,179049103,0,47596351
HepG2|chr5:131562555-131562702,chr5,131562555,131562702,HepG2|chr5:217701-217851,chr5,217701,217851,0,131344854
HepG2|chr5:131694946-131695068,chr5,131694946,131695068,HepG2|chr5:217679-217829,chr5,217679,217829,0,131477267
HepG2|chr5:132044998-132045147,chr5,132044998,132045147,HepG2|chr5:217752-217902,chr5,217752,217902,0,131827246
HepG2|chr5:132716765-132716912,chr5,132716765,132716912,HepG2|chr5:273221-273367,chr5,273221,273367,0,132443544
HepG2|chr5:133557384-133557534,chr5,133557384,133557534,HepG2|chr5:272161-272305,chr5,272161,272305,0,133285223
HepG2|chr5:133779529-133779599,chr5,133779529,133779599,HepG2|chr5:148724734-148724764,chr5,148724734,148724764,0,14945205
HepG2|chr5:135402459-135402609,chr5,135402459,135402609,HepG2|chr5:272416-272566,chr5,272416,272566,0,135130043
HepG2|chr5:136052130-136052280,chr5,136052130,136052280,HepG2|chr5:217771-217917,chr5,217771,217917,0,135834359
HepG2|chr5:136124303-136124453,chr5,136124303,136124453,HepG2|chr5:272115-272264,chr5,272115,272264,0,135852188
HepG2|chr5:136631044-136631111,chr5,136631044,136631111,HepG2|chr5:154089077-154089128,chr5,154089077,154089128,0,17458033
HepG2|chr5:137149992-137150142,chr5,137149992,137150142,HepG2|chr5:273065-273215,chr5,273065,273215,0,136876927
HepG2|chr5:137417395-137417545,chr5,137417395,137417545,HepG2|chr5:273026-273176,chr5,273026,273176,0,137144369
HepG2|chr5:137807205-137807349,chr5,137807205,137807349,HepG2|chr5:272612-272762,chr5,272612,272762,0,137534593
HepG2|chr5:138157703-138157852,chr5,138157703,138157852,HepG2|chr5:175394468-175394603,chr5,175394468,175394603,0,37236765
HepG2|chr5:138169776-138169806,chr5,138169776,138169806,HepG2|chr5:133856945-133857004,chr5,133856945,133857004,0,4312831
HepG2|chr5:138226212-138226272,chr5,138226212,138226272,HepG2|chr5:96143956-96143999,chr5,96143956,96143999,0,42082256
HepG2|chr5:138608644-138608792,chr5,138608644,138608792,HepG2|chr5:273077-273227,chr5,273077,273227,0,138335567
HepG2|chr5:138755454-138755598,chr5,138755454,138755598,HepG2|chr5:272612-272762,chr5,272612,272762,0,138482842
HepG2|chr5:138942516-138942621,chr5,138942516,138942621,HepG2|chr5:133855244-133855289,chr5,133855244,133855289,0,5087272
HepG2|chr5:139031389-139031478,chr5,139031389,139031478,HepG2|chr5:76508226-76508287,chr5,76508226,76508287,0,62523163
HepG2|chr5:139223267-139223290,chr5,139223267,139223290,HepG2|chr5:76502237-76502367,chr5,76502237,76502367,0,62721030
HepG2|chr5:139675552-139675684,chr5,139675552,139675684,HepG2|chr5:272433-272566,chr5,272433,272566,0,139403119
HepG2|chr5:141216037-141216187,chr5,141216037,141216187,HepG2|chr5:273065-273215,chr5,273065,273215,0,140942972
HepG2|chr5:141228755-141228905,chr5,141228755,141228905,HepG2|chr5:272416-272566,chr5,272416,272566,0,140956339
HepG2|chr5:141394650-141394800,chr5,141394650,141394800,HepG2|chr5:235882-236032,chr5,235882,236032,0,141158768
HepG2|chr5:141433896-141433928,chr5,141433896,141433928,HepG2|chr5:613754-613872,chr5,613754,613872,0,140820142
HepG2|chr5:141510266-141510413,chr5,141510266,141510413,HepG2|chr5:272212-272362,chr5,272212,272362,0,141238054
HepG2|chr5:141666590-141666739,chr5,141666590,141666739,HepG2|chr5:175394468-175394603,chr5,175394468,175394603,0,33727878
HepG2|chr5:141795580-141795605,chr5,141795580,141795605,HepG2|chr5:176744069-176744219,chr5,176744069,176744219,0,34948489
HepG2|chr5:142043069-142043154,chr5,142043069,142043154,HepG2|chr5:236103-236141,chr5,236103,236141,0,141806966
HepG2|chr5:142483556-142483702,chr5,142483556,142483702,HepG2|chr5:217654-217804,chr5,217654,217804,0,142265902
HepG2|chr5:142509150-142509256,chr5,142509150,142509256,HepG2|chr5:272415-272565,chr5,272415,272565,0,142236735
HepG2|chr5:142826737-142826887,chr5,142826737,142826887,HepG2|chr5:272416-272566,chr5,272416,272566,0,142554321
HepG2|chr5:143687339-143687489,chr5,143687339,143687489,HepG2|chr5:272706-272856,chr5,272706,272856,0,143414633
HepG2|chr5:143744689-143744836,chr5,143744689,143744836,HepG2|chr5:273075-273192,chr5,273075,273192,0,143471614
HepG2|chr5:145004937-145005019,chr5,145004937,145005019,HepG2|chr5:236144-236284,chr5,236144,236284,0,144768793
HepG2|chr5:145655641-145655791,chr5,145655641,145655791,HepG2|chr5:272421-272571,chr5,272421,272571,0,145383220
HepG2|chr5:145917959-145918044,chr5,145917959,145918044,HepG2|chr5:154089077-154089128,chr5,154089077,154089128,0,8171118
HepG2|chr5:146535416-146535566,chr5,146535416,146535566,HepG2|chr5:217724-217871,chr5,217724,217871,0,146317692
HepG2|chr5:146659162-146659182,chr5,146659162,146659182,HepG2|chr5:76502237-76502367,chr5,76502237,76502367,0,70156925
HepG2|chr5:146663204-146663354,chr5,146663204,146663354,HepG2|chr5:272427-272571,chr5,272427,272571,0,146390777
HepG2|chr5:147717731-147717881,chr5,147717731,147717881,HepG2|chr5:217771-217917,chr5,217771,217917,0,147499960
HepG2|chr5:148058631-148058781,chr5,148058631,148058781,HepG2|chr5:217721-217871,chr5,217721,217871,0,147840910
HepG2|chr5:148097041-148097191,chr5,148097041,148097191,HepG2|chr5:217725-217871,chr5,217725,217871,0,147879316
HepG2|chr5:148102219-148102366,chr5,148102219,148102366,HepG2|chr5:173114844-173114866,chr5,173114844,173114866,0,25012625
HepG2|chr5:148454156-148454297,chr5,148454156,148454297,HepG2|chr5:236104-236141,chr5,236104,236141,0,148218052
HepG2|chr5:149493055-149493205,chr5,149493055,149493205,HepG2|chr5:272405-272555,chr5,272405,272555,0,149220650
HepG2|chr5:149788014-149788161,chr5,149788014,149788161,HepG2|chr5:272414-272564,chr5,272414,272564,0,149515600
HepG2|chr5:150090041-150090191,chr5,150090041,150090191,HepG2|chr5:272442-272592,chr5,272442,272592,0,149817599
HepG2|chr5:150340326-150340394,chr5,150340326,150340394,HepG2|chr5:148724734-148724822,chr5,148724734,148724822,0,1615592
HepG2|chr5:150407634-150407782,chr5,150407634,150407782,HepG2|chr5:272383-272529,chr5,272383,272529,0,150135251
HepG2|chr5:150499112-150499185,chr5,150499112,150499185,HepG2|chr5:178988929-178989000,chr5,178988929,178989000,0,28489817
HepG2|chr5:150592757-150592907,chr5,150592757,150592907,HepG2|chr5:217739-217871,chr5,217739,217871,0,150375018
HepG2|chr5:151358661-151358766,chr5,151358661,151358766,HepG2|chr5:236110-236153,chr5,236110,236153,0,151122551
HepG2|chr5:151502522-151502672,chr5,151502522,151502672,HepG2|chr5:272377-272527,chr5,272377,272527,0,151230145
HepG2|chr5:153357747-153357891,chr5,153357747,153357891,HepG2|chr5:272383-272529,chr5,272383,272529,0,153085364
HepG2|chr5:153511898-153511968,chr5,153511898,153511968,HepG2|chr5:139491608-139491648,chr5,139491608,139491648,0,14020290
HepG2|chr5:154664903-154664988,chr5,154664903,154664988,HepG2|chr5:236103-236141,chr5,236103,236141,0,154428800
HepG2|chr5:154893792-154893924,chr5,154893792,154893924,HepG2|chr5:217791-217941,chr5,217791,217941,0,154676001
HepG2|chr5:155349502-155349631,chr5,155349502,155349631,HepG2|chr5:272383-272529,chr5,272383,272529,0,155077119
HepG2|chr5:155522141-155522223,chr5,155522141,155522223,HepG2|chr5:236144-236284,chr5,236144,236284,0,155285997
HepG2|chr5:156412613-156412763,chr5,156412613,156412763,HepG2|chr5:272405-272555,chr5,272405,272555,0,156140208
HepG2|chr5:156788462-156788556,chr5,156788462,156788556,HepG2|chr5:176744544-176744643,chr5,176744544,176744643,0,19956082
HepG2|chr5:156818824-156818971,chr5,156818824,156818971,HepG2|chr5:272675-272825,chr5,272675,272825,0,156546149
HepG2|chr5:156977048-156977066,chr5,156977048,156977066,HepG2|chr5:43067341-43067441,chr5,43067341,43067441,0,113909707
HepG2|chr5:157156289-157156439,chr5,157156289,157156439,HepG2|chr5:217806-217956,chr5,217806,217956,0,156938483
HepG2|chr5:157268536-157268686,chr5,157268536,157268686,HepG2|chr5:217726-217872,chr5,217726,217872,0,157050810
HepG2|chr5:157308122-157308186,chr5,157308122,157308186,HepG2|chr5:236153-236299,chr5,236153,236299,0,157071969
HepG2|chr5:157511661-157511731,chr5,157511661,157511731,HepG2|chr5:139491608-139491648,chr5,139491608,139491648,0,18020053
HepG2|chr5:157523148-157523295,chr5,157523148,157523295,HepG2|chr5:217831-217981,chr5,217831,217981,0,157305317
HepG2|chr5:157795098-157795245,chr5,157795098,157795245,HepG2|chr5:217835-217985,chr5,217835,217985,0,157577263
HepG2|chr5:157907907-157908057,chr5,157907907,157908057,HepG2|chr5:272405-272555,chr5,272405,272555,0,157635502
HepG2|chr5:158012773-158012921,chr5,158012773,158012921,HepG2|chr5:272384-272534,chr5,272384,272534,0,157740389
HepG2|chr5:158479044-158479194,chr5,158479044,158479194,HepG2|chr5:273054-273204,chr5,273054,273204,0,158205990
HepG2|chr5:158619571-158619721,chr5,158619571,158619721,HepG2|chr5:273041-273188,chr5,273041,273188,0,158346530
HepG2|chr5:159299018-159299052,chr5,159299018,159299052,HepG2|chr5:176742931-176743047,chr5,176742931,176743047,0,17443913
HepG2|chr5:159407543-159407693,chr5,159407543,159407693,HepG2|chr5:273041-273188,chr5,273041,273188,0,159134502
HepG2|chr5:159461351-159461501,chr5,159461351,159461501,HepG2|chr5:272210-272360,chr5,272210,272360,0,159189141
HepG2|chr5:160790876-160790969,chr5,160790876,160790969,HepG2|chr5:98264402-98264455,chr5,98264402,98264455,0,62526474
HepG2|chr5:161096952-161097102,chr5,161096952,161097102,HepG2|chr5:148724734-148724813,chr5,148724734,148724813,0,12372218
HepG2|chr5:162910923-162910991,chr5,162910923,162910991,HepG2|chr5:236103-236252,chr5,236103,236252,0,162674820
HepG2|chr5:163049483-163049633,chr5,163049483,163049633,HepG2|chr5:218038-218167,chr5,218038,218167,0,162831445
HepG2|chr5:163409568-163409644,chr5,163409568,163409644,HepG2|chr5:40756225-40756272,chr5,40756225,40756272,0,122653343
HepG2|chr5:163652253-163652403,chr5,163652253,163652403,HepG2|chr5:217664-217814,chr5,217664,217814,0,163434589
HepG2|chr5:164156050-164156155,chr5,164156050,164156155,HepG2|chr5:217797-217871,chr5,217797,217871,0,163938253
HepG2|chr5:164336907-164337057,chr5,164336907,164337057,HepG2|chr5:273060-273210,chr5,273060,273210,0,164063847
HepG2|chr5:164550659-164550809,chr5,164550659,164550809,HepG2|chr5:217724-217871,chr5,217724,217871,0,164332935
HepG2|chr5:165126747-165126806,chr5,165126747,165126806,HepG2|chr5:176740291-176740382,chr5,176740291,176740382,0,11613544
HepG2|chr5:165416279-165416429,chr5,165416279,165416429,HepG2|chr5:272427-272571,chr5,272427,272571,0,165143852
HepG2|chr5:165800037-165800187,chr5,165800037,165800187,HepG2|chr5:273036-273186,chr5,273036,273186,0,165527001
HepG2|chr5:167558867-167558921,chr5,167558867,167558921,HepG2|chr5:37248904-37248971,chr5,37248904,37248971,0,130309963
HepG2|chr5:168132770-168132800,chr5,168132770,168132800,HepG2|chr5:133856945-133857004,chr5,133856945,133857004,0,34275825
HepG2|chr5:169605488-169605638,chr5,169605488,169605638,HepG2|chr5:175394468-175394590,chr5,175394468,175394590,0,5788980
HepG2|chr5:169729010-169729115,chr5,169729010,169729115,HepG2|chr5:133855244-133855289,chr5,133855244,133855289,0,35873766
HepG2|chr5:170555311-170555394,chr5,170555311,170555394,HepG2|chr5:76502355-76502420,chr5,76502355,76502420,0,94052956
HepG2|chr5:170740464-170740608,chr5,170740464,170740608,HepG2|chr5:272377-272527,chr5,272377,272527,0,170468087
HepG2|chr5:170958395-170958423,chr5,170958395,170958423,HepG2|chr5:76501934-76501959,chr5,76501934,76501959,0,94456461
HepG2|chr5:170987293-170987440,chr5,170987293,170987440,HepG2|chr5:217835-217985,chr5,217835,217985,0,170769458
HepG2|chr5:171304331-171304431,chr5,171304331,171304431,HepG2|chr5:217828-217885,chr5,217828,217885,0,171086503
HepG2|chr5:171475019-171475169,chr5,171475019,171475169,HepG2|chr5:217825-217950,chr5,217825,217950,0,171257194
HepG2|chr5:172200768-172200918,chr5,172200768,172200918,HepG2|chr5:217710-217860,chr5,217710,217860,0,171983058
HepG2|chr5:172388649-172388799,chr5,172388649,172388799,HepG2|chr5:217668-217818,chr5,217668,217818,0,172170981
HepG2|chr5:172901282-172901432,chr5,172901282,172901432,HepG2|chr5:272421-272571,chr5,272421,272571,0,172628861
HepG2|chr5:173414987-173415137,chr5,173414987,173415137,HepG2|chr5:273041-273187,chr5,273041,273187,0,173141946
HepG2|chr5:173759959-173760027,chr5,173759959,173760027,HepG2|chr5:148724734-148724822,chr5,148724734,148724822,0,25035225
HepG2|chr5:173770407-173770458,chr5,173770407,173770458,HepG2|chr5:176744544-176744643,chr5,176744544,176744643,0,2974137
HepG2|chr5:174129836-174129903,chr5,174129836,174129903,HepG2|chr5:133856945-133857004,chr5,133856945,133857004,0,40272891
HepG2|chr5:174241109-174241167,chr5,174241109,174241167,HepG2|chr5:76503244-76503321,chr5,76503244,76503321,0,97737865
HepG2|chr5:174880980-174881130,chr5,174880980,174881130,HepG2|chr5:272149-272291,chr5,272149,272291,0,174608831
HepG2|chr5:174910645-174910795,chr5,174910645,174910795,HepG2|chr5:217833-217983,chr5,217833,217983,0,174692812
HepG2|chr5:175197924-175198074,chr5,175197924,175198074,HepG2|chr5:217490-217639,chr5,217490,217639,0,174980434
HepG2|chr5:175358834-175358948,chr5,175358834,175358948,HepG2|chr5:217928-217964,chr5,217928,217964,0,175140906
HepG2|chr5:175460334-175460484,chr5,175460334,175460484,HepG2|chr5:217962-218112,chr5,217962,218112,0,175242372
HepG2|chr5:175621184-175621226,chr5,175621184,175621226,HepG2|chr5:154084787-154084895,chr5,154084787,154084895,0,21536397
HepG2|chr5:176468576-176468659,chr5,176468576,176468659,HepG2|chr5:68484817-68484884,chr5,68484817,68484884,0,107983759
HepG2|chr5:177632545-177632689,chr5,177632545,177632689,HepG2|chr5:272377-272527,chr5,272377,272527,0,177360168
HepG2|chr5:177674297-177674356,chr5,177674297,177674356,HepG2|chr5:175631751-175631842,chr5,175631751,175631842,0,2042546
HepG2|chr5:177692922-177693072,chr5,177692922,177693072,HepG2|chr5:217733-217883,chr5,217733,217883,0,177475189
HepG2|chr5:178030099-178030151,chr5,178030099,178030151,HepG2|chr5:36149710-36149860,chr5,36149710,36149860,0,141880389
HepG2|chr5:178151836-178151953,chr5,178151836,178151953,HepG2|chr5:154084787-154084895,chr5,154084787,154084895,0,24067049
HepG2|chr5:178815713-178815751,chr5,178815713,178815751,HepG2|chr5:40756239-40756272,chr5,40756239,40756272,0,138059474
HepG2|chr5:180227029-180227177,chr5,180227029,180227177,HepG2|chr5:272416-272535,chr5,272416,272535,0,179954613
HepG2|chr6:656352-656383,chr6,656352,656383,HepG2|chr6:31794979-31795098,chr6,31794979,31795098,0,31138627
HepG2|chr6:665962-666024,chr6,665962,666024,HepG2|chr6:35227066-35227148,chr6,35227066,35227148,0,34561104
HepG2|chr6:737492-737642,chr6,737492,737642,HepG2|chr6:30534258-30534291,chr6,30534258,30534291,0,29796766
HepG2|chr6:1001917-1002006,chr6,1001917,1002006,HepG2|chr6:31794979-31795093,chr6,31794979,31795093,0,30793062
HepG2|chr6:2004793-2004838,chr6,2004793,2004838,HepG2|chr6:1385438-1385588,chr6,1385438,1385588,0,619355
HepG2|chr6:2520088-2520130,chr6,2520088,2520130,HepG2|chr6:31794979-31795098,chr6,31794979,31795098,0,29274891
HepG2|chr6:2682205-2682258,chr6,2682205,2682258,HepG2|chr6:31458623-31458772,chr6,31458623,31458772,0,28776418
HepG2|chr6:2757131-2757201,chr6,2757131,2757201,HepG2|chr6:26285998-26286070,chr6,26285998,26286070,0,23528867
HepG2|chr6:3109275-3109326,chr6,3109275,3109326,HepG2|chr6:31458067-31458107,chr6,31458067,31458107,0,28348792
HepG2|chr6:3273342-3273464,chr6,3273342,3273464,HepG2|chr6:42716563-42716709,chr6,42716563,42716709,0,39443221
HepG2|chr6:3388355-3388505,chr6,3388355,3388505,HepG2|chr6:116692423-116692573,chr6,116692423,116692573,0,113304068
HepG2|chr6:4115418-4115499,chr6,4115418,4115499,HepG2|chr6:31459015-31459084,chr6,31459015,31459084,0,27343597
HepG2|chr6:4299992-4300085,chr6,4299992,4300085,HepG2|chr6:26286130-26286280,chr6,26286130,26286280,0,21986138
HepG2|chr6:4617826-4617873,chr6,4617826,4617873,HepG2|chr6:3118078-3118222,chr6,3118078,3118222,0,1499748
HepG2|chr6:5037953-5038022,chr6,5037953,5038022,HepG2|chr6:3002854-3002896,chr6,3002854,3002896,0,2035099
HepG2|chr6:5045152-5045233,chr6,5045152,5045233,HepG2|chr6:80247477-80247500,chr6,80247477,80247500,0,75202325
HepG2|chr6:5241990-5242025,chr6,5241990,5242025,HepG2|chr6:31794981-31795078,chr6,31794981,31795078,0,26552991
HepG2|chr6:5558495-5558547,chr6,5558495,5558547,HepG2|chr6:35226846-35226879,chr6,35226846,35226879,0,29668351
HepG2|chr6:6214714-6214864,chr6,6214714,6214864,HepG2|chr6:31460149-31460299,chr6,31460149,31460299,0,25245435
HepG2|chr6:6288587-6288649,chr6,6288587,6288649,HepG2|chr6:35227066-35227148,chr6,35227066,35227148,0,28938479
HepG2|chr6:6663565-6663608,chr6,6663565,6663608,HepG2|chr6:10531791-10531918,chr6,10531791,10531918,0,3868226
HepG2|chr6:6996696-6996756,chr6,6996696,6996756,HepG2|chr6:111300557-111300707,chr6,111300557,111300707,0,104303861
HepG2|chr6:7120603-7120691,chr6,7120603,7120691,HepG2|chr6:31459857-31459917,chr6,31459857,31459917,0,24339254
HepG2|chr6:7208240-7208299,chr6,7208240,7208299,HepG2|chr6:31793927-31794077,chr6,31793927,31794077,0,24585687
HepG2|chr6:7369548-7369606,chr6,7369548,7369606,HepG2|chr6:31457746-31457871,chr6,31457746,31457871,0,24088198
HepG2|chr6:7548762-7548834,chr6,7548762,7548834,HepG2|chr6:116421654-116421766,chr6,116421654,116421766,0,108872892
HepG2|chr6:8070243-8070316,chr6,8070243,8070316,HepG2|chr6:1308817-1308853,chr6,1308817,1308853,0,6761426
HepG2|chr6:8381802-8381949,chr6,8381802,8381949,HepG2|chr6:31462099-31462141,chr6,31462099,31462141,0,23080297
HepG2|chr6:8904084-8904231,chr6,8904084,8904231,HepG2|chr6:27442962-27443021,chr6,27442962,27443021,0,18538878
HepG2|chr6:8944578-8944633,chr6,8944578,8944633,HepG2|chr6:31794979-31795074,chr6,31794979,31795074,0,22850401
HepG2|chr6:8960678-8960763,chr6,8960678,8960763,HepG2|chr6:30538448-30538512,chr6,30538448,30538512,0,21577770
HepG2|chr6:9028830-9028875,chr6,9028830,9028875,HepG2|chr6:111301058-111301205,chr6,111301058,111301205,0,102272228
HepG2|chr6:9122198-9122230,chr6,9122198,9122230,HepG2|chr6:31795089-31795238,chr6,31795089,31795238,0,22672891
HepG2|chr6:9303611-9303664,chr6,9303611,9303664,HepG2|chr6:111281690-111281787,chr6,111281690,111281787,0,101978079
HepG2|chr6:9589818-9589858,chr6,9589818,9589858,HepG2|chr6:34724875-34724928,chr6,34724875,34724928,0,25135057
HepG2|chr6:9612902-9612997,chr6,9612902,9612997,HepG2|chr6:1309638-1309672,chr6,1309638,1309672,0,8303264
HepG2|chr6:9792567-9792671,chr6,9792567,9792671,HepG2|chr6:3118022-3118111,chr6,3118022,3118111,0,6674545
HepG2|chr6:9998789-9998859,chr6,9998789,9998859,HepG2|chr6:35226846-35226892,chr6,35226846,35226892,0,25228057
HepG2|chr6:10004316-10004398,chr6,10004316,10004398,HepG2|chr6:35226850-35226895,chr6,35226850,35226895,0,25222534
HepG2|chr6:10606864-10606935,chr6,10606864,10606935,HepG2|chr6:35177481-35177543,chr6,35177481,35177543,0,24570617
HepG2|chr6:10963497-10963574,chr6,10963497,10963574,HepG2|chr6:2841501-2841574,chr6,2841501,2841574,0,8121996
HepG2|chr6:11420397-11420428,chr6,11420397,11420428,HepG2|chr6:1308817-1308853,chr6,1308817,1308853,0,10111580
HepG2|chr6:12028144-12028172,chr6,12028144,12028172,HepG2|chr6:111300357-111300384,chr6,111300357,111300384,0,99272213
HepG2|chr6:12491117-12491206,chr6,12491117,12491206,HepG2|chr6:111299049-111299118,chr6,111299049,111299118,0,98807932
HepG2|chr6:12585288-12585361,chr6,12585288,12585361,HepG2|chr6:111298197-111298347,chr6,111298197,111298347,0,98712909
HepG2|chr6:12688069-12688103,chr6,12688069,12688103,HepG2|chr6:3118022-3118138,chr6,3118022,3118138,0,9570047
HepG2|chr6:12764389-12764453,chr6,12764389,12764453,HepG2|chr6:31457909-31458013,chr6,31457909,31458013,0,18693520
HepG2|chr6:13037934-13037994,chr6,13037934,13037994,HepG2|chr6:111300557-111300707,chr6,111300557,111300707,0,98262623
HepG2|chr6:13217508-13217562,chr6,13217508,13217562,HepG2|chr6:30536264-30536336,chr6,30536264,30536336,0,17318756
HepG2|chr6:13258088-13258147,chr6,13258088,13258147,HepG2|chr6:31794979-31795111,chr6,31794979,31795111,0,18536891
HepG2|chr6:13582769-13582916,chr6,13582769,13582916,HepG2|chr6:31459041-31459077,chr6,31459041,31459077,0,17876272
HepG2|chr6:14053310-14053375,chr6,14053310,14053375,HepG2|chr6:116421654-116421742,chr6,116421654,116421742,0,102368344
HepG2|chr6:14267082-14267148,chr6,14267082,14267148,HepG2|chr6:80249791-80249935,chr6,80249791,80249935,0,65982709
HepG2|chr6:14366732-14366808,chr6,14366732,14366808,HepG2|chr6:80247477-80247500,chr6,80247477,80247500,0,65880745
HepG2|chr6:14430483-14430579,chr6,14430483,14430579,HepG2|chr6:3118022-3118054,chr6,3118022,3118054,0,11312461
HepG2|chr6:14485641-14485742,chr6,14485641,14485742,HepG2|chr6:26286233-26286281,chr6,26286233,26286281,0,11800592
HepG2|chr6:14775615-14775660,chr6,14775615,14775660,HepG2|chr6:3118022-3118138,chr6,3118022,3118138,0,11657593
HepG2|chr6:15658250-15658330,chr6,15658250,15658330,HepG2|chr6:52282785-52282845,chr6,52282785,52282845,0,36624535
HepG2|chr6:15665609-15665723,chr6,15665609,15665723,HepG2|chr6:5262512-5262548,chr6,5262512,5262548,0,10403097
HepG2|chr6:15808066-15808113,chr6,15808066,15808113,HepG2|chr6:1308817-1308883,chr6,1308817,1308883,0,14499249
HepG2|chr6:15985158-15985268,chr6,15985158,15985268,HepG2|chr6:31459019-31459077,chr6,31459019,31459077,0,15473861
HepG2|chr6:15997426-15997474,chr6,15997426,15997474,HepG2|chr6:31459019-31459077,chr6,31459019,31459077,0,15461593
HepG2|chr6:16186519-16186610,chr6,16186519,16186610,HepG2|chr6:43734518-43734655,chr6,43734518,43734655,0,27547999
HepG2|chr6:16337979-16338006,chr6,16337979,16338006,HepG2|chr6:38672372-38672391,chr6,38672372,38672391,0,22334393
HepG2|chr6:16503505-16503614,chr6,16503505,16503614,HepG2|chr6:31459014-31459077,chr6,31459014,31459077,0,14955509
HepG2|chr6:16693426-16693459,chr6,16693426,16693459,HepG2|chr6:30538052-30538202,chr6,30538052,30538202,0,13844626
HepG2|chr6:17126134-17126274,chr6,17126134,17126274,HepG2|chr6:143771041-143771072,chr6,143771041,143771072,0,126644907
HepG2|chr6:17397694-17397810,chr6,17397694,17397810,HepG2|chr6:31457909-31457971,chr6,31457909,31457971,0,14060215
HepG2|chr6:17489056-17489137,chr6,17489056,17489137,HepG2|chr6:31459015-31459084,chr6,31459015,31459084,0,13969959
HepG2|chr6:17883787-17883864,chr6,17883787,17883864,HepG2|chr6:30535035-30535108,chr6,30535035,30535108,0,12651248
HepG2|chr6:18972832-18972858,chr6,18972832,18972858,HepG2|chr6:30534242-30534299,chr6,30534242,30534299,0,11561410
HepG2|chr6:19233485-19233561,chr6,19233485,19233561,HepG2|chr6:111281677-111281787,chr6,111281677,111281787,0,92048192
HepG2|chr6:19244127-19244165,chr6,19244127,19244165,HepG2|chr6:116421654-116421766,chr6,116421654,116421766,0,97177527
HepG2|chr6:19463218-19463367,chr6,19463218,19463367,HepG2|chr6:150183600-150183688,chr6,150183600,150183688,0,130720382
HepG2|chr6:19587699-19587746,chr6,19587699,19587746,HepG2|chr6:116421654-116421742,chr6,116421654,116421742,0,96833955
HepG2|chr6:19680711-19680762,chr6,19680711,19680762,HepG2|chr6:31458067-31458107,chr6,31458067,31458107,0,11777356
HepG2|chr6:19796937-19797015,chr6,19796937,19797015,HepG2|chr6:1309638-1309693,chr6,1309638,1309693,0,18487299
HepG2|chr6:20560335-20560408,chr6,20560335,20560408,HepG2|chr6:35227066-35227094,chr6,35227066,35227094,0,14666731
HepG2|chr6:20902248-20902274,chr6,20902248,20902274,HepG2|chr6:31458200-31458324,chr6,31458200,31458324,0,10555952
HepG2|chr6:20916362-20916472,chr6,20916362,20916472,HepG2|chr6:31457886-31457919,chr6,31457886,31457919,0,10541524
HepG2|chr6:21308777-21308812,chr6,21308777,21308812,HepG2|chr6:116420311-116420461,chr6,116420311,116420461,0,95111534
HepG2|chr6:21450906-21450999,chr6,21450906,21450999,HepG2|chr6:27445100-27445136,chr6,27445100,27445136,0,5994194
HepG2|chr6:21526007-21526075,chr6,21526007,21526075,HepG2|chr6:150183599-150183688,chr6,150183599,150183688,0,128657592
HepG2|chr6:21579056-21579203,chr6,21579056,21579203,HepG2|chr6:31459041-31459077,chr6,31459041,31459077,0,9879985
HepG2|chr6:21929909-21929987,chr6,21929909,21929987,HepG2|chr6:1309638-1309693,chr6,1309638,1309693,0,20620271
HepG2|chr6:22248616-22248683,chr6,22248616,22248683,HepG2|chr6:31372552-31372638,chr6,31372552,31372638,0,9123936
HepG2|chr6:23776244-23776303,chr6,23776244,23776303,HepG2|chr6:31459019-31459077,chr6,31459019,31459077,0,7682775
HepG2|chr6:24222690-24222708,chr6,24222690,24222708,HepG2|chr6:116691843-116691972,chr6,116691843,116691972,0,92469153
HepG2|chr6:24242001-24242050,chr6,24242001,24242050,HepG2|chr6:35226846-35226916,chr6,35226846,35226916,0,10984845
HepG2|chr6:24388362-24388383,chr6,24388362,24388383,HepG2|chr6:90351617-90351748,chr6,90351617,90351748,0,65963255
HepG2|chr6:25346764-25346894,chr6,25346764,25346894,HepG2|chr6:31794979-31794999,chr6,31794979,31794999,0,6448215
HepG2|chr6:25438042-25438129,chr6,25438042,25438129,HepG2|chr6:31459014-31459077,chr6,31459014,31459077,0,6020972
HepG2|chr6:25791123-25791171,chr6,25791123,25791171,HepG2|chr6:35227066-35227168,chr6,35227066,35227168,0,9435943
HepG2|chr6:26468448-26468476,chr6,26468448,26468476,HepG2|chr6:26252333-26252483,chr6,26252333,26252483,0,216115
HepG2|chr6:26633853-26633970,chr6,26633853,26633970,HepG2|chr6:5262512-5262545,chr6,5262512,5262545,0,21371341
HepG2|chr6:26743325-26743425,chr6,26743325,26743425,HepG2|chr6:31459034-31459084,chr6,31459034,31459084,0,4715709
HepG2|chr6:26821410-26821501,chr6,26821410,26821501,HepG2|chr6:31459025-31459084,chr6,31459025,31459084,0,4637615
HepG2|chr6:27111295-27111388,chr6,27111295,27111388,HepG2|chr6:27445100-27445136,chr6,27445100,27445136,0,333805
HepG2|chr6:27207369-27207488,chr6,27207369,27207488,HepG2|chr6:34723444-34723472,chr6,34723444,34723472,0,7516075
HepG2|chr6:27428032-27428164,chr6,27428032,27428164,HepG2|chr6:111303094-111303147,chr6,111303094,111303147,0,83875062
HepG2|chr6:27886350-27886431,chr6,27886350,27886431,HepG2|chr6:111299049-111299118,chr6,111299049,111299118,0,83412699
HepG2|chr6:27956971-27957121,chr6,27956971,27957121,HepG2|chr6:52285006-52285026,chr6,52285006,52285026,0,24328035
HepG2|chr6:28165391-28165412,chr6,28165391,28165412,HepG2|chr6:90351617-90351748,chr6,90351617,90351748,0,62186226
HepG2|chr6:28562041-28562093,chr6,28562041,28562093,HepG2|chr6:31457909-31457986,chr6,31457909,31457986,0,2895868
HepG2|chr6:28632005-28632142,chr6,28632005,28632142,HepG2|chr6:3118022-3118077,chr6,3118022,3118077,0,25513983
HepG2|chr6:28990728-28990775,chr6,28990728,28990775,HepG2|chr6:31794979-31795082,chr6,31794979,31795082,0,2804251
HepG2|chr6:29005288-29005358,chr6,29005288,29005358,HepG2|chr6:42719335-42719415,chr6,42719335,42719415,0,13714047
HepG2|chr6:29013213-29013278,chr6,29013213,29013278,HepG2|chr6:1308817-1308941,chr6,1308817,1308941,0,27704396
HepG2|chr6:29678869-29678907,chr6,29678869,29678907,HepG2|chr6:35226869-35227016,chr6,35226869,35227016,0,5548000
HepG2|chr6:29933599-29933666,chr6,29933599,29933666,HepG2|chr6:116421688-116421838,chr6,116421688,116421838,0,86488089
HepG2|chr6:30515376-30515523,chr6,30515376,30515523,HepG2|chr6:30534156-30534306,chr6,30534156,30534306,0,18780
HepG2|chr6:30588754-30588784,chr6,30588754,30588784,HepG2|chr6:31794979-31795093,chr6,31794979,31795093,0,1206225
HepG2|chr6:30732517-30732627,chr6,30732517,30732627,HepG2|chr6:43736676-43736716,chr6,43736676,43736716,0,13004159
HepG2|chr6:30905846-30905996,chr6,30905846,30905996,HepG2|chr6:26159066-26159195,chr6,26159066,26159195,0,4746780
HepG2|chr6:31121120-31121234,chr6,31121120,31121234,HepG2|chr6:26252298-26252371,chr6,26252298,26252371,0,4868822
HepG2|chr6:31556728-31556872,chr6,31556728,31556872,HepG2|chr6:30534152-30534214,chr6,30534152,30534214,0,1022576
HepG2|chr6:31646017-31646062,chr6,31646017,31646062,HepG2|chr6:5004936-5005041,chr6,5004936,5005041,0,26641081
HepG2|chr6:31689543-31689582,chr6,31689543,31689582,HepG2|chr6:111281673-111281787,chr6,111281673,111281787,0,79592130
HepG2|chr6:32174440-32174510,chr6,32174440,32174510,HepG2|chr6:10530537-10530619,chr6,10530537,10530619,0,21643903
HepG2|chr6:33211217-33211311,chr6,33211217,33211311,HepG2|chr6:31794979-31795093,chr6,31794979,31795093,0,1416238
HepG2|chr6:33285052-33285081,chr6,33285052,33285081,HepG2|chr6:31794979-31795093,chr6,31794979,31795093,0,1490073
HepG2|chr6:33383491-33383571,chr6,33383491,33383571,HepG2|chr6:35227066-35227168,chr6,35227066,35227168,0,1843575
HepG2|chr6:34011453-34011487,chr6,34011453,34011487,HepG2|chr6:3118022-3118138,chr6,3118022,3118138,0,30893431
HepG2|chr6:34943906-34943979,chr6,34943906,34943979,HepG2|chr6:34723885-34723939,chr6,34723885,34723939,0,220021
HepG2|chr6:35682897-35682992,chr6,35682897,35682992,HepG2|chr6:31459032-31459084,chr6,31459032,31459084,0,4223865
HepG2|chr6:35921084-35921169,chr6,35921084,35921169,HepG2|chr6:30538448-30538512,chr6,30538448,30538512,0,5382636
HepG2|chr6:36364752-36364809,chr6,36364752,36364809,HepG2|chr6:44233631-44233653,chr6,44233631,44233653,0,7868879
HepG2|chr6:36654682-36654832,chr6,36654682,36654832,HepG2|chr6:80250689-80250795,chr6,80250689,80250795,0,43596007
HepG2|chr6:37058712-37058807,chr6,37058712,37058807,HepG2|chr6:3118022-3118044,chr6,3118022,3118044,0,33940690
HepG2|chr6:37059129-37059189,chr6,37059129,37059189,HepG2|chr6:1309381-1309527,chr6,1309381,1309527,0,35749748
HepG2|chr6:37314740-37314797,chr6,37314740,37314797,HepG2|chr6:31794979-31795072,chr6,31794979,31795072,0,5519761
HepG2|chr6:37530291-37530368,chr6,37530291,37530368,HepG2|chr6:2841501-2841574,chr6,2841501,2841574,0,34688790
HepG2|chr6:37612118-37612156,chr6,37612118,37612156,HepG2|chr6:3118022-3118134,chr6,3118022,3118134,0,34494096
HepG2|chr6:37632265-37632371,chr6,37632265,37632371,HepG2|chr6:52285006-52285047,chr6,52285006,52285047,0,14652741
HepG2|chr6:37720135-37720221,chr6,37720135,37720221,HepG2|chr6:31459023-31459084,chr6,31459023,31459084,0,6261112
HepG2|chr6:37872803-37872827,chr6,37872803,37872827,HepG2|chr6:31794979-31795101,chr6,31794979,31795101,0,6077824
HepG2|chr6:38102182-38102223,chr6,38102182,38102223,HepG2|chr6:31794979-31795093,chr6,31794979,31795093,0,6307203
HepG2|chr6:38153029-38153143,chr6,38153029,38153143,HepG2|chr6:31459041-31459077,chr6,31459041,31459077,0,6693988
HepG2|chr6:38538765-38538819,chr6,38538765,38538819,HepG2|chr6:35227066-35227133,chr6,35227066,35227133,0,3311699
HepG2|chr6:38760270-38760366,chr6,38760270,38760366,HepG2|chr6:31459030-31459084,chr6,31459030,31459084,0,7301240
HepG2|chr6:38992243-38992300,chr6,38992243,38992300,HepG2|chr6:5004060-5004148,chr6,5004060,5004148,0,33988183
HepG2|chr6:39207513-39207628,chr6,39207513,39207628,HepG2|chr6:52284647-52284679,chr6,52284647,52284679,0,13077134
HepG2|chr6:39432726-39432776,chr6,39432726,39432776,HepG2|chr6:35226846-35226916,chr6,35226846,35226916,0,4205880
HepG2|chr6:40263043-40263103,chr6,40263043,40263103,HepG2|chr6:34723885-34723948,chr6,34723885,34723948,0,5539158
HepG2|chr6:40395110-40395177,chr6,40395110,40395177,HepG2|chr6:26285998-26286070,chr6,26285998,26286070,0,14109112
HepG2|chr6:40414651-40414735,chr6,40414651,40414735,HepG2|chr6:116421654-116421720,chr6,116421654,116421720,0,76007003
HepG2|chr6:40470762-40470809,chr6,40470762,40470809,HepG2|chr6:1308817-1308883,chr6,1308817,1308883,0,39161945
HepG2|chr6:40884506-40884556,chr6,40884506,40884556,HepG2|chr6:31461699-31461843,chr6,31461699,31461843,0,9422807
HepG2|chr6:41187210-41187265,chr6,41187210,41187265,HepG2|chr6:35227066-35227128,chr6,35227066,35227128,0,5960144
HepG2|chr6:41208247-41208295,chr6,41208247,41208295,HepG2|chr6:26286201-26286281,chr6,26286201,26286281,0,14922046
HepG2|chr6:41388904-41389051,chr6,41388904,41389051,HepG2|chr6:30534235-30534272,chr6,30534235,30534272,0,10854669
HepG2|chr6:41666337-41666367,chr6,41666337,41666367,HepG2|chr6:31794979-31795093,chr6,31794979,31795093,0,9871358
HepG2|chr6:41933277-41933372,chr6,41933277,41933372,HepG2|chr6:31795050-31795200,chr6,31795050,31795200,0,10138227
HepG2|chr6:42005951-42006003,chr6,42005951,42006003,HepG2|chr6:44094503-44094653,chr6,44094503,44094653,0,2088552
HepG2|chr6:42153432-42153555,chr6,42153432,42153555,HepG2|chr6:111300674-111300703,chr6,111300674,111300703,0,69147242
HepG2|chr6:42487251-42487362,chr6,42487251,42487362,HepG2|chr6:80251765-80251789,chr6,80251765,80251789,0,37764514
HepG2|chr6:42531194-42531285,chr6,42531194,42531285,HepG2|chr6:27442962-27443021,chr6,27442962,27443021,0,15088232
HepG2|chr6:42554608-42554658,chr6,42554608,42554658,HepG2|chr6:31372533-31372674,chr6,31372533,31372674,0,11182075
HepG2|chr6:42653340-42653490,chr6,42653340,42653490,HepG2|chr6:52285006-52285026,chr6,52285006,52285026,0,9631666
HepG2|chr6:43086903-43086957,chr6,43086903,43086957,HepG2|chr6:3003690-3003833,chr6,3003690,3003833,0,40083213
HepG2|chr6:43388289-43388437,chr6,43388289,43388437,HepG2|chr6:36093661-36093717,chr6,36093661,36093717,0,7294628
HepG2|chr6:43419677-43419713,chr6,43419677,43419713,HepG2|chr6:13815491-13815585,chr6,13815491,13815585,0,29604186
HepG2|chr6:43647731-43647776,chr6,43647731,43647776,HepG2|chr6:1308817-1308870,chr6,1308817,1308870,0,42338914
HepG2|chr6:43904070-43904185,chr6,43904070,43904185,HepG2|chr6:52284647-52284679,chr6,52284647,52284679,0,8380577
HepG2|chr6:44679025-44679052,chr6,44679025,44679052,HepG2|chr6:38672372-38672391,chr6,38672372,38672391,0,6006653
HepG2|chr6:45025457-45025580,chr6,45025457,45025580,HepG2|chr6:7722668-7722711,chr6,7722668,7722711,0,37302789
HepG2|chr6:45098676-45098726,chr6,45098676,45098726,HepG2|chr6:1309191-1309274,chr6,1309191,1309274,0,43789485
HepG2|chr6:45105934-45106066,chr6,45105934,45106066,HepG2|chr6:111303094-111303147,chr6,111303094,111303147,0,66197160
HepG2|chr6:45669373-45669489,chr6,45669373,45669489,HepG2|chr6:143771041-143771072,chr6,143771041,143771072,0,98101668
HepG2|chr6:46051097-46051136,chr6,46051097,46051136,HepG2|chr6:31459044-31459084,chr6,31459044,31459084,0,14592053
HepG2|chr6:46307944-46307981,chr6,46307944,46307981,HepG2|chr6:5262399-5262512,chr6,5262399,5262512,0,41045545
HepG2|chr6:46326068-46326187,chr6,46326068,46326187,HepG2|chr6:34723444-34723472,chr6,34723444,34723472,0,11602624
HepG2|chr6:46385287-46385350,chr6,46385287,46385350,HepG2|chr6:5004936-5005041,chr6,5004936,5005041,0,41380351
HepG2|chr6:46968718-46968759,chr6,46968718,46968759,HepG2|chr6:80250689-80250795,chr6,80250689,80250795,0,33281971
HepG2|chr6:47036574-47036723,chr6,47036574,47036723,HepG2|chr6:31459019-31459077,chr6,31459019,31459077,0,15577555
HepG2|chr6:47364991-47365080,chr6,47364991,47365080,HepG2|chr6:31459023-31459084,chr6,31459023,31459084,0,15905968
HepG2|chr6:47518740-47518828,chr6,47518740,47518828,HepG2|chr6:31457909-31457960,chr6,31457909,31457960,0,16060831
HepG2|chr6:47966738-47966759,chr6,47966738,47966759,HepG2|chr6:1307690-1307816,chr6,1307690,1307816,0,46659048
HepG2|chr6:48635241-48635335,chr6,48635241,48635335,HepG2|chr6:111303094-111303147,chr6,111303094,111303147,0,62667853
HepG2|chr6:48662918-48662956,chr6,48662918,48662956,HepG2|chr6:3118022-3118134,chr6,3118022,3118134,0,45544896
HepG2|chr6:48756008-48756158,chr6,48756008,48756158,HepG2|chr6:150183599-150183688,chr6,150183599,150183688,0,101427591
HepG2|chr6:48865784-48865849,chr6,48865784,48865849,HepG2|chr6:44093104-44093144,chr6,44093104,44093144,0,4772680
HepG2|chr6:48953798-48953815,chr6,48953798,48953815,HepG2|chr6:30535035-30535108,chr6,30535035,30535108,0,18418763
HepG2|chr6:49160373-49160523,chr6,49160373,49160523,HepG2|chr6:31459019-31459077,chr6,31459019,31459077,0,17701354
HepG2|chr6:49288875-49288956,chr6,49288875,49288956,HepG2|chr6:2841501-2841574,chr6,2841501,2841574,0,46447374
HepG2|chr6:49718779-49718924,chr6,49718779,49718924,HepG2|chr6:31459024-31459077,chr6,31459024,31459077,0,18259755
HepG2|chr6:49760122-49760217,chr6,49760122,49760217,HepG2|chr6:80248491-80248560,chr6,80248491,80248560,0,30488369
HepG2|chr6:50049020-50049130,chr6,50049020,50049130,HepG2|chr6:31459019-31459077,chr6,31459019,31459077,0,18590001
HepG2|chr6:50110358-50110439,chr6,50110358,50110439,HepG2|chr6:80248491-80248560,chr6,80248491,80248560,0,30138133
HepG2|chr6:50274734-50274797,chr6,50274734,50274797,HepG2|chr6:35226880-35227030,chr6,35226880,35227030,0,15047854
HepG2|chr6:50377619-50377701,chr6,50377619,50377701,HepG2|chr6:26286088-26286152,chr6,26286088,26286152,0,24091531
HepG2|chr6:50467008-50467104,chr6,50467008,50467104,HepG2|chr6:35226846-35226902,chr6,35226846,35226902,0,15240162
HepG2|chr6:50851171-50851260,chr6,50851171,50851260,HepG2|chr6:111299049-111299118,chr6,111299049,111299118,0,60447878
HepG2|chr6:50862133-50862200,chr6,50862133,50862200,HepG2|chr6:35226854-35227004,chr6,35226854,35227004,0,15635279
HepG2|chr6:50864358-50864508,chr6,50864358,50864508,HepG2|chr6:31794979-31795082,chr6,31794979,31795082,0,19069379
HepG2|chr6:51191710-51191763,chr6,51191710,51191763,HepG2|chr6:3003461-3003610,chr6,3003461,3003610,0,48188249
HepG2|chr6:51211687-51211837,chr6,51211687,51211837,HepG2|chr6:27445089-27445129,chr6,27445089,27445129,0,23766598
HepG2|chr6:52572782-52572881,chr6,52572782,52572881,HepG2|chr6:31459026-31459077,chr6,31459026,31459077,0,21113756
HepG2|chr6:52596668-52596776,chr6,52596668,52596776,HepG2|chr6:35226846-35226921,chr6,35226846,35226921,0,17369822
HepG2|chr6:52609675-52609784,chr6,52609675,52609784,HepG2|chr6:26286238-26286281,chr6,26286238,26286281,0,26323437
HepG2|chr6:52627418-52627495,chr6,52627418,52627495,HepG2|chr6:111281690-111281787,chr6,111281690,111281787,0,58654272
HepG2|chr6:52697115-52697187,chr6,52697115,52697187,HepG2|chr6:80250900-80250975,chr6,80250900,80250975,0,27553785
HepG2|chr6:53282710-53282746,chr6,53282710,53282746,HepG2|chr6:31459012-31459084,chr6,31459012,31459084,0,21823698
HepG2|chr6:53623430-53623560,chr6,53623430,53623560,HepG2|chr6:31794979-31794999,chr6,31794979,31794999,0,21828451
HepG2|chr6:53991017-53991121,chr6,53991017,53991121,HepG2|chr6:111300688-111300808,chr6,111300688,111300808,0,57309671
HepG2|chr6:54282696-54282790,chr6,54282696,54282790,HepG2|chr6:36093661-36093717,chr6,36093661,36093717,0,18189035
HepG2|chr6:54308082-54308160,chr6,54308082,54308160,HepG2|chr6:31459019-31459077,chr6,31459019,31459077,0,22849063
HepG2|chr6:54516903-54516983,chr6,54516903,54516983,HepG2|chr6:35227066-35227168,chr6,35227066,35227168,0,19289837
HepG2|chr6:54814754-54814842,chr6,54814754,54814842,HepG2|chr6:31457909-31457960,chr6,31457909,31457960,0,23356845
HepG2|chr6:55199432-55199502,chr6,55199432,55199502,HepG2|chr6:26285998-26286070,chr6,26285998,26286070,0,28913434
HepG2|chr6:55303882-55303929,chr6,55303882,55303929,HepG2|chr6:116421654-116421742,chr6,116421654,116421742,0,61117772
HepG2|chr6:55433936-55434078,chr6,55433936,55434078,HepG2|chr6:31458200-31458324,chr6,31458200,31458324,0,23975736
HepG2|chr6:55456400-55456491,chr6,55456400,55456491,HepG2|chr6:89673796-89673849,chr6,89673796,89673849,0,34217396
HepG2|chr6:55528735-55528806,chr6,55528735,55528806,HepG2|chr6:116421654-116421719,chr6,116421654,116421719,0,60892919
HepG2|chr6:55772460-55772582,chr6,55772460,55772582,HepG2|chr6:42716563-42716709,chr6,42716563,42716709,0,13055897
HepG2|chr6:55880523-55880611,chr6,55880523,55880611,HepG2|chr6:31794979-31795050,chr6,31794979,31795050,0,24085544
HepG2|chr6:55900543-55900583,chr6,55900543,55900583,HepG2|chr6:31457909-31458013,chr6,31457909,31458013,0,24442634
HepG2|chr6:56158393-56158457,chr6,56158393,56158457,HepG2|chr6:3118022-3118105,chr6,3118022,3118105,0,53040371
HepG2|chr6:56372823-56372973,chr6,56372823,56372973,HepG2|chr6:31794979-31795085,chr6,31794979,31795085,0,24577844
HepG2|chr6:56676105-56676137,chr6,56676105,56676137,HepG2|chr6:31795089-31795238,chr6,31795089,31795238,0,24881016
HepG2|chr6:56711331-56711398,chr6,56711331,56711398,HepG2|chr6:34723885-34723967,chr6,34723885,34723967,0,21987446
HepG2|chr6:57848944-57849067,chr6,57848944,57849067,HepG2|chr6:2841446-2841574,chr6,2841446,2841574,0,55007498
HepG2|chr6:58642888-58642965,chr6,58642888,58642965,HepG2|chr6:26252298-26252371,chr6,26252298,26252371,0,32390590
HepG2|chr6:59515662-59515718,chr6,59515662,59515718,HepG2|chr6:5004060-5004148,chr6,5004060,5004148,0,54511602
HepG2|chr6:59625242-59625342,chr6,59625242,59625342,HepG2|chr6:111300204-111300289,chr6,111300204,111300289,0,51674962
HepG2|chr6:59907553-59907626,chr6,59907553,59907626,HepG2|chr6:1308817-1308853,chr6,1308817,1308853,0,58598736
HepG2|chr6:60126684-60126723,chr6,60126684,60126723,HepG2|chr6:31459044-31459084,chr6,31459044,31459084,0,28667640
HepG2|chr6:60753115-60753206,chr6,60753115,60753206,HepG2|chr6:89673796-89673849,chr6,89673796,89673849,0,28920681
HepG2|chr6:60929044-60929095,chr6,60929044,60929095,HepG2|chr6:31794979-31795078,chr6,31794979,31795078,0,29134065
HepG2|chr6:61429446-61429520,chr6,61429446,61429520,HepG2|chr6:34723885-34723955,chr6,34723885,34723955,0,26705561
HepG2|chr6:62203198-62203272,chr6,62203198,62203272,HepG2|chr6:26252295-26252371,chr6,26252295,26252371,0,35950903
HepG2|chr6:62269826-62269874,chr6,62269826,62269874,HepG2|chr6:35227066-35227168,chr6,35227066,35227168,0,27042760
HepG2|chr6:62399189-62399254,chr6,62399189,62399254,HepG2|chr6:31458988-31459084,chr6,31458988,31459084,0,30940201
HepG2|chr6:62798057-62798145,chr6,62798057,62798145,HepG2|chr6:116421654-116421720,chr6,116421654,116421720,0,53623597
HepG2|chr6:63064841-63064926,chr6,63064841,63064926,HepG2|chr6:31459012-31459077,chr6,31459012,31459077,0,31605829
HepG2|chr6:63088763-63088837,chr6,63088763,63088837,HepG2|chr6:34723885-34723955,chr6,34723885,34723955,0,28364878
HepG2|chr6:63275293-63275372,chr6,63275293,63275372,HepG2|chr6:31794979-31795050,chr6,31794979,31795050,0,31480314
HepG2|chr6:63291941-63292088,chr6,63291941,63292088,HepG2|chr6:30534156-30534306,chr6,30534156,30534306,0,32757785
HepG2|chr6:63319410-63319483,chr6,63319410,63319483,HepG2|chr6:34723885-34723939,chr6,34723885,34723939,0,28595525
HepG2|chr6:63429619-63429679,chr6,63429619,63429679,HepG2|chr6:31794979-31795076,chr6,31794979,31795076,0,31634640
HepG2|chr6:63583927-63583982,chr6,63583927,63583982,HepG2|chr6:30536264-30536336,chr6,30536264,30536336,0,33047663
HepG2|chr6:63585995-63586054,chr6,63585995,63586054,HepG2|chr6:1308817-1308853,chr6,1308817,1308853,0,62277178
HepG2|chr6:64359045-64359140,chr6,64359045,64359140,HepG2|chr6:80248491-80248560,chr6,80248491,80248560,0,15889446
HepG2|chr6:64419737-64419827,chr6,64419737,64419827,HepG2|chr6:89673810-89673849,chr6,89673810,89673849,0,25254073
HepG2|chr6:64437141-64437202,chr6,64437141,64437202,HepG2|chr6:150183599-150183688,chr6,150183599,150183688,0,85746458
HepG2|chr6:64878469-64878550,chr6,64878469,64878550,HepG2|chr6:111299049-111299118,chr6,111299049,111299118,0,46420580
HepG2|chr6:65189034-65189077,chr6,65189034,65189077,HepG2|chr6:80249508-80249567,chr6,80249508,80249567,0,15060474
HepG2|chr6:65542220-65542355,chr6,65542220,65542355,HepG2|chr6:31794979-31795072,chr6,31794979,31795072,0,33747241
HepG2|chr6:65869385-65869425,chr6,65869385,65869425,HepG2|chr6:34724875-34724928,chr6,34724875,34724928,0,31144510
HepG2|chr6:66112024-66112156,chr6,66112024,66112156,HepG2|chr6:31794979-31795098,chr6,31794979,31795098,0,34317045
HepG2|chr6:66155551-66155701,chr6,66155551,66155701,HepG2|chr6:31794979-31795085,chr6,31794979,31795085,0,34360572
HepG2|chr6:66235600-66235690,chr6,66235600,66235690,HepG2|chr6:89673810-89673849,chr6,89673810,89673849,0,23438210
HepG2|chr6:66291210-66291360,chr6,66291210,66291360,HepG2|chr6:26159066-26159195,chr6,26159066,26159195,0,40132144
HepG2|chr6:66495737-66495770,chr6,66495737,66495770,HepG2|chr6:52285006-52285123,chr6,52285006,52285123,0,14210731
HepG2|chr6:66534944-66535035,chr6,66534944,66535035,HepG2|chr6:27442962-27443021,chr6,27442962,27443021,0,39091982
HepG2|chr6:66555173-66555273,chr6,66555173,66555273,HepG2|chr6:111300204-111300289,chr6,111300204,111300289,0,44745031
HepG2|chr6:66756507-66756593,chr6,66756507,66756593,HepG2|chr6:43734687-43734739,chr6,43734687,43734739,0,23021820
HepG2|chr6:67066624-67066728,chr6,67066624,67066728,HepG2|chr6:35227066-35227094,chr6,35227066,35227094,0,31839558
HepG2|chr6:67828014-67828059,chr6,67828014,67828059,HepG2|chr6:3118022-3118138,chr6,3118022,3118138,0,64709992
HepG2|chr6:67905801-67905894,chr6,67905801,67905894,HepG2|chr6:27445100-27445136,chr6,27445100,27445136,0,40460701
HepG2|chr6:68026032-68026128,chr6,68026032,68026128,HepG2|chr6:31794979-31795069,chr6,31794979,31795069,0,36231053
HepG2|chr6:68206744-68206791,chr6,68206744,68206791,HepG2|chr6:3118078-3118222,chr6,3118078,3118222,0,65088666
HepG2|chr6:68885127-68885198,chr6,68885127,68885198,HepG2|chr6:116421654-116421719,chr6,116421654,116421719,0,47536527
HepG2|chr6:69045024-69045087,chr6,69045024,69045087,HepG2|chr6:2840570-2840630,chr6,2840570,2840630,0,66204454
HepG2|chr6:69531658-69531754,chr6,69531658,69531754,HepG2|chr6:3118022-3118054,chr6,3118022,3118054,0,66413636
HepG2|chr6:69546354-69546504,chr6,69546354,69546504,HepG2|chr6:52281185-52281206,chr6,52281185,52281206,0,17265169
HepG2|chr6:69840837-69840930,chr6,69840837,69840930,HepG2|chr6:27445100-27445136,chr6,27445100,27445136,0,42395737
HepG2|chr6:69998001-69998151,chr6,69998001,69998151,HepG2|chr6:30534228-30534272,chr6,30534228,30534272,0,39463773
HepG2|chr6:70045540-70045593,chr6,70045540,70045593,HepG2|chr6:3003461-3003610,chr6,3003461,3003610,0,67042079
HepG2|chr6:70122508-70122544,chr6,70122508,70122544,HepG2|chr6:13815491-13815585,chr6,13815491,13815585,0,56307017
HepG2|chr6:70184509-70184544,chr6,70184509,70184544,HepG2|chr6:116420311-116420461,chr6,116420311,116420461,0,46235802
HepG2|chr6:70479159-70479211,chr6,70479159,70479211,HepG2|chr6:5004038-5004188,chr6,5004038,5004188,0,65475121
HepG2|chr6:70574353-70574374,chr6,70574353,70574374,HepG2|chr6:1307690-1307816,chr6,1307690,1307816,0,69266663
HepG2|chr6:70678425-70678535,chr6,70678425,70678535,HepG2|chr6:31457886-31457919,chr6,31457886,31457919,0,39220539
HepG2|chr6:70711790-70711918,chr6,70711790,70711918,HepG2|chr6:31794979-31795081,chr6,31794979,31795081,0,38916811
HepG2|chr6:70861161-70861230,chr6,70861161,70861230,HepG2|chr6:42719335-42719415,chr6,42719335,42719415,0,28141826
HepG2|chr6:71468157-71468231,chr6,71468157,71468231,HepG2|chr6:116421654-116421707,chr6,116421654,116421707,0,44953497
HepG2|chr6:71715244-71715360,chr6,71715244,71715360,HepG2|chr6:143771041-143771072,chr6,143771041,143771072,0,72055797
HepG2|chr6:71798581-71798602,chr6,71798581,71798602,HepG2|chr6:116421688-116421838,chr6,116421688,116421838,0,44623107
HepG2|chr6:71951502-71951556,chr6,71951502,71951556,HepG2|chr6:35227066-35227133,chr6,35227066,35227133,0,36724436
HepG2|chr6:72051701-72051822,chr6,72051701,72051822,HepG2|chr6:111300674-111300703,chr6,111300674,111300703,0,39248973
HepG2|chr6:72231050-72231136,chr6,72231050,72231136,HepG2|chr6:43734687-43734739,chr6,43734687,43734739,0,28496363
HepG2|chr6:72231433-72231476,chr6,72231433,72231476,HepG2|chr6:34723444-34723469,chr6,34723444,34723469,0,37507989
HepG2|chr6:72581975-72582043,chr6,72581975,72582043,HepG2|chr6:150183599-150183688,chr6,150183599,150183688,0,77601624
HepG2|chr6:72787544-72787638,chr6,72787544,72787638,HepG2|chr6:35226846-35226902,chr6,35226846,35226902,0,37560698
HepG2|chr6:73419239-73419260,chr6,73419239,73419260,HepG2|chr6:27443120-27443224,chr6,27443120,27443224,0,45976119
HepG2|chr6:74001303-74001396,chr6,74001303,74001396,HepG2|chr6:26286130-26286280,chr6,26286130,26286280,0,47715173
HepG2|chr6:74290168-74290270,chr6,74290168,74290270,HepG2|chr6:27442973-27443021,chr6,27442973,27443021,0,46847195
HepG2|chr6:74333259-74333326,chr6,74333259,74333326,HepG2|chr6:34723885-34723967,chr6,34723885,34723967,0,39609374
HepG2|chr6:74406564-74406678,chr6,74406564,74406678,HepG2|chr6:26252298-26252371,chr6,26252298,26252371,0,48154266
HepG2|chr6:74560477-74560625,chr6,74560477,74560625,HepG2|chr6:5004083-5004122,chr6,5004083,5004122,0,69556394
HepG2|chr6:74610483-74610619,chr6,74610483,74610619,HepG2|chr6:44093104-44093144,chr6,44093104,44093144,0,30517379
HepG2|chr6:75050392-75050472,chr6,75050392,75050472,HepG2|chr6:116418098-116418217,chr6,116418098,116418217,0,41367706
HepG2|chr6:75339857-75339906,chr6,75339857,75339906,HepG2|chr6:35226846-35226916,chr6,35226846,35226916,0,40113011
HepG2|chr6:75737088-75737195,chr6,75737088,75737195,HepG2|chr6:52281735-52281776,chr6,52281735,52281776,0,23455353
HepG2|chr6:75832203-75832247,chr6,75832203,75832247,HepG2|chr6:31794979-31795085,chr6,31794979,31795085,0,44037224
HepG2|chr6:75893121-75893249,chr6,75893121,75893249,HepG2|chr6:31794979-31795081,chr6,31794979,31795081,0,44098142
HepG2|chr6:75906313-75906394,chr6,75906313,75906394,HepG2|chr6:80248491-80248560,chr6,80248491,80248560,0,4342178
HepG2|chr6:76228451-76228601,chr6,76228451,76228601,HepG2|chr6:150183599-150183688,chr6,150183599,150183688,0,73955148
HepG2|chr6:76291318-76291410,chr6,76291318,76291410,HepG2|chr6:80251573-80251712,chr6,80251573,80251712,0,3960255
HepG2|chr6:76588489-76588584,chr6,76588489,76588584,HepG2|chr6:1309638-1309672,chr6,1309638,1309672,0,75278851
HepG2|chr6:77087760-77087791,chr6,77087760,77087791,HepG2|chr6:38672372-38672391,chr6,38672372,38672391,0,38415388
HepG2|chr6:77096853-77096921,chr6,77096853,77096921,HepG2|chr6:116416942-116417092,chr6,116416942,116417092,0,39320089
HepG2|chr6:77151836-77151879,chr6,77151836,77151879,HepG2|chr6:10531791-10531918,chr6,10531791,10531918,0,66620045
HepG2|chr6:77263244-77263328,chr6,77263244,77263328,HepG2|chr6:116421654-116421720,chr6,116421654,116421720,0,39158410
HepG2|chr6:77388013-77388031,chr6,77388013,77388031,HepG2|chr6:116691843-116691972,chr6,116691843,116691972,0,39303830
HepG2|chr6:77616174-77616260,chr6,77616174,77616260,HepG2|chr6:31795019-31795169,chr6,31795019,31795169,0,45821155
HepG2|chr6:77845541-77845688,chr6,77845541,77845688,HepG2|chr6:27442962-27443021,chr6,27442962,27443021,0,50402579
HepG2|chr6:78274664-78274723,chr6,78274664,78274723,HepG2|chr6:1308817-1308853,chr6,1308817,1308853,0,76965847
HepG2|chr6:78381662-78381727,chr6,78381662,78381727,HepG2|chr6:111300204-111300289,chr6,111300204,111300289,0,32918542
HepG2|chr6:78811650-78811741,chr6,78811650,78811741,HepG2|chr6:31459018-31459077,chr6,31459018,31459077,0,47352632
HepG2|chr6:78885577-78885647,chr6,78885577,78885647,HepG2|chr6:10530537-10530619,chr6,10530537,10530619,0,68355040
HepG2|chr6:79179767-79179827,chr6,79179767,79179827,HepG2|chr6:3118022-3118087,chr6,3118022,3118087,0,76061745
HepG2|chr6:79289367-79289476,chr6,79289367,79289476,HepG2|chr6:31459014-31459077,chr6,31459014,31459077,0,47830353
HepG2|chr6:79457736-79457818,chr6,79457736,79457818,HepG2|chr6:35226850-35226895,chr6,35226850,35226895,0,44230886
HepG2|chr6:79789607-79789754,chr6,79789607,79789754,HepG2|chr6:42719425-42719575,chr6,42719425,42719575,0,37070182
HepG2|chr6:79806080-79806230,chr6,79806080,79806230,HepG2|chr6:116692423-116692573,chr6,116692423,116692573,0,36886343
HepG2|chr6:80087432-80087530,chr6,80087432,80087530,HepG2|chr6:31459032-31459084,chr6,31459032,31459084,0,48628400
HepG2|chr6:80090973-80091021,chr6,80090973,80091021,HepG2|chr6:31459019-31459077,chr6,31459019,31459077,0,48631954
HepG2|chr6:80259876-80259944,chr6,80259876,80259944,HepG2|chr6:10530537-10530619,chr6,10530537,10530619,0,69729339
HepG2|chr6:80338951-80339048,chr6,80338951,80339048,HepG2|chr6:1389253-1389293,chr6,1389253,1389293,0,78949698
HepG2|chr6:80483915-80483991,chr6,80483915,80483991,HepG2|chr6:111281677-111281787,chr6,111281677,111281787,0,30797762
HepG2|chr6:80764349-80764408,chr6,80764349,80764408,HepG2|chr6:31794979-31795111,chr6,31794979,31795111,0,48969370
HepG2|chr6:80792996-80793060,chr6,80792996,80793060,HepG2|chr6:1308817-1308875,chr6,1308817,1308875,0,79484179
HepG2|chr6:80830126-80830181,chr6,80830126,80830181,HepG2|chr6:31794979-31795074,chr6,31794979,31795074,0,49035147
HepG2|chr6:80913881-80913958,chr6,80913881,80913958,HepG2|chr6:1310457-1310530,chr6,1310457,1310530,0,79603424
HepG2|chr6:81070129-81070203,chr6,81070129,81070203,HepG2|chr6:26288608-26288665,chr6,26288608,26288665,0,54781521
HepG2|chr6:81423224-81423347,chr6,81423224,81423347,HepG2|chr6:7722668-7722711,chr6,7722668,7722711,0,73700556
HepG2|chr6:81433105-81433209,chr6,81433105,81433209,HepG2|chr6:3118022-3118111,chr6,3118022,3118111,0,78315083
HepG2|chr6:81450888-81450945,chr6,81450888,81450945,HepG2|chr6:35227066-35227143,chr6,35227066,35227143,0,46223822
HepG2|chr6:81872976-81873024,chr6,81872976,81873024,HepG2|chr6:31794979-31795081,chr6,31794979,31795081,0,50077997
HepG2|chr6:81957334-81957430,chr6,81957334,81957430,HepG2|chr6:31459030-31459084,chr6,31459030,31459084,0,50498304
HepG2|chr6:81970911-81970968,chr6,81970911,81970968,HepG2|chr6:35227066-35227143,chr6,35227066,35227143,0,46743845
HepG2|chr6:82097183-82097295,chr6,82097183,82097295,HepG2|chr6:31794979-31795017,chr6,31794979,31795017,0,50302204
HepG2|chr6:82215569-82215655,chr6,82215569,82215655,HepG2|chr6:3118022-3118083,chr6,3118022,3118083,0,79097547
HepG2|chr6:82310525-82310661,chr6,82310525,82310661,HepG2|chr6:44093104-44093144,chr6,44093104,44093144,0,38217421
HepG2|chr6:82432278-82432343,chr6,82432278,82432343,HepG2|chr6:31458988-31459084,chr6,31458988,31459084,0,50973290
HepG2|chr6:82742329-82742373,chr6,82742329,82742373,HepG2|chr6:31794979-31795085,chr6,31794979,31795085,0,50947350
HepG2|chr6:82779619-82779679,chr6,82779619,82779679,HepG2|chr6:31794979-31795076,chr6,31794979,31795076,0,50984640
HepG2|chr6:82869325-82869380,chr6,82869325,82869380,HepG2|chr6:35227066-35227128,chr6,35227066,35227128,0,47642259
HepG2|chr6:82886566-82886603,chr6,82886566,82886603,HepG2|chr6:5262399-5262512,chr6,5262399,5262512,0,77624167
HepG2|chr6:83029261-83029326,chr6,83029261,83029326,HepG2|chr6:44093104-44093144,chr6,44093104,44093144,0,38936157
HepG2|chr6:83413372-83413425,chr6,83413372,83413425,HepG2|chr6:111281690-111281787,chr6,111281690,111281787,0,27868318
HepG2|chr6:83529383-83529472,chr6,83529383,83529472,HepG2|chr6:31794979-31795093,chr6,31794979,31795093,0,51734404
HepG2|chr6:84177406-84177430,chr6,84177406,84177430,HepG2|chr6:30534147-30534269,chr6,30534147,30534269,0,53643259
HepG2|chr6:84196306-84196433,chr6,84196306,84196433,HepG2|chr6:52281032-52281106,chr6,52281032,52281106,0,31915274
HepG2|chr6:84313447-84313508,chr6,84313447,84313508,HepG2|chr6:111300357-111300384,chr6,111300357,111300384,0,26986910
HepG2|chr6:84643092-84643146,chr6,84643092,84643146,HepG2|chr6:30536264-30536336,chr6,30536264,30536336,0,54106828
HepG2|chr6:84662228-84662254,chr6,84662228,84662254,HepG2|chr6:30534242-30534299,chr6,30534242,30534299,0,54127986
HepG2|chr6:85211842-85211920,chr6,85211842,85211920,HepG2|chr6:116421689-116421839,chr6,116421689,116421839,0,31209847
HepG2|chr6:85238875-85238953,chr6,85238875,85238953,HepG2|chr6:31459019-31459077,chr6,31459019,31459077,0,53779856
HepG2|chr6:85334512-85334540,chr6,85334512,85334540,HepG2|chr6:111300357-111300384,chr6,111300357,111300384,0,25965845
HepG2|chr6:85360123-85360206,chr6,85360123,85360206,HepG2|chr6:1309191-1309259,chr6,1309191,1309259,0,84050932
HepG2|chr6:85489521-85489540,chr6,85489521,85489540,HepG2|chr6:35180405-35180546,chr6,35180405,35180546,0,50309116
HepG2|chr6:85680581-85680626,chr6,85680581,85680626,HepG2|chr6:5004936-5005041,chr6,5004936,5005041,0,80675645
HepG2|chr6:85704835-85704884,chr6,85704835,85704884,HepG2|chr6:43735801-43735899,chr6,43735801,43735899,0,41969034
HepG2|chr6:85761211-85761361,chr6,85761211,85761361,HepG2|chr6:30534240-30534346,chr6,30534240,30534346,0,55226971
HepG2|chr6:85950871-85950921,chr6,85950871,85950921,HepG2|chr6:31372533-31372674,chr6,31372533,31372674,0,54578338
HepG2|chr6:86262151-86262232,chr6,86262151,86262232,HepG2|chr6:2841501-2841574,chr6,2841501,2841574,0,83420650
HepG2|chr6:87163289-87163439,chr6,87163289,87163439,HepG2|chr6:31794979-31795082,chr6,31794979,31795082,0,55368310
HepG2|chr6:87561411-87561442,chr6,87561411,87561442,HepG2|chr6:35226846-35226927,chr6,35226846,35226927,0,52334565
HepG2|chr6:87758689-87758802,chr6,87758689,87758802,HepG2|chr6:80251765-80251789,chr6,80251765,80251789,0,7506924
HepG2|chr6:88044439-88044536,chr6,88044439,88044536,HepG2|chr6:1389253-1389293,chr6,1389253,1389293,0,86655186
HepG2|chr6:88171058-88171134,chr6,88171058,88171134,HepG2|chr6:52281032-52281106,chr6,52281032,52281106,0,35890026
HepG2|chr6:88178528-88178600,chr6,88178528,88178600,HepG2|chr6:35226847-35226997,chr6,35226847,35226997,0,52951681
HepG2|chr6:88782435-88782556,chr6,88782435,88782556,HepG2|chr6:111300674-111300703,chr6,111300674,111300703,0,22518239
HepG2|chr6:88993579-88993622,chr6,88993579,88993622,HepG2|chr6:31794972-31795112,chr6,31794972,31795112,0,57198607
HepG2|chr6:89057140-89057190,chr6,89057140,89057190,HepG2|chr6:31794979-31795093,chr6,31794979,31795093,0,57262161
HepG2|chr6:89064474-89064542,chr6,89064474,89064542,HepG2|chr6:1309638-1309685,chr6,1309638,1309685,0,87754836
HepG2|chr6:89081522-89081583,chr6,89081522,89081583,HepG2|chr6:3118022-3118111,chr6,3118022,3118111,0,85963500
HepG2|chr6:89299176-89299265,chr6,89299176,89299265,HepG2|chr6:80248469-80248560,chr6,80248469,80248560,0,9050707
HepG2|chr6:89536627-89536700,chr6,89536627,89536700,HepG2|chr6:35227066-35227094,chr6,35227066,35227094,0,54309561
HepG2|chr6:90077566-90077616,chr6,90077566,90077616,HepG2|chr6:35226846-35226916,chr6,35226846,35226916,0,54850720
HepG2|chr6:90099542-90099562,chr6,90099542,90099562,HepG2|chr6:30535497-30535570,chr6,30535497,30535570,0,59564045
HepG2|chr6:90365509-90365601,chr6,90365509,90365601,HepG2|chr6:31459019-31459077,chr6,31459019,31459077,0,58906490
HepG2|chr6:90737738-90737863,chr6,90737738,90737863,HepG2|chr6:52281185-52281206,chr6,52281185,52281206,0,38456553
HepG2|chr6:90862396-90862428,chr6,90862396,90862428,HepG2|chr6:13821457-13821575,chr6,13821457,13821575,0,77040939
HepG2|chr6:91004323-91004403,chr6,91004323,91004403,HepG2|chr6:28236895-28236935,chr6,28236895,28236935,0,62767428
HepG2|chr6:91114923-91115022,chr6,91114923,91115022,HepG2|chr6:26286239-26286281,chr6,26286239,26286281,0,64828684
HepG2|chr6:91417086-91417188,chr6,91417086,91417188,HepG2|chr6:31459012-31459077,chr6,31459012,31459077,0,59958074
HepG2|chr6:91483499-91483622,chr6,91483499,91483622,HepG2|chr6:31459026-31459077,chr6,31459026,31459077,0,60024473
HepG2|chr6:91577228-91577266,chr6,91577228,91577266,HepG2|chr6:31794979-31795100,chr6,31794979,31795100,0,59782249
HepG2|chr6:91714984-91715094,chr6,91714984,91715094,HepG2|chr6:43736676-43736716,chr6,43736676,43736716,0,47978308
HepG2|chr6:92348359-92348418,chr6,92348359,92348418,HepG2|chr6:31793927-31794077,chr6,31793927,31794077,0,60554432
HepG2|chr6:94194206-94194295,chr6,94194206,94194295,HepG2|chr6:31459023-31459084,chr6,31459023,31459084,0,62735183
HepG2|chr6:94457058-94457126,chr6,94457058,94457126,HepG2|chr6:116421654-116421736,chr6,116421654,116421736,0,21964596
HepG2|chr6:94702651-94702669,chr6,94702651,94702669,HepG2|chr6:31794979-31795111,chr6,31794979,31795111,0,62907672
HepG2|chr6:95151389-95151506,chr6,95151389,95151506,HepG2|chr6:3118022-3118054,chr6,3118022,3118054,0,92033367
HepG2|chr6:95546620-95546728,chr6,95546620,95546728,HepG2|chr6:35226846-35226921,chr6,35226846,35226921,0,60319774
HepG2|chr6:95841855-95841980,chr6,95841855,95841980,HepG2|chr6:52281185-52281206,chr6,52281185,52281206,0,43560670
HepG2|chr6:96113614-96113764,chr6,96113614,96113764,HepG2|chr6:30534244-30534277,chr6,30534244,30534277,0,65579370
HepG2|chr6:96580223-96580273,chr6,96580223,96580273,HepG2|chr6:31794979-31795093,chr6,31794979,31795093,0,64785244
HepG2|chr6:96639279-96639340,chr6,96639279,96639340,HepG2|chr6:150183599-150183688,chr6,150183599,150183688,0,53544320
HepG2|chr6:96752371-96752449,chr6,96752371,96752449,HepG2|chr6:116421689-116421839,chr6,116421689,116421839,0,19669318
HepG2|chr6:97493502-97493583,chr6,97493502,97493583,HepG2|chr6:31795055-31795205,chr6,31795055,31795205,0,65698447
HepG2|chr6:97499836-97499919,chr6,97499836,97499919,HepG2|chr6:31459017-31459084,chr6,31459017,31459084,0,66040819
HepG2|chr6:97754040-97754148,chr6,97754040,97754148,HepG2|chr6:31462099-31462141,chr6,31462099,31462141,0,66291941
HepG2|chr6:98246325-98246347,chr6,98246325,98246347,HepG2|chr6:30534147-30534269,chr6,30534147,30534269,0,67712178
HepG2|chr6:98519698-98519764,chr6,98519698,98519764,HepG2|chr6:80249791-80249935,chr6,80249791,80249935,0,18269907
HepG2|chr6:98838920-98838943,chr6,98838920,98838943,HepG2|chr6:27443120-27443224,chr6,27443120,27443224,0,71395800
HepG2|chr6:99483415-99483471,chr6,99483415,99483471,HepG2|chr6:5004060-5004148,chr6,5004060,5004148,0,94479355
HepG2|chr6:99515781-99515851,chr6,99515781,99515851,HepG2|chr6:42719335-42719415,chr6,42719335,42719415,0,56796446
HepG2|chr6:99690152-99690250,chr6,99690152,99690250,HepG2|chr6:31459032-31459084,chr6,31459032,31459084,0,68231120
HepG2|chr6:99735079-99735117,chr6,99735079,99735117,HepG2|chr6:35226869-35227016,chr6,35226869,35227016,0,64508210
HepG2|chr6:100444177-100444274,chr6,100444177,100444274,HepG2|chr6:31459024-31459077,chr6,31459024,31459077,0,68985153
HepG2|chr6:100862172-100862205,chr6,100862172,100862205,HepG2|chr6:35228178-35228295,chr6,35228178,35228295,0,65633994
HepG2|chr6:101435883-101435979,chr6,101435883,101435979,HepG2|chr6:31794979-31795069,chr6,31794979,31795069,0,69640904
HepG2|chr6:102106515-102106665,chr6,102106515,102106665,HepG2|chr6:1309638-1309685,chr6,1309638,1309685,0,100796877
HepG2|chr6:102265558-102265594,chr6,102265558,102265594,HepG2|chr6:31459012-31459084,chr6,31459012,31459084,0,70806546
HepG2|chr6:102697156-102697303,chr6,102697156,102697303,HepG2|chr6:31462099-31462141,chr6,31462099,31462141,0,71235057
HepG2|chr6:103245514-103245593,chr6,103245514,103245593,HepG2|chr6:31794979-31795050,chr6,31794979,31795050,0,71450535
HepG2|chr6:103452182-103452322,chr6,103452182,103452322,HepG2|chr6:31794979-31794999,chr6,31794979,31794999,0,71657203
HepG2|chr6:103538504-103538578,chr6,103538504,103538578,HepG2|chr6:26252295-26252371,chr6,26252295,26252371,0,77286209
HepG2|chr6:103862350-103862465,chr6,103862350,103862465,HepG2|chr6:26252295-26252371,chr6,26252295,26252371,0,77610055
HepG2|chr6:103894110-103894196,chr6,103894110,103894196,HepG2|chr6:3118022-3118083,chr6,3118022,3118083,0,100776088
HepG2|chr6:103964243-103964333,chr6,103964243,103964333,HepG2|chr6:116421654-116421797,chr6,116421654,116421797,0,12457411
HepG2|chr6:104453745-104453791,chr6,104453745,104453791,HepG2|chr6:31459026-31459077,chr6,31459026,31459077,0,72994719
HepG2|chr6:104636132-104636233,chr6,104636132,104636233,HepG2|chr6:31794979-31795082,chr6,31794979,31795082,0,72841153
HepG2|chr6:104861010-104861160,chr6,104861010,104861160,HepG2|chr6:30534244-30534277,chr6,30534244,30534277,0,74326766
HepG2|chr6:105160407-105160474,chr6,105160407,105160474,HepG2|chr6:1308817-1308853,chr6,1308817,1308853,0,103851590
HepG2|chr6:105267191-105267258,chr6,105267191,105267258,HepG2|chr6:31372552-31372638,chr6,31372552,31372638,0,73894639
HepG2|chr6:105298924-105299074,chr6,105298924,105299074,HepG2|chr6:1310457-1310530,chr6,1310457,1310530,0,103988467
HepG2|chr6:105612913-105612959,chr6,105612913,105612959,HepG2|chr6:31459026-31459077,chr6,31459026,31459077,0,74153887
HepG2|chr6:105645388-105645498,chr6,105645388,105645498,HepG2|chr6:27445089-27445129,chr6,27445089,27445129,0,78200299
HepG2|chr6:105659395-105659431,chr6,105659395,105659431,HepG2|chr6:31794972-31795119,chr6,31794972,31795119,0,73864423
HepG2|chr6:105795677-105795698,chr6,105795677,105795698,HepG2|chr6:26159066-26159195,chr6,26159066,26159195,0,79636611
HepG2|chr6:106768031-106768118,chr6,106768031,106768118,HepG2|chr6:116421654-116421696,chr6,116421654,116421696,0,9653623
HepG2|chr6:106770153-106770236,chr6,106770153,106770236,HepG2|chr6:35226868-35226923,chr6,35226868,35226923,0,71543285
HepG2|chr6:106982271-106982341,chr6,106982271,106982341,HepG2|chr6:13815505-13815585,chr6,13815505,13815585,0,93166766
HepG2|chr6:107233219-107233369,chr6,107233219,107233369,HepG2|chr6:7722668-7722710,chr6,7722668,7722710,0,99510551
HepG2|chr6:107411097-107411177,chr6,107411097,107411177,HepG2|chr6:116418098-116418217,chr6,116418098,116418217,0,9007001
HepG2|chr6:107448292-107448343,chr6,107448292,107448343,HepG2|chr6:31794979-31795078,chr6,31794979,31795078,0,75653313
HepG2|chr6:107513547-107513624,chr6,107513547,107513624,HepG2|chr6:30535035-30535108,chr6,30535035,30535108,0,76978512
HepG2|chr6:107519234-107519341,chr6,107519234,107519341,HepG2|chr6:52281735-52281776,chr6,52281735,52281776,0,55237499
HepG2|chr6:107565474-107565587,chr6,107565474,107565587,HepG2|chr6:80251765-80251789,chr6,80251765,80251789,0,27313709
HepG2|chr6:107591412-107591521,chr6,107591412,107591521,HepG2|chr6:26286238-26286281,chr6,26286238,26286281,0,81305174
HepG2|chr6:107839909-107840011,chr6,107839909,107840011,HepG2|chr6:27442973-27443021,chr6,27442973,27443021,0,80396936
HepG2|chr6:108104644-108104698,chr6,108104644,108104698,HepG2|chr6:3003690-3003833,chr6,3003690,3003833,0,105100954
HepG2|chr6:108272957-108273031,chr6,108272957,108273031,HepG2|chr6:26288608-26288665,chr6,26288608,26288665,0,81984349
HepG2|chr6:108613293-108613333,chr6,108613293,108613333,HepG2|chr6:31795055-31795205,chr6,31795055,31795205,0,76818238
HepG2|chr6:108840508-108840603,chr6,108840508,108840603,HepG2|chr6:31795050-31795200,chr6,31795050,31795200,0,77045458
HepG2|chr6:109294705-109294852,chr6,109294705,109294852,HepG2|chr6:30534179-30534250,chr6,30534179,30534250,0,78760526
HepG2|chr6:109350510-109350569,chr6,109350510,109350569,HepG2|chr6:31459019-31459077,chr6,31459019,31459077,0,77891491
HepG2|chr6:109517766-109517839,chr6,109517766,109517839,HepG2|chr6:111298197-111298347,chr6,111298197,111298347,0,1780431
HepG2|chr6:109999655-109999805,chr6,109999655,109999805,HepG2|chr6:7722668-7722710,chr6,7722668,7722710,0,102276987
HepG2|chr6:110283764-110283795,chr6,110283764,110283795,HepG2|chr6:35226846-35226927,chr6,35226846,35226927,0,75056918
HepG2|chr6:110570927-110571077,chr6,110570927,110571077,HepG2|chr6:31460149-31460299,chr6,31460149,31460299,0,79110778
HepG2|chr6:110578206-110578238,chr6,110578206,110578238,HepG2|chr6:13821457-13821575,chr6,13821457,13821575,0,96756749
HepG2|chr6:110597543-110597580,chr6,110597543,110597580,HepG2|chr6:111281677-111281787,chr6,111281677,111281787,0,684134
HepG2|chr6:110816998-110817068,chr6,110816998,110817068,HepG2|chr6:13815505-13815585,chr6,13815505,13815585,0,97001493
HepG2|chr6:110920731-110920826,chr6,110920731,110920826,HepG2|chr6:31459032-31459084,chr6,31459032,31459084,0,79461699
HepG2|chr6:110939533-110939665,chr6,110939533,110939665,HepG2|chr6:31794979-31795098,chr6,31794979,31795098,0,79144554
HepG2|chr6:111366244-111366263,chr6,111366244,111366263,HepG2|chr6:35180405-35180546,chr6,35180405,35180546,0,76185839
HepG2|chr6:111388281-111388358,chr6,111388281,111388358,HepG2|chr6:26252298-26252371,chr6,26252298,26252371,0,85135983
HepG2|chr6:111501668-111501735,chr6,111501668,111501735,HepG2|chr6:1308817-1308853,chr6,1308817,1308853,0,110192851
HepG2|chr6:112022775-112022902,chr6,112022775,112022902,HepG2|chr6:52281032-52281106,chr6,52281032,52281106,0,59741743
HepG2|chr6:112217665-112217707,chr6,112217665,112217707,HepG2|chr6:31794979-31795098,chr6,31794979,31795098,0,80422686
HepG2|chr6:112535895-112535962,chr6,112535895,112535962,HepG2|chr6:26285998-26286070,chr6,26285998,26286070,0,86249897
HepG2|chr6:113233034-113233098,chr6,113233034,113233098,HepG2|chr6:31457909-31458013,chr6,31457909,31458013,0,81775125
HepG2|chr6:113669056-113669147,chr6,113669056,113669147,HepG2|chr6:43734518-43734655,chr6,43734518,43734655,0,69934538
HepG2|chr6:114439288-114439438,chr6,114439288,114439438,HepG2|chr6:1310867-1310967,chr6,1310867,1310967,0,113128421
HepG2|chr6:114503628-114503683,chr6,114503628,114503683,HepG2|chr6:30536264-30536336,chr6,30536264,30536336,0,83967364
HepG2|chr6:114604842-114604875,chr6,114604842,114604875,HepG2|chr6:52285006-52285123,chr6,52285006,52285123,0,62319836
HepG2|chr6:114695045-114695083,chr6,114695045,114695083,HepG2|chr6:31794979-31795100,chr6,31794979,31795100,0,82900066
HepG2|chr6:114857678-114857760,chr6,114857678,114857760,HepG2|chr6:80250900-80250975,chr6,80250900,80250975,0,34606778
HepG2|chr6:115303374-115303466,chr6,115303374,115303466,HepG2|chr6:80251573-80251712,chr6,80251573,80251712,0,35051801
HepG2|chr6:115562447-115562500,chr6,115562447,115562500,HepG2|chr6:31458623-31458772,chr6,31458623,31458772,0,84103824
HepG2|chr6:115628367-115628432,chr6,115628367,115628432,HepG2|chr6:116421654-116421742,chr6,116421654,116421742,0,793287
HepG2|chr6:116181645-116181708,chr6,116181645,116181708,HepG2|chr6:2840570-2840630,chr6,2840570,2840630,0,113341075
HepG2|chr6:116516629-116516740,chr6,116516629,116516740,HepG2|chr6:80251765-80251789,chr6,80251765,80251789,0,36264864
HepG2|chr6:116630026-116630078,chr6,116630026,116630078,HepG2|chr6:31459019-31459084,chr6,31459019,31459084,0,85171007
HepG2|chr6:116884230-116884288,chr6,116884230,116884288,HepG2|chr6:31457746-31457871,chr6,31457746,31457871,0,85426484
HepG2|chr6:116962888-116962938,chr6,116962888,116962938,HepG2|chr6:1309191-1309274,chr6,1309191,1309274,0,115653697
HepG2|chr6:117381472-117381587,chr6,117381472,117381587,HepG2|chr6:26252295-26252371,chr6,26252295,26252371,0,91129177
HepG2|chr6:117717148-117717297,chr6,117717148,117717297,HepG2|chr6:31459019-31459077,chr6,31459019,31459077,0,86258129
HepG2|chr6:117851193-117851245,chr6,117851193,117851245,HepG2|chr6:44094503-44094653,chr6,44094503,44094653,0,73756690
HepG2|chr6:118055156-118055252,chr6,118055156,118055252,HepG2|chr6:35226846-35226902,chr6,35226846,35226902,0,82828310
HepG2|chr6:119109305-119109442,chr6,119109305,119109442,HepG2|chr6:3118022-3118077,chr6,3118022,3118077,0,115991283
HepG2|chr6:119186753-119186796,chr6,119186753,119186796,HepG2|chr6:31794972-31795112,chr6,31794972,31795112,0,87391781
HepG2|chr6:119377556-119377621,chr6,119377556,119377621,HepG2|chr6:1308817-1308941,chr6,1308817,1308941,0,118068739
HepG2|chr6:119645606-119645708,chr6,119645606,119645708,HepG2|chr6:31459012-31459077,chr6,31459012,31459077,0,88186594
HepG2|chr6:120341712-120341732,chr6,120341712,120341732,HepG2|chr6:30535497-30535570,chr6,30535497,30535570,0,89806215
HepG2|chr6:120375620-120375770,chr6,120375620,120375770,HepG2|chr6:30534258-30534291,chr6,30534258,30534291,0,89841362
HepG2|chr6:120572671-120572821,chr6,120572671,120572821,HepG2|chr6:1309638-1309685,chr6,1309638,1309685,0,119263033
HepG2|chr6:120719336-120719416,chr6,120719336,120719416,HepG2|chr6:28236895-28236935,chr6,28236895,28236935,0,92482441
HepG2|chr6:121393853-121393910,chr6,121393853,121393910,HepG2|chr6:44233631-44233653,chr6,44233631,44233653,0,77160222
HepG2|chr6:121422291-121422436,chr6,121422291,121422436,HepG2|chr6:30537962-30538112,chr6,30537962,30538112,0,90884329
HepG2|chr6:121756228-121756322,chr6,121756228,121756322,HepG2|chr6:35226846-35226902,chr6,35226846,35226902,0,86529382
HepG2|chr6:122371815-122371851,chr6,122371815,122371851,HepG2|chr6:36098917-36098934,chr6,36098917,36098934,0,86272898
HepG2|chr6:122572930-122572982,chr6,122572930,122572982,HepG2|chr6:35226846-35226879,chr6,35226846,35226879,0,87346084
HepG2|chr6:122806011-122806050,chr6,122806011,122806050,HepG2|chr6:111281673-111281787,chr6,111281673,111281787,0,11524338
HepG2|chr6:123425443-123425541,chr6,123425443,123425541,HepG2|chr6:143771041-143771072,chr6,143771041,143771072,0,20345598
HepG2|chr6:123683837-123683973,chr6,123683837,123683973,HepG2|chr6:3118022-3118134,chr6,3118022,3118134,0,120565815
HepG2|chr6:123908453-123908489,chr6,123908453,123908489,HepG2|chr6:111281673-111281787,chr6,111281673,111281787,0,12626780
HepG2|chr6:124089357-124089431,chr6,124089357,124089431,HepG2|chr6:116421654-116421707,chr6,116421654,116421707,0,7667703
HepG2|chr6:124216472-124216578,chr6,124216472,124216578,HepG2|chr6:52285006-52285047,chr6,52285006,52285047,0,71931466
HepG2|chr6:124641704-124641854,chr6,124641704,124641854,HepG2|chr6:30534228-30534272,chr6,30534228,30534272,0,94107476
HepG2|chr6:124704739-124704782,chr6,124704739,124704782,HepG2|chr6:34723444-34723469,chr6,34723444,34723469,0,89981295
HepG2|chr6:124893309-124893400,chr6,124893309,124893400,HepG2|chr6:31459018-31459077,chr6,31459018,31459077,0,93434291
HepG2|chr6:125166945-125167064,chr6,125166945,125167064,HepG2|chr6:3118022-3118051,chr6,3118022,3118051,0,122048923
HepG2|chr6:125265471-125265507,chr6,125265471,125265507,HepG2|chr6:31794972-31795119,chr6,31794972,31795119,0,93470499
HepG2|chr6:125424593-125424712,chr6,125424593,125424712,HepG2|chr6:3118022-3118051,chr6,3118022,3118051,0,122306571
HepG2|chr6:125609247-125609292,chr6,125609247,125609292,HepG2|chr6:1385438-1385588,chr6,1385438,1385588,0,124223809
HepG2|chr6:125658395-125658481,chr6,125658395,125658481,HepG2|chr6:31795019-31795169,chr6,31795019,31795169,0,93863376
HepG2|chr6:126226250-126226271,chr6,126226250,126226271,HepG2|chr6:1307690-1307816,chr6,1307690,1307816,0,124918560
HepG2|chr6:126605547-126605575,chr6,126605547,126605575,HepG2|chr6:26252333-26252483,chr6,26252333,26252483,0,100353214
HepG2|chr6:126673883-126673943,chr6,126673883,126673943,HepG2|chr6:1309381-1309527,chr6,1309381,1309527,0,125364502
HepG2|chr6:126815447-126815500,chr6,126815447,126815500,HepG2|chr6:31794979-31795076,chr6,31794979,31795076,0,95020468
HepG2|chr6:126857371-126857427,chr6,126857371,126857427,HepG2|chr6:44233631-44233654,chr6,44233631,44233654,0,82623740
HepG2|chr6:126864145-126864222,chr6,126864145,126864222,HepG2|chr6:1310457-1310530,chr6,1310457,1310530,0,125553688
HepG2|chr6:127171395-127171545,chr6,127171395,127171545,HepG2|chr6:27445089-27445129,chr6,27445089,27445129,0,99726306
HepG2|chr6:127301749-127301899,chr6,127301749,127301899,HepG2|chr6:1310457-1310530,chr6,1310457,1310530,0,125991292
HepG2|chr6:127709831-127709981,chr6,127709831,127709981,HepG2|chr6:52281185-52281206,chr6,52281185,52281206,0,75428646
HepG2|chr6:127729954-127730077,chr6,127729954,127730077,HepG2|chr6:13821457-13821575,chr6,13821457,13821575,0,113908497
HepG2|chr6:127865494-127865610,chr6,127865494,127865610,HepG2|chr6:31457909-31457971,chr6,31457909,31457971,0,96407585
HepG2|chr6:128523513-128523627,chr6,128523513,128523627,HepG2|chr6:5262512-5262548,chr6,5262512,5262548,0,123261001
HepG2|chr6:128896611-128896710,chr6,128896611,128896710,HepG2|chr6:31459026-31459077,chr6,31459026,31459077,0,97437585
HepG2|chr6:129075297-129075420,chr6,129075297,129075420,HepG2|chr6:31459026-31459077,chr6,31459026,31459077,0,97616271
HepG2|chr6:129165604-129165654,chr6,129165604,129165654,HepG2|chr6:31461699-31461843,chr6,31461699,31461843,0,97703905
HepG2|chr6:129329224-129329292,chr6,129329224,129329292,HepG2|chr6:1309638-1309685,chr6,1309638,1309685,0,128019586
HepG2|chr6:129455914-129455982,chr6,129455914,129455982,HepG2|chr6:10530537-10530619,chr6,10530537,10530619,0,118925377
HepG2|chr6:130452521-130452581,chr6,130452521,130452581,HepG2|chr6:3118022-3118087,chr6,3118022,3118087,0,127334499
HepG2|chr6:131007376-131007474,chr6,131007376,131007474,HepG2|chr6:143771041-143771072,chr6,143771041,143771072,0,12763665
HepG2|chr6:131464067-131464161,chr6,131464067,131464161,HepG2|chr6:36093661-36093717,chr6,36093661,36093717,0,95370406
HepG2|chr6:131854062-131854136,chr6,131854062,131854136,HepG2|chr6:35226846-35226922,chr6,35226846,35226922,0,96627216
HepG2|chr6:132907413-132907444,chr6,132907413,132907444,HepG2|chr6:1308817-1308853,chr6,1308817,1308853,0,131598596
HepG2|chr6:133078824-133078912,chr6,133078824,133078912,HepG2|chr6:27442964-27443021,chr6,27442964,27443021,0,105635860
HepG2|chr6:133123746-133123840,chr6,133123746,133123840,HepG2|chr6:31794979-31795093,chr6,31794979,31795093,0,101328767
HepG2|chr6:133877973-133878010,chr6,133877973,133878010,HepG2|chr6:111281677-111281787,chr6,111281677,111281787,0,22596296
HepG2|chr6:133887479-133887627,chr6,133887479,133887627,HepG2|chr6:36093661-36093717,chr6,36093661,36093717,0,97793818
HepG2|chr6:134407418-134407485,chr6,134407418,134407485,HepG2|chr6:35226854-35227004,chr6,35226854,35227004,0,99180564
HepG2|chr6:134784511-134784658,chr6,134784511,134784658,HepG2|chr6:31461989-31462139,chr6,31461989,31462139,0,103322522
HepG2|chr6:134925498-134925524,chr6,134925498,134925524,HepG2|chr6:31458200-31458324,chr6,31458200,31458324,0,103467298
HepG2|chr6:135224886-135224904,chr6,135224886,135224904,HepG2|chr6:31794979-31795111,chr6,31794979,31795111,0,103429907
HepG2|chr6:135255380-135255450,chr6,135255380,135255450,HepG2|chr6:35226846-35226892,chr6,35226846,35226892,0,100028534
HepG2|chr6:135468333-135468480,chr6,135468333,135468480,HepG2|chr6:30534235-30534272,chr6,30534235,30534272,0,104934098
HepG2|chr6:135484822-135484913,chr6,135484822,135484913,HepG2|chr6:31459025-31459084,chr6,31459025,31459084,0,104025797
HepG2|chr6:135815193-135815236,chr6,135815193,135815236,HepG2|chr6:80249508-80249567,chr6,80249508,80249567,0,55565685
HepG2|chr6:135958330-135958412,chr6,135958330,135958412,HepG2|chr6:80250900-80250975,chr6,80250900,80250975,0,55707430
HepG2|chr6:136101547-136101595,chr6,136101547,136101595,HepG2|chr6:31794979-31795081,chr6,31794979,31795081,0,104306568
HepG2|chr6:136213944-136214079,chr6,136213944,136214079,HepG2|chr6:31794979-31795072,chr6,31794979,31795072,0,104418965
HepG2|chr6:136319272-136319386,chr6,136319272,136319386,HepG2|chr6:27442973-27443021,chr6,27442973,27443021,0,108876299
HepG2|chr6:136522723-136522865,chr6,136522723,136522865,HepG2|chr6:31458200-31458324,chr6,31458200,31458324,0,105064523
HepG2|chr6:136750601-136750665,chr6,136750601,136750665,HepG2|chr6:1308817-1308875,chr6,1308817,1308875,0,135441784
HepG2|chr6:136859321-136859349,chr6,136859321,136859349,HepG2|chr6:116421654-116421775,chr6,116421654,116421775,0,20437667
HepG2|chr6:137013707-137013759,chr6,137013707,137013759,HepG2|chr6:5004038-5004188,chr6,5004038,5004188,0,132009669
HepG2|chr6:137044850-137044931,chr6,137044850,137044931,HepG2|chr6:31795055-31795205,chr6,31795055,31795205,0,105249795
HepG2|chr6:138293625-138293740,chr6,138293625,138293740,HepG2|chr6:5262512-5262546,chr6,5262512,5262546,0,133031113
HepG2|chr6:138701476-138701580,chr6,138701476,138701580,HepG2|chr6:111300688-111300808,chr6,111300688,111300808,0,27400788
HepG2|chr6:139176751-139176896,chr6,139176751,139176896,HepG2|chr6:31459024-31459077,chr6,31459024,31459077,0,107717727
HepG2|chr6:139722987-139723058,chr6,139722987,139723058,HepG2|chr6:35226846-35226922,chr6,35226846,35226922,0,104496141
HepG2|chr6:139918974-139919074,chr6,139918974,139919074,HepG2|chr6:26286233-26286281,chr6,26286233,26286281,0,113632741
HepG2|chr6:140000949-140001010,chr6,140000949,140001010,HepG2|chr6:3118022-3118111,chr6,3118022,3118111,0,136882927
HepG2|chr6:140196153-140196241,chr6,140196153,140196241,HepG2|chr6:31794979-31795050,chr6,31794979,31795050,0,108401174
HepG2|chr6:140446874-140447010,chr6,140446874,140447010,HepG2|chr6:3118022-3118134,chr6,3118022,3118134,0,137328852
HepG2|chr6:140846083-140846160,chr6,140846083,140846160,HepG2|chr6:111281690-111281787,chr6,111281690,111281787,0,29564393
HepG2|chr6:141246399-141246514,chr6,141246399,141246514,HepG2|chr6:5262512-5262546,chr6,5262512,5262546,0,135983887
HepG2|chr6:141259647-141259732,chr6,141259647,141259732,HepG2|chr6:31459012-31459077,chr6,31459012,31459077,0,109800635
HepG2|chr6:141313699-141313781,chr6,141313699,141313781,HepG2|chr6:26286088-26286152,chr6,26286088,26286152,0,115027611
HepG2|chr6:141482768-141482872,chr6,141482768,141482872,HepG2|chr6:89673796-89673849,chr6,89673796,89673849,0,51808972
HepG2|chr6:141783673-141783777,chr6,141783673,141783777,HepG2|chr6:35227066-35227094,chr6,35227066,35227094,0,106556607
HepG2|chr6:141931357-141931429,chr6,141931357,141931429,HepG2|chr6:80250900-80250975,chr6,80250900,80250975,0,61680457
HepG2|chr6:142102160-142102191,chr6,142102160,142102191,HepG2|chr6:31794979-31795098,chr6,31794979,31795098,0,110307181
HepG2|chr6:143066389-143066425,chr6,143066389,143066425,HepG2|chr6:36098917-36098934,chr6,36098917,36098934,0,106967472
HepG2|chr6:143505144-143505209,chr6,143505144,143505209,HepG2|chr6:111300204-111300289,chr6,111300204,111300289,0,32204940
HepG2|chr6:143687117-143687180,chr6,143687117,143687180,HepG2|chr6:35226880-35227030,chr6,35226880,35227030,0,108460237
HepG2|chr6:143767179-143767215,chr6,143767179,143767215,HepG2|chr6:1308817-1308920,chr6,1308817,1308920,0,142458362
HepG2|chr6:143809965-143810115,chr6,143809965,143810115,HepG2|chr6:26286238-26286281,chr6,26286238,26286281,0,117523727
HepG2|chr6:143814398-143814548,chr6,143814398,143814548,HepG2|chr6:30534240-30534346,chr6,30534240,30534346,0,113280158
HepG2|chr6:143830335-143830409,chr6,143830335,143830409,HepG2|chr6:35226846-35226922,chr6,35226846,35226922,0,108603489
HepG2|chr6:144647524-144647664,chr6,144647524,144647664,HepG2|chr6:31794979-31794999,chr6,31794979,31794999,0,112852545
HepG2|chr6:145204699-145204775,chr6,145204699,145204775,HepG2|chr6:80247477-80247500,chr6,80247477,80247500,0,64957222
HepG2|chr6:145314100-145314167,chr6,145314100,145314167,HepG2|chr6:116421688-116421838,chr6,116421688,116421838,0,28892412
HepG2|chr6:145592265-145592337,chr6,145592265,145592337,HepG2|chr6:116421654-116421766,chr6,116421654,116421766,0,29170611
HepG2|chr6:145662301-145662448,chr6,145662301,145662448,HepG2|chr6:31461989-31462139,chr6,31461989,31462139,0,114200312
HepG2|chr6:145935034-145935102,chr6,145935034,145935102,HepG2|chr6:116421654-116421736,chr6,116421654,116421736,0,29513380
HepG2|chr6:145982475-145982589,chr6,145982475,145982589,HepG2|chr6:27442973-27443021,chr6,27442973,27443021,0,118539502
HepG2|chr6:146162634-146162734,chr6,146162634,146162734,HepG2|chr6:31459034-31459084,chr6,31459034,31459084,0,114703600
HepG2|chr6:146315324-146315410,chr6,146315324,146315410,HepG2|chr6:30538448-30538512,chr6,30538448,30538512,0,115776876
HepG2|chr6:146364511-146364582,chr6,146364511,146364582,HepG2|chr6:35226846-35226922,chr6,35226846,35226922,0,111137665
HepG2|chr6:146508547-146508697,chr6,146508547,146508697,HepG2|chr6:1310867-1310967,chr6,1310867,1310967,0,145197680
HepG2|chr6:146544003-146544097,chr6,146544003,146544097,HepG2|chr6:111303094-111303147,chr6,111303094,111303147,0,35240909
HepG2|chr6:146724422-146724511,chr6,146724422,146724511,HepG2|chr6:80248469-80248560,chr6,80248469,80248560,0,66475953
HepG2|chr6:146735025-146735056,chr6,146735025,146735056,HepG2|chr6:38672372-38672391,chr6,38672372,38672391,0,108062653
HepG2|chr6:146797886-146797970,chr6,146797886,146797970,HepG2|chr6:5004021-5004171,chr6,5004021,5004171,0,141793865
HepG2|chr6:146950600-146950717,chr6,146950600,146950717,HepG2|chr6:5262512-5262545,chr6,5262512,5262545,0,141688088
HepG2|chr6:146953169-146953319,chr6,146953169,146953319,HepG2|chr6:80250689-80250795,chr6,80250689,80250795,0,66702480
HepG2|chr6:147139158-147139259,chr6,147139158,147139259,HepG2|chr6:31794979-31795082,chr6,31794979,31795082,0,115344179
HepG2|chr6:147208344-147208392,chr6,147208344,147208392,HepG2|chr6:26286201-26286281,chr6,26286201,26286281,0,120922143
HepG2|chr6:147317910-147317938,chr6,147317910,147317938,HepG2|chr6:116421654-116421775,chr6,116421654,116421775,0,30896256
HepG2|chr6:148344325-148344386,chr6,148344325,148344386,HepG2|chr6:111300357-111300384,chr6,111300357,111300384,0,37043968
HepG2|chr6:148355991-148356041,chr6,148355991,148356041,HepG2|chr6:31794979-31795093,chr6,31794979,31795093,0,116561012
HepG2|chr6:148367964-148368052,chr6,148367964,148368052,HepG2|chr6:116421654-116421720,chr6,116421654,116421720,0,31946310
HepG2|chr6:148879652-148879796,chr6,148879652,148879796,HepG2|chr6:30534152-30534214,chr6,30534152,30534214,0,118345500
HepG2|chr6:148897881-148897922,chr6,148897881,148897922,HepG2|chr6:31794979-31795093,chr6,31794979,31795093,0,117102902
HepG2|chr6:148939600-148939683,chr6,148939600,148939683,HepG2|chr6:35226868-35226923,chr6,35226868,35226923,0,113712732
HepG2|chr6:149224249-149224299,chr6,149224249,149224299,HepG2|chr6:1310867-1310967,chr6,1310867,1310967,0,147913382
HepG2|chr6:149500234-149500256,chr6,149500234,149500256,HepG2|chr6:30534147-30534269,chr6,30534147,30534269,0,118966087
HepG2|chr6:149573825-149573942,chr6,149573825,149573942,HepG2|chr6:3118022-3118054,chr6,3118022,3118054,0,146455803
HepG2|chr6:149601280-149601372,chr6,149601280,149601372,HepG2|chr6:31459019-31459077,chr6,31459019,31459077,0,118142261
HepG2|chr6:149744779-149744889,chr6,149744779,149744889,HepG2|chr6:27445089-27445129,chr6,27445089,27445129,0,122299690
HepG2|chr6:149909109-149909145,chr6,149909109,149909145,HepG2|chr6:111281673-111281787,chr6,111281673,111281787,0,38627436
HepG2|chr6:150114110-150114162,chr6,150114110,150114162,HepG2|chr6:31457909-31457986,chr6,31457909,31457986,0,118656201
HepG2|chr6:150396995-150397048,chr6,150396995,150397048,HepG2|chr6:31794979-31795076,chr6,31794979,31795076,0,118602016
HepG2|chr6:150760516-150760584,chr6,150760516,150760584,HepG2|chr6:116416942-116417092,chr6,116416942,116417092,0,34343574
HepG2|chr6:151015507-151015656,chr6,151015507,151015656,HepG2|chr6:150183600-150183688,chr6,150183600,150183688,0,831907
HepG2|chr6:151894420-151894484,chr6,151894420,151894484,HepG2|chr6:3118022-3118105,chr6,3118022,3118105,0,148776398
HepG2|chr6:152272787-152272820,chr6,152272787,152272820,HepG2|chr6:30538052-30538202,chr6,30538052,30538202,0,121734735
HepG2|chr6:152656207-152656347,chr6,152656207,152656347,HepG2|chr6:143771041-143771072,chr6,143771041,143771072,0,8885166
HepG2|chr6:152727403-152727424,chr6,152727403,152727424,HepG2|chr6:27443120-27443224,chr6,27443120,27443224,0,125284283
HepG2|chr6:152880377-152880398,chr6,152880377,152880398,HepG2|chr6:26159066-26159195,chr6,26159066,26159195,0,126721311
HepG2|chr6:153003166-153003253,chr6,153003166,153003253,HepG2|chr6:116421654-116421696,chr6,116421654,116421696,0,36581512
HepG2|chr6:153166329-153166362,chr6,153166329,153166362,HepG2|chr6:35228178-35228295,chr6,35228178,35228295,0,117938151
HepG2|chr6:153261753-153261774,chr6,153261753,153261774,HepG2|chr6:1307690-1307816,chr6,1307690,1307816,0,151954063
HepG2|chr6:153465672-153465693,chr6,153465672,153465693,HepG2|chr6:116421688-116421838,chr6,116421688,116421838,0,37043984
HepG2|chr6:154121725-154121800,chr6,154121725,154121800,HepG2|chr6:31792729-31792788,chr6,31792729,31792788,0,122328996
HepG2|chr6:154200273-154200361,chr6,154200273,154200361,HepG2|chr6:31459857-31459917,chr6,31459857,31459917,0,122740416
HepG2|chr6:154204833-154204893,chr6,154204833,154204893,HepG2|chr6:34723885-34723948,chr6,34723885,34723948,0,119480948
HepG2|chr6:154514561-154514618,chr6,154514561,154514618,HepG2|chr6:31794979-31795072,chr6,31794979,31795072,0,122719582
HepG2|chr6:154617711-154617749,chr6,154617711,154617749,HepG2|chr6:116421654-116421766,chr6,116421654,116421766,0,38196057
HepG2|chr6:154638578-154638635,chr6,154638578,154638635,HepG2|chr6:5004060-5004148,chr6,5004060,5004148,0,149634518
HepG2|chr6:154738173-154738197,chr6,154738173,154738197,HepG2|chr6:30534147-30534269,chr6,30534147,30534269,0,124204026
HepG2|chr6:154954992-154955106,chr6,154954992,154955106,HepG2|chr6:31459041-31459077,chr6,31459041,31459077,0,123495951
HepG2|chr6:154959688-154959835,chr6,154959688,154959835,HepG2|chr6:42719425-42719575,chr6,42719425,42719575,0,112240263
HepG2|chr6:155220985-155221072,chr6,155220985,155221072,HepG2|chr6:31459014-31459077,chr6,31459014,31459077,0,123761971
HepG2|chr6:155411065-155411106,chr6,155411065,155411106,HepG2|chr6:80250689-80250795,chr6,80250689,80250795,0,75160376
HepG2|chr6:156061371-156061501,chr6,156061371,156061501,HepG2|chr6:52285006-52285026,chr6,52285006,52285026,0,103776365
HepG2|chr6:156080925-156081006,chr6,156080925,156081006,HepG2|chr6:80247477-80247500,chr6,80247477,80247500,0,75833448
HepG2|chr6:156401184-156401267,chr6,156401184,156401267,HepG2|chr6:31459017-31459084,chr6,31459017,31459084,0,124942167
HepG2|chr6:156819618-156819768,chr6,156819618,156819768,HepG2|chr6:31459019-31459077,chr6,31459019,31459077,0,125360599
HepG2|chr6:156919239-156919386,chr6,156919239,156919386,HepG2|chr6:30534179-30534250,chr6,30534179,30534250,0,126385060
HepG2|chr6:157167071-157167118,chr6,157167071,157167118,HepG2|chr6:31794979-31795082,chr6,31794979,31795082,0,125372092
HepG2|chr6:157511910-157511950,chr6,157511910,157511950,HepG2|chr6:31457909-31458013,chr6,31457909,31458013,0,126054001
HepG2|chr6:157526191-157526311,chr6,157526191,157526311,HepG2|chr6:3118022-3118051,chr6,3118022,3118051,0,154408169
HepG2|chr6:157961229-157961324,chr6,157961229,157961324,HepG2|chr6:3118022-3118044,chr6,3118022,3118044,0,154843207
HepG2|chr6:158566611-158566647,chr6,158566611,158566647,HepG2|chr6:1308817-1308920,chr6,1308817,1308920,0,157257794
HepG2|chr6:159157973-159158008,chr6,159157973,159158008,HepG2|chr6:31794981-31795078,chr6,31794981,31795078,0,127362992
HepG2|chr6:159247344-159247413,chr6,159247344,159247413,HepG2|chr6:42719335-42719415,chr6,42719335,42719415,0,116528009
HepG2|chr6:159765758-159765782,chr6,159765758,159765782,HepG2|chr6:31794979-31795101,chr6,31794979,31795101,0,127970779
HepG2|chr6:159804470-159804593,chr6,159804470,159804593,HepG2|chr6:13821457-13821575,chr6,13821457,13821575,0,145983013
HepG2|chr6:159994963-159995086,chr6,159994963,159995086,HepG2|chr6:2841446-2841574,chr6,2841446,2841574,0,157153517
HepG2|chr6:160397788-160397837,chr6,160397788,160397837,HepG2|chr6:43735801-43735899,chr6,43735801,43735899,0,116661987
HepG2|chr6:160510347-160510467,chr6,160510347,160510467,HepG2|chr6:3118022-3118051,chr6,3118022,3118051,0,157392325
HepG2|chr6:160598827-160598890,chr6,160598827,160598890,HepG2|chr6:5004936-5005041,chr6,5004936,5005041,0,155593891
HepG2|chr6:160619622-160619712,chr6,160619622,160619712,HepG2|chr6:116421654-116421797,chr6,116421654,116421797,0,44197968
HepG2|chr6:160653031-160653102,chr6,160653031,160653102,HepG2|chr6:35177481-35177543,chr6,35177481,35177543,0,125475550
HepG2|chr6:160988553-160988665,chr6,160988553,160988665,HepG2|chr6:31794979-31795017,chr6,31794979,31795017,0,129193574
HepG2|chr6:161302409-161302435,chr6,161302409,161302435,HepG2|chr6:1308817-1308941,chr6,1308817,1308941,0,159993592
HepG2|chr6:161461099-161461182,chr6,161461099,161461182,HepG2|chr6:1309191-1309259,chr6,1309191,1309259,0,160151908
HepG2|chr6:161542191-161542237,chr6,161542191,161542237,HepG2|chr6:1308817-1308853,chr6,1308817,1308853,0,160233374
HepG2|chr6:162027543-162027572,chr6,162027543,162027572,HepG2|chr6:31794979-31795093,chr6,31794979,31795093,0,130232564
HepG2|chr6:162457837-162457925,chr6,162457837,162457925,HepG2|chr6:27442964-27443021,chr6,27442964,27443021,0,135014873
HepG2|chr6:162792416-162792566,chr6,162792416,162792566,HepG2|chr6:26286238-26286281,chr6,26286238,26286281,0,136506178
HepG2|chr6:163262404-163262454,chr6,163262404,163262454,HepG2|chr6:31794979-31795093,chr6,31794979,31795093,0,131467425
HepG2|chr6:163378530-163378605,chr6,163378530,163378605,HepG2|chr6:31792729-31792788,chr6,31792729,31792788,0,131585801
HepG2|chr6:163398167-163398290,chr6,163398167,163398290,HepG2|chr6:111300674-111300703,chr6,111300674,111300703,0,52097493
HepG2|chr6:164281436-164281566,chr6,164281436,164281566,HepG2|chr6:52285006-52285026,chr6,52285006,52285026,0,111996430
HepG2|chr6:164996381-164996478,chr6,164996381,164996478,HepG2|chr6:31459024-31459077,chr6,31459024,31459077,0,133537357
HepG2|chr6:165045200-165045246,chr6,165045200,165045246,HepG2|chr6:1308817-1308853,chr6,1308817,1308853,0,163736383
HepG2|chr6:165081853-165081876,chr6,165081853,165081876,HepG2|chr6:10531791-10531918,chr6,10531791,10531918,0,154550062
HepG2|chr6:165293342-165293426,chr6,165293342,165293426,HepG2|chr6:5004021-5004171,chr6,5004021,5004171,0,160289321
HepG2|chr6:165720225-165720333,chr6,165720225,165720333,HepG2|chr6:31462099-31462141,chr6,31462099,31462141,0,134258126
HepG2|chr6:165761355-165761441,chr6,165761355,165761441,HepG2|chr6:30538448-30538512,chr6,30538448,30538512,0,135222907
HepG2|chr6:165905632-165905649,chr6,165905632,165905649,HepG2|chr6:30535035-30535108,chr6,30535035,30535108,0,135370597
HepG2|chr6:166275886-166275962,chr6,166275886,166275962,HepG2|chr6:52281032-52281106,chr6,52281032,52281106,0,113994854
HepG2|chr6:166507184-166507332,chr6,166507184,166507332,HepG2|chr6:5004083-5004122,chr6,5004083,5004122,0,161503101
HepG2|chr6:166750711-166750811,chr6,166750711,166750811,HepG2|chr6:26286233-26286281,chr6,26286233,26286281,0,140464478
HepG2|chr6:167007719-167007759,chr6,167007719,167007759,HepG2|chr6:31795055-31795205,chr6,31795055,31795205,0,135212664
HepG2|chr6:167176033-167176102,chr6,167176033,167176102,HepG2|chr6:3002854-3002896,chr6,3002854,3002896,0,164173179
HepG2|chr6:167318198-167318221,chr6,167318198,167318221,HepG2|chr6:10531791-10531918,chr6,10531791,10531918,0,156786407
HepG2|chr6:167484961-167485006,chr6,167484961,167485006,HepG2|chr6:111301058-111301205,chr6,111301058,111301205,0,56183903
HepG2|chr6:168335727-168335777,chr6,168335727,168335777,HepG2|chr6:1310867-1310967,chr6,1310867,1310967,0,167024860
HepG2|chr6:168569720-168569824,chr6,168569720,168569824,HepG2|chr6:89673796-89673849,chr6,89673796,89673849,0,78895924
HepG2|chr6:168614141-168614240,chr6,168614141,168614240,HepG2|chr6:26286239-26286281,chr6,26286239,26286281,0,142327902
HepG2|chr6:168861729-168861774,chr6,168861729,168861774,HepG2|chr6:1308817-1308870,chr6,1308817,1308870,0,167552912
HepG2|chr6:169140714-169140737,chr6,169140714,169140737,HepG2|chr6:27443120-27443224,chr6,27443120,27443224,0,141697594
HepG2|chr6:169165574-169165626,chr6,169165574,169165626,HepG2|chr6:31459019-31459084,chr6,31459019,31459084,0,137706555
HepG2|chr6:169631308-169631380,chr6,169631308,169631380,HepG2|chr6:35226847-35226997,chr6,35226847,35226997,0,134404461
HepG2|chr6:169716745-169716890,chr6,169716745,169716890,HepG2|chr6:30537962-30538112,chr6,30537962,30538112,0,139178783
HepG2|chr6:169790152-169790178,chr6,169790152,169790178,HepG2|chr6:1308817-1308941,chr6,1308817,1308941,0,168481335
HepG2|chr6:170034487-170034588,chr6,170034487,170034588,HepG2|chr6:26286233-26286281,chr6,26286233,26286281,0,143748254
HepG2|chr6:170396577-170396633,chr6,170396577,170396633,HepG2|chr6:44233631-44233654,chr6,44233631,44233654,0,126162946
HepG2|chr6:170408526-170408606,chr6,170408526,170408606,HepG2|chr6:52282785-52282845,chr6,52282785,52282845,0,118125741
HepG2|chr6:170608395-170608481,chr6,170608395,170608481,HepG2|chr6:31459023-31459084,chr6,31459023,31459084,0,139149372
HepG2|chr7:30045-30192,chr7,30045,30192,HepG2|chr7:102004890-102004987,chr7,102004890,102004987,0,101974845
HepG2|chr7:279477-279565,chr7,279477,279565,HepG2|chr7:41744259-41744277,chr7,41744259,41744277,0,41464782
HepG2|chr7:679742-679764,chr7,679742,679764,HepG2|chr7:6748619-6748670,chr7,6748619,6748670,0,6068877
HepG2|chr7:697668-697707,chr7,697668,697707,HepG2|chr7:56121918-56122029,chr7,56121918,56122029,0,55424250
HepG2|chr7:811994-812093,chr7,811994,812093,HepG2|chr7:99934670-99934819,chr7,99934670,99934819,0,99122676
HepG2|chr7:1068005-1068113,chr7,1068005,1068113,HepG2|chr7:75931687-75931728,chr7,75931687,75931728,0,74863682
HepG2|chr7:1105037-1105134,chr7,1105037,1105134,HepG2|chr7:75113873-75114020,chr7,75113873,75114020,0,74008836
HepG2|chr7:1404328-1404437,chr7,1404328,1404437,HepG2|chr7:74866388-74866538,chr7,74866388,74866538,0,73462060
HepG2|chr7:1634358-1634444,chr7,1634358,1634444,HepG2|chr7:45810486-45810542,chr7,45810486,45810542,0,44176128
HepG2|chr7:1943546-1943695,chr7,1943546,1943695,HepG2|chr7:74381675-74381712,chr7,74381675,74381712,0,72438129
HepG2|chr7:2052129-2052210,chr7,2052129,2052210,HepG2|chr7:65338722-65338797,chr7,65338722,65338797,0,63286593
HepG2|chr7:2078549-2078571,chr7,2078549,2078571,HepG2|chr7:41744259-41744282,chr7,41744259,41744282,0,39665710
HepG2|chr7:2662696-2662845,chr7,2662696,2662845,HepG2|chr7:102004837-102004987,chr7,102004837,102004987,0,99342141
HepG2|chr7:2855200-2855350,chr7,2855200,2855350,HepG2|chr7:74867569-74867618,chr7,74867569,74867618,0,72012369
HepG2|chr7:3421373-3421432,chr7,3421373,3421432,HepG2|chr7:5631330-5631469,chr7,5631330,5631469,0,2209957
HepG2|chr7:3421888-3422032,chr7,3421888,3422032,HepG2|chr7:74867484-74867631,chr7,74867484,74867631,0,71445596
HepG2|chr7:4170917-4171062,chr7,4170917,4171062,HepG2|chr7:29720482-29720631,chr7,29720482,29720631,0,25549565
HepG2|chr7:4454714-4454849,chr7,4454714,4454849,HepG2|chr7:99934709-99934854,chr7,99934709,99934854,0,95479995
HepG2|chr7:4723973-4724050,chr7,4723973,4724050,HepG2|chr7:134859765-134859838,chr7,134859765,134859838,0,130135792
HepG2|chr7:4824046-4824192,chr7,4824046,4824192,HepG2|chr7:65338726-65338828,chr7,65338726,65338828,0,60514680
HepG2|chr7:4824789-4824936,chr7,4824789,4824936,HepG2|chr7:100729415-100729539,chr7,100729415,100729539,0,95904626
HepG2|chr7:4840791-4840895,chr7,4840791,4840895,HepG2|chr7:101461730-101461776,chr7,101461730,101461776,0,96620939
HepG2|chr7:4882693-4882843,chr7,4882693,4882843,HepG2|chr7:74867504-74867630,chr7,74867504,74867630,0,69984811
HepG2|chr7:5522272-5522380,chr7,5522272,5522380,HepG2|chr7:75931687-75931728,chr7,75931687,75931728,0,70409415
HepG2|chr7:5752823-5752923,chr7,5752823,5752923,HepG2|chr7:74867472-74867622,chr7,74867472,74867622,0,69114649
HepG2|chr7:6144125-6144174,chr7,6144125,6144174,HepG2|chr7:101461730-101461776,chr7,101461730,101461776,0,95317605
HepG2|chr7:6570386-6570428,chr7,6570386,6570428,HepG2|chr7:56121943-56122023,chr7,56121943,56122023,0,49551557
HepG2|chr7:6719231-6719379,chr7,6719231,6719379,HepG2|chr7:99934671-99934821,chr7,99934671,99934821,0,93215440
HepG2|chr7:7405787-7405933,chr7,7405787,7405933,HepG2|chr7:30327451-30327498,chr7,30327451,30327498,0,22921664
HepG2|chr7:7723190-7723340,chr7,7723190,7723340,HepG2|chr7:65338722-65338809,chr7,65338722,65338809,0,57615532
HepG2|chr7:7734803-7734905,chr7,7734803,7734905,HepG2|chr7:99934709-99934854,chr7,99934709,99934854,0,92199906
HepG2|chr7:7740642-7740769,chr7,7740642,7740769,HepG2|chr7:74381618-74381680,chr7,74381618,74381680,0,66640976
HepG2|chr7:7774603-7774670,chr7,7774603,7774670,HepG2|chr7:5607634-5607670,chr7,5607634,5607670,0,2166969
HepG2|chr7:8137874-8138024,chr7,8137874,8138024,HepG2|chr7:74867473-74867623,chr7,74867473,74867623,0,66729599
HepG2|chr7:8237024-8237145,chr7,8237024,8237145,HepG2|chr7:99934404-99934440,chr7,99934404,99934440,0,91697380
HepG2|chr7:8244060-8244209,chr7,8244060,8244209,HepG2|chr7:74381675-74381712,chr7,74381675,74381712,0,66137615
HepG2|chr7:8420380-8420525,chr7,8420380,8420525,HepG2|chr7:65338723-65338782,chr7,65338723,65338782,0,56918343
HepG2|chr7:8430800-8430928,chr7,8430800,8430928,HepG2|chr7:6864858-6864902,chr7,6864858,6864902,0,1565942
HepG2|chr7:9165884-9166034,chr7,9165884,9166034,HepG2|chr7:65338723-65338792,chr7,65338723,65338792,0,56172839
HepG2|chr7:9246511-9246632,chr7,9246511,9246632,HepG2|chr7:99934404-99934440,chr7,99934404,99934440,0,90687893
HepG2|chr7:9561983-9562133,chr7,9561983,9562133,HepG2|chr7:74867484-74867630,chr7,74867484,74867630,0,65305501
HepG2|chr7:9569293-9569421,chr7,9569293,9569421,HepG2|chr7:73184787-73184807,chr7,73184787,73184807,0,63615494
HepG2|chr7:9636702-9636796,chr7,9636702,9636796,HepG2|chr7:5631709-5631765,chr7,5631709,5631765,0,4004993
HepG2|chr7:10039940-10040022,chr7,10039940,10040022,HepG2|chr7:92465723-92465787,chr7,92465723,92465787,0,82425783
HepG2|chr7:10051079-10051105,chr7,10051079,10051105,HepG2|chr7:41744259-41744283,chr7,41744259,41744283,0,31693180
HepG2|chr7:10105539-10105627,chr7,10105539,10105627,HepG2|chr7:41744259-41744277,chr7,41744259,41744277,0,31638720
HepG2|chr7:10210273-10210354,chr7,10210273,10210354,HepG2|chr7:134859765-134859838,chr7,134859765,134859838,0,124649492
HepG2|chr7:10906757-10906902,chr7,10906757,10906902,HepG2|chr7:102004837-102004987,chr7,102004837,102004987,0,91098080
HepG2|chr7:11023477-11023627,chr7,11023477,11023627,HepG2|chr7:5631709-5631765,chr7,5631709,5631765,0,5391768
HepG2|chr7:11107945-11108066,chr7,11107945,11108066,HepG2|chr7:41744259-41744285,chr7,41744259,41744285,0,30636314
HepG2|chr7:11679273-11679423,chr7,11679273,11679423,HepG2|chr7:29720495-29720641,chr7,29720495,29720641,0,18041222
HepG2|chr7:11721268-11721418,chr7,11721268,11721418,HepG2|chr7:99934693-99934837,chr7,99934693,99934837,0,88213425
HepG2|chr7:12173763-12173881,chr7,12173763,12173881,HepG2|chr7:99934693-99934823,chr7,99934693,99934823,0,87760930
HepG2|chr7:12278967-12279046,chr7,12278967,12279046,HepG2|chr7:99934928-99935054,chr7,99934928,99935054,0,87655961
HepG2|chr7:12405699-12405776,chr7,12405699,12405776,HepG2|chr7:134859765-134859838,chr7,134859765,134859838,0,122454066
HepG2|chr7:12572093-12572182,chr7,12572093,12572182,HepG2|chr7:45810481-45810542,chr7,45810481,45810542,0,33238388
HepG2|chr7:12923881-12924028,chr7,12923881,12924028,HepG2|chr7:102247028-102247178,chr7,102247028,102247178,0,89323147
HepG2|chr7:13657166-13657315,chr7,13657166,13657315,HepG2|chr7:102004837-102004987,chr7,102004837,102004987,0,88347671
HepG2|chr7:13881611-13881720,chr7,13881611,13881720,HepG2|chr7:99934670-99934820,chr7,99934670,99934820,0,86053059
HepG2|chr7:14572918-14573029,chr7,14572918,14573029,HepG2|chr7:72351631-72351733,chr7,72351631,72351733,0,57778713
HepG2|chr7:15233734-15233846,chr7,15233734,15233846,HepG2|chr7:72351543-72351671,chr7,72351543,72351671,0,57117809
HepG2|chr7:15317311-15317390,chr7,15317311,15317390,HepG2|chr7:92465699-92465737,chr7,92465699,92465737,0,77148388
HepG2|chr7:15319854-15319930,chr7,15319854,15319930,HepG2|chr7:134860442-134860569,chr7,134860442,134860569,0,119540588
HepG2|chr7:15618090-15618184,chr7,15618090,15618184,HepG2|chr7:5631709-5631765,chr7,5631709,5631765,0,9986381
HepG2|chr7:15724604-15724748,chr7,15724604,15724748,HepG2|chr7:74867484-74867631,chr7,74867484,74867631,0,59142880
HepG2|chr7:15750767-15750914,chr7,15750767,15750914,HepG2|chr7:74867472-74867622,chr7,74867472,74867622,0,59116705
HepG2|chr7:15788892-15788955,chr7,15788892,15788955,HepG2|chr7:77163525-77163579,chr7,77163525,77163579,0,61374633
HepG2|chr7:15875095-15875154,chr7,15875095,15875154,HepG2|chr7:65338716-65338795,chr7,65338716,65338795,0,49463621
HepG2|chr7:16071121-16071209,chr7,16071121,16071209,HepG2|chr7:134857182-134857222,chr7,134857182,134857222,0,118786061
HepG2|chr7:16288546-16288675,chr7,16288546,16288675,HepG2|chr7:41744261-41744282,chr7,41744261,41744282,0,25455715
HepG2|chr7:16409839-16409915,chr7,16409839,16409915,HepG2|chr7:100426579-100426676,chr7,100426579,100426676,0,84016740
HepG2|chr7:16486614-16486679,chr7,16486614,16486679,HepG2|chr7:72726255-72726321,chr7,72726255,72726321,0,56239641
HepG2|chr7:16604746-16604866,chr7,16604746,16604866,HepG2|chr7:41744259-41744282,chr7,41744259,41744282,0,25139513
HepG2|chr7:17040383-17040532,chr7,17040383,17040532,HepG2|chr7:73184787-73184807,chr7,73184787,73184807,0,56144404
HepG2|chr7:17127040-17127159,chr7,17127040,17127159,HepG2|chr7:75113905-75113963,chr7,75113905,75113963,0,57986865
HepG2|chr7:17257098-17257195,chr7,17257098,17257195,HepG2|chr7:75113873-75114020,chr7,75113873,75114020,0,57856775
HepG2|chr7:17536575-17536652,chr7,17536575,17536652,HepG2|chr7:75113875-75113962,chr7,75113875,75113962,0,57577300
HepG2|chr7:17695100-17695250,chr7,17695100,17695250,HepG2|chr7:65338723-65338792,chr7,65338723,65338792,0,47643623
HepG2|chr7:17819353-17819451,chr7,17819353,17819451,HepG2|chr7:121788033-121788182,chr7,121788033,121788182,0,103968680
HepG2|chr7:18235526-18235655,chr7,18235526,18235655,HepG2|chr7:99937962-99938105,chr7,99937962,99938105,0,81702436
HepG2|chr7:18691755-18691904,chr7,18691755,18691904,HepG2|chr7:99934693-99934808,chr7,99934693,99934808,0,81242938
HepG2|chr7:19836689-19836818,chr7,19836689,19836818,HepG2|chr7:41744259-41744277,chr7,41744259,41744277,0,21907570
HepG2|chr7:19958215-19958365,chr7,19958215,19958365,HepG2|chr7:30327602-30327752,chr7,30327602,30327752,0,10369387
HepG2|chr7:20202696-20202845,chr7,20202696,20202845,HepG2|chr7:74867470-74867620,chr7,74867470,74867620,0,54664774
HepG2|chr7:20285840-20285983,chr7,20285840,20285983,HepG2|chr7:74867480-74867630,chr7,74867480,74867630,0,54581640
HepG2|chr7:20445429-20445579,chr7,20445429,20445579,HepG2|chr7:102004838-102004988,chr7,102004838,102004988,0,81559409
HepG2|chr7:20775982-20776129,chr7,20775982,20776129,HepG2|chr7:65338717-65338798,chr7,65338717,65338798,0,44562735
HepG2|chr7:21090726-21090876,chr7,21090726,21090876,HepG2|chr7:99934671-99934731,chr7,99934671,99934731,0,78843945
HepG2|chr7:21496946-21497075,chr7,21496946,21497075,HepG2|chr7:99937962-99938105,chr7,99937962,99938105,0,78441016
HepG2|chr7:21521043-21521113,chr7,21521043,21521113,HepG2|chr7:139767737-139767809,chr7,139767737,139767809,0,118246694
HepG2|chr7:21977594-21977679,chr7,21977594,21977679,HepG2|chr7:6748596-6748670,chr7,6748596,6748670,0,15228998
HepG2|chr7:22390811-22390955,chr7,22390811,22390955,HepG2|chr7:99934693-99934837,chr7,99934693,99934837,0,77543882
HepG2|chr7:22647259-22647339,chr7,22647259,22647339,HepG2|chr7:75114831-75114901,chr7,75114831,75114901,0,52467572
HepG2|chr7:22728956-22729106,chr7,22728956,22729106,HepG2|chr7:74867569-74867618,chr7,74867569,74867618,0,52138613
HepG2|chr7:22786502-22786523,chr7,22786502,22786523,HepG2|chr7:121788175-121788303,chr7,121788175,121788303,0,99001673
HepG2|chr7:22933267-22933288,chr7,22933267,22933288,HepG2|chr7:121788175-121788303,chr7,121788175,121788303,0,98854908
HepG2|chr7:23812732-23812882,chr7,23812732,23812882,HepG2|chr7:99744593-99744686,chr7,99744593,99744686,0,75931861
HepG2|chr7:23873787-23873886,chr7,23873787,23873886,HepG2|chr7:41744259-41744282,chr7,41744259,41744282,0,17870472
HepG2|chr7:23920043-23920165,chr7,23920043,23920165,HepG2|chr7:99934497-99934644,chr7,99934497,99934644,0,76014454
HepG2|chr7:24146410-24146554,chr7,24146410,24146554,HepG2|chr7:99934603-99934702,chr7,99934603,99934702,0,75788193
HepG2|chr7:24457680-24457791,chr7,24457680,24457791,HepG2|chr7:99934710-99934860,chr7,99934710,99934860,0,75477030
HepG2|chr7:24987953-24988050,chr7,24987953,24988050,HepG2|chr7:75618047-75618100,chr7,75618047,75618100,0,50630094
HepG2|chr7:25270088-25270238,chr7,25270088,25270238,HepG2|chr7:101461730-101461776,chr7,101461730,101461776,0,76191642
HepG2|chr7:25608834-25608926,chr7,25608834,25608926,HepG2|chr7:41744259-41744282,chr7,41744259,41744282,0,16135425
HepG2|chr7:25860972-25861119,chr7,25860972,25861119,HepG2|chr7:65338717-65338818,chr7,65338717,65338818,0,39477745
HepG2|chr7:26043756-26043851,chr7,26043756,26043851,HepG2|chr7:72460119-72460257,chr7,72460119,72460257,0,46416363
HepG2|chr7:26049145-26049187,chr7,26049145,26049187,HepG2|chr7:45146281-45146366,chr7,45146281,45146366,0,19097136
HepG2|chr7:26217002-26217143,chr7,26217002,26217143,HepG2|chr7:74867489-74867622,chr7,74867489,74867622,0,48650487
HepG2|chr7:26291637-26291743,chr7,26291637,26291743,HepG2|chr7:65338723-65338811,chr7,65338723,65338811,0,39047086
HepG2|chr7:26420200-26420334,chr7,26420200,26420334,HepG2|chr7:99934636-99934786,chr7,99934636,99934786,0,73514436
HepG2|chr7:26463654-26463681,chr7,26463654,26463681,HepG2|chr7:41744259-41744283,chr7,41744259,41744283,0,15280605
HepG2|chr7:26630126-26630162,chr7,26630126,26630162,HepG2|chr7:134860435-134860556,chr7,134860435,134860556,0,108230309
HepG2|chr7:26894558-26894603,chr7,26894558,26894603,HepG2|chr7:56121918-56122023,chr7,56121918,56122023,0,29227360
HepG2|chr7:27015808-27015946,chr7,27015808,27015946,HepG2|chr7:99934693-99934825,chr7,99934693,99934825,0,72918885
HepG2|chr7:27445872-27445994,chr7,27445872,27445994,HepG2|chr7:99934497-99934644,chr7,99934497,99934644,0,72488625
HepG2|chr7:27459475-27459497,chr7,27459475,27459497,HepG2|chr7:6748619-6748670,chr7,6748619,6748670,0,20710856
HepG2|chr7:27561850-27561948,chr7,27561850,27561948,HepG2|chr7:74866412-74866562,chr7,74866412,74866562,0,47304562
HepG2|chr7:28179052-28179186,chr7,28179052,28179186,HepG2|chr7:99934636-99934786,chr7,99934636,99934786,0,71755584
HepG2|chr7:28376887-28376992,chr7,28376887,28376992,HepG2|chr7:44835404-44835549,chr7,44835404,44835549,0,16458517
HepG2|chr7:29129588-29129728,chr7,29129588,29129728,HepG2|chr7:99934693-99934835,chr7,99934693,99934835,0,70805105
HepG2|chr7:29312081-29312196,chr7,29312081,29312196,HepG2|chr7:41744259-41744282,chr7,41744259,41744282,0,12432178
HepG2|chr7:29611128-29611272,chr7,29611128,29611272,HepG2|chr7:74867491-74867641,chr7,74867491,74867641,0,45256363
HepG2|chr7:30330965-30331108,chr7,30330965,30331108,HepG2|chr7:74867480-74867630,chr7,74867480,74867630,0,44536515
HepG2|chr7:30837240-30837369,chr7,30837240,30837369,HepG2|chr7:74867491-74867641,chr7,74867491,74867641,0,44030251
HepG2|chr7:31224749-31224863,chr7,31224749,31224863,HepG2|chr7:99934671-99934821,chr7,99934671,99934821,0,68709922
HepG2|chr7:31252865-31252904,chr7,31252865,31252904,HepG2|chr7:56121918-56122029,chr7,56121918,56122029,0,24869053
HepG2|chr7:31356538-31356688,chr7,31356538,31356688,HepG2|chr7:102004838-102004988,chr7,102004838,102004988,0,70648300
HepG2|chr7:31457607-31457752,chr7,31457607,31457752,HepG2|chr7:29720482-29720631,chr7,29720482,29720631,0,1737125
HepG2|chr7:31556916-31557053,chr7,31556916,31557053,HepG2|chr7:99934669-99934819,chr7,99934669,99934819,0,68377753
HepG2|chr7:31767355-31767410,chr7,31767355,31767410,HepG2|chr7:134859232-134859304,chr7,134859232,134859304,0,103091877
HepG2|chr7:32098062-32098209,chr7,32098062,32098209,HepG2|chr7:65338732-65338788,chr7,65338732,65338788,0,33240670
HepG2|chr7:32772525-32772561,chr7,32772525,32772561,HepG2|chr7:134860435-134860556,chr7,134860435,134860556,0,102087910
HepG2|chr7:33062281-33062431,chr7,33062281,33062431,HepG2|chr7:99934693-99934829,chr7,99934693,99934829,0,66872412
HepG2|chr7:33073399-33073507,chr7,33073399,33073507,HepG2|chr7:99934766-99934916,chr7,99934766,99934916,0,66861367
HepG2|chr7:33576794-33576885,chr7,33576794,33576885,HepG2|chr7:102004840-102004990,chr7,102004840,102004990,0,68428046
HepG2|chr7:33887892-33887949,chr7,33887892,33887949,HepG2|chr7:99744593-99744686,chr7,99744593,99744686,0,65856701
HepG2|chr7:34257783-34257874,chr7,34257783,34257874,HepG2|chr7:102004840-102004990,chr7,102004840,102004990,0,67747057
HepG2|chr7:34350807-34350893,chr7,34350807,34350893,HepG2|chr7:2395797-2395947,chr7,2395797,2395947,0,31955010
HepG2|chr7:34409607-34409704,chr7,34409607,34409704,HepG2|chr7:102005966-102006035,chr7,102005966,102006035,0,67596359
HepG2|chr7:34780744-34780892,chr7,34780744,34780892,HepG2|chr7:74867578-74867629,chr7,74867578,74867629,0,40086834
HepG2|chr7:35120888-35120946,chr7,35120888,35120946,HepG2|chr7:72726255-72726321,chr7,72726255,72726321,0,37605367
HepG2|chr7:35176696-35176750,chr7,35176696,35176750,HepG2|chr7:121788101-121788251,chr7,121788101,121788251,0,86611405
HepG2|chr7:35749370-35749520,chr7,35749370,35749520,HepG2|chr7:99744593-99744686,chr7,99744593,99744686,0,63995223
HepG2|chr7:36093807-36093936,chr7,36093807,36093936,HepG2|chr7:99934693-99934835,chr7,99934693,99934835,0,63840886
HepG2|chr7:37073566-37073716,chr7,37073566,37073716,HepG2|chr7:75618047-75618100,chr7,75618047,75618100,0,38544481
HepG2|chr7:37538751-37538901,chr7,37538751,37538901,HepG2|chr7:99934867-99935013,chr7,99934867,99935013,0,62396116
HepG2|chr7:37566497-37566535,chr7,37566497,37566535,HepG2|chr7:56121918-56122029,chr7,56121918,56122029,0,18555421
HepG2|chr7:37741035-37741184,chr7,37741035,37741184,HepG2|chr7:99934799-99934923,chr7,99934799,99934923,0,62193764
HepG2|chr7:38394820-38394949,chr7,38394820,38394949,HepG2|chr7:41744259-41744277,chr7,41744259,41744277,0,3349439
HepG2|chr7:38513104-38513254,chr7,38513104,38513254,HepG2|chr7:65338717-65338776,chr7,65338717,65338776,0,26825613
HepG2|chr7:38708468-38708493,chr7,38708468,38708493,HepG2|chr7:55084253-55084370,chr7,55084253,55084370,0,16375785
HepG2|chr7:38755167-38755199,chr7,38755167,38755199,HepG2|chr7:55001042-55001160,chr7,55001042,55001160,0,16245875
HepG2|chr7:38831457-38831604,chr7,38831457,38831604,HepG2|chr7:65338722-65338763,chr7,65338722,65338763,0,26507265
HepG2|chr7:38965391-38965500,chr7,38965391,38965500,HepG2|chr7:74866388-74866538,chr7,74866388,74866538,0,35900997
HepG2|chr7:39045329-39045410,chr7,39045329,39045410,HepG2|chr7:45810479-45810542,chr7,45810479,45810542,0,6765150
HepG2|chr7:39058246-39058361,chr7,39058246,39058361,HepG2|chr7:134860375-134860406,chr7,134860375,134860406,0,95802129
HepG2|chr7:39526776-39526891,chr7,39526776,39526891,HepG2|chr7:41744259-41744282,chr7,41744259,41744282,0,2217483
HepG2|chr7:39639661-39639780,chr7,39639661,39639780,HepG2|chr7:150025858-150025930,chr7,150025858,150025930,0,110386197
HepG2|chr7:39721649-39721730,chr7,39721649,39721730,HepG2|chr7:65338722-65338797,chr7,65338722,65338797,0,25617073
HepG2|chr7:39804793-39804913,chr7,39804793,39804913,HepG2|chr7:41744259-41744282,chr7,41744259,41744282,0,1939466
HepG2|chr7:39905222-39905261,chr7,39905222,39905261,HepG2|chr7:56121918-56122029,chr7,56121918,56122029,0,16216696
HepG2|chr7:39954535-39954640,chr7,39954535,39954640,HepG2|chr7:5607634-5607670,chr7,5607634,5607670,0,34346901
HepG2|chr7:40150181-40150272,chr7,40150181,40150272,HepG2|chr7:75930698-75930797,chr7,75930698,75930797,0,35780517
HepG2|chr7:40670637-40670784,chr7,40670637,40670784,HepG2|chr7:74867472-74867622,chr7,74867472,74867622,0,34196835
HepG2|chr7:41218429-41218534,chr7,41218429,41218534,HepG2|chr7:5607634-5607670,chr7,5607634,5607670,0,35610795
HepG2|chr7:41320114-41320202,chr7,41320114,41320202,HepG2|chr7:134857182-134857222,chr7,134857182,134857222,0,93537068
HepG2|chr7:41633517-41633667,chr7,41633517,41633667,HepG2|chr7:29720567-29720716,chr7,29720567,29720716,0,11912950
HepG2|chr7:41840742-41840866,chr7,41840742,41840866,HepG2|chr7:75113936-75113985,chr7,75113936,75113985,0,33273194
HepG2|chr7:41942334-41942483,chr7,41942334,41942483,HepG2|chr7:29720482-29720631,chr7,29720482,29720631,0,12221852
HepG2|chr7:42099852-42099976,chr7,42099852,42099976,HepG2|chr7:41744259-41744282,chr7,41744259,41744282,0,355593
HepG2|chr7:42181981-42182127,chr7,42181981,42182127,HepG2|chr7:76091147-76091297,chr7,76091147,76091297,0,33909166
HepG2|chr7:42458651-42458700,chr7,42458651,42458700,HepG2|chr7:56121918-56122023,chr7,56121918,56122023,0,13663267
HepG2|chr7:42684021-42684160,chr7,42684021,42684160,HepG2|chr7:65338723-65338771,chr7,65338723,65338771,0,22654702
HepG2|chr7:43552277-43552332,chr7,43552277,43552332,HepG2|chr7:75799215-75799310,chr7,75799215,75799310,0,32246938
HepG2|chr7:43869376-43869524,chr7,43869376,43869524,HepG2|chr7:74867472-74867622,chr7,74867472,74867622,0,30998096
HepG2|chr7:44029802-44029952,chr7,44029802,44029952,HepG2|chr7:29720491-29720638,chr7,29720491,29720638,0,14309311
HepG2|chr7:44225902-44226052,chr7,44225902,44226052,HepG2|chr7:99934671-99934731,chr7,99934671,99934731,0,55708769
HepG2|chr7:44258161-44258243,chr7,44258161,44258243,HepG2|chr7:99746471-99746535,chr7,99746471,99746535,0,55488310
HepG2|chr7:44476225-44476375,chr7,44476225,44476375,HepG2|chr7:99934693-99934827,chr7,99934693,99934827,0,55458468
HepG2|chr7:44573950-44574100,chr7,44573950,44574100,HepG2|chr7:74867480-74867630,chr7,74867480,74867630,0,30293530
HepG2|chr7:45442454-45442604,chr7,45442454,45442604,HepG2|chr7:102251004-102251128,chr7,102251004,102251128,0,56808550
HepG2|chr7:45553787-45553838,chr7,45553787,45553838,HepG2|chr7:75930698-75930797,chr7,75930698,75930797,0,30376911
HepG2|chr7:45634164-45634208,chr7,45634164,45634208,HepG2|chr7:56121943-56122023,chr7,56121943,56122023,0,10487779
HepG2|chr7:46327253-46327319,chr7,46327253,46327319,HepG2|chr7:134857653-134857777,chr7,134857653,134857777,0,88530400
HepG2|chr7:47084672-47084751,chr7,47084672,47084751,HepG2|chr7:99934718-99934868,chr7,99934718,99934868,0,52850046
HepG2|chr7:47322173-47322302,chr7,47322173,47322302,HepG2|chr7:41744259-41744277,chr7,41744259,41744277,0,5577914
HepG2|chr7:47372053-47372101,chr7,47372053,47372101,HepG2|chr7:56121928-56122072,chr7,56121928,56122072,0,8749875
HepG2|chr7:48032516-48032560,chr7,48032516,48032560,HepG2|chr7:56121883-56122025,chr7,56121883,56122025,0,8089367
HepG2|chr7:48470064-48470210,chr7,48470064,48470210,HepG2|chr7:76091147-76091297,chr7,76091147,76091297,0,27621083
HepG2|chr7:48741133-48741223,chr7,48741133,48741223,HepG2|chr7:99934693-99934839,chr7,99934693,99934839,0,51193560
HepG2|chr7:48807627-48807722,chr7,48807627,48807722,HepG2|chr7:72460119-72460257,chr7,72460119,72460257,0,23652492
HepG2|chr7:48832099-48832134,chr7,48832099,48832134,HepG2|chr7:72726255-72726321,chr7,72726255,72726321,0,23894156
HepG2|chr7:49716937-49717042,chr7,49716937,49717042,HepG2|chr7:41744259-41744282,chr7,41744259,41744282,0,7972678
HepG2|chr7:50548613-50548724,chr7,50548613,50548724,HepG2|chr7:77163525-77163631,chr7,77163525,77163631,0,26614912
HepG2|chr7:50794805-50794919,chr7,50794805,50794919,HepG2|chr7:134860400-134860547,chr7,134860400,134860547,0,84065595
HepG2|chr7:51903508-51903537,chr7,51903508,51903537,HepG2|chr7:41744259-41744282,chr7,41744259,41744282,0,10159249
HepG2|chr7:52019530-52019680,chr7,52019530,52019680,HepG2|chr7:41744259-41744277,chr7,41744259,41744277,0,10275271
HepG2|chr7:52215454-52215603,chr7,52215454,52215603,HepG2|chr7:29720482-29720631,chr7,29720482,29720631,0,22494972
HepG2|chr7:52412588-52412667,chr7,52412588,52412667,HepG2|chr7:75004749-75004869,chr7,75004749,75004869,0,22592161
HepG2|chr7:52847002-52847083,chr7,52847002,52847083,HepG2|chr7:74866409-74866505,chr7,74866409,74866505,0,22019407
HepG2|chr7:52906929-52907073,chr7,52906929,52907073,HepG2|chr7:100729415-100729539,chr7,100729415,100729539,0,47822486
HepG2|chr7:53058590-53058611,chr7,53058590,53058611,HepG2|chr7:99746271-99746416,chr7,99746271,99746416,0,46687681
HepG2|chr7:53357121-53357139,chr7,53357121,53357139,HepG2|chr7:55087142-55087255,chr7,55087142,55087255,0,1730021
HepG2|chr7:53427901-53428029,chr7,53427901,53428029,HepG2|chr7:6864858-6864902,chr7,6864858,6864902,0,46563043
HepG2|chr7:53429192-53429314,chr7,53429192,53429314,HepG2|chr7:41744259-41744284,chr7,41744259,41744284,0,11684933
HepG2|chr7:53855772-53855858,chr7,53855772,53855858,HepG2|chr7:99934707-99934831,chr7,99934707,99934831,0,46078935
HepG2|chr7:53924697-53924811,chr7,53924697,53924811,HepG2|chr7:99934693-99934832,chr7,99934693,99934832,0,46009996
HepG2|chr7:54150768-54150789,chr7,54150768,54150789,HepG2|chr7:102794366-102794495,chr7,102794366,102794495,0,48643598
HepG2|chr7:54223763-54223832,chr7,54223763,54223832,HepG2|chr7:139767737-139767809,chr7,139767737,139767809,0,85543974
HepG2|chr7:54516350-54516407,chr7,54516350,54516407,HepG2|chr7:99744593-99744686,chr7,99744593,99744686,0,45228243
HepG2|chr7:54941401-54941453,chr7,54941401,54941453,HepG2|chr7:72351633-72351730,chr7,72351633,72351730,0,17410232
HepG2|chr7:55009305-55009455,chr7,55009305,55009455,HepG2|chr7:99934693-99934823,chr7,99934693,99934823,0,44925388
HepG2|chr7:55419891-55419977,chr7,55419891,55419977,HepG2|chr7:99934707-99934831,chr7,99934707,99934831,0,44514816
HepG2|chr7:55752133-55752262,chr7,55752133,55752262,HepG2|chr7:41744259-41744277,chr7,41744259,41744277,0,14007874
HepG2|chr7:56153162-56153204,chr7,56153162,56153204,HepG2|chr7:45146281-45146366,chr7,45146281,45146366,0,11006881
HepG2|chr7:56867302-56867436,chr7,56867302,56867436,HepG2|chr7:99934653-99934803,chr7,99934653,99934803,0,43067351
HepG2|chr7:56873745-56873772,chr7,56873745,56873772,HepG2|chr7:55084896-55085019,chr7,55084896,55085019,0,1788849
HepG2|chr7:56939713-56939792,chr7,56939713,56939792,HepG2|chr7:75004749-75004869,chr7,75004749,75004869,0,18065036
HepG2|chr7:57583037-57583161,chr7,57583037,57583161,HepG2|chr7:41744259-41744282,chr7,41744259,41744282,0,15838778
HepG2|chr7:57754016-57754165,chr7,57754016,57754165,HepG2|chr7:102251004-102251128,chr7,102251004,102251128,0,44496988
HepG2|chr7:57821033-57821183,chr7,57821033,57821183,HepG2|chr7:99934867-99935013,chr7,99934867,99935013,0,42113834
HepG2|chr7:57826628-57826774,chr7,57826628,57826774,HepG2|chr7:30327451-30327498,chr7,30327451,30327498,0,27499177
HepG2|chr7:58064474-58064621,chr7,58064474,58064621,HepG2|chr7:100729415-100729539,chr7,100729415,100729539,0,42664941
HepG2|chr7:58110867-58111006,chr7,58110867,58111006,HepG2|chr7:99746471-99746535,chr7,99746471,99746535,0,41635604
HepG2|chr7:58564748-58564769,chr7,58564748,58564769,HepG2|chr7:102794366-102794495,chr7,102794366,102794495,0,44229618
HepG2|chr7:58565278-58565375,chr7,58565278,58565375,HepG2|chr7:102005966-102006035,chr7,102005966,102006035,0,43440688
HepG2|chr7:58969557-58969648,chr7,58969557,58969648,HepG2|chr7:99934670-99934820,chr7,99934670,99934820,0,40965113
HepG2|chr7:59410821-59410964,chr7,59410821,59410964,HepG2|chr7:102004837-102004987,chr7,102004837,102004987,0,42594016
HepG2|chr7:60243856-60244006,chr7,60243856,60244006,HepG2|chr7:74867480-74867630,chr7,74867480,74867630,0,14623624
HepG2|chr7:60490086-60490215,chr7,60490086,60490215,HepG2|chr7:74867491-74867641,chr7,74867491,74867641,0,14377405
HepG2|chr7:60902785-60902889,chr7,60902785,60902889,HepG2|chr7:44837502-44837574,chr7,44837502,44837574,0,16065283
HepG2|chr7:61299528-61299610,chr7,61299528,61299610,HepG2|chr7:23568908-23568960,chr7,23568908,23568960,0,37730620
HepG2|chr7:61337891-61337941,chr7,61337891,61337941,HepG2|chr7:74311328-74311385,chr7,74311328,74311385,0,12973437
HepG2|chr7:61779327-61779477,chr7,61779327,61779477,HepG2|chr7:74867473-74867622,chr7,74867473,74867622,0,13088146
HepG2|chr7:62634178-62634328,chr7,62634178,62634328,HepG2|chr7:74867480-74867630,chr7,74867480,74867630,0,12233302
HepG2|chr7:63118906-63118945,chr7,63118906,63118945,HepG2|chr7:56121918-56122029,chr7,56121918,56122029,0,6996988
HepG2|chr7:63348765-63348851,chr7,63348765,63348851,HepG2|chr7:45810486-45810542,chr7,45810486,45810542,0,17538279
HepG2|chr7:63354339-63354421,chr7,63354339,63354421,HepG2|chr7:92465723-92465787,chr7,92465723,92465787,0,29111384
HepG2|chr7:63472039-63472120,chr7,63472039,63472120,HepG2|chr7:45810479-45810542,chr7,45810479,45810542,0,17661560
HepG2|chr7:63510059-63510199,chr7,63510059,63510199,HepG2|chr7:99934693-99934835,chr7,99934693,99934835,0,36424634
HepG2|chr7:63767316-63767371,chr7,63767316,63767371,HepG2|chr7:134859232-134859304,chr7,134859232,134859304,0,71091916
HepG2|chr7:64128412-64128562,chr7,64128412,64128562,HepG2|chr7:65338723-65338782,chr7,65338723,65338782,0,1210311
HepG2|chr7:64483779-64483928,chr7,64483779,64483928,HepG2|chr7:74381648-74381711,chr7,74381648,74381711,0,9897869
HepG2|chr7:64925419-64925560,chr7,64925419,64925560,HepG2|chr7:99934693-99934835,chr7,99934693,99934835,0,35009274
HepG2|chr7:65075286-65075359,chr7,65075286,65075359,HepG2|chr7:75799258-75799335,chr7,75799258,75799335,0,10723972
HepG2|chr7:65853938-65854052,chr7,65853938,65854052,HepG2|chr7:55001042-55001160,chr7,55001042,55001160,0,10852896
HepG2|chr7:66255887-66256035,chr7,66255887,66256035,HepG2|chr7:74867578-74867629,chr7,74867578,74867629,0,8611691
HepG2|chr7:66613226-66613312,chr7,66613226,66613312,HepG2|chr7:99934513-99934663,chr7,99934513,99934663,0,33321287
HepG2|chr7:66616713-66616852,chr7,66616713,66616852,HepG2|chr7:99934693-99934827,chr7,99934693,99934827,0,33317980
HepG2|chr7:66760977-66761042,chr7,66760977,66761042,HepG2|chr7:72726255-72726321,chr7,72726255,72726321,0,5965278
HepG2|chr7:67633767-67633845,chr7,67633767,67633845,HepG2|chr7:44837502-44837574,chr7,44837502,44837574,0,22796265
HepG2|chr7:67964289-67964314,chr7,67964289,67964314,HepG2|chr7:134857653-134857777,chr7,134857653,134857777,0,66893364
HepG2|chr7:68248836-68248986,chr7,68248836,68248986,HepG2|chr7:73184787-73184807,chr7,73184787,73184807,0,4935951
HepG2|chr7:68304397-68304513,chr7,68304397,68304513,HepG2|chr7:76091083-76091232,chr7,76091083,76091232,0,7786686
HepG2|chr7:68585814-68585841,chr7,68585814,68585841,HepG2|chr7:41744259-41744283,chr7,41744259,41744283,0,26841555
HepG2|chr7:68699675-68699825,chr7,68699675,68699825,HepG2|chr7:65338723-65338795,chr7,65338723,65338795,0,3360952
HepG2|chr7:68808499-68808542,chr7,68808499,68808542,HepG2|chr7:56121928-56122028,chr7,56121928,56122028,0,12686571
HepG2|chr7:68876611-68876732,chr7,68876611,68876732,HepG2|chr7:41744259-41744285,chr7,41744259,41744285,0,27132352
HepG2|chr7:69017624-69017774,chr7,69017624,69017774,HepG2|chr7:75618047-75618100,chr7,75618047,75618100,0,6600423
HepG2|chr7:69036262-69036391,chr7,69036262,69036391,HepG2|chr7:41744259-41744277,chr7,41744259,41744277,0,27292003
HepG2|chr7:69291589-69291692,chr7,69291589,69291692,HepG2|chr7:75928009-75928045,chr7,75928009,75928045,0,6636420
HepG2|chr7:69321955-69322026,chr7,69321955,69322026,HepG2|chr7:6519792-6519871,chr7,6519792,6519871,0,62802163
HepG2|chr7:70307064-70307211,chr7,70307064,70307211,HepG2|chr7:74381609-74381682,chr7,74381609,74381682,0,4074545
HepG2|chr7:70364285-70364435,chr7,70364285,70364435,HepG2|chr7:41744259-41744285,chr7,41744259,41744285,0,28620026
HepG2|chr7:70481121-70481243,chr7,70481121,70481243,HepG2|chr7:134860410-134860438,chr7,134860410,134860438,0,64379289
HepG2|chr7:70603531-70603579,chr7,70603531,70603579,HepG2|chr7:74311337-74311386,chr7,74311337,74311386,0,3707806
HepG2|chr7:70647572-70647707,chr7,70647572,70647707,HepG2|chr7:134860126-134860276,chr7,134860126,134860276,0,64212554
HepG2|chr7:70806530-70806680,chr7,70806530,70806680,HepG2|chr7:65338723-65338795,chr7,65338723,65338795,0,5467807
HepG2|chr7:70819645-70819683,chr7,70819645,70819683,HepG2|chr7:56121918-56122029,chr7,56121918,56122029,0,14697727
HepG2|chr7:71143443-71143593,chr7,71143443,71143593,HepG2|chr7:65338723-65338820,chr7,65338723,65338820,0,5804720
HepG2|chr7:71618332-71618451,chr7,71618332,71618451,HepG2|chr7:75113905-75113963,chr7,75113905,75113963,0,3495573
HepG2|chr7:71794517-71794620,chr7,71794517,71794620,HepG2|chr7:75928009-75928045,chr7,75928009,75928045,0,4133492
HepG2|chr7:72019823-72019921,chr7,72019823,72019921,HepG2|chr7:99934693-99934821,chr7,99934693,99934821,0,27914870
HepG2|chr7:72030019-72030135,chr7,72030019,72030135,HepG2|chr7:99934499-99934621,chr7,99934499,99934621,0,27904480
HepG2|chr7:72333397-72333547,chr7,72333397,72333547,HepG2|chr7:30327601-30327751,chr7,30327601,30327751,0,42005796
HepG2|chr7:72748841-72748991,chr7,72748841,72748991,HepG2|chr7:65338721-65338784,chr7,65338721,65338784,0,7410120
HepG2|chr7:72757908-72758022,chr7,72757908,72758022,HepG2|chr7:55001042-55001160,chr7,55001042,55001160,0,17756866
HepG2|chr7:72843844-72843930,chr7,72843844,72843930,HepG2|chr7:2395797-2395947,chr7,2395797,2395947,0,70448047
HepG2|chr7:72991436-72991583,chr7,72991436,72991583,HepG2|chr7:65338717-65338818,chr7,65338717,65338818,0,7652719
HepG2|chr7:73115408-73115535,chr7,73115408,73115535,HepG2|chr7:72460117-72460230,chr7,72460117,72460230,0,655291
HepG2|chr7:73259725-73259754,chr7,73259725,73259754,HepG2|chr7:41744259-41744282,chr7,41744259,41744282,0,31515466
HepG2|chr7:73430721-73430871,chr7,73430721,73430871,HepG2|chr7:134860485-134860558,chr7,134860485,134860558,0,61429764
HepG2|chr7:73633617-73633756,chr7,73633617,73633756,HepG2|chr7:102794472-102794507,chr7,102794472,102794507,0,29160855
HepG2|chr7:73673890-73674015,chr7,73673890,73674015,HepG2|chr7:121788282-121788303,chr7,121788282,121788303,0,48114392
HepG2|chr7:73719567-73719665,chr7,73719567,73719665,HepG2|chr7:74866412-74866562,chr7,74866412,74866562,0,1146845
HepG2|chr7:73964933-73964958,chr7,73964933,73964958,HepG2|chr7:134857653-134857777,chr7,134857653,134857777,0,60892720
HepG2|chr7:74136864-74136975,chr7,74136864,74136975,HepG2|chr7:99934710-99934860,chr7,99934710,99934860,0,25797846
HepG2|chr7:74465703-74465750,chr7,74465703,74465750,HepG2|chr7:5607634-5607670,chr7,5607634,5607670,0,68858069
HepG2|chr7:74747612-74747670,chr7,74747612,74747670,HepG2|chr7:72726255-72726321,chr7,72726255,72726321,0,2021357
HepG2|chr7:74810037-74810082,chr7,74810037,74810082,HepG2|chr7:56121918-56122023,chr7,56121918,56122023,0,18688119
HepG2|chr7:75011630-75011780,chr7,75011630,75011780,HepG2|chr7:41744259-41744285,chr7,41744259,41744285,0,33267371
HepG2|chr7:75028063-75028189,chr7,75028063,75028189,HepG2|chr7:41744259-41744280,chr7,41744259,41744280,0,33283804
HepG2|chr7:75172256-75172331,chr7,75172256,75172331,HepG2|chr7:5631793-5631943,chr7,5631793,5631943,0,69540463
HepG2|chr7:75560616-75560682,chr7,75560616,75560682,HepG2|chr7:41744259-41744282,chr7,41744259,41744282,0,33816357
HepG2|chr7:75942599-75942672,chr7,75942599,75942672,HepG2|chr7:75799258-75799335,chr7,75799258,75799335,0,143341
HepG2|chr7:76002613-76002672,chr7,76002613,76002672,HepG2|chr7:65338716-65338795,chr7,65338716,65338795,0,10663897
HepG2|chr7:76126907-76126981,chr7,76126907,76126981,HepG2|chr7:74866405-74866537,chr7,74866405,74866537,0,1260502
HepG2|chr7:76496810-76496884,chr7,76496810,76496884,HepG2|chr7:150025858-150025930,chr7,150025858,150025930,0,73529048
HepG2|chr7:76508410-76508500,chr7,76508410,76508500,HepG2|chr7:134860441-134860556,chr7,134860441,134860556,0,58352031
HepG2|chr7:76571956-76571982,chr7,76571956,76571982,HepG2|chr7:41744259-41744283,chr7,41744259,41744283,0,34827697
HepG2|chr7:76579794-76579831,chr7,76579794,76579831,HepG2|chr7:102004837-102004987,chr7,102004837,102004987,0,25425043
HepG2|chr7:76675513-76675659,chr7,76675513,76675659,HepG2|chr7:65338726-65338828,chr7,65338726,65338828,0,11336787
HepG2|chr7:76910206-76910356,chr7,76910206,76910356,HepG2|chr7:75113932-75113980,chr7,75113932,75113980,0,1796274
HepG2|chr7:76958074-76958164,chr7,76958074,76958164,HepG2|chr7:99934693-99934839,chr7,99934693,99934839,0,22976619
HepG2|chr7:77157030-77157180,chr7,77157030,77157180,HepG2|chr7:150023749-150023788,chr7,150023749,150023788,0,72866719
HepG2|chr7:77413238-77413388,chr7,77413238,77413388,HepG2|chr7:74867470-74867620,chr7,74867470,74867620,0,2545768
HepG2|chr7:77565662-77565776,chr7,77565662,77565776,HepG2|chr7:134860400-134860547,chr7,134860400,134860547,0,57294738
HepG2|chr7:77604024-77604174,chr7,77604024,77604174,HepG2|chr7:65338722-65338809,chr7,65338722,65338809,0,12265302
HepG2|chr7:77635666-77635701,chr7,77635666,77635701,HepG2|chr7:72726255-72726321,chr7,72726255,72726321,0,4909411
HepG2|chr7:78691225-78691354,chr7,78691225,78691354,HepG2|chr7:99934693-99934835,chr7,99934693,99934835,0,21243468
HepG2|chr7:78792597-78792747,chr7,78792597,78792747,HepG2|chr7:74381490-74381640,chr7,74381490,74381640,0,4411107
HepG2|chr7:78946665-78946815,chr7,78946665,78946815,HepG2|chr7:30327602-30327752,chr7,30327602,30327752,0,48619063
HepG2|chr7:78988361-78988510,chr7,78988361,78988510,HepG2|chr7:74867470-74867619,chr7,74867470,74867619,0,4120891
HepG2|chr7:79574893-79575009,chr7,79574893,79575009,HepG2|chr7:99934693-99934837,chr7,99934693,99934837,0,20359800
HepG2|chr7:79760560-79760675,chr7,79760560,79760675,HepG2|chr7:134860375-134860406,chr7,134860375,134860406,0,55099815
HepG2|chr7:79830107-79830213,chr7,79830107,79830213,HepG2|chr7:5628358-5628396,chr7,5628358,5628396,0,74201749
HepG2|chr7:80707144-80707169,chr7,80707144,80707169,HepG2|chr7:44620961-44621111,chr7,44620961,44621111,0,36086183
HepG2|chr7:80783704-80783826,chr7,80783704,80783826,HepG2|chr7:134860410-134860438,chr7,134860410,134860438,0,54076706
HepG2|chr7:81271769-81271919,chr7,81271769,81271919,HepG2|chr7:74867511-74867661,chr7,74867511,74867661,0,6404258
HepG2|chr7:82523583-82523729,chr7,82523583,82523729,HepG2|chr7:74867479-74867629,chr7,74867479,74867629,0,7656104
HepG2|chr7:83054455-83054530,chr7,83054455,83054530,HepG2|chr7:5631793-5631943,chr7,5631793,5631943,0,77422662
HepG2|chr7:83099841-83099987,chr7,83099841,83099987,HepG2|chr7:99934693-99934839,chr7,99934693,99934839,0,16834852
HepG2|chr7:83203770-83203920,chr7,83203770,83203920,HepG2|chr7:29720495-29720641,chr7,29720495,29720641,0,53483275
HepG2|chr7:83247311-83247420,chr7,83247311,83247420,HepG2|chr7:74866388-74866480,chr7,74866388,74866480,0,8380923
HepG2|chr7:83261459-83261540,chr7,83261459,83261540,HepG2|chr7:134859765-134859838,chr7,134859765,134859838,0,51598306
HepG2|chr7:83342979-83343129,chr7,83342979,83343129,HepG2|chr7:41744261-41744282,chr7,41744261,41744282,0,41598718
HepG2|chr7:83414195-83414340,chr7,83414195,83414340,HepG2|chr7:65338723-65338782,chr7,65338723,65338782,0,18075472
HepG2|chr7:83483930-83484080,chr7,83483930,83484080,HepG2|chr7:65338723-65338820,chr7,65338723,65338820,0,18145207
HepG2|chr7:83619280-83619430,chr7,83619280,83619430,HepG2|chr7:74867471-74867621,chr7,74867471,74867621,0,8751809
HepG2|chr7:84010502-84010652,chr7,84010502,84010652,HepG2|chr7:74867480-74867630,chr7,74867480,74867630,0,9143022
HepG2|chr7:84072922-84072965,chr7,84072922,84072965,HepG2|chr7:56121928-56122028,chr7,56121928,56122028,0,27950994
HepG2|chr7:84163900-84163998,chr7,84163900,84163998,HepG2|chr7:99934693-99934821,chr7,99934693,99934821,0,15770793
HepG2|chr7:84284925-84284988,chr7,84284925,84284988,HepG2|chr7:77163525-77163579,chr7,77163525,77163579,0,7121400
HepG2|chr7:84333221-84333349,chr7,84333221,84333349,HepG2|chr7:73184787-73184807,chr7,73184787,73184807,0,11148434
HepG2|chr7:84427208-84427358,chr7,84427208,84427358,HepG2|chr7:72460886-72461036,chr7,72460886,72461036,0,11966322
HepG2|chr7:84723985-84724135,chr7,84723985,84724135,HepG2|chr7:74867472-74867622,chr7,74867472,74867622,0,9856513
HepG2|chr7:84828992-84829142,chr7,84828992,84829142,HepG2|chr7:30327055-30327205,chr7,30327055,30327205,0,54501937
HepG2|chr7:84892163-84892313,chr7,84892163,84892313,HepG2|chr7:65338721-65338784,chr7,65338721,65338784,0,19553442
HepG2|chr7:85558747-85558860,chr7,85558747,85558860,HepG2|chr7:74867497-74867621,chr7,74867497,74867621,0,10691250
HepG2|chr7:85595801-85595885,chr7,85595801,85595885,HepG2|chr7:54999980-55000071,chr7,54999980,55000071,0,30595821
HepG2|chr7:85659218-85659265,chr7,85659218,85659265,HepG2|chr7:56121928-56122028,chr7,56121928,56122028,0,29537290
HepG2|chr7:85796234-85796384,chr7,85796234,85796384,HepG2|chr7:134860412-134860556,chr7,134860412,134860556,0,49064178
HepG2|chr7:85831115-85831159,chr7,85831115,85831159,HepG2|chr7:134860418-134860565,chr7,134860418,134860565,0,49029303
HepG2|chr7:86156493-86156518,chr7,86156493,86156518,HepG2|chr7:55084253-55084370,chr7,55084253,55084370,0,31072240
HepG2|chr7:86453402-86453458,chr7,86453402,86453458,HepG2|chr7:75114794-75114934,chr7,75114794,75114934,0,11338608
HepG2|chr7:86950621-86950755,chr7,86950621,86950755,HepG2|chr7:99934693-99934831,chr7,99934693,99934831,0,12984072
HepG2|chr7:87024592-87024646,chr7,87024592,87024646,HepG2|chr7:74867506-74867646,chr7,74867506,74867646,0,12157086
HepG2|chr7:87107705-87107841,chr7,87107705,87107841,HepG2|chr7:65338719-65338806,chr7,65338719,65338806,0,21768986
HepG2|chr7:87128111-87128220,chr7,87128111,87128220,HepG2|chr7:74866388-74866480,chr7,74866388,74866480,0,12261723
HepG2|chr7:87460999-87461133,chr7,87460999,87461133,HepG2|chr7:99934653-99934803,chr7,99934653,99934803,0,12473654
HepG2|chr7:87570579-87570606,chr7,87570579,87570606,HepG2|chr7:55084896-55085019,chr7,55084896,55085019,0,32485683
HepG2|chr7:87758161-87758311,chr7,87758161,87758311,HepG2|chr7:74867484-74867631,chr7,74867484,74867631,0,12890677
HepG2|chr7:87898734-87898884,chr7,87898734,87898884,HepG2|chr7:134860412-134860556,chr7,134860412,134860556,0,46961678
HepG2|chr7:88296888-88297034,chr7,88296888,88297034,HepG2|chr7:74867479-74867629,chr7,74867479,74867629,0,13429409
HepG2|chr7:88301491-88301547,chr7,88301491,88301547,HepG2|chr7:75114794-75114934,chr7,75114794,75114934,0,13186697
HepG2|chr7:88855593-88855615,chr7,88855593,88855615,HepG2|chr7:130794056-130794206,chr7,130794056,130794206,0,41938463
HepG2|chr7:89128525-89128669,chr7,89128525,89128669,HepG2|chr7:65338717-65338774,chr7,65338717,65338774,0,23789808
HepG2|chr7:89158010-89158088,chr7,89158010,89158088,HepG2|chr7:44837502-44837574,chr7,44837502,44837574,0,44320508
HepG2|chr7:90139660-90139804,chr7,90139660,90139804,HepG2|chr7:99934693-99934837,chr7,99934693,99934837,0,9795033
HepG2|chr7:90284950-90285077,chr7,90284950,90285077,HepG2|chr7:72460117-72460230,chr7,72460117,72460230,0,17824833
HepG2|chr7:90317811-90317958,chr7,90317811,90317958,HepG2|chr7:74381609-74381682,chr7,74381609,74381682,0,15936202
HepG2|chr7:90653617-90653753,chr7,90653617,90653753,HepG2|chr7:65338719-65338806,chr7,65338719,65338806,0,25314898
HepG2|chr7:90760658-90760805,chr7,90760658,90760805,HepG2|chr7:102247028-102247178,chr7,102247028,102247178,0,11486370
HepG2|chr7:90818906-90819006,chr7,90818906,90819006,HepG2|chr7:74867472-74867622,chr7,74867472,74867622,0,15951434
HepG2|chr7:91385816-91385867,chr7,91385816,91385867,HepG2|chr7:75930698-75930797,chr7,75930698,75930797,0,15455118
HepG2|chr7:91630901-91631025,chr7,91630901,91631025,HepG2|chr7:99934693-99934826,chr7,99934693,99934826,0,8303792
HepG2|chr7:91667136-91667177,chr7,91667136,91667177,HepG2|chr7:56121979-56122029,chr7,56121979,56122029,0,35545157
HepG2|chr7:91730621-91730687,chr7,91730621,91730687,HepG2|chr7:55087189-55087337,chr7,55087189,55087337,0,36643432
HepG2|chr7:91784286-91784356,chr7,91784286,91784356,HepG2|chr7:139767737-139767809,chr7,139767737,139767809,0,47983451
HepG2|chr7:92640514-92640664,chr7,92640514,92640664,HepG2|chr7:74867473-74867623,chr7,74867473,74867623,0,17773041
HepG2|chr7:92989846-92989992,chr7,92989846,92989992,HepG2|chr7:99934693-99934839,chr7,99934693,99934839,0,6944847
HepG2|chr7:94058703-94058805,chr7,94058703,94058805,HepG2|chr7:99934709-99934854,chr7,99934709,99934854,0,5876006
HepG2|chr7:94459377-94459526,chr7,94459377,94459526,HepG2|chr7:74867470-74867620,chr7,74867470,74867620,0,19591907
HepG2|chr7:94461456-94461604,chr7,94461456,94461604,HepG2|chr7:65338719-65338765,chr7,65338719,65338765,0,29122737
HepG2|chr7:94795765-94795856,chr7,94795765,94795856,HepG2|chr7:99934670-99934820,chr7,99934670,99934820,0,5138905
HepG2|chr7:95008607-95008757,chr7,95008607,95008757,HepG2|chr7:30327602-30327752,chr7,30327602,30327752,0,64681005
HepG2|chr7:95466143-95466207,chr7,95466143,95466207,HepG2|chr7:75004675-75004811,chr7,75004675,75004811,0,20461468
HepG2|chr7:95908081-95908178,chr7,95908081,95908178,HepG2|chr7:74379940-74380047,chr7,74379940,74380047,0,21528141
HepG2|chr7:96043297-96043345,chr7,96043297,96043345,HepG2|chr7:56121928-56122072,chr7,56121928,56122072,0,39921369
HepG2|chr7:96406370-96406405,chr7,96406370,96406405,HepG2|chr7:134860441-134860556,chr7,134860441,134860556,0,38454071
HepG2|chr7:96511506-96511646,chr7,96511506,96511646,HepG2|chr7:74867471-74867620,chr7,74867471,74867620,0,21644035
HepG2|chr7:96799647-96799686,chr7,96799647,96799686,HepG2|chr7:121786659-121786712,chr7,121786659,121786712,0,24987012
HepG2|chr7:96816068-96816135,chr7,96816068,96816135,HepG2|chr7:5607634-5607670,chr7,5607634,5607670,0,91208434
HepG2|chr7:96945849-96945908,chr7,96945849,96945908,HepG2|chr7:54999980-55000071,chr7,54999980,55000071,0,41945869
HepG2|chr7:97056161-97056241,chr7,97056161,97056241,HepG2|chr7:75114831-75114901,chr7,75114831,75114901,0,21941330
HepG2|chr7:97179304-97179348,chr7,97179304,97179348,HepG2|chr7:56121943-56122023,chr7,56121943,56122023,0,41057361
HepG2|chr7:97597504-97597648,chr7,97597504,97597648,HepG2|chr7:65338717-65338774,chr7,65338717,65338774,0,32258787
HepG2|chr7:97851727-97851877,chr7,97851727,97851877,HepG2|chr7:102004837-102004987,chr7,102004837,102004987,0,4153110
HepG2|chr7:98171330-98171468,chr7,98171330,98171468,HepG2|chr7:99934693-99934825,chr7,99934693,99934825,0,1763363
HepG2|chr7:98484539-98484661,chr7,98484539,98484661,HepG2|chr7:41744259-41744284,chr7,41744259,41744284,0,56740280
HepG2|chr7:98574014-98574111,chr7,98574014,98574111,HepG2|chr7:75618047-75618100,chr7,75618047,75618100,0,22955967
HepG2|chr7:99179184-99179334,chr7,99179184,99179334,HepG2|chr7:99934693-99934837,chr7,99934693,99934837,0,755509
HepG2|chr7:99256056-99256093,chr7,99256056,99256093,HepG2|chr7:102004837-102004987,chr7,102004837,102004987,0,2748781
HepG2|chr7:99473855-99473878,chr7,99473855,99473878,HepG2|chr7:134860442-134860569,chr7,134860442,134860569,0,35386587
HepG2|chr7:99846109-99846259,chr7,99846109,99846259,HepG2|chr7:74867511-74867661,chr7,74867511,74867661,0,24978598
HepG2|chr7:100120401-100120470,chr7,100120401,100120470,HepG2|chr7:139767737-139767809,chr7,139767737,139767809,0,39647336
HepG2|chr7:100154283-100154327,chr7,100154283,100154327,HepG2|chr7:56121883-56122025,chr7,56121883,56122025,0,44032400
HepG2|chr7:100343626-100343751,chr7,100343626,100343751,HepG2|chr7:121788282-121788303,chr7,121788282,121788303,0,21444656
HepG2|chr7:100351268-100351335,chr7,100351268,100351335,HepG2|chr7:5630351-5630434,chr7,5630351,5630434,0,94720917
HepG2|chr7:100444211-100444350,chr7,100444211,100444350,HepG2|chr7:102794472-102794507,chr7,102794472,102794507,0,2350261
HepG2|chr7:100654172-100654271,chr7,100654172,100654271,HepG2|chr7:99934670-99934819,chr7,99934670,99934819,0,719502
HepG2|chr7:101048810-101048944,chr7,101048810,101048944,HepG2|chr7:99934693-99934831,chr7,99934693,99934831,0,1114117
HepG2|chr7:101182685-101182835,chr7,101182685,101182835,HepG2|chr7:74867470-74867620,chr7,74867470,74867620,0,26315215
HepG2|chr7:101326520-101326667,chr7,101326520,101326667,HepG2|chr7:65338722-65338763,chr7,65338722,65338763,0,35987798
HepG2|chr7:101679015-101679165,chr7,101679015,101679165,HepG2|chr7:65338735-65338819,chr7,65338735,65338819,0,36340280
HepG2|chr7:102200952-102200977,chr7,102200952,102200977,HepG2|chr7:44620961-44621111,chr7,44620961,44621111,0,57579991
HepG2|chr7:102545446-102545467,chr7,102545446,102545467,HepG2|chr7:99746271-99746416,chr7,99746271,99746416,0,2799175
HepG2|chr7:102568139-102568162,chr7,102568139,102568162,HepG2|chr7:41744259-41744282,chr7,41744259,41744282,0,60823880
HepG2|chr7:102683790-102683940,chr7,102683790,102683940,HepG2|chr7:74381633-74381680,chr7,74381633,74381680,0,28302157
HepG2|chr7:102818790-102818940,chr7,102818790,102818940,HepG2|chr7:134860406-134860556,chr7,134860406,134860556,0,32041616
HepG2|chr7:103093812-103093844,chr7,103093812,103093844,HepG2|chr7:55001042-55001160,chr7,55001042,55001160,0,48092770
HepG2|chr7:104621014-104621164,chr7,104621014,104621164,HepG2|chr7:74867484-74867631,chr7,74867484,74867631,0,29753530
HepG2|chr7:104783502-104783550,chr7,104783502,104783550,HepG2|chr7:74311337-74311386,chr7,74311337,74311386,0,30472165
HepG2|chr7:104909898-104909984,chr7,104909898,104909984,HepG2|chr7:99934513-99934663,chr7,99934513,99934663,0,4975385
HepG2|chr7:105333576-105333719,chr7,105333576,105333719,HepG2|chr7:121788281-121788303,chr7,121788281,121788303,0,16454705
HepG2|chr7:105554017-105554134,chr7,105554017,105554134,HepG2|chr7:41744259-41744282,chr7,41744259,41744282,0,63809758
HepG2|chr7:105796908-105796960,chr7,105796908,105796960,HepG2|chr7:72351633-72351730,chr7,72351633,72351730,0,33445275
HepG2|chr7:106406995-106407119,chr7,106406995,106407119,HepG2|chr7:99934693-99934826,chr7,99934693,99934826,0,6472302
HepG2|chr7:107064785-107064893,chr7,107064785,107064893,HepG2|chr7:99934766-99934916,chr7,99934766,99934916,0,7130019
HepG2|chr7:107310432-107310515,chr7,107310432,107310515,HepG2|chr7:72460119-72460239,chr7,72460119,72460239,0,34850313
HepG2|chr7:107530375-107530499,chr7,107530375,107530499,HepG2|chr7:98741137-98741163,chr7,98741137,98741163,0,8789238
HepG2|chr7:107720608-107720697,chr7,107720608,107720697,HepG2|chr7:45810481-45810542,chr7,45810481,45810542,0,61910127
HepG2|chr7:107752794-107752840,chr7,107752794,107752840,HepG2|chr7:55087217-55087367,chr7,55087217,55087367,0,52665577
HepG2|chr7:107791719-107791869,chr7,107791719,107791869,HepG2|chr7:134860410-134860438,chr7,134860410,134860438,0,27068691
HepG2|chr7:108104733-108104868,chr7,108104733,108104868,HepG2|chr7:134860126-134860276,chr7,134860126,134860276,0,26755393
HepG2|chr7:108110148-108110243,chr7,108110148,108110243,HepG2|chr7:99934781-99934929,chr7,99934781,99934929,0,8175367
HepG2|chr7:108134087-108134236,chr7,108134087,108134236,HepG2|chr7:73184787-73184807,chr7,73184787,73184807,0,34949300
HepG2|chr7:108341848-108341924,chr7,108341848,108341924,HepG2|chr7:134860442-134860569,chr7,134860442,134860569,0,26518594
HepG2|chr7:108425454-108425526,chr7,108425454,108425526,HepG2|chr7:65338723-65338799,chr7,65338723,65338799,0,43086731
HepG2|chr7:108455607-108455757,chr7,108455607,108455757,HepG2|chr7:30327601-30327751,chr7,30327601,30327751,0,78128006
HepG2|chr7:108546747-108546897,chr7,108546747,108546897,HepG2|chr7:29720491-29720638,chr7,29720491,29720638,0,78826256
HepG2|chr7:108607380-108607509,chr7,108607380,108607509,HepG2|chr7:41744259-41744277,chr7,41744259,41744277,0,66863121
HepG2|chr7:108709940-108710031,chr7,108709940,108710031,HepG2|chr7:45810486-45810545,chr7,45810486,45810545,0,62899454
HepG2|chr7:108754787-108754914,chr7,108754787,108754914,HepG2|chr7:73184787-73184807,chr7,73184787,73184807,0,35570000
HepG2|chr7:108913212-108913296,chr7,108913212,108913296,HepG2|chr7:54999980-55000071,chr7,54999980,55000071,0,53913232
HepG2|chr7:109008331-109008436,chr7,109008331,109008436,HepG2|chr7:74866416-74866566,chr7,74866416,74866566,0,34141915
HepG2|chr7:109200469-109200524,chr7,109200469,109200524,HepG2|chr7:75799215-75799310,chr7,75799215,75799310,0,33401254
HepG2|chr7:109202314-109202449,chr7,109202314,109202449,HepG2|chr7:99934709-99934854,chr7,99934709,99934854,0,9267605
HepG2|chr7:109380688-109380731,chr7,109380688,109380731,HepG2|chr7:77163525-77163631,chr7,77163525,77163631,0,32217163
HepG2|chr7:109425628-109425778,chr7,109425628,109425778,HepG2|chr7:72460964-72461058,chr7,72460964,72461058,0,36964664
HepG2|chr7:109671236-109671386,chr7,109671236,109671386,HepG2|chr7:5630351-5630434,chr7,5630351,5630434,0,104040885
HepG2|chr7:110149135-110149278,chr7,110149135,110149278,HepG2|chr7:102004837-102004987,chr7,102004837,102004987,0,8144298
HepG2|chr7:110475519-110475669,chr7,110475519,110475669,HepG2|chr7:99934693-99934823,chr7,99934693,99934823,0,10540826
HepG2|chr7:110514466-110514540,chr7,110514466,110514540,HepG2|chr7:6867818-6867939,chr7,6867818,6867939,0,103646648
HepG2|chr7:110533049-110533113,chr7,110533049,110533113,HepG2|chr7:75004675-75004811,chr7,75004675,75004811,0,35528374
HepG2|chr7:110784188-110784338,chr7,110784188,110784338,HepG2|chr7:134860410-134860438,chr7,134860410,134860438,0,24076222
HepG2|chr7:111135093-111135143,chr7,111135093,111135143,HepG2|chr7:74311328-74311385,chr7,74311328,74311385,0,36823765
HepG2|chr7:111230386-111230525,chr7,111230386,111230525,HepG2|chr7:99934693-99934827,chr7,99934693,99934827,0,11295693
HepG2|chr7:111907360-111907440,chr7,111907360,111907440,HepG2|chr7:23568908-23568960,chr7,23568908,23568960,0,88338452
HepG2|chr7:111983987-111984041,chr7,111983987,111984041,HepG2|chr7:74867506-74867646,chr7,74867506,74867646,0,37116481
HepG2|chr7:112308093-112308243,chr7,112308093,112308243,HepG2|chr7:5630351-5630434,chr7,5630351,5630434,0,106677742
HepG2|chr7:112695417-112695515,chr7,112695417,112695515,HepG2|chr7:121788033-121788182,chr7,121788033,121788182,0,9092616
HepG2|chr7:112894487-112894593,chr7,112894487,112894593,HepG2|chr7:5628358-5628396,chr7,5628358,5628396,0,107266129
HepG2|chr7:112965283-112965433,chr7,112965283,112965433,HepG2|chr7:99934693-99934829,chr7,99934693,99934829,0,13030590
HepG2|chr7:113199818-113199917,chr7,113199818,113199917,HepG2|chr7:41744259-41744282,chr7,41744259,41744282,0,71455559
HepG2|chr7:113384667-113384817,chr7,113384667,113384817,HepG2|chr7:65338717-65338776,chr7,65338717,65338776,0,48045950
HepG2|chr7:113684050-113684199,chr7,113684050,113684199,HepG2|chr7:74867472-74867622,chr7,74867472,74867622,0,38816578
HepG2|chr7:114700642-114700701,chr7,114700642,114700701,HepG2|chr7:5631330-5631469,chr7,5631330,5631469,0,109069312
HepG2|chr7:114750559-114750709,chr7,114750559,114750709,HepG2|chr7:99934693-99934827,chr7,99934693,99934827,0,14815866
HepG2|chr7:115068510-115068651,chr7,115068510,115068651,HepG2|chr7:74867489-74867622,chr7,74867489,74867622,0,40201021
HepG2|chr7:116514949-116515083,chr7,116514949,116515083,HepG2|chr7:74867506-74867621,chr7,74867506,74867621,0,41647443
HepG2|chr7:116603173-116603253,chr7,116603173,116603253,HepG2|chr7:23568908-23568960,chr7,23568908,23568960,0,93034265
HepG2|chr7:117082288-117082397,chr7,117082288,117082397,HepG2|chr7:65338719-65338818,chr7,65338719,65338818,0,51743569
HepG2|chr7:117391736-117391863,chr7,117391736,117391863,HepG2|chr7:74381618-74381680,chr7,74381618,74381680,0,43010118
HepG2|chr7:117561246-117561361,chr7,117561246,117561361,HepG2|chr7:102794472-102794507,chr7,102794472,102794507,0,14766774
HepG2|chr7:118064979-118065097,chr7,118064979,118065097,HepG2|chr7:41744259-41744279,chr7,41744259,41744279,0,76320720
HepG2|chr7:118205113-118205250,chr7,118205113,118205250,HepG2|chr7:99934607-99934757,chr7,99934607,99934757,0,18270506
HepG2|chr7:118532396-118532512,chr7,118532396,118532512,HepG2|chr7:76091083-76091232,chr7,76091083,76091232,0,42441313
HepG2|chr7:118629990-118630081,chr7,118629990,118630081,HepG2|chr7:75799258-75799335,chr7,75799258,75799335,0,42830732
HepG2|chr7:118670923-118671073,chr7,118670923,118671073,HepG2|chr7:72460964-72461058,chr7,72460964,72461058,0,46209959
HepG2|chr7:118682478-118682628,chr7,118682478,118682628,HepG2|chr7:101461730-101461776,chr7,101461730,101461776,0,17220748
HepG2|chr7:118712544-118712692,chr7,118712544,118712692,HepG2|chr7:74381641-74381680,chr7,74381641,74381680,0,44330903
HepG2|chr7:119010347-119010437,chr7,119010347,119010437,HepG2|chr7:134860441-134860556,chr7,134860441,134860556,0,15850094
HepG2|chr7:119186980-119187062,chr7,119186980,119187062,HepG2|chr7:23568908-23568960,chr7,23568908,23568960,0,95618072
HepG2|chr7:119345927-119346052,chr7,119345927,119346052,HepG2|chr7:99934492-99934621,chr7,99934492,99934621,0,19411435
HepG2|chr7:119913137-119913281,chr7,119913137,119913281,HepG2|chr7:100729415-100729539,chr7,100729415,100729539,0,19183722
HepG2|chr7:119964695-119964771,chr7,119964695,119964771,HepG2|chr7:100426579-100426676,chr7,100426579,100426676,0,19538116
HepG2|chr7:120219102-120219125,chr7,120219102,120219125,HepG2|chr7:134860442-134860569,chr7,134860442,134860569,0,14641340
HepG2|chr7:120257707-120257823,chr7,120257707,120257823,HepG2|chr7:99934499-99934621,chr7,99934499,99934621,0,20323208
HepG2|chr7:120641468-120641592,chr7,120641468,120641592,HepG2|chr7:75113936-75113985,chr7,75113936,75113985,0,45527532
HepG2|chr7:121045034-121045184,chr7,121045034,121045184,HepG2|chr7:134860406-134860556,chr7,134860406,134860556,0,13815372
HepG2|chr7:121323226-121323273,chr7,121323226,121323273,HepG2|chr7:56121928-56122028,chr7,56121928,56122028,0,65201298
HepG2|chr7:121775093-121775198,chr7,121775093,121775198,HepG2|chr7:74866416-74866566,chr7,74866416,74866566,0,46908677
HepG2|chr7:121825515-121825651,chr7,121825515,121825651,HepG2|chr7:41744259-41744284,chr7,41744259,41744284,0,80081256
HepG2|chr7:121832284-121832398,chr7,121832284,121832398,HepG2|chr7:99934671-99934821,chr7,99934671,99934821,0,21897613
HepG2|chr7:121881595-121881661,chr7,121881595,121881661,HepG2|chr7:41744259-41744282,chr7,41744259,41744282,0,80137336
HepG2|chr7:122290482-122290627,chr7,122290482,122290627,HepG2|chr7:74867484-74867630,chr7,74867484,74867630,0,47422998
HepG2|chr7:122679746-122679795,chr7,122679746,122679795,HepG2|chr7:101461730-101461776,chr7,101461730,101461776,0,21218016
HepG2|chr7:123018445-123018560,chr7,123018445,123018560,HepG2|chr7:102794472-102794507,chr7,102794472,102794507,0,20223973
HepG2|chr7:123715896-123716046,chr7,123715896,123716046,HepG2|chr7:74867471-74867621,chr7,74867471,74867621,0,48848425
HepG2|chr7:123839323-123839415,chr7,123839323,123839415,HepG2|chr7:41744259-41744282,chr7,41744259,41744282,0,82095064
HepG2|chr7:123849899-123850040,chr7,123849899,123850040,HepG2|chr7:99934693-99934835,chr7,99934693,99934835,0,23915206
HepG2|chr7:124171632-124171771,chr7,124171632,124171771,HepG2|chr7:99746471-99746535,chr7,99746471,99746535,0,24425161
HepG2|chr7:124172040-124172179,chr7,124172040,124172179,HepG2|chr7:76091157-76091296,chr7,76091157,76091296,0,48080883
HepG2|chr7:124443639-124443688,chr7,124443639,124443688,HepG2|chr7:56121918-56122023,chr7,56121918,56122023,0,68321721
HepG2|chr7:124751136-124751210,chr7,124751136,124751210,HepG2|chr7:74866405-74866537,chr7,74866405,74866537,0,49884731
HepG2|chr7:124766579-124766729,chr7,124766579,124766729,HepG2|chr7:102004842-102004992,chr7,102004842,102004992,0,22761737
HepG2|chr7:125520431-125520581,chr7,125520431,125520581,HepG2|chr7:30327602-30327752,chr7,30327602,30327752,0,95192829
HepG2|chr7:126710125-126710275,chr7,126710125,126710275,HepG2|chr7:102004837-102004987,chr7,102004837,102004987,0,24705288
HepG2|chr7:128011137-128011179,chr7,128011137,128011179,HepG2|chr7:29720624-29720697,chr7,29720624,29720697,0,98290513
HepG2|chr7:128684786-128684845,chr7,128684786,128684845,HepG2|chr7:54999980-55000071,chr7,54999980,55000071,0,73684806
HepG2|chr7:129168797-129168947,chr7,129168797,129168947,HepG2|chr7:74867484-74867630,chr7,74867484,74867630,0,54301313
HepG2|chr7:129175572-129175616,chr7,129175572,129175616,HepG2|chr7:134860418-134860565,chr7,134860418,134860565,0,5684846
HepG2|chr7:129926382-129926500,chr7,129926382,129926500,HepG2|chr7:99934693-99934823,chr7,99934693,99934823,0,29991689
HepG2|chr7:130800501-130800650,chr7,130800501,130800650,HepG2|chr7:74867472-74867622,chr7,74867472,74867622,0,55933029
HepG2|chr7:130924564-130924714,chr7,130924564,130924714,HepG2|chr7:150023749-150023788,chr7,150023749,150023788,0,19099185
HepG2|chr7:131283421-131283571,chr7,131283421,131283571,HepG2|chr7:41744261-41744282,chr7,41744261,41744282,0,89539160
HepG2|chr7:131375278-131375330,chr7,131375278,131375330,HepG2|chr7:76091162-76091253,chr7,76091162,76091253,0,55284116
HepG2|chr7:131400949-131401093,chr7,131400949,131401093,HepG2|chr7:72460900-72461002,chr7,72460900,72461002,0,58940049
HepG2|chr7:131653090-131653240,chr7,131653090,131653240,HepG2|chr7:74381633-74381680,chr7,74381633,74381680,0,57271457
HepG2|chr7:131807737-131807863,chr7,131807737,131807863,HepG2|chr7:41744259-41744280,chr7,41744259,41744280,0,90063478
HepG2|chr7:131808875-131808964,chr7,131808875,131808964,HepG2|chr7:41744259-41744282,chr7,41744259,41744282,0,90064616
HepG2|chr7:132430778-132430888,chr7,132430778,132430888,HepG2|chr7:74867501-74867619,chr7,74867501,74867619,0,57563277
HepG2|chr7:132645648-132645797,chr7,132645648,132645797,HepG2|chr7:74381648-74381711,chr7,74381648,74381711,0,58264000
HepG2|chr7:132681850-132681997,chr7,132681850,132681997,HepG2|chr7:102004890-102004987,chr7,102004890,102004987,0,30676960
HepG2|chr7:133152611-133152678,chr7,133152611,133152678,HepG2|chr7:5630351-5630434,chr7,5630351,5630434,0,127522260
HepG2|chr7:133256422-133256544,chr7,133256422,133256544,HepG2|chr7:75931687-75931728,chr7,75931687,75931728,0,57324735
HepG2|chr7:133582201-133582278,chr7,133582201,133582278,HepG2|chr7:75113875-75113962,chr7,75113875,75113962,0,58468326
HepG2|chr7:133601866-133601930,chr7,133601866,133601930,HepG2|chr7:121788102-121788249,chr7,121788102,121788249,0,11813764
HepG2|chr7:133643556-133643660,chr7,133643556,133643660,HepG2|chr7:44837502-44837574,chr7,44837502,44837574,0,88806054
HepG2|chr7:134129199-134129273,chr7,134129199,134129273,HepG2|chr7:6867818-6867939,chr7,6867818,6867939,0,127261381
HepG2|chr7:134223119-134223171,chr7,134223119,134223171,HepG2|chr7:76091162-76091253,chr7,76091162,76091253,0,58131957
HepG2|chr7:134314156-134314292,chr7,134314156,134314292,HepG2|chr7:41744259-41744284,chr7,41744259,41744284,0,92569897
HepG2|chr7:134545621-134545771,chr7,134545621,134545771,HepG2|chr7:5631709-5631765,chr7,5631709,5631765,0,128913912
HepG2|chr7:134608620-134608747,chr7,134608620,134608747,HepG2|chr7:73184787-73184807,chr7,73184787,73184807,0,61423833
HepG2|chr7:134818344-134818494,chr7,134818344,134818494,HepG2|chr7:102251004-102251128,chr7,102251004,102251128,0,32567340
HepG2|chr7:135187723-135187867,chr7,135187723,135187867,HepG2|chr7:72460900-72461002,chr7,72460900,72461002,0,62726823
HepG2|chr7:135502997-135503121,chr7,135502997,135503121,HepG2|chr7:98741137-98741163,chr7,98741137,98741163,0,36761860
HepG2|chr7:135899943-135900061,chr7,135899943,135900061,HepG2|chr7:41744259-41744279,chr7,41744259,41744279,0,94155684
HepG2|chr7:136182301-136182319,chr7,136182301,136182319,HepG2|chr7:55087142-55087255,chr7,55087142,55087255,0,81095159
HepG2|chr7:136703552-136703702,chr7,136703552,136703702,HepG2|chr7:72460886-72461036,chr7,72460886,72461036,0,64242666
HepG2|chr7:137064460-137064610,chr7,137064460,137064610,HepG2|chr7:74381490-74381640,chr7,74381490,74381640,0,62682970
HepG2|chr7:137105166-137105316,chr7,137105166,137105316,HepG2|chr7:65338735-65338819,chr7,65338735,65338819,0,71766431
HepG2|chr7:137323528-137323617,chr7,137323528,137323617,HepG2|chr7:41744259-41744282,chr7,41744259,41744282,0,95579269
HepG2|chr7:137470578-137470663,chr7,137470578,137470663,HepG2|chr7:6748596-6748670,chr7,6748596,6748670,0,130721982
HepG2|chr7:137798598-137798689,chr7,137798598,137798689,HepG2|chr7:75930698-75930797,chr7,75930698,75930797,0,61867900
HepG2|chr7:138291172-138291281,chr7,138291172,138291281,HepG2|chr7:65338719-65338818,chr7,65338719,65338818,0,72952453
HepG2|chr7:138940529-138940600,chr7,138940529,138940600,HepG2|chr7:6519792-6519871,chr7,6519792,6519871,0,132420737
HepG2|chr7:139432667-139432773,chr7,139432667,139432773,HepG2|chr7:65338723-65338811,chr7,65338723,65338811,0,74093944
HepG2|chr7:139598654-139598804,chr7,139598654,139598804,HepG2|chr7:102004842-102004992,chr7,102004842,102004992,0,37593812
HepG2|chr7:139743184-139743248,chr7,139743184,139743248,HepG2|chr7:121788102-121788249,chr7,121788102,121788249,0,17955082
HepG2|chr7:140114614-140114711,chr7,140114614,140114711,HepG2|chr7:74379940-74380047,chr7,74379940,74380047,0,65734674
HepG2|chr7:140147552-140147700,chr7,140147552,140147700,HepG2|chr7:74867472-74867622,chr7,74867472,74867622,0,65280080
HepG2|chr7:140170720-140170833,chr7,140170720,140170833,HepG2|chr7:74867497-74867621,chr7,74867497,74867621,0,65303223
HepG2|chr7:140381979-140382119,chr7,140381979,140382119,HepG2|chr7:74867471-74867620,chr7,74867471,74867620,0,65514508
HepG2|chr7:140673031-140673175,chr7,140673031,140673175,HepG2|chr7:74867491-74867641,chr7,74867491,74867641,0,65805540
HepG2|chr7:140793735-140793846,chr7,140793735,140793846,HepG2|chr7:72351631-72351733,chr7,72351631,72351733,0,68442104
HepG2|chr7:141681845-141681992,chr7,141681845,141681992,HepG2|chr7:65338732-65338788,chr7,65338732,65338788,0,76343113
HepG2|chr7:141991393-141991432,chr7,141991393,141991432,HepG2|chr7:121786659-121786712,chr7,121786659,121786712,0,20204734
HepG2|chr7:142184369-142184423,chr7,142184369,142184423,HepG2|chr7:121788101-121788251,chr7,121788101,121788251,0,20396268
HepG2|chr7:142314952-142315035,chr7,142314952,142315035,HepG2|chr7:72460119-72460239,chr7,72460119,72460239,0,69854833
HepG2|chr7:142380345-142380387,chr7,142380345,142380387,HepG2|chr7:56121943-56122023,chr7,56121943,56122023,0,86258402
HepG2|chr7:142405514-142405549,chr7,142405514,142405549,HepG2|chr7:134860441-134860556,chr7,134860441,134860556,0,7545073
HepG2|chr7:142545018-142545155,chr7,142545018,142545155,HepG2|chr7:99934669-99934819,chr7,99934669,99934819,0,42610349
HepG2|chr7:143057301-143057448,chr7,143057301,143057448,HepG2|chr7:65338717-65338798,chr7,65338717,65338798,0,77718584
HepG2|chr7:143079468-143079612,chr7,143079468,143079612,HepG2|chr7:99934603-99934702,chr7,99934603,99934702,0,43144865
HepG2|chr7:143242892-143243031,chr7,143242892,143243031,HepG2|chr7:76091157-76091296,chr7,76091157,76091296,0,67151735
HepG2|chr7:143274974-143275053,chr7,143274974,143275053,HepG2|chr7:92465699-92465737,chr7,92465699,92465737,0,50809275
HepG2|chr7:143341929-143342066,chr7,143341929,143342066,HepG2|chr7:65338716-65338834,chr7,65338716,65338834,0,78003213
HepG2|chr7:143379962-143380057,chr7,143379962,143380057,HepG2|chr7:99934781-99934929,chr7,99934781,99934929,0,43445181
HepG2|chr7:144713450-144713598,chr7,144713450,144713598,HepG2|chr7:74381641-74381680,chr7,74381641,74381680,0,70331809
HepG2|chr7:144750120-144750231,chr7,144750120,144750231,HepG2|chr7:77163525-77163631,chr7,77163525,77163631,0,67586595
HepG2|chr7:144842274-144842413,chr7,144842274,144842413,HepG2|chr7:65338723-65338771,chr7,65338723,65338771,0,79503551
HepG2|chr7:144897925-144898003,chr7,144897925,144898003,HepG2|chr7:45810476-45810545,chr7,45810476,45810545,0,99087449
HepG2|chr7:145295443-145295588,chr7,145295443,145295588,HepG2|chr7:74867484-74867630,chr7,74867484,74867630,0,70427959
HepG2|chr7:146013404-146013447,chr7,146013404,146013447,HepG2|chr7:77163525-77163631,chr7,77163525,77163631,0,68849879
HepG2|chr7:146078233-146078383,chr7,146078233,146078383,HepG2|chr7:75113932-75113980,chr7,75113932,75113980,0,70964301
HepG2|chr7:146484815-146484893,chr7,146484815,146484893,HepG2|chr7:45810476-45810545,chr7,45810476,45810545,0,100674339
HepG2|chr7:147071894-147072042,chr7,147071894,147072042,HepG2|chr7:99934671-99934821,chr7,99934671,99934821,0,47137223
HepG2|chr7:147210774-147210903,chr7,147210774,147210903,HepG2|chr7:41744261-41744282,chr7,41744261,41744282,0,105466513
HepG2|chr7:147271048-147271071,chr7,147271048,147271071,HepG2|chr7:41744259-41744282,chr7,41744259,41744282,0,105526789
HepG2|chr7:147563542-147563624,chr7,147563542,147563624,HepG2|chr7:99746471-99746535,chr7,99746471,99746535,0,47817071
HepG2|chr7:147851045-147851092,chr7,147851045,147851092,HepG2|chr7:5607634-5607670,chr7,5607634,5607670,0,142243411
HepG2|chr7:147856432-147856582,chr7,147856432,147856582,HepG2|chr7:41744259-41744277,chr7,41744259,41744277,0,106112173
HepG2|chr7:147890073-147890223,chr7,147890073,147890223,HepG2|chr7:30327055-30327205,chr7,30327055,30327205,0,117563018
HepG2|chr7:148240928-148241077,chr7,148240928,148241077,HepG2|chr7:74867492-74867623,chr7,74867492,74867623,0,73373436
HepG2|chr7:148282052-148282131,chr7,148282052,148282131,HepG2|chr7:99934928-99935054,chr7,99934928,99935054,0,48347124
HepG2|chr7:148478605-148478647,chr7,148478605,148478647,HepG2|chr7:29720624-29720697,chr7,29720624,29720697,0,118757981
HepG2|chr7:149031522-149031627,chr7,149031522,149031627,HepG2|chr7:41744259-41744282,chr7,41744259,41744282,0,107287263
HepG2|chr7:149219431-149219477,chr7,149219431,149219477,HepG2|chr7:55087217-55087367,chr7,55087217,55087367,0,94132214
HepG2|chr7:149842137-149842286,chr7,149842137,149842286,HepG2|chr7:102251004-102251128,chr7,102251004,102251128,0,47591133
HepG2|chr7:149865367-149865489,chr7,149865367,149865489,HepG2|chr7:75931687-75931728,chr7,75931687,75931728,0,73933680
HepG2|chr7:149986896-149987001,chr7,149986896,149987001,HepG2|chr7:44835404-44835549,chr7,44835404,44835549,0,105151492
HepG2|chr7:150585163-150585279,chr7,150585163,150585279,HepG2|chr7:99934693-99934837,chr7,99934693,99934837,0,50650470
HepG2|chr7:150641735-150641885,chr7,150641735,150641885,HepG2|chr7:29720567-29720716,chr7,29720567,29720716,0,120921168
HepG2|chr7:150721626-150721771,chr7,150721626,150721771,HepG2|chr7:102004837-102004987,chr7,102004837,102004987,0,48716789
HepG2|chr7:150814271-150814408,chr7,150814271,150814408,HepG2|chr7:99934607-99934757,chr7,99934607,99934757,0,50879664
HepG2|chr7:150814610-150814724,chr7,150814610,150814724,HepG2|chr7:99934693-99934832,chr7,99934693,99934832,0,50879917
HepG2|chr7:151733515-151733587,chr7,151733515,151733587,HepG2|chr7:65338723-65338799,chr7,65338723,65338799,0,86394792
HepG2|chr7:151990121-151990271,chr7,151990121,151990271,HepG2|chr7:73184787-73184807,chr7,73184787,73184807,0,78805334
HepG2|chr7:152096028-152096177,chr7,152096028,152096177,HepG2|chr7:99934693-99934808,chr7,99934693,99934808,0,52161335
HepG2|chr7:152209932-152210036,chr7,152209932,152210036,HepG2|chr7:101461730-101461776,chr7,101461730,101461776,0,50748202
HepG2|chr7:152319393-152319543,chr7,152319393,152319543,HepG2|chr7:74867473-74867622,chr7,74867473,74867622,0,77451920
HepG2|chr7:152784232-152784382,chr7,152784232,152784382,HepG2|chr7:74867504-74867630,chr7,74867504,74867630,0,77916728
HepG2|chr7:152908022-152908147,chr7,152908022,152908147,HepG2|chr7:99934492-99934621,chr7,99934492,99934621,0,52973530
HepG2|chr7:153156827-153156977,chr7,153156827,153156977,HepG2|chr7:74867472-74867622,chr7,74867472,74867622,0,78289355
HepG2|chr7:153547187-153547253,chr7,153547187,153547253,HepG2|chr7:134857653-134857777,chr7,134857653,134857777,0,18689534
HepG2|chr7:153717616-153717759,chr7,153717616,153717759,HepG2|chr7:121788281-121788303,chr7,121788281,121788303,0,31929335
HepG2|chr7:153832451-153832601,chr7,153832451,153832601,HepG2|chr7:134860485-134860558,chr7,134860485,134860558,0,18971966
HepG2|chr7:153939514-153939536,chr7,153939514,153939536,HepG2|chr7:130794056-130794206,chr7,130794056,130794206,0,23145458
HepG2|chr7:154046690-154046800,chr7,154046690,154046800,HepG2|chr7:74867501-74867619,chr7,74867501,74867619,0,79179189
HepG2|chr7:154286348-154286457,chr7,154286348,154286457,HepG2|chr7:99934670-99934820,chr7,99934670,99934820,0,54351678
HepG2|chr7:154303575-154303666,chr7,154303575,154303666,HepG2|chr7:45810486-45810545,chr7,45810486,45810545,0,108493089
HepG2|chr7:154459909-154460043,chr7,154459909,154460043,HepG2|chr7:74867506-74867621,chr7,74867506,74867621,0,79592403
HepG2|chr7:154840833-154840982,chr7,154840833,154840982,HepG2|chr7:74867492-74867623,chr7,74867492,74867623,0,79973341
HepG2|chr7:155094650-155094769,chr7,155094650,155094769,HepG2|chr7:150025858-150025930,chr7,150025858,150025930,0,5068792
HepG2|chr7:155242523-155242602,chr7,155242523,155242602,HepG2|chr7:99934718-99934868,chr7,99934718,99934868,0,55307805
HepG2|chr7:155588997-155589146,chr7,155588997,155589146,HepG2|chr7:99934799-99934923,chr7,99934799,99934923,0,55654198
HepG2|chr7:155690676-155690757,chr7,155690676,155690757,HepG2|chr7:74866409-74866505,chr7,74866409,74866505,0,80824267
HepG2|chr7:155752614-155752731,chr7,155752614,155752731,HepG2|chr7:41744259-41744282,chr7,41744259,41744282,0,114008355
HepG2|chr7:156035543-156035680,chr7,156035543,156035680,HepG2|chr7:65338716-65338834,chr7,65338716,65338834,0,90696827
HepG2|chr7:156390036-156390058,chr7,156390036,156390058,HepG2|chr7:41744259-41744282,chr7,41744259,41744282,0,114645777
HepG2|chr7:156423911-156424002,chr7,156423911,156424002,HepG2|chr7:75799258-75799335,chr7,75799258,75799335,0,80624653
HepG2|chr7:156929038-156929187,chr7,156929038,156929187,HepG2|chr7:74867470-74867619,chr7,74867470,74867619,0,82061568
HepG2|chr7:157082062-157082210,chr7,157082062,157082210,HepG2|chr7:65338719-65338765,chr7,65338719,65338765,0,91743343
HepG2|chr7:158065544-158065610,chr7,158065544,158065610,HepG2|chr7:55087189-55087337,chr7,55087189,55087337,0,102978355
HepG2|chr7:158255490-158255564,chr7,158255490,158255564,HepG2|chr7:150025858-150025930,chr7,150025858,150025930,0,8229632
HepG2|chr7:158303901-158303942,chr7,158303901,158303942,HepG2|chr7:56121979-56122029,chr7,56121979,56122029,0,102181922
HepG2|chr7:158327931-158328043,chr7,158327931,158328043,HepG2|chr7:72351543-72351671,chr7,72351543,72351671,0,85976388
HepG2|chr7:159055519-159055669,chr7,159055519,159055669,HepG2|chr7:65338723-65338782,chr7,65338723,65338782,0,93716796
HepG2|chr8:418772-418856,chr8,418772,418856,HepG2|chr8:103668874-103669014,chr8,103668874,103669014,0,103250102
HepG2|chr8:2049424-2049459,chr8,2049424,2049459,HepG2|chr8:37758472-37758570,chr8,37758472,37758570,0,35709048
HepG2|chr8:3027186-3027268,chr8,3027186,3027268,HepG2|chr8:128751884-128751915,chr8,128751884,128751915,0,125724698
HepG2|chr8:3266743-3266806,chr8,3266743,3266806,HepG2|chr8:119119853-119119935,chr8,119119853,119119935,0,115853110
HepG2|chr8:3684512-3684662,chr8,3684512,3684662,HepG2|chr8:22093915-22093942,chr8,22093915,22093942,0,18409403
HepG2|chr8:3740627-3740756,chr8,3740627,3740756,HepG2|chr8:124216541-124216558,chr8,124216541,124216558,0,120475914
HepG2|chr8:3752126-3752239,chr8,3752126,3752239,HepG2|chr8:40015745-40015782,chr8,40015745,40015782,0,36263619
HepG2|chr8:5495680-5495742,chr8,5495680,5495742,HepG2|chr8:54938477-54938591,chr8,54938477,54938591,0,49442797
HepG2|chr8:6346209-6346296,chr8,6346209,6346296,HepG2|chr8:40015719-40015782,chr8,40015719,40015782,0,33669510
HepG2|chr8:6508749-6508843,chr8,6508749,6508843,HepG2|chr8:101348669-101348725,chr8,101348669,101348725,0,94839920
HepG2|chr8:7617344-7617408,chr8,7617344,7617408,HepG2|chr8:37758484-37758570,chr8,37758484,37758570,0,30141140
HepG2|chr8:7933649-7933745,chr8,7933649,7933745,HepG2|chr8:37758516-37758570,chr8,37758516,37758570,0,29824867
HepG2|chr8:8452099-8452216,chr8,8452099,8452216,HepG2|chr8:128749088-128749137,chr8,128749088,128749137,0,120296989
HepG2|chr8:9484942-9485089,chr8,9484942,9485089,HepG2|chr8:71017862-71017894,chr8,71017862,71017894,0,61532920
HepG2|chr8:10437491-10437580,chr8,10437491,10437580,HepG2|chr8:128751642-128751731,chr8,128751642,128751731,0,118314151
HepG2|chr8:10852540-10852634,chr8,10852540,10852634,HepG2|chr8:101348669-101348725,chr8,101348669,101348725,0,90496129
HepG2|chr8:10860252-10860269,chr8,10860252,10860269,HepG2|chr8:101319896-101319988,chr8,101319896,101319988,0,90459644
HepG2|chr8:11189268-11189355,chr8,11189268,11189355,HepG2|chr8:71017861-71017892,chr8,71017861,71017892,0,59828593
HepG2|chr8:11557005-11557064,chr8,11557005,11557064,HepG2|chr8:134581505-134581652,chr8,134581505,134581652,0,123024500
HepG2|chr8:12214048-12214116,chr8,12214048,12214116,HepG2|chr8:103536171-103536318,chr8,103536171,103536318,0,91322123
HepG2|chr8:12319427-12319504,chr8,12319427,12319504,HepG2|chr8:40015709-40015782,chr8,40015709,40015782,0,27696282
HepG2|chr8:12567955-12568058,chr8,12567955,12568058,HepG2|chr8:144393523-144393570,chr8,144393523,144393570,0,131825568
HepG2|chr8:13981470-13981620,chr8,13981470,13981620,HepG2|chr8:144642365-144642386,chr8,144642365,144642386,0,130660895
HepG2|chr8:14372363-14372419,chr8,14372363,14372419,HepG2|chr8:40014301-40014407,chr8,40014301,40014407,0,25641938
HepG2|chr8:14759431-14759484,chr8,14759431,14759484,HepG2|chr8:37758459-37758570,chr8,37758459,37758570,0,22999028
HepG2|chr8:15094657-15094731,chr8,15094657,15094731,HepG2|chr8:128752446-128752556,chr8,128752446,128752556,0,113657789
HepG2|chr8:15098852-15098946,chr8,15098852,15098946,HepG2|chr8:117780105-117780168,chr8,117780105,117780168,0,102681253
HepG2|chr8:15229273-15229399,chr8,15229273,15229399,HepG2|chr8:54939560-54939700,chr8,54939560,54939700,0,39710287
HepG2|chr8:15963970-15964072,chr8,15963970,15964072,HepG2|chr8:128752343-128752483,chr8,128752343,128752483,0,112788373
HepG2|chr8:16014216-16014278,chr8,16014216,16014278,HepG2|chr8:37758484-37758570,chr8,37758484,37758570,0,21744268
HepG2|chr8:16141788-16141827,chr8,16141788,16141827,HepG2|chr8:37758459-37758570,chr8,37758459,37758570,0,21616671
HepG2|chr8:16198151-16198202,chr8,16198151,16198202,HepG2|chr8:37761712-37761741,chr8,37761712,37761741,0,21563561
HepG2|chr8:17131190-17131311,chr8,17131190,17131311,HepG2|chr8:103539009-103539038,chr8,103539009,103539038,0,86407819
HepG2|chr8:17501100-17501226,chr8,17501100,17501226,HepG2|chr8:54939560-54939700,chr8,54939560,54939700,0,37438460
HepG2|chr8:17747949-17747979,chr8,17747949,17747979,HepG2|chr8:37758450-37758570,chr8,37758450,37758570,0,20010501
HepG2|chr8:17952383-17952415,chr8,17952383,17952415,HepG2|chr8:128752164-128752217,chr8,128752164,128752217,0,110799781
HepG2|chr8:19621102-19621165,chr8,19621102,19621165,HepG2|chr8:103548274-103548320,chr8,103548274,103548320,0,83927172
HepG2|chr8:19851520-19851670,chr8,19851520,19851670,HepG2|chr8:144393523-144393570,chr8,144393523,144393570,0,124542003
HepG2|chr8:19897568-19897605,chr8,19897568,19897605,HepG2|chr8:134308878-134308943,chr8,134308878,134308943,0,114411310
HepG2|chr8:19972752-19972876,chr8,19972752,19972876,HepG2|chr8:124408985-124409002,chr8,124408985,124409002,0,104436233
HepG2|chr8:21305069-21305182,chr8,21305069,21305182,HepG2|chr8:40015745-40015782,chr8,40015745,40015782,0,18710676
HepG2|chr8:21891245-21891333,chr8,21891245,21891333,HepG2|chr8:124408983-124409002,chr8,124408983,124409002,0,102517738
HepG2|chr8:22767835-22767956,chr8,22767835,22767956,HepG2|chr8:124408985-124409002,chr8,124408985,124409002,0,101641150
HepG2|chr8:23154964-23155084,chr8,23154964,23155084,HepG2|chr8:124408983-124409001,chr8,124408983,124409001,0,101254019
HepG2|chr8:23294831-23294879,chr8,23294831,23294879,HepG2|chr8:101348629-101348725,chr8,101348629,101348725,0,78053798
HepG2|chr8:23332979-23333002,chr8,23332979,23333002,HepG2|chr8:71017861-71017891,chr8,71017861,71017891,0,47684882
HepG2|chr8:24371529-24371573,chr8,24371529,24371573,HepG2|chr8:37758464-37758570,chr8,37758464,37758570,0,13386935
HepG2|chr8:24671848-24671916,chr8,24671848,24671916,HepG2|chr8:128752077-128752159,chr8,128752077,128752159,0,104080229
HepG2|chr8:26703579-26703639,chr8,26703579,26703639,HepG2|chr8:119119853-119119935,chr8,119119853,119119935,0,92416274
HepG2|chr8:27190169-27190310,chr8,27190169,27190310,HepG2|chr8:37758537-37758570,chr8,37758537,37758570,0,10568368
HepG2|chr8:27881788-27881912,chr8,27881788,27881912,HepG2|chr8:124408985-124409002,chr8,124408985,124409002,0,96527197
HepG2|chr8:28123430-28123483,chr8,28123430,28123483,HepG2|chr8:37755763-37755860,chr8,37755763,37755860,0,9632333
HepG2|chr8:28477879-28477897,chr8,28477879,28477897,HepG2|chr8:101319894-101319988,chr8,101319894,101319988,0,72842015
HepG2|chr8:28617625-28617766,chr8,28617625,28617766,HepG2|chr8:37758537-37758570,chr8,37758537,37758570,0,9140912
HepG2|chr8:28906782-28906832,chr8,28906782,28906832,HepG2|chr8:40014307-40014407,chr8,40014307,40014407,0,11107525
HepG2|chr8:29985184-29985237,chr8,29985184,29985237,HepG2|chr8:134308878-134308943,chr8,134308878,134308943,0,104323694
HepG2|chr8:32804752-32804775,chr8,32804752,32804775,HepG2|chr8:103548010-103548140,chr8,103548010,103548140,0,70743258
HepG2|chr8:33934472-33934523,chr8,33934472,33934523,HepG2|chr8:54933541-54933632,chr8,54933541,54933632,0,20999069
HepG2|chr8:35129165-35129207,chr8,35129165,35129207,HepG2|chr8:128746852-128746959,chr8,128746852,128746959,0,93617687
HepG2|chr8:35736521-35736552,chr8,35736521,35736552,HepG2|chr8:125488693-125488816,chr8,125488693,125488816,0,89752172
HepG2|chr8:36049536-36049594,chr8,36049536,36049594,HepG2|chr8:103549208-103549286,chr8,103549208,103549286,0,67499672
HepG2|chr8:36723561-36723678,chr8,36723561,36723678,HepG2|chr8:37758537-37758570,chr8,37758537,37758570,0,1034976
HepG2|chr8:36762502-36762581,chr8,36762502,36762581,HepG2|chr8:101162100-101162205,chr8,101162100,101162205,0,64399598
HepG2|chr8:36812602-36812711,chr8,36812602,36812711,HepG2|chr8:54938522-54938591,chr8,54938522,54938591,0,18125920
HepG2|chr8:38032036-38032123,chr8,38032036,38032123,HepG2|chr8:40015719-40015782,chr8,40015719,40015782,0,1983683
HepG2|chr8:38591659-38591721,chr8,38591659,38591721,HepG2|chr8:37758464-37758570,chr8,37758464,37758570,0,833195
HepG2|chr8:41184603-41184649,chr8,41184603,41184649,HepG2|chr8:37758450-37758570,chr8,37758450,37758570,0,3426153
HepG2|chr8:41197400-41197491,chr8,41197400,41197491,HepG2|chr8:144636284-144636304,chr8,144636284,144636304,0,103438884
HepG2|chr8:41628736-41628783,chr8,41628736,41628783,HepG2|chr8:27695562-27695665,chr8,27695562,27695665,0,13933174
HepG2|chr8:41802458-41802474,chr8,41802458,41802474,HepG2|chr8:101319896-101319989,chr8,101319896,101319989,0,59517438
HepG2|chr8:43070689-43070736,chr8,43070689,43070736,HepG2|chr8:27695562-27695665,chr8,27695562,27695665,0,15375127
HepG2|chr8:43877863-43878013,chr8,43877863,43878013,HepG2|chr8:22093915-22093942,chr8,22093915,22093942,0,21783948
HepG2|chr8:44630488-44630564,chr8,44630488,44630564,HepG2|chr8:71017855-71017892,chr8,71017855,71017892,0,26387367
HepG2|chr8:44787012-44787141,chr8,44787012,44787141,HepG2|chr8:124216541-124216558,chr8,124216541,124216558,0,79429529
HepG2|chr8:45015264-45015304,chr8,45015264,45015304,HepG2|chr8:128752446-128752556,chr8,128752446,128752556,0,83737182
HepG2|chr8:45582189-45582206,chr8,45582189,45582206,HepG2|chr8:101319896-101319988,chr8,101319896,101319988,0,55737707
HepG2|chr8:47575574-47575613,chr8,47575574,47575613,HepG2|chr8:103668920-103669014,chr8,103668920,103669014,0,56093346
HepG2|chr8:47634704-47634800,chr8,47634704,47634800,HepG2|chr8:128751695-128751749,chr8,128751695,128751749,0,81116991
HepG2|chr8:47989311-47989342,chr8,47989311,47989342,HepG2|chr8:144632810-144632958,chr8,144632810,144632958,0,96643499
HepG2|chr8:49452401-49452493,chr8,49452401,49452493,HepG2|chr8:128751884-128751915,chr8,128751884,128751915,0,79299483
HepG2|chr8:49505295-49505341,chr8,49505295,49505341,HepG2|chr8:54939418-54939535,chr8,54939418,54939535,0,5434123
HepG2|chr8:50000229-50000247,chr8,50000229,50000247,HepG2|chr8:101319894-101319988,chr8,101319894,101319988,0,51319665
HepG2|chr8:50234162-50234284,chr8,50234162,50234284,HepG2|chr8:54938497-54938565,chr8,54938497,54938565,0,4704335
HepG2|chr8:50504785-50504809,chr8,50504785,50504809,HepG2|chr8:144396560-144396603,chr8,144396560,144396603,0,93891775
HepG2|chr8:50589907-50590051,chr8,50589907,50590051,HepG2|chr8:101348669-101348725,chr8,101348669,101348725,0,50758762
HepG2|chr8:51572033-51572095,chr8,51572033,51572095,HepG2|chr8:54938477-54938591,chr8,54938477,54938591,0,3366444
HepG2|chr8:51904106-51904162,chr8,51904106,51904162,HepG2|chr8:40014334-40014407,chr8,40014334,40014407,0,11889772
HepG2|chr8:52044855-52044892,chr8,52044855,52044892,HepG2|chr8:134308878-134308943,chr8,134308878,134308943,0,82264023
HepG2|chr8:53165531-53165634,chr8,53165531,53165634,HepG2|chr8:128751695-128751749,chr8,128751695,128751749,0,75586164
HepG2|chr8:53362805-53362825,chr8,53362805,53362825,HepG2|chr8:144677678-144677736,chr8,144677678,144677736,0,91314873
HepG2|chr8:53425215-53425364,chr8,53425215,53425364,HepG2|chr8:103539009-103539038,chr8,103539009,103539038,0,50113794
HepG2|chr8:54330534-54330637,chr8,54330534,54330637,HepG2|chr8:128751695-128751749,chr8,128751695,128751749,0,74421161
HepG2|chr8:55259223-55259372,chr8,55259223,55259372,HepG2|chr8:103539009-103539038,chr8,103539009,103539038,0,48279786
HepG2|chr8:55709273-55709387,chr8,55709273,55709387,HepG2|chr8:71017855-71017892,chr8,71017855,71017892,0,15308582
HepG2|chr8:55729367-55729438,chr8,55729367,55729438,HepG2|chr8:17352623-17352711,chr8,17352623,17352711,0,38376744
HepG2|chr8:57381057-57381158,chr8,57381057,57381158,HepG2|chr8:37758516-37758570,chr8,37758516,37758570,0,19622541
HepG2|chr8:57756827-57756959,chr8,57756827,57756959,HepG2|chr8:124408983-124409001,chr8,124408983,124409001,0,66652156
HepG2|chr8:57927519-57927572,chr8,57927519,57927572,HepG2|chr8:37755763-37755860,chr8,37755763,37755860,0,20171756
HepG2|chr8:59962694-59962795,chr8,59962694,59962795,HepG2|chr8:37758516-37758570,chr8,37758516,37758570,0,22204178
HepG2|chr8:59989537-59989664,chr8,59989537,59989664,HepG2|chr8:124408983-124409001,chr8,124408983,124409001,0,64419446
HepG2|chr8:60741171-60741224,chr8,60741171,60741224,HepG2|chr8:54938556-54938591,chr8,54938556,54938591,0,5802615
HepG2|chr8:60864706-60864853,chr8,60864706,60864853,HepG2|chr8:71017862-71017894,chr8,71017862,71017894,0,10153156
HepG2|chr8:61481607-61481638,chr8,61481607,61481638,HepG2|chr8:144632810-144632958,chr8,144632810,144632958,0,83151203
HepG2|chr8:61680916-61681036,chr8,61680916,61681036,HepG2|chr8:124408983-124409001,chr8,124408983,124409001,0,62728067
HepG2|chr8:61796909-61796962,chr8,61796909,61796962,HepG2|chr8:37755763-37755860,chr8,37755763,37755860,0,24041146
HepG2|chr8:62885915-62885949,chr8,62885915,62885949,HepG2|chr8:11658859-11659009,chr8,11658859,11659009,0,51227056
HepG2|chr8:62983772-62983793,chr8,62983772,62983793,HepG2|chr8:54939418-54939535,chr8,54939418,54939535,0,8044354
HepG2|chr8:63437294-63437311,chr8,63437294,63437311,HepG2|chr8:37758424-37758570,chr8,37758424,37758570,0,25678870
HepG2|chr8:64282521-64282660,chr8,64282521,64282660,HepG2|chr8:37758426-37758570,chr8,37758426,37758570,0,26524095
HepG2|chr8:64549218-64549238,chr8,64549218,64549238,HepG2|chr8:144677678-144677736,chr8,144677678,144677736,0,80128460
HepG2|chr8:65073329-65073357,chr8,65073329,65073357,HepG2|chr8:144396522-144396645,chr8,144396522,144396645,0,79323193
HepG2|chr8:65425708-65425770,chr8,65425708,65425770,HepG2|chr8:37758464-37758570,chr8,37758464,37758570,0,27667244
HepG2|chr8:66727578-66727666,chr8,66727578,66727666,HepG2|chr8:124408983-124409002,chr8,124408983,124409002,0,57681405
HepG2|chr8:67437421-67437465,chr8,67437421,67437465,HepG2|chr8:37758464-37758570,chr8,37758464,37758570,0,29678957
HepG2|chr8:68040446-68040533,chr8,68040446,68040533,HepG2|chr8:71017861-71017892,chr8,71017861,71017892,0,2977415
HepG2|chr8:68318817-68318920,chr8,68318817,68318920,HepG2|chr8:11658821-11658840,chr8,11658821,11658840,0,56659996
HepG2|chr8:68424820-68424959,chr8,68424820,68424959,HepG2|chr8:37758426-37758570,chr8,37758426,37758570,0,30666394
HepG2|chr8:68689230-68689360,chr8,68689230,68689360,HepG2|chr8:124408985-124409002,chr8,124408985,124409002,0,55719755
HepG2|chr8:68901643-68901696,chr8,68901643,68901696,HepG2|chr8:37758459-37758570,chr8,37758459,37758570,0,31143184
HepG2|chr8:69014714-69014735,chr8,69014714,69014735,HepG2|chr8:40014307-40014407,chr8,40014307,40014407,0,29000407
HepG2|chr8:69675279-69675319,chr8,69675279,69675319,HepG2|chr8:128752446-128752556,chr8,128752446,128752556,0,59077167
HepG2|chr8:71242169-71242217,chr8,71242169,71242217,HepG2|chr8:37758426-37758570,chr8,37758426,37758570,0,33483743
HepG2|chr8:72430618-72430645,chr8,72430618,72430645,HepG2|chr8:125488693-125488816,chr8,125488693,125488816,0,53058075
HepG2|chr8:72737627-72737776,chr8,72737627,72737776,HepG2|chr8:71017858-71017891,chr8,71017858,71017891,0,1719769
HepG2|chr8:73237921-73238042,chr8,73237921,73238042,HepG2|chr8:124408985-124409002,chr8,124408985,124409002,0,51171064
HepG2|chr8:73461116-73461178,chr8,73461116,73461178,HepG2|chr8:37758484-37758570,chr8,37758484,37758570,0,35702632
HepG2|chr8:73951636-73951768,chr8,73951636,73951768,HepG2|chr8:124216541-124216558,chr8,124216541,124216558,0,50264905
HepG2|chr8:74762843-74762927,chr8,74762843,74762927,HepG2|chr8:40015687-40015764,chr8,40015687,40015764,0,34747156
HepG2|chr8:75000448-75000550,chr8,75000448,75000550,HepG2|chr8:128752343-128752483,chr8,128752343,128752483,0,53751895
HepG2|chr8:75826130-75826157,chr8,75826130,75826157,HepG2|chr8:144396522-144396645,chr8,144396522,144396645,0,68570392
HepG2|chr8:75880043-75880193,chr8,75880043,75880193,HepG2|chr8:144642365-144642386,chr8,144642365,144642386,0,68762322
HepG2|chr8:78889551-78889585,chr8,78889551,78889585,HepG2|chr8:11658859-11659009,chr8,11658859,11659009,0,67230692
HepG2|chr8:80401690-80401745,chr8,80401690,80401745,HepG2|chr8:54936262-54936325,chr8,54936262,54936325,0,25465428
HepG2|chr8:80439457-80439567,chr8,80439457,80439567,HepG2|chr8:128746852-128746959,chr8,128746852,128746959,0,48307395
HepG2|chr8:80524560-80524576,chr8,80524560,80524576,HepG2|chr8:101319896-101319989,chr8,101319896,101319989,0,20795336
HepG2|chr8:81228762-81228859,chr8,81228762,81228859,HepG2|chr8:103669502-103669649,chr8,103669502,103669649,0,22440740
HepG2|chr8:82246613-82246661,chr8,82246613,82246661,HepG2|chr8:101348629-101348725,chr8,101348629,101348725,0,19102016
HepG2|chr8:82958059-82958168,chr8,82958059,82958168,HepG2|chr8:54938522-54938591,chr8,54938522,54938591,0,28019537
HepG2|chr8:84950275-84950330,chr8,84950275,84950330,HepG2|chr8:54936262-54936325,chr8,54936262,54936325,0,30014013
HepG2|chr8:86247500-86247622,chr8,86247500,86247622,HepG2|chr8:54938497-54938565,chr8,54938497,54938565,0,31309003
HepG2|chr8:87765010-87765031,chr8,87765010,87765031,HepG2|chr8:40014307-40014407,chr8,40014307,40014407,0,47750703
HepG2|chr8:88055180-88055228,chr8,88055180,88055228,HepG2|chr8:37758426-37758570,chr8,37758426,37758570,0,50296754
HepG2|chr8:89176502-89176619,chr8,89176502,89176619,HepG2|chr8:37758537-37758570,chr8,37758537,37758570,0,51417965
HepG2|chr8:90519354-90519428,chr8,90519354,90519428,HepG2|chr8:128752446-128752556,chr8,128752446,128752556,0,38233092
HepG2|chr8:90703691-90703712,chr8,90703691,90703712,HepG2|chr8:54939418-54939535,chr8,54939418,54939535,0,35764273
HepG2|chr8:91124165-91124297,chr8,91124165,91124297,HepG2|chr8:124408983-124409001,chr8,124408983,124409001,0,33284818
HepG2|chr8:91211600-91211696,chr8,91211600,91211696,HepG2|chr8:22090719-22090760,chr8,22090719,22090760,0,69120881
HepG2|chr8:92578581-92578634,chr8,92578581,92578634,HepG2|chr8:37755763-37755860,chr8,37755763,37755860,0,54822818
HepG2|chr8:92652713-92652766,chr8,92652713,92652766,HepG2|chr8:134308878-134308943,chr8,134308878,134308943,0,41656165
HepG2|chr8:92775413-92775563,chr8,92775413,92775563,HepG2|chr8:144393523-144393570,chr8,144393523,144393570,0,51618110
HepG2|chr8:92887464-92887495,chr8,92887464,92887495,HepG2|chr8:125488693-125488816,chr8,125488693,125488816,0,32601229
HepG2|chr8:93402374-93402465,chr8,93402374,93402465,HepG2|chr8:144636284-144636304,chr8,144636284,144636304,0,51233910
HepG2|chr8:94440211-94440228,chr8,94440211,94440228,HepG2|chr8:37758424-37758570,chr8,37758424,37758570,0,56681787
HepG2|chr8:95897428-95897484,chr8,95897428,95897484,HepG2|chr8:40014334-40014407,chr8,40014334,40014407,0,55883094
HepG2|chr8:95913319-95913341,chr8,95913319,95913341,HepG2|chr8:40014366-40014407,chr8,40014366,40014407,0,55898953
HepG2|chr8:95988529-95988603,chr8,95988529,95988603,HepG2|chr8:37621428-37621482,chr8,37621428,37621482,0,58367101
HepG2|chr8:96345645-96345707,chr8,96345645,96345707,HepG2|chr8:103548274-103548320,chr8,103548274,103548320,0,7202629
HepG2|chr8:96404839-96404926,chr8,96404839,96404926,HepG2|chr8:101348629-101348725,chr8,101348629,101348725,0,4943790
HepG2|chr8:96922161-96922245,chr8,96922161,96922245,HepG2|chr8:40015687-40015764,chr8,40015687,40015764,0,56906474
HepG2|chr8:97277499-97277620,chr8,97277499,97277620,HepG2|chr8:103539009-103539038,chr8,103539009,103539038,0,6261510
HepG2|chr8:97738556-97738654,chr8,97738556,97738654,HepG2|chr8:128749088-128749137,chr8,128749088,128749137,0,31010532
HepG2|chr8:97847855-97847912,chr8,97847855,97847912,HepG2|chr8:128751642-128751731,chr8,128751642,128751731,0,30903787
HepG2|chr8:98000211-98000270,chr8,98000211,98000270,HepG2|chr8:134581505-134581652,chr8,134581505,134581652,0,36581294
HepG2|chr8:98007688-98007730,chr8,98007688,98007730,HepG2|chr8:128746852-128746959,chr8,128746852,128746959,0,30739164
HepG2|chr8:98383145-98383248,chr8,98383145,98383248,HepG2|chr8:17352623-17352662,chr8,17352623,17352662,0,81030522
HepG2|chr8:98538924-98539056,chr8,98538924,98539056,HepG2|chr8:124216541-124216558,chr8,124216541,124216558,0,25677617
HepG2|chr8:99266935-99267022,chr8,99266935,99267022,HepG2|chr8:101348629-101348725,chr8,101348629,101348725,0,2081694
HepG2|chr8:99929516-99929643,chr8,99929516,99929643,HepG2|chr8:54938451-54938565,chr8,54938451,54938565,0,44991065
HepG2|chr8:101598139-101598233,chr8,101598139,101598233,HepG2|chr8:117780105-117780168,chr8,117780105,117780168,0,16181966
HepG2|chr8:102261717-102261786,chr8,102261717,102261786,HepG2|chr8:54938510-54938591,chr8,54938510,54938591,0,47323207
HepG2|chr8:103443592-103443642,chr8,103443592,103443642,HepG2|chr8:40014307-40014407,chr8,40014307,40014407,0,63429285
HepG2|chr8:105613144-105613202,chr8,105613144,105613202,HepG2|chr8:103549208-103549286,chr8,103549208,103549286,0,2063936
HepG2|chr8:106677602-106677729,chr8,106677602,106677729,HepG2|chr8:54938451-54938565,chr8,54938451,54938565,0,51739151
HepG2|chr8:106765859-106766003,chr8,106765859,106766003,HepG2|chr8:101348669-101348725,chr8,101348669,101348725,0,5417190
HepG2|chr8:107159732-107159849,chr8,107159732,107159849,HepG2|chr8:128749088-128749137,chr8,128749088,128749137,0,21589356
HepG2|chr8:107546860-107546941,chr8,107546860,107546941,HepG2|chr8:54938522-54938591,chr8,54938522,54938591,0,52608338
HepG2|chr8:107990511-107990546,chr8,107990511,107990546,HepG2|chr8:37758472-37758570,chr8,37758472,37758570,0,70232039
HepG2|chr8:108316745-108316807,chr8,108316745,108316807,HepG2|chr8:134580663-134580800,chr8,134580663,134580800,0,26263918
HepG2|chr8:110599501-110599547,chr8,110599501,110599547,HepG2|chr8:54939418-54939535,chr8,54939418,54939535,0,55660083
HepG2|chr8:111752113-111752184,chr8,111752113,111752184,HepG2|chr8:17352623-17352711,chr8,17352623,17352711,0,94399490
HepG2|chr8:112951079-112951106,chr8,112951079,112951106,HepG2|chr8:125488693-125488816,chr8,125488693,125488816,0,12537614
HepG2|chr8:113089412-113089486,chr8,113089412,113089486,HepG2|chr8:37621428-37621482,chr8,37621428,37621482,0,75467984
HepG2|chr8:114362283-114362307,chr8,114362283,114362307,HepG2|chr8:144396560-144396603,chr8,144396560,144396603,0,30034277
HepG2|chr8:115395217-115395297,chr8,115395217,115395297,HepG2|chr8:40015752-40015782,chr8,40015752,40015782,0,75379465
HepG2|chr8:115774548-115774578,chr8,115774548,115774578,HepG2|chr8:37758450-37758570,chr8,37758450,37758570,0,78016098
HepG2|chr8:116408987-116409026,chr8,116408987,116409026,HepG2|chr8:103668920-103669014,chr8,103668920,103669014,0,12740067
HepG2|chr8:116740830-116740912,chr8,116740830,116740912,HepG2|chr8:128751884-128751915,chr8,128751884,128751915,0,12011054
HepG2|chr8:116825456-116825554,chr8,116825456,116825554,HepG2|chr8:128749088-128749137,chr8,128749088,128749137,0,11923632
HepG2|chr8:117513977-117514054,chr8,117513977,117514054,HepG2|chr8:40015709-40015782,chr8,40015709,40015782,0,77498268
HepG2|chr8:117613998-117614054,chr8,117613998,117614054,HepG2|chr8:40014301-40014407,chr8,40014301,40014407,0,77599697
HepG2|chr8:118673656-118673748,chr8,118673656,118673748,HepG2|chr8:144677678-144677736,chr8,144677678,144677736,0,26004022
HepG2|chr8:119436174-119436206,chr8,119436174,119436206,HepG2|chr8:128752164-128752217,chr8,128752164,128752217,0,9315990
HepG2|chr8:120426178-120426235,chr8,120426178,120426235,HepG2|chr8:128751642-128751731,chr8,128751642,128751731,0,8325464
HepG2|chr8:120583796-120583856,chr8,120583796,120583856,HepG2|chr8:119119853-119119935,chr8,119119853,119119935,0,1463943
HepG2|chr8:120604228-120604324,chr8,120604228,120604324,HepG2|chr8:37758516-37758570,chr8,37758516,37758570,0,82845712
HepG2|chr8:120679401-120679447,chr8,120679401,120679447,HepG2|chr8:37758450-37758570,chr8,37758450,37758570,0,82920951
HepG2|chr8:120765058-120765134,chr8,120765058,120765134,HepG2|chr8:71017855-71017892,chr8,71017855,71017892,0,49747203
HepG2|chr8:120769253-120769367,chr8,120769253,120769367,HepG2|chr8:71017855-71017892,chr8,71017855,71017892,0,49751398
HepG2|chr8:121568037-121568140,chr8,121568037,121568140,HepG2|chr8:144393523-144393570,chr8,144393523,144393570,0,22825486
HepG2|chr8:121947689-121947716,chr8,121947689,121947716,HepG2|chr8:144396522-144396645,chr8,144396522,144396645,0,22448833
HepG2|chr8:122347202-122347241,chr8,122347202,122347241,HepG2|chr8:37758459-37758570,chr8,37758459,37758570,0,84588743
HepG2|chr8:123471609-123471698,chr8,123471609,123471698,HepG2|chr8:128751642-128751731,chr8,128751642,128751731,0,5280033
HepG2|chr8:123695278-123695347,chr8,123695278,123695347,HepG2|chr8:54938510-54938591,chr8,54938510,54938591,0,68756768
HepG2|chr8:124551434-124551553,chr8,124551434,124551553,HepG2|chr8:124408983-124409002,chr8,124408983,124409002,0,142451
HepG2|chr8:124672146-124672206,chr8,124672146,124672206,HepG2|chr8:54935417-54935567,chr8,54935417,54935567,0,69736729
HepG2|chr8:124681737-124681886,chr8,124681737,124681886,HepG2|chr8:71017858-71017891,chr8,71017858,71017891,0,53663879
HepG2|chr8:124739781-124739843,chr8,124739781,124739843,HepG2|chr8:103548274-103548320,chr8,103548274,103548320,0,21191507
HepG2|chr8:125773317-125773370,chr8,125773317,125773370,HepG2|chr8:40015685-40015782,chr8,40015685,40015782,0,85757632
HepG2|chr8:126221579-126221663,chr8,126221579,126221663,HepG2|chr8:117780105-117780168,chr8,117780105,117780168,0,8441474
HepG2|chr8:126348976-126349027,chr8,126348976,126349027,HepG2|chr8:37761712-37761741,chr8,37761712,37761741,0,88587264
HepG2|chr8:126671215-126671325,chr8,126671215,126671325,HepG2|chr8:128746852-128746959,chr8,128746852,128746959,0,2075637
HepG2|chr8:127000880-127000976,chr8,127000880,127000976,HepG2|chr8:128751695-128751749,chr8,128751695,128751749,0,1750815
HepG2|chr8:127238496-127238599,chr8,127238496,127238599,HepG2|chr8:11658821-11658840,chr8,11658821,11658840,0,115579675
HepG2|chr8:127266293-127266346,chr8,127266293,127266346,HepG2|chr8:54938556-54938591,chr8,54938556,54938591,0,72327737
HepG2|chr8:127730691-127730775,chr8,127730691,127730775,HepG2|chr8:103668874-103669014,chr8,103668874,103669014,0,24061817
HepG2|chr8:129666702-129666792,chr8,129666702,129666792,HepG2|chr8:71017861-71017892,chr8,71017861,71017892,0,58648841
HepG2|chr8:129927567-129927657,chr8,129927567,129927657,HepG2|chr8:71017861-71017892,chr8,71017861,71017892,0,58909706
HepG2|chr8:132129665-132129762,chr8,132129665,132129762,HepG2|chr8:103669502-103669649,chr8,103669502,103669649,0,28460163
HepG2|chr8:133091592-133091684,chr8,133091592,133091684,HepG2|chr8:144677678-144677736,chr8,144677678,144677736,0,11586086
HepG2|chr8:134968854-134968918,chr8,134968854,134968918,HepG2|chr8:37758484-37758570,chr8,37758484,37758570,0,97210370
HepG2|chr8:135285236-135285339,chr8,135285236,135285339,HepG2|chr8:17352623-17352662,chr8,17352623,17352662,0,117932613
HepG2|chr8:135382213-135382293,chr8,135382213,135382293,HepG2|chr8:40015752-40015782,chr8,40015752,40015782,0,95366461
HepG2|chr8:135859715-135859794,chr8,135859715,135859794,HepG2|chr8:101162100-101162205,chr8,101162100,101162205,0,34697615
HepG2|chr8:136832219-136832247,chr8,136832219,136832247,HepG2|chr8:144396522-144396645,chr8,144396522,144396645,0,7564303
HepG2|chr8:139059508-139059600,chr8,139059508,139059600,HepG2|chr8:128751884-128751915,chr8,128751884,128751915,0,10307624
HepG2|chr8:139115174-139115304,chr8,139115174,139115304,HepG2|chr8:124408985-124409002,chr8,124408985,124409002,0,14706189
HepG2|chr8:139217126-139217186,chr8,139217126,139217186,HepG2|chr8:54935417-54935567,chr8,54935417,54935567,0,84281709
HepG2|chr8:139837066-139837150,chr8,139837066,139837150,HepG2|chr8:117780105-117780168,chr8,117780105,117780168,0,22056961
HepG2|chr8:140630187-140630255,chr8,140630187,140630255,HepG2|chr8:128752077-128752159,chr8,128752077,128752159,0,11878110
HepG2|chr8:142412907-142412930,chr8,142412907,142412930,HepG2|chr8:71017861-71017891,chr8,71017861,71017891,0,71395046
HepG2|chr8:142468497-142468519,chr8,142468497,142468519,HepG2|chr8:40014366-40014407,chr8,40014366,40014407,0,102454131
HepG2|chr8:142622634-142622753,chr8,142622634,142622753,HepG2|chr8:124408983-124409002,chr8,124408983,124409002,0,18213651
HepG2|chr8:142751995-142752063,chr8,142751995,142752063,HepG2|chr8:103536171-103536318,chr8,103536171,103536318,0,39215824
HepG2|chr8:143081660-143081713,chr8,143081660,143081713,HepG2|chr8:40015685-40015782,chr8,40015685,40015782,0,103065975
HepG2|chr8:143259116-143259197,chr8,143259116,143259197,HepG2|chr8:54938522-54938591,chr8,54938522,54938591,0,88320594
HepG2|chr8:143595899-143595950,chr8,143595899,143595950,HepG2|chr8:54933541-54933632,chr8,54933541,54933632,0,88662358
HepG2|chr8:143760732-143760795,chr8,143760732,143760795,HepG2|chr8:103548274-103548320,chr8,103548274,103548320,0,40212458
HepG2|chr8:144434717-144434780,chr8,144434717,144434780,HepG2|chr8:119119853-119119935,chr8,119119853,119119935,0,25314864
HepG2|chr8:144659696-144659792,chr8,144659696,144659792,HepG2|chr8:22090719-22090760,chr8,22090719,22090760,0,122568977
HepG2|chr8:145287940-145288002,chr8,145287940,145288002,HepG2|chr8:134580663-134580800,chr8,134580663,134580800,0,10707277
HepG2|chr8:146034356-146034379,chr8,146034356,146034379,HepG2|chr8:103548010-103548140,chr8,103548010,103548140,0,42486346
HepG2|chr8:146310109-146310236,chr8,146310109,146310236,HepG2|chr8:124408983-124409001,chr8,124408983,124409001,0,21901126
HepG2|chr9:1459427-1459577,chr9,1459427,1459577,HepG2|chr9:70646052-70646109,chr9,70646052,70646109,0,69186625
HepG2|chr9:1464082-1464141,chr9,1464082,1464141,HepG2|chr9:45442109-45442224,chr9,45442109,45442224,0,43978027
HepG2|chr9:2425283-2425394,chr9,2425283,2425394,HepG2|chr9:45442301-45442389,chr9,45442301,45442389,0,43017018
HepG2|chr9:2987098-2987228,chr9,2987098,2987228,HepG2|chr9:86432779-86432848,chr9,86432779,86432848,0,83445681
HepG2|chr9:3221807-3221846,chr9,3221807,3221846,HepG2|chr9:37122031-37122081,chr9,37122031,37122081,0,33900224
HepG2|chr9:4137269-4137381,chr9,4137269,4137381,HepG2|chr9:67335066-67335103,chr9,67335066,67335103,0,63197797
HepG2|chr9:4618164-4618232,chr9,4618164,4618232,HepG2|chr9:37121747-37121800,chr9,37121747,37121800,0,32503583
HepG2|chr9:4827530-4827577,chr9,4827530,4827577,HepG2|chr9:131443746-131443896,chr9,131443746,131443896,0,126616216
HepG2|chr9:5263890-5264036,chr9,5263890,5264036,HepG2|chr9:131441853-131441915,chr9,131441853,131441915,0,126177963
HepG2|chr9:5516783-5516842,chr9,5516783,5516842,HepG2|chr9:45442256-45442394,chr9,45442256,45442394,0,39925473
HepG2|chr9:5722256-5722373,chr9,5722256,5722373,HepG2|chr9:45442310-45442394,chr9,45442310,45442394,0,39720054
HepG2|chr9:6010876-6010982,chr9,6010876,6010982,HepG2|chr9:71731728-71731878,chr9,71731728,71731878,0,65720852
HepG2|chr9:6611751-6611813,chr9,6611751,6611813,HepG2|chr9:45442234-45442320,chr9,45442234,45442320,0,38830483
HepG2|chr9:6668905-6668968,chr9,6668905,6668968,HepG2|chr9:45442265-45442394,chr9,45442265,45442394,0,38773360
HepG2|chr9:7821201-7821288,chr9,7821201,7821288,HepG2|chr9:45442431-45442490,chr9,45442431,45442490,0,37621230
HepG2|chr9:8765265-8765346,chr9,8765265,8765346,HepG2|chr9:97770132-97770187,chr9,97770132,97770187,0,89004867
HepG2|chr9:8810862-8810959,chr9,8810862,8810959,HepG2|chr9:91145491-91145543,chr9,91145491,91145543,0,82334629
HepG2|chr9:9250307-9250434,chr9,9250307,9250434,HepG2|chr9:90341808-90341825,chr9,90341808,90341825,0,81091501
HepG2|chr9:9931693-9931782,chr9,9931693,9931782,HepG2|chr9:91145621-91145682,chr9,91145621,91145682,0,81213928
HepG2|chr9:11274226-11274336,chr9,11274226,11274336,HepG2|chr9:6703562-6703602,chr9,6703562,6703602,0,4570664
HepG2|chr9:11527659-11527748,chr9,11527659,11527748,HepG2|chr9:71733398-71733548,chr9,71733398,71733548,0,60205739
HepG2|chr9:13152349-13152451,chr9,13152349,13152451,HepG2|chr9:45442431-45442492,chr9,45442431,45442492,0,32290082
HepG2|chr9:13608324-13608380,chr9,13608324,13608380,HepG2|chr9:45442179-45442262,chr9,45442179,45442262,0,31833855
HepG2|chr9:13773171-13773314,chr9,13773171,13773314,HepG2|chr9:86432762-86432813,chr9,86432762,86432813,0,72659591
HepG2|chr9:14093910-14094007,chr9,14093910,14094007,HepG2|chr9:91145491-91145543,chr9,91145491,91145543,0,77051581
HepG2|chr9:14442172-14442262,chr9,14442172,14442262,HepG2|chr9:35695154-35695304,chr9,35695154,35695304,0,21252982
HepG2|chr9:14875409-14875525,chr9,14875409,14875525,HepG2|chr9:91147223-91147257,chr9,91147223,91147257,0,76271814
HepG2|chr9:15702114-15702232,chr9,15702114,15702232,HepG2|chr9:70645946-70646028,chr9,70645946,70646028,0,54943832
HepG2|chr9:16888454-16888558,chr9,16888454,16888558,HepG2|chr9:70645938-70646007,chr9,70645938,70646007,0,53757484
HepG2|chr9:17385303-17385415,chr9,17385303,17385415,HepG2|chr9:45442301-45442389,chr9,45442301,45442389,0,28056998
HepG2|chr9:18797957-18798035,chr9,18797957,18798035,HepG2|chr9:35695154-35695194,chr9,35695154,35695194,0,16897197
HepG2|chr9:18858551-18858638,chr9,18858551,18858638,HepG2|chr9:45442431-45442490,chr9,45442431,45442490,0,26583880
HepG2|chr9:18925838-18925900,chr9,18925838,18925900,HepG2|chr9:45442234-45442320,chr9,45442234,45442320,0,26516396
HepG2|chr9:18939908-18939981,chr9,18939908,18939981,HepG2|chr9:37122045-37122120,chr9,37122045,37122120,0,18182137
HepG2|chr9:19031622-19031709,chr9,19031622,19031709,HepG2|chr9:70646052-70646139,chr9,70646052,70646139,0,51614430
HepG2|chr9:19037062-19037112,chr9,19037062,19037112,HepG2|chr9:131441940-131442035,chr9,131441940,131442035,0,112404878
HepG2|chr9:19061423-19061512,chr9,19061423,19061512,HepG2|chr9:71733398-71733548,chr9,71733398,71733548,0,52671975
HepG2|chr9:19495428-19495575,chr9,19495428,19495575,HepG2|chr9:91145621-91145682,chr9,91145621,91145682,0,71650193
HepG2|chr9:19725765-19725795,chr9,19725765,19725795,HepG2|chr9:97770006-97770093,chr9,97770006,97770093,0,78044241
HepG2|chr9:20809219-20809262,chr9,20809219,20809262,HepG2|chr9:131443763-131443856,chr9,131443763,131443856,0,110634544
HepG2|chr9:23073328-23073387,chr9,23073328,23073387,HepG2|chr9:37121478-37121532,chr9,37121478,37121532,0,14048150
HepG2|chr9:23517318-23517407,chr9,23517318,23517407,HepG2|chr9:71733083-71733144,chr9,71733083,71733144,0,48215765
HepG2|chr9:23951035-23951125,chr9,23951035,23951125,HepG2|chr9:37121478-37121532,chr9,37121478,37121532,0,13170443
HepG2|chr9:24125716-24125760,chr9,24125716,24125760,HepG2|chr9:140008839-140008985,chr9,140008839,140008985,0,115883123
HepG2|chr9:24662164-24662276,chr9,24662164,24662276,HepG2|chr9:45442301-45442389,chr9,45442301,45442389,0,20780137
HepG2|chr9:25049228-25049301,chr9,25049228,25049301,HepG2|chr9:37121760-37121904,chr9,37121760,37121904,0,12072532
HepG2|chr9:25097554-25097704,chr9,25097554,25097704,HepG2|chr9:70646315-70646465,chr9,70646315,70646465,0,45548761
HepG2|chr9:26224574-26224704,chr9,26224574,26224704,HepG2|chr9:86432779-86432848,chr9,86432779,86432848,0,60208205
HepG2|chr9:26557150-26557250,chr9,26557150,26557250,HepG2|chr9:37122031-37122081,chr9,37122031,37122081,0,10564881
HepG2|chr9:26864181-26864262,chr9,26864181,26864262,HepG2|chr9:132562389-132562446,chr9,132562389,132562446,0,105698208
HepG2|chr9:30627371-30627419,chr9,30627371,30627419,HepG2|chr9:131446559-131446634,chr9,131446559,131446634,0,100819188
HepG2|chr9:30949097-30949170,chr9,30949097,30949170,HepG2|chr9:26946163-26946252,chr9,26946163,26946252,0,4002934
HepG2|chr9:31766459-31766571,chr9,31766459,31766571,HepG2|chr9:67335066-67335103,chr9,67335066,67335103,0,35568607
HepG2|chr9:31848434-31848521,chr9,31848434,31848521,HepG2|chr9:70646052-70646139,chr9,70646052,70646139,0,38797618
HepG2|chr9:32772668-32772727,chr9,32772668,32772727,HepG2|chr9:45442256-45442394,chr9,45442256,45442394,0,12669588
HepG2|chr9:33118052-33118193,chr9,33118052,33118193,HepG2|chr9:35695942-35696014,chr9,35695942,35696014,0,2577890
HepG2|chr9:33760504-33760561,chr9,33760504,33760561,HepG2|chr9:26946163-26946252,chr9,26946163,26946252,0,6814341
HepG2|chr9:34061759-34061878,chr9,34061759,34061878,HepG2|chr9:70646011-70646067,chr9,70646011,70646067,0,36584252
HepG2|chr9:34491660-34491705,chr9,34491660,34491705,HepG2|chr9:33000199-33000346,chr9,33000199,33000346,0,1491461
HepG2|chr9:37735084-37735128,chr9,37735084,37735128,HepG2|chr9:98270346-98270484,chr9,98270346,98270484,0,60535262
HepG2|chr9:39438233-39438307,chr9,39438233,39438307,HepG2|chr9:131441853-131441915,chr9,131441853,131441915,0,92003620
HepG2|chr9:40587587-40587700,chr9,40587587,40587700,HepG2|chr9:67335066-67335103,chr9,67335066,67335103,0,26747479
HepG2|chr9:40848131-40848184,chr9,40848131,40848184,HepG2|chr9:131446559-131446634,chr9,131446559,131446634,0,90598428
HepG2|chr9:41884546-41884592,chr9,41884546,41884592,HepG2|chr9:131440756-131440830,chr9,131440756,131440830,0,89556210
HepG2|chr9:42565383-42565493,chr9,42565383,42565493,HepG2|chr9:45442301-45442394,chr9,45442301,45442394,0,2876918
HepG2|chr9:44428199-44428240,chr9,44428199,44428240,HepG2|chr9:130741146-130741291,chr9,130741146,130741291,0,86312947
HepG2|chr9:44504466-44504570,chr9,44504466,44504570,HepG2|chr9:45442217-45442367,chr9,45442217,45442367,0,937751
HepG2|chr9:45166397-45166439,chr9,45166397,45166439,HepG2|chr9:33475630-33475694,chr9,33475630,33475694,0,11690767
HepG2|chr9:46692294-46692335,chr9,46692294,46692335,HepG2|chr9:33000199-33000346,chr9,33000199,33000346,0,13692095
HepG2|chr9:47428551-47428655,chr9,47428551,47428655,HepG2|chr9:130371225-130371287,chr9,130371225,130371287,0,82942674
HepG2|chr9:48907366-48907422,chr9,48907366,48907422,HepG2|chr9:130369985-130370068,chr9,130369985,130370068,0,81462619
HepG2|chr9:49117060-49117159,chr9,49117060,49117159,HepG2|chr9:70646011-70646062,chr9,70646011,70646062,0,21528951
HepG2|chr9:49302297-49302447,chr9,49302297,49302447,HepG2|chr9:70646052-70646103,chr9,70646052,70646103,0,21343755
HepG2|chr9:50007258-50007404,chr9,50007258,50007404,HepG2|chr9:131441853-131441915,chr9,131441853,131441915,0,81434595
HepG2|chr9:50407537-50407620,chr9,50407537,50407620,HepG2|chr9:91145491-91145543,chr9,91145491,91145543,0,40737954
HepG2|chr9:51881481-51881511,chr9,51881481,51881511,HepG2|chr9:139309290-139309440,chr9,139309290,139309440,0,87427809
HepG2|chr9:52707907-52707990,chr9,52707907,52707990,HepG2|chr9:97770132-97770187,chr9,97770132,97770187,0,45062225
HepG2|chr9:52916612-52916704,chr9,52916612,52916704,HepG2|chr9:71734866-71734913,chr9,71734866,71734913,0,18818254
HepG2|chr9:52920310-52920443,chr9,52920310,52920443,HepG2|chr9:70646030-70646169,chr9,70646030,70646169,0,17725720
HepG2|chr9:53282800-53282944,chr9,53282800,53282944,HepG2|chr9:70646052-70646124,chr9,70646052,70646124,0,17363252
HepG2|chr9:53317148-53317202,chr9,53317148,53317202,HepG2|chr9:37121291-37121326,chr9,37121291,37121326,0,16195857
HepG2|chr9:54476959-54477030,chr9,54476959,54477030,HepG2|chr9:102860430-102860507,chr9,102860430,102860507,0,48383471
HepG2|chr9:54559376-54559418,chr9,54559376,54559418,HepG2|chr9:131443763-131443856,chr9,131443763,131443856,0,76884387
HepG2|chr9:54949714-54949818,chr9,54949714,54949818,HepG2|chr9:45442217-45442367,chr9,45442217,45442367,0,9507497
HepG2|chr9:55301657-55301760,chr9,55301657,55301760,HepG2|chr9:91004558-91004590,chr9,91004558,91004590,0,35702901
HepG2|chr9:55613834-55613912,chr9,55613834,55613912,HepG2|chr9:35695942-35696014,chr9,35695942,35696014,0,19917892
HepG2|chr9:55772123-55772195,chr9,55772123,55772195,HepG2|chr9:131446559-131446634,chr9,131446559,131446634,0,75674436
HepG2|chr9:59063653-59063770,chr9,59063653,59063770,HepG2|chr9:45442310-45442394,chr9,45442310,45442394,0,13621343
HepG2|chr9:59324209-59324359,chr9,59324209,59324359,HepG2|chr9:70645946-70646043,chr9,70645946,70646043,0,11321737
HepG2|chr9:59519460-59519519,chr9,59519460,59519519,HepG2|chr9:37121478-37121532,chr9,37121478,37121532,0,22397982
HepG2|chr9:60212770-60212907,chr9,60212770,60212907,HepG2|chr9:130821282-130821432,chr9,130821282,130821432,0,70608512
HepG2|chr9:60472526-60472676,chr9,60472526,60472676,HepG2|chr9:131440727-131440779,chr9,131440727,131440779,0,70968201
HepG2|chr9:60696956-60696986,chr9,60696956,60696986,HepG2|chr9:139309290-139309440,chr9,139309290,139309440,0,78612334
HepG2|chr9:61589725-61589840,chr9,61589725,61589840,HepG2|chr9:91148744-91148779,chr9,91148744,91148779,0,29559019
HepG2|chr9:61669864-61670014,chr9,61669864,61670014,HepG2|chr9:70646315-70646465,chr9,70646315,70646465,0,8976451
HepG2|chr9:61682540-61682655,chr9,61682540,61682655,HepG2|chr9:91148744-91148779,chr9,91148744,91148779,0,29466204
HepG2|chr9:61714524-61714613,chr9,61714524,61714613,HepG2|chr9:91145621-91145682,chr9,91145621,91145682,0,29431097
HepG2|chr9:62260449-62260486,chr9,62260449,62260486,HepG2|chr9:45442244-45442394,chr9,45442244,45442394,0,16818205
HepG2|chr9:62806377-62806492,chr9,62806377,62806492,HepG2|chr9:45442296-45442394,chr9,45442296,45442394,0,17364081
HepG2|chr9:63783014-63783157,chr9,63783014,63783157,HepG2|chr9:86432762-86432813,chr9,86432762,86432813,0,22649748
HepG2|chr9:63910136-63910231,chr9,63910136,63910231,HepG2|chr9:37121851-37121904,chr9,37121851,37121904,0,26788285
HepG2|chr9:64388514-64388561,chr9,64388514,64388561,HepG2|chr9:131443746-131443896,chr9,131443746,131443896,0,67055232
HepG2|chr9:65159865-65159909,chr9,65159865,65159909,HepG2|chr9:140008839-140008985,chr9,140008839,140008985,0,74848974
HepG2|chr9:65168462-65168552,chr9,65168462,65168552,HepG2|chr9:35695154-35695304,chr9,35695154,35695304,0,29473308
HepG2|chr9:65761025-65761067,chr9,65761025,65761067,HepG2|chr9:33475630-33475694,chr9,33475630,33475694,0,32285395
HepG2|chr9:66255118-66255169,chr9,66255118,66255169,HepG2|chr9:67335066-67335103,chr9,67335066,67335103,0,1079948
HepG2|chr9:66572785-66572882,chr9,66572785,66572882,HepG2|chr9:45442299-45442394,chr9,45442299,45442394,0,21130486
HepG2|chr9:67114680-67114782,chr9,67114680,67114782,HepG2|chr9:45442431-45442492,chr9,45442431,45442492,0,21672249
HepG2|chr9:67493929-67493993,chr9,67493929,67493993,HepG2|chr9:33478860-33478946,chr9,33478860,33478946,0,34015069
HepG2|chr9:67705797-67705903,chr9,67705797,67705903,HepG2|chr9:91004558-91004590,chr9,91004558,91004590,0,23298761
HepG2|chr9:68109120-68109270,chr9,68109120,68109270,HepG2|chr9:131440727-131440779,chr9,131440727,131440779,0,63331607
HepG2|chr9:68541643-68541664,chr9,68541643,68541664,HepG2|chr9:91148120-91148270,chr9,91148120,91148270,0,22606477
HepG2|chr9:69547879-69548029,chr9,69547879,69548029,HepG2|chr9:45442241-45442391,chr9,45442241,45442391,0,24105638
HepG2|chr9:69705847-69705997,chr9,69705847,69705997,HepG2|chr9:70646052-70646103,chr9,70646052,70646103,0,940205
HepG2|chr9:71158996-71159111,chr9,71158996,71159111,HepG2|chr9:45442431-45442484,chr9,45442431,45442484,0,25716565
HepG2|chr9:71398974-71399124,chr9,71398974,71399124,HepG2|chr9:35695912-35696062,chr9,35695912,35696062,0,35703062
HepG2|chr9:71566458-71566531,chr9,71566458,71566531,HepG2|chr9:102860430-102860507,chr9,102860430,102860507,0,31293972
HepG2|chr9:71734699-71734772,chr9,71734699,71734772,HepG2|chr9:37121760-37121904,chr9,37121760,37121904,0,34612939
HepG2|chr9:71980112-71980176,chr9,71980112,71980176,HepG2|chr9:33478860-33478946,chr9,33478860,33478946,0,38501252
HepG2|chr9:72616794-72616944,chr9,72616794,72616944,HepG2|chr9:35695912-35696062,chr9,35695912,35696062,0,36920882
HepG2|chr9:72658272-72658372,chr9,72658272,72658372,HepG2|chr9:37122031-37122081,chr9,37122031,37122081,0,35536241
HepG2|chr9:72931174-72931265,chr9,72931174,72931265,HepG2|chr9:45442431-45442563,chr9,45442431,45442563,0,27488743
HepG2|chr9:73490300-73490415,chr9,73490300,73490415,HepG2|chr9:6703562-6703602,chr9,6703562,6703602,0,66786738
HepG2|chr9:73725831-73725903,chr9,73725831,73725903,HepG2|chr9:131446559-131446634,chr9,131446559,131446634,0,57720728
HepG2|chr9:74997724-74997874,chr9,74997724,74997874,HepG2|chr9:91148744-91148779,chr9,91148744,91148779,0,16151020
HepG2|chr9:75783951-75784039,chr9,75783951,75784039,HepG2|chr9:130371225-130371287,chr9,130371225,130371287,0,54587274
HepG2|chr9:76702621-76702745,chr9,76702621,76702745,HepG2|chr9:45442301-45442394,chr9,45442301,45442394,0,31260320
HepG2|chr9:76704731-76704761,chr9,76704731,76704761,HepG2|chr9:97770006-97770093,chr9,97770006,97770093,0,21065275
HepG2|chr9:78010725-78010762,chr9,78010725,78010762,HepG2|chr9:45442244-45442394,chr9,45442244,45442394,0,32568481
HepG2|chr9:79728578-79728694,chr9,79728578,79728694,HepG2|chr9:45442431-45442491,chr9,45442431,45442491,0,34286147
HepG2|chr9:79813780-79813875,chr9,79813780,79813875,HepG2|chr9:37121851-37121904,chr9,37121851,37121904,0,42691929
HepG2|chr9:81214244-81214285,chr9,81214244,81214285,HepG2|chr9:130741146-130741291,chr9,130741146,130741291,0,49526902
HepG2|chr9:81940080-81940213,chr9,81940080,81940213,HepG2|chr9:71733083-71733144,chr9,71733083,71733144,0,10206997
HepG2|chr9:82235112-82235262,chr9,82235112,82235262,HepG2|chr9:45442241-45442391,chr9,45442241,45442391,0,36792871
HepG2|chr9:82317888-82317971,chr9,82317888,82317971,HepG2|chr9:6703562-6703606,chr9,6703562,6703606,0,75614326
HepG2|chr9:83026719-83026774,chr9,83026719,83026774,HepG2|chr9:130821399-130821438,chr9,130821399,130821438,0,47794680
HepG2|chr9:83285915-83286021,chr9,83285915,83286021,HepG2|chr9:6703562-6703606,chr9,6703562,6703606,0,76582353
HepG2|chr9:83323484-83323557,chr9,83323484,83323557,HepG2|chr9:26946163-26946252,chr9,26946163,26946252,0,56377321
HepG2|chr9:83680835-83680898,chr9,83680835,83680898,HepG2|chr9:45442265-45442394,chr9,45442265,45442394,0,38238570
HepG2|chr9:83729916-83730032,chr9,83729916,83730032,HepG2|chr9:45442431-45442491,chr9,45442431,45442491,0,38287485
HepG2|chr9:84115606-84115696,chr9,84115606,84115696,HepG2|chr9:67335081-67335103,chr9,67335081,67335103,0,16780525
HepG2|chr9:85000418-85000531,chr9,85000418,85000531,HepG2|chr9:6703562-6703599,chr9,6703562,6703599,0,78296856
HepG2|chr9:85159075-85159212,chr9,85159075,85159212,HepG2|chr9:130821282-130821432,chr9,130821282,130821432,0,45662207
HepG2|chr9:86641405-86641496,chr9,86641405,86641496,HepG2|chr9:45442431-45442563,chr9,45442431,45442563,0,41198974
HepG2|chr9:86767611-86767657,chr9,86767611,86767657,HepG2|chr9:131440756-131440830,chr9,131440756,131440830,0,44673145
HepG2|chr9:86788151-86788257,chr9,86788151,86788257,HepG2|chr9:6703562-6703606,chr9,6703562,6703606,0,80084589
HepG2|chr9:87115958-87116017,chr9,87115958,87116017,HepG2|chr9:45442109-45442224,chr9,45442109,45442224,0,41673849
HepG2|chr9:88027605-88027671,chr9,88027605,88027671,HepG2|chr9:19375000-19375061,chr9,19375000,19375061,0,68652605
HepG2|chr9:88527068-88527218,chr9,88527068,88527218,HepG2|chr9:70646052-70646109,chr9,70646052,70646109,0,17881016
HepG2|chr9:88539440-88539461,chr9,88539440,88539461,HepG2|chr9:91148120-91148270,chr9,91148120,91148270,0,2608680
HepG2|chr9:90122804-90122858,chr9,90122804,90122858,HepG2|chr9:37121291-37121326,chr9,37121291,37121326,0,53001513
HepG2|chr9:90561474-90561589,chr9,90561474,90561589,HepG2|chr9:45442431-45442484,chr9,45442431,45442484,0,45119043
HepG2|chr9:90884761-90884907,chr9,90884761,90884907,HepG2|chr9:102860430-102860507,chr9,102860430,102860507,0,11975669
HepG2|chr9:91019956-91020003,chr9,91019956,91020003,HepG2|chr9:130369985-130370068,chr9,130369985,130370068,0,39350029
HepG2|chr9:92296425-92296463,chr9,92296425,92296463,HepG2|chr9:71732259-71732409,chr9,71732259,71732409,0,20564166
HepG2|chr9:93375216-93375257,chr9,93375216,93375257,HepG2|chr9:33000199-33000346,chr9,33000199,33000346,0,60375017
HepG2|chr9:93982758-93982836,chr9,93982758,93982836,HepG2|chr9:35695154-35695194,chr9,35695154,35695194,0,58287604
HepG2|chr9:95204585-95204673,chr9,95204585,95204673,HepG2|chr9:130371225-130371287,chr9,130371225,130371287,0,35166640
HepG2|chr9:95391448-95391561,chr9,95391448,95391561,HepG2|chr9:67335066-67335103,chr9,67335066,67335103,0,28056382
HepG2|chr9:95423508-95423635,chr9,95423508,95423635,HepG2|chr9:90341808-90341825,chr9,90341808,90341825,0,5081700
HepG2|chr9:96289001-96289100,chr9,96289001,96289100,HepG2|chr9:70646011-70646062,chr9,70646011,70646062,0,25642990
HepG2|chr9:96810062-96810142,chr9,96810062,96810142,HepG2|chr9:45442431-45442486,chr9,45442431,45442486,0,51367631
HepG2|chr9:97723931-97724023,chr9,97723931,97724023,HepG2|chr9:71734866-71734913,chr9,71734866,71734913,0,25989065
HepG2|chr9:97789415-97789565,chr9,97789415,97789565,HepG2|chr9:70645946-70646043,chr9,70645946,70646043,0,27143469
HepG2|chr9:98880328-98880409,chr9,98880328,98880409,HepG2|chr9:97770132-97770187,chr9,97770132,97770187,0,1110196
HepG2|chr9:99449608-99449667,chr9,99449608,99449667,HepG2|chr9:139782553-139782612,chr9,139782553,139782612,0,40332945
HepG2|chr9:99535081-99535154,chr9,99535081,99535154,HepG2|chr9:37122045-37122120,chr9,37122045,37122120,0,62413036
HepG2|chr9:99535968-99536042,chr9,99535968,99536042,HepG2|chr9:131441853-131441915,chr9,131441853,131441915,0,31905885
HepG2|chr9:100737587-100737702,chr9,100737587,100737702,HepG2|chr9:45442296-45442394,chr9,45442296,45442394,0,55295291
HepG2|chr9:102033673-102033762,chr9,102033673,102033762,HepG2|chr9:71733083-71733144,chr9,71733083,71733144,0,30300590
HepG2|chr9:102630718-102630809,chr9,102630718,102630809,HepG2|chr9:45442301-45442394,chr9,45442301,45442394,0,57188417
HepG2|chr9:102641155-102641228,chr9,102641155,102641228,HepG2|chr9:102860430-102860507,chr9,102860430,102860507,0,219275
HepG2|chr9:102806886-102806925,chr9,102806886,102806925,HepG2|chr9:37122031-37122081,chr9,37122031,37122081,0,65684855
HepG2|chr9:102944530-102944587,chr9,102944530,102944587,HepG2|chr9:26946163-26946252,chr9,26946163,26946252,0,75998367
HepG2|chr9:103196582-103196635,chr9,103196582,103196635,HepG2|chr9:131446559-131446634,chr9,131446559,131446634,0,28249977
HepG2|chr9:105355751-105355861,chr9,105355751,105355861,HepG2|chr9:45442301-45442394,chr9,45442301,45442394,0,59913450
HepG2|chr9:106291037-106291062,chr9,106291037,106291062,HepG2|chr9:33475630-33475694,chr9,33475630,33475694,0,72815407
HepG2|chr9:106535025-106535144,chr9,106535025,106535144,HepG2|chr9:70646011-70646067,chr9,70646011,70646067,0,35889014
HepG2|chr9:107854826-107854892,chr9,107854826,107854892,HepG2|chr9:19375000-19375061,chr9,19375000,19375061,0,88479826
HepG2|chr9:108171633-108171680,chr9,108171633,108171680,HepG2|chr9:130369985-130370068,chr9,130369985,130370068,0,22198352
HepG2|chr9:108611099-108611209,chr9,108611099,108611209,HepG2|chr9:6703562-6703602,chr9,6703562,6703602,0,101907537
HepG2|chr9:108626506-108626620,chr9,108626506,108626620,HepG2|chr9:67335066-67335103,chr9,67335066,67335103,0,41291440
HepG2|chr9:109613435-109613492,chr9,109613435,109613492,HepG2|chr9:45442185-45442335,chr9,45442185,45442335,0,64171250
HepG2|chr9:110090589-110090679,chr9,110090589,110090679,HepG2|chr9:67335081-67335103,chr9,67335081,67335103,0,42755508
HepG2|chr9:110251371-110251475,chr9,110251371,110251475,HepG2|chr9:70645938-70646007,chr9,70645938,70646007,0,39605433
HepG2|chr9:110880063-110880107,chr9,110880063,110880107,HepG2|chr9:98270346-98270484,chr9,98270346,98270484,0,12609717
HepG2|chr9:110949788-110949904,chr9,110949788,110949904,HepG2|chr9:91147223-91147257,chr9,91147223,91147257,0,19802565
HepG2|chr9:111369484-111369564,chr9,111369484,111369564,HepG2|chr9:45442431-45442486,chr9,45442431,45442486,0,65927053
HepG2|chr9:111866173-111866256,chr9,111866173,111866256,HepG2|chr9:6703562-6703606,chr9,6703562,6703606,0,105162611
HepG2|chr9:111962859-111962884,chr9,111962859,111962884,HepG2|chr9:33475630-33475694,chr9,33475630,33475694,0,78487229
HepG2|chr9:112097712-112097750,chr9,112097712,112097750,HepG2|chr9:71732259-71732409,chr9,71732259,71732409,0,40365453
HepG2|chr9:113321637-113321693,chr9,113321637,113321693,HepG2|chr9:45442179-45442262,chr9,45442179,45442262,0,67879458
HepG2|chr9:113597418-113597521,chr9,113597418,113597521,HepG2|chr9:91004558-91004590,chr9,91004558,91004590,0,22592860
HepG2|chr9:113790272-113790322,chr9,113790272,113790322,HepG2|chr9:131441940-131442035,chr9,131441940,131442035,0,17651668
HepG2|chr9:113801168-113801272,chr9,113801168,113801272,HepG2|chr9:130371225-130371287,chr9,130371225,130371287,0,16570057
HepG2|chr9:113897004-113897128,chr9,113897004,113897128,HepG2|chr9:45442301-45442394,chr9,45442301,45442394,0,68454703
HepG2|chr9:114356227-114356360,chr9,114356227,114356360,HepG2|chr9:70646030-70646169,chr9,70646030,70646169,0,43710197
HepG2|chr9:114472309-114472450,chr9,114472309,114472450,HepG2|chr9:35695942-35696014,chr9,35695942,35696014,0,78776367
HepG2|chr9:114724241-114724289,chr9,114724241,114724289,HepG2|chr9:131446559-131446634,chr9,131446559,131446634,0,16722318
HepG2|chr9:115223655-115223746,chr9,115223655,115223746,HepG2|chr9:45442301-45442394,chr9,45442301,45442394,0,69781354
HepG2|chr9:115287444-115287594,chr9,115287444,115287594,HepG2|chr9:91148744-91148779,chr9,91148744,91148779,0,24138700
HepG2|chr9:117441339-117441396,chr9,117441339,117441396,HepG2|chr9:45442185-45442335,chr9,45442185,45442335,0,71999154
HepG2|chr9:117578339-117578436,chr9,117578339,117578436,HepG2|chr9:45442299-45442394,chr9,45442299,45442394,0,72136040
HepG2|chr9:118709463-118709596,chr9,118709463,118709596,HepG2|chr9:71733083-71733144,chr9,71733083,71733144,0,46976380
HepG2|chr9:120134749-120134820,chr9,120134749,120134820,HepG2|chr9:102860430-102860507,chr9,102860430,102860507,0,17274319
HepG2|chr9:120811756-120811815,chr9,120811756,120811815,HepG2|chr9:139782553-139782612,chr9,139782553,139782612,0,18970797
HepG2|chr9:120972437-120972505,chr9,120972437,120972505,HepG2|chr9:37121747-37121800,chr9,37121747,37121800,0,83850690
HepG2|chr9:122239484-122239574,chr9,122239484,122239574,HepG2|chr9:37121478-37121532,chr9,37121478,37121532,0,85118006
HepG2|chr9:122786416-122786471,chr9,122786416,122786471,HepG2|chr9:130821399-130821438,chr9,130821399,130821438,0,8034983
HepG2|chr9:122846667-122846814,chr9,122846667,122846814,HepG2|chr9:91145621-91145682,chr9,91145621,91145682,0,31701046
HepG2|chr9:124102137-124102220,chr9,124102137,124102220,HepG2|chr9:97770132-97770187,chr9,97770132,97770187,0,26332005
HepG2|chr9:126430955-126430974,chr9,126430955,126430974,HepG2|chr9:37120938-37121018,chr9,37120938,37121018,0,89310017
HepG2|chr9:126467889-126467931,chr9,126467889,126467931,HepG2|chr9:131443763-131443856,chr9,131443763,131443856,0,4975874
HepG2|chr9:127472385-127472463,chr9,127472385,127472463,HepG2|chr9:35695942-35696014,chr9,35695942,35696014,0,91776443
HepG2|chr9:127502186-127502292,chr9,127502186,127502292,HepG2|chr9:71731728-71731878,chr9,71731728,71731878,0,55770458
HepG2|chr9:127977673-127977754,chr9,127977673,127977754,HepG2|chr9:132562389-132562446,chr9,132562389,132562446,0,4584716
HepG2|chr9:128518218-128518368,chr9,128518218,128518368,HepG2|chr9:70646315-70646465,chr9,70646315,70646465,0,57871903
HepG2|chr9:128543806-128543849,chr9,128543806,128543849,HepG2|chr9:131443763-131443856,chr9,131443763,131443856,0,2899957
HepG2|chr9:129144187-129144206,chr9,129144187,129144206,HepG2|chr9:37120938-37121018,chr9,37120938,37121018,0,92023249
HepG2|chr9:130706063-130706176,chr9,130706063,130706176,HepG2|chr9:6703562-6703599,chr9,6703562,6703599,0,124002501
HepG2|chr9:130981058-130981114,chr9,130981058,130981114,HepG2|chr9:130369985-130370068,chr9,130369985,130370068,0,611073
HepG2|chr9:131676596-131676740,chr9,131676596,131676740,HepG2|chr9:70646052-70646124,chr9,70646052,70646124,0,61030544
HepG2|chr9:133009760-133009878,chr9,133009760,133009878,HepG2|chr9:70645946-70646028,chr9,70645946,70646028,0,62363814
HepG2|chr9:133842217-133842332,chr9,133842217,133842332,HepG2|chr9:6703562-6703602,chr9,6703562,6703602,0,127138655
HepG2|chr9:134210466-134210616,chr9,134210466,134210616,HepG2|chr9:70646315-70646465,chr9,70646315,70646465,0,63564151
HepG2|chr9:134261513-134261624,chr9,134261513,134261624,HepG2|chr9:45442301-45442389,chr9,45442301,45442389,0,88819212
HepG2|chr9:136367198-136367243,chr9,136367198,136367243,HepG2|chr9:33000199-33000346,chr9,33000199,33000346,0,103366999
HepG2|chr9:137984023-137984169,chr9,137984023,137984169,HepG2|chr9:102860430-102860507,chr9,102860430,102860507,0,35123593
HepG2|chr9:138213079-138213193,chr9,138213079,138213193,HepG2|chr9:67335066-67335103,chr9,67335066,67335103,0,70878013
HepG2|chr9:139895915-139895966,chr9,139895915,139895966,HepG2|chr9:67335066-67335103,chr9,67335066,67335103,0,72560849
HepG2|chr9:140121578-140121661,chr9,140121578,140121661,HepG2|chr9:91145491-91145543,chr9,91145491,91145543,0,48976087
HepG2|chr9:141139738-141139844,chr9,141139738,141139844,HepG2|chr9:91004558-91004590,chr9,91004558,91004590,0,50135180
HepG2|chr10:206124-206239,chr10,206124,206239,HepG2|chr10:60030072-60030162,chr10,60030072,60030162,0,59823948
HepG2|chr10:423653-423703,chr10,423653,423703,HepG2|chr10:65278371-65278451,chr10,65278371,65278451,0,64854718
HepG2|chr10:600693-600813,chr10,600693,600813,HepG2|chr10:73852707-73852820,chr10,73852707,73852820,0,73252014
HepG2|chr10:1057701-1057739,chr10,1057701,1057739,HepG2|chr10:134350229-134350341,chr10,134350229,134350341,0,133292528
HepG2|chr10:1101406-1101465,chr10,1101406,1101465,HepG2|chr10:134350229-134350341,chr10,134350229,134350341,0,133248823
HepG2|chr10:1199270-1199379,chr10,1199270,1199379,HepG2|chr10:75503921-75503958,chr10,75503921,75503958,0,74304651
HepG2|chr10:1535206-1535292,chr10,1535206,1535292,HepG2|chr10:65279778-65279898,chr10,65279778,65279898,0,63744572
HepG2|chr10:1685235-1685337,chr10,1685235,1685337,HepG2|chr10:75503921-75503959,chr10,75503921,75503959,0,73818686
HepG2|chr10:1835865-1835912,chr10,1835865,1835912,HepG2|chr10:65278427-65278507,chr10,65278427,65278507,0,63442562
HepG2|chr10:2285928-2286014,chr10,2285928,2286014,HepG2|chr10:75504001-75504148,chr10,75504001,75504148,0,73218073
HepG2|chr10:2522021-2522171,chr10,2522021,2522171,HepG2|chr10:106098721-106098830,chr10,106098721,106098830,0,103576700
HepG2|chr10:2950422-2950452,chr10,2950422,2950452,HepG2|chr10:65279778-65279898,chr10,65279778,65279898,0,62329356
HepG2|chr10:3602736-3602798,chr10,3602736,3602798,HepG2|chr10:73852216-73852299,chr10,73852216,73852299,0,70249480
HepG2|chr10:3965829-3965887,chr10,3965829,3965887,HepG2|chr10:73852216-73852299,chr10,73852216,73852299,0,69886387
HepG2|chr10:4243415-4243517,chr10,4243415,4243517,HepG2|chr10:75503921-75503959,chr10,75503921,75503959,0,71260506
HepG2|chr10:4668959-4669109,chr10,4668959,4669109,HepG2|chr10:89259694-89259844,chr10,89259694,89259844,0,84590735
HepG2|chr10:4862554-4862673,chr10,4862554,4862673,HepG2|chr10:73852780-73852823,chr10,73852780,73852823,0,68990226
HepG2|chr10:4962341-4962363,chr10,4962341,4962363,HepG2|chr10:73612852-73612940,chr10,73612852,73612940,0,68650511
HepG2|chr10:5006938-5006962,chr10,5006938,5006962,HepG2|chr10:81967316-81967426,chr10,81967316,81967426,0,76960378
HepG2|chr10:5210047-5210071,chr10,5210047,5210071,HepG2|chr10:81967316-81967426,chr10,81967316,81967426,0,76757269
HepG2|chr10:6559153-6559303,chr10,6559153,6559303,HepG2|chr10:75503921-75503946,chr10,75503921,75503946,0,68944768
HepG2|chr10:6627639-6627691,chr10,6627639,6627691,HepG2|chr10:75503921-75504034,chr10,75503921,75504034,0,68876282
HepG2|chr10:7660368-7660458,chr10,7660368,7660458,HepG2|chr10:65279995-65280055,chr10,65279995,65280055,0,57619627
HepG2|chr10:8217339-8217387,chr10,8217339,8217387,HepG2|chr10:73853126-73853218,chr10,73853126,73853218,0,65635787
HepG2|chr10:8448941-8449060,chr10,8448941,8449060,HepG2|chr10:73852780-73852823,chr10,73852780,73852823,0,65403839
HepG2|chr10:8847843-8847911,chr10,8847843,8847911,HepG2|chr10:92977507-92977654,chr10,92977507,92977654,0,84129664
HepG2|chr10:9159042-9159115,chr10,9159042,9159115,HepG2|chr10:65279864-65279973,chr10,65279864,65279973,0,56120822
HepG2|chr10:9362479-9362577,chr10,9362479,9362577,HepG2|chr10:99182950-99183001,chr10,99182950,99183001,0,89820471
HepG2|chr10:9764155-9764192,chr10,9764155,9764192,HepG2|chr10:75503921-75504034,chr10,75503921,75504034,0,65739766
HepG2|chr10:9827493-9827607,chr10,9827493,9827607,HepG2|chr10:75503921-75504012,chr10,75503921,75504012,0,65676428
HepG2|chr10:9869343-9869433,chr10,9869343,9869433,HepG2|chr10:75503921-75503981,chr10,75503921,75503981,0,65634578
HepG2|chr10:9877880-9877902,chr10,9877880,9877902,HepG2|chr10:65280462-65280538,chr10,65280462,65280538,0,55402582
HepG2|chr10:9935079-9935178,chr10,9935079,9935178,HepG2|chr10:99182950-99183001,chr10,99182950,99183001,0,89247871
HepG2|chr10:10022989-10023029,chr10,10022989,10023029,HepG2|chr10:134350302-134350452,chr10,134350302,134350452,0,124327313
HepG2|chr10:10083994-10084050,chr10,10083994,10084050,HepG2|chr10:120940424-120940542,chr10,120940424,120940542,0,110856430
HepG2|chr10:10124260-10124310,chr10,10124260,10124310,HepG2|chr10:65278371-65278451,chr10,65278371,65278451,0,55154111
HepG2|chr10:10881815-10881852,chr10,10881815,10881852,HepG2|chr10:92977613-92977724,chr10,92977613,92977724,0,82095798
HepG2|chr10:11862428-11862578,chr10,11862428,11862578,HepG2|chr10:81967218-81967248,chr10,81967218,81967248,0,70104790
HepG2|chr10:13262223-13262263,chr10,13262223,13262263,HepG2|chr10:134350302-134350452,chr10,134350302,134350452,0,121088079
HepG2|chr10:13320267-13320399,chr10,13320267,13320399,HepG2|chr10:75503921-75503939,chr10,75503921,75503939,0,62183654
HepG2|chr10:13717416-13717495,chr10,13717416,13717495,HepG2|chr10:75503921-75503959,chr10,75503921,75503959,0,61786505
HepG2|chr10:14496453-14496603,chr10,14496453,14496603,HepG2|chr10:89259694-89259844,chr10,89259694,89259844,0,74763241
HepG2|chr10:15688732-15688771,chr10,15688732,15688771,HepG2|chr10:65276908-65277057,chr10,65276908,65277057,0,49588176
HepG2|chr10:15986502-15986631,chr10,15986502,15986631,HepG2|chr10:75503915-75503936,chr10,75503915,75503936,0,59517413
HepG2|chr10:16906767-16906852,chr10,16906767,16906852,HepG2|chr10:65277358-65277390,chr10,65277358,65277390,0,48370591
HepG2|chr10:17020962-17021045,chr10,17020962,17021045,HepG2|chr10:73852809-73852931,chr10,73852809,73852931,0,56831847
HepG2|chr10:17087471-17087513,chr10,17087471,17087513,HepG2|chr10:65279324-65279432,chr10,65279324,65279432,0,48191853
HepG2|chr10:17509455-17509557,chr10,17509455,17509557,HepG2|chr10:12110910-12110927,chr10,12110910,12110927,0,5398545
HepG2|chr10:17752386-17752465,chr10,17752386,17752465,HepG2|chr10:73852673-73852785,chr10,73852673,73852785,0,56100287
HepG2|chr10:17966734-17966827,chr10,17966734,17966827,HepG2|chr10:65278989-65279052,chr10,65278989,65279052,0,47312255
HepG2|chr10:17985149-17985171,chr10,17985149,17985171,HepG2|chr10:73612852-73612940,chr10,73612852,73612940,0,55627703
HepG2|chr10:18834091-18834155,chr10,18834091,18834155,HepG2|chr10:65280408-65280494,chr10,65280408,65280494,0,46446317
HepG2|chr10:19792854-19792982,chr10,19792854,19792982,HepG2|chr10:89259767-89259835,chr10,89259767,89259835,0,69466913
HepG2|chr10:19853395-19853444,chr10,19853395,19853444,HepG2|chr10:92981274-92981323,chr10,92981274,92981323,0,73127879
HepG2|chr10:20242992-20243036,chr10,20242992,20243036,HepG2|chr10:75503921-75503995,chr10,75503921,75503995,0,55260929
HepG2|chr10:20781316-20781357,chr10,20781316,20781357,HepG2|chr10:65279864-65279973,chr10,65279864,65279973,0,44498548
HepG2|chr10:21037201-21037332,chr10,21037201,21037332,HepG2|chr10:134350229-134350248,chr10,134350229,134350248,0,113313028
HepG2|chr10:21677048-21677150,chr10,21677048,21677150,HepG2|chr10:12110910-12110927,chr10,12110910,12110927,0,9566138
HepG2|chr10:22026311-22026398,chr10,22026311,22026398,HepG2|chr10:65278202-65278236,chr10,65278202,65278236,0,43251891
HepG2|chr10:22166357-22166404,chr10,22166357,22166404,HepG2|chr10:75503921-75504024,chr10,75503921,75504024,0,53337564
HepG2|chr10:22943967-22944008,chr10,22943967,22944008,HepG2|chr10:65279864-65279973,chr10,65279864,65279973,0,42335897
HepG2|chr10:23361681-23361755,chr10,23361681,23361755,HepG2|chr10:65278248-65278365,chr10,65278248,65278365,0,41916567
HepG2|chr10:24666109-24666142,chr10,24666109,24666142,HepG2|chr10:65279313-65279463,chr10,65279313,65279463,0,40613204
HepG2|chr10:25370136-25370239,chr10,25370136,25370239,HepG2|chr10:65280100-65280166,chr10,65280100,65280166,0,39909964
HepG2|chr10:25774738-25774845,chr10,25774738,25774845,HepG2|chr10:73853040-73853093,chr10,73853040,73853093,0,48078302
HepG2|chr10:25828514-25828560,chr10,25828514,25828560,HepG2|chr10:73852714-73852836,chr10,73852714,73852836,0,48024200
HepG2|chr10:25902054-25902135,chr10,25902054,25902135,HepG2|chr10:65280100-65280166,chr10,65280100,65280166,0,39378046
HepG2|chr10:27557603-27557749,chr10,27557603,27557749,HepG2|chr10:75503921-75503939,chr10,75503921,75503939,0,47946318
HepG2|chr10:27946475-27946625,chr10,27946475,27946625,HepG2|chr10:81967218-81967248,chr10,81967218,81967248,0,54020743
HepG2|chr10:28561628-28561687,chr10,28561628,28561687,HepG2|chr10:134350229-134350341,chr10,134350229,134350341,0,105788601
HepG2|chr10:28864794-28864884,chr10,28864794,28864884,HepG2|chr10:65276788-65276846,chr10,65276788,65276846,0,36411994
HepG2|chr10:29107707-29107782,chr10,29107707,29107782,HepG2|chr10:73853422-73853497,chr10,73853422,73853497,0,44745715
HepG2|chr10:29531360-29531379,chr10,29531360,29531379,HepG2|chr10:73852720-73852760,chr10,73852720,73852760,0,44321360
HepG2|chr10:29746614-29746700,chr10,29746614,29746700,HepG2|chr10:65278989-65279052,chr10,65278989,65279052,0,35532375
HepG2|chr10:30039038-30039145,chr10,30039038,30039145,HepG2|chr10:73852780-73852823,chr10,73852780,73852823,0,43813742
HepG2|chr10:31034653-31034704,chr10,31034653,31034704,HepG2|chr10:65278371-65278451,chr10,65278371,65278451,0,34243718
HepG2|chr10:31312214-31312244,chr10,31312214,31312244,HepG2|chr10:73852387-73852501,chr10,73852387,73852501,0,42540173
HepG2|chr10:31673689-31673754,chr10,31673689,31673754,HepG2|chr10:73852387-73852501,chr10,73852387,73852501,0,42178698
HepG2|chr10:31790979-31791025,chr10,31790979,31791025,HepG2|chr10:73852714-73852836,chr10,73852714,73852836,0,42061735
HepG2|chr10:31929636-31929707,chr10,31929636,31929707,HepG2|chr10:65278120-65278175,chr10,65278120,65278175,0,33348484
HepG2|chr10:32842232-32842303,chr10,32842232,32842303,HepG2|chr10:73853188-73853291,chr10,73853188,73853291,0,41010956
HepG2|chr10:32919443-32919524,chr10,32919443,32919524,HepG2|chr10:73851490-73851595,chr10,73851490,73851595,0,40932047
HepG2|chr10:33305861-33305883,chr10,33305861,33305883,HepG2|chr10:73852707-73852820,chr10,73852707,73852820,0,40546846
HepG2|chr10:33343242-33343294,chr10,33343242,33343294,HepG2|chr10:99055111-99055164,chr10,99055111,99055164,0,65711869
HepG2|chr10:33760594-33760667,chr10,33760594,33760667,HepG2|chr10:65278120-65278175,chr10,65278120,65278175,0,31517526
HepG2|chr10:34802289-34802384,chr10,34802289,34802384,HepG2|chr10:81967325-81967353,chr10,81967325,81967353,0,47165036
HepG2|chr10:34923621-34923769,chr10,34923621,34923769,HepG2|chr10:134350229-134350270,chr10,134350229,134350270,0,99426608
HepG2|chr10:35034851-35034966,chr10,35034851,35034966,HepG2|chr10:60030072-60030162,chr10,60030072,60030162,0,24995221
HepG2|chr10:35153829-35153878,chr10,35153829,35153878,HepG2|chr10:92981274-92981323,chr10,92981274,92981323,0,57827445
HepG2|chr10:35616326-35616370,chr10,35616326,35616370,HepG2|chr10:120941976-120942067,chr10,120941976,120942067,0,85325650
HepG2|chr10:35697857-35697911,chr10,35697857,35697911,HepG2|chr10:75503921-75504012,chr10,75503921,75504012,0,39806064
HepG2|chr10:36036542-36036607,chr10,36036542,36036607,HepG2|chr10:73852387-73852501,chr10,73852387,73852501,0,37815845
HepG2|chr10:36095817-36095967,chr10,36095817,36095967,HepG2|chr10:75503921-75503981,chr10,75503921,75503981,0,39408104
HepG2|chr10:36586477-36586553,chr10,36586477,36586553,HepG2|chr10:73853144-73853208,chr10,73853144,73853208,0,37266667
HepG2|chr10:37793323-37793399,chr10,37793323,37793399,HepG2|chr10:73853567-73853602,chr10,73853567,73853602,0,36060244
HepG2|chr10:37934032-37934052,chr10,37934032,37934052,HepG2|chr10:75503943-75504091,chr10,75503943,75504091,0,37569911
HepG2|chr10:38988891-38989022,chr10,38988891,38989022,HepG2|chr10:134350229-134350248,chr10,134350229,134350248,0,95361338
HepG2|chr10:39230838-39230896,chr10,39230838,39230896,HepG2|chr10:65277308-65277376,chr10,65277308,65277376,0,26046470
HepG2|chr10:39515592-39515668,chr10,39515592,39515668,HepG2|chr10:73853567-73853602,chr10,73853567,73853602,0,34337975
HepG2|chr10:39553356-39553416,chr10,39553356,39553416,HepG2|chr10:60030072-60030162,chr10,60030072,60030162,0,20476716
HepG2|chr10:40914938-40914966,chr10,40914938,40914966,HepG2|chr10:73852714-73852836,chr10,73852714,73852836,0,32937776
HepG2|chr10:41179943-41179965,chr10,41179943,41179965,HepG2|chr10:65277358-65277391,chr10,65277358,65277391,0,24097415
HepG2|chr10:41546728-41546771,chr10,41546728,41546771,HepG2|chr10:99055111-99055164,chr10,99055111,99055164,0,57508383
HepG2|chr10:42065745-42065888,chr10,42065745,42065888,HepG2|chr10:89259694-89259844,chr10,89259694,89259844,0,47193949
HepG2|chr10:43300208-43300315,chr10,43300208,43300315,HepG2|chr10:65278045-65278133,chr10,65278045,65278133,0,21977837
HepG2|chr10:45169114-45169193,chr10,45169114,45169193,HepG2|chr10:92980836-92980986,chr10,92980836,92980986,0,47811722
HepG2|chr10:45499399-45499489,chr10,45499399,45499489,HepG2|chr10:75503921-75503981,chr10,75503921,75503981,0,30004522
HepG2|chr10:46459600-46459746,chr10,46459600,46459746,HepG2|chr10:73852620-73852697,chr10,73852620,73852697,0,27393020
HepG2|chr10:47558020-47558036,chr10,47558020,47558036,HepG2|chr10:135207810-135207960,chr10,135207810,135207960,0,87649790
HepG2|chr10:47712288-47712306,chr10,47712288,47712306,HepG2|chr10:65277737-65277804,chr10,65277737,65277804,0,17565449
HepG2|chr10:47964533-47964569,chr10,47964533,47964569,HepG2|chr10:73849451-73849543,chr10,73849451,73849543,0,25884918
HepG2|chr10:47999723-47999810,chr10,47999723,47999810,HepG2|chr10:65278202-65278236,chr10,65278202,65278236,0,17278479
HepG2|chr10:48366738-48366850,chr10,48366738,48366850,HepG2|chr10:75503921-75503958,chr10,75503921,75503958,0,27137183
HepG2|chr10:49062484-49062550,chr10,49062484,49062550,HepG2|chr10:75503921-75503965,chr10,75503921,75503965,0,26441437
HepG2|chr10:49495880-49495953,chr10,49495880,49495953,HepG2|chr10:65278120-65278175,chr10,65278120,65278175,0,15782240
HepG2|chr10:50812872-50812902,chr10,50812872,50812902,HepG2|chr10:73852387-73852501,chr10,73852387,73852501,0,23039515
HepG2|chr10:51023730-51023776,chr10,51023730,51023776,HepG2|chr10:65278427-65278507,chr10,65278427,65278507,0,14254697
HepG2|chr10:52591737-52591780,chr10,52591737,52591780,HepG2|chr10:65276246-65276396,chr10,65276246,65276396,0,12684509
HepG2|chr10:53192431-53192459,chr10,53192431,53192459,HepG2|chr10:73852714-73852836,chr10,73852714,73852836,0,20660283
HepG2|chr10:53994928-53995023,chr10,53994928,53995023,HepG2|chr10:81967325-81967353,chr10,81967325,81967353,0,27972397
HepG2|chr10:54093576-54093662,chr10,54093576,54093662,HepG2|chr10:65276767-65276827,chr10,65276767,65276827,0,11183191
HepG2|chr10:54482253-54482349,chr10,54482253,54482349,HepG2|chr10:73853040-73853093,chr10,73853040,73853093,0,19370787
HepG2|chr10:54586108-54586204,chr10,54586108,54586204,HepG2|chr10:73853040-73853093,chr10,73853040,73853093,0,19266932
HepG2|chr10:54693309-54693416,chr10,54693309,54693416,HepG2|chr10:73852780-73852823,chr10,73852780,73852823,0,19159471
HepG2|chr10:55635862-55635941,chr10,55635862,55635941,HepG2|chr10:75503921-75503959,chr10,75503921,75503959,0,19868059
HepG2|chr10:55736450-55736559,chr10,55736450,55736559,HepG2|chr10:134350229-134350270,chr10,134350229,134350270,0,78613779
HepG2|chr10:56071450-56071529,chr10,56071450,56071529,HepG2|chr10:81967201-81967248,chr10,81967201,81967248,0,25895751
HepG2|chr10:56584251-56584281,chr10,56584251,56584281,HepG2|chr10:65279778-65279898,chr10,65279778,65279898,0,8695527
HepG2|chr10:56665310-56665460,chr10,56665310,56665460,HepG2|chr10:75503921-75503981,chr10,75503921,75503981,0,18838611
HepG2|chr10:57271874-57271936,chr10,57271874,57271936,HepG2|chr10:73852216-73852299,chr10,73852216,73852299,0,16580342
HepG2|chr10:57450965-57451051,chr10,57450965,57451051,HepG2|chr10:65276767-65276827,chr10,65276767,65276827,0,7825802
HepG2|chr10:57581173-57581305,chr10,57581173,57581305,HepG2|chr10:75503921-75503939,chr10,75503921,75503939,0,17922748
HepG2|chr10:57877603-57877658,chr10,57877603,57877658,HepG2|chr10:65277582-65277677,chr10,65277582,65277677,0,7399979
HepG2|chr10:58462126-58462276,chr10,58462126,58462276,HepG2|chr10:73853422-73853497,chr10,73853422,73853497,0,15391296
HepG2|chr10:58849112-58849149,chr10,58849112,58849149,HepG2|chr10:92977613-92977724,chr10,92977613,92977724,0,34128501
HepG2|chr10:58900087-58900188,chr10,58900087,58900188,HepG2|chr10:73852477-73852533,chr10,73852477,73852533,0,14952390
HepG2|chr10:58923610-58923632,chr10,58923610,58923632,HepG2|chr10:73852707-73852820,chr10,73852707,73852820,0,14929097
HepG2|chr10:59165092-59165165,chr10,59165092,59165165,HepG2|chr10:73853075-73853152,chr10,73853075,73853152,0,14687983
HepG2|chr10:59642567-59642599,chr10,59642567,59642599,HepG2|chr10:65280117-65280238,chr10,65280117,65280238,0,5637550
HepG2|chr10:59666748-59666873,chr10,59666748,59666873,HepG2|chr10:75503921-75503946,chr10,75503921,75503946,0,15837173
HepG2|chr10:60464342-60464435,chr10,60464342,60464435,HepG2|chr10:73852711-73852748,chr10,73852711,73852748,0,13388369
HepG2|chr10:61546047-61546159,chr10,61546047,61546159,HepG2|chr10:65279170-65279311,chr10,65279170,65279311,0,3733123
HepG2|chr10:61808814-61808939,chr10,61808814,61808939,HepG2|chr10:75503921-75503946,chr10,75503921,75503946,0,13695107
HepG2|chr10:62005308-62005334,chr10,62005308,62005334,HepG2|chr10:73849451-73849543,chr10,73849451,73849543,0,11844143
HepG2|chr10:62339046-62339196,chr10,62339046,62339196,HepG2|chr10:89259694-89259844,chr10,89259694,89259844,0,26920648
HepG2|chr10:62750815-62750905,chr10,62750815,62750905,HepG2|chr10:73852711-73852748,chr10,73852711,73852748,0,11101896
HepG2|chr10:63093360-63093442,chr10,63093360,63093442,HepG2|chr10:73853035-73853174,chr10,73853035,73853174,0,10759675
HepG2|chr10:63174262-63174352,chr10,63174262,63174352,HepG2|chr10:81967206-81967248,chr10,81967206,81967248,0,18792944
HepG2|chr10:63534129-63534220,chr10,63534129,63534220,HepG2|chr10:65279995-65280055,chr10,65279995,65280055,0,1745866
HepG2|chr10:63728182-63728218,chr10,63728182,63728218,HepG2|chr10:73849451-73849543,chr10,73849451,73849543,0,10121269
HepG2|chr10:64078922-64079069,chr10,64078922,64079069,HepG2|chr10:134350229-134350248,chr10,134350229,134350248,0,70271307
HepG2|chr10:65374373-65374454,chr10,65374373,65374454,HepG2|chr10:65281497-65281566,chr10,65281497,65281566,0,92876
HepG2|chr10:65618004-65618102,chr10,65618004,65618102,HepG2|chr10:99182950-99183001,chr10,99182950,99183001,0,33564946
HepG2|chr10:66860369-66860445,chr10,66860369,66860445,HepG2|chr10:81967228-81967353,chr10,81967228,81967353,0,15106859
HepG2|chr10:68113657-68113704,chr10,68113657,68113704,HepG2|chr10:65278427-65278507,chr10,65278427,65278507,0,2835230
HepG2|chr10:68520481-68520588,chr10,68520481,68520588,HepG2|chr10:73853040-73853093,chr10,73853040,73853093,0,5332559
HepG2|chr10:68757877-68757924,chr10,68757877,68757924,HepG2|chr10:73853188-73853291,chr10,73853188,73853291,0,5095311
HepG2|chr10:69781158-69781305,chr10,69781158,69781305,HepG2|chr10:134350229-134350248,chr10,134350229,134350248,0,64569071
HepG2|chr10:70208724-70208795,chr10,70208724,70208795,HepG2|chr10:73853188-73853291,chr10,73853188,73853291,0,3644464
HepG2|chr10:70529091-70529107,chr10,70529091,70529107,HepG2|chr10:135207810-135207960,chr10,135207810,135207960,0,64678719
HepG2|chr10:71750487-71750547,chr10,71750487,71750547,HepG2|chr10:65277558-65277685,chr10,65277558,65277685,0,6472929
HepG2|chr10:71805046-71805068,chr10,71805046,71805068,HepG2|chr10:65280462-65280538,chr10,65280462,65280538,0,6524584
HepG2|chr10:73359337-73359397,chr10,73359337,73359397,HepG2|chr10:60030072-60030162,chr10,60030072,60030162,0,13329265
HepG2|chr10:73970574-73970665,chr10,73970574,73970665,HepG2|chr10:81967220-81967248,chr10,81967220,81967248,0,7996646
HepG2|chr10:75772394-75772442,chr10,75772394,75772442,HepG2|chr10:73853126-73853218,chr10,73853126,73853218,0,1919268
HepG2|chr10:75931729-75931849,chr10,75931729,75931849,HepG2|chr10:73852707-73852820,chr10,73852707,73852820,0,2079022
HepG2|chr10:76217345-76217464,chr10,76217345,76217464,HepG2|chr10:73852720-73852760,chr10,73852720,73852760,0,2364625
HepG2|chr10:76237202-76237352,chr10,76237202,76237352,HepG2|chr10:89259694-89259844,chr10,89259694,89259844,0,13022492
HepG2|chr10:76550663-76550715,chr10,76550663,76550715,HepG2|chr10:75503921-75504034,chr10,75503921,75504034,0,1046742
HepG2|chr10:77254176-77254234,chr10,77254176,77254234,HepG2|chr10:73852216-73852299,chr10,73852216,73852299,0,3401960
HepG2|chr10:77272699-77272779,chr10,77272699,77272779,HepG2|chr10:65280408-65280494,chr10,65280408,65280494,0,11992291
HepG2|chr10:77514866-77514986,chr10,77514866,77514986,HepG2|chr10:81967218-81967248,chr10,81967218,81967248,0,4452352
HepG2|chr10:78476659-78476769,chr10,78476659,78476769,HepG2|chr10:65276899-65276927,chr10,65276899,65276927,0,13199760
HepG2|chr10:78497938-78498036,chr10,78497938,78498036,HepG2|chr10:73853035-73853164,chr10,73853035,73853164,0,4644903
HepG2|chr10:78707271-78707392,chr10,78707271,78707392,HepG2|chr10:73853391-73853502,chr10,73853391,73853502,0,4853880
HepG2|chr10:78834684-78834779,chr10,78834684,78834779,HepG2|chr10:65276291-65276346,chr10,65276291,65276346,0,13558393
HepG2|chr10:79227076-79227177,chr10,79227076,79227177,HepG2|chr10:73852477-73852533,chr10,73852477,73852533,0,5374599
HepG2|chr10:79464377-79464403,chr10,79464377,79464403,HepG2|chr10:65280117-65280238,chr10,65280117,65280238,0,14184260
HepG2|chr10:79480760-79480789,chr10,79480760,79480789,HepG2|chr10:120940424-120940542,chr10,120940424,120940542,0,41459664
HepG2|chr10:79561200-79561312,chr10,79561200,79561312,HepG2|chr10:75503921-75503958,chr10,75503921,75503958,0,4057279
HepG2|chr10:80175144-80175230,chr10,80175144,80175230,HepG2|chr10:75504001-75504148,chr10,75504001,75504148,0,4671143
HepG2|chr10:81066803-81066896,chr10,81066803,81066896,HepG2|chr10:65278989-65279052,chr10,65278989,65279052,0,15787814
HepG2|chr10:81231912-81232028,chr10,81231912,81232028,HepG2|chr10:60030072-60030162,chr10,60030072,60030162,0,21201840
HepG2|chr10:81286371-81286430,chr10,81286371,81286430,HepG2|chr10:65278045-65278133,chr10,65278045,65278133,0,16008326
HepG2|chr10:81368138-81368158,chr10,81368138,81368158,HepG2|chr10:75503943-75504091,chr10,75503943,75504091,0,5864195
HepG2|chr10:81473691-81473783,chr10,81473691,81473783,HepG2|chr10:65276788-65276846,chr10,65276788,65276846,0,16196903
HepG2|chr10:81570720-81570767,chr10,81570720,81570767,HepG2|chr10:75503921-75504024,chr10,75503921,75504024,0,6066799
HepG2|chr10:81580187-81580277,chr10,81580187,81580277,HepG2|chr10:65279995-65280055,chr10,65279995,65280055,0,16300192
HepG2|chr10:81623544-81623660,chr10,81623544,81623660,HepG2|chr10:60030072-60030162,chr10,60030072,60030162,0,21593472
HepG2|chr10:83373564-83373643,chr10,83373564,83373643,HepG2|chr10:81967201-81967248,chr10,81967201,81967248,0,1406363
HepG2|chr10:83831201-83831315,chr10,83831201,83831315,HepG2|chr10:73852720-73852807,chr10,73852720,73852807,0,9978481
HepG2|chr10:84228867-84228942,chr10,84228867,84228942,HepG2|chr10:73853422-73853497,chr10,73853422,73853497,0,10375445
HepG2|chr10:84673344-84673388,chr10,84673344,84673388,HepG2|chr10:75503916-75504018,chr10,75503916,75504018,0,9169428
HepG2|chr10:85226751-85226901,chr10,85226751,85226901,HepG2|chr10:75503921-75503946,chr10,75503921,75503946,0,9722830
HepG2|chr10:85307180-85307231,chr10,85307180,85307231,HepG2|chr10:65278371-65278451,chr10,65278371,65278451,0,20028809
HepG2|chr10:85496541-85496626,chr10,85496541,85496626,HepG2|chr10:81967183-81967248,chr10,81967183,81967248,0,3529358
HepG2|chr10:85537091-85537149,chr10,85537091,85537149,HepG2|chr10:65277308-65277376,chr10,65277308,65277376,0,20259783
HepG2|chr10:85949099-85949242,chr10,85949099,85949242,HepG2|chr10:89259694-89259844,chr10,89259694,89259844,0,3310595
HepG2|chr10:86485742-86485794,chr10,86485742,86485794,HepG2|chr10:99055111-99055164,chr10,99055111,99055164,0,12569369
HepG2|chr10:86600030-86600074,chr10,86600030,86600074,HepG2|chr10:75503921-75503995,chr10,75503921,75503995,0,11096109
HepG2|chr10:86751326-86751422,chr10,86751326,86751422,HepG2|chr10:65279101-65279154,chr10,65279101,65279154,0,21472225
HepG2|chr10:86825329-86825477,chr10,86825329,86825477,HepG2|chr10:134350229-134350270,chr10,134350229,134350270,0,47524900
HepG2|chr10:87401697-87401843,chr10,87401697,87401843,HepG2|chr10:75503921-75503939,chr10,75503921,75503939,0,11897776
HepG2|chr10:87433938-87434019,chr10,87433938,87434019,HepG2|chr10:73851490-73851595,chr10,73851490,73851595,0,13582448
HepG2|chr10:87544900-87544922,chr10,87544900,87544922,HepG2|chr10:65277358-65277391,chr10,65277358,65277391,0,22267542
HepG2|chr10:87905350-87905421,chr10,87905350,87905421,HepG2|chr10:65278120-65278175,chr10,65278120,65278175,0,22627230
HepG2|chr10:88375819-88375965,chr10,88375819,88375965,HepG2|chr10:73852620-73852697,chr10,73852620,73852697,0,14523199
HepG2|chr10:88501164-88501190,chr10,88501164,88501190,HepG2|chr10:73849451-73849543,chr10,73849451,73849543,0,14651713
HepG2|chr10:88984042-88984128,chr10,88984042,88984128,HepG2|chr10:65278989-65279052,chr10,65278989,65279052,0,23705053
HepG2|chr10:89116996-89117094,chr10,89116996,89117094,HepG2|chr10:73853035-73853164,chr10,73853035,73853164,0,15263961
HepG2|chr10:89261364-89261432,chr10,89261364,89261432,HepG2|chr10:92977507-92977654,chr10,92977507,92977654,0,3716143
HepG2|chr10:89951868-89951950,chr10,89951868,89951950,HepG2|chr10:73853035-73853174,chr10,73853035,73853174,0,16098833
HepG2|chr10:90009254-90009350,chr10,90009254,90009350,HepG2|chr10:65279101-65279154,chr10,65279101,65279154,0,24730153
HepG2|chr10:90110012-90110126,chr10,90110012,90110126,HepG2|chr10:73852720-73852807,chr10,73852720,73852807,0,16257292
HepG2|chr10:90202767-90202887,chr10,90202767,90202887,HepG2|chr10:81967218-81967248,chr10,81967218,81967248,0,8235549
HepG2|chr10:90613165-90613238,chr10,90613165,90613238,HepG2|chr10:65279864-65279973,chr10,65279864,65279973,0,25333301
HepG2|chr10:90731865-90731949,chr10,90731865,90731949,HepG2|chr10:81967183-81967248,chr10,81967183,81967248,0,8764682
HepG2|chr10:90933199-90933242,chr10,90933199,90933242,HepG2|chr10:99055111-99055164,chr10,99055111,99055164,0,8121912
HepG2|chr10:90958745-90958848,chr10,90958745,90958848,HepG2|chr10:65280100-65280166,chr10,65280100,65280166,0,25678645
HepG2|chr10:90995072-90995181,chr10,90995072,90995181,HepG2|chr10:134350229-134350270,chr10,134350229,134350270,0,43355157
HepG2|chr10:91203194-91203231,chr10,91203194,91203231,HepG2|chr10:75503921-75504034,chr10,75503921,75504034,0,15699273
HepG2|chr10:91411423-91411499,chr10,91411423,91411499,HepG2|chr10:73853144-73853208,chr10,73853144,73853208,0,17558279
HepG2|chr10:91564025-91564108,chr10,91564025,91564108,HepG2|chr10:73852809-73852931,chr10,73852809,73852931,0,17711216
HepG2|chr10:91854379-91854486,chr10,91854379,91854486,HepG2|chr10:65278045-65278133,chr10,65278045,65278133,0,26576334
HepG2|chr10:92549112-92549164,chr10,92549112,92549164,HepG2|chr10:92978941-92979039,chr10,92978941,92979039,0,429829
HepG2|chr10:92658327-92658434,chr10,92658327,92658434,HepG2|chr10:75503921-75503937,chr10,75503921,75503937,0,17154406
HepG2|chr10:92909648-92909707,chr10,92909648,92909707,HepG2|chr10:65278045-65278133,chr10,65278045,65278133,0,27631603
HepG2|chr10:93518786-93518935,chr10,93518786,93518935,HepG2|chr10:89259757-89259837,chr10,89259757,89259837,0,4259029
HepG2|chr10:93674728-93674819,chr10,93674728,93674819,HepG2|chr10:73853017-73853161,chr10,73853017,73853161,0,19821711
HepG2|chr10:94353128-94353147,chr10,94353128,94353147,HepG2|chr10:73852720-73852760,chr10,73852720,73852760,0,20500408
HepG2|chr10:94840089-94840170,chr10,94840089,94840170,HepG2|chr10:65280100-65280166,chr10,65280100,65280166,0,29559989
HepG2|chr10:94848331-94848476,chr10,94848331,94848476,HepG2|chr10:65276291-65276346,chr10,65276291,65276346,0,29572040
HepG2|chr10:94873998-94874093,chr10,94873998,94874093,HepG2|chr10:75503915-75503970,chr10,75503915,75503970,0,19370083
HepG2|chr10:95826271-95826337,chr10,95826271,95826337,HepG2|chr10:75503921-75503965,chr10,75503921,75503965,0,20322350
HepG2|chr10:97955663-97955791,chr10,97955663,97955791,HepG2|chr10:134347793-134347940,chr10,134347793,134347940,0,36392130
HepG2|chr10:98362682-98362736,chr10,98362682,98362736,HepG2|chr10:75503921-75504012,chr10,75503921,75504012,0,22858761
HepG2|chr10:98675591-98675630,chr10,98675591,98675630,HepG2|chr10:65276908-65277057,chr10,65276908,65277057,0,33398683
HepG2|chr10:98944490-98944597,chr10,98944490,98944597,HepG2|chr10:75503921-75503937,chr10,75503921,75503937,0,23440569
HepG2|chr10:98982749-98982859,chr10,98982749,98982859,HepG2|chr10:65276899-65276927,chr10,65276899,65276927,0,33705850
HepG2|chr10:99675690-99675709,chr10,99675690,99675709,HepG2|chr10:135207826-135207952,chr10,135207826,135207952,0,35532136
HepG2|chr10:99792530-99792649,chr10,99792530,99792649,HepG2|chr10:73852720-73852760,chr10,73852720,73852760,0,25939810
HepG2|chr10:99856498-99856572,chr10,99856498,99856572,HepG2|chr10:65278248-65278365,chr10,65278248,65278365,0,34578250
HepG2|chr10:100517955-100517998,chr10,100517955,100517998,HepG2|chr10:65276246-65276396,chr10,65276246,65276396,0,35241709
HepG2|chr10:100922113-100922263,chr10,100922113,100922263,HepG2|chr10:106098721-106098830,chr10,106098721,106098830,0,5176608
HepG2|chr10:101396356-101396402,chr10,101396356,101396402,HepG2|chr10:65278427-65278507,chr10,65278427,65278507,0,36117929
HepG2|chr10:102253981-102254126,chr10,102253981,102254126,HepG2|chr10:65277358-65277390,chr10,65277358,65277390,0,36976623
HepG2|chr10:102711433-102711497,chr10,102711433,102711497,HepG2|chr10:65280408-65280494,chr10,65280408,65280494,0,37431025
HepG2|chr10:103162433-103162512,chr10,103162433,103162512,HepG2|chr10:73852673-73852785,chr10,73852673,73852785,0,29309760
HepG2|chr10:104185459-104185550,chr10,104185459,104185550,HepG2|chr10:65279995-65280055,chr10,65279995,65280055,0,38905464
HepG2|chr10:104236493-104236578,chr10,104236493,104236578,HepG2|chr10:65277358-65277390,chr10,65277358,65277390,0,38959135
HepG2|chr10:105372607-105372654,chr10,105372607,105372654,HepG2|chr10:73853188-73853291,chr10,73853188,73853291,0,31519419
HepG2|chr10:106289653-106289748,chr10,106289653,106289748,HepG2|chr10:65276291-65276346,chr10,65276291,65276346,0,41013362
HepG2|chr10:106687465-106687550,chr10,106687465,106687550,HepG2|chr10:81967183-81967248,chr10,81967183,81967248,0,24720282
HepG2|chr10:107056793-107056812,chr10,107056793,107056812,HepG2|chr10:135207826-135207952,chr10,135207826,135207952,0,28151033
HepG2|chr10:107268974-107269103,chr10,107268974,107269103,HepG2|chr10:75503915-75503936,chr10,75503915,75503936,0,31765059
HepG2|chr10:109238783-109238911,chr10,109238783,109238911,HepG2|chr10:89259767-89259835,chr10,89259767,89259835,0,19979016
HepG2|chr10:109247762-109247912,chr10,109247762,109247912,HepG2|chr10:73853075-73853152,chr10,73853075,73853152,0,35394687
HepG2|chr10:109565980-109566101,chr10,109565980,109566101,HepG2|chr10:73853391-73853502,chr10,73853391,73853502,0,35712589
HepG2|chr10:109649825-109649911,chr10,109649825,109649911,HepG2|chr10:65279778-65279898,chr10,65279778,65279898,0,44370047
HepG2|chr10:110077150-110077262,chr10,110077150,110077262,HepG2|chr10:65279170-65279311,chr10,65279170,65279311,0,44797980
HepG2|chr10:110528151-110528244,chr10,110528151,110528244,HepG2|chr10:73852711-73852748,chr10,73852711,73852748,0,36675440
HepG2|chr10:110677827-110677919,chr10,110677827,110677919,HepG2|chr10:65276788-65276846,chr10,65276788,65276846,0,45401039
HepG2|chr10:111463470-111463516,chr10,111463470,111463516,HepG2|chr10:75503924-75504074,chr10,75503924,75504074,0,35959546
HepG2|chr10:111921912-111921932,chr10,111921912,111921932,HepG2|chr10:92978926-92979072,chr10,92978926,92979072,0,18942986
HepG2|chr10:112065214-112065247,chr10,112065214,112065247,HepG2|chr10:65279313-65279463,chr10,65279313,65279463,0,46785901
HepG2|chr10:112355624-112355650,chr10,112355624,112355650,HepG2|chr10:65280117-65280238,chr10,65280117,65280238,0,47075507
HepG2|chr10:112710502-112710592,chr10,112710502,112710592,HepG2|chr10:65276788-65276846,chr10,65276788,65276846,0,47433714
HepG2|chr10:113246618-113246694,chr10,113246618,113246694,HepG2|chr10:81967228-81967353,chr10,81967228,81967353,0,31279390
HepG2|chr10:113521334-113521414,chr10,113521334,113521414,HepG2|chr10:65280408-65280494,chr10,65280408,65280494,0,48240926
HepG2|chr10:113579545-113579618,chr10,113579545,113579618,HepG2|chr10:73853075-73853152,chr10,73853075,73853152,0,39726470
HepG2|chr10:114418738-114418822,chr10,114418738,114418822,HepG2|chr10:81967183-81967248,chr10,81967183,81967248,0,32451555
HepG2|chr10:114903661-114903716,chr10,114903661,114903716,HepG2|chr10:65277582-65277677,chr10,65277582,65277677,0,49626079
HepG2|chr10:115040331-115040421,chr10,115040331,115040421,HepG2|chr10:73852711-73852748,chr10,73852711,73852748,0,41187620
HepG2|chr10:115806915-115806959,chr10,115806915,115806959,HepG2|chr10:75503916-75504018,chr10,75503916,75504018,0,40302999
HepG2|chr10:115839353-115839398,chr10,115839353,115839398,HepG2|chr10:73851490-73851595,chr10,73851490,73851595,0,41987863
HepG2|chr10:115935088-115935179,chr10,115935088,115935179,HepG2|chr10:73853017-73853161,chr10,73853017,73853161,0,42082071
HepG2|chr10:116745052-116745116,chr10,116745052,116745116,HepG2|chr10:65280528-65280574,chr10,65280528,65280574,0,51464524
HepG2|chr10:116876197-116876226,chr10,116876197,116876226,HepG2|chr10:73852673-73852785,chr10,73852673,73852785,0,43023524
HepG2|chr10:118229135-118229216,chr10,118229135,118229216,HepG2|chr10:65281497-65281566,chr10,65281497,65281566,0,52947638
HepG2|chr10:119293493-119293531,chr10,119293493,119293531,HepG2|chr10:134350229-134350341,chr10,134350229,134350341,0,15056736
HepG2|chr10:119920836-119920981,chr10,119920836,119920981,HepG2|chr10:65276291-65276346,chr10,65276291,65276346,0,54644545
HepG2|chr10:120126960-120126993,chr10,120126960,120126993,HepG2|chr10:65278248-65278365,chr10,65278248,65278365,0,54848712
HepG2|chr10:120331988-120332107,chr10,120331988,120332107,HepG2|chr10:75503915-75503970,chr10,75503915,75503970,0,44828073
HepG2|chr10:120426358-120426433,chr10,120426358,120426433,HepG2|chr10:92978941-92979039,chr10,92978941,92979039,0,27447417
HepG2|chr10:120533907-120533949,chr10,120533907,120533949,HepG2|chr10:65279324-65279432,chr10,65279324,65279432,0,55254583
HepG2|chr10:121769659-121769688,chr10,121769659,121769688,HepG2|chr10:120940424-120940542,chr10,120940424,120940542,0,829235
HepG2|chr10:121774442-121774592,chr10,121774442,121774592,HepG2|chr10:73853422-73853497,chr10,73853422,73853497,0,47921020
HepG2|chr10:122068217-122068312,chr10,122068217,122068312,HepG2|chr10:65279101-65279154,chr10,65279101,65279154,0,56789116
HepG2|chr10:122111593-122111613,chr10,122111593,122111613,HepG2|chr10:92978926-92979072,chr10,92978926,92979072,0,29132667
HepG2|chr10:122600695-122600720,chr10,122600695,122600720,HepG2|chr10:65279324-65279432,chr10,65279324,65279432,0,57321371
HepG2|chr10:122621383-122621408,chr10,122621383,122621408,HepG2|chr10:65279324-65279432,chr10,65279324,65279432,0,57342059
HepG2|chr10:123024348-123024374,chr10,123024348,123024374,HepG2|chr10:65278463-65278521,chr10,65278463,65278521,0,57745885
HepG2|chr10:123404893-123404911,chr10,123404893,123404911,HepG2|chr10:65277737-65277804,chr10,65277737,65277804,0,58127156
HepG2|chr10:124441542-124441691,chr10,124441542,124441691,HepG2|chr10:89259757-89259837,chr10,89259757,89259837,0,35181785
HepG2|chr10:125181789-125181833,chr10,125181789,125181833,HepG2|chr10:120941976-120942067,chr10,120941976,120942067,0,4239813
HepG2|chr10:125639328-125639427,chr10,125639328,125639427,HepG2|chr10:99182950-99183001,chr10,99182950,99183001,0,26456378
HepG2|chr10:125988410-125988455,chr10,125988410,125988455,HepG2|chr10:73851490-73851595,chr10,73851490,73851595,0,52136920
HepG2|chr10:126508841-126508969,chr10,126508841,126508969,HepG2|chr10:134347793-134347940,chr10,134347793,134347940,0,7838952
HepG2|chr10:127801039-127801095,chr10,127801039,127801095,HepG2|chr10:120940424-120940542,chr10,120940424,120940542,0,6860615
HepG2|chr10:127812156-127812235,chr10,127812156,127812235,HepG2|chr10:92980836-92980986,chr10,92980836,92980986,0,34831320
HepG2|chr10:128169029-128169089,chr10,128169029,128169089,HepG2|chr10:65277558-65277685,chr10,65277558,65277685,0,62891471
HepG2|chr10:128360599-128360718,chr10,128360599,128360718,HepG2|chr10:75503915-75503970,chr10,75503915,75503970,0,52856684
HepG2|chr10:128401721-128401767,chr10,128401721,128401767,HepG2|chr10:75503924-75504074,chr10,75503924,75504074,0,52897797
HepG2|chr10:128622831-128622945,chr10,128622831,128622945,HepG2|chr10:75503921-75504012,chr10,75503921,75504012,0,53118910
HepG2|chr10:129710244-129710339,chr10,129710244,129710339,HepG2|chr10:65279101-65279154,chr10,65279101,65279154,0,64431143
HepG2|chr10:129883182-129883215,chr10,129883182,129883215,HepG2|chr10:65278248-65278365,chr10,65278248,65278365,0,64604934
HepG2|chr10:130139800-130139864,chr10,130139800,130139864,HepG2|chr10:65280528-65280574,chr10,65280528,65280574,0,64859272
HepG2|chr10:130774353-130774462,chr10,130774353,130774462,HepG2|chr10:75503921-75503958,chr10,75503921,75503958,0,55270432
HepG2|chr10:130864472-130864501,chr10,130864472,130864501,HepG2|chr10:73852673-73852785,chr10,73852673,73852785,0,57011799
HepG2|chr10:131506614-131506704,chr10,131506614,131506704,HepG2|chr10:81967206-81967248,chr10,81967206,81967248,0,49539408
HepG2|chr10:131510357-131510432,chr10,131510357,131510432,HepG2|chr10:92978941-92979039,chr10,92978941,92979039,0,38531416
HepG2|chr10:131806063-131806095,chr10,131806063,131806095,HepG2|chr10:65280117-65280238,chr10,65280117,65280238,0,66525946
HepG2|chr10:132246998-132247093,chr10,132246998,132247093,HepG2|chr10:75503915-75503970,chr10,75503915,75503970,0,56743083
HepG2|chr10:132745644-132745670,chr10,132745644,132745670,HepG2|chr10:65278463-65278521,chr10,65278463,65278521,0,67467181
HepG2|chr10:134114131-134114222,chr10,134114131,134114222,HepG2|chr10:81967220-81967248,chr10,81967220,81967248,0,52146911
HepG2|chr10:134513247-134513299,chr10,134513247,134513299,HepG2|chr10:92978941-92979039,chr10,92978941,92979039,0,41534306
HepG2|chr10:134707588-134707733,chr10,134707588,134707733,HepG2|chr10:65277358-65277390,chr10,65277358,65277390,0,69430230
HepG2|chr10:134981340-134981490,chr10,134981340,134981490,HepG2|chr10:73853075-73853152,chr10,73853075,73853152,0,61128265
HepG2|chr11:11877-11916,chr11,11877,11916,HepG2|chr11:126225336-126225412,chr11,126225336,126225412,0,126213459
HepG2|chr11:22950-23014,chr11,22950,23014,HepG2|chr11:126225336-126225422,chr11,126225336,126225422,0,126202386
HepG2|chr11:75557-75618,chr11,75557,75618,HepG2|chr11:65081814-65081903,chr11,65081814,65081903,0,65006257
HepG2|chr11:693685-693766,chr11,693685,693766,HepG2|chr11:65077347-65077470,chr11,65077347,65077470,0,64383662
HepG2|chr11:954367-954477,chr11,954367,954477,HepG2|chr11:65080104-65080129,chr11,65080104,65080129,0,64125737
HepG2|chr11:1034011-1034132,chr11,1034011,1034132,HepG2|chr11:108532163-108532184,chr11,108532163,108532184,0,107498152
HepG2|chr11:1042810-1042899,chr11,1042810,1042899,HepG2|chr11:93519130-93519170,chr11,93519130,93519170,0,92476320
HepG2|chr11:1306140-1306163,chr11,1306140,1306163,HepG2|chr11:65081241-65081281,chr11,65081241,65081281,0,63775101
HepG2|chr11:1403662-1403812,chr11,1403662,1403812,HepG2|chr11:126224687-126224708,chr11,126224687,126224708,0,124821025
HepG2|chr11:1422683-1422813,chr11,1422683,1422813,HepG2|chr11:776756-776841,chr11,776756,776841,0,645927
HepG2|chr11:1599655-1599686,chr11,1599655,1599686,HepG2|chr11:78128564-78128606,chr11,78128564,78128606,0,76528909
HepG2|chr11:1601999-1602111,chr11,1601999,1602111,HepG2|chr11:64043067-64043096,chr11,64043067,64043096,0,62441068
HepG2|chr11:1816369-1816434,chr11,1816369,1816434,HepG2|chr11:66673181-66673271,chr11,66673181,66673271,0,64856812
HepG2|chr11:1919647-1919681,chr11,1919647,1919681,HepG2|chr11:74695747-74695841,chr11,74695747,74695841,0,72776100
HepG2|chr11:2026384-2026410,chr11,2026384,2026410,HepG2|chr11:65081838-65081874,chr11,65081838,65081874,0,63055454
HepG2|chr11:2448589-2448646,chr11,2448589,2448646,HepG2|chr11:126225336-126225398,chr11,126225336,126225398,0,123776747
HepG2|chr11:2560205-2560288,chr11,2560205,2560288,HepG2|chr11:66680143-66680161,chr11,66680143,66680161,0,64119938
HepG2|chr11:2737836-2737962,chr11,2737836,2737962,HepG2|chr11:65081814-65081903,chr11,65081814,65081903,0,62343978
HepG2|chr11:2852874-2852937,chr11,2852874,2852937,HepG2|chr11:65081237-65081324,chr11,65081237,65081324,0,62228363
HepG2|chr11:3019526-3019606,chr11,3019526,3019606,HepG2|chr11:126225336-126225389,chr11,126225336,126225389,0,123205810
HepG2|chr11:3175693-3175730,chr11,3175693,3175730,HepG2|chr11:118887802-118887839,chr11,118887802,118887839,0,115712109
HepG2|chr11:3399972-3400077,chr11,3399972,3400077,HepG2|chr11:17298712-17298734,chr11,17298712,17298734,0,13898740
HepG2|chr11:3669789-3669845,chr11,3669789,3669845,HepG2|chr11:65077680-65077718,chr11,65077680,65077718,0,61407891
HepG2|chr11:3731877-3731945,chr11,3731877,3731945,HepG2|chr11:67155005-67155022,chr11,67155005,67155022,0,63423128
HepG2|chr11:3959138-3959262,chr11,3959138,3959262,HepG2|chr11:102180615-102180677,chr11,102180615,102180677,0,98221477
HepG2|chr11:4443598-4443685,chr11,4443598,4443685,HepG2|chr11:65081241-65081304,chr11,65081241,65081304,0,60637643
HepG2|chr11:4614879-4615029,chr11,4614879,4615029,HepG2|chr11:126225336-126225415,chr11,126225336,126225415,0,121610457
HepG2|chr11:4790406-4790511,chr11,4790406,4790511,HepG2|chr11:126225336-126225415,chr11,126225336,126225415,0,121434930
HepG2|chr11:4989370-4989401,chr11,4989370,4989401,HepG2|chr11:65082034-65082117,chr11,65082034,65082117,0,60092664
HepG2|chr11:5021050-5021102,chr11,5021050,5021102,HepG2|chr11:528158-528240,chr11,528158,528240,0,4492892
HepG2|chr11:5072795-5072913,chr11,5072795,5072913,HepG2|chr11:78127291-78127440,chr11,78127291,78127440,0,73054496
HepG2|chr11:5100503-5100619,chr11,5100503,5100619,HepG2|chr11:126225336-126225434,chr11,126225336,126225434,0,121124833
HepG2|chr11:5224700-5224754,chr11,5224700,5224754,HepG2|chr11:65081241-65081337,chr11,65081241,65081337,0,59856541
HepG2|chr11:5257939-5258035,chr11,5257939,5258035,HepG2|chr11:126225336-126225415,chr11,126225336,126225415,0,120967397
HepG2|chr11:5299894-5300010,chr11,5299894,5300010,HepG2|chr11:68227453-68227603,chr11,68227453,68227603,0,62927559
HepG2|chr11:5341442-5341467,chr11,5341442,5341467,HepG2|chr11:126221889-126222014,chr11,126221889,126222014,0,120880447
HepG2|chr11:5559222-5559372,chr11,5559222,5559372,HepG2|chr11:65081241-65081264,chr11,65081241,65081264,0,59522019
HepG2|chr11:6413092-6413242,chr11,6413092,6413242,HepG2|chr11:65079695-65079726,chr11,65079695,65079726,0,58666603
HepG2|chr11:6417396-6417523,chr11,6417396,6417523,HepG2|chr11:65081237-65081260,chr11,65081237,65081260,0,58663841
HepG2|chr11:6532989-6533070,chr11,6532989,6533070,HepG2|chr11:65077347-65077470,chr11,65077347,65077470,0,58544358
HepG2|chr11:6579877-6580000,chr11,6579877,6580000,HepG2|chr11:65819321-65819339,chr11,65819321,65819339,0,59239444
HepG2|chr11:6606570-6606644,chr11,6606570,6606644,HepG2|chr11:65081970-65082047,chr11,65081970,65082047,0,58475400
HepG2|chr11:6821547-6821659,chr11,6821547,6821659,HepG2|chr11:65081237-65081360,chr11,65081237,65081360,0,58259690
HepG2|chr11:6911613-6911706,chr11,6911613,6911706,HepG2|chr11:73586324-73586378,chr11,73586324,73586378,0,66674711
HepG2|chr11:7111082-7111204,chr11,7111082,7111204,HepG2|chr11:65081241-65081304,chr11,65081241,65081304,0,57970159
HepG2|chr11:7269505-7269625,chr11,7269505,7269625,HepG2|chr11:810565-810632,chr11,810565,810632,0,6458940
HepG2|chr11:7381565-7381675,chr11,7381565,7381675,HepG2|chr11:68229607-68229647,chr11,68229607,68229647,0,60848042
HepG2|chr11:7463445-7463595,chr11,7463445,7463595,HepG2|chr11:126224907-126225008,chr11,126224907,126225008,0,118761462
HepG2|chr11:7499244-7499394,chr11,7499244,7499394,HepG2|chr11:126225336-126225412,chr11,126225336,126225412,0,118726092
HepG2|chr11:7523528-7523655,chr11,7523528,7523655,HepG2|chr11:65081237-65081260,chr11,65081237,65081260,0,57557709
HepG2|chr11:7743169-7743204,chr11,7743169,7743204,HepG2|chr11:65082529-65082657,chr11,65082529,65082657,0,57339360
HepG2|chr11:7941879-7941954,chr11,7941879,7941954,HepG2|chr11:65081237-65081324,chr11,65081237,65081324,0,57139358
HepG2|chr11:7950183-7950212,chr11,7950183,7950212,HepG2|chr11:82781863-82782007,chr11,82781863,82782007,0,74831680
HepG2|chr11:8000784-8000894,chr11,8000784,8000894,HepG2|chr11:65080104-65080129,chr11,65080104,65080129,0,57079320
HepG2|chr11:8153371-8153519,chr11,8153371,8153519,HepG2|chr11:65081836-65081945,chr11,65081836,65081945,0,56928465
HepG2|chr11:8406324-8406384,chr11,8406324,8406384,HepG2|chr11:790423-790516,chr11,790423,790516,0,7615901
HepG2|chr11:8512961-8513053,chr11,8512961,8513053,HepG2|chr11:65078079-65078177,chr11,65078079,65078177,0,56565118
HepG2|chr11:8617770-8617825,chr11,8617770,8617825,HepG2|chr11:118787841-118787928,chr11,118787841,118787928,0,110170071
HepG2|chr11:8724492-8724528,chr11,8724492,8724528,HepG2|chr11:528215-528365,chr11,528215,528365,0,8196277
HepG2|chr11:8837948-8838065,chr11,8837948,8838065,HepG2|chr11:59580562-59580591,chr11,59580562,59580591,0,50742614
HepG2|chr11:8876284-8876336,chr11,8876284,8876336,HepG2|chr11:65078079-65078177,chr11,65078079,65078177,0,56201795
HepG2|chr11:8927339-8927438,chr11,8927339,8927438,HepG2|chr11:65081237-65081308,chr11,65081237,65081308,0,56153898
HepG2|chr11:9059517-9059569,chr11,9059517,9059569,HepG2|chr11:126225336-126225379,chr11,126225336,126225379,0,117165819
HepG2|chr11:9363983-9364066,chr11,9363983,9364066,HepG2|chr11:65081241-65081276,chr11,65081241,65081276,0,55717258
HepG2|chr11:9393669-9393705,chr11,9393669,9393705,HepG2|chr11:74695747-74695841,chr11,74695747,74695841,0,65302078
HepG2|chr11:9572928-9573045,chr11,9572928,9573045,HepG2|chr11:65377786-65377804,chr11,65377786,65377804,0,55804858
HepG2|chr11:9645325-9645425,chr11,9645325,9645425,HepG2|chr11:14520564-14520587,chr11,14520564,14520587,0,4875239
HepG2|chr11:9800497-9800591,chr11,9800497,9800591,HepG2|chr11:631372-631456,chr11,631372,631456,0,9169125
HepG2|chr11:9819101-9819154,chr11,9819101,9819154,HepG2|chr11:65084948-65084990,chr11,65084948,65084990,0,55265847
HepG2|chr11:10004023-10004048,chr11,10004023,10004048,HepG2|chr11:126225336-126225457,chr11,126225336,126225457,0,116221313
HepG2|chr11:10634538-10634683,chr11,10634538,10634683,HepG2|chr11:14520564-14520587,chr11,14520564,14520587,0,3886026
HepG2|chr11:10700711-10700817,chr11,10700711,10700817,HepG2|chr11:68227603-68227647,chr11,68227603,68227647,0,57526892
HepG2|chr11:10933431-10933498,chr11,10933431,10933498,HepG2|chr11:126225336-126225432,chr11,126225336,126225432,0,115291905
HepG2|chr11:11141534-11141684,chr11,11141534,11141684,HepG2|chr11:65081245-65081395,chr11,65081245,65081395,0,53939711
HepG2|chr11:11328079-11328189,chr11,11328079,11328189,HepG2|chr11:65081241-65081281,chr11,65081241,65081281,0,53753162
HepG2|chr11:11403636-11403686,chr11,11403636,11403686,HepG2|chr11:65081241-65081327,chr11,65081241,65081327,0,53677605
HepG2|chr11:11434142-11434271,chr11,11434142,11434271,HepG2|chr11:65081078-65081099,chr11,65081078,65081099,0,53646936
HepG2|chr11:11515335-11515441,chr11,11515335,11515441,HepG2|chr11:126225336-126225377,chr11,126225336,126225377,0,114710001
HepG2|chr11:11585382-11585408,chr11,11585382,11585408,HepG2|chr11:65081838-65081874,chr11,65081838,65081874,0,53496456
HepG2|chr11:11669298-11669379,chr11,11669298,11669379,HepG2|chr11:65081237-65081306,chr11,65081237,65081306,0,53411939
HepG2|chr11:11738348-11738470,chr11,11738348,11738470,HepG2|chr11:126225336-126225364,chr11,126225336,126225364,0,114486988
HepG2|chr11:11873205-11873355,chr11,11873205,11873355,HepG2|chr11:65317728-65317793,chr11,65317728,65317793,0,53444523
HepG2|chr11:11909855-11910005,chr11,11909855,11910005,HepG2|chr11:17093062-17093131,chr11,17093062,17093131,0,5183207
HepG2|chr11:12832106-12832140,chr11,12832106,12832140,HepG2|chr11:65817378-65817393,chr11,65817378,65817393,0,52985272
HepG2|chr11:13081202-13081237,chr11,13081202,13081237,HepG2|chr11:65081241-65081332,chr11,65081241,65081332,0,52000039
HepG2|chr11:13761393-13761506,chr11,13761393,13761506,HepG2|chr11:126222137-126222177,chr11,126222137,126222177,0,112460744
HepG2|chr11:14084229-14084341,chr11,14084229,14084341,HepG2|chr11:126225336-126225374,chr11,126225336,126225374,0,112141107
HepG2|chr11:14350464-14350496,chr11,14350464,14350496,HepG2|chr11:93517976-93518094,chr11,93517976,93518094,0,79167512
HepG2|chr11:14609708-14609796,chr11,14609708,14609796,HepG2|chr11:65079711-65079753,chr11,65079711,65079753,0,50470003
HepG2|chr11:14858753-14858793,chr11,14858753,14858793,HepG2|chr11:65081241-65081340,chr11,65081241,65081340,0,50222488
HepG2|chr11:15373458-15373587,chr11,15373458,15373587,HepG2|chr11:102218855-102218875,chr11,102218855,102218875,0,86845397
HepG2|chr11:15932893-15932975,chr11,15932893,15932975,HepG2|chr11:810565-810632,chr11,810565,810632,0,15122328
HepG2|chr11:16030988-16031133,chr11,16030988,16031133,HepG2|chr11:14520564-14520587,chr11,14520564,14520587,0,1510424
HepG2|chr11:16052463-16052575,chr11,16052463,16052575,HepG2|chr11:118887802-118887839,chr11,118887802,118887839,0,102835339
HepG2|chr11:16130769-16130796,chr11,16130769,16130796,HepG2|chr11:65081241-65081366,chr11,65081241,65081366,0,48950472
HepG2|chr11:16146054-16146157,chr11,16146054,16146157,HepG2|chr11:126225336-126225383,chr11,126225336,126225383,0,110079282
HepG2|chr11:16270458-16270567,chr11,16270458,16270567,HepG2|chr11:65081241-65081276,chr11,65081241,65081276,0,48810783
HepG2|chr11:16442563-16442621,chr11,16442563,16442621,HepG2|chr11:126225336-126225385,chr11,126225336,126225385,0,109782773
HepG2|chr11:16644978-16645041,chr11,16644978,16645041,HepG2|chr11:126225336-126225355,chr11,126225336,126225355,0,109580358
HepG2|chr11:16946931-16947046,chr11,16946931,16947046,HepG2|chr11:126225336-126225391,chr11,126225336,126225391,0,109278405
HepG2|chr11:16950744-16950782,chr11,16950744,16950782,HepG2|chr11:528204-528354,chr11,528204,528354,0,16422540
HepG2|chr11:17214415-17214493,chr11,17214415,17214493,HepG2|chr11:66679838-66679964,chr11,66679838,66679964,0,49465423
HepG2|chr11:17323363-17323416,chr11,17323363,17323416,HepG2|chr11:65081245-65081285,chr11,65081245,65081285,0,47757882
HepG2|chr11:17443894-17443913,chr11,17443894,17443913,HepG2|chr11:65080963-65081061,chr11,65080963,65081061,0,47637069
HepG2|chr11:17739936-17739954,chr11,17739936,17739954,HepG2|chr11:3878239-3878320,chr11,3878239,3878320,0,13861697
HepG2|chr11:17755577-17755600,chr11,17755577,17755600,HepG2|chr11:65081241-65081281,chr11,65081241,65081281,0,47325664
HepG2|chr11:18012784-18012804,chr11,18012784,18012804,HepG2|chr11:65081267-65081417,chr11,65081267,65081417,0,47068483
HepG2|chr11:18088341-18088382,chr11,18088341,18088382,HepG2|chr11:65313280-65313428,chr11,65313280,65313428,0,47224939
HepG2|chr11:18858243-18858262,chr11,18858243,18858262,HepG2|chr11:111637488-111637592,chr11,111637488,111637592,0,92779245
HepG2|chr11:19181977-19182018,chr11,19181977,19182018,HepG2|chr11:528198-528343,chr11,528198,528343,0,18653779
HepG2|chr11:19270201-19270299,chr11,19270201,19270299,HepG2|chr11:126224854-126224921,chr11,126224854,126224921,0,106954653
HepG2|chr11:19299444-19299549,chr11,19299444,19299549,HepG2|chr11:17298712-17298734,chr11,17298712,17298734,0,2000732
HepG2|chr11:19334633-19334759,chr11,19334633,19334759,HepG2|chr11:510967-511037,chr11,510967,511037,0,18823666
HepG2|chr11:19698465-19698611,chr11,19698465,19698611,HepG2|chr11:65081078-65081099,chr11,65081078,65081099,0,45382613
HepG2|chr11:19784721-19784773,chr11,19784721,19784773,HepG2|chr11:126225336-126225434,chr11,126225336,126225434,0,106440615
HepG2|chr11:19795961-19796027,chr11,19795961,19796027,HepG2|chr11:67155005-67155022,chr11,67155005,67155022,0,47359044
HepG2|chr11:19905075-19905106,chr11,19905075,19905106,HepG2|chr11:126224392-126224475,chr11,126224392,126224475,0,106319317
HepG2|chr11:19989328-19989359,chr11,19989328,19989359,HepG2|chr11:78128564-78128606,chr11,78128564,78128606,0,58139236
HepG2|chr11:20033357-20033406,chr11,20033357,20033406,HepG2|chr11:65081814-65081915,chr11,65081814,65081915,0,45048457
HepG2|chr11:20132143-20132185,chr11,20132143,20132185,HepG2|chr11:118789405-118789440,chr11,118789405,118789440,0,98657262
HepG2|chr11:20171071-20171090,chr11,20171071,20171090,HepG2|chr11:111637488-111637592,chr11,111637488,111637592,0,91466417
HepG2|chr11:20410639-20410694,chr11,20410639,20410694,HepG2|chr11:126220950-126221007,chr11,126220950,126221007,0,105810311
HepG2|chr11:20835439-20835587,chr11,20835439,20835587,HepG2|chr11:126224907-126225008,chr11,126224907,126225008,0,105389468
HepG2|chr11:20857572-20857647,chr11,20857572,20857647,HepG2|chr11:808030-808105,chr11,808030,808105,0,20049542
HepG2|chr11:20914230-20914322,chr11,20914230,20914322,HepG2|chr11:65078079-65078177,chr11,65078079,65078177,0,44163849
HepG2|chr11:21208423-21208573,chr11,21208423,21208573,HepG2|chr11:68227596-68227627,chr11,68227596,68227627,0,47019173
HepG2|chr11:21535431-21535506,chr11,21535431,21535506,HepG2|chr11:65313538-65313586,chr11,65313538,65313586,0,43778107
HepG2|chr11:21665114-21665153,chr11,21665114,21665153,HepG2|chr11:3877643-3877754,chr11,3877643,3877754,0,17787471
HepG2|chr11:22077424-22077555,chr11,22077424,22077555,HepG2|chr11:65375050-65375069,chr11,65375050,65375069,0,43297626
HepG2|chr11:22240209-22240239,chr11,22240209,22240239,HepG2|chr11:65382052-65382158,chr11,65382052,65382158,0,43141843
HepG2|chr11:22242793-22242885,chr11,22242793,22242885,HepG2|chr11:3878914-3878971,chr11,3878914,3878971,0,18363879
HepG2|chr11:22362891-22362962,chr11,22362891,22362962,HepG2|chr11:126225336-126225415,chr11,126225336,126225415,0,103862445
HepG2|chr11:22404390-22404438,chr11,22404390,22404438,HepG2|chr11:126225336-126225418,chr11,126225336,126225418,0,103820946
HepG2|chr11:22445185-22445217,chr11,22445185,22445217,HepG2|chr11:65081241-65081340,chr11,65081241,65081340,0,42636056
HepG2|chr11:22477690-22477749,chr11,22477690,22477749,HepG2|chr11:528198-528343,chr11,528198,528343,0,21949492
HepG2|chr11:22623428-22623510,chr11,22623428,22623510,HepG2|chr11:65081241-65081320,chr11,65081241,65081320,0,42457813
HepG2|chr11:23102997-23103076,chr11,23102997,23103076,HepG2|chr11:631368-631456,chr11,631368,631456,0,22471629
HepG2|chr11:23187510-23187540,chr11,23187510,23187540,HepG2|chr11:126224450-126224563,chr11,126224450,126224563,0,103036940
HepG2|chr11:23264375-23264493,chr11,23264375,23264493,HepG2|chr11:65081241-65081345,chr11,65081241,65081345,0,41816866
HepG2|chr11:23272577-23272622,chr11,23272577,23272622,HepG2|chr11:126224907-126225008,chr11,126224907,126225008,0,102952330
HepG2|chr11:23315368-23315388,chr11,23315368,23315388,HepG2|chr11:65081267-65081417,chr11,65081267,65081417,0,41765899
HepG2|chr11:23350611-23350718,chr11,23350611,23350718,HepG2|chr11:3081335-3081485,chr11,3081335,3081485,0,20269276
HepG2|chr11:23818523-23818564,chr11,23818523,23818564,HepG2|chr11:65081258-65081408,chr11,65081258,65081408,0,41262735
HepG2|chr11:23944478-23944598,chr11,23944478,23944598,HepG2|chr11:126225336-126225397,chr11,126225336,126225397,0,102280858
HepG2|chr11:23951067-23951196,chr11,23951067,23951196,HepG2|chr11:65375366-65375386,chr11,65375366,65375386,0,41424299
HepG2|chr11:24014858-24014896,chr11,24014858,24014896,HepG2|chr11:126225336-126225448,chr11,126225336,126225448,0,102210478
HepG2|chr11:24261399-24261546,chr11,24261399,24261546,HepG2|chr11:65081241-65081308,chr11,65081241,65081308,0,40819842
HepG2|chr11:24322855-24322935,chr11,24322855,24322935,HepG2|chr11:105893659-105893725,chr11,105893659,105893725,0,81570804
HepG2|chr11:24613789-24613849,chr11,24613789,24613849,HepG2|chr11:126225336-126225387,chr11,126225336,126225387,0,101611547
HepG2|chr11:24727043-24727173,chr11,24727043,24727173,HepG2|chr11:126225336-126225357,chr11,126225336,126225357,0,101498293
HepG2|chr11:24733675-24733698,chr11,24733675,24733698,HepG2|chr11:63540585-63540675,chr11,63540585,63540675,0,38806910
HepG2|chr11:25026949-25027043,chr11,25026949,25027043,HepG2|chr11:126225387-126225443,chr11,126225387,126225443,0,101198438
HepG2|chr11:25260580-25260618,chr11,25260580,25260618,HepG2|chr11:65081248-65081398,chr11,65081248,65081398,0,39820668
HepG2|chr11:25468935-25468981,chr11,25468935,25468981,HepG2|chr11:126225336-126225355,chr11,126225336,126225355,0,100756401
HepG2|chr11:25529753-25529866,chr11,25529753,25529866,HepG2|chr11:126222137-126222177,chr11,126222137,126222177,0,100692384
HepG2|chr11:25615614-25615754,chr11,25615614,25615754,HepG2|chr11:64848724-64848874,chr11,64848724,64848874,0,39233110
HepG2|chr11:25715514-25715552,chr11,25715514,25715552,HepG2|chr11:65081248-65081398,chr11,65081248,65081398,0,39365734
HepG2|chr11:25780103-25780183,chr11,25780103,25780183,HepG2|chr11:65081241-65081264,chr11,65081241,65081264,0,39301138
HepG2|chr11:26026500-26026558,chr11,26026500,26026558,HepG2|chr11:65220667-65220778,chr11,65220667,65220778,0,39194167
HepG2|chr11:26059373-26059414,chr11,26059373,26059414,HepG2|chr11:65081258-65081408,chr11,65081258,65081408,0,39021885
HepG2|chr11:26231447-26231503,chr11,26231447,26231503,HepG2|chr11:65079759-65079853,chr11,65079759,65079853,0,38848312
HepG2|chr11:26252361-26252405,chr11,26252361,26252405,HepG2|chr11:62493498-62493604,chr11,62493498,62493604,0,36241137
HepG2|chr11:26382410-26382524,chr11,26382410,26382524,HepG2|chr11:65081241-65081274,chr11,65081241,65081274,0,38698831
HepG2|chr11:26502969-26503056,chr11,26502969,26503056,HepG2|chr11:102180615-102180677,chr11,102180615,102180677,0,75677646
HepG2|chr11:26584532-26584586,chr11,26584532,26584586,HepG2|chr11:126225336-126225432,chr11,126225336,126225432,0,99640804
HepG2|chr11:26677125-26677247,chr11,26677125,26677247,HepG2|chr11:65081241-65081304,chr11,65081241,65081304,0,38404116
HepG2|chr11:26786322-26786469,chr11,26786322,26786469,HepG2|chr11:126225364-126225430,chr11,126225364,126225430,0,99439042
HepG2|chr11:27172979-27173108,chr11,27172979,27173108,HepG2|chr11:528158-528192,chr11,528158,528192,0,26644821
HepG2|chr11:27706685-27706707,chr11,27706685,27706707,HepG2|chr11:65081393-65081543,chr11,65081393,65081543,0,37374708
HepG2|chr11:27750215-27750350,chr11,27750215,27750350,HepG2|chr11:65079563-65079602,chr11,65079563,65079602,0,37329348
HepG2|chr11:27894966-27895097,chr11,27894966,27895097,HepG2|chr11:65375050-65375069,chr11,65375050,65375069,0,37480084
HepG2|chr11:28588551-28588639,chr11,28588551,28588639,HepG2|chr11:67155005-67155022,chr11,67155005,67155022,0,38566454
HepG2|chr11:28646739-28646816,chr11,28646739,28646816,HepG2|chr11:3878793-3878881,chr11,3878793,3878881,0,24767946
HepG2|chr11:28661216-28661366,chr11,28661216,28661366,HepG2|chr11:126224648-126224763,chr11,126224648,126224763,0,97563432
HepG2|chr11:28689472-28689531,chr11,28689472,28689531,HepG2|chr11:63540585-63540675,chr11,63540585,63540675,0,34851113
HepG2|chr11:28806212-28806231,chr11,28806212,28806231,HepG2|chr11:3878239-3878320,chr11,3878239,3878320,0,24927973
HepG2|chr11:28812078-28812228,chr11,28812078,28812228,HepG2|chr11:126224907-126225008,chr11,126224907,126225008,0,97412829
HepG2|chr11:28829510-28829546,chr11,28829510,28829546,HepG2|chr11:126225336-126225443,chr11,126225336,126225443,0,97395826
HepG2|chr11:28852801-28852951,chr11,28852801,28852951,HepG2|chr11:65081241-65081275,chr11,65081241,65081275,0,36228440
HepG2|chr11:28960696-28960738,chr11,28960696,28960738,HepG2|chr11:65081241-65081347,chr11,65081241,65081347,0,36120545
HepG2|chr11:29296785-29296819,chr11,29296785,29296819,HepG2|chr11:65081814-65081903,chr11,65081814,65081903,0,35785029
HepG2|chr11:29445195-29445275,chr11,29445195,29445275,HepG2|chr11:808036-808106,chr11,808036,808106,0,28637159
HepG2|chr11:29839292-29839375,chr11,29839292,29839375,HepG2|chr11:528205-528352,chr11,528205,528352,0,29311087
HepG2|chr11:30058112-30058167,chr11,30058112,30058167,HepG2|chr11:126220950-126221007,chr11,126220950,126221007,0,96162838
HepG2|chr11:30065352-30065440,chr11,30065352,30065440,HepG2|chr11:126225336-126225398,chr11,126225336,126225398,0,96159984
HepG2|chr11:30072774-30072924,chr11,30072774,30072924,HepG2|chr11:124609489-124609638,chr11,124609489,124609638,0,94536715
HepG2|chr11:30228083-30228129,chr11,30228083,30228129,HepG2|chr11:62493518-62493604,chr11,62493518,62493604,0,32265435
HepG2|chr11:30303049-30303199,chr11,30303049,30303199,HepG2|chr11:65081241-65081324,chr11,65081241,65081324,0,34778192
HepG2|chr11:30444815-30444837,chr11,30444815,30444837,HepG2|chr11:65081393-65081543,chr11,65081393,65081543,0,34636578
HepG2|chr11:30495008-30495158,chr11,30495008,30495158,HepG2|chr11:82781221-82781371,chr11,82781221,82781371,0,52286213
HepG2|chr11:30538842-30538906,chr11,30538842,30538906,HepG2|chr11:126225336-126225355,chr11,126225336,126225355,0,95686494
HepG2|chr11:30703781-30703822,chr11,30703781,30703822,HepG2|chr11:65342331-65342479,chr11,65342331,65342479,0,34638550
HepG2|chr11:30879615-30879651,chr11,30879615,30879651,HepG2|chr11:102218611-102218700,chr11,102218611,102218700,0,71338996
HepG2|chr11:30922549-30922672,chr11,30922549,30922672,HepG2|chr11:65081241-65081264,chr11,65081241,65081264,0,34158692
HepG2|chr11:31186759-31186882,chr11,31186759,31186882,HepG2|chr11:126225336-126225363,chr11,126225336,126225363,0,95038577
HepG2|chr11:31339325-31339468,chr11,31339325,31339468,HepG2|chr11:65081241-65081296,chr11,65081241,65081296,0,33741916
HepG2|chr11:31356041-31356150,chr11,31356041,31356150,HepG2|chr11:3879331-3879372,chr11,3879331,3879372,0,27476710
HepG2|chr11:31396210-31396294,chr11,31396210,31396294,HepG2|chr11:14520564-14520587,chr11,14520564,14520587,0,16875646
HepG2|chr11:31636299-31636428,chr11,31636299,31636428,HepG2|chr11:102218855-102218875,chr11,102218855,102218875,0,70582556
HepG2|chr11:31769695-31769747,chr11,31769695,31769747,HepG2|chr11:65078079-65078177,chr11,65078079,65078177,0,33308384
HepG2|chr11:31800850-31800916,chr11,31800850,31800916,HepG2|chr11:65079759-65079853,chr11,65079759,65079853,0,33278909
HepG2|chr11:31900509-31900622,chr11,31900509,31900622,HepG2|chr11:65081237-65081272,chr11,65081237,65081272,0,33180728
HepG2|chr11:31926249-31926399,chr11,31926249,31926399,HepG2|chr11:68227596-68227627,chr11,68227596,68227627,0,36301347
HepG2|chr11:32482293-32482374,chr11,32482293,32482374,HepG2|chr11:65081237-65081306,chr11,65081237,65081306,0,32598944
HepG2|chr11:32621704-32621798,chr11,32621704,32621798,HepG2|chr11:126225336-126225422,chr11,126225336,126225422,0,93603632
HepG2|chr11:32681744-32681841,chr11,32681744,32681841,HepG2|chr11:126225336-126225389,chr11,126225336,126225389,0,93543592
HepG2|chr11:32774330-32774461,chr11,32774330,32774461,HepG2|chr11:126225336-126225391,chr11,126225336,126225391,0,93451006
HepG2|chr11:32958931-32959049,chr11,32958931,32959049,HepG2|chr11:78127291-78127440,chr11,78127291,78127440,0,45168360
HepG2|chr11:33082274-33082292,chr11,33082274,33082292,HepG2|chr11:65081237-65081260,chr11,65081237,65081260,0,31998963
HepG2|chr11:33269946-33270096,chr11,33269946,33270096,HepG2|chr11:14520564-14520587,chr11,14520564,14520587,0,18749382
HepG2|chr11:33492393-33492432,chr11,33492393,33492432,HepG2|chr11:3877643-3877754,chr11,3877643,3877754,0,29614750
HepG2|chr11:33766498-33766600,chr11,33766498,33766600,HepG2|chr11:17097793-17097820,chr11,17097793,17097820,0,16668705
HepG2|chr11:33796080-33796098,chr11,33796080,33796098,HepG2|chr11:65081237-65081260,chr11,65081237,65081260,0,31285157
HepG2|chr11:33820638-33820732,chr11,33820638,33820732,HepG2|chr11:126225387-126225443,chr11,126225387,126225443,0,92404749
HepG2|chr11:33923288-33923313,chr11,33923288,33923313,HepG2|chr11:3861052-3861202,chr11,3861052,3861202,0,30062236
HepG2|chr11:33982233-33982328,chr11,33982233,33982328,HepG2|chr11:126225336-126225391,chr11,126225336,126225391,0,92243103
HepG2|chr11:34003822-34003916,chr11,34003822,34003916,HepG2|chr11:631372-631456,chr11,631372,631456,0,33372450
HepG2|chr11:34298902-34299004,chr11,34298902,34299004,HepG2|chr11:65081241-65081272,chr11,65081241,65081272,0,30782339
HepG2|chr11:34378741-34378815,chr11,34378741,34378815,HepG2|chr11:65081970-65082047,chr11,65081970,65082047,0,30703229
HepG2|chr11:34394639-34394661,chr11,34394639,34394661,HepG2|chr11:65082529-65082657,chr11,65082529,65082657,0,30687890
HepG2|chr11:34415967-34416009,chr11,34415967,34416009,HepG2|chr11:528158-528266,chr11,528158,528266,0,33887809
HepG2|chr11:34418460-34418610,chr11,34418460,34418610,HepG2|chr11:126225336-126225396,chr11,126225336,126225396,0,91806876
HepG2|chr11:34711327-34711457,chr11,34711327,34711457,HepG2|chr11:102218855-102218875,chr11,102218855,102218875,0,67507528
HepG2|chr11:34902268-34902337,chr11,34902268,34902337,HepG2|chr11:528215-528365,chr11,528215,528365,0,34374053
HepG2|chr11:35247267-35247303,chr11,35247267,35247303,HepG2|chr11:102218611-102218700,chr11,102218611,102218700,0,66971344
HepG2|chr11:35253748-35253874,chr11,35253748,35253874,HepG2|chr11:126225336-126225357,chr11,126225336,126225357,0,90971588
HepG2|chr11:35374070-35374220,chr11,35374070,35374220,HepG2|chr11:65317728-65317793,chr11,65317728,65317793,0,29943658
HepG2|chr11:35693874-35693897,chr11,35693874,35693897,HepG2|chr11:65081241-65081294,chr11,65081241,65081294,0,29387367
HepG2|chr11:35710767-35710875,chr11,35710767,35710875,HepG2|chr11:126225388-126225430,chr11,126225388,126225430,0,90514621
HepG2|chr11:35884844-35884994,chr11,35884844,35884994,HepG2|chr11:65081241-65081275,chr11,65081241,65081275,0,29196397
HepG2|chr11:35892003-35892146,chr11,35892003,35892146,HepG2|chr11:803602-803647,chr11,803602,803647,0,35088401
HepG2|chr11:35954817-35954917,chr11,35954817,35954917,HepG2|chr11:14520564-14520587,chr11,14520564,14520587,0,21434253
HepG2|chr11:36200873-36200950,chr11,36200873,36200950,HepG2|chr11:93395761-93395798,chr11,93395761,93395798,0,57194888
HepG2|chr11:36279138-36279217,chr11,36279138,36279217,HepG2|chr11:65218182-65218285,chr11,65218182,65218285,0,28939044
HepG2|chr11:36346181-36346274,chr11,36346181,36346274,HepG2|chr11:126225336-126225393,chr11,126225336,126225393,0,89879155
HepG2|chr11:36428660-36428767,chr11,36428660,36428767,HepG2|chr11:126224676-126224730,chr11,126224676,126224730,0,89796016
HepG2|chr11:36454553-36454649,chr11,36454553,36454649,HepG2|chr11:126224676-126224730,chr11,126224676,126224730,0,89770123
HepG2|chr11:36591384-36591531,chr11,36591384,36591531,HepG2|chr11:67155005-67155047,chr11,67155005,67155047,0,30563621
HepG2|chr11:36694693-36694721,chr11,36694693,36694721,HepG2|chr11:112832967-112832987,chr11,112832967,112832987,0,76138274
HepG2|chr11:36714250-36714379,chr11,36714250,36714379,HepG2|chr11:94770505-94770523,chr11,94770505,94770523,0,58056255
HepG2|chr11:36904186-36904314,chr11,36904186,36904314,HepG2|chr11:65081814-65081841,chr11,65081814,65081841,0,28177628
HepG2|chr11:36985403-36985441,chr11,36985403,36985441,HepG2|chr11:528204-528354,chr11,528204,528354,0,36457199
HepG2|chr11:37141065-37141204,chr11,37141065,37141204,HepG2|chr11:64848724-64848874,chr11,64848724,64848874,0,27707659
HepG2|chr11:37217128-37217151,chr11,37217128,37217151,HepG2|chr11:65081241-65081294,chr11,65081241,65081294,0,27864113
HepG2|chr11:37706764-37706856,chr11,37706764,37706856,HepG2|chr11:3878688-3878809,chr11,3878688,3878809,0,33828076
HepG2|chr11:37787195-37787317,chr11,37787195,37787317,HepG2|chr11:126225387-126225415,chr11,126225387,126225415,0,88438192
HepG2|chr11:37952100-37952136,chr11,37952100,37952136,HepG2|chr11:126225389-126225435,chr11,126225389,126225435,0,88273289
HepG2|chr11:38272406-38272461,chr11,38272406,38272461,HepG2|chr11:126225336-126225420,chr11,126225336,126225420,0,87952930
HepG2|chr11:38449084-38449118,chr11,38449084,38449118,HepG2|chr11:74695747-74695841,chr11,74695747,74695841,0,36246663
HepG2|chr11:38729394-38729544,chr11,38729394,38729544,HepG2|chr11:67155005-67155029,chr11,67155005,67155029,0,28425611
HepG2|chr11:38751740-38751890,chr11,38751740,38751890,HepG2|chr11:65081237-65081276,chr11,65081237,65081276,0,26329497
HepG2|chr11:38760604-38760754,chr11,38760604,38760754,HepG2|chr11:124609489-124609638,chr11,124609489,124609638,0,85848885
HepG2|chr11:38864428-38864501,chr11,38864428,38864501,HepG2|chr11:65081237-65081285,chr11,65081237,65081285,0,26216809
HepG2|chr11:39177148-39177179,chr11,39177148,39177179,HepG2|chr11:117167966-117168066,chr11,117167966,117168066,0,77990818
HepG2|chr11:39452553-39452659,chr11,39452553,39452659,HepG2|chr11:126225336-126225377,chr11,126225336,126225377,0,86772783
HepG2|chr11:39491389-39491448,chr11,39491389,39491448,HepG2|chr11:528198-528343,chr11,528198,528343,0,38963191
HepG2|chr11:39522318-39522445,chr11,39522318,39522445,HepG2|chr11:67155005-67155030,chr11,67155005,67155030,0,27632687
HepG2|chr11:39525675-39525710,chr11,39525675,39525710,HepG2|chr11:126225336-126225446,chr11,126225336,126225446,0,86699661
HepG2|chr11:39600582-39600603,chr11,39600582,39600603,HepG2|chr11:65081278-65081424,chr11,65081278,65081424,0,25480696
HepG2|chr11:39735329-39735372,chr11,39735329,39735372,HepG2|chr11:126224907-126225008,chr11,126224907,126225008,0,86489578
HepG2|chr11:39739502-39739620,chr11,39739502,39739620,HepG2|chr11:126225336-126225368,chr11,126225336,126225368,0,86485834
HepG2|chr11:39798392-39798482,chr11,39798392,39798482,HepG2|chr11:65376905-65376949,chr11,65376905,65376949,0,25578513
HepG2|chr11:39903821-39903930,chr11,39903821,39903930,HepG2|chr11:65081241-65081276,chr11,65081241,65081276,0,25177420
HepG2|chr11:39933613-39933763,chr11,39933613,39933763,HepG2|chr11:67155005-67155029,chr11,67155005,67155029,0,27221392
HepG2|chr11:40120449-40120599,chr11,40120449,40120599,HepG2|chr11:17093062-17093131,chr11,17093062,17093131,0,23027387
HepG2|chr11:40263499-40263592,chr11,40263499,40263592,HepG2|chr11:73586324-73586378,chr11,73586324,73586378,0,33322825
HepG2|chr11:40286944-40287091,chr11,40286944,40287091,HepG2|chr11:65081237-65081272,chr11,65081237,65081272,0,24794293
HepG2|chr11:40635631-40635710,chr11,40635631,40635710,HepG2|chr11:631368-631456,chr11,631368,631456,0,40004263
HepG2|chr11:40902416-40902555,chr11,40902416,40902555,HepG2|chr11:67375137-67375279,chr11,67375137,67375279,0,26472721
HepG2|chr11:41457490-41457596,chr11,41457490,41457596,HepG2|chr11:126225337-126225377,chr11,126225337,126225377,0,84767847
HepG2|chr11:41683651-41683801,chr11,41683651,41683801,HepG2|chr11:117103965-117103993,chr11,117103965,117103993,0,75420314
HepG2|chr11:41780249-41780328,chr11,41780249,41780328,HepG2|chr11:65218182-65218285,chr11,65218182,65218285,0,23437933
HepG2|chr11:41879191-41879212,chr11,41879191,41879212,HepG2|chr11:67375410-67375535,chr11,67375410,67375535,0,25496219
HepG2|chr11:41987364-41987476,chr11,41987364,41987476,HepG2|chr11:93396107-93396170,chr11,93396107,93396170,0,51408743
HepG2|chr11:42054935-42055001,chr11,42054935,42055001,HepG2|chr11:65080956-65080999,chr11,65080956,65080999,0,23026021
HepG2|chr11:42112585-42112649,chr11,42112585,42112649,HepG2|chr11:790424-790516,chr11,790424,790516,0,41322161
HepG2|chr11:42262353-42262391,chr11,42262353,42262391,HepG2|chr11:118780468-118780615,chr11,118780468,118780615,0,76518115
HepG2|chr11:42453456-42453578,chr11,42453456,42453578,HepG2|chr11:65294924-65294952,chr11,65294924,65294952,0,22841468
HepG2|chr11:42478181-42478213,chr11,42478181,42478213,HepG2|chr11:65081241-65081340,chr11,65081241,65081340,0,22603060
HepG2|chr11:42521645-42521691,chr11,42521645,42521691,HepG2|chr11:126225336-126225427,chr11,126225336,126225427,0,83703691
HepG2|chr11:42653726-42653815,chr11,42653726,42653815,HepG2|chr11:126225336-126225397,chr11,126225336,126225397,0,83571610
HepG2|chr11:42680654-42680804,chr11,42680654,42680804,HepG2|chr11:9407778-9407888,chr11,9407778,9407888,0,33272876
HepG2|chr11:42779721-42779755,chr11,42779721,42779755,HepG2|chr11:65081814-65081903,chr11,65081814,65081903,0,22302093
HepG2|chr11:43043738-43043824,chr11,43043738,43043824,HepG2|chr11:65384135-65384199,chr11,65384135,65384199,0,22340397
HepG2|chr11:43188809-43188842,chr11,43188809,43188842,HepG2|chr11:65081241-65081366,chr11,65081241,65081366,0,21892432
HepG2|chr11:43236728-43236763,chr11,43236728,43236763,HepG2|chr11:65082529-65082657,chr11,65082529,65082657,0,21845801
HepG2|chr11:43305834-43305928,chr11,43305834,43305928,HepG2|chr11:65081263-65081318,chr11,65081263,65081318,0,21775429
HepG2|chr11:43523340-43523490,chr11,43523340,43523490,HepG2|chr11:73586324-73586378,chr11,73586324,73586378,0,30062984
HepG2|chr11:43795659-43795705,chr11,43795659,43795705,HepG2|chr11:62341694-62341779,chr11,62341694,62341779,0,18546035
HepG2|chr11:43972003-43972036,chr11,43972003,43972036,HepG2|chr11:65080885-65080999,chr11,65080885,65080999,0,21108882
HepG2|chr11:44137987-44138098,chr11,44137987,44138098,HepG2|chr11:65081241-65081319,chr11,65081241,65081319,0,20943254
HepG2|chr11:44349669-44349725,chr11,44349669,44349725,HepG2|chr11:126225336-126225396,chr11,126225336,126225396,0,81875667
HepG2|chr11:44578593-44578738,chr11,44578593,44578738,HepG2|chr11:65081241-65081276,chr11,65081241,65081276,0,20502648
HepG2|chr11:44732518-44732575,chr11,44732518,44732575,HepG2|chr11:66673181-66673271,chr11,66673181,66673271,0,21940663
HepG2|chr11:44781274-44781370,chr11,44781274,44781370,HepG2|chr11:73703906-73703952,chr11,73703906,73703952,0,28922632
HepG2|chr11:44910308-44910421,chr11,44910308,44910421,HepG2|chr11:118887802-118887839,chr11,118887802,118887839,0,73977494
HepG2|chr11:45284994-45285080,chr11,45284994,45285080,HepG2|chr11:65384135-65384199,chr11,65384135,65384199,0,20099141
HepG2|chr11:45406822-45406869,chr11,45406822,45406869,HepG2|chr11:3081424-3081564,chr11,3081424,3081564,0,42325398
HepG2|chr11:45413693-45413747,chr11,45413693,45413747,HepG2|chr11:790423-790516,chr11,790423,790516,0,44623270
HepG2|chr11:45509626-45509756,chr11,45509626,45509756,HepG2|chr11:126225337-126225397,chr11,126225337,126225397,0,80715711
HepG2|chr11:46093810-46093929,chr11,46093810,46093929,HepG2|chr11:117103965-117103993,chr11,117103965,117103993,0,71010155
HepG2|chr11:46454517-46454584,chr11,46454517,46454584,HepG2|chr11:76497986-76498069,chr11,76497986,76498069,0,30043469
HepG2|chr11:46922484-46922632,chr11,46922484,46922632,HepG2|chr11:65081836-65081945,chr11,65081836,65081945,0,18159352
HepG2|chr11:46932293-46932423,chr11,46932293,46932423,HepG2|chr11:65375366-65375386,chr11,65375366,65375386,0,18443073
HepG2|chr11:46990861-46990915,chr11,46990861,46990915,HepG2|chr11:65081241-65081337,chr11,65081241,65081337,0,18090380
HepG2|chr11:46995171-46995269,chr11,46995171,46995269,HepG2|chr11:126224854-126224921,chr11,126224854,126224921,0,79229683
HepG2|chr11:47018846-47018982,chr11,47018846,47018982,HepG2|chr11:126225336-126225355,chr11,126225336,126225355,0,79206490
HepG2|chr11:47106328-47106352,chr11,47106328,47106352,HepG2|chr11:3861052-3861202,chr11,3861052,3861202,0,43245276
HepG2|chr11:47304251-47304291,chr11,47304251,47304291,HepG2|chr11:126225336-126225446,chr11,126225336,126225446,0,78921085
HepG2|chr11:47418342-47418434,chr11,47418342,47418434,HepG2|chr11:65081261-65081378,chr11,65081261,65081378,0,17662919
HepG2|chr11:47443454-47443555,chr11,47443454,47443555,HepG2|chr11:118959037-118959082,chr11,118959037,118959082,0,71515583
HepG2|chr11:47514079-47514175,chr11,47514079,47514175,HepG2|chr11:65081237-65081285,chr11,65081237,65081285,0,17567158
HepG2|chr11:47901792-47901923,chr11,47901792,47901923,HepG2|chr11:126225336-126225363,chr11,126225336,126225363,0,78323544
HepG2|chr11:48225906-48225969,chr11,48225906,48225969,HepG2|chr11:117171622-117171683,chr11,117171622,117171683,0,68945716
HepG2|chr11:48453989-48454022,chr11,48453989,48454022,HepG2|chr11:65081241-65081366,chr11,65081241,65081366,0,16627252
HepG2|chr11:48526773-48526874,chr11,48526773,48526874,HepG2|chr11:17097793-17097820,chr11,17097793,17097820,0,31428980
HepG2|chr11:48584865-48584981,chr11,48584865,48584981,HepG2|chr11:65146410-65146444,chr11,65146410,65146444,0,16561545
HepG2|chr11:49037489-49037616,chr11,49037489,49037616,HepG2|chr11:59580569-59580592,chr11,59580569,59580592,0,10543080
HepG2|chr11:49140075-49140128,chr11,49140075,49140128,HepG2|chr11:126225336-126225420,chr11,126225336,126225420,0,77085261
HepG2|chr11:49357156-49357206,chr11,49357156,49357206,HepG2|chr11:126225303-126225415,chr11,126225303,126225415,0,76868147
HepG2|chr11:49360989-49361106,chr11,49360989,49361106,HepG2|chr11:526956-526977,chr11,526956,526977,0,48834033
HepG2|chr11:49476355-49476480,chr11,49476355,49476480,HepG2|chr11:126225336-126225356,chr11,126225336,126225356,0,76748981
HepG2|chr11:50001514-50001664,chr11,50001514,50001664,HepG2|chr11:65081241-65081364,chr11,65081241,65081364,0,15079727
HepG2|chr11:50079819-50079924,chr11,50079819,50079924,HepG2|chr11:65081241-65081264,chr11,65081241,65081264,0,15001422
HepG2|chr11:50185344-50185442,chr11,50185344,50185442,HepG2|chr11:126225336-126225369,chr11,126225336,126225369,0,76039992
HepG2|chr11:50366710-50366820,chr11,50366710,50366820,HepG2|chr11:126225336-126225357,chr11,126225336,126225357,0,75858626
HepG2|chr11:50477963-50478113,chr11,50477963,50478113,HepG2|chr11:111637519-111637592,chr11,111637519,111637592,0,61159556
HepG2|chr11:50528236-50528370,chr11,50528236,50528370,HepG2|chr11:67155005-67155117,chr11,67155005,67155117,0,16626769
HepG2|chr11:50567153-50567238,chr11,50567153,50567238,HepG2|chr11:74696291-74696356,chr11,74696291,74696356,0,24129138
HepG2|chr11:50695545-50695625,chr11,50695545,50695625,HepG2|chr11:3877643-3877754,chr11,3877643,3877754,0,46817902
HepG2|chr11:50743607-50743749,chr11,50743607,50743749,HepG2|chr11:59580562-59580595,chr11,59580562,59580595,0,8836955
HepG2|chr11:50748990-50749089,chr11,50748990,50749089,HepG2|chr11:65342052-65342073,chr11,65342052,65342073,0,14593062
HepG2|chr11:50843643-50843775,chr11,50843643,50843775,HepG2|chr11:126225336-126225374,chr11,126225336,126225374,0,75381693
HepG2|chr11:50950534-50950636,chr11,50950534,50950636,HepG2|chr11:17097793-17097820,chr11,17097793,17097820,0,33852741
HepG2|chr11:51029860-51029898,chr11,51029860,51029898,HepG2|chr11:65153440-65153540,chr11,65153440,65153540,0,14123580
HepG2|chr11:51149884-51149964,chr11,51149884,51149964,HepG2|chr11:105893659-105893725,chr11,105893659,105893725,0,54743775
HepG2|chr11:51158776-51158926,chr11,51158776,51158926,HepG2|chr11:126225336-126225396,chr11,126225336,126225396,0,75066560
HepG2|chr11:51290416-51290469,chr11,51290416,51290469,HepG2|chr11:65084948-65084990,chr11,65084948,65084990,0,13794532
HepG2|chr11:51315140-51315272,chr11,51315140,51315272,HepG2|chr11:126225336-126225374,chr11,126225336,126225374,0,74910196
HepG2|chr11:51512358-51512508,chr11,51512358,51512508,HepG2|chr11:65081256-65081406,chr11,65081256,65081406,0,13568898
HepG2|chr11:51679288-51679379,chr11,51679288,51679379,HepG2|chr11:126225336-126225395,chr11,126225336,126225395,0,74546048
HepG2|chr11:51696528-51696646,chr11,51696528,51696646,HepG2|chr11:65081241-65081345,chr11,65081241,65081345,0,13384713
HepG2|chr11:51882036-51882186,chr11,51882036,51882186,HepG2|chr11:82781221-82781371,chr11,82781221,82781371,0,30899185
HepG2|chr11:51913246-51913271,chr11,51913246,51913271,HepG2|chr11:66674891-66675026,chr11,66674891,66675026,0,14761645
HepG2|chr11:51944379-51944490,chr11,51944379,51944490,HepG2|chr11:112832967-112832987,chr11,112832967,112832987,0,60888588
HepG2|chr11:52050780-52050838,chr11,52050780,52050838,HepG2|chr11:65220667-65220778,chr11,65220667,65220778,0,13169887
HepG2|chr11:52109401-52109534,chr11,52109401,52109534,HepG2|chr11:65223224-65223241,chr11,65223224,65223241,0,13113823
HepG2|chr11:52139571-52139683,chr11,52139571,52139683,HepG2|chr11:126225336-126225374,chr11,126225336,126225374,0,74085765
HepG2|chr11:52162522-52162582,chr11,52162522,52162582,HepG2|chr11:126225336-126225387,chr11,126225336,126225387,0,74062814
HepG2|chr11:52433102-52433207,chr11,52433102,52433207,HepG2|chr11:65081241-65081264,chr11,65081241,65081264,0,12648139
HepG2|chr11:52718640-52718741,chr11,52718640,52718741,HepG2|chr11:118952875-118953021,chr11,118952875,118953021,0,66234235
HepG2|chr11:52792614-52792724,chr11,52792614,52792724,HepG2|chr11:65294807-65294847,chr11,65294807,65294847,0,12502193
HepG2|chr11:52804273-52804379,chr11,52804273,52804379,HepG2|chr11:68227603-68227647,chr11,68227603,68227647,0,15423330
HepG2|chr11:52890270-52890385,chr11,52890270,52890385,HepG2|chr11:59580562-59580592,chr11,59580562,59580592,0,6690292
HepG2|chr11:53155161-53155186,chr11,53155161,53155186,HepG2|chr11:66674891-66675026,chr11,66674891,66675026,0,13519730
HepG2|chr11:53262436-53262461,chr11,53262436,53262461,HepG2|chr11:3861052-3861202,chr11,3861052,3861202,0,49401384
HepG2|chr11:53323838-53323940,chr11,53323838,53323940,HepG2|chr11:102180609-102180749,chr11,102180609,102180749,0,48856771
HepG2|chr11:53498321-53498384,chr11,53498321,53498384,HepG2|chr11:65081237-65081324,chr11,65081237,65081324,0,11582916
HepG2|chr11:53774097-53774223,chr11,53774097,53774223,HepG2|chr11:510967-511037,chr11,510967,511037,0,53263130
HepG2|chr11:53781867-53782017,chr11,53781867,53782017,HepG2|chr11:67375410-67375535,chr11,67375410,67375535,0,13593543
HepG2|chr11:53840737-53840860,chr11,53840737,53840860,HepG2|chr11:65819321-65819339,chr11,65819321,65819339,0,11978584
HepG2|chr11:53933651-53933733,chr11,53933651,53933733,HepG2|chr11:810565-810632,chr11,810565,810632,0,53123086
HepG2|chr11:53962753-53962831,chr11,53962753,53962831,HepG2|chr11:65081970-65082021,chr11,65081970,65082021,0,11119217
HepG2|chr11:54114432-54114463,chr11,54114432,54114463,HepG2|chr11:65080963-65081061,chr11,65080963,65081061,0,10966531
HepG2|chr11:54121375-54121525,chr11,54121375,54121525,HepG2|chr11:117103965-117103993,chr11,117103965,117103993,0,62982590
HepG2|chr11:54160875-54160958,chr11,54160875,54160958,HepG2|chr11:66680143-66680161,chr11,66680143,66680161,0,12519268
HepG2|chr11:54418460-54418512,chr11,54418460,54418512,HepG2|chr11:126225336-126225434,chr11,126225336,126225434,0,71806876
HepG2|chr11:54426599-54426749,chr11,54426599,54426749,HepG2|chr11:107876951-107876968,chr11,107876951,107876968,0,53450352
HepG2|chr11:55082985-55083010,chr11,55082985,55083010,HepG2|chr11:65081241-65081366,chr11,65081241,65081366,0,9998256
HepG2|chr11:55375291-55375387,chr11,55375291,55375387,HepG2|chr11:126225336-126225415,chr11,126225336,126225415,0,70850045
HepG2|chr11:55442671-55442757,chr11,55442671,55442757,HepG2|chr11:94772611-94772666,chr11,94772611,94772666,0,39329940
HepG2|chr11:55444291-55444422,chr11,55444291,55444422,HepG2|chr11:3879331-3879372,chr11,3879331,3879372,0,51564960
HepG2|chr11:55646951-55647010,chr11,55646951,55647010,HepG2|chr11:63540585-63540675,chr11,63540585,63540675,0,7893634
HepG2|chr11:55654820-55654875,chr11,55654820,55654875,HepG2|chr11:65081241-65081332,chr11,65081241,65081332,0,9426421
HepG2|chr11:55753262-55753412,chr11,55753262,55753412,HepG2|chr11:126225336-126225442,chr11,126225336,126225442,0,70472074
HepG2|chr11:55850798-55850854,chr11,55850798,55850854,HepG2|chr11:63540585-63540675,chr11,63540585,63540675,0,7689787
HepG2|chr11:56092529-56092620,chr11,56092529,56092620,HepG2|chr11:94772611-94772666,chr11,94772611,94772666,0,38680082
HepG2|chr11:56488641-56488705,chr11,56488641,56488705,HepG2|chr11:790424-790516,chr11,790424,790516,0,55698217
HepG2|chr11:56521472-56521581,chr11,56521472,56521581,HepG2|chr11:93517976-93518094,chr11,93517976,93518094,0,36996504
HepG2|chr11:57307327-57307457,chr11,57307327,57307457,HepG2|chr11:102218855-102218875,chr11,102218855,102218875,0,44911528
HepG2|chr11:57697940-57698020,chr11,57697940,57698020,HepG2|chr11:65081241-65081308,chr11,65081241,65081308,0,7383301
HepG2|chr11:58177482-58177592,chr11,58177482,58177592,HepG2|chr11:126222137-126222177,chr11,126222137,126222177,0,68044655
HepG2|chr11:58877857-58877907,chr11,58877857,58877907,HepG2|chr11:65081241-65081327,chr11,65081241,65081327,0,6203384
HepG2|chr11:58903362-58903445,chr11,58903362,58903445,HepG2|chr11:810565-810632,chr11,810565,810632,0,58092797
HepG2|chr11:58985713-58985749,chr11,58985713,58985749,HepG2|chr11:67155005-67155030,chr11,67155005,67155030,0,8169292
HepG2|chr11:59057309-59057397,chr11,59057309,59057397,HepG2|chr11:3878914-3878971,chr11,3878914,3878971,0,55178395
HepG2|chr11:59319290-59319326,chr11,59319290,59319326,HepG2|chr11:74695747-74695841,chr11,74695747,74695841,0,15376457
HepG2|chr11:59324170-59324255,chr11,59324170,59324255,HepG2|chr11:65078301-65078325,chr11,65078301,65078325,0,5754131
HepG2|chr11:59524835-59524892,chr11,59524835,59524892,HepG2|chr11:126225336-126225398,chr11,126225336,126225398,0,66700501
HepG2|chr11:59647102-59647211,chr11,59647102,59647211,HepG2|chr11:3879331-3879372,chr11,3879331,3879372,0,55767771
HepG2|chr11:59769061-59769144,chr11,59769061,59769144,HepG2|chr11:810565-810632,chr11,810565,810632,0,58958496
HepG2|chr11:59787176-59787261,chr11,59787176,59787261,HepG2|chr11:67155005-67155135,chr11,67155005,67155135,0,7367829
HepG2|chr11:59935075-59935162,chr11,59935075,59935162,HepG2|chr11:102180615-102180677,chr11,102180615,102180677,0,42245540
HepG2|chr11:60100581-60100669,chr11,60100581,60100669,HepG2|chr11:528158-528233,chr11,528158,528233,0,59572423
HepG2|chr11:60123287-60123317,chr11,60123287,60123317,HepG2|chr11:65081237-65081353,chr11,65081237,65081353,0,4957950
HepG2|chr11:60510326-60510355,chr11,60510326,60510355,HepG2|chr11:82781863-82782007,chr11,82781863,82782007,0,22271537
HepG2|chr11:60530343-60530462,chr11,60530343,60530462,HepG2|chr11:126225336-126225367,chr11,126225336,126225367,0,65694993
HepG2|chr11:60559834-60559901,chr11,60559834,60559901,HepG2|chr11:65081241-65081324,chr11,65081241,65081324,0,4521407
HepG2|chr11:60863331-60863355,chr11,60863331,60863355,HepG2|chr11:3080164-3080248,chr11,3080164,3080248,0,57783167
HepG2|chr11:61187274-61187310,chr11,61187274,61187310,HepG2|chr11:509432-509530,chr11,509432,509530,0,60677842
HepG2|chr11:61192005-61192074,chr11,61192005,61192074,HepG2|chr11:528215-528365,chr11,528215,528365,0,60663790
HepG2|chr11:61214897-61214944,chr11,61214897,61214944,HepG2|chr11:65081237-65081340,chr11,65081237,65081340,0,3866340
HepG2|chr11:61253000-61253129,chr11,61253000,61253129,HepG2|chr11:65081078-65081099,chr11,65081078,65081099,0,3828078
HepG2|chr11:61608988-61609106,chr11,61608988,61609106,HepG2|chr11:65079695-65079726,chr11,65079695,65079726,0,3470707
HepG2|chr11:61630787-61630817,chr11,61630787,61630817,HepG2|chr11:107882054-107882127,chr11,107882054,107882127,0,46251267
HepG2|chr11:61675996-61676093,chr11,61675996,61676093,HepG2|chr11:118970586-118970603,chr11,118970586,118970603,0,57294590
HepG2|chr11:62439763-62439885,chr11,62439763,62439885,HepG2|chr11:126225336-126225364,chr11,126225336,126225364,0,63785573
HepG2|chr11:62481276-62481335,chr11,62481276,62481335,HepG2|chr11:64768689-64768737,chr11,64768689,64768737,0,2287413
HepG2|chr11:62574458-62574534,chr11,62574458,62574534,HepG2|chr11:66680143-66680161,chr11,66680143,66680161,0,4105685
HepG2|chr11:62830475-62830574,chr11,62830475,62830574,HepG2|chr11:126225291-126225342,chr11,126225291,126225342,0,63394816
HepG2|chr11:63130118-63130142,chr11,63130118,63130142,HepG2|chr11:65081245-65081395,chr11,65081245,65081395,0,1951127
HepG2|chr11:63177166-63177206,chr11,63177166,63177206,HepG2|chr11:126225336-126225446,chr11,126225336,126225446,0,63048170
HepG2|chr11:63235068-63235183,chr11,63235068,63235183,HepG2|chr11:126225336-126225391,chr11,126225336,126225391,0,62990268
HepG2|chr11:63322459-63322575,chr11,63322459,63322575,HepG2|chr11:68227453-68227603,chr11,68227453,68227603,0,4904994
HepG2|chr11:63615584-63615734,chr11,63615584,63615734,HepG2|chr11:102218855-102218875,chr11,102218855,102218875,0,38603271
HepG2|chr11:63774723-63774873,chr11,63774723,63774873,HepG2|chr11:67375410-67375535,chr11,67375410,67375535,0,3600687
HepG2|chr11:63786451-63786583,chr11,63786451,63786583,HepG2|chr11:121298656-121298674,chr11,121298656,121298674,0,57512205
HepG2|chr11:64001128-64001152,chr11,64001128,64001152,HepG2|chr11:126225336-126225440,chr11,126225336,126225440,0,62224208
HepG2|chr11:64011547-64011603,chr11,64011547,64011603,HepG2|chr11:117171622-117171683,chr11,117171622,117171683,0,53160075
HepG2|chr11:64024078-64024146,chr11,64024078,64024146,HepG2|chr11:126223345-126223427,chr11,126223345,126223427,0,62199267
HepG2|chr11:64052318-64052404,chr11,64052318,64052404,HepG2|chr11:126225336-126225396,chr11,126225336,126225396,0,62173018
HepG2|chr11:64120456-64120568,chr11,64120456,64120568,HepG2|chr11:93396107-93396170,chr11,93396107,93396170,0,29275651
HepG2|chr11:64229948-64229993,chr11,64229948,64229993,HepG2|chr11:126224907-126225008,chr11,126224907,126225008,0,61994959
HepG2|chr11:64300180-64300305,chr11,64300180,64300305,HepG2|chr11:126225336-126225356,chr11,126225336,126225356,0,61925156
HepG2|chr11:64456029-64456156,chr11,64456029,64456156,HepG2|chr11:118787841-118787928,chr11,118787841,118787928,0,54331812
HepG2|chr11:64477631-64477751,chr11,64477631,64477751,HepG2|chr11:65081814-65081841,chr11,65081814,65081841,0,604183
HepG2|chr11:64700156-64700279,chr11,64700156,64700279,HepG2|chr11:126225336-126225363,chr11,126225336,126225363,0,61525180
HepG2|chr11:64905228-64905263,chr11,64905228,64905263,HepG2|chr11:65081241-65081332,chr11,65081241,65081332,0,176013
HepG2|chr11:64960847-64960981,chr11,64960847,64960981,HepG2|chr11:67155005-67155117,chr11,67155005,67155117,0,2194158
HepG2|chr11:65087074-65087123,chr11,65087074,65087123,HepG2|chr11:126225336-126225415,chr11,126225336,126225415,0,61138262
HepG2|chr11:65346289-65346413,chr11,65346289,65346413,HepG2|chr11:118952723-118952790,chr11,118952723,118952790,0,53606434
HepG2|chr11:65750651-65750777,chr11,65750651,65750777,HepG2|chr11:65081814-65081903,chr11,65081814,65081903,0,668837
HepG2|chr11:65769724-65769874,chr11,65769724,65769874,HepG2|chr11:65081263-65081318,chr11,65081263,65081318,0,688461
HepG2|chr11:66070730-66070880,chr11,66070730,66070880,HepG2|chr11:9407778-9407888,chr11,9407778,9407888,0,56662952
HepG2|chr11:66325613-66325698,chr11,66325613,66325698,HepG2|chr11:67155005-67155135,chr11,67155005,67155135,0,829392
HepG2|chr11:66539909-66539986,chr11,66539909,66539986,HepG2|chr11:17093062-17093131,chr11,17093062,17093131,0,49446847
HepG2|chr11:66838580-66838601,chr11,66838580,66838601,HepG2|chr11:65081278-65081424,chr11,65081278,65081424,0,1757302
HepG2|chr11:67165012-67165141,chr11,67165012,67165141,HepG2|chr11:126225336-126225397,chr11,126225336,126225397,0,59060324
HepG2|chr11:67359624-67359660,chr11,67359624,67359660,HepG2|chr11:67155005-67155030,chr11,67155005,67155030,0,204619
HepG2|chr11:67406913-67406960,chr11,67406913,67406960,HepG2|chr11:3081424-3081564,chr11,3081424,3081564,0,64325489
HepG2|chr11:67454611-67454691,chr11,67454611,67454691,HepG2|chr11:126225336-126225389,chr11,126225336,126225389,0,58770725
HepG2|chr11:67485657-67485786,chr11,67485657,67485786,HepG2|chr11:126225336-126225397,chr11,126225336,126225397,0,58739679
HepG2|chr11:67532940-67533029,chr11,67532940,67533029,HepG2|chr11:126225336-126225397,chr11,126225336,126225397,0,58692396
HepG2|chr11:67593865-67593978,chr11,67593865,67593978,HepG2|chr11:76497986-76498069,chr11,76497986,76498069,0,8904121
HepG2|chr11:67646702-67646747,chr11,67646702,67646747,HepG2|chr11:126225291-126225396,chr11,126225291,126225396,0,58578589
HepG2|chr11:68067593-68067634,chr11,68067593,68067634,HepG2|chr11:126225336-126225362,chr11,126225336,126225362,0,58157743
HepG2|chr11:68285481-68285565,chr11,68285481,68285565,HepG2|chr11:65082022-65082117,chr11,65082022,65082117,0,3203459
HepG2|chr11:68330606-68330709,chr11,68330606,68330709,HepG2|chr11:126225336-126225383,chr11,126225336,126225383,0,57894730
HepG2|chr11:68558353-68558492,chr11,68558353,68558492,HepG2|chr11:67375137-67375279,chr11,67375137,67375279,0,1183216
HepG2|chr11:68666854-68666930,chr11,68666854,68666930,HepG2|chr11:510967-511037,chr11,510967,511037,0,68155887
HepG2|chr11:68803536-68803653,chr11,68803536,68803653,HepG2|chr11:68229607-68229647,chr11,68229607,68229647,0,573929
HepG2|chr11:68834114-68834177,chr11,68834114,68834177,HepG2|chr11:126225336-126225355,chr11,126225336,126225355,0,57391222
HepG2|chr11:68876077-68876118,chr11,68876077,68876118,HepG2|chr11:528198-528343,chr11,528198,528343,0,68347879
HepG2|chr11:69078680-69078713,chr11,69078680,69078713,HepG2|chr11:126225336-126225432,chr11,126225336,126225432,0,57146656
HepG2|chr11:69232216-69232336,chr11,69232216,69232336,HepG2|chr11:810565-810632,chr11,810565,810632,0,68421651
HepG2|chr11:69350890-69351023,chr11,69350890,69351023,HepG2|chr11:65223224-65223241,chr11,65223224,65223241,0,4127666
HepG2|chr11:69421752-69421804,chr11,69421752,69421804,HepG2|chr11:126225336-126225379,chr11,126225336,126225379,0,56803584
HepG2|chr11:69441936-69441981,chr11,69441936,69441981,HepG2|chr11:126225291-126225396,chr11,126225291,126225396,0,56783355
HepG2|chr11:69759116-69759199,chr11,69759116,69759199,HepG2|chr11:118952723-118952790,chr11,118952723,118952790,0,49193607
HepG2|chr11:69871725-69871803,chr11,69871725,69871803,HepG2|chr11:66679838-66679964,chr11,66679838,66679964,0,3191887
HepG2|chr11:69882862-69882924,chr11,69882862,69882924,HepG2|chr11:3878793-3878881,chr11,3878793,3878881,0,66004069
HepG2|chr11:69980753-69980778,chr11,69980753,69980778,HepG2|chr11:65081241-65081366,chr11,65081241,65081366,0,4899512
HepG2|chr11:70018068-70018174,chr11,70018068,70018174,HepG2|chr11:126225337-126225377,chr11,126225337,126225377,0,56207269
HepG2|chr11:70158037-70158076,chr11,70158037,70158076,HepG2|chr11:126225336-126225412,chr11,126225336,126225412,0,56067299
HepG2|chr11:70173494-70173644,chr11,70173494,70173644,HepG2|chr11:126225336-126225412,chr11,126225336,126225412,0,56051842
HepG2|chr11:70206871-70206974,chr11,70206871,70206974,HepG2|chr11:65081241-65081276,chr11,65081241,65081276,0,5125630
HepG2|chr11:70220482-70220621,chr11,70220482,70220621,HepG2|chr11:126225336-126225374,chr11,126225336,126225374,0,56004854
HepG2|chr11:70581955-70582105,chr11,70581955,70582105,HepG2|chr11:105893659-105893725,chr11,105893659,105893725,0,35311704
HepG2|chr11:71333222-71333287,chr11,71333222,71333287,HepG2|chr11:776756-776841,chr11,776756,776841,0,70556466
HepG2|chr11:71683876-71683900,chr11,71683876,71683900,HepG2|chr11:3080164-3080248,chr11,3080164,3080248,0,68603712
HepG2|chr11:71791350-71791436,chr11,71791350,71791436,HepG2|chr11:64768690-64768737,chr11,64768690,64768737,0,7022660
HepG2|chr11:71925279-71925332,chr11,71925279,71925332,HepG2|chr11:65081245-65081285,chr11,65081245,65081285,0,6844034
HepG2|chr11:71941264-71941300,chr11,71941264,71941300,HepG2|chr11:528215-528365,chr11,528215,528365,0,71413049
HepG2|chr11:72232178-72232307,chr11,72232178,72232307,HepG2|chr11:65375366-65375386,chr11,65375366,65375386,0,6856812
HepG2|chr11:72242750-72242876,chr11,72242750,72242876,HepG2|chr11:121298652-121298674,chr11,121298652,121298674,0,49055902
HepG2|chr11:72358307-72358457,chr11,72358307,72358457,HepG2|chr11:73586324-73586378,chr11,73586324,73586378,0,1228017
HepG2|chr11:72495337-72495424,chr11,72495337,72495424,HepG2|chr11:93396107-93396170,chr11,93396107,93396170,0,20900770
HepG2|chr11:72622897-72623047,chr11,72622897,72623047,HepG2|chr11:126225336-126225357,chr11,126225336,126225357,0,53602439
HepG2|chr11:72873435-72873538,chr11,72873435,72873538,HepG2|chr11:17298712-17298734,chr11,17298712,17298734,0,55574723
HepG2|chr11:72899324-72899474,chr11,72899324,72899474,HepG2|chr11:126225336-126225398,chr11,126225336,126225398,0,53326012
HepG2|chr11:73000758-73000823,chr11,73000758,73000823,HepG2|chr11:65081241-65081304,chr11,65081241,65081304,0,7919517
HepG2|chr11:73150957-73151107,chr11,73150957,73151107,HepG2|chr11:65081263-65081318,chr11,65081263,65081318,0,8069694
HepG2|chr11:73174845-73174933,chr11,73174845,73174933,HepG2|chr11:65081241-65081272,chr11,65081241,65081272,0,8093604
HepG2|chr11:73276573-73276603,chr11,73276573,73276603,HepG2|chr11:107882054-107882127,chr11,107882054,107882127,0,34605481
HepG2|chr11:73358364-73358463,chr11,73358364,73358463,HepG2|chr11:74696585-74696652,chr11,74696585,74696652,0,1338221
HepG2|chr11:73496949-73497029,chr11,73496949,73497029,HepG2|chr11:65081241-65081308,chr11,65081241,65081308,0,8415708
HepG2|chr11:73614740-73614820,chr11,73614740,73614820,HepG2|chr11:3877643-3877754,chr11,3877643,3877754,0,69737097
HepG2|chr11:73779410-73779517,chr11,73779410,73779517,HepG2|chr11:126224676-126224730,chr11,126224676,126224730,0,52445266
HepG2|chr11:74104063-74104111,chr11,74104063,74104111,HepG2|chr11:65081814-65081916,chr11,65081814,65081916,0,9022249
HepG2|chr11:74261773-74261919,chr11,74261773,74261919,HepG2|chr11:126225336-126225368,chr11,126225336,126225368,0,51963563
HepG2|chr11:74347608-74347708,chr11,74347608,74347708,HepG2|chr11:73703906-73703952,chr11,73703906,73703952,0,643702
HepG2|chr11:74444220-74444360,chr11,74444220,74444360,HepG2|chr11:65078472-65078509,chr11,65078472,65078509,0,9365748
HepG2|chr11:75054091-75054237,chr11,75054091,75054237,HepG2|chr11:126225336-126225368,chr11,126225336,126225368,0,51171245
HepG2|chr11:75312528-75312611,chr11,75312528,75312611,HepG2|chr11:126225336-126225427,chr11,126225336,126225427,0,50912808
HepG2|chr11:75484548-75484656,chr11,75484548,75484656,HepG2|chr11:126225336-126225389,chr11,126225336,126225389,0,50740788
HepG2|chr11:75506119-75506263,chr11,75506119,75506263,HepG2|chr11:108537373-108537518,chr11,108537373,108537518,0,33031254
HepG2|chr11:75553144-75553197,chr11,75553144,75553197,HepG2|chr11:3081405-3081476,chr11,3081405,3081476,0,72471739
HepG2|chr11:75615241-75615360,chr11,75615241,75615360,HepG2|chr11:528158-528266,chr11,528158,528266,0,75087083
HepG2|chr11:76029763-76029858,chr11,76029763,76029858,HepG2|chr11:65081241-65081296,chr11,65081241,65081296,0,10948522
HepG2|chr11:76067764-76067851,chr11,76067764,76067851,HepG2|chr11:93396107-93396170,chr11,93396107,93396170,0,17328343
HepG2|chr11:76167693-76167771,chr11,76167693,76167771,HepG2|chr11:65081970-65082021,chr11,65081970,65082021,0,11085723
HepG2|chr11:76495043-76495135,chr11,76495043,76495135,HepG2|chr11:65081261-65081378,chr11,65081261,65081378,0,11413782
HepG2|chr11:76658572-76658624,chr11,76658572,76658624,HepG2|chr11:528158-528240,chr11,528158,528240,0,76130414
HepG2|chr11:76668454-76668551,chr11,76668454,76668551,HepG2|chr11:126225336-126225389,chr11,126225336,126225389,0,49556882
HepG2|chr11:76857021-76857084,chr11,76857021,76857084,HepG2|chr11:67375062-67375206,chr11,67375062,67375206,0,9481959
HepG2|chr11:77044319-77044386,chr11,77044319,77044386,HepG2|chr11:76497986-76498069,chr11,76497986,76498069,0,546333
HepG2|chr11:77249442-77249552,chr11,77249442,77249552,HepG2|chr11:126222137-126222177,chr11,126222137,126222177,0,48972695
HepG2|chr11:77359672-77359760,chr11,77359672,77359760,HepG2|chr11:528158-528233,chr11,528158,528233,0,76831514
HepG2|chr11:77369604-77369640,chr11,77369604,77369640,HepG2|chr11:126225336-126225443,chr11,126225336,126225443,0,48855732
HepG2|chr11:77866000-77866101,chr11,77866000,77866101,HepG2|chr11:118952875-118953021,chr11,118952875,118953021,0,41086875
HepG2|chr11:78023757-78023788,chr11,78023757,78023788,HepG2|chr11:65082034-65082117,chr11,65082034,65082117,0,12941723
HepG2|chr11:78434763-78434799,chr11,78434763,78434799,HepG2|chr11:509432-509530,chr11,509432,509530,0,77925331
HepG2|chr11:78867826-78867867,chr11,78867826,78867867,HepG2|chr11:126225336-126225362,chr11,126225336,126225362,0,47357510
HepG2|chr11:79180192-79180288,chr11,79180192,79180288,HepG2|chr11:73703906-73703952,chr11,73703906,73703952,0,5476286
HepG2|chr11:79181975-79182036,chr11,79181975,79182036,HepG2|chr11:68227602-68227663,chr11,68227602,68227663,0,10954373
HepG2|chr11:79344700-79344829,chr11,79344700,79344829,HepG2|chr11:65081237-65081264,chr11,65081237,65081264,0,14263463
HepG2|chr11:79345444-79345549,chr11,79345444,79345549,HepG2|chr11:126225336-126225415,chr11,126225336,126225415,0,46879892
HepG2|chr11:79522406-79522555,chr11,79522406,79522555,HepG2|chr11:67375410-67375535,chr11,67375410,67375535,0,12146996
HepG2|chr11:79771227-79771294,chr11,79771227,79771294,HepG2|chr11:126225336-126225432,chr11,126225336,126225432,0,46454109
HepG2|chr11:80015197-80015288,chr11,80015197,80015288,HepG2|chr11:126225336-126225395,chr11,126225336,126225395,0,46210139
HepG2|chr11:80087177-80087194,chr11,80087177,80087194,HepG2|chr11:126225336-126225415,chr11,126225336,126225415,0,46138159
HepG2|chr11:80090297-80090407,chr11,80090297,80090407,HepG2|chr11:93395761-93395798,chr11,93395761,93395798,0,13305464
HepG2|chr11:80111840-80111912,chr11,80111840,80111912,HepG2|chr11:65081241-65081319,chr11,65081241,65081319,0,15030599
HepG2|chr11:80124988-80125138,chr11,80124988,80125138,HepG2|chr11:65081256-65081406,chr11,65081256,65081406,0,15043732
HepG2|chr11:80127209-80127226,chr11,80127209,80127226,HepG2|chr11:67155054-67155083,chr11,67155054,67155083,0,12972155
HepG2|chr11:80204989-80205136,chr11,80204989,80205136,HepG2|chr11:67155005-67155047,chr11,67155005,67155047,0,13049984
HepG2|chr11:80224356-80224387,chr11,80224356,80224387,HepG2|chr11:65080963-65081061,chr11,65080963,65081061,0,15143393
HepG2|chr11:80367334-80367397,chr11,80367334,80367397,HepG2|chr11:117171622-117171683,chr11,117171622,117171683,0,36804288
HepG2|chr11:80497880-80497908,chr11,80497880,80497908,HepG2|chr11:112832967-112832987,chr11,112832967,112832987,0,32335087
HepG2|chr11:80678610-80678750,chr11,80678610,80678750,HepG2|chr11:65078472-65078509,chr11,65078472,65078509,0,15600138
HepG2|chr11:80696481-80696601,chr11,80696481,80696601,HepG2|chr11:126225336-126225397,chr11,126225336,126225397,0,45528855
HepG2|chr11:80743269-80743355,chr11,80743269,80743355,HepG2|chr11:126225336-126225396,chr11,126225336,126225396,0,45482067
HepG2|chr11:80808978-80809107,chr11,80808978,80809107,HepG2|chr11:94770505-94770523,chr11,94770505,94770523,0,13961527
HepG2|chr11:81076067-81076217,chr11,81076067,81076217,HepG2|chr11:14520564-14520587,chr11,14520564,14520587,0,66555503
HepG2|chr11:81080699-81080739,chr11,81080699,81080739,HepG2|chr11:9407778-9407888,chr11,9407778,9407888,0,71672921
HepG2|chr11:81113068-81113218,chr11,81113068,81113218,HepG2|chr11:65081836-65081945,chr11,65081836,65081945,0,16031232
HepG2|chr11:82104552-82104687,chr11,82104552,82104687,HepG2|chr11:65079563-65079602,chr11,65079563,65079602,0,17024989
HepG2|chr11:82408526-82408612,chr11,82408526,82408612,HepG2|chr11:64768690-64768737,chr11,64768690,64768737,0,17639836
HepG2|chr11:82539935-82539988,chr11,82539935,82539988,HepG2|chr11:126225336-126225420,chr11,126225336,126225420,0,43685401
HepG2|chr11:82967323-82967365,chr11,82967323,82967365,HepG2|chr11:118789405-118789440,chr11,118789405,118789440,0,35822082
HepG2|chr11:83154687-83154837,chr11,83154687,83154837,HepG2|chr11:126225336-126225357,chr11,126225336,126225357,0,43070649
HepG2|chr11:83230436-83230501,chr11,83230436,83230501,HepG2|chr11:776756-776841,chr11,776756,776841,0,82453680
HepG2|chr11:83339105-83339149,chr11,83339105,83339149,HepG2|chr11:126225336-126225442,chr11,126225336,126225442,0,42886231
HepG2|chr11:83339389-83339436,chr11,83339389,83339436,HepG2|chr11:126225371-126225432,chr11,126225371,126225432,0,42885982
HepG2|chr11:83598255-83598280,chr11,83598255,83598280,HepG2|chr11:65382033-65382158,chr11,65382033,65382158,0,18216222
HepG2|chr11:83691221-83691286,chr11,83691221,83691286,HepG2|chr11:65081241-65081304,chr11,65081241,65081304,0,18609980
HepG2|chr11:83850904-83851024,chr11,83850904,83851024,HepG2|chr11:65081814-65081841,chr11,65081814,65081841,0,18769090
HepG2|chr11:83857473-83857509,chr11,83857473,83857509,HepG2|chr11:65081258-65081408,chr11,65081258,65081408,0,18776215
HepG2|chr11:83894010-83894078,chr11,83894010,83894078,HepG2|chr11:67155005-67155022,chr11,67155005,67155022,0,16739005
HepG2|chr11:83957363-83957389,chr11,83957363,83957389,HepG2|chr11:65081970-65082090,chr11,65081970,65082090,0,18875393
HepG2|chr11:84177104-84177254,chr11,84177104,84177254,HepG2|chr11:126225336-126225409,chr11,126225336,126225409,0,42048232
HepG2|chr11:84290687-84290728,chr11,84290687,84290728,HepG2|chr11:65081836-65081945,chr11,65081836,65081945,0,19208851
HepG2|chr11:84342672-84342710,chr11,84342672,84342710,HepG2|chr11:507035-507182,chr11,507035,507182,0,83835637
HepG2|chr11:84368060-84368115,chr11,84368060,84368115,HepG2|chr11:102217022-102217168,chr11,102217022,102217168,0,17848962
HepG2|chr11:84582442-84582552,chr11,84582442,84582552,HepG2|chr11:65081241-65081281,chr11,65081241,65081281,0,19501201
HepG2|chr11:85250454-85250582,chr11,85250454,85250582,HepG2|chr11:65081814-65081841,chr11,65081814,65081841,0,20168640
HepG2|chr11:85352712-85352752,chr11,85352712,85352752,HepG2|chr11:65081241-65081340,chr11,65081241,65081340,0,20271471
HepG2|chr11:85426755-85426869,chr11,85426755,85426869,HepG2|chr11:65081241-65081274,chr11,65081241,65081274,0,20345514
HepG2|chr11:85470871-85471001,chr11,85470871,85471001,HepG2|chr11:776756-776841,chr11,776756,776841,0,84694115
HepG2|chr11:85833836-85833898,chr11,85833836,85833898,HepG2|chr11:111639341-111639399,chr11,111639341,111639399,0,25805505
HepG2|chr11:86198436-86198491,chr11,86198436,86198491,HepG2|chr11:102217022-102217168,chr11,102217022,102217168,0,16018586
HepG2|chr11:86316959-86317045,chr11,86316959,86317045,HepG2|chr11:94772611-94772666,chr11,94772611,94772666,0,8455652
HepG2|chr11:86460631-86460686,chr11,86460631,86460686,HepG2|chr11:126225336-126225420,chr11,126225336,126225420,0,39764705
HepG2|chr11:86513198-86513341,chr11,86513198,86513341,HepG2|chr11:803602-803647,chr11,803602,803647,0,85709596
HepG2|chr11:86599894-86599950,chr11,86599894,86599950,HepG2|chr11:65079759-65079853,chr11,65079759,65079853,0,21520135
HepG2|chr11:86732895-86733006,chr11,86732895,86733006,HepG2|chr11:65081241-65081319,chr11,65081241,65081319,0,21651654
HepG2|chr11:86740145-86740295,chr11,86740145,86740295,HepG2|chr11:65081241-65081364,chr11,65081241,65081364,0,21658904
HepG2|chr11:86743027-86743100,chr11,86743027,86743100,HepG2|chr11:65081237-65081285,chr11,65081237,65081285,0,21661790
HepG2|chr11:86875638-86875733,chr11,86875638,86875733,HepG2|chr11:111637563-111637592,chr11,111637563,111637592,0,24761925
HepG2|chr11:86882397-86882505,chr11,86882397,86882505,HepG2|chr11:126225336-126225389,chr11,126225336,126225389,0,39342939
HepG2|chr11:86961826-86961922,chr11,86961826,86961922,HepG2|chr11:65081237-65081285,chr11,65081237,65081285,0,21880589
HepG2|chr11:87006762-87006912,chr11,87006762,87006912,HepG2|chr11:94799800-94799939,chr11,94799800,94799939,0,7793038
HepG2|chr11:87290436-87290519,chr11,87290436,87290519,HepG2|chr11:126224854-126224921,chr11,126224854,126224921,0,38934418
HepG2|chr11:87449340-87449453,chr11,87449340,87449453,HepG2|chr11:528158-528192,chr11,528158,528192,0,86921182
HepG2|chr11:87530234-87530281,chr11,87530234,87530281,HepG2|chr11:65081237-65081340,chr11,65081237,65081340,0,22448997
HepG2|chr11:87657726-87657745,chr11,87657726,87657745,HepG2|chr11:65080963-65081061,chr11,65080963,65081061,0,22576763
HepG2|chr11:87854500-87854643,chr11,87854500,87854643,HepG2|chr11:65081241-65081296,chr11,65081241,65081296,0,22773259
HepG2|chr11:88038252-88038340,chr11,88038252,88038340,HepG2|chr11:126225336-126225398,chr11,126225336,126225398,0,38187084
HepG2|chr11:88077392-88077473,chr11,88077392,88077473,HepG2|chr11:105893659-105893725,chr11,105893659,105893725,0,17816267
HepG2|chr11:88291710-88291740,chr11,88291710,88291740,HepG2|chr11:65081237-65081353,chr11,65081237,65081353,0,23210473
HepG2|chr11:88403390-88403516,chr11,88403390,88403516,HepG2|chr11:126225336-126225357,chr11,126225336,126225357,0,37821946
HepG2|chr11:88529232-88529364,chr11,88529232,88529364,HepG2|chr11:121298656-121298674,chr11,121298656,121298674,0,32769424
HepG2|chr11:88712543-88712564,chr11,88712543,88712564,HepG2|chr11:107882054-107882127,chr11,107882054,107882127,0,19169511
HepG2|chr11:89052392-89052445,chr11,89052392,89052445,HepG2|chr11:3081405-3081476,chr11,3081405,3081476,0,85970987
HepG2|chr11:89094486-89094586,chr11,89094486,89094586,HepG2|chr11:73703906-73703952,chr11,73703906,73703952,0,15390580
HepG2|chr11:89203129-89203227,chr11,89203129,89203227,HepG2|chr11:126225336-126225369,chr11,126225336,126225369,0,37022207
HepG2|chr11:89403946-89404049,chr11,89403946,89404049,HepG2|chr11:17298712-17298734,chr11,17298712,17298734,0,72105234
HepG2|chr11:89415007-89415058,chr11,89415007,89415058,HepG2|chr11:126225336-126225355,chr11,126225336,126225355,0,36810329
HepG2|chr11:89444318-89444355,chr11,89444318,89444355,HepG2|chr11:118887802-118887839,chr11,118887802,118887839,0,29443484
HepG2|chr11:89527459-89527507,chr11,89527459,89527507,HepG2|chr11:528158-528281,chr11,528158,528281,0,88999301
HepG2|chr11:89775250-89775373,chr11,89775250,89775373,HepG2|chr11:126223345-126223427,chr11,126223345,126223427,0,36448095
HepG2|chr11:90114023-90114069,chr11,90114023,90114069,HepG2|chr11:126225336-126225427,chr11,126225336,126225427,0,36111313
HepG2|chr11:90153998-90154053,chr11,90153998,90154053,HepG2|chr11:118787841-118787928,chr11,118787841,118787928,0,28633843
HepG2|chr11:90236568-90236718,chr11,90236568,90236718,HepG2|chr11:65081237-65081276,chr11,65081237,65081276,0,25155331
HepG2|chr11:90278809-90278908,chr11,90278809,90278908,HepG2|chr11:74696585-74696652,chr11,74696585,74696652,0,15582224
HepG2|chr11:90572630-90572721,chr11,90572630,90572721,HepG2|chr11:94772611-94772666,chr11,94772611,94772666,0,4199981
HepG2|chr11:90611431-90611558,chr11,90611431,90611558,HepG2|chr11:67155005-67155030,chr11,67155005,67155030,0,23456426
HepG2|chr11:90751351-90751501,chr11,90751351,90751501,HepG2|chr11:126225336-126225357,chr11,126225336,126225357,0,35473985
HepG2|chr11:90944947-90944974,chr11,90944947,90944974,HepG2|chr11:65077347-65077470,chr11,65077347,65077470,0,25867600
HepG2|chr11:91013998-91014075,chr11,91013998,91014075,HepG2|chr11:65081263-65081329,chr11,65081263,65081329,0,25932735
HepG2|chr11:91132418-91132542,chr11,91132418,91132542,HepG2|chr11:118952723-118952790,chr11,118952723,118952790,0,27820305
HepG2|chr11:91207428-91207525,chr11,91207428,91207525,HepG2|chr11:118970586-118970603,chr11,118970586,118970603,0,27763158
HepG2|chr11:91358220-91358370,chr11,91358220,91358370,HepG2|chr11:65294807-65294847,chr11,65294807,65294847,0,26063413
HepG2|chr11:91753546-91753633,chr11,91753546,91753633,HepG2|chr11:126225336-126225396,chr11,126225336,126225396,0,34471790
HepG2|chr11:91888114-91888260,chr11,91888114,91888260,HepG2|chr11:528158-528192,chr11,528158,528192,0,91359956
HepG2|chr11:92128893-92128944,chr11,92128893,92128944,HepG2|chr11:126225336-126225355,chr11,126225336,126225355,0,34096443
HepG2|chr11:92158699-92158828,chr11,92158699,92158828,HepG2|chr11:126225336-126225397,chr11,126225336,126225397,0,34066637
HepG2|chr11:92160444-92160471,chr11,92160444,92160471,HepG2|chr11:65081241-65081366,chr11,65081241,65081366,0,27079203
HepG2|chr11:92175339-92175377,chr11,92175339,92175377,HepG2|chr11:118780468-118780615,chr11,118780468,118780615,0,26605129
HepG2|chr11:92490853-92490963,chr11,92490853,92490963,HepG2|chr11:65294807-65294847,chr11,65294807,65294847,0,27196046
HepG2|chr11:92672999-92673145,chr11,92672999,92673145,HepG2|chr11:528158-528192,chr11,528158,528192,0,92144841
HepG2|chr11:92864256-92864333,chr11,92864256,92864333,HepG2|chr11:126225336-126225409,chr11,126225336,126225409,0,33361080
HepG2|chr11:93009738-93009764,chr11,93009738,93009764,HepG2|chr11:126225388-126225430,chr11,126225388,126225430,0,33215650
HepG2|chr11:93187389-93187502,chr11,93187389,93187502,HepG2|chr11:126225336-126225373,chr11,126225336,126225373,0,33037947
HepG2|chr11:93579837-93579914,chr11,93579837,93579914,HepG2|chr11:126225336-126225409,chr11,126225336,126225409,0,32645499
HepG2|chr11:93601394-93601421,chr11,93601394,93601421,HepG2|chr11:65220667-65220778,chr11,65220667,65220778,0,28380727
HepG2|chr11:93734592-93734644,chr11,93734592,93734644,HepG2|chr11:126225336-126225397,chr11,126225336,126225397,0,32490744
HepG2|chr11:93767059-93767147,chr11,93767059,93767147,HepG2|chr11:3878914-3878971,chr11,3878914,3878971,0,89888145
HepG2|chr11:93772349-93772478,chr11,93772349,93772478,HepG2|chr11:65081237-65081264,chr11,65081237,65081264,0,28691112
HepG2|chr11:93777671-93777699,chr11,93777671,93777699,HepG2|chr11:65081256-65081406,chr11,65081256,65081406,0,28696415
HepG2|chr11:94092891-94093021,chr11,94092891,94093021,HepG2|chr11:65375366-65375386,chr11,65375366,65375386,0,28717525
HepG2|chr11:94113751-94113861,chr11,94113751,94113861,HepG2|chr11:68229607-68229647,chr11,68229607,68229647,0,25884144
HepG2|chr11:94303023-94303145,chr11,94303023,94303145,HepG2|chr11:126225387-126225415,chr11,126225387,126225415,0,31922364
HepG2|chr11:94337852-94337936,chr11,94337852,94337936,HepG2|chr11:65082022-65082117,chr11,65082022,65082117,0,29255830
HepG2|chr11:94436518-94436562,chr11,94436518,94436562,HepG2|chr11:62493498-62493604,chr11,62493498,62493604,0,31943020
HepG2|chr11:94610513-94610560,chr11,94610513,94610560,HepG2|chr11:126225371-126225432,chr11,126225371,126225432,0,31614858
HepG2|chr11:94853133-94853245,chr11,94853133,94853245,HepG2|chr11:76497986-76498069,chr11,76497986,76498069,0,18355147
HepG2|chr11:95122730-95122880,chr11,95122730,95122880,HepG2|chr11:65294807-65294847,chr11,65294807,65294847,0,29827923
HepG2|chr11:95242512-95242595,chr11,95242512,95242595,HepG2|chr11:74696585-74696652,chr11,74696585,74696652,0,20545927
HepG2|chr11:95428403-95428509,chr11,95428403,95428509,HepG2|chr11:65081241-65081276,chr11,65081241,65081276,0,30347162
HepG2|chr11:95470109-95470165,chr11,95470109,95470165,HepG2|chr11:117171622-117171683,chr11,117171622,117171683,0,21701513
HepG2|chr11:95666509-95666601,chr11,95666509,95666601,HepG2|chr11:3878914-3878971,chr11,3878914,3878971,0,91787595
HepG2|chr11:95722820-95722847,chr11,95722820,95722847,HepG2|chr11:65077347-65077470,chr11,65077347,65077470,0,30645473
HepG2|chr11:96015290-96015380,chr11,96015290,96015380,HepG2|chr11:65376905-65376949,chr11,65376905,65376949,0,30638385
HepG2|chr11:96144280-96144418,chr11,96144280,96144418,HepG2|chr11:65081237-65081358,chr11,65081237,65081358,0,31063043
HepG2|chr11:96284122-96284148,chr11,96284122,96284148,HepG2|chr11:126225388-126225430,chr11,126225388,126225430,0,29941266
HepG2|chr11:96551997-96552103,chr11,96551997,96552103,HepG2|chr11:65081241-65081276,chr11,65081241,65081276,0,31470756
HepG2|chr11:96681323-96681384,chr11,96681323,96681384,HepG2|chr11:65081814-65081903,chr11,65081814,65081903,0,31599509
HepG2|chr11:96732155-96732263,chr11,96732155,96732263,HepG2|chr11:126225388-126225430,chr11,126225388,126225430,0,29493233
HepG2|chr11:97074472-97074605,chr11,97074472,97074605,HepG2|chr11:126225291-126225308,chr11,126225291,126225308,0,29150819
HepG2|chr11:97120946-97121056,chr11,97120946,97121056,HepG2|chr11:93395761-93395798,chr11,93395761,93395798,0,3725185
HepG2|chr11:97268509-97268656,chr11,97268509,97268656,HepG2|chr11:126225291-126225318,chr11,126225291,126225318,0,28956782
HepG2|chr11:97386832-97386880,chr11,97386832,97386880,HepG2|chr11:126225336-126225418,chr11,126225336,126225418,0,28838504
HepG2|chr11:97463979-97464045,chr11,97463979,97464045,HepG2|chr11:65080956-65080999,chr11,65080956,65080999,0,32383023
HepG2|chr11:97931969-97932085,chr11,97931969,97932085,HepG2|chr11:126225336-126225434,chr11,126225336,126225434,0,28293367
HepG2|chr11:97945466-97945491,chr11,97945466,97945491,HepG2|chr11:126225336-126225457,chr11,126225336,126225457,0,28279870
HepG2|chr11:98184315-98184361,chr11,98184315,98184361,HepG2|chr11:62493518-62493604,chr11,62493518,62493604,0,35690797
HepG2|chr11:98282698-98282810,chr11,98282698,98282810,HepG2|chr11:64043067-64043096,chr11,64043067,64043096,0,34239631
HepG2|chr11:98686713-98686785,chr11,98686713,98686785,HepG2|chr11:528158-528233,chr11,528158,528233,0,98158555
HepG2|chr11:98767014-98767038,chr11,98767014,98767038,HepG2|chr11:65081245-65081395,chr11,65081245,65081395,0,33685769
HepG2|chr11:98856372-98856443,chr11,98856372,98856443,HepG2|chr11:65081970-65082049,chr11,65081970,65082049,0,33774402
HepG2|chr11:98974521-98974657,chr11,98974521,98974657,HepG2|chr11:126225336-126225355,chr11,126225336,126225355,0,27250815
HepG2|chr11:99137662-99137809,chr11,99137662,99137809,HepG2|chr11:126225364-126225430,chr11,126225364,126225430,0,27087702
HepG2|chr11:99216075-99216181,chr11,99216075,99216181,HepG2|chr11:66676460-66676488,chr11,66676460,66676488,0,32539615
HepG2|chr11:99325419-99325469,chr11,99325419,99325469,HepG2|chr11:126225303-126225415,chr11,126225303,126225415,0,26899884
HepG2|chr11:99357654-99357785,chr11,99357654,99357785,HepG2|chr11:126225336-126225363,chr11,126225336,126225363,0,26867682
HepG2|chr11:99484569-99484709,chr11,99484569,99484709,HepG2|chr11:64848724-64848874,chr11,64848724,64848874,0,34635845
HepG2|chr11:99565164-99565240,chr11,99565164,99565240,HepG2|chr11:66680143-66680161,chr11,66680143,66680161,0,32885021
HepG2|chr11:99990436-99990560,chr11,99990436,99990560,HepG2|chr11:102180615-102180677,chr11,102180615,102180677,0,2190179
HepG2|chr11:100079625-100079750,chr11,100079625,100079750,HepG2|chr11:117102139-117102285,chr11,117102139,117102285,0,17022514
HepG2|chr11:100284635-100284662,chr11,100284635,100284662,HepG2|chr11:65220667-65220778,chr11,65220667,65220778,0,35063968
HepG2|chr11:100339134-100339284,chr11,100339134,100339284,HepG2|chr11:126225336-126225357,chr11,126225336,126225357,0,25886202
HepG2|chr11:100339478-100339571,chr11,100339478,100339571,HepG2|chr11:126225336-126225393,chr11,126225336,126225393,0,25885858
HepG2|chr11:100622012-100622087,chr11,100622012,100622087,HepG2|chr11:808030-808105,chr11,808030,808105,0,99813982
HepG2|chr11:100687784-100687817,chr11,100687784,100687817,HepG2|chr11:126225336-126225432,chr11,126225336,126225432,0,25537552
HepG2|chr11:100747100-100747177,chr11,100747100,100747177,HepG2|chr11:93395761-93395798,chr11,93395761,93395798,0,7351339
HepG2|chr11:100840414-100840446,chr11,100840414,100840446,HepG2|chr11:93517976-93518094,chr11,93517976,93518094,0,7322438
HepG2|chr11:100887127-100887216,chr11,100887127,100887216,HepG2|chr11:93519130-93519170,chr11,93519130,93519170,0,7367997
HepG2|chr11:100958834-100958977,chr11,100958834,100958977,HepG2|chr11:118966837-118966983,chr11,118966837,118966983,0,18008003
HepG2|chr11:100966610-100966717,chr11,100966610,100966717,HepG2|chr11:126225336-126225379,chr11,126225336,126225379,0,25258726
HepG2|chr11:101045116-101045178,chr11,101045116,101045178,HepG2|chr11:111639341-111639399,chr11,111639341,111639399,0,10594225
HepG2|chr11:101509887-101509929,chr11,101509887,101509929,HepG2|chr11:528158-528266,chr11,528158,528266,0,100981729
HepG2|chr11:101569457-101569513,chr11,101569457,101569513,HepG2|chr11:65077680-65077718,chr11,65077680,65077718,0,36491777
HepG2|chr11:101788339-101788370,chr11,101788339,101788370,HepG2|chr11:117167966-117168066,chr11,117167966,117168066,0,15379627
HepG2|chr11:101802267-101802388,chr11,101802267,101802388,HepG2|chr11:126225336-126225379,chr11,126225336,126225379,0,24423069
HepG2|chr11:101803680-101803807,chr11,101803680,101803807,HepG2|chr11:126225336-126225356,chr11,126225336,126225356,0,24421656
HepG2|chr11:101808051-101808113,chr11,101808051,101808113,HepG2|chr11:3878793-3878881,chr11,3878793,3878881,0,97929258
HepG2|chr11:101813478-101813499,chr11,101813478,101813499,HepG2|chr11:65081241-65081274,chr11,65081241,65081274,0,36732237
HepG2|chr11:101846694-101846814,chr11,101846694,101846814,HepG2|chr11:126225387-126225415,chr11,126225387,126225415,0,24378693
HepG2|chr11:101883168-101883185,chr11,101883168,101883185,HepG2|chr11:126225336-126225415,chr11,126225336,126225415,0,24342168
HepG2|chr11:102002719-102002796,chr11,102002719,102002796,HepG2|chr11:17093062-17093131,chr11,17093062,17093131,0,84909657
HepG2|chr11:102191570-102191716,chr11,102191570,102191716,HepG2|chr11:14520564-14520587,chr11,14520564,14520587,0,87671006
HepG2|chr11:102377692-102377842,chr11,102377692,102377842,HepG2|chr11:126225351-126225415,chr11,126225351,126225415,0,23847659
HepG2|chr11:102554416-102554452,chr11,102554416,102554452,HepG2|chr11:65081258-65081408,chr11,65081258,65081408,0,37473158
HepG2|chr11:102916804-102916903,chr11,102916804,102916903,HepG2|chr11:126225291-126225342,chr11,126225291,126225342,0,23308487
HepG2|chr11:103078082-103078153,chr11,103078082,103078153,HepG2|chr11:65081970-65082049,chr11,65081970,65082049,0,37996112
HepG2|chr11:103181564-103181634,chr11,103181564,103181634,HepG2|chr11:65081970-65082047,chr11,65081970,65082047,0,38099594
HepG2|chr11:103541932-103542082,chr11,103541932,103542082,HepG2|chr11:126225336-126225415,chr11,126225336,126225415,0,22683404
HepG2|chr11:103577512-103577592,chr11,103577512,103577592,HepG2|chr11:65081241-65081264,chr11,65081241,65081264,0,38496271
HepG2|chr11:103748500-103748563,chr11,103748500,103748563,HepG2|chr11:67375062-67375206,chr11,67375062,67375206,0,36373438
HepG2|chr11:103804013-103804035,chr11,103804013,103804035,HepG2|chr11:528218-528368,chr11,528218,528368,0,103275795
HepG2|chr11:104075363-104075511,chr11,104075363,104075511,HepG2|chr11:126224907-126225008,chr11,126224907,126225008,0,22149544
HepG2|chr11:105066389-105066520,chr11,105066389,105066520,HepG2|chr11:3879331-3879372,chr11,3879331,3879372,0,101187058
HepG2|chr11:105236562-105236712,chr11,105236562,105236712,HepG2|chr11:126225336-126225356,chr11,126225336,126225356,0,20988774
HepG2|chr11:105539793-105539818,chr11,105539793,105539818,HepG2|chr11:126221889-126222014,chr11,126221889,126222014,0,20682096
HepG2|chr11:105604511-105604578,chr11,105604511,105604578,HepG2|chr11:65081241-65081324,chr11,65081241,65081324,0,40523270
HepG2|chr11:105983692-105983842,chr11,105983692,105983842,HepG2|chr11:111637519-111637592,chr11,111637519,111637592,0,5653827
HepG2|chr11:106081318-106081378,chr11,106081318,106081378,HepG2|chr11:790423-790516,chr11,790423,790516,0,105290895
HepG2|chr11:106280418-106280568,chr11,106280418,106280568,HepG2|chr11:126225336-126225442,chr11,126225336,126225442,0,19944918
HepG2|chr11:106443821-106443940,chr11,106443821,106443940,HepG2|chr11:126225336-126225367,chr11,126225336,126225367,0,19781515
HepG2|chr11:106552428-106552547,chr11,106552428,106552547,HepG2|chr11:65384135-65384199,chr11,65384135,65384199,0,41168293
HepG2|chr11:107061620-107061714,chr11,107061620,107061714,HepG2|chr11:126225336-126225422,chr11,126225336,126225422,0,19163716
HepG2|chr11:107484780-107484839,chr11,107484780,107484839,HepG2|chr11:64768689-64768737,chr11,64768689,64768737,0,42716091
HepG2|chr11:107644685-107644784,chr11,107644685,107644784,HepG2|chr11:65342052-65342073,chr11,65342052,65342073,0,42302633
HepG2|chr11:107777736-107777795,chr11,107777736,107777795,HepG2|chr11:65081241-65081283,chr11,65081241,65081283,0,42696495
HepG2|chr11:107837491-107837598,chr11,107837491,107837598,HepG2|chr11:3081335-3081485,chr11,3081335,3081485,0,104756156
HepG2|chr11:107863550-107863584,chr11,107863550,107863584,HepG2|chr11:3878763-3878845,chr11,3878763,3878845,0,103984787
HepG2|chr11:107960689-107960810,chr11,107960689,107960810,HepG2|chr11:126225336-126225379,chr11,126225336,126225379,0,18264647
HepG2|chr11:108025676-108025826,chr11,108025676,108025826,HepG2|chr11:65081241-65081324,chr11,65081241,65081324,0,42944435
HepG2|chr11:108113372-108113485,chr11,108113372,108113485,HepG2|chr11:126225336-126225373,chr11,126225336,126225373,0,18111964
HepG2|chr11:108339942-108340057,chr11,108339942,108340057,HepG2|chr11:59580562-59580592,chr11,59580562,59580592,0,48759380
HepG2|chr11:108533005-108533124,chr11,108533005,108533124,HepG2|chr11:117103965-117103993,chr11,117103965,117103993,0,8570960
HepG2|chr11:108557166-108557279,chr11,108557166,108557279,HepG2|chr11:118887802-118887839,chr11,118887802,118887839,0,10330636
HepG2|chr11:108562743-108562772,chr11,108562743,108562772,HepG2|chr11:65081237-65081358,chr11,65081237,65081358,0,43481506
HepG2|chr11:108878897-108879020,chr11,108878897,108879020,HepG2|chr11:126223345-126223427,chr11,126223345,126223427,0,17344448
HepG2|chr11:108889915-108890065,chr11,108889915,108890065,HepG2|chr11:102218855-102218875,chr11,102218855,102218875,0,6671060
HepG2|chr11:108921937-108922020,chr11,108921937,108922020,HepG2|chr11:126224854-126224921,chr11,126224854,126224921,0,17302917
HepG2|chr11:109059829-109059942,chr11,109059829,109059942,HepG2|chr11:65081237-65081272,chr11,65081237,65081272,0,43978592
HepG2|chr11:109292878-109292996,chr11,109292878,109292996,HepG2|chr11:126225336-126225368,chr11,126225336,126225368,0,16932458
HepG2|chr11:109477675-109477730,chr11,109477675,109477730,HepG2|chr11:790424-790516,chr11,790424,790516,0,108687251
HepG2|chr11:109654771-109654900,chr11,109654771,109654900,HepG2|chr11:126224687-126224708,chr11,126224687,126224708,0,16569916
HepG2|chr11:109758452-109758599,chr11,109758452,109758599,HepG2|chr11:65081237-65081272,chr11,65081237,65081272,0,44677215
HepG2|chr11:109759103-109759182,chr11,109759103,109759182,HepG2|chr11:73586526-73586673,chr11,73586526,73586673,0,36172577
HepG2|chr11:110007402-110007472,chr11,110007402,110007472,HepG2|chr11:65081970-65082047,chr11,65081970,65082047,0,44925432
HepG2|chr11:110368346-110368418,chr11,110368346,110368418,HepG2|chr11:65081241-65081319,chr11,65081241,65081319,0,45287105
HepG2|chr11:110401136-110401211,chr11,110401136,110401211,HepG2|chr11:65081237-65081324,chr11,65081237,65081324,0,45319899
HepG2|chr11:110529129-110529150,chr11,110529129,110529150,HepG2|chr11:65081241-65081274,chr11,65081241,65081274,0,45447888
HepG2|chr11:110699101-110699183,chr11,110699101,110699183,HepG2|chr11:65081241-65081320,chr11,65081241,65081320,0,45617860
HepG2|chr11:110730399-110730482,chr11,110730399,110730482,HepG2|chr11:528205-528352,chr11,528205,528352,0,110202194
HepG2|chr11:110881752-110881865,chr11,110881752,110881865,HepG2|chr11:76497986-76498069,chr11,76497986,76498069,0,34383766
HepG2|chr11:111000244-111000290,chr11,111000244,111000290,HepG2|chr11:62341694-62341779,chr11,62341694,62341779,0,48658550
HepG2|chr11:111310960-111311008,chr11,111310960,111311008,HepG2|chr11:65081814-65081916,chr11,65081814,65081916,0,46229146
HepG2|chr11:111341210-111341335,chr11,111341210,111341335,HepG2|chr11:117102139-117102285,chr11,117102139,117102285,0,5760929
HepG2|chr11:111348407-111348530,chr11,111348407,111348530,HepG2|chr11:65081241-65081264,chr11,65081241,65081264,0,46267166
HepG2|chr11:111399094-111399244,chr11,111399094,111399244,HepG2|chr11:126224687-126224708,chr11,126224687,126224708,0,14825593
HepG2|chr11:111597996-111598050,chr11,111597996,111598050,HepG2|chr11:126225336-126225432,chr11,126225336,126225432,0,14627340
HepG2|chr11:112252929-112253056,chr11,112252929,112253056,HepG2|chr11:126225336-126225356,chr11,126225336,126225356,0,13972407
HepG2|chr11:112284373-112284490,chr11,112284373,112284490,HepG2|chr11:59580562-59580591,chr11,59580562,59580591,0,52703811
HepG2|chr11:112346362-112346398,chr11,112346362,112346398,HepG2|chr11:66678596-66678746,chr11,66678596,66678746,0,45667766
HepG2|chr11:112426058-112426113,chr11,112426058,112426113,HepG2|chr11:65081241-65081332,chr11,65081241,65081332,0,47344817
HepG2|chr11:112579468-112579551,chr11,112579468,112579551,HepG2|chr11:65081241-65081276,chr11,65081241,65081276,0,47498227
HepG2|chr11:112603287-112603399,chr11,112603287,112603399,HepG2|chr11:118887802-118887839,chr11,118887802,118887839,0,6284515
HepG2|chr11:112760332-112760459,chr11,112760332,112760459,HepG2|chr11:59580569-59580592,chr11,59580569,59580592,0,53179763
HepG2|chr11:112796729-112796758,chr11,112796729,112796758,HepG2|chr11:65081237-65081358,chr11,65081237,65081358,0,47715492
HepG2|chr11:112812839-112812951,chr11,112812839,112812951,HepG2|chr11:76497986-76498069,chr11,76497986,76498069,0,36314853
HepG2|chr11:113135515-113135600,chr11,113135515,113135600,HepG2|chr11:65317728-65317793,chr11,65317728,65317793,0,47817787
HepG2|chr11:113174718-113174749,chr11,113174718,113174749,HepG2|chr11:126224392-126224475,chr11,126224392,126224475,0,13049674
HepG2|chr11:113385350-113385485,chr11,113385350,113385485,HepG2|chr11:126225336-126225357,chr11,126225336,126225357,0,12839986
HepG2|chr11:113468868-113468943,chr11,113468868,113468943,HepG2|chr11:65313538-65313586,chr11,65313538,65313586,0,48155330
HepG2|chr11:113485513-113485663,chr11,113485513,113485663,HepG2|chr11:105893659-105893725,chr11,105893659,105893725,0,7591854
HepG2|chr11:113514185-113514206,chr11,113514185,113514206,HepG2|chr11:67375410-67375535,chr11,67375410,67375535,0,46138775
HepG2|chr11:113720985-113721131,chr11,113720985,113721131,HepG2|chr11:65081078-65081099,chr11,65081078,65081099,0,48639907
HepG2|chr11:114176346-114176448,chr11,114176346,114176448,HepG2|chr11:65081241-65081272,chr11,65081241,65081272,0,49095105
HepG2|chr11:114222716-114222754,chr11,114222716,114222754,HepG2|chr11:507035-507182,chr11,507035,507182,0,113715681
HepG2|chr11:114383075-114383209,chr11,114383075,114383209,HepG2|chr11:65146410-65146444,chr11,65146410,65146444,0,49236665
HepG2|chr11:114397305-114397354,chr11,114397305,114397354,HepG2|chr11:65081814-65081915,chr11,65081814,65081915,0,49315491
HepG2|chr11:114416238-114416387,chr11,114416238,114416387,HepG2|chr11:526956-526977,chr11,526956,526977,0,113889282
HepG2|chr11:114559032-114559121,chr11,114559032,114559121,HepG2|chr11:65081241-65081277,chr11,65081241,65081277,0,49477791
HepG2|chr11:114664065-114664157,chr11,114664065,114664157,HepG2|chr11:126225336-126225395,chr11,126225336,126225395,0,11561271
HepG2|chr11:114673589-114673674,chr11,114673589,114673674,HepG2|chr11:65317728-65317793,chr11,65317728,65317793,0,49355861
HepG2|chr11:114713955-114714040,chr11,114713955,114714040,HepG2|chr11:65078301-65078325,chr11,65078301,65078325,0,49635654
HepG2|chr11:114731113-114731242,chr11,114731113,114731242,HepG2|chr11:126225336-126225397,chr11,126225336,126225397,0,11494223
HepG2|chr11:114741182-114741265,chr11,114741182,114741265,HepG2|chr11:74696585-74696652,chr11,74696585,74696652,0,40044597
HepG2|chr11:114856660-114856745,chr11,114856660,114856745,HepG2|chr11:74696291-74696356,chr11,74696291,74696356,0,40160369
HepG2|chr11:114930724-114930854,chr11,114930724,114930854,HepG2|chr11:126225336-126225357,chr11,126225336,126225357,0,11294612
HepG2|chr11:115210497-115210585,chr11,115210497,115210585,HepG2|chr11:65081241-65081272,chr11,65081241,65081272,0,50129256
HepG2|chr11:115454510-115454626,chr11,115454510,115454626,HepG2|chr11:65081241-65081275,chr11,65081241,65081275,0,50373269
HepG2|chr11:115668487-115668610,chr11,115668487,115668610,HepG2|chr11:118962712-118962862,chr11,118962712,118962862,0,3294225
HepG2|chr11:116186600-116186630,chr11,116186600,116186630,HepG2|chr11:126224450-126224563,chr11,126224450,126224563,0,10037850
HepG2|chr11:116216648-116216702,chr11,116216648,116216702,HepG2|chr11:790423-790516,chr11,790423,790516,0,115426225
HepG2|chr11:116365161-116365310,chr11,116365161,116365310,HepG2|chr11:526956-526977,chr11,526956,526977,0,115838205
HepG2|chr11:116736555-116736700,chr11,116736555,116736700,HepG2|chr11:65081241-65081276,chr11,65081241,65081276,0,51655314
HepG2|chr11:116775853-116775970,chr11,116775853,116775970,HepG2|chr11:526956-526977,chr11,526956,526977,0,116248897
HepG2|chr11:116901817-116901934,chr11,116901817,116901934,HepG2|chr11:68229607-68229647,chr11,68229607,68229647,0,48672210
HepG2|chr11:117308355-117308426,chr11,117308355,117308426,HepG2|chr11:126225336-126225415,chr11,126225336,126225415,0,8916981
HepG2|chr11:117416196-117416238,chr11,117416196,117416238,HepG2|chr11:65081241-65081347,chr11,65081241,65081347,0,52334955
HepG2|chr11:117466884-117467031,chr11,117466884,117467031,HepG2|chr11:65081241-65081308,chr11,65081241,65081308,0,52385643
HepG2|chr11:117480894-117481006,chr11,117480894,117481006,HepG2|chr11:65081237-65081360,chr11,65081237,65081360,0,52399657
HepG2|chr11:117622072-117622188,chr11,117622072,117622188,HepG2|chr11:65081241-65081275,chr11,65081241,65081275,0,52540831
HepG2|chr11:117671002-117671097,chr11,117671002,117671097,HepG2|chr11:126225336-126225391,chr11,126225336,126225391,0,8554334
HepG2|chr11:117767558-117767669,chr11,117767558,117767669,HepG2|chr11:112832967-112832987,chr11,112832967,112832987,0,4934591
HepG2|chr11:117860454-117860488,chr11,117860454,117860488,HepG2|chr11:3878763-3878845,chr11,3878763,3878845,0,113981691
HepG2|chr11:117991174-117991275,chr11,117991174,117991275,HepG2|chr11:17097793-17097820,chr11,17097793,17097820,0,100893381
HepG2|chr11:118844486-118844578,chr11,118844486,118844578,HepG2|chr11:3878688-3878809,chr11,3878688,3878809,0,114965798
HepG2|chr11:118862116-118862192,chr11,118862116,118862192,HepG2|chr11:510967-511037,chr11,510967,511037,0,118351149
HepG2|chr11:118982737-118982839,chr11,118982737,118982839,HepG2|chr11:102180609-102180749,chr11,102180609,102180749,0,16802128
HepG2|chr11:119046803-119046839,chr11,119046803,119046839,HepG2|chr11:126225389-126225435,chr11,126225389,126225435,0,7178586
HepG2|chr11:119097987-119098071,chr11,119097987,119098071,HepG2|chr11:14520564-14520587,chr11,14520564,14520587,0,104577423
HepG2|chr11:119159147-119159290,chr11,119159147,119159290,HepG2|chr11:118966837-118966983,chr11,118966837,118966983,0,192310
HepG2|chr11:119200824-119200882,chr11,119200824,119200882,HepG2|chr11:126225336-126225385,chr11,126225336,126225385,0,7024512
HepG2|chr11:119232575-119232671,chr11,119232575,119232671,HepG2|chr11:126224676-126224730,chr11,126224676,126224730,0,6992101
HepG2|chr11:119283504-119283654,chr11,119283504,119283654,HepG2|chr11:65081241-65081264,chr11,65081241,65081264,0,54202263
HepG2|chr11:119433433-119433457,chr11,119433433,119433457,HepG2|chr11:3861052-3861202,chr11,3861052,3861202,0,115572381
HepG2|chr11:119600944-119601094,chr11,119600944,119601094,HepG2|chr11:65079695-65079726,chr11,65079695,65079726,0,54521249
HepG2|chr11:119606683-119606801,chr11,119606683,119606801,HepG2|chr11:65079695-65079726,chr11,65079695,65079726,0,54526988
HepG2|chr11:119708113-119708240,chr11,119708113,119708240,HepG2|chr11:118787841-118787928,chr11,118787841,118787928,0,920272
HepG2|chr11:119996692-119996733,chr11,119996692,119996733,HepG2|chr11:65313280-65313428,chr11,65313280,65313428,0,54683412
HepG2|chr11:120208385-120208480,chr11,120208385,120208480,HepG2|chr11:65081241-65081296,chr11,65081241,65081296,0,55127144
HepG2|chr11:120406344-120406494,chr11,120406344,120406494,HepG2|chr11:65081245-65081395,chr11,65081245,65081395,0,55325099
HepG2|chr11:120516175-120516263,chr11,120516175,120516263,HepG2|chr11:65079711-65079753,chr11,65079711,65079753,0,55436464
HepG2|chr11:120536664-120536773,chr11,120536664,120536773,HepG2|chr11:93517976-93518094,chr11,93517976,93518094,0,27018688
HepG2|chr11:120577613-120577757,chr11,120577613,120577757,HepG2|chr11:108537373-108537518,chr11,108537373,108537518,0,12040240
HepG2|chr11:120608357-120608446,chr11,120608357,120608446,HepG2|chr11:65081241-65081277,chr11,65081241,65081277,0,55527116
HepG2|chr11:120698446-120698579,chr11,120698446,120698579,HepG2|chr11:126225291-126225308,chr11,126225291,126225308,0,5526845
HepG2|chr11:120738608-120738634,chr11,120738608,120738634,HepG2|chr11:65081970-65082090,chr11,65081970,65082090,0,55656638
HepG2|chr11:120802776-120802926,chr11,120802776,120802926,HepG2|chr11:126225336-126225398,chr11,126225336,126225398,0,5422560
HepG2|chr11:120869039-120869091,chr11,120869039,120869091,HepG2|chr11:126225336-126225397,chr11,126225336,126225397,0,5356297
HepG2|chr11:120959628-120959696,chr11,120959628,120959696,HepG2|chr11:126223345-126223427,chr11,126223345,126223427,0,5263717
HepG2|chr11:120967442-120967476,chr11,120967442,120967476,HepG2|chr11:65817378-65817393,chr11,65817378,65817393,0,55150064
HepG2|chr11:121112888-121113038,chr11,121112888,121113038,HepG2|chr11:65081836-65081945,chr11,65081836,65081945,0,56031052
HepG2|chr11:121296949-121296992,chr11,121296949,121296992,HepG2|chr11:126224907-126225008,chr11,126224907,126225008,0,4927958
HepG2|chr11:121412467-121412500,chr11,121412467,121412500,HepG2|chr11:65080885-65080999,chr11,65080885,65080999,0,56331582
HepG2|chr11:121609497-121609520,chr11,121609497,121609520,HepG2|chr11:63540585-63540675,chr11,63540585,63540675,0,58068912
HepG2|chr11:122083955-122084025,chr11,122083955,122084025,HepG2|chr11:126225336-126225357,chr11,126225336,126225357,0,4141381
HepG2|chr11:122138158-122138308,chr11,122138158,122138308,HepG2|chr11:126225336-126225356,chr11,126225336,126225356,0,4087178
HepG2|chr11:122354698-122354734,chr11,122354698,122354734,HepG2|chr11:66678596-66678746,chr11,66678596,66678746,0,55676102
HepG2|chr11:122385623-122385687,chr11,122385623,122385687,HepG2|chr11:126225336-126225355,chr11,126225336,126225355,0,3839713
HepG2|chr11:122444529-122444570,chr11,122444529,122444570,HepG2|chr11:65342331-65342479,chr11,65342331,65342479,0,57102198
HepG2|chr11:122465742-122465823,chr11,122465742,122465823,HepG2|chr11:105893659-105893725,chr11,105893659,105893725,0,16572083
HepG2|chr11:123050676-123050700,chr11,123050676,123050700,HepG2|chr11:126225336-126225440,chr11,126225336,126225440,0,3174660
HepG2|chr11:123341927-123341965,chr11,123341927,123341965,HepG2|chr11:126225336-126225448,chr11,126225336,126225448,0,2883409
HepG2|chr11:123496618-123496738,chr11,123496618,123496738,HepG2|chr11:126225387-126225415,chr11,126225387,126225415,0,2728769
HepG2|chr11:123570638-123570660,chr11,123570638,123570660,HepG2|chr11:528218-528368,chr11,528218,528368,0,123042420
HepG2|chr11:123750673-123750789,chr11,123750673,123750789,HepG2|chr11:65146410-65146444,chr11,65146410,65146444,0,58604263
HepG2|chr11:123961759-123961800,chr11,123961759,123961800,HepG2|chr11:65081836-65081945,chr11,65081836,65081945,0,58879923
HepG2|chr11:124159973-124160030,chr11,124159973,124160030,HepG2|chr11:66673181-66673271,chr11,66673181,66673271,0,57486792
HepG2|chr11:124167790-124167856,chr11,124167790,124167856,HepG2|chr11:65079759-65079853,chr11,65079759,65079853,0,59088031
HepG2|chr11:124186224-124186303,chr11,124186224,124186303,HepG2|chr11:73586526-73586673,chr11,73586526,73586673,0,50599698
HepG2|chr11:124255061-124255138,chr11,124255061,124255138,HepG2|chr11:3878793-3878881,chr11,3878793,3878881,0,120376268
HepG2|chr11:124296134-124296237,chr11,124296134,124296237,HepG2|chr11:65081241-65081276,chr11,65081241,65081276,0,59214893
HepG2|chr11:124394143-124394293,chr11,124394143,124394293,HepG2|chr11:126224648-126224763,chr11,126224648,126224763,0,1830505
HepG2|chr11:124539733-124539880,chr11,124539733,124539880,HepG2|chr11:65081241-65081304,chr11,65081241,65081304,0,59458492
HepG2|chr11:124574227-124574267,chr11,124574227,124574267,HepG2|chr11:9407778-9407888,chr11,9407778,9407888,0,115166449
HepG2|chr11:124643129-124643151,chr11,124643129,124643151,HepG2|chr11:65082529-65082657,chr11,65082529,65082657,0,59560600
HepG2|chr11:124766668-124766785,chr11,124766668,124766785,HepG2|chr11:65377786-65377804,chr11,65377786,65377804,0,59388882
HepG2|chr11:124911451-124911534,chr11,124911451,124911534,HepG2|chr11:126225336-126225427,chr11,126225336,126225427,0,1313885
HepG2|chr11:125090633-125090763,chr11,125090633,125090763,HepG2|chr11:126225337-126225397,chr11,126225337,126225397,0,1134704
HepG2|chr11:125149355-125149399,chr11,125149355,125149399,HepG2|chr11:126225336-126225442,chr11,126225336,126225442,0,1075981
HepG2|chr11:125216550-125216679,chr11,125216550,125216679,HepG2|chr11:126224687-126224708,chr11,126224687,126224708,0,1008137
HepG2|chr11:125220094-125220142,chr11,125220094,125220142,HepG2|chr11:528158-528281,chr11,528158,528281,0,124691936
HepG2|chr11:125404798-125404897,chr11,125404798,125404897,HepG2|chr11:65081237-65081308,chr11,65081237,65081308,0,60323561
HepG2|chr11:125466131-125466250,chr11,125466131,125466250,HepG2|chr11:528158-528266,chr11,528158,528266,0,124937973
HepG2|chr11:125580399-125580455,chr11,125580399,125580455,HepG2|chr11:126225336-126225396,chr11,126225336,126225396,0,644937
HepG2|chr11:125608238-125608387,chr11,125608238,125608387,HepG2|chr11:67375410-67375535,chr11,67375410,67375535,0,58232828
HepG2|chr11:125733876-125733901,chr11,125733876,125733901,HepG2|chr11:65382033-65382158,chr11,65382033,65382158,0,60351843
HepG2|chr11:125905460-125905606,chr11,125905460,125905606,HepG2|chr11:14520564-14520587,chr11,14520564,14520587,0,111384896
HepG2|chr11:126018361-126018391,chr11,126018361,126018391,HepG2|chr11:65382052-65382158,chr11,65382052,65382158,0,60636309
HepG2|chr11:126097296-126097435,chr11,126097296,126097435,HepG2|chr11:126225336-126225374,chr11,126225336,126225374,0,128040
HepG2|chr11:126213925-126214031,chr11,126213925,126214031,HepG2|chr11:66676460-66676488,chr11,66676460,66676488,0,59537465
HepG2|chr11:126254642-126254719,chr11,126254642,126254719,HepG2|chr11:65081263-65081329,chr11,65081263,65081329,0,61173379
HepG2|chr11:126422113-126422200,chr11,126422113,126422200,HepG2|chr11:65081241-65081304,chr11,65081241,65081304,0,61340872
HepG2|chr11:126682202-126682297,chr11,126682202,126682297,HepG2|chr11:111637563-111637592,chr11,111637563,111637592,0,15044639
HepG2|chr11:126739659-126739746,chr11,126739659,126739746,HepG2|chr11:126225336-126225396,chr11,126225336,126225396,0,514323
HepG2|chr11:126751536-126751571,chr11,126751536,126751571,HepG2|chr11:126225336-126225446,chr11,126225336,126225446,0,526200
HepG2|chr11:127193663-127193770,chr11,127193663,127193770,HepG2|chr11:126225336-126225379,chr11,126225336,126225379,0,968327
HepG2|chr11:127231562-127231628,chr11,127231562,127231628,HepG2|chr11:67155005-67155022,chr11,67155005,67155022,0,60076557
HepG2|chr11:127315163-127315282,chr11,127315163,127315282,HepG2|chr11:65384135-65384199,chr11,65384135,65384199,0,61931028
HepG2|chr11:127511374-127511433,chr11,127511374,127511433,HepG2|chr11:65081241-65081283,chr11,65081241,65081283,0,62430133
HepG2|chr11:127755617-127755767,chr11,127755617,127755767,HepG2|chr11:107876951-107876968,chr11,107876951,107876968,0,19878666
HepG2|chr11:127984954-127985024,chr11,127984954,127985024,HepG2|chr11:126225336-126225357,chr11,126225336,126225357,0,1759618
HepG2|chr11:128701524-128701674,chr11,128701524,128701674,HepG2|chr11:126225351-126225415,chr11,126225351,126225415,0,2476173
HepG2|chr11:128741745-128741837,chr11,128741745,128741837,HepG2|chr11:126225336-126225395,chr11,126225336,126225395,0,2516409
HepG2|chr11:128789854-128789942,chr11,128789854,128789942,HepG2|chr11:67155005-67155022,chr11,67155005,67155022,0,61634849
HepG2|chr11:129114367-129114428,chr11,129114367,129114428,HepG2|chr11:68227602-68227663,chr11,68227602,68227663,0,60886765
HepG2|chr11:130122229-130122367,chr11,130122229,130122367,HepG2|chr11:65081237-65081358,chr11,65081237,65081358,0,65040992
HepG2|chr11:130193607-130193662,chr11,130193607,130193662,HepG2|chr11:790424-790516,chr11,790424,790516,0,129403183
HepG2|chr11:130372030-130372051,chr11,130372030,130372051,HepG2|chr11:107882054-107882127,chr11,107882054,107882127,0,22489976
HepG2|chr11:130839287-130839370,chr11,130839287,130839370,HepG2|chr11:118952723-118952790,chr11,118952723,118952790,0,11886564
HepG2|chr11:130914981-130915000,chr11,130914981,130915000,HepG2|chr11:3878239-3878320,chr11,3878239,3878320,0,127036742
HepG2|chr11:131086915-131086964,chr11,131086915,131086964,HepG2|chr11:126225336-126225415,chr11,126225336,126225415,0,4861579
HepG2|chr11:131168579-131168692,chr11,131168579,131168692,HepG2|chr11:528158-528192,chr11,528158,528192,0,130640421
HepG2|chr11:131306399-131306493,chr11,131306399,131306493,HepG2|chr11:65081263-65081318,chr11,65081263,65081318,0,66225136
HepG2|chr11:131337465-131337482,chr11,131337465,131337482,HepG2|chr11:67155054-67155083,chr11,67155054,67155083,0,64182411
HepG2|chr11:131525893-131525939,chr11,131525893,131525939,HepG2|chr11:126225336-126225355,chr11,126225336,126225355,0,5300557
HepG2|chr11:131644848-131644971,chr11,131644848,131644971,HepG2|chr11:118962712-118962862,chr11,118962712,118962862,0,12682136
HepG2|chr11:131986511-131986539,chr11,131986511,131986539,HepG2|chr11:65081256-65081406,chr11,65081256,65081406,0,66905255
HepG2|chr11:132243593-132243724,chr11,132243593,132243724,HepG2|chr11:126225336-126225391,chr11,126225336,126225391,0,6018257
HepG2|chr11:132545738-132545818,chr11,132545738,132545818,HepG2|chr11:808036-808106,chr11,808036,808106,0,131737702
HepG2|chr11:132906647-132906719,chr11,132906647,132906719,HepG2|chr11:528158-528233,chr11,528158,528233,0,132378489
HepG2|chr11:132915468-132915532,chr11,132915468,132915532,HepG2|chr11:126225336-126225422,chr11,126225336,126225422,0,6690132
HepG2|chr11:132957509-132957631,chr11,132957509,132957631,HepG2|chr11:65294924-65294952,chr11,65294924,65294952,0,67662585
HepG2|chr11:133146099-133146246,chr11,133146099,133146246,HepG2|chr11:126225291-126225318,chr11,126225291,126225318,0,6920808
HepG2|chr11:133448223-133448344,chr11,133448223,133448344,HepG2|chr11:108532163-108532184,chr11,108532163,108532184,0,24916060
HepG2|chr11:133482059-133482209,chr11,133482059,133482209,HepG2|chr11:126225336-126225409,chr11,126225336,126225409,0,7256723
HepG2|chr11:133487830-133487959,chr11,133487830,133487959,HepG2|chr11:528158-528192,chr11,528158,528192,0,132959672
HepG2|chr11:133582528-133582546,chr11,133582528,133582546,HepG2|chr11:3878239-3878320,chr11,3878239,3878320,0,129704289
HepG2|chr11:133997537-133997575,chr11,133997537,133997575,HepG2|chr11:65153440-65153540,chr11,65153440,65153540,0,68844097
HepG2|chr11:134205053-134205154,chr11,134205053,134205154,HepG2|chr11:118959037-118959082,chr11,118959037,118959082,0,15246016
HepG2|chr11:134216758-134216908,chr11,134216758,134216908,HepG2|chr11:94799800-94799939,chr11,94799800,94799939,0,39416958
HepG2|chr11:134225280-134225345,chr11,134225280,134225345,HepG2|chr11:66673181-66673271,chr11,66673181,66673271,0,67552099
HepG2|chr11:134595221-134595355,chr11,134595221,134595355,HepG2|chr11:65146410-65146444,chr11,65146410,65146444,0,69448811
HepG2|chr11:134675762-134675888,chr11,134675762,134675888,HepG2|chr11:121298652-121298674,chr11,121298652,121298674,0,13377110
HepG2|chr11:134706937-134707076,chr11,134706937,134707076,HepG2|chr11:64848724-64848874,chr11,64848724,64848874,0,69858213
HepG2|chr11:134736805-134736861,chr11,134736805,134736861,HepG2|chr11:63540585-63540675,chr11,63540585,63540675,0,71196220
HepG2|chr11:134804101-134804211,chr11,134804101,134804211,HepG2|chr11:126225336-126225357,chr11,126225336,126225357,0,8578765
HepG2|chr11:134910779-134910926,chr11,134910779,134910926,HepG2|chr11:65081241-65081304,chr11,65081241,65081304,0,69829538
HepG2|chr11:134944309-134944451,chr11,134944309,134944451,HepG2|chr11:59580562-59580595,chr11,59580562,59580595,0,75363747
HepG2|chr11:134989167-134989302,chr11,134989167,134989302,HepG2|chr11:126225336-126225357,chr11,126225336,126225357,0,8763831
HepG2|chr12:24734-24777,chr12,24734,24777,HepG2|chr12:7280783-7280884,chr12,7280783,7280884,0,7256049
HepG2|chr12:339952-340070,chr12,339952,340070,HepG2|chr12:7280783-7280815,chr12,7280783,7280815,0,6940831
HepG2|chr12:401846-401876,chr12,401846,401876,HepG2|chr12:54392020-54392117,chr12,54392020,54392117,0,53990174
HepG2|chr12:562257-562280,chr12,562257,562280,HepG2|chr12:7280783-7280847,chr12,7280783,7280847,0,6718526
HepG2|chr12:827429-827507,chr12,827429,827507,HepG2|chr12:124085659-124085809,chr12,124085659,124085809,0,123258230
HepG2|chr12:864917-864970,chr12,864917,864970,HepG2|chr12:7280783-7280878,chr12,7280783,7280878,0,6415866
HepG2|chr12:926441-926503,chr12,926441,926503,HepG2|chr12:7280783-7280881,chr12,7280783,7280881,0,6354342
HepG2|chr12:964564-964632,chr12,964564,964632,HepG2|chr12:14922833-14922882,chr12,14922833,14922882,0,13958269
HepG2|chr12:1711603-1711645,chr12,1711603,1711645,HepG2|chr12:7280783-7280810,chr12,7280783,7280810,0,5569180
HepG2|chr12:2002417-2002485,chr12,2002417,2002485,HepG2|chr12:6717126-6717187,chr12,6717126,6717187,0,4714709
HepG2|chr12:2127169-2127207,chr12,2127169,2127207,HepG2|chr12:7280783-7280867,chr12,7280783,7280867,0,5153614
HepG2|chr12:2170856-2170908,chr12,2170856,2170908,HepG2|chr12:7280783-7280817,chr12,7280783,7280817,0,5109927
HepG2|chr12:2639265-2639359,chr12,2639265,2639359,HepG2|chr12:89748812-89748906,chr12,89748812,89748906,0,87109547
HepG2|chr12:2710441-2710591,chr12,2710441,2710591,HepG2|chr12:89749493-89749531,chr12,89749493,89749531,0,87039052
HepG2|chr12:2711524-2711557,chr12,2711524,2711557,HepG2|chr12:7280783-7280878,chr12,7280783,7280878,0,4569259
HepG2|chr12:2801414-2801441,chr12,2801414,2801441,HepG2|chr12:7280783-7280847,chr12,7280783,7280847,0,4479369
HepG2|chr12:2926894-2926928,chr12,2926894,2926928,HepG2|chr12:7280783-7280809,chr12,7280783,7280809,0,4353889
HepG2|chr12:3287330-3287349,chr12,3287330,3287349,HepG2|chr12:7280783-7280847,chr12,7280783,7280847,0,3993453
HepG2|chr12:3289229-3289341,chr12,3289229,3289341,HepG2|chr12:7280783-7280854,chr12,7280783,7280854,0,3991554
HepG2|chr12:3551316-3551368,chr12,3551316,3551368,HepG2|chr12:7280783-7280817,chr12,7280783,7280817,0,3729467
HepG2|chr12:3668632-3668765,chr12,3668632,3668765,HepG2|chr12:7280783-7280878,chr12,7280783,7280878,0,3612151
HepG2|chr12:3969981-3970093,chr12,3969981,3970093,HepG2|chr12:31798282-31798324,chr12,31798282,31798324,0,27828301
HepG2|chr12:3989146-3989207,chr12,3989146,3989207,HepG2|chr12:7280783-7280851,chr12,7280783,7280851,0,3291637
HepG2|chr12:4084489-4084543,chr12,4084489,4084543,HepG2|chr12:7280783-7280853,chr12,7280783,7280853,0,3196294
HepG2|chr12:4150975-4151112,chr12,4150975,4151112,HepG2|chr12:69201671-69201821,chr12,69201671,69201821,0,65050696
HepG2|chr12:4246243-4246290,chr12,4246243,4246290,HepG2|chr12:7280783-7280883,chr12,7280783,7280883,0,3034540
HepG2|chr12:4560284-4560416,chr12,4560284,4560416,HepG2|chr12:7280783-7280810,chr12,7280783,7280810,0,2720499
HepG2|chr12:4621792-4621825,chr12,4621792,4621825,HepG2|chr12:7280783-7280878,chr12,7280783,7280878,0,2658991
HepG2|chr12:4774569-4774650,chr12,4774569,4774650,HepG2|chr12:7280783-7280857,chr12,7280783,7280857,0,2506214
HepG2|chr12:5444509-5444547,chr12,5444509,5444547,HepG2|chr12:14922833-14922935,chr12,14922833,14922935,0,9478324
HepG2|chr12:5918743-5918787,chr12,5918743,5918787,HepG2|chr12:7280783-7280878,chr12,7280783,7280878,0,1362040
HepG2|chr12:6041379-6041430,chr12,6041379,6041430,HepG2|chr12:7280783-7280854,chr12,7280783,7280854,0,1239404
HepG2|chr12:6234631-6234714,chr12,6234631,6234714,HepG2|chr12:7280783-7280851,chr12,7280783,7280851,0,1046152
HepG2|chr12:6437683-6437742,chr12,6437683,6437742,HepG2|chr12:7280783-7280862,chr12,7280783,7280862,0,843100
HepG2|chr12:6541667-6541728,chr12,6541667,6541728,HepG2|chr12:76432623-76432773,chr12,76432623,76432773,0,69890956
HepG2|chr12:6602996-6603101,chr12,6602996,6603101,HepG2|chr12:7280783-7280828,chr12,7280783,7280828,0,677787
HepG2|chr12:7085613-7085689,chr12,7085613,7085689,HepG2|chr12:7280783-7280857,chr12,7280783,7280857,0,195170
HepG2|chr12:7453257-7453302,chr12,7453257,7453302,HepG2|chr12:7280783-7280808,chr12,7280783,7280808,0,172474
HepG2|chr12:7814293-7814331,chr12,7814293,7814331,HepG2|chr12:7280783-7280847,chr12,7280783,7280847,0,533510
HepG2|chr12:8638649-8638684,chr12,8638649,8638684,HepG2|chr12:7280783-7280818,chr12,7280783,7280818,0,1357866
HepG2|chr12:8704492-8704511,chr12,8704492,8704511,HepG2|chr12:7280783-7280847,chr12,7280783,7280847,0,1423709
HepG2|chr12:8770947-8771063,chr12,8770947,8771063,HepG2|chr12:51156342-51156440,chr12,51156342,51156440,0,42385395
HepG2|chr12:8818299-8818400,chr12,8818299,8818400,HepG2|chr12:7280783-7280832,chr12,7280783,7280832,0,1537516
HepG2|chr12:9230261-9230407,chr12,9230261,9230407,HepG2|chr12:122513327-122513459,chr12,122513327,122513459,0,113283066
HepG2|chr12:9276581-9276622,chr12,9276581,9276622,HepG2|chr12:7280783-7280853,chr12,7280783,7280853,0,1995798
HepG2|chr12:9398654-9398758,chr12,9398654,9398758,HepG2|chr12:7279426-7279522,chr12,7279426,7279522,0,2119228
HepG2|chr12:9508430-9508575,chr12,9508430,9508575,HepG2|chr12:7280783-7280810,chr12,7280783,7280810,0,2227647
HepG2|chr12:9558704-9558742,chr12,9558704,9558742,HepG2|chr12:7280783-7280809,chr12,7280783,7280809,0,2277921
HepG2|chr12:9629346-9629416,chr12,9629346,9629416,HepG2|chr12:7280783-7280879,chr12,7280783,7280879,0,2348563
HepG2|chr12:9632108-9632258,chr12,9632108,9632258,HepG2|chr12:123379344-123379395,chr12,123379344,123379395,0,113747236
HepG2|chr12:10073133-10073164,chr12,10073133,10073164,HepG2|chr12:7280244-7280373,chr12,7280244,7280373,0,2792889
HepG2|chr12:10263035-10263057,chr12,10263035,10263057,HepG2|chr12:7280781-7280824,chr12,7280781,7280824,0,2982254
HepG2|chr12:10296832-10296928,chr12,10296832,10296928,HepG2|chr12:7280783-7280884,chr12,7280783,7280884,0,3016049
HepG2|chr12:10428190-10428270,chr12,10428190,10428270,HepG2|chr12:7280783-7280854,chr12,7280783,7280854,0,3147407
HepG2|chr12:10481352-10481388,chr12,10481352,10481388,HepG2|chr12:7280783-7280810,chr12,7280783,7280810,0,3200569
HepG2|chr12:11456220-11456256,chr12,11456220,11456256,HepG2|chr12:7280783-7280813,chr12,7280783,7280813,0,4175437
HepG2|chr12:11696047-11696093,chr12,11696047,11696093,HepG2|chr12:7280783-7280809,chr12,7280783,7280809,0,4415264
HepG2|chr12:11921967-11922017,chr12,11921967,11922017,HepG2|chr12:14921872-14921938,chr12,14921872,14921938,0,2999905
HepG2|chr12:12011095-12011138,chr12,12011095,12011138,HepG2|chr12:7280781-7280888,chr12,7280781,7280888,0,4730314
HepG2|chr12:12136284-12136404,chr12,12136284,12136404,HepG2|chr12:7280783-7280820,chr12,7280783,7280820,0,4855501
HepG2|chr12:12227567-12227626,chr12,12227567,12227626,HepG2|chr12:7280783-7280862,chr12,7280783,7280862,0,4946784
HepG2|chr12:12389155-12389188,chr12,12389155,12389188,HepG2|chr12:7280783-7280879,chr12,7280783,7280879,0,5108372
HepG2|chr12:12498519-12498559,chr12,12498519,12498559,HepG2|chr12:7280783-7280824,chr12,7280783,7280824,0,5217736
HepG2|chr12:12643394-12643418,chr12,12643394,12643418,HepG2|chr12:7280783-7280808,chr12,7280783,7280808,0,5362611
HepG2|chr12:12714476-12714512,chr12,12714476,12714512,HepG2|chr12:7280783-7280813,chr12,7280783,7280813,0,5433693
HepG2|chr12:12751764-12751828,chr12,12751764,12751828,HepG2|chr12:7280783-7280854,chr12,7280783,7280854,0,5470981
HepG2|chr12:12758851-12758946,chr12,12758851,12758946,HepG2|chr12:7280783-7280815,chr12,7280783,7280815,0,5478068
HepG2|chr12:12837627-12837707,chr12,12837627,12837707,HepG2|chr12:7280783-7280851,chr12,7280783,7280851,0,5556844
HepG2|chr12:12999567-12999605,chr12,12999567,12999605,HepG2|chr12:7280783-7280883,chr12,7280783,7280883,0,5718784
HepG2|chr12:13057517-13057629,chr12,13057517,13057629,HepG2|chr12:7280783-7280815,chr12,7280783,7280815,0,5776734
HepG2|chr12:13556671-13556734,chr12,13556671,13556734,HepG2|chr12:866223-866367,chr12,866223,866367,0,12690448
HepG2|chr12:13779821-13779866,chr12,13779821,13779866,HepG2|chr12:7279525-7279630,chr12,7279525,7279630,0,6500296
HepG2|chr12:14173223-14173301,chr12,14173223,14173301,HepG2|chr12:7280783-7280854,chr12,7280783,7280854,0,6892440
HepG2|chr12:14371166-14371226,chr12,14371166,14371226,HepG2|chr12:7280783-7280883,chr12,7280783,7280883,0,7090383
HepG2|chr12:14413529-14413573,chr12,14413529,14413573,HepG2|chr12:7280781-7280883,chr12,7280781,7280883,0,7132748
HepG2|chr12:14483309-14483446,chr12,14483309,14483446,HepG2|chr12:122514211-122514290,chr12,122514211,122514290,0,108030902
HepG2|chr12:14735437-14735462,chr12,14735437,14735462,HepG2|chr12:7280783-7280881,chr12,7280783,7280881,0,7454654
HepG2|chr12:14745871-14745918,chr12,14745871,14745918,HepG2|chr12:7280783-7280854,chr12,7280783,7280854,0,7465088
HepG2|chr12:14805435-14805584,chr12,14805435,14805584,HepG2|chr12:7279525-7279630,chr12,7279525,7279630,0,7525910
HepG2|chr12:15059883-15059900,chr12,15059883,15059900,HepG2|chr12:7280783-7280854,chr12,7280783,7280854,0,7779100
HepG2|chr12:15060863-15060980,chr12,15060863,15060980,HepG2|chr12:7280783-7280887,chr12,7280783,7280887,0,7780080
HepG2|chr12:15363345-15363369,chr12,15363345,15363369,HepG2|chr12:7280783-7280808,chr12,7280783,7280808,0,8082562
HepG2|chr12:15791386-15791512,chr12,15791386,15791512,HepG2|chr12:7280783-7280853,chr12,7280783,7280853,0,8510603
HepG2|chr12:16122629-16122704,chr12,16122629,16122704,HepG2|chr12:7280783-7280857,chr12,7280783,7280857,0,8841846
HepG2|chr12:16275199-16275299,chr12,16275199,16275299,HepG2|chr12:7280783-7280833,chr12,7280783,7280833,0,8994416
HepG2|chr12:16604584-16604616,chr12,16604584,16604616,HepG2|chr12:7280783-7280854,chr12,7280783,7280854,0,9323801
HepG2|chr12:16765534-16765582,chr12,16765534,16765582,HepG2|chr12:53616208-53616266,chr12,53616208,53616266,0,36850674
HepG2|chr12:17052785-17052853,chr12,17052785,17052853,HepG2|chr12:7280783-7280865,chr12,7280783,7280865,0,9772002
HepG2|chr12:17177590-17177642,chr12,17177590,17177642,HepG2|chr12:7280783-7280878,chr12,7280783,7280878,0,9896807
HepG2|chr12:17813382-17813496,chr12,17813382,17813496,HepG2|chr12:7280783-7280818,chr12,7280783,7280818,0,10532599
HepG2|chr12:17849538-17849661,chr12,17849538,17849661,HepG2|chr12:27672896-27672917,chr12,27672896,27672917,0,9823358
HepG2|chr12:17937510-17937610,chr12,17937510,17937610,HepG2|chr12:7280783-7280808,chr12,7280783,7280808,0,10656727
HepG2|chr12:18128413-18128462,chr12,18128413,18128462,HepG2|chr12:7280783-7280883,chr12,7280783,7280883,0,10847630
HepG2|chr12:18143278-18143393,chr12,18143278,18143393,HepG2|chr12:14921872-14921938,chr12,14921872,14921938,0,3221406
HepG2|chr12:18634285-18634384,chr12,18634285,18634384,HepG2|chr12:123379344-123379395,chr12,123379344,123379395,0,104745059
HepG2|chr12:18730700-18730794,chr12,18730700,18730794,HepG2|chr12:7280783-7280839,chr12,7280783,7280839,0,11449917
HepG2|chr12:18878281-18878405,chr12,18878281,18878405,HepG2|chr12:7280783-7280809,chr12,7280783,7280809,0,11597498
HepG2|chr12:18909630-18909726,chr12,18909630,18909726,HepG2|chr12:7280783-7280884,chr12,7280783,7280884,0,11628847
HepG2|chr12:19106425-19106540,chr12,19106425,19106540,HepG2|chr12:7280783-7280854,chr12,7280783,7280854,0,11825642
HepG2|chr12:19374813-19374889,chr12,19374813,19374889,HepG2|chr12:14922833-14922935,chr12,14922833,14922935,0,4451980
HepG2|chr12:19527965-19528115,chr12,19527965,19528115,HepG2|chr12:46761317-46761363,chr12,46761317,46761363,0,27233352
HepG2|chr12:19530456-19530550,chr12,19530456,19530550,HepG2|chr12:7280783-7280839,chr12,7280783,7280839,0,12249673
HepG2|chr12:19621075-19621113,chr12,19621075,19621113,HepG2|chr12:14922833-14922935,chr12,14922833,14922935,0,4698242
HepG2|chr12:19637364-19637399,chr12,19637364,19637399,HepG2|chr12:7280783-7280818,chr12,7280783,7280818,0,12356581
HepG2|chr12:20294603-20294710,chr12,20294603,20294710,HepG2|chr12:7280783-7280884,chr12,7280783,7280884,0,13013820
HepG2|chr12:20412359-20412496,chr12,20412359,20412496,HepG2|chr12:122514211-122514290,chr12,122514211,122514290,0,102101852
HepG2|chr12:21549859-21549891,chr12,21549859,21549891,HepG2|chr12:7280783-7280854,chr12,7280783,7280854,0,14269076
HepG2|chr12:22141400-22141436,chr12,22141400,22141436,HepG2|chr12:7280783-7280886,chr12,7280783,7280886,0,14860617
HepG2|chr12:22473284-22473426,chr12,22473284,22473426,HepG2|chr12:7280783-7280874,chr12,7280783,7280874,0,15192501
HepG2|chr12:22619861-22619940,chr12,22619861,22619940,HepG2|chr12:7280783-7280851,chr12,7280783,7280851,0,15339078
HepG2|chr12:22659405-22659451,chr12,22659405,22659451,HepG2|chr12:7280783-7280884,chr12,7280783,7280884,0,15378622
HepG2|chr12:23084084-23084154,chr12,23084084,23084154,HepG2|chr12:6717126-6717187,chr12,6717126,6717187,0,16366958
HepG2|chr12:23221227-23221261,chr12,23221227,23221261,HepG2|chr12:7280783-7280809,chr12,7280783,7280809,0,15940444
HepG2|chr12:23484779-23484829,chr12,23484779,23484829,HepG2|chr12:7280783-7280878,chr12,7280783,7280878,0,16203996
HepG2|chr12:23539010-23539156,chr12,23539010,23539156,HepG2|chr12:89750717-89750746,chr12,89750717,89750746,0,66211707
HepG2|chr12:23557335-23557448,chr12,23557335,23557448,HepG2|chr12:31228007-31228152,chr12,31228007,31228152,0,7670672
HepG2|chr12:23886568-23886639,chr12,23886568,23886639,HepG2|chr12:124084050-124084200,chr12,124084050,124084200,0,100197482
HepG2|chr12:24402623-24402647,chr12,24402623,24402647,HepG2|chr12:7280783-7280807,chr12,7280783,7280807,0,17121840
HepG2|chr12:24865823-24865967,chr12,24865823,24865967,HepG2|chr12:7280783-7280819,chr12,7280783,7280819,0,17585040
HepG2|chr12:24936940-24936969,chr12,24936940,24936969,HepG2|chr12:46761938-46762059,chr12,46761938,46762059,0,21824998
HepG2|chr12:24951009-24951156,chr12,24951009,24951156,HepG2|chr12:7280783-7280818,chr12,7280783,7280818,0,17670226
HepG2|chr12:26163907-26163932,chr12,26163907,26163932,HepG2|chr12:7280783-7280881,chr12,7280783,7280881,0,18883124
HepG2|chr12:26294585-26294712,chr12,26294585,26294712,HepG2|chr12:7280783-7280847,chr12,7280783,7280847,0,19013802
HepG2|chr12:26332915-26333000,chr12,26332915,26333000,HepG2|chr12:7280783-7280847,chr12,7280783,7280847,0,19052132
HepG2|chr12:26466140-26466162,chr12,26466140,26466162,HepG2|chr12:53774610-53774724,chr12,53774610,53774724,0,27308470
HepG2|chr12:27336492-27336612,chr12,27336492,27336612,HepG2|chr12:51156342-51156446,chr12,51156342,51156446,0,23819850
HepG2|chr12:27339591-27339720,chr12,27339591,27339720,HepG2|chr12:7280783-7280804,chr12,7280783,7280804,0,20058808
HepG2|chr12:27686237-27686330,chr12,27686237,27686330,HepG2|chr12:7280783-7280818,chr12,7280783,7280818,0,20405454
HepG2|chr12:27748150-27748213,chr12,27748150,27748213,HepG2|chr12:7280783-7280870,chr12,7280783,7280870,0,20467367
HepG2|chr12:28193350-28193397,chr12,28193350,28193397,HepG2|chr12:7278377-7278480,chr12,7278377,7278480,0,20914973
HepG2|chr12:28341679-28341724,chr12,28341679,28341724,HepG2|chr12:7280783-7280854,chr12,7280783,7280854,0,21060896
HepG2|chr12:28993706-28993768,chr12,28993706,28993768,HepG2|chr12:6472084-6472172,chr12,6472084,6472172,0,22521622
HepG2|chr12:29014641-29014748,chr12,29014641,29014748,HepG2|chr12:89750783-89750933,chr12,89750783,89750933,0,60736142
HepG2|chr12:29109923-29110011,chr12,29109923,29110011,HepG2|chr12:7280783-7280808,chr12,7280783,7280808,0,21829140
HepG2|chr12:29136968-29137033,chr12,29136968,29137033,HepG2|chr12:7280783-7280854,chr12,7280783,7280854,0,21856185
HepG2|chr12:29209138-29209258,chr12,29209138,29209258,HepG2|chr12:7280781-7280815,chr12,7280781,7280815,0,21928357
HepG2|chr12:30083518-30083551,chr12,30083518,30083551,HepG2|chr12:7280783-7280879,chr12,7280783,7280879,0,22802735
HepG2|chr12:30172836-30172969,chr12,30172836,30172969,HepG2|chr12:7280783-7280847,chr12,7280783,7280847,0,22892053
HepG2|chr12:30332588-30332686,chr12,30332588,30332686,HepG2|chr12:7280783-7280881,chr12,7280783,7280881,0,23051805
HepG2|chr12:30445567-30445597,chr12,30445567,30445597,HepG2|chr12:14921872-14921943,chr12,14921872,14921943,0,15523695
HepG2|chr12:30476993-30477065,chr12,30476993,30477065,HepG2|chr12:56510569-56510647,chr12,56510569,56510647,0,26033576
HepG2|chr12:30902979-30903026,chr12,30902979,30903026,HepG2|chr12:7280783-7280883,chr12,7280783,7280883,0,23622196
HepG2|chr12:31097414-31097456,chr12,31097414,31097456,HepG2|chr12:7280783-7280847,chr12,7280783,7280847,0,23816631
HepG2|chr12:31183406-31183452,chr12,31183406,31183452,HepG2|chr12:7280783-7280878,chr12,7280783,7280878,0,23902623
HepG2|chr12:31900297-31900419,chr12,31900297,31900419,HepG2|chr12:7280783-7280857,chr12,7280783,7280857,0,24619514
HepG2|chr12:31983798-31983888,chr12,31983798,31983888,HepG2|chr12:7280781-7280810,chr12,7280781,7280810,0,24703017
HepG2|chr12:32287826-32287915,chr12,32287826,32287915,HepG2|chr12:56510579-56510613,chr12,56510579,56510613,0,24222753
HepG2|chr12:32679535-32679624,chr12,32679535,32679624,HepG2|chr12:56510579-56510613,chr12,56510579,56510613,0,23831044
HepG2|chr12:32833916-32833952,chr12,32833916,32833952,HepG2|chr12:12765944-12766094,chr12,12765944,12766094,0,20067972
HepG2|chr12:33005481-33005609,chr12,33005481,33005609,HepG2|chr12:7280781-7280802,chr12,7280781,7280802,0,25724700
HepG2|chr12:33125116-33125133,chr12,33125116,33125133,HepG2|chr12:7280783-7280818,chr12,7280783,7280818,0,25844333
HepG2|chr12:33489009-33489033,chr12,33489009,33489033,HepG2|chr12:7280783-7280807,chr12,7280783,7280807,0,26208226
HepG2|chr12:33619880-33619943,chr12,33619880,33619943,HepG2|chr12:866223-866367,chr12,866223,866367,0,32753657
HepG2|chr12:33627890-33627933,chr12,33627890,33627933,HepG2|chr12:7280783-7280884,chr12,7280783,7280884,0,26347107
HepG2|chr12:33843552-33843702,chr12,33843552,33843702,HepG2|chr12:7280783-7280871,chr12,7280783,7280871,0,26562769
HepG2|chr12:33961327-33961347,chr12,33961327,33961347,HepG2|chr12:7280783-7280850,chr12,7280783,7280850,0,26680544
HepG2|chr12:33997483-33997555,chr12,33997483,33997555,HepG2|chr12:7280783-7280854,chr12,7280783,7280854,0,26716700
HepG2|chr12:34183505-34183621,chr12,34183505,34183621,HepG2|chr12:7280783-7280808,chr12,7280783,7280808,0,26902722
HepG2|chr12:34338574-34338676,chr12,34338574,34338676,HepG2|chr12:7280252-7280402,chr12,7280252,7280402,0,27058322
HepG2|chr12:34578825-34578870,chr12,34578825,34578870,HepG2|chr12:7280783-7280847,chr12,7280783,7280847,0,27298042
HepG2|chr12:34598152-34598242,chr12,34598152,34598242,HepG2|chr12:7281215-7281362,chr12,7281215,7281362,0,27316937
HepG2|chr12:35055711-35055752,chr12,35055711,35055752,HepG2|chr12:7280783-7280853,chr12,7280783,7280853,0,27774928
HepG2|chr12:35271982-35272104,chr12,35271982,35272104,HepG2|chr12:7280783-7280811,chr12,7280783,7280811,0,27991199
HepG2|chr12:35388152-35388199,chr12,35388152,35388199,HepG2|chr12:7280781-7280883,chr12,7280781,7280883,0,28107371
HepG2|chr12:35538835-35538906,chr12,35538835,35538906,HepG2|chr12:124084050-124084200,chr12,124084050,124084200,0,88545215
HepG2|chr12:35647741-35647857,chr12,35647741,35647857,HepG2|chr12:51156342-51156440,chr12,51156342,51156440,0,15508601
HepG2|chr12:35876206-35876345,chr12,35876206,35876345,HepG2|chr12:7280783-7280815,chr12,7280783,7280815,0,28595423
HepG2|chr12:35974182-35974238,chr12,35974182,35974238,HepG2|chr12:7280783-7280851,chr12,7280783,7280851,0,28693399
HepG2|chr12:36488187-36488327,chr12,36488187,36488327,HepG2|chr12:7280783-7280883,chr12,7280783,7280883,0,29207404
HepG2|chr12:36561870-36562015,chr12,36561870,36562015,HepG2|chr12:7280783-7280804,chr12,7280783,7280804,0,29281087
HepG2|chr12:36699586-36699635,chr12,36699586,36699635,HepG2|chr12:7280783-7280883,chr12,7280783,7280883,0,29418803
HepG2|chr12:37030858-37030974,chr12,37030858,37030974,HepG2|chr12:7280783-7280808,chr12,7280783,7280808,0,29750075
HepG2|chr12:37611451-37611595,chr12,37611451,37611595,HepG2|chr12:7280783-7280809,chr12,7280783,7280809,0,30330668
HepG2|chr12:37615166-37615188,chr12,37615166,37615188,HepG2|chr12:7280781-7280824,chr12,7280781,7280824,0,30334385
HepG2|chr12:37653575-37653698,chr12,37653575,37653698,HepG2|chr12:7280783-7280808,chr12,7280783,7280808,0,30372792
HepG2|chr12:38060901-38060939,chr12,38060901,38060939,HepG2|chr12:7280783-7280847,chr12,7280783,7280847,0,30780118
HepG2|chr12:38503293-38503396,chr12,38503293,38503396,HepG2|chr12:7280781-7280847,chr12,7280781,7280847,0,31222512
HepG2|chr12:38521592-38521719,chr12,38521592,38521719,HepG2|chr12:14922833-14922856,chr12,14922833,14922856,0,23598759
HepG2|chr12:38655052-38655104,chr12,38655052,38655104,HepG2|chr12:51156342-51156446,chr12,51156342,51156446,0,12501290
HepG2|chr12:39264301-39264440,chr12,39264301,39264440,HepG2|chr12:7280783-7280804,chr12,7280783,7280804,0,31983518
HepG2|chr12:39366225-39366313,chr12,39366225,39366313,HepG2|chr12:7280783-7280808,chr12,7280783,7280808,0,32085442
HepG2|chr12:39768322-39768367,chr12,39768322,39768367,HepG2|chr12:7280783-7280808,chr12,7280783,7280808,0,32487539
HepG2|chr12:39915988-39916138,chr12,39915988,39916138,HepG2|chr12:89749493-89749531,chr12,89749493,89749531,0,49833505
HepG2|chr12:39936669-39936812,chr12,39936669,39936812,HepG2|chr12:7280783-7280824,chr12,7280783,7280824,0,32655886
HepG2|chr12:39970539-39970682,chr12,39970539,39970682,HepG2|chr12:7280783-7280808,chr12,7280783,7280808,0,32689756
HepG2|chr12:40023567-40023603,chr12,40023567,40023603,HepG2|chr12:7280783-7280810,chr12,7280783,7280810,0,32742784
HepG2|chr12:40057964-40058104,chr12,40057964,40058104,HepG2|chr12:7280783-7280883,chr12,7280783,7280883,0,32777181
HepG2|chr12:40218431-40218460,chr12,40218431,40218460,HepG2|chr12:7280783-7280817,chr12,7280783,7280817,0,32937648
HepG2|chr12:40365339-40365382,chr12,40365339,40365382,HepG2|chr12:7280783-7280805,chr12,7280783,7280805,0,33084556
HepG2|chr12:40397108-40397219,chr12,40397108,40397219,HepG2|chr12:7280783-7280805,chr12,7280783,7280805,0,33116325
HepG2|chr12:40461514-40461574,chr12,40461514,40461574,HepG2|chr12:7280783-7280810,chr12,7280783,7280810,0,33180731
HepG2|chr12:40485188-40485256,chr12,40485188,40485256,HepG2|chr12:122514211-122514290,chr12,122514211,122514290,0,82029023
HepG2|chr12:40526326-40526366,chr12,40526326,40526366,HepG2|chr12:7280783-7280879,chr12,7280783,7280879,0,33245543
HepG2|chr12:41001148-41001170,chr12,41001148,41001170,HepG2|chr12:7280783-7280883,chr12,7280783,7280883,0,33720365
HepG2|chr12:41630663-41630789,chr12,41630663,41630789,HepG2|chr12:7280783-7280853,chr12,7280783,7280853,0,34349880
HepG2|chr12:41718358-41718502,chr12,41718358,41718502,HepG2|chr12:7280783-7280809,chr12,7280783,7280809,0,34437575
HepG2|chr12:42224648-42224706,chr12,42224648,42224706,HepG2|chr12:7280783-7280872,chr12,7280783,7280872,0,34943865
HepG2|chr12:42366505-42366612,chr12,42366505,42366612,HepG2|chr12:64234473-64234490,chr12,64234473,64234490,0,21867968
HepG2|chr12:42473765-42473813,chr12,42473765,42473813,HepG2|chr12:7280783-7280862,chr12,7280783,7280862,0,35192982
HepG2|chr12:42755861-42755993,chr12,42755861,42755993,HepG2|chr12:7280783-7280810,chr12,7280783,7280810,0,35475078
HepG2|chr12:42762087-42762208,chr12,42762087,42762208,HepG2|chr12:6472126-6472155,chr12,6472126,6472155,0,36289961
HepG2|chr12:43572561-43572588,chr12,43572561,43572588,HepG2|chr12:7280783-7280847,chr12,7280783,7280847,0,36291778
HepG2|chr12:43871007-43871128,chr12,43871007,43871128,HepG2|chr12:89750717-89750746,chr12,89750717,89750746,0,45879710
HepG2|chr12:43933913-43933932,chr12,43933913,43933932,HepG2|chr12:7284140-7284228,chr12,7284140,7284228,0,36649773
HepG2|chr12:43943852-43943942,chr12,43943852,43943942,HepG2|chr12:7280783-7280884,chr12,7280783,7280884,0,36663069
HepG2|chr12:44156856-44156876,chr12,44156856,44156876,HepG2|chr12:7280783-7280803,chr12,7280783,7280803,0,36876073
HepG2|chr12:44364315-44364353,chr12,44364315,44364353,HepG2|chr12:7280783-7280809,chr12,7280783,7280809,0,37083532
HepG2|chr12:44499003-44499131,chr12,44499003,44499131,HepG2|chr12:7280783-7280805,chr12,7280783,7280805,0,37218220
HepG2|chr12:44601519-44601574,chr12,44601519,44601574,HepG2|chr12:7280783-7280878,chr12,7280783,7280878,0,37320736
HepG2|chr12:45212995-45213088,chr12,45212995,45213088,HepG2|chr12:46763200-46763237,chr12,46763200,46763237,0,1550205
HepG2|chr12:45487593-45487678,chr12,45487593,45487678,HepG2|chr12:7280783-7280878,chr12,7280783,7280878,0,38206810
HepG2|chr12:45537734-45537803,chr12,45537734,45537803,HepG2|chr12:7280783-7280864,chr12,7280783,7280864,0,38256951
HepG2|chr12:45651187-45651208,chr12,45651187,45651208,HepG2|chr12:7280783-7280883,chr12,7280783,7280883,0,38370404
HepG2|chr12:45708414-45708433,chr12,45708414,45708433,HepG2|chr12:7284487-7284605,chr12,7284487,7284605,0,38423927
HepG2|chr12:45756796-45756883,chr12,45756796,45756883,HepG2|chr12:7280783-7280816,chr12,7280783,7280816,0,38476013
HepG2|chr12:46459236-46459301,chr12,46459236,46459301,HepG2|chr12:7280783-7280854,chr12,7280783,7280854,0,39178453
HepG2|chr12:46464824-46464880,chr12,46464824,46464880,HepG2|chr12:89748812-89748906,chr12,89748812,89748906,0,43283988
HepG2|chr12:46485658-46485761,chr12,46485658,46485761,HepG2|chr12:7280781-7280847,chr12,7280781,7280847,0,39204877
HepG2|chr12:46559947-46559990,chr12,46559947,46559990,HepG2|chr12:53774590-53774728,chr12,53774590,53774728,0,7214643
HepG2|chr12:47462182-47462272,chr12,47462182,47462272,HepG2|chr12:7280783-7280857,chr12,7280783,7280857,0,40181399
HepG2|chr12:48217329-48217399,chr12,48217329,48217399,HepG2|chr12:7280783-7280883,chr12,7280783,7280883,0,40936546
HepG2|chr12:48302210-48302252,chr12,48302210,48302252,HepG2|chr12:7280783-7280849,chr12,7280783,7280849,0,41021427
HepG2|chr12:48780491-48780510,chr12,48780491,48780510,HepG2|chr12:7280755-7280888,chr12,7280755,7280888,0,41499736
HepG2|chr12:49131226-49131333,chr12,49131226,49131333,HepG2|chr12:7280783-7280884,chr12,7280783,7280884,0,41850443
HepG2|chr12:49376088-49376139,chr12,49376088,49376139,HepG2|chr12:7280786-7280846,chr12,7280786,7280846,0,42095302
HepG2|chr12:49505651-49505703,chr12,49505651,49505703,HepG2|chr12:7280783-7280810,chr12,7280783,7280810,0,42224868
HepG2|chr12:50671077-50671094,chr12,50671077,50671094,HepG2|chr12:7280783-7280818,chr12,7280783,7280818,0,43390294
HepG2|chr12:50770775-50770843,chr12,50770775,50770843,HepG2|chr12:122514211-122514290,chr12,122514211,122514290,0,71743436
HepG2|chr12:51337225-51337317,chr12,51337225,51337317,HepG2|chr12:53616208-53616266,chr12,53616208,53616266,0,2278983
HepG2|chr12:51355868-51355913,chr12,51355868,51355913,HepG2|chr12:7279525-7279630,chr12,7279525,7279630,0,44076343
HepG2|chr12:51723118-51723158,chr12,51723118,51723158,HepG2|chr12:7280783-7280879,chr12,7280783,7280879,0,44442335
HepG2|chr12:51866181-51866296,chr12,51866181,51866296,HepG2|chr12:31227657-31227729,chr12,31227657,31227729,0,20638524
HepG2|chr12:51890915-51891040,chr12,51890915,51891040,HepG2|chr12:31260514-31260539,chr12,31260514,31260539,0,20630401
HepG2|chr12:52405084-52405134,chr12,52405084,52405134,HepG2|chr12:14921872-14921938,chr12,14921872,14921938,0,37483212
HepG2|chr12:52601146-52601255,chr12,52601146,52601255,HepG2|chr12:89749493-89749531,chr12,89749493,89749531,0,37148347
HepG2|chr12:52768835-52768931,chr12,52768835,52768931,HepG2|chr12:7280781-7280834,chr12,7280781,7280834,0,45488054
HepG2|chr12:52919627-52919707,chr12,52919627,52919707,HepG2|chr12:7280783-7280851,chr12,7280783,7280851,0,45638844
HepG2|chr12:53106695-53106808,chr12,53106695,53106808,HepG2|chr12:76429392-76429462,chr12,76429392,76429462,0,23322697
HepG2|chr12:53346180-53346228,chr12,53346180,53346228,HepG2|chr12:7280783-7280862,chr12,7280783,7280862,0,46065397
HepG2|chr12:53472659-53472731,chr12,53472659,53472731,HepG2|chr12:56510569-56510647,chr12,56510569,56510647,0,3037910
HepG2|chr12:54268226-54268264,chr12,54268226,54268264,HepG2|chr12:7280783-7280883,chr12,7280783,7280883,0,46987443
HepG2|chr12:54448449-54448469,chr12,54448449,54448469,HepG2|chr12:7280783-7280818,chr12,7280783,7280818,0,47167666
HepG2|chr12:54707444-54707559,chr12,54707444,54707559,HepG2|chr12:31227657-31227729,chr12,31227657,31227729,0,23479787
HepG2|chr12:55087973-55088002,chr12,55087973,55088002,HepG2|chr12:54390378-54390522,chr12,54390378,54390522,0,697595
HepG2|chr12:55529842-55529899,chr12,55529842,55529899,HepG2|chr12:56394821-56394868,chr12,56394821,56394868,0,864979
HepG2|chr12:55712264-55712300,chr12,55712264,55712300,HepG2|chr12:7280783-7280886,chr12,7280783,7280886,0,48431481
HepG2|chr12:55714172-55714297,chr12,55714172,55714297,HepG2|chr12:7280783-7280808,chr12,7280783,7280808,0,48433389
HepG2|chr12:55889491-55889513,chr12,55889491,55889513,HepG2|chr12:14921872-14921943,chr12,14921872,14921943,0,40967619
HepG2|chr12:56198191-56198244,chr12,56198191,56198244,HepG2|chr12:7280783-7280878,chr12,7280783,7280878,0,48917408
HepG2|chr12:56571950-56572007,chr12,56571950,56572007,HepG2|chr12:56394821-56394868,chr12,56394821,56394868,0,177129
HepG2|chr12:56648651-56648681,chr12,56648651,56648681,HepG2|chr12:7280783-7280809,chr12,7280783,7280809,0,49367868
HepG2|chr12:56739195-56739282,chr12,56739195,56739282,HepG2|chr12:7280783-7280816,chr12,7280783,7280816,0,49458412
HepG2|chr12:56779221-56779337,chr12,56779221,56779337,HepG2|chr12:7280783-7280808,chr12,7280783,7280808,0,49498438
HepG2|chr12:56787785-56787836,chr12,56787785,56787836,HepG2|chr12:7280786-7280846,chr12,7280786,7280846,0,49506999
HepG2|chr12:57405259-57405348,chr12,57405259,57405348,HepG2|chr12:124085727-124085832,chr12,124085727,124085832,0,66680468
HepG2|chr12:57545644-57545753,chr12,57545644,57545753,HepG2|chr12:89749493-89749531,chr12,89749493,89749531,0,32203849
HepG2|chr12:57551712-57551776,chr12,57551712,57551776,HepG2|chr12:7280783-7280854,chr12,7280783,7280854,0,50270929
HepG2|chr12:57625063-57625127,chr12,57625063,57625127,HepG2|chr12:64234470-64234490,chr12,64234470,64234490,0,6609407
HepG2|chr12:57629908-57630009,chr12,57629908,57630009,HepG2|chr12:46761317-46761363,chr12,46761317,46761363,0,10868591
HepG2|chr12:57693460-57693573,chr12,57693460,57693573,HepG2|chr12:7280783-7280816,chr12,7280783,7280816,0,50412677
HepG2|chr12:57799843-57799861,chr12,57799843,57799861,HepG2|chr12:7280783-7280842,chr12,7280783,7280842,0,50519060
HepG2|chr12:58541164-58541287,chr12,58541164,58541287,HepG2|chr12:7280783-7280808,chr12,7280783,7280808,0,51260381
HepG2|chr12:58594409-58594448,chr12,58594409,58594448,HepG2|chr12:7280783-7280854,chr12,7280783,7280854,0,51313626
HepG2|chr12:59019878-59019967,chr12,59019878,59019967,HepG2|chr12:124085727-124085832,chr12,124085727,124085832,0,65065849
HepG2|chr12:59306930-59307051,chr12,59306930,59307051,HepG2|chr12:124085462-124085491,chr12,124085462,124085491,0,64778532
HepG2|chr12:59584985-59585052,chr12,59584985,59585052,HepG2|chr12:7280783-7280848,chr12,7280783,7280848,0,52304202
HepG2|chr12:59945556-59945600,chr12,59945556,59945600,HepG2|chr12:7280781-7280883,chr12,7280781,7280883,0,52664775
HepG2|chr12:60609574-60609661,chr12,60609574,60609661,HepG2|chr12:7280783-7280846,chr12,7280783,7280846,0,53328791
HepG2|chr12:60739990-60740075,chr12,60739990,60740075,HepG2|chr12:7278377-7278480,chr12,7278377,7278480,0,53461613
HepG2|chr12:61199134-61199220,chr12,61199134,61199220,HepG2|chr12:7280783-7280847,chr12,7280783,7280847,0,53918351
HepG2|chr12:61308244-61308323,chr12,61308244,61308323,HepG2|chr12:7280783-7280851,chr12,7280783,7280851,0,54027461
HepG2|chr12:61715680-61715725,chr12,61715680,61715725,HepG2|chr12:7280781-7280858,chr12,7280781,7280858,0,54434899
HepG2|chr12:61783489-61783546,chr12,61783489,61783546,HepG2|chr12:7280783-7280854,chr12,7280783,7280854,0,54502706
HepG2|chr12:61886897-61887011,chr12,61886897,61887011,HepG2|chr12:7280783-7280853,chr12,7280783,7280853,0,54606114
HepG2|chr12:61958208-61958237,chr12,61958208,61958237,HepG2|chr12:54390378-54390522,chr12,54390378,54390522,0,7567830
HepG2|chr12:61958303-61958426,chr12,61958303,61958426,HepG2|chr12:51422204-51422226,chr12,51422204,51422226,0,10536099
HepG2|chr12:62431158-62431227,chr12,62431158,62431227,HepG2|chr12:76432429-76432509,chr12,76432429,76432509,0,14001271
HepG2|chr12:62907810-62907938,chr12,62907810,62907938,HepG2|chr12:7280783-7280805,chr12,7280783,7280805,0,55627027
HepG2|chr12:63038136-63038208,chr12,63038136,63038208,HepG2|chr12:7280783-7280882,chr12,7280783,7280882,0,55757353
HepG2|chr12:63051426-63051576,chr12,63051426,63051576,HepG2|chr12:124085462-124085491,chr12,124085462,124085491,0,61034036
HepG2|chr12:63477680-63477774,chr12,63477680,63477774,HepG2|chr12:46763200-46763237,chr12,46763200,46763237,0,16714480
HepG2|chr12:63549311-63549358,chr12,63549311,63549358,HepG2|chr12:7280781-7280883,chr12,7280781,7280883,0,56268530
HepG2|chr12:63582454-63582558,chr12,63582454,63582558,HepG2|chr12:7280783-7280808,chr12,7280783,7280808,0,56301671
HepG2|chr12:63665555-63665594,chr12,63665555,63665594,HepG2|chr12:7280783-7280847,chr12,7280783,7280847,0,56384772
HepG2|chr12:63684745-63684838,chr12,63684745,63684838,HepG2|chr12:7280783-7280883,chr12,7280783,7280883,0,56403962
HepG2|chr12:63750544-63750599,chr12,63750544,63750599,HepG2|chr12:7280783-7280847,chr12,7280783,7280847,0,56469761
HepG2|chr12:63791099-63791181,chr12,63791099,63791181,HepG2|chr12:89749678-89749739,chr12,89749678,89749739,0,25958579
HepG2|chr12:63840853-63841001,chr12,63840853,63841001,HepG2|chr12:7280783-7280847,chr12,7280783,7280847,0,56560070
HepG2|chr12:63957230-63957298,chr12,63957230,63957298,HepG2|chr12:14922833-14922882,chr12,14922833,14922882,0,49034397
HepG2|chr12:64085397-64085484,chr12,64085397,64085484,HepG2|chr12:7280783-7280802,chr12,7280783,7280802,0,56804614
HepG2|chr12:64343076-64343207,chr12,64343076,64343207,HepG2|chr12:7280783-7280854,chr12,7280783,7280854,0,57062293
HepG2|chr12:64366049-64366081,chr12,64366049,64366081,HepG2|chr12:7280783-7280854,chr12,7280783,7280854,0,57085266
HepG2|chr12:64450996-64451141,chr12,64450996,64451141,HepG2|chr12:7280783-7280804,chr12,7280783,7280804,0,57170213
HepG2|chr12:64495013-64495044,chr12,64495013,64495044,HepG2|chr12:7280782-7280843,chr12,7280782,7280843,0,57214231
HepG2|chr12:65068191-65068257,chr12,65068191,65068257,HepG2|chr12:7280783-7280854,chr12,7280783,7280854,0,57787408
HepG2|chr12:65271367-65271436,chr12,65271367,65271436,HepG2|chr12:7280783-7280864,chr12,7280783,7280864,0,57990584
HepG2|chr12:65555530-65555642,chr12,65555530,65555642,HepG2|chr12:7280781-7280819,chr12,7280781,7280819,0,58274749
HepG2|chr12:65611525-65611570,chr12,65611525,65611570,HepG2|chr12:7280781-7280858,chr12,7280781,7280858,0,58330744
HepG2|chr12:65626154-65626215,chr12,65626154,65626215,HepG2|chr12:76429392-76429462,chr12,76429392,76429462,0,10803238
HepG2|chr12:65923840-65923941,chr12,65923840,65923941,HepG2|chr12:27672896-27672917,chr12,27672896,27672917,0,38250944
HepG2|chr12:65959724-65959786,chr12,65959724,65959786,HepG2|chr12:7280783-7280881,chr12,7280783,7280881,0,58678941
HepG2|chr12:66803045-66803189,chr12,66803045,66803189,HepG2|chr12:7280783-7280819,chr12,7280783,7280819,0,59522262
HepG2|chr12:66855500-66855571,chr12,66855500,66855571,HepG2|chr12:7280783-7280853,chr12,7280783,7280853,0,59574717
HepG2|chr12:67200629-67200716,chr12,67200629,67200716,HepG2|chr12:7280783-7280846,chr12,7280783,7280846,0,59919846
HepG2|chr12:67864103-67864152,chr12,67864103,67864152,HepG2|chr12:51418602-51418686,chr12,51418602,51418686,0,16445501
HepG2|chr12:68018120-68018174,chr12,68018120,68018174,HepG2|chr12:7280783-7280878,chr12,7280783,7280878,0,60737337
HepG2|chr12:68124088-68124118,chr12,68124088,68124118,HepG2|chr12:14921872-14921943,chr12,14921872,14921943,0,53202216
HepG2|chr12:68167722-68167753,chr12,68167722,68167753,HepG2|chr12:7280783-7280854,chr12,7280783,7280854,0,60886939
HepG2|chr12:68557996-68558017,chr12,68557996,68558017,HepG2|chr12:7280783-7280819,chr12,7280783,7280819,0,61277213
HepG2|chr12:68790350-68790399,chr12,68790350,68790399,HepG2|chr12:7280783-7280857,chr12,7280783,7280857,0,61509567
HepG2|chr12:69435986-69436104,chr12,69435986,69436104,HepG2|chr12:7280783-7280815,chr12,7280783,7280815,0,62155203
HepG2|chr12:70107771-70107855,chr12,70107771,70107855,HepG2|chr12:7280783-7280849,chr12,7280783,7280849,0,62826988
HepG2|chr12:70114877-70114898,chr12,70114877,70114898,HepG2|chr12:7280783-7280819,chr12,7280783,7280819,0,62834094
HepG2|chr12:70619780-70619930,chr12,70619780,70619930,HepG2|chr12:7280783-7280854,chr12,7280783,7280854,0,63338997
HepG2|chr12:71029027-71029148,chr12,71029027,71029148,HepG2|chr12:6472126-6472155,chr12,6472126,6472155,0,64556901
HepG2|chr12:71189775-71189833,chr12,71189775,71189833,HepG2|chr12:7280783-7280872,chr12,7280783,7280872,0,63908992
HepG2|chr12:71479370-71479481,chr12,71479370,71479481,HepG2|chr12:7280783-7280805,chr12,7280783,7280805,0,64198587
HepG2|chr12:71760169-71760289,chr12,71760169,71760289,HepG2|chr12:7280783-7280820,chr12,7280783,7280820,0,64479386
HepG2|chr12:71836966-71837087,chr12,71836966,71837087,HepG2|chr12:7280783-7280811,chr12,7280783,7280811,0,64556183
HepG2|chr12:71862755-71862845,chr12,71862755,71862845,HepG2|chr12:76432093-76432121,chr12,76432093,76432121,0,4569338
HepG2|chr12:71965232-71965337,chr12,71965232,71965337,HepG2|chr12:7280783-7280828,chr12,7280783,7280828,0,64684449
HepG2|chr12:72010695-72010755,chr12,72010695,72010755,HepG2|chr12:7280783-7280810,chr12,7280783,7280810,0,64729912
HepG2|chr12:72264855-72265005,chr12,72264855,72265005,HepG2|chr12:7280783-7280854,chr12,7280783,7280854,0,64984072
HepG2|chr12:72273843-72273917,chr12,72273843,72273917,HepG2|chr12:7280783-7280859,chr12,7280783,7280859,0,64993060
HepG2|chr12:72375667-72375708,chr12,72375667,72375708,HepG2|chr12:7280783-7280854,chr12,7280783,7280854,0,65094884
HepG2|chr12:73012852-73012882,chr12,73012852,73012882,HepG2|chr12:7280783-7280843,chr12,7280783,7280843,0,65732069
HepG2|chr12:73087529-73087581,chr12,73087529,73087581,HepG2|chr12:7280783-7280854,chr12,7280783,7280854,0,65806746
HepG2|chr12:73171431-73171482,chr12,73171431,73171482,HepG2|chr12:46761938-46762059,chr12,46761938,46762059,0,26409493
HepG2|chr12:73394581-73394628,chr12,73394581,73394628,HepG2|chr12:7280782-7280881,chr12,7280782,7280881,0,66113799
HepG2|chr12:73470199-73470315,chr12,73470199,73470315,HepG2|chr12:7280781-7280815,chr12,7280781,7280815,0,66189418
HepG2|chr12:73663659-73663683,chr12,73663659,73663683,HepG2|chr12:7280783-7280879,chr12,7280783,7280879,0,66382876
HepG2|chr12:73740715-73740865,chr12,73740715,73740865,HepG2|chr12:46761317-46761363,chr12,46761317,46761363,0,26979398
HepG2|chr12:76038719-76038836,chr12,76038719,76038836,HepG2|chr12:7280783-7280818,chr12,7280783,7280818,0,68757936
HepG2|chr12:76191407-76191523,chr12,76191407,76191523,HepG2|chr12:7280781-7280815,chr12,7280781,7280815,0,68910626
HepG2|chr12:76363631-76363723,chr12,76363631,76363723,HepG2|chr12:7280783-7280840,chr12,7280783,7280840,0,69082848
HepG2|chr12:76576390-76576518,chr12,76576390,76576518,HepG2|chr12:7280781-7280802,chr12,7280781,7280802,0,69295609
HepG2|chr12:76583890-76583980,chr12,76583890,76583980,HepG2|chr12:7280783-7280884,chr12,7280783,7280884,0,69303107
HepG2|chr12:77001398-77001513,chr12,77001398,77001513,HepG2|chr12:7280783-7280854,chr12,7280783,7280854,0,69720615
HepG2|chr12:77079492-77079641,chr12,77079492,77079641,HepG2|chr12:31228083-31228233,chr12,31228083,31228233,0,45851409
HepG2|chr12:77397824-77397873,chr12,77397824,77397873,HepG2|chr12:51418602-51418686,chr12,51418602,51418686,0,25979222
HepG2|chr12:77489453-77489484,chr12,77489453,77489484,HepG2|chr12:7280244-7280373,chr12,7280244,7280373,0,70209209
HepG2|chr12:77639712-77639804,chr12,77639712,77639804,HepG2|chr12:7280783-7280840,chr12,7280783,7280840,0,70358929
HepG2|chr12:77698934-77698990,chr12,77698934,77698990,HepG2|chr12:89748812-89748906,chr12,89748812,89748906,0,12049878
HepG2|chr12:77853324-77853344,chr12,77853324,77853344,HepG2|chr12:7280783-7280850,chr12,7280783,7280850,0,70572541
HepG2|chr12:77869433-77869467,chr12,77869433,77869467,HepG2|chr12:7280783-7280815,chr12,7280783,7280815,0,70588650
HepG2|chr12:77901135-77901243,chr12,77901135,77901243,HepG2|chr12:7280783-7280818,chr12,7280783,7280818,0,70620352
HepG2|chr12:78023625-78023739,chr12,78023625,78023739,HepG2|chr12:7280783-7280846,chr12,7280783,7280846,0,70742842
HepG2|chr12:78148739-78148805,chr12,78148739,78148805,HepG2|chr12:7280783-7280854,chr12,7280783,7280854,0,70867956
HepG2|chr12:78698511-78698601,chr12,78698511,78698601,HepG2|chr12:7280783-7280818,chr12,7280783,7280818,0,71417728
HepG2|chr12:78922859-78922899,chr12,78922859,78922899,HepG2|chr12:7280783-7280807,chr12,7280783,7280807,0,71642076
HepG2|chr12:78937437-78937506,chr12,78937437,78937506,HepG2|chr12:76432429-76432509,chr12,76432429,76432509,0,2505008
HepG2|chr12:79122420-79122540,chr12,79122420,79122540,HepG2|chr12:51156342-51156446,chr12,51156342,51156446,0,27966078
HepG2|chr12:79646823-79646948,chr12,79646823,79646948,HepG2|chr12:7280783-7280808,chr12,7280783,7280808,0,72366040
HepG2|chr12:79684896-79684941,chr12,79684896,79684941,HepG2|chr12:7280783-7280878,chr12,7280783,7280878,0,72404113
HepG2|chr12:79863162-79863230,chr12,79863162,79863230,HepG2|chr12:7280783-7280865,chr12,7280783,7280865,0,72582379
HepG2|chr12:80090463-80090483,chr12,80090463,80090483,HepG2|chr12:7280783-7280818,chr12,7280783,7280818,0,72809680
HepG2|chr12:80289329-80289420,chr12,80289329,80289420,HepG2|chr12:7280783-7280857,chr12,7280783,7280857,0,73008546
HepG2|chr12:80724171-80724243,chr12,80724171,80724243,HepG2|chr12:7280783-7280882,chr12,7280783,7280882,0,73443388
HepG2|chr12:80809151-80809201,chr12,80809151,80809201,HepG2|chr12:53774610-53774728,chr12,53774610,53774728,0,27034541
HepG2|chr12:80855748-80855800,chr12,80855748,80855800,HepG2|chr12:7280783-7280878,chr12,7280783,7280878,0,73574965
HepG2|chr12:81274908-81275022,chr12,81274908,81275022,HepG2|chr12:7280783-7280846,chr12,7280783,7280846,0,73994125
HepG2|chr12:81473458-81473505,chr12,81473458,81473505,HepG2|chr12:7280786-7280846,chr12,7280786,7280846,0,74192672
HepG2|chr12:81660594-81660658,chr12,81660594,81660658,HepG2|chr12:64234470-64234490,chr12,64234470,64234490,0,17426124
HepG2|chr12:81969638-81969687,chr12,81969638,81969687,HepG2|chr12:7280783-7280810,chr12,7280783,7280810,0,74688855
HepG2|chr12:82133798-82133917,chr12,82133798,82133917,HepG2|chr12:7280783-7280810,chr12,7280783,7280810,0,74853015
HepG2|chr12:82185652-82185696,chr12,82185652,82185696,HepG2|chr12:53774614-53774718,chr12,53774614,53774718,0,28411038
HepG2|chr12:82271624-82271773,chr12,82271624,82271773,HepG2|chr12:7279525-7279630,chr12,7279525,7279630,0,74992099
HepG2|chr12:82450908-82450988,chr12,82450908,82450988,HepG2|chr12:122512935-122512990,chr12,122512935,122512990,0,40062027
HepG2|chr12:82482006-82482131,chr12,82482006,82482131,HepG2|chr12:31260514-31260539,chr12,31260514,31260539,0,51221492
HepG2|chr12:83107339-83107394,chr12,83107339,83107394,HepG2|chr12:7280783-7280878,chr12,7280783,7280878,0,75826556
HepG2|chr12:83866345-83866385,chr12,83866345,83866385,HepG2|chr12:7280783-7280807,chr12,7280783,7280807,0,76585562
HepG2|chr12:84060324-84060376,chr12,84060324,84060376,HepG2|chr12:7280783-7280810,chr12,7280783,7280810,0,76779541
HepG2|chr12:84740719-84740828,chr12,84740719,84740828,HepG2|chr12:7280783-7280824,chr12,7280783,7280824,0,77459936
HepG2|chr12:84896356-84896406,chr12,84896356,84896406,HepG2|chr12:6721153-6721244,chr12,6721153,6721244,0,78175203
HepG2|chr12:84931263-84931304,chr12,84931263,84931304,HepG2|chr12:7280783-7280854,chr12,7280783,7280854,0,77650480
HepG2|chr12:85289808-85289928,chr12,85289808,85289928,HepG2|chr12:7280781-7280815,chr12,7280781,7280815,0,78009027
HepG2|chr12:85336616-85336760,chr12,85336616,85336760,HepG2|chr12:7280783-7280851,chr12,7280783,7280851,0,78055833
HepG2|chr12:85660253-85660307,chr12,85660253,85660307,HepG2|chr12:7280783-7280813,chr12,7280783,7280813,0,78379470
HepG2|chr12:85675254-85675343,chr12,85675254,85675343,HepG2|chr12:31798282-31798323,chr12,31798282,31798323,0,53876972
HepG2|chr12:85892935-85893055,chr12,85892935,85893055,HepG2|chr12:7280783-7280807,chr12,7280783,7280807,0,78612152
HepG2|chr12:86224108-86224214,chr12,86224108,86224214,HepG2|chr12:7280783-7280807,chr12,7280783,7280807,0,78943325
HepG2|chr12:86517867-86517886,chr12,86517867,86517886,HepG2|chr12:7284487-7284605,chr12,7284487,7284605,0,79233380
HepG2|chr12:86521019-86521109,chr12,86521019,86521109,HepG2|chr12:7280783-7280857,chr12,7280783,7280857,0,79240236
HepG2|chr12:86613278-86613376,chr12,86613278,86613376,HepG2|chr12:7280783-7280881,chr12,7280783,7280881,0,79332495
HepG2|chr12:86664209-86664321,chr12,86664209,86664321,HepG2|chr12:69201622-69201660,chr12,69201622,69201660,0,17462587
HepG2|chr12:86938265-86938335,chr12,86938265,86938335,HepG2|chr12:7280783-7280883,chr12,7280783,7280883,0,79657482
HepG2|chr12:87018674-87018767,chr12,87018674,87018767,HepG2|chr12:7280783-7280883,chr12,7280783,7280883,0,79737891
HepG2|chr12:87327144-87327173,chr12,87327144,87327173,HepG2|chr12:7280783-7280883,chr12,7280783,7280883,0,80046361
HepG2|chr12:88107363-88107453,chr12,88107363,88107453,HepG2|chr12:7281215-7281362,chr12,7281215,7281362,0,80826148
HepG2|chr12:88392801-88392849,chr12,88392801,88392849,HepG2|chr12:53616208-53616266,chr12,53616208,53616266,0,34776593
HepG2|chr12:89273973-89274027,chr12,89273973,89274027,HepG2|chr12:7280783-7280813,chr12,7280783,7280813,0,81993190
HepG2|chr12:89640589-89640712,chr12,89640589,89640712,HepG2|chr12:7280783-7280810,chr12,7280783,7280810,0,82359806
HepG2|chr12:89641408-89641492,chr12,89641408,89641492,HepG2|chr12:7280781-7280847,chr12,7280781,7280847,0,82360627
HepG2|chr12:89902508-89902553,chr12,89902508,89902553,HepG2|chr12:7280783-7280808,chr12,7280783,7280808,0,82621725
HepG2|chr12:89992277-89992321,chr12,89992277,89992321,HepG2|chr12:53774614-53774718,chr12,53774614,53774718,0,36217663
HepG2|chr12:90856793-90856842,chr12,90856793,90856842,HepG2|chr12:7280783-7280857,chr12,7280783,7280857,0,83576010
HepG2|chr12:91310421-91310464,chr12,91310421,91310464,HepG2|chr12:53774590-53774728,chr12,53774590,53774728,0,37535831
HepG2|chr12:91552443-91552592,chr12,91552443,91552592,HepG2|chr12:6492421-6492571,chr12,6492421,6492571,0,85060022
HepG2|chr12:91669363-91669419,chr12,91669363,91669419,HepG2|chr12:7280783-7280851,chr12,7280783,7280851,0,84388580
HepG2|chr12:91886175-91886276,chr12,91886175,91886276,HepG2|chr12:27672896-27672917,chr12,27672896,27672917,0,64213279
HepG2|chr12:91888548-91888575,chr12,91888548,91888575,HepG2|chr12:7280783-7280884,chr12,7280783,7280884,0,84607765
HepG2|chr12:92082982-92083099,chr12,92082982,92083099,HepG2|chr12:7280783-7280818,chr12,7280783,7280818,0,84802199
HepG2|chr12:92263127-92263150,chr12,92263127,92263150,HepG2|chr12:7280783-7280847,chr12,7280783,7280847,0,84982344
HepG2|chr12:92451515-92451628,chr12,92451515,92451628,HepG2|chr12:7280783-7280820,chr12,7280783,7280820,0,85170732
HepG2|chr12:92482694-92482806,chr12,92482694,92482806,HepG2|chr12:7280783-7280854,chr12,7280783,7280854,0,85201911
HepG2|chr12:92571529-92571599,chr12,92571529,92571599,HepG2|chr12:6717126-6717187,chr12,6717126,6717187,0,85854403
HepG2|chr12:92904429-92904541,chr12,92904429,92904541,HepG2|chr12:69201622-69201660,chr12,69201622,69201660,0,23702807
HepG2|chr12:92938614-92938669,chr12,92938614,92938669,HepG2|chr12:7280783-7280847,chr12,7280783,7280847,0,85657831
HepG2|chr12:92984181-92984271,chr12,92984181,92984271,HepG2|chr12:7280783-7280818,chr12,7280783,7280818,0,85703398
HepG2|chr12:92989937-92989955,chr12,92989937,92989955,HepG2|chr12:7280783-7280842,chr12,7280783,7280842,0,85709154
HepG2|chr12:93377957-93378050,chr12,93377957,93378050,HepG2|chr12:7280783-7280818,chr12,7280783,7280818,0,86097174
HepG2|chr12:93470795-93470912,chr12,93470795,93470912,HepG2|chr12:7280783-7280887,chr12,7280783,7280887,0,86190012
HepG2|chr12:93508801-93508886,chr12,93508801,93508886,HepG2|chr12:7278377-7278480,chr12,7278377,7278480,0,86230424
HepG2|chr12:93551957-93552042,chr12,93551957,93552042,HepG2|chr12:7280783-7280878,chr12,7280783,7280878,0,86271174
HepG2|chr12:94195720-94195763,chr12,94195720,94195763,HepG2|chr12:7280783-7280851,chr12,7280783,7280851,0,86914937
HepG2|chr12:94389772-94389884,chr12,94389772,94389884,HepG2|chr12:7280783-7280815,chr12,7280783,7280815,0,87108989
HepG2|chr12:94876865-94876909,chr12,94876865,94876909,HepG2|chr12:7280783-7280884,chr12,7280783,7280884,0,87596082
HepG2|chr12:95311149-95311170,chr12,95311149,95311170,HepG2|chr12:7280783-7280883,chr12,7280783,7280883,0,88030366
HepG2|chr12:95351821-95351847,chr12,95351821,95351847,HepG2|chr12:7280980-7281130,chr12,7280980,7281130,0,88070841
HepG2|chr12:95578408-95578521,chr12,95578408,95578521,HepG2|chr12:7280783-7280820,chr12,7280783,7280820,0,88297625
HepG2|chr12:95641651-95641746,chr12,95641651,95641746,HepG2|chr12:7280783-7280815,chr12,7280783,7280815,0,88360868
HepG2|chr12:95912953-95913103,chr12,95912953,95913103,HepG2|chr12:7280783-7280815,chr12,7280783,7280815,0,88632170
HepG2|chr12:96184536-96184657,chr12,96184536,96184657,HepG2|chr12:7280783-7280811,chr12,7280783,7280811,0,88903753
HepG2|chr12:96531854-96531944,chr12,96531854,96531944,HepG2|chr12:7280781-7280810,chr12,7280781,7280810,0,89251073
HepG2|chr12:96567611-96567711,chr12,96567611,96567711,HepG2|chr12:7280783-7280833,chr12,7280783,7280833,0,89286828
HepG2|chr12:96669240-96669284,chr12,96669240,96669284,HepG2|chr12:7280783-7280878,chr12,7280783,7280878,0,89388457
HepG2|chr12:96753103-96753174,chr12,96753103,96753174,HepG2|chr12:7280783-7280853,chr12,7280783,7280853,0,89472320
HepG2|chr12:96779416-96779520,chr12,96779416,96779520,HepG2|chr12:7280783-7280808,chr12,7280783,7280808,0,89498633
HepG2|chr12:97460320-97460337,chr12,97460320,97460337,HepG2|chr12:69201634-69201780,chr12,69201634,69201780,0,28258686
HepG2|chr12:98294581-98294705,chr12,98294581,98294705,HepG2|chr12:7280783-7280809,chr12,7280783,7280809,0,91013798
HepG2|chr12:98374730-98374774,chr12,98374730,98374774,HepG2|chr12:7280783-7280884,chr12,7280783,7280884,0,91093947
HepG2|chr12:98742630-98742712,chr12,98742630,98742712,HepG2|chr12:7280783-7280849,chr12,7280783,7280849,0,91461847
HepG2|chr12:99139768-99139876,chr12,99139768,99139876,HepG2|chr12:7280783-7280818,chr12,7280783,7280818,0,91858985
HepG2|chr12:99173182-99173227,chr12,99173182,99173227,HepG2|chr12:7280783-7280854,chr12,7280783,7280854,0,91892399
HepG2|chr12:99360937-99361043,chr12,99360937,99361043,HepG2|chr12:7280783-7280807,chr12,7280783,7280807,0,92080154
HepG2|chr12:99427545-99427658,chr12,99427545,99427658,HepG2|chr12:31228007-31228152,chr12,31228007,31228152,0,68199538
HepG2|chr12:99530586-99530719,chr12,99530586,99530719,HepG2|chr12:7280783-7280847,chr12,7280783,7280847,0,92249803
HepG2|chr12:99697856-99697975,chr12,99697856,99697975,HepG2|chr12:6472126-6472157,chr12,6472126,6472157,0,93225730
HepG2|chr12:100097076-100097138,chr12,100097076,100097138,HepG2|chr12:6472084-6472172,chr12,6472084,6472172,0,93624992
HepG2|chr12:100245416-100245515,chr12,100245416,100245515,HepG2|chr12:7280783-7280854,chr12,7280783,7280854,0,92964633
HepG2|chr12:100340231-100340261,chr12,100340231,100340261,HepG2|chr12:7280783-7280843,chr12,7280783,7280843,0,93059448
HepG2|chr12:100559138-100559230,chr12,100559138,100559230,HepG2|chr12:53616208-53616266,chr12,53616208,53616266,0,46942930
HepG2|chr12:101158927-101158950,chr12,101158927,101158950,HepG2|chr12:7280783-7280882,chr12,7280783,7280882,0,93878144
HepG2|chr12:101477701-101477774,chr12,101477701,101477774,HepG2|chr12:7280783-7280878,chr12,7280783,7280878,0,94196918
HepG2|chr12:102024919-102025068,chr12,102024919,102025068,HepG2|chr12:31228083-31228233,chr12,31228083,31228233,0,70796836
HepG2|chr12:102054221-102054275,chr12,102054221,102054275,HepG2|chr12:7280783-7280853,chr12,7280783,7280853,0,94773438
HepG2|chr12:102370256-102370331,chr12,102370256,102370331,HepG2|chr12:7280783-7280857,chr12,7280783,7280857,0,95089473
HepG2|chr12:103302361-103302413,chr12,103302361,103302413,HepG2|chr12:7280783-7280854,chr12,7280783,7280854,0,96021578
HepG2|chr12:103614033-103614177,chr12,103614033,103614177,HepG2|chr12:14922833-14922856,chr12,14922833,14922856,0,88691200
HepG2|chr12:103648557-103648627,chr12,103648557,103648627,HepG2|chr12:7280783-7280854,chr12,7280783,7280854,0,96367774
HepG2|chr12:103672246-103672323,chr12,103672246,103672323,HepG2|chr12:7280783-7280854,chr12,7280783,7280854,0,96391463
HepG2|chr12:103782345-103782388,chr12,103782345,103782388,HepG2|chr12:7280783-7280851,chr12,7280783,7280851,0,96501562
HepG2|chr12:103810515-103810608,chr12,103810515,103810608,HepG2|chr12:46763200-46763237,chr12,46763200,46763237,0,57047315
HepG2|chr12:103914229-103914341,chr12,103914229,103914341,HepG2|chr12:7280781-7280819,chr12,7280781,7280819,0,96633448
HepG2|chr12:103963186-103963240,chr12,103963186,103963240,HepG2|chr12:7280783-7280878,chr12,7280783,7280878,0,96682403
HepG2|chr12:104094732-104094814,chr12,104094732,104094814,HepG2|chr12:89749678-89749739,chr12,89749678,89749739,0,14345054
HepG2|chr12:104212058-104212100,chr12,104212058,104212100,HepG2|chr12:7280783-7280847,chr12,7280783,7280847,0,96931275
HepG2|chr12:104234051-104234133,chr12,104234051,104234133,HepG2|chr12:7280783-7280849,chr12,7280783,7280849,0,96953268
HepG2|chr12:104279209-104279272,chr12,104279209,104279272,HepG2|chr12:7280783-7280870,chr12,7280783,7280870,0,96998426
HepG2|chr12:104332041-104332101,chr12,104332041,104332101,HepG2|chr12:7280783-7280883,chr12,7280783,7280883,0,97051258
HepG2|chr12:104642843-104642862,chr12,104642843,104642862,HepG2|chr12:7284140-7284228,chr12,7284140,7284228,0,97358703
HepG2|chr12:104928765-104928794,chr12,104928765,104928794,HepG2|chr12:46761938-46762059,chr12,46761938,46762059,0,58166827
HepG2|chr12:105483290-105483335,chr12,105483290,105483335,HepG2|chr12:7280783-7280878,chr12,7280783,7280878,0,98202507
HepG2|chr12:105782625-105782647,chr12,105782625,105782647,HepG2|chr12:14921872-14921943,chr12,14921872,14921943,0,90860753
HepG2|chr12:105930215-105930337,chr12,105930215,105930337,HepG2|chr12:7280783-7280811,chr12,7280783,7280811,0,98649432
HepG2|chr12:106072882-106073012,chr12,106072882,106073012,HepG2|chr12:7280783-7280878,chr12,7280783,7280878,0,98792099
HepG2|chr12:106301296-106301396,chr12,106301296,106301396,HepG2|chr12:7280783-7280808,chr12,7280783,7280808,0,99020513
HepG2|chr12:106449780-106449926,chr12,106449780,106449926,HepG2|chr12:89750717-89750746,chr12,89750717,89750746,0,16699063
HepG2|chr12:106569791-106569837,chr12,106569791,106569837,HepG2|chr12:7280783-7280878,chr12,7280783,7280878,0,99289008
HepG2|chr12:106729292-106729363,chr12,106729292,106729363,HepG2|chr12:7280783-7280808,chr12,7280783,7280808,0,99448509
HepG2|chr12:106776680-106776742,chr12,106776680,106776742,HepG2|chr12:7280783-7280853,chr12,7280783,7280853,0,99495897
HepG2|chr12:107006707-107006768,chr12,107006707,107006768,HepG2|chr12:76432623-76432773,chr12,76432623,76432773,0,30574084
HepG2|chr12:107199778-107199928,chr12,107199778,107199928,HepG2|chr12:7280783-7280815,chr12,7280783,7280815,0,99918995
HepG2|chr12:107300095-107300245,chr12,107300095,107300245,HepG2|chr12:7280783-7280871,chr12,7280783,7280871,0,100019312
HepG2|chr12:107725297-107725434,chr12,107725297,107725434,HepG2|chr12:69201671-69201821,chr12,69201671,69201821,0,38523626
HepG2|chr12:107763092-107763162,chr12,107763092,107763162,HepG2|chr12:7280783-7280879,chr12,7280783,7280879,0,100482309
HepG2|chr12:107894800-107894843,chr12,107894800,107894843,HepG2|chr12:7280781-7280888,chr12,7280781,7280888,0,100614019
HepG2|chr12:108133538-108133686,chr12,108133538,108133686,HepG2|chr12:7280783-7280847,chr12,7280783,7280847,0,100852755
HepG2|chr12:108254524-108254628,chr12,108254524,108254628,HepG2|chr12:124085916-124085947,chr12,124085916,124085947,0,15831392
HepG2|chr12:108372320-108372442,chr12,108372320,108372442,HepG2|chr12:7280783-7280857,chr12,7280783,7280857,0,101091537
HepG2|chr12:108568533-108568624,chr12,108568533,108568624,HepG2|chr12:7280783-7280857,chr12,7280783,7280857,0,101287750
HepG2|chr12:108709059-108709186,chr12,108709059,108709186,HepG2|chr12:14922833-14922856,chr12,14922833,14922856,0,93786226
HepG2|chr12:108985786-108985923,chr12,108985786,108985923,HepG2|chr12:52444493-52444634,chr12,52444493,52444634,0,56541293
HepG2|chr12:109066138-109066162,chr12,109066138,109066162,HepG2|chr12:7280783-7280879,chr12,7280783,7280879,0,101785355
HepG2|chr12:109558126-109558203,chr12,109558126,109558203,HepG2|chr12:7280783-7280854,chr12,7280783,7280854,0,102277343
HepG2|chr12:109575716-109575861,chr12,109575716,109575861,HepG2|chr12:7280783-7280810,chr12,7280783,7280810,0,102294933
HepG2|chr12:109599413-109599463,chr12,109599413,109599463,HepG2|chr12:53774610-53774728,chr12,53774610,53774728,0,55824803
HepG2|chr12:110011938-110012069,chr12,110011938,110012069,HepG2|chr12:7280783-7280854,chr12,7280783,7280854,0,102731155
HepG2|chr12:110340259-110340360,chr12,110340259,110340360,HepG2|chr12:7280783-7280832,chr12,7280783,7280832,0,103059476
HepG2|chr12:110485095-110485245,chr12,110485095,110485245,HepG2|chr12:124085462-124085491,chr12,124085462,124085491,0,13600367
HepG2|chr12:110729547-110729596,chr12,110729547,110729596,HepG2|chr12:7280783-7280878,chr12,7280783,7280878,0,103448764
HepG2|chr12:110972836-110972980,chr12,110972836,110972980,HepG2|chr12:7280783-7280851,chr12,7280783,7280851,0,103692053
HepG2|chr12:111228067-111228156,chr12,111228067,111228156,HepG2|chr12:76432093-76432121,chr12,76432093,76432121,0,34795974
HepG2|chr12:111301424-111301471,chr12,111301424,111301471,HepG2|chr12:7278377-7278480,chr12,7278377,7278480,0,104023047
HepG2|chr12:111408694-111408767,chr12,111408694,111408767,HepG2|chr12:7280783-7280878,chr12,7280783,7280878,0,104127911
HepG2|chr12:111503750-111503876,chr12,111503750,111503876,HepG2|chr12:7280783-7280807,chr12,7280783,7280807,0,104222967
HepG2|chr12:111653107-111653157,chr12,111653107,111653157,HepG2|chr12:7280783-7280878,chr12,7280783,7280878,0,104372324
HepG2|chr12:111988733-111988750,chr12,111988733,111988750,HepG2|chr12:7280783-7280854,chr12,7280783,7280854,0,104707950
HepG2|chr12:112174282-112174301,chr12,112174282,112174301,HepG2|chr12:7280755-7280888,chr12,7280755,7280888,0,104893527
HepG2|chr12:112177910-112178004,chr12,112177910,112178004,HepG2|chr12:89748812-89748906,chr12,89748812,89748906,0,22429098
HepG2|chr12:112192631-112192744,chr12,112192631,112192744,HepG2|chr12:76429392-76429462,chr12,76429392,76429462,0,35763239
HepG2|chr12:112279242-112279332,chr12,112279242,112279332,HepG2|chr12:76432093-76432121,chr12,76432093,76432121,0,35847149
HepG2|chr12:112452261-112452339,chr12,112452261,112452339,HepG2|chr12:7280783-7280854,chr12,7280783,7280854,0,105171478
HepG2|chr12:112819849-112819894,chr12,112819849,112819894,HepG2|chr12:124085727-124085832,chr12,124085727,124085832,0,11265878
HepG2|chr12:113023326-113023377,chr12,113023326,113023377,HepG2|chr12:46761938-46762059,chr12,46761938,46762059,0,66261388
HepG2|chr12:113385669-113385750,chr12,113385669,113385750,HepG2|chr12:7280783-7280857,chr12,7280783,7280857,0,106104886
HepG2|chr12:113538574-113538711,chr12,113538574,113538711,HepG2|chr12:52444493-52444634,chr12,52444493,52444634,0,61094081
HepG2|chr12:113779078-113779227,chr12,113779078,113779227,HepG2|chr12:31259982-31260132,chr12,31259982,31260132,0,82519096
HepG2|chr12:114272103-114272245,chr12,114272103,114272245,HepG2|chr12:7280783-7280874,chr12,7280783,7280874,0,106991320
HepG2|chr12:114649188-114649228,chr12,114649188,114649228,HepG2|chr12:7280783-7280824,chr12,7280783,7280824,0,107368405
HepG2|chr12:114806289-114806372,chr12,114806289,114806372,HepG2|chr12:7280783-7280851,chr12,7280783,7280851,0,107525506
HepG2|chr12:114960010-114960080,chr12,114960010,114960080,HepG2|chr12:7280783-7280854,chr12,7280783,7280854,0,107679227
HepG2|chr12:115094166-115094285,chr12,115094166,115094285,HepG2|chr12:7280783-7280810,chr12,7280783,7280810,0,107813383
HepG2|chr12:115328869-115328971,chr12,115328869,115328971,HepG2|chr12:7280252-7280402,chr12,7280252,7280402,0,108048617
HepG2|chr12:115459114-115459263,chr12,115459114,115459263,HepG2|chr12:6492421-6492571,chr12,6492421,6492571,0,108966693
HepG2|chr12:115478409-115478461,chr12,115478409,115478461,HepG2|chr12:51156342-51156446,chr12,51156342,51156446,0,64322067
HepG2|chr12:115855759-115855843,chr12,115855759,115855843,HepG2|chr12:14921872-14921938,chr12,14921872,14921938,0,100933887
HepG2|chr12:115891348-115891393,chr12,115891348,115891393,HepG2|chr12:7280783-7280847,chr12,7280783,7280847,0,108610565
HepG2|chr12:116249223-116249344,chr12,116249223,116249344,HepG2|chr12:124085462-124085491,chr12,124085462,124085491,0,7836239
HepG2|chr12:116634552-116634638,chr12,116634552,116634638,HepG2|chr12:7280783-7280847,chr12,7280783,7280847,0,109353769
HepG2|chr12:116710578-116710629,chr12,116710578,116710629,HepG2|chr12:7280783-7280854,chr12,7280783,7280854,0,109429795
HepG2|chr12:116794821-116794950,chr12,116794821,116794950,HepG2|chr12:7280783-7280804,chr12,7280783,7280804,0,109514038
HepG2|chr12:116961954-116961999,chr12,116961954,116961999,HepG2|chr12:7280783-7280808,chr12,7280783,7280808,0,109681171
HepG2|chr12:116969539-116969601,chr12,116969539,116969601,HepG2|chr12:7280783-7280853,chr12,7280783,7280853,0,109688756
HepG2|chr12:117155004-117155148,chr12,117155004,117155148,HepG2|chr12:14922833-14922856,chr12,14922833,14922856,0,102232171
HepG2|chr12:117231658-117231683,chr12,117231658,117231683,HepG2|chr12:7280783-7280814,chr12,7280783,7280814,0,109950875
HepG2|chr12:117279804-117279834,chr12,117279804,117279834,HepG2|chr12:7280783-7280809,chr12,7280783,7280809,0,109999021
HepG2|chr12:117556850-117556867,chr12,117556850,117556867,HepG2|chr12:69201634-69201780,chr12,69201634,69201780,0,48355216
HepG2|chr12:118059138-118059234,chr12,118059138,118059234,HepG2|chr12:7280781-7280834,chr12,7280781,7280834,0,110778357
HepG2|chr12:118399090-118399186,chr12,118399090,118399186,HepG2|chr12:7280783-7280883,chr12,7280783,7280883,0,111118307
HepG2|chr12:118565654-118565775,chr12,118565654,118565775,HepG2|chr12:89750717-89750746,chr12,89750717,89750746,0,28814937
HepG2|chr12:118698829-118698909,chr12,118698829,118698909,HepG2|chr12:122512935-122512990,chr12,122512935,122512990,0,3814106
HepG2|chr12:118774815-118774958,chr12,118774815,118774958,HepG2|chr12:7280783-7280808,chr12,7280783,7280808,0,111494032
HepG2|chr12:118836600-118836623,chr12,118836600,118836623,HepG2|chr12:7280783-7280882,chr12,7280783,7280882,0,111555817
HepG2|chr12:119079756-119079801,chr12,119079756,119079801,HepG2|chr12:124085727-124085832,chr12,124085727,124085832,0,5005971
HepG2|chr12:119363467-119363571,chr12,119363467,119363571,HepG2|chr12:124085916-124085947,chr12,124085916,124085947,0,4722449
HepG2|chr12:119602718-119602844,chr12,119602718,119602844,HepG2|chr12:7280783-7280807,chr12,7280783,7280807,0,112321935
HepG2|chr12:119623214-119623256,chr12,119623214,119623256,HepG2|chr12:7280783-7280849,chr12,7280783,7280849,0,112342431
HepG2|chr12:119757259-119757373,chr12,119757259,119757373,HepG2|chr12:7280783-7280818,chr12,7280783,7280818,0,112476476
HepG2|chr12:119787664-119787742,chr12,119787664,119787742,HepG2|chr12:124085659-124085809,chr12,124085659,124085809,0,4297995
HepG2|chr12:119944060-119944161,chr12,119944060,119944161,HepG2|chr12:46761317-46761363,chr12,46761317,46761363,0,73182743
HepG2|chr12:119947445-119947519,chr12,119947445,119947519,HepG2|chr12:7280783-7280859,chr12,7280783,7280859,0,112666662
HepG2|chr12:119997908-119997955,chr12,119997908,119997955,HepG2|chr12:7280783-7280854,chr12,7280783,7280854,0,112717125
HepG2|chr12:120153332-120153481,chr12,120153332,120153481,HepG2|chr12:31259982-31260132,chr12,31259982,31260132,0,88893350
HepG2|chr12:120428215-120428348,chr12,120428215,120428348,HepG2|chr12:7280783-7280878,chr12,7280783,7280878,0,113147432
HepG2|chr12:120490013-120490062,chr12,120490013,120490062,HepG2|chr12:7280783-7280878,chr12,7280783,7280878,0,113209230
HepG2|chr12:120922248-120922298,chr12,120922248,120922298,HepG2|chr12:6721153-6721244,chr12,6721153,6721244,0,114201095
HepG2|chr12:121048712-121048744,chr12,121048712,121048744,HepG2|chr12:7280783-7280854,chr12,7280783,7280854,0,113767929
HepG2|chr12:121296069-121296181,chr12,121296069,121296181,HepG2|chr12:31798282-31798324,chr12,31798282,31798324,0,89497787
HepG2|chr12:121316194-121316281,chr12,121316194,121316281,HepG2|chr12:7280783-7280802,chr12,7280783,7280802,0,114035411
HepG2|chr12:121320297-121320358,chr12,121320297,121320358,HepG2|chr12:7280783-7280851,chr12,7280783,7280851,0,114039514
HepG2|chr12:121335630-121335719,chr12,121335630,121335719,HepG2|chr12:31798282-31798323,chr12,31798282,31798323,0,89537348
HepG2|chr12:121373383-121373451,chr12,121373383,121373451,HepG2|chr12:6717126-6717187,chr12,6717126,6717187,0,114656257
HepG2|chr12:121611825-121611924,chr12,121611825,121611924,HepG2|chr12:7280783-7280854,chr12,7280783,7280854,0,114331042
HepG2|chr12:121618022-121618116,chr12,121618022,121618116,HepG2|chr12:46763200-46763237,chr12,46763200,46763237,0,74854822
HepG2|chr12:121935959-121936002,chr12,121935959,121936002,HepG2|chr12:7280783-7280805,chr12,7280783,7280805,0,114655176
HepG2|chr12:122066828-122066978,chr12,122066828,122066978,HepG2|chr12:123379344-123379395,chr12,123379344,123379395,0,1312516
HepG2|chr12:122090972-122091001,chr12,122090972,122091001,HepG2|chr12:7280783-7280883,chr12,7280783,7280883,0,114810189
HepG2|chr12:122204821-122204917,chr12,122204821,122204917,HepG2|chr12:7280783-7280883,chr12,7280783,7280883,0,114924038
HepG2|chr12:122389181-122389320,chr12,122389181,122389320,HepG2|chr12:7280783-7280815,chr12,7280783,7280815,0,115108398
HepG2|chr12:122407622-122407661,chr12,122407622,122407661,HepG2|chr12:7280783-7280854,chr12,7280783,7280854,0,115126839
HepG2|chr12:123001360-123001449,chr12,123001360,123001449,HepG2|chr12:76432093-76432121,chr12,76432093,76432121,0,46569267
HepG2|chr12:123178345-123178452,chr12,123178345,123178452,HepG2|chr12:89750783-89750933,chr12,89750783,89750933,0,33427562
HepG2|chr12:123191237-123191351,chr12,123191237,123191351,HepG2|chr12:7280783-7280853,chr12,7280783,7280853,0,115910454
HepG2|chr12:123357715-123357741,chr12,123357715,123357741,HepG2|chr12:7280980-7281130,chr12,7280980,7281130,0,116076735
HepG2|chr12:123362238-123362309,chr12,123362238,123362309,HepG2|chr12:7280783-7280808,chr12,7280783,7280808,0,116081455
HepG2|chr12:123612941-123612990,chr12,123612941,123612990,HepG2|chr12:7280783-7280810,chr12,7280783,7280810,0,116332158
HepG2|chr12:123771868-123772007,chr12,123771868,123772007,HepG2|chr12:7280783-7280804,chr12,7280783,7280804,0,116491085
HepG2|chr12:123791221-123791344,chr12,123791221,123791344,HepG2|chr12:51422204-51422226,chr12,51422204,51422226,0,72369017
HepG2|chr12:124101515-124101549,chr12,124101515,124101549,HepG2|chr12:7280783-7280815,chr12,7280783,7280815,0,116820732
HepG2|chr12:124185188-124185272,chr12,124185188,124185272,HepG2|chr12:7280783-7280849,chr12,7280783,7280849,0,116904405
HepG2|chr12:124622177-124622304,chr12,124622177,124622304,HepG2|chr12:7280783-7280847,chr12,7280783,7280847,0,117341394
HepG2|chr12:124903769-124903845,chr12,124903769,124903845,HepG2|chr12:14922833-14922935,chr12,14922833,14922935,0,109980936
HepG2|chr12:125284815-125284887,chr12,125284815,125284887,HepG2|chr12:7280783-7280854,chr12,7280783,7280854,0,118004032
HepG2|chr12:126246120-126246158,chr12,126246120,126246158,HepG2|chr12:7280783-7280867,chr12,7280783,7280867,0,118965337
HepG2|chr12:126616522-126616642,chr12,126616522,126616642,HepG2|chr12:7280783-7280807,chr12,7280783,7280807,0,119335739
HepG2|chr12:127007410-127007557,chr12,127007410,127007557,HepG2|chr12:7280783-7280818,chr12,7280783,7280818,0,119726627
HepG2|chr12:127429571-127429596,chr12,127429571,127429596,HepG2|chr12:7280783-7280814,chr12,7280783,7280814,0,120148788
HepG2|chr12:127517439-127517582,chr12,127517439,127517582,HepG2|chr12:7280783-7280824,chr12,7280783,7280824,0,120236656
HepG2|chr12:127615293-127615408,chr12,127615293,127615408,HepG2|chr12:14921872-14921938,chr12,14921872,14921938,0,112693421
HepG2|chr12:127630584-127630615,chr12,127630584,127630615,HepG2|chr12:7280782-7280843,chr12,7280782,7280843,0,120349802
HepG2|chr12:127718862-127718929,chr12,127718862,127718929,HepG2|chr12:7280783-7280848,chr12,7280783,7280848,0,120438079
HepG2|chr12:128137657-128137756,chr12,128137657,128137756,HepG2|chr12:123379344-123379395,chr12,123379344,123379395,0,4758313
HepG2|chr12:128186004-128186033,chr12,128186004,128186033,HepG2|chr12:7280783-7280817,chr12,7280783,7280817,0,120905221
HepG2|chr12:128220541-128220687,chr12,128220541,128220687,HepG2|chr12:122513327-122513459,chr12,122513327,122513459,0,5707214
HepG2|chr12:128571181-128571227,chr12,128571181,128571227,HepG2|chr12:7280783-7280884,chr12,7280783,7280884,0,121290398
HepG2|chr12:128629928-128629964,chr12,128629928,128629964,HepG2|chr12:12765944-12766094,chr12,12765944,12766094,0,115863984
HepG2|chr12:128809273-128809396,chr12,128809273,128809396,HepG2|chr12:7280783-7280810,chr12,7280783,7280810,0,121528490
HepG2|chr12:128862120-128862177,chr12,128862120,128862177,HepG2|chr12:7280783-7280854,chr12,7280783,7280854,0,121581337
HepG2|chr12:129502092-129502168,chr12,129502092,129502168,HepG2|chr12:7280783-7280857,chr12,7280783,7280857,0,122221309
HepG2|chr12:129912839-129912870,chr12,129912839,129912870,HepG2|chr12:7280783-7280854,chr12,7280783,7280854,0,122632056
HepG2|chr12:130422520-130422581,chr12,130422520,130422581,HepG2|chr12:76429392-76429462,chr12,76429392,76429462,0,53993128
HepG2|chr12:130485666-130485688,chr12,130485666,130485688,HepG2|chr12:53774610-53774724,chr12,53774610,53774724,0,76711056
HepG2|chr12:130759314-130759361,chr12,130759314,130759361,HepG2|chr12:7280782-7280881,chr12,7280782,7280881,0,123478532
HepG2|chr12:131082246-131082362,chr12,131082246,131082362,HepG2|chr12:7280783-7280808,chr12,7280783,7280808,0,123801463
HepG2|chr12:131280482-131280524,chr12,131280482,131280524,HepG2|chr12:7280783-7280810,chr12,7280783,7280810,0,123999699
HepG2|chr12:131499846-131499892,chr12,131499846,131499892,HepG2|chr12:7280783-7280809,chr12,7280783,7280809,0,124219063
HepG2|chr12:131727839-131727919,chr12,131727839,131727919,HepG2|chr12:7280783-7280854,chr12,7280783,7280854,0,124447056
HepG2|chr12:131846722-131846841,chr12,131846722,131846841,HepG2|chr12:6472126-6472157,chr12,6472126,6472157,0,125374596
HepG2|chr12:132023632-132023741,chr12,132023632,132023741,HepG2|chr12:7280783-7280824,chr12,7280783,7280824,0,124742849
HepG2|chr12:132163853-132163960,chr12,132163853,132163960,HepG2|chr12:64234473-64234490,chr12,64234473,64234490,0,67929380
HepG2|chr12:132266608-132266647,chr12,132266608,132266647,HepG2|chr12:7280783-7280847,chr12,7280783,7280847,0,124985825
HepG2|chr12:132471678-132471698,chr12,132471678,132471698,HepG2|chr12:7280783-7280803,chr12,7280783,7280803,0,125190895
HepG2|chr12:132480296-132480380,chr12,132480296,132480380,HepG2|chr12:7280781-7280847,chr12,7280781,7280847,0,125199515
HepG2|chr12:132510798-132510928,chr12,132510798,132510928,HepG2|chr12:7280783-7280878,chr12,7280783,7280878,0,125230015
HepG2|chr12:132511584-132511606,chr12,132511584,132511606,HepG2|chr12:7280783-7280883,chr12,7280783,7280883,0,125230801
HepG2|chr12:132513134-132513161,chr12,132513134,132513161,HepG2|chr12:7280783-7280884,chr12,7280783,7280884,0,125232351
HepG2|chr12:132918487-132918591,chr12,132918487,132918591,HepG2|chr12:7279426-7279522,chr12,7279426,7279522,0,125639061
HepG2|chr12:133042905-133042952,chr12,133042905,133042952,HepG2|chr12:7280786-7280846,chr12,7280786,7280846,0,125762119
HepG2|chr12:133121371-133121484,chr12,133121371,133121484,HepG2|chr12:7280783-7280816,chr12,7280783,7280816,0,125840588
HepG2|chr12:133378944-133379028,chr12,133378944,133379028,HepG2|chr12:14921872-14921938,chr12,14921872,14921938,0,118457072
HepG2|chr12:133454757-133454842,chr12,133454757,133454842,HepG2|chr12:7280783-7280847,chr12,7280783,7280847,0,126173974
HepG2|chr12:133551510-133551540,chr12,133551510,133551540,HepG2|chr12:54392020-54392117,chr12,54392020,54392117,0,79159490
HepG2|chr12:133651442-133651565,chr12,133651442,133651565,HepG2|chr12:27672896-27672917,chr12,27672896,27672917,0,105978546
HepG2|chr13:634570-634619,chr13,634570,634619,HepG2|chr13:20205629-20205688,chr13,20205629,20205688,0,19571059
HepG2|chr13:2443852-2443949,chr13,2443852,2443949,HepG2|chr13:20207759-20207809,chr13,20207759,20207809,0,17763907
HepG2|chr13:7925460-7925482,chr13,7925460,7925482,HepG2|chr13:50656726-50656835,chr13,50656726,50656835,0,42731266
HepG2|chr13:8106498-8106625,chr13,8106498,8106625,HepG2|chr13:20207759-20207815,chr13,20207759,20207815,0,12101261
HepG2|chr13:8565892-8565953,chr13,8565892,8565953,HepG2|chr13:50656726-50656835,chr13,50656726,50656835,0,42090834
HepG2|chr13:9384383-9384485,chr13,9384383,9384485,HepG2|chr13:20207759-20207807,chr13,20207759,20207807,0,10823376
HepG2|chr13:10275453-10275494,chr13,10275453,10275494,HepG2|chr13:50656726-50656835,chr13,50656726,50656835,0,40381273
HepG2|chr13:16441206-16441257,chr13,16441206,16441257,HepG2|chr13:113344429-113344486,chr13,113344429,113344486,0,96903223
HepG2|chr13:17762684-17762752,chr13,17762684,17762752,HepG2|chr13:20207759-20207809,chr13,20207759,20207809,0,2445075
HepG2|chr13:19476247-19476375,chr13,19476247,19476375,HepG2|chr13:20207759-20207809,chr13,20207759,20207809,0,731512
HepG2|chr13:20002068-20002212,chr13,20002068,20002212,HepG2|chr13:20207759-20207807,chr13,20207759,20207807,0,205691
HepG2|chr13:21468447-21468577,chr13,21468447,21468577,HepG2|chr13:20207759-20207779,chr13,20207759,20207779,0,1260688
HepG2|chr13:22100914-22100964,chr13,22100914,22100964,HepG2|chr13:20203696-20203836,chr13,20203696,20203836,0,1897218
HepG2|chr13:25148780-25148841,chr13,25148780,25148841,HepG2|chr13:50656726-50656835,chr13,50656726,50656835,0,25507946
HepG2|chr13:25890007-25890057,chr13,25890007,25890057,HepG2|chr13:20203696-20203836,chr13,20203696,20203836,0,5686311
HepG2|chr13:27662888-27662990,chr13,27662888,27662990,HepG2|chr13:113819961-113820003,chr13,113819961,113820003,0,86157073
HepG2|chr13:28006100-28006167,chr13,28006100,28006167,HepG2|chr13:113823106-113823167,chr13,113823106,113823167,0,85817006
HepG2|chr13:30598549-30598601,chr13,30598549,30598601,HepG2|chr13:113344429-113344486,chr13,113344429,113344486,0,82745880
HepG2|chr13:31219137-31219210,chr13,31219137,31219210,HepG2|chr13:20207759-20207811,chr13,20207759,20207811,0,11011378
HepG2|chr13:38197844-38197984,chr13,38197844,38197984,HepG2|chr13:20203697-20203752,chr13,20203697,20203752,0,17994147
HepG2|chr13:40084370-40084475,chr13,40084370,40084475,HepG2|chr13:20207759-20207804,chr13,20207759,20207804,0,19876611
HepG2|chr13:40237617-40237757,chr13,40237617,40237757,HepG2|chr13:20203697-20203752,chr13,20203697,20203752,0,20033920
HepG2|chr13:45802348-45802415,chr13,45802348,45802415,HepG2|chr13:113823106-113823167,chr13,113823106,113823167,0,68020758
HepG2|chr13:47800778-47800830,chr13,47800778,47800830,HepG2|chr13:113344429-113344486,chr13,113344429,113344486,0,65543651
HepG2|chr13:51430450-51430534,chr13,51430450,51430534,HepG2|chr13:20203697-20203753,chr13,20203697,20203753,0,31226753
HepG2|chr13:51468975-51469016,chr13,51468975,51469016,HepG2|chr13:50656726-50656835,chr13,50656726,50656835,0,812249
HepG2|chr13:54959401-54959468,chr13,54959401,54959468,HepG2|chr13:20203696-20203834,chr13,20203696,20203834,0,34755705
HepG2|chr13:55397347-55397428,chr13,55397347,55397428,HepG2|chr13:113819725-113819875,chr13,113819725,113819875,0,58422378
HepG2|chr13:57815509-57815659,chr13,57815509,57815659,HepG2|chr13:20207759-20207809,chr13,20207759,20207809,0,37607750
HepG2|chr13:58643388-58643469,chr13,58643388,58643469,HepG2|chr13:113819725-113819875,chr13,113819725,113819875,0,55176337
HepG2|chr13:64381517-64381628,chr13,64381517,64381628,HepG2|chr13:20203697-20203757,chr13,20203697,20203757,0,44177820
HepG2|chr13:67034881-67034949,chr13,67034881,67034949,HepG2|chr13:20207759-20207809,chr13,20207759,20207809,0,46827122
HepG2|chr13:68428980-68429108,chr13,68428980,68429108,HepG2|chr13:20207759-20207809,chr13,20207759,20207809,0,48221221
HepG2|chr13:68800163-68800257,chr13,68800163,68800257,HepG2|chr13:20207759-20207815,chr13,20207759,20207815,0,48592404
HepG2|chr13:73251130-73251235,chr13,73251130,73251235,HepG2|chr13:20207759-20207804,chr13,20207759,20207804,0,53043371
HepG2|chr13:75221567-75221697,chr13,75221567,75221697,HepG2|chr13:20207759-20207779,chr13,20207759,20207779,0,55013808
HepG2|chr13:76094673-76094775,chr13,76094673,76094775,HepG2|chr13:113819961-113820003,chr13,113819961,113820003,0,37725288
HepG2|chr13:78125740-78125842,chr13,78125740,78125842,HepG2|chr13:20207759-20207807,chr13,20207759,20207807,0,57917981
HepG2|chr13:87536622-87536706,chr13,87536622,87536706,HepG2|chr13:20203697-20203753,chr13,20203697,20203753,0,67332925
HepG2|chr13:88042531-88042642,chr13,88042531,88042642,HepG2|chr13:20203697-20203757,chr13,20203697,20203757,0,67838834
HepG2|chr13:90676497-90676570,chr13,90676497,90676570,HepG2|chr13:20207759-20207811,chr13,20207759,20207811,0,70468738
HepG2|chr13:93624643-93624694,chr13,93624643,93624694,HepG2|chr13:113344429-113344486,chr13,113344429,113344486,0,19719786
HepG2|chr13:95732174-95732305,chr13,95732174,95732305,HepG2|chr13:20207759-20207809,chr13,20207759,20207809,0,75524415
HepG2|chr13:96037433-96037534,chr13,96037433,96037534,HepG2|chr13:113819961-113820003,chr13,113819961,113820003,0,17782528
HepG2|chr13:97668855-97668956,chr13,97668855,97668956,HepG2|chr13:113819961-113820003,chr13,113819961,113820003,0,16151106
HepG2|chr13:99829068-99829165,chr13,99829068,99829165,HepG2|chr13:20207759-20207809,chr13,20207759,20207809,0,79621309
HepG2|chr13:101800967-101801094,chr13,101800967,101801094,HepG2|chr13:20207759-20207815,chr13,20207759,20207815,0,81593208
HepG2|chr13:105796972-105797122,chr13,105796972,105797122,HepG2|chr13:20207759-20207809,chr13,20207759,20207809,0,85589213
HepG2|chr13:107785927-107785994,chr13,107785927,107785994,HepG2|chr13:20203696-20203834,chr13,20203696,20203834,0,87582231
HepG2|chr13:108935901-108936045,chr13,108935901,108936045,HepG2|chr13:20207759-20207807,chr13,20207759,20207807,0,88728142
HepG2|chr13:109903388-109903410,chr13,109903388,109903410,HepG2|chr13:50656726-50656835,chr13,50656726,50656835,0,59246662
HepG2|chr13:110540696-110540790,chr13,110540696,110540790,HepG2|chr13:20207759-20207815,chr13,20207759,20207815,0,90332937
HepG2|chr13:112903111-112903160,chr13,112903111,112903160,HepG2|chr13:20205629-20205688,chr13,20205629,20205688,0,92697482
HepG2|chr13:113212141-113212272,chr13,113212141,113212272,HepG2|chr13:20207759-20207809,chr13,20207759,20207809,0,93004382
HepG2|chr14:75474-75514,chr14,75474,75514,HepG2|chr14:103527995-103528117,chr14,103527995,103528117,0,103452521
HepG2|chr14:259101-259202,chr14,259101,259202,HepG2|chr14:103055800-103055846,chr14,103055800,103055846,0,102796699
HepG2|chr14:300043-300113,chr14,300043,300113,HepG2|chr14:21922461-21922547,chr14,21922461,21922547,0,21622418
HepG2|chr14:624533-624599,chr14,624533,624599,HepG2|chr14:50106299-50106393,chr14,50106299,50106393,0,49481766
HepG2|chr14:958215-958346,chr14,958215,958346,HepG2|chr14:51414880-51414899,chr14,51414880,51414899,0,50456665
HepG2|chr14:1091305-1091332,chr14,1091305,1091332,HepG2|chr14:51414682-51414832,chr14,51414682,51414832,0,50323377
HepG2|chr14:1272421-1272438,chr14,1272421,1272438,HepG2|chr14:51413005-51413150,chr14,51413005,51413150,0,50140584
HepG2|chr14:1302541-1302681,chr14,1302541,1302681,HepG2|chr14:103528090-103528117,chr14,103528090,103528117,0,102225549
HepG2|chr14:1324190-1324255,chr14,1324190,1324255,HepG2|chr14:103527996-103528117,chr14,103527996,103528117,0,102203806
HepG2|chr14:1848594-1848646,chr14,1848594,1848646,HepG2|chr14:103527996-103528117,chr14,103527996,103528117,0,101679402
HepG2|chr14:2001324-2001474,chr14,2001324,2001474,HepG2|chr14:103528061-103528117,chr14,103528061,103528117,0,101526737
HepG2|chr14:2067668-2067774,chr14,2067668,2067774,HepG2|chr14:51414855-51414899,chr14,51414855,51414899,0,49347187
HepG2|chr14:2271508-2271560,chr14,2271508,2271560,HepG2|chr14:103527996-103528117,chr14,103527996,103528117,0,101256488
HepG2|chr14:2829805-2829843,chr14,2829805,2829843,HepG2|chr14:50103734-50103884,chr14,50103734,50103884,0,47273929
HepG2|chr14:2951445-2951496,chr14,2951445,2951496,HepG2|chr14:103528023-103528117,chr14,103528023,103528117,0,100576578
HepG2|chr14:2979130-2979280,chr14,2979130,2979280,HepG2|chr14:103527996-103528117,chr14,103527996,103528117,0,100548866
HepG2|chr14:3434503-3434526,chr14,3434503,3434526,HepG2|chr14:50105246-50105354,chr14,50105246,50105354,0,46670743
HepG2|chr14:3614783-3614891,chr14,3614783,3614891,HepG2|chr14:103528062-103528117,chr14,103528062,103528117,0,99913279
HepG2|chr14:3930788-3930833,chr14,3930788,3930833,HepG2|chr14:51414771-51414899,chr14,51414771,51414899,0,47483983
HepG2|chr14:4609962-4609995,chr14,4609962,4609995,HepG2|chr14:103528006-103528117,chr14,103528006,103528117,0,98918044
HepG2|chr14:4644706-4644856,chr14,4644706,4644856,HepG2|chr14:24421937-24422084,chr14,24421937,24422084,0,19777231
HepG2|chr14:4745043-4745097,chr14,4745043,4745097,HepG2|chr14:103527992-103528117,chr14,103527992,103528117,0,98782949
HepG2|chr14:4889003-4889043,chr14,4889003,4889043,HepG2|chr14:51414408-51414485,chr14,51414408,51414485,0,46525405
HepG2|chr14:4914624-4914735,chr14,4914624,4914735,HepG2|chr14:50106907-50106964,chr14,50106907,50106964,0,45192283
HepG2|chr14:5414570-5414699,chr14,5414570,5414699,HepG2|chr14:51414879-51414899,chr14,51414879,51414899,0,46000309
HepG2|chr14:5506334-5506484,chr14,5506334,5506484,HepG2|chr14:103528089-103528117,chr14,103528089,103528117,0,98021755
HepG2|chr14:5577615-5577706,chr14,5577615,5577706,HepG2|chr14:103527990-103528117,chr14,103527990,103528117,0,97950375
HepG2|chr14:5655160-5655308,chr14,5655160,5655308,HepG2|chr14:24421917-24422067,chr14,24421917,24422067,0,18766757
HepG2|chr14:5917754-5917835,chr14,5917754,5917835,HepG2|chr14:103528048-103528117,chr14,103528048,103528117,0,97610294
HepG2|chr14:5962971-5963121,chr14,5962971,5963121,HepG2|chr14:103527996-103528117,chr14,103527996,103528117,0,97565025
HepG2|chr14:6031639-6031677,chr14,6031639,6031677,HepG2|chr14:103527996-103528117,chr14,103527996,103528117,0,97496357
HepG2|chr14:6164206-6164301,chr14,6164206,6164301,HepG2|chr14:103528062-103528117,chr14,103528062,103528117,0,97363856
HepG2|chr14:6356935-6357085,chr14,6356935,6357085,HepG2|chr14:103055800-103055822,chr14,103055800,103055822,0,96698865
HepG2|chr14:6602124-6602184,chr14,6602124,6602184,HepG2|chr14:103525332-103525422,chr14,103525332,103525422,0,96923208
HepG2|chr14:6731247-6731301,chr14,6731247,6731301,HepG2|chr14:31888320-31888470,chr14,31888320,31888470,0,25157073
HepG2|chr14:7035473-7035623,chr14,7035473,7035623,HepG2|chr14:24422737-24422778,chr14,24422737,24422778,0,17387264
HepG2|chr14:7279559-7279653,chr14,7279559,7279653,HepG2|chr14:103528061-103528117,chr14,103528061,103528117,0,96248502
HepG2|chr14:7330192-7330293,chr14,7330192,7330293,HepG2|chr14:51414708-51414858,chr14,51414708,51414858,0,44084516
HepG2|chr14:7385690-7385724,chr14,7385690,7385724,HepG2|chr14:103527996-103528112,chr14,103527996,103528112,0,96142306
HepG2|chr14:7616898-7617048,chr14,7616898,7617048,HepG2|chr14:103528059-103528117,chr14,103528059,103528117,0,95911161
HepG2|chr14:8058880-8058916,chr14,8058880,8058916,HepG2|chr14:51414371-51414485,chr14,51414371,51414485,0,43355491
HepG2|chr14:8257730-8257803,chr14,8257730,8257803,HepG2|chr14:102790467-102790542,chr14,102790467,102790542,0,94532737
HepG2|chr14:8546946-8547082,chr14,8546946,8547082,HepG2|chr14:34932120-34932156,chr14,34932120,34932156,0,26385174
HepG2|chr14:8702369-8702455,chr14,8702369,8702455,HepG2|chr14:24421922-24422072,chr14,24421922,24422072,0,15719553
HepG2|chr14:8709432-8709470,chr14,8709432,8709470,HepG2|chr14:50103734-50103884,chr14,50103734,50103884,0,41394302
HepG2|chr14:8952264-8952396,chr14,8952264,8952396,HepG2|chr14:103527995-103528117,chr14,103527995,103528117,0,94575731
HepG2|chr14:8993570-8993679,chr14,8993570,8993679,HepG2|chr14:51414858-51414899,chr14,51414858,51414899,0,42421288
HepG2|chr14:9032224-9032264,chr14,9032224,9032264,HepG2|chr14:24421535-24421685,chr14,24421535,24421685,0,15389311
HepG2|chr14:9657198-9657242,chr14,9657198,9657242,HepG2|chr14:103528041-103528117,chr14,103528041,103528117,0,93870843
HepG2|chr14:10004179-10004258,chr14,10004179,10004258,HepG2|chr14:103055800-103055822,chr14,103055800,103055822,0,93051621
HepG2|chr14:10021846-10021869,chr14,10021846,10021869,HepG2|chr14:50105246-50105354,chr14,50105246,50105354,0,40083400
HepG2|chr14:10188403-10188519,chr14,10188403,10188519,HepG2|chr14:103527994-103528117,chr14,103527994,103528117,0,93339591
HepG2|chr14:10312984-10313043,chr14,10312984,10313043,HepG2|chr14:103528048-103528113,chr14,103528048,103528113,0,93215064
HepG2|chr14:10805054-10805149,chr14,10805054,10805149,HepG2|chr14:51414857-51414899,chr14,51414857,51414899,0,40609803
HepG2|chr14:10878000-10878137,chr14,10878000,10878137,HepG2|chr14:50102369-50102414,chr14,50102369,50102414,0,39224369
HepG2|chr14:11204039-11204185,chr14,11204039,11204185,HepG2|chr14:24421928-24422078,chr14,24421928,24422078,0,13217889
HepG2|chr14:11396843-11396993,chr14,11396843,11396993,HepG2|chr14:24421924-24422071,chr14,24421924,24422071,0,13025081
HepG2|chr14:11441702-11441783,chr14,11441702,11441783,HepG2|chr14:103528061-103528117,chr14,103528061,103528117,0,92086359
HepG2|chr14:11731959-11731986,chr14,11731959,11731986,HepG2|chr14:50105214-50105336,chr14,50105214,50105336,0,38373255
HepG2|chr14:12209071-12209097,chr14,12209071,12209097,HepG2|chr14:103527996-103528117,chr14,103527996,103528117,0,91318925
HepG2|chr14:12421551-12421619,chr14,12421551,12421619,HepG2|chr14:103055506-103055622,chr14,103055506,103055622,0,90633955
HepG2|chr14:12464106-12464127,chr14,12464106,12464127,HepG2|chr14:103528005-103528117,chr14,103528005,103528117,0,91063899
HepG2|chr14:12524428-12524525,chr14,12524428,12524525,HepG2|chr14:50106698-50106840,chr14,50106698,50106840,0,37582270
HepG2|chr14:12634171-12634272,chr14,12634171,12634272,HepG2|chr14:103528070-103528117,chr14,103528070,103528117,0,90893899
HepG2|chr14:12855302-12855400,chr14,12855302,12855400,HepG2|chr14:35185974-35186042,chr14,35185974,35186042,0,22330672
HepG2|chr14:13004612-13004754,chr14,13004612,13004754,HepG2|chr14:24456364-24456440,chr14,24456364,24456440,0,11451752
HepG2|chr14:13063825-13063855,chr14,13063825,13063855,HepG2|chr14:73496157-73496246,chr14,73496157,73496246,0,60432332
HepG2|chr14:13286196-13286324,chr14,13286196,13286324,HepG2|chr14:51414858-51414899,chr14,51414858,51414899,0,38128662
HepG2|chr14:13286890-13286971,chr14,13286890,13286971,HepG2|chr14:103528048-103528117,chr14,103528048,103528117,0,90241158
HepG2|chr14:13327762-13327912,chr14,13327762,13327912,HepG2|chr14:103528062-103528117,chr14,103528062,103528117,0,90200300
HepG2|chr14:13410470-13410522,chr14,13410470,13410522,HepG2|chr14:51414759-51414900,chr14,51414759,51414900,0,38004289
HepG2|chr14:13462504-13462654,chr14,13462504,13462654,HepG2|chr14:24421939-24422084,chr14,24421939,24422084,0,10959435
HepG2|chr14:13779143-13779271,chr14,13779143,13779271,HepG2|chr14:51414858-51414899,chr14,51414858,51414899,0,37635715
HepG2|chr14:13818544-13818619,chr14,13818544,13818619,HepG2|chr14:102790469-102790532,chr14,102790469,102790532,0,88971925
HepG2|chr14:13988683-13988762,chr14,13988683,13988762,HepG2|chr14:35185974-35186042,chr14,35185974,35186042,0,21197291
HepG2|chr14:14127464-14127529,chr14,14127464,14127529,HepG2|chr14:103527996-103528117,chr14,103527996,103528117,0,89400532
HepG2|chr14:14409688-14409768,chr14,14409688,14409768,HepG2|chr14:24421522-24421672,chr14,24421522,24421672,0,10011834
HepG2|chr14:14686842-14686894,chr14,14686842,14686894,HepG2|chr14:103528002-103528099,chr14,103528002,103528099,0,88841160
HepG2|chr14:14937881-14937954,chr14,14937881,14937954,HepG2|chr14:74082372-74082402,chr14,74082372,74082402,0,59144491
HepG2|chr14:14992692-14992725,chr14,14992692,14992725,HepG2|chr14:103528002-103528117,chr14,103528002,103528117,0,88535310
HepG2|chr14:15176033-15176180,chr14,15176033,15176180,HepG2|chr14:24421922-24422072,chr14,24421922,24422072,0,9245889
HepG2|chr14:15934056-15934206,chr14,15934056,15934206,HepG2|chr14:50106676-50106697,chr14,50106676,50106697,0,34172620
HepG2|chr14:16105684-16105706,chr14,16105684,16105706,HepG2|chr14:103527990-103528117,chr14,103527990,103528117,0,87422306
HepG2|chr14:16385290-16385359,chr14,16385290,16385359,HepG2|chr14:35186424-35186505,chr14,35186424,35186505,0,18801134
HepG2|chr14:16567066-16567110,chr14,16567066,16567110,HepG2|chr14:51414380-51414485,chr14,51414380,51414485,0,34847314
HepG2|chr14:16837673-16837728,chr14,16837673,16837728,HepG2|chr14:103527523-103527673,chr14,103527523,103527673,0,86689850
HepG2|chr14:17150700-17150847,chr14,17150700,17150847,HepG2|chr14:24456364-24456421,chr14,24456364,24456421,0,7305664
HepG2|chr14:17263620-17263723,chr14,17263620,17263723,HepG2|chr14:24456836-24456874,chr14,24456836,24456874,0,7193216
HepG2|chr14:18197319-18197414,chr14,18197319,18197414,HepG2|chr14:103528062-103528117,chr14,103528062,103528117,0,85330743
HepG2|chr14:18394731-18394798,chr14,18394731,18394798,HepG2|chr14:103528061-103528117,chr14,103528061,103528117,0,85133330
HepG2|chr14:18521663-18521749,chr14,18521663,18521749,HepG2|chr14:24421922-24422072,chr14,24421922,24422072,0,5900259
HepG2|chr14:18569303-18569396,chr14,18569303,18569396,HepG2|chr14:51414857-51414899,chr14,51414857,51414899,0,32845554
HepG2|chr14:18576999-18577145,chr14,18576999,18577145,HepG2|chr14:102775106-102775139,chr14,102775106,102775139,0,84198107
HepG2|chr14:18850590-18850631,chr14,18850590,18850631,HepG2|chr14:103527992-103528117,chr14,103527992,103528117,0,84677402
HepG2|chr14:18899576-18899611,chr14,18899576,18899611,HepG2|chr14:50106648-50106737,chr14,50106648,50106737,0,31207072
HepG2|chr14:18932098-18932137,chr14,18932098,18932137,HepG2|chr14:50102658-50102777,chr14,50102658,50102777,0,31170560
HepG2|chr14:19433641-19433746,chr14,19433641,19433746,HepG2|chr14:51414855-51414899,chr14,51414855,51414899,0,31981214
HepG2|chr14:19631806-19631853,chr14,19631806,19631853,HepG2|chr14:61791725-61791828,chr14,61791725,61791828,0,42159919
HepG2|chr14:19901189-19901248,chr14,19901189,19901248,HepG2|chr14:103527996-103528117,chr14,103527996,103528117,0,83626807
HepG2|chr14:20155433-20155539,chr14,20155433,20155539,HepG2|chr14:103527995-103528117,chr14,103527995,103528117,0,83372562
HepG2|chr14:20268232-20268295,chr14,20268232,20268295,HepG2|chr14:34932118-34932156,chr14,34932118,34932156,0,14663886
HepG2|chr14:20328037-20328151,chr14,20328037,20328151,HepG2|chr14:24455998-24456148,chr14,24455998,24456148,0,4127961
HepG2|chr14:20454073-20454159,chr14,20454073,20454159,HepG2|chr14:103527996-103528117,chr14,103527996,103528117,0,83073923
HepG2|chr14:20733949-20734040,chr14,20733949,20734040,HepG2|chr14:50103716-50103837,chr14,50103716,50103837,0,29369767
HepG2|chr14:20945396-20945442,chr14,20945396,20945442,HepG2|chr14:103527996-103528117,chr14,103527996,103528117,0,82582600
HepG2|chr14:20972759-20972794,chr14,20972759,20972794,HepG2|chr14:50106648-50106737,chr14,50106648,50106737,0,29133889
HepG2|chr14:21201411-21201508,chr14,21201411,21201508,HepG2|chr14:103055800-103055822,chr14,103055800,103055822,0,81854389
HepG2|chr14:21502065-21502161,chr14,21502065,21502161,HepG2|chr14:51414859-51414899,chr14,51414859,51414899,0,29912794
HepG2|chr14:21636308-21636381,chr14,21636308,21636381,HepG2|chr14:102790467-102790542,chr14,102790467,102790542,0,81154159
HepG2|chr14:22085411-22085510,chr14,22085411,22085510,HepG2|chr14:103528089-103528117,chr14,103528089,103528117,0,81442678
HepG2|chr14:22181302-22181349,chr14,22181302,22181349,HepG2|chr14:103055800-103055903,chr14,103055800,103055903,0,80874498
HepG2|chr14:22205909-22206045,chr14,22205909,22206045,HepG2|chr14:34932120-34932156,chr14,34932120,34932156,0,12726211
HepG2|chr14:22269890-22269909,chr14,22269890,22269909,HepG2|chr14:103527997-103528117,chr14,103527997,103528117,0,81258107
HepG2|chr14:22337774-22337834,chr14,22337774,22337834,HepG2|chr14:103525332-103525422,chr14,103525332,103525422,0,81187558
HepG2|chr14:22505627-22505777,chr14,22505627,22505777,HepG2|chr14:24456364-24456451,chr14,24456364,24456451,0,1950737
HepG2|chr14:22513132-22513156,chr14,22513132,22513156,HepG2|chr14:50106656-50106790,chr14,50106656,50106790,0,27593524
HepG2|chr14:22590787-22590849,chr14,22590787,22590849,HepG2|chr14:24422585-24422732,chr14,24422585,24422732,0,1831798
HepG2|chr14:22738320-22738367,chr14,22738320,22738367,HepG2|chr14:103527996-103528117,chr14,103527996,103528117,0,80789676
HepG2|chr14:22741842-22741937,chr14,22741842,22741937,HepG2|chr14:103528062-103528117,chr14,103528062,103528117,0,80786220
HepG2|chr14:22827292-22827409,chr14,22827292,22827409,HepG2|chr14:103527995-103528117,chr14,103527995,103528117,0,80700703
HepG2|chr14:22923246-22923374,chr14,22923246,22923374,HepG2|chr14:103055800-103055822,chr14,103055800,103055822,0,80132554
HepG2|chr14:23007885-23007932,chr14,23007885,23007932,HepG2|chr14:103528013-103528116,chr14,103528013,103528116,0,80520128
HepG2|chr14:23238747-23238806,chr14,23238747,23238806,HepG2|chr14:51414855-51414899,chr14,51414855,51414899,0,28176108
HepG2|chr14:23429845-23429900,chr14,23429845,23429900,HepG2|chr14:103528023-103528117,chr14,103528023,103528117,0,80098178
HepG2|chr14:23445665-23445747,chr14,23445665,23445747,HepG2|chr14:24052967-24053044,chr14,24052967,24053044,0,607302
HepG2|chr14:23459127-23459181,chr14,23459127,23459181,HepG2|chr14:31888320-31888470,chr14,31888320,31888470,0,8429193
HepG2|chr14:23543536-23543572,chr14,23543536,23543572,HepG2|chr14:50106648-50106737,chr14,50106648,50106737,0,26563112
HepG2|chr14:23915413-23915518,chr14,23915413,23915518,HepG2|chr14:51414855-51414899,chr14,51414855,51414899,0,27499442
HepG2|chr14:24264903-24264955,chr14,24264903,24264955,HepG2|chr14:103528002-103528099,chr14,103528002,103528099,0,79263099
HepG2|chr14:24841261-24841319,chr14,24841261,24841319,HepG2|chr14:103527995-103528117,chr14,103527995,103528117,0,78686734
HepG2|chr14:24979260-24979334,chr14,24979260,24979334,HepG2|chr14:103528041-103528117,chr14,103528041,103528117,0,78548781
HepG2|chr14:25055722-25055819,chr14,25055722,25055819,HepG2|chr14:103528064-103528117,chr14,103528064,103528117,0,78472342
HepG2|chr14:25366352-25366455,chr14,25366352,25366455,HepG2|chr14:103055797-103055826,chr14,103055797,103055826,0,77689445
HepG2|chr14:25433627-25433649,chr14,25433627,25433649,HepG2|chr14:21924570-21924706,chr14,21924570,21924706,0,3509057
HepG2|chr14:26307234-26307258,chr14,26307234,26307258,HepG2|chr14:51414880-51414899,chr14,51414880,51414899,0,25107646
HepG2|chr14:26469150-26469176,chr14,26469150,26469176,HepG2|chr14:73730088-73730203,chr14,73730088,73730203,0,47260938
HepG2|chr14:26628026-26628107,chr14,26628026,26628107,HepG2|chr14:51414858-51414899,chr14,51414858,51414899,0,24786832
HepG2|chr14:26681512-26681598,chr14,26681512,26681598,HepG2|chr14:51414424-51414485,chr14,51414424,51414485,0,24732912
HepG2|chr14:26759695-26759845,chr14,26759695,26759845,HepG2|chr14:24421916-24422066,chr14,24421916,24422066,0,2337779
HepG2|chr14:26793397-26793547,chr14,26793397,26793547,HepG2|chr14:103055800-103055846,chr14,103055800,103055846,0,76262403
HepG2|chr14:27029721-27029858,chr14,27029721,27029858,HepG2|chr14:50102369-50102414,chr14,50102369,50102414,0,23072648
HepG2|chr14:27349276-27349349,chr14,27349276,27349349,HepG2|chr14:74082372-74082402,chr14,74082372,74082402,0,46733096
HepG2|chr14:27493929-27494033,chr14,27493929,27494033,HepG2|chr14:103528041-103528117,chr14,103528041,103528117,0,76034112
HepG2|chr14:27706239-27706388,chr14,27706239,27706388,HepG2|chr14:24438713-24438844,chr14,24438713,24438844,0,3267526
HepG2|chr14:27973732-27973882,chr14,27973732,27973882,HepG2|chr14:103528065-103528117,chr14,103528065,103528117,0,75554333
HepG2|chr14:27987936-27988062,chr14,27987936,27988062,HepG2|chr14:51414875-51414899,chr14,51414875,51414899,0,23426939
HepG2|chr14:28084358-28084423,chr14,28084358,28084423,HepG2|chr14:74082193-74082343,chr14,74082193,74082343,0,45997835
HepG2|chr14:28233312-28233335,chr14,28233312,28233335,HepG2|chr14:73730088-73730203,chr14,73730088,73730203,0,45496776
HepG2|chr14:28301977-28302127,chr14,28301977,28302127,HepG2|chr14:24439764-24439797,chr14,24439764,24439797,0,3862213
HepG2|chr14:28558204-28558270,chr14,28558204,28558270,HepG2|chr14:50103975-50104059,chr14,50103975,50104059,0,21545771
HepG2|chr14:28614496-28614545,chr14,28614496,28614545,HepG2|chr14:103528013-103528116,chr14,103528013,103528116,0,74913517
HepG2|chr14:28671868-28671988,chr14,28671868,28671988,HepG2|chr14:50106165-50106197,chr14,50106165,50106197,0,21434297
HepG2|chr14:28684104-28684254,chr14,28684104,28684254,HepG2|chr14:24456364-24456451,chr14,24456364,24456451,0,4227740
HepG2|chr14:28768470-28768617,chr14,28768470,28768617,HepG2|chr14:103528088-103528117,chr14,103528088,103528117,0,74759618
HepG2|chr14:29021998-29022097,chr14,29021998,29022097,HepG2|chr14:103528097-103528117,chr14,103528097,103528117,0,74506099
HepG2|chr14:29029637-29029722,chr14,29029637,29029722,HepG2|chr14:51414424-51414485,chr14,51414424,51414485,0,22384787
HepG2|chr14:29029993-29030094,chr14,29029993,29030094,HepG2|chr14:21925862-21925880,chr14,21925862,21925880,0,7104131
HepG2|chr14:29231453-29231480,chr14,29231453,29231480,HepG2|chr14:50106604-50106747,chr14,50106604,50106747,0,20875151
HepG2|chr14:29324465-29324615,chr14,29324465,29324615,HepG2|chr14:24421917-24422067,chr14,24421917,24422067,0,4902548
HepG2|chr14:29450170-29450209,chr14,29450170,29450209,HepG2|chr14:103528002-103528117,chr14,103528002,103528117,0,74077832
HepG2|chr14:29755425-29755575,chr14,29755425,29755575,HepG2|chr14:103528000-103528117,chr14,103528000,103528117,0,73772575
HepG2|chr14:30159613-30159711,chr14,30159613,30159711,HepG2|chr14:103528092-103528117,chr14,103528092,103528117,0,73368479
HepG2|chr14:30182657-30182807,chr14,30182657,30182807,HepG2|chr14:103528065-103528117,chr14,103528065,103528117,0,73345408
HepG2|chr14:30356194-30356341,chr14,30356194,30356341,HepG2|chr14:103528088-103528117,chr14,103528088,103528117,0,73171894
HepG2|chr14:30492522-30492590,chr14,30492522,30492590,HepG2|chr14:103055506-103055622,chr14,103055506,103055622,0,72562984
HepG2|chr14:30651719-30651820,chr14,30651719,30651820,HepG2|chr14:103528038-103528117,chr14,103528038,103528117,0,72876319
HepG2|chr14:30979262-30979366,chr14,30979262,30979366,HepG2|chr14:51414855-51414899,chr14,51414855,51414899,0,20435593
HepG2|chr14:31088291-31088372,chr14,31088291,31088372,HepG2|chr14:51414858-51414899,chr14,51414858,51414899,0,20326567
HepG2|chr14:31397172-31397232,chr14,31397172,31397232,HepG2|chr14:103528000-103528117,chr14,103528000,103528117,0,72130828
HepG2|chr14:31542532-31542628,chr14,31542532,31542628,HepG2|chr14:103528063-103528117,chr14,103528063,103528117,0,71985531
HepG2|chr14:31710023-31710173,chr14,31710023,31710173,HepG2|chr14:24421928-24422078,chr14,24421928,24422078,0,7288095
HepG2|chr14:31758835-31758882,chr14,31758835,31758882,HepG2|chr14:61791725-61791828,chr14,61791725,61791828,0,30032890
HepG2|chr14:31841708-31841732,chr14,31841708,31841732,HepG2|chr14:50106656-50106790,chr14,50106656,50106790,0,18264948
HepG2|chr14:32022254-32022350,chr14,32022254,32022350,HepG2|chr14:103528063-103528117,chr14,103528063,103528117,0,71505809
HepG2|chr14:32086224-32086290,chr14,32086224,32086290,HepG2|chr14:103527990-103528117,chr14,103527990,103528117,0,71441766
HepG2|chr14:32097728-32097817,chr14,32097728,32097817,HepG2|chr14:103528056-103528117,chr14,103528056,103528117,0,71430328
HepG2|chr14:32181827-32181925,chr14,32181827,32181925,HepG2|chr14:103528092-103528117,chr14,103528092,103528117,0,71346265
HepG2|chr14:32384091-32384115,chr14,32384091,32384115,HepG2|chr14:51414880-51414899,chr14,51414880,51414899,0,19030789
HepG2|chr14:32930864-32930943,chr14,32930864,32930943,HepG2|chr14:50105052-50105117,chr14,50105052,50105117,0,17174188
HepG2|chr14:32958786-32958903,chr14,32958786,32958903,HepG2|chr14:103527995-103528117,chr14,103527995,103528117,0,70569209
HepG2|chr14:33131210-33131360,chr14,33131210,33131360,HepG2|chr14:103528061-103528117,chr14,103528061,103528117,0,70396851
HepG2|chr14:33150772-33150903,chr14,33150772,33150903,HepG2|chr14:51414880-51414899,chr14,51414880,51414899,0,18264108
HepG2|chr14:33280394-33280497,chr14,33280394,33280497,HepG2|chr14:24456836-24456874,chr14,24456836,24456874,0,8823558
HepG2|chr14:33339841-33339861,chr14,33339841,33339861,HepG2|chr14:103527996-103528117,chr14,103527996,103528117,0,70188155
HepG2|chr14:33876159-33876188,chr14,33876159,33876188,HepG2|chr14:50103716-50103837,chr14,50103716,50103837,0,16227557
HepG2|chr14:33921485-33921590,chr14,33921485,33921590,HepG2|chr14:50102369-50102414,chr14,50102369,50102414,0,16180884
HepG2|chr14:34033499-34033623,chr14,34033499,34033623,HepG2|chr14:103055800-103055826,chr14,103055800,103055826,0,69022301
HepG2|chr14:34094163-34094213,chr14,34094163,34094213,HepG2|chr14:70041355-70041450,chr14,70041355,70041450,0,35947192
HepG2|chr14:34192305-34192455,chr14,34192305,34192455,HepG2|chr14:24421917-24422067,chr14,24421917,24422067,0,9770388
HepG2|chr14:34229847-34229953,chr14,34229847,34229953,HepG2|chr14:51414855-51414899,chr14,51414855,51414899,0,17185008
HepG2|chr14:34283333-34283364,chr14,34283333,34283364,HepG2|chr14:50105976-50105998,chr14,50105976,50105998,0,15822643
HepG2|chr14:34361532-34361586,chr14,34361532,34361586,HepG2|chr14:51414759-51414900,chr14,51414759,51414900,0,17053227
HepG2|chr14:34415747-34415820,chr14,34415747,34415820,HepG2|chr14:51414408-51414485,chr14,51414408,51414485,0,16998661
HepG2|chr14:34649704-34649848,chr14,34649704,34649848,HepG2|chr14:24421917-24422067,chr14,24421917,24422067,0,10227787
HepG2|chr14:34691686-34691803,chr14,34691686,34691803,HepG2|chr14:102775106-102775139,chr14,102775106,102775139,0,68083420
HepG2|chr14:34763895-34763972,chr14,34763895,34763972,HepG2|chr14:103528059-103528117,chr14,103528059,103528117,0,68764164
HepG2|chr14:34879643-34879685,chr14,34879643,34879685,HepG2|chr14:103528002-103528117,chr14,103528002,103528117,0,68648359
HepG2|chr14:35148525-35148580,chr14,35148525,35148580,HepG2|chr14:103528046-103528117,chr14,103528046,103528117,0,68379521
HepG2|chr14:35275496-35275599,chr14,35275496,35275599,HepG2|chr14:50104615-50104679,chr14,50104615,50104679,0,14829119
HepG2|chr14:35328490-35328586,chr14,35328490,35328586,HepG2|chr14:51414859-51414899,chr14,51414859,51414899,0,16086369
HepG2|chr14:35433306-35433336,chr14,35433306,35433336,HepG2|chr14:103527998-103528117,chr14,103527998,103528117,0,68094692
HepG2|chr14:35801927-35801997,chr14,35801927,35801997,HepG2|chr14:103527990-103528117,chr14,103527990,103528117,0,67726063
HepG2|chr14:35856836-35856882,chr14,35856836,35856882,HepG2|chr14:51414791-51414895,chr14,51414791,51414895,0,15557955
HepG2|chr14:35998199-35998221,chr14,35998199,35998221,HepG2|chr14:51414771-51414899,chr14,51414771,51414899,0,15416572
HepG2|chr14:36348566-36348716,chr14,36348566,36348716,HepG2|chr14:24421937-24422084,chr14,24421937,24422084,0,11926629
HepG2|chr14:36542980-36543082,chr14,36542980,36543082,HepG2|chr14:103055800-103055903,chr14,103055800,103055903,0,66512820
HepG2|chr14:36695011-36695035,chr14,36695011,36695035,HepG2|chr14:103527996-103528117,chr14,103527996,103528117,0,66832985
HepG2|chr14:36784582-36784636,chr14,36784582,36784636,HepG2|chr14:51414759-51414900,chr14,51414759,51414900,0,14630177
HepG2|chr14:36828750-36828869,chr14,36828750,36828869,HepG2|chr14:103528064-103528117,chr14,103528064,103528117,0,66699314
HepG2|chr14:37072914-37072952,chr14,37072914,37072952,HepG2|chr14:24456762-24456874,chr14,24456762,24456874,0,12616152
HepG2|chr14:37591359-37591470,chr14,37591359,37591470,HepG2|chr14:50106907-50106964,chr14,50106907,50106964,0,12515548
HepG2|chr14:38030330-38030390,chr14,38030330,38030390,HepG2|chr14:24456363-24456448,chr14,24456363,24456448,0,13573967
HepG2|chr14:38206089-38206193,chr14,38206089,38206193,HepG2|chr14:51414855-51414899,chr14,51414855,51414899,0,13208766
HepG2|chr14:38273266-38273297,chr14,38273266,38273297,HepG2|chr14:103528002-103528117,chr14,103528002,103528117,0,65254736
HepG2|chr14:38679197-38679238,chr14,38679197,38679238,HepG2|chr14:103527992-103528117,chr14,103527992,103528117,0,64848795
HepG2|chr14:38736045-38736165,chr14,38736045,38736165,HepG2|chr14:50103478-50103497,chr14,50103478,50103497,0,11367433
HepG2|chr14:38843208-38843331,chr14,38843208,38843331,HepG2|chr14:51414405-51414485,chr14,51414405,51414485,0,12571197
HepG2|chr14:39037856-39037885,chr14,39037856,39037885,HepG2|chr14:103528006-103528117,chr14,103528006,103528117,0,64490150
HepG2|chr14:39210152-39210175,chr14,39210152,39210175,HepG2|chr14:103528002-103528117,chr14,103528002,103528117,0,64317850
HepG2|chr14:39481976-39482022,chr14,39481976,39482022,HepG2|chr14:34932122-34932156,chr14,34932122,34932156,0,4549854
HepG2|chr14:39556246-39556310,chr14,39556246,39556310,HepG2|chr14:21922461-21922547,chr14,21922461,21922547,0,17633785
HepG2|chr14:39659883-39659976,chr14,39659883,39659976,HepG2|chr14:50106907-50106964,chr14,50106907,50106964,0,10447024
HepG2|chr14:39854407-39854446,chr14,39854407,39854446,HepG2|chr14:34932120-34932156,chr14,34932120,34932156,0,4922287
HepG2|chr14:39963065-39963129,chr14,39963065,39963129,HepG2|chr14:21922461-21922547,chr14,21922461,21922547,0,18040604
HepG2|chr14:40059475-40059522,chr14,40059475,40059522,HepG2|chr14:103527996-103528117,chr14,103527996,103528117,0,63468521
HepG2|chr14:40303533-40303595,chr14,40303533,40303595,HepG2|chr14:24422585-24422732,chr14,24422585,24422732,0,15880948
HepG2|chr14:40618649-40618799,chr14,40618649,40618799,HepG2|chr14:103528062-103528117,chr14,103528062,103528117,0,62909413
HepG2|chr14:40660665-40660721,chr14,40660665,40660721,HepG2|chr14:103522997-103523059,chr14,103522997,103523059,0,62862332
HepG2|chr14:40945864-40945893,chr14,40945864,40945893,HepG2|chr14:103528006-103528117,chr14,103528006,103528117,0,62582142
HepG2|chr14:41499987-41500112,chr14,41499987,41500112,HepG2|chr14:50105562-50105587,chr14,50105562,50105587,0,8605575
HepG2|chr14:41568403-41568534,chr14,41568403,41568534,HepG2|chr14:50103330-50103393,chr14,50103330,50103393,0,8534927
HepG2|chr14:41678426-41678556,chr14,41678426,41678556,HepG2|chr14:24456796-24456874,chr14,24456796,24456874,0,17221630
HepG2|chr14:41818723-41818815,chr14,41818723,41818815,HepG2|chr14:103528061-103528117,chr14,103528061,103528117,0,61709338
HepG2|chr14:42337347-42337460,chr14,42337347,42337460,HepG2|chr14:51414412-51414429,chr14,51414412,51414429,0,9077065
HepG2|chr14:42421163-42421233,chr14,42421163,42421233,HepG2|chr14:51414371-51414485,chr14,51414371,51414485,0,8993208
HepG2|chr14:42607857-42607909,chr14,42607857,42607909,HepG2|chr14:50105666-50105750,chr14,50105666,50105750,0,7497809
HepG2|chr14:42675036-42675186,chr14,42675036,42675186,HepG2|chr14:24421937-24422084,chr14,24421937,24422084,0,18253099
HepG2|chr14:42823983-42824071,chr14,42823983,42824071,HepG2|chr14:103528075-103528117,chr14,103528075,103528117,0,60704092
HepG2|chr14:42935805-42935826,chr14,42935805,42935826,HepG2|chr14:51415074-51415221,chr14,51415074,51415221,0,8479269
HepG2|chr14:43274227-43274323,chr14,43274227,43274323,HepG2|chr14:103055800-103055846,chr14,103055800,103055846,0,59781573
HepG2|chr14:43634640-43634720,chr14,43634640,43634720,HepG2|chr14:103528047-103528117,chr14,103528047,103528117,0,59893407
HepG2|chr14:43757157-43757264,chr14,43757157,43757264,HepG2|chr14:24456839-24456874,chr14,24456839,24456874,0,19300318
HepG2|chr14:43877562-43877663,chr14,43877562,43877663,HepG2|chr14:103055800-103055846,chr14,103055800,103055846,0,59178238
HepG2|chr14:44028772-44028898,chr14,44028772,44028898,HepG2|chr14:51414875-51414899,chr14,51414875,51414899,0,7386103
HepG2|chr14:44071265-44071410,chr14,44071265,44071410,HepG2|chr14:35186424-35186505,chr14,35186424,35186505,0,8884841
HepG2|chr14:44210166-44210212,chr14,44210166,44210212,HepG2|chr14:103528038-103528116,chr14,103528038,103528116,0,59317872
HepG2|chr14:44476019-44476153,chr14,44476019,44476153,HepG2|chr14:103055806-103055956,chr14,103055806,103055956,0,58579787
HepG2|chr14:44514935-44515060,chr14,44514935,44515060,HepG2|chr14:103055800-103055825,chr14,103055800,103055825,0,58540865
HepG2|chr14:44672661-44672794,chr14,44672661,44672794,HepG2|chr14:51414855-51414899,chr14,51414855,51414899,0,6742194
HepG2|chr14:44762480-44762570,chr14,44762480,44762570,HepG2|chr14:102772492-102772530,chr14,102772492,102772530,0,58010012
HepG2|chr14:44899218-44899248,chr14,44899218,44899248,HepG2|chr14:73496157-73496246,chr14,73496157,73496246,0,28596939
HepG2|chr14:44991770-44991879,chr14,44991770,44991879,HepG2|chr14:61791725-61791828,chr14,61791725,61791828,0,16799955
HepG2|chr14:45038453-45038488,chr14,45038453,45038488,HepG2|chr14:73495321-73495390,chr14,73495321,73495390,0,28456868
HepG2|chr14:45063642-45063788,chr14,45063642,45063788,HepG2|chr14:24421928-24422078,chr14,24421928,24422078,0,20641714
HepG2|chr14:45290866-45290927,chr14,45290866,45290927,HepG2|chr14:103528002-103528117,chr14,103528002,103528117,0,58237136
HepG2|chr14:45313968-45313993,chr14,45313968,45313993,HepG2|chr14:103527990-103528117,chr14,103527990,103528117,0,58214022
HepG2|chr14:45824016-45824091,chr14,45824016,45824091,HepG2|chr14:24052969-24053042,chr14,24052969,24053042,0,21771047
HepG2|chr14:45911059-45911167,chr14,45911059,45911167,HepG2|chr14:24456836-24456874,chr14,24456836,24456874,0,21454223
HepG2|chr14:46007773-46007869,chr14,46007773,46007869,HepG2|chr14:24439679-24439824,chr14,24439679,24439824,0,21568094
HepG2|chr14:46331525-46331614,chr14,46331525,46331614,HepG2|chr14:51414370-51414413,chr14,51414370,51414413,0,5082845
HepG2|chr14:46350298-46350336,chr14,46350298,46350336,HepG2|chr14:103527996-103528117,chr14,103527996,103528117,0,57177698
HepG2|chr14:46764779-46764838,chr14,46764779,46764838,HepG2|chr14:51414855-51414899,chr14,51414855,51414899,0,4650076
HepG2|chr14:47450559-47450589,chr14,47450559,47450589,HepG2|chr14:103527998-103528117,chr14,103527998,103528117,0,56077439
HepG2|chr14:47597445-47597511,chr14,47597445,47597511,HepG2|chr14:24456790-24456874,chr14,24456790,24456874,0,23140655
HepG2|chr14:47755511-47755557,chr14,47755511,47755557,HepG2|chr14:103528038-103528116,chr14,103528038,103528116,0,55772527
HepG2|chr14:47947855-47947958,chr14,47947855,47947958,HepG2|chr14:51414853-51414899,chr14,51414853,51414899,0,3466998
HepG2|chr14:48077600-48077633,chr14,48077600,48077633,HepG2|chr14:103528006-103528117,chr14,103528006,103528117,0,55450406
HepG2|chr14:48446815-48446917,chr14,48446815,48446917,HepG2|chr14:51414855-51414899,chr14,51414855,51414899,0,2968040
HepG2|chr14:48575721-48575792,chr14,48575721,48575792,HepG2|chr14:103528038-103528117,chr14,103528038,103528117,0,54952317
HepG2|chr14:48772475-48772621,chr14,48772475,48772621,HepG2|chr14:24421818-24421968,chr14,24421818,24421968,0,24350657
HepG2|chr14:48825036-48825102,chr14,48825036,48825102,HepG2|chr14:103527990-103528117,chr14,103527990,103528117,0,54702954
HepG2|chr14:49221821-49221971,chr14,49221821,49221971,HepG2|chr14:24421917-24422067,chr14,24421917,24422067,0,24799904
HepG2|chr14:49235630-49235669,chr14,49235630,49235669,HepG2|chr14:50102658-50102777,chr14,50102658,50102777,0,867028
HepG2|chr14:49628304-49628412,chr14,49628304,49628412,HepG2|chr14:24456836-24456874,chr14,24456836,24456874,0,25171468
HepG2|chr14:49730561-49730657,chr14,49730561,49730657,HepG2|chr14:103528063-103528117,chr14,103528063,103528117,0,53797502
HepG2|chr14:49900274-49900308,chr14,49900274,49900308,HepG2|chr14:103528001-103528117,chr14,103528001,103528117,0,53627727
HepG2|chr14:50236765-50236905,chr14,50236765,50236905,HepG2|chr14:103528090-103528117,chr14,103528090,103528117,0,53291325
HepG2|chr14:50303232-50303325,chr14,50303232,50303325,HepG2|chr14:50106907-50106964,chr14,50106907,50106964,0,196325
HepG2|chr14:50553931-50554037,chr14,50553931,50554037,HepG2|chr14:51414855-51414899,chr14,51414855,51414899,0,860924
HepG2|chr14:50841273-50841387,chr14,50841273,50841387,HepG2|chr14:24455998-24456148,chr14,24455998,24456148,0,26385275
HepG2|chr14:51062004-51062154,chr14,51062004,51062154,HepG2|chr14:103528000-103528117,chr14,103528000,103528117,0,52465996
HepG2|chr14:51199954-51199979,chr14,51199954,51199979,HepG2|chr14:103527990-103528117,chr14,103527990,103528117,0,52328036
HepG2|chr14:52238510-52238573,chr14,52238510,52238573,HepG2|chr14:34932118-34932156,chr14,34932118,34932156,0,17306392
HepG2|chr14:52424537-52424587,chr14,52424537,52424587,HepG2|chr14:70041355-70041450,chr14,70041355,70041450,0,17616818
HepG2|chr14:52569422-52569464,chr14,52569422,52569464,HepG2|chr14:50106423-50106531,chr14,50106423,50106531,0,2462999
HepG2|chr14:52594563-52594605,chr14,52594563,52594605,HepG2|chr14:51414791-51414899,chr14,51414791,51414899,0,1179772
HepG2|chr14:52724729-52724758,chr14,52724729,52724758,HepG2|chr14:50105433-50105572,chr14,50105433,50105572,0,2619296
HepG2|chr14:52895201-52895350,chr14,52895201,52895350,HepG2|chr14:103527996-103528117,chr14,103527996,103528117,0,50632795
HepG2|chr14:53018929-53019052,chr14,53018929,53019052,HepG2|chr14:103528090-103528117,chr14,103528090,103528117,0,50509161
HepG2|chr14:53100631-53100763,chr14,53100631,53100763,HepG2|chr14:103055800-103055826,chr14,103055800,103055826,0,49955169
HepG2|chr14:53172457-53172504,chr14,53172457,53172504,HepG2|chr14:103055800-103055903,chr14,103055800,103055903,0,49883343
HepG2|chr14:53351951-53352037,chr14,53351951,53352037,HepG2|chr14:51414424-51414485,chr14,51414424,51414485,0,1937527
HepG2|chr14:53662716-53662832,chr14,53662716,53662832,HepG2|chr14:103527994-103528117,chr14,103527994,103528117,0,49865278
HepG2|chr14:53965394-53965476,chr14,53965394,53965476,HepG2|chr14:24456762-24456874,chr14,24456762,24456874,0,29508632
HepG2|chr14:54101417-54101548,chr14,54101417,54101548,HepG2|chr14:103528089-103528117,chr14,103528089,103528117,0,49426672
HepG2|chr14:54322714-54322765,chr14,54322714,54322765,HepG2|chr14:103528023-103528117,chr14,103528023,103528117,0,49205309
HepG2|chr14:54432495-54432645,chr14,54432495,54432645,HepG2|chr14:50103975-50104059,chr14,50103975,50104059,0,4328520
HepG2|chr14:55014078-55014228,chr14,55014078,55014228,HepG2|chr14:103055800-103055825,chr14,103055800,103055825,0,48041722
HepG2|chr14:55021137-55021193,chr14,55021137,55021193,HepG2|chr14:50106299-50106393,chr14,50106299,50106393,0,4914838
HepG2|chr14:55177846-55177903,chr14,55177846,55177903,HepG2|chr14:103528002-103528117,chr14,103528002,103528117,0,48350156
HepG2|chr14:55441377-55441485,chr14,55441377,55441485,HepG2|chr14:103528062-103528117,chr14,103528062,103528117,0,48086685
HepG2|chr14:55642781-55642803,chr14,55642781,55642803,HepG2|chr14:21924570-21924706,chr14,21924570,21924706,0,33718211
HepG2|chr14:55886065-55886082,chr14,55886065,55886082,HepG2|chr14:75510675-75510804,chr14,75510675,75510804,0,19624610
HepG2|chr14:55930814-55930858,chr14,55930814,55930858,HepG2|chr14:103528041-103528117,chr14,103528041,103528117,0,47597227
HepG2|chr14:55987936-55987981,chr14,55987936,55987981,HepG2|chr14:103527997-103528117,chr14,103527997,103528117,0,47540061
HepG2|chr14:56101411-56101479,chr14,56101411,56101479,HepG2|chr14:24456792-24456874,chr14,24456792,24456874,0,31644619
HepG2|chr14:56170929-56170975,chr14,56170929,56170975,HepG2|chr14:34932122-34932156,chr14,34932122,34932156,0,21238807
HepG2|chr14:56388631-56388740,chr14,56388631,56388740,HepG2|chr14:103528088-103528117,chr14,103528088,103528117,0,47139457
HepG2|chr14:56565399-56565549,chr14,56565399,56565549,HepG2|chr14:103055800-103055825,chr14,103055800,103055825,0,46490401
HepG2|chr14:56774248-56774398,chr14,56774248,56774398,HepG2|chr14:103055800-103055839,chr14,103055800,103055839,0,46281552
HepG2|chr14:56861133-56861262,chr14,56861133,56861262,HepG2|chr14:50106676-50106697,chr14,50106676,50106697,0,6754457
HepG2|chr14:56970077-56970122,chr14,56970077,56970122,HepG2|chr14:51414771-51414899,chr14,51414771,51414899,0,5555306
HepG2|chr14:57163346-57163381,chr14,57163346,57163381,HepG2|chr14:103528061-103528117,chr14,103528061,103528117,0,46364715
HepG2|chr14:57284452-57284574,chr14,57284452,57284574,HepG2|chr14:103528056-103528117,chr14,103528056,103528117,0,46243604
HepG2|chr14:57394490-57394545,chr14,57394490,57394545,HepG2|chr14:103528046-103528117,chr14,103528046,103528117,0,46133556
HepG2|chr14:57638962-57638989,chr14,57638962,57638989,HepG2|chr14:103528044-103528117,chr14,103528044,103528117,0,45889082
HepG2|chr14:57671524-57671606,chr14,57671524,57671606,HepG2|chr14:24052967-24053044,chr14,24052967,24053044,0,33618557
HepG2|chr14:57836530-57836680,chr14,57836530,57836680,HepG2|chr14:103528002-103528117,chr14,103528002,103528117,0,45691472
HepG2|chr14:58409247-58409270,chr14,58409247,58409270,HepG2|chr14:103528002-103528117,chr14,103528002,103528117,0,45118755
HepG2|chr14:58787618-58787641,chr14,58787618,58787641,HepG2|chr14:73730088-73730203,chr14,73730088,73730203,0,14942470
HepG2|chr14:58804866-58804998,chr14,58804866,58804998,HepG2|chr14:51414879-51414899,chr14,51414879,51414899,0,7389987
HepG2|chr14:58884385-58884535,chr14,58884385,58884535,HepG2|chr14:103528089-103528117,chr14,103528089,103528117,0,44643704
HepG2|chr14:58885686-58885793,chr14,58885686,58885793,HepG2|chr14:24456839-24456874,chr14,24456839,24456874,0,34428847
HepG2|chr14:59052749-59052847,chr14,59052749,59052847,HepG2|chr14:103528065-103528117,chr14,103528065,103528117,0,44475316
HepG2|chr14:59316004-59316071,chr14,59316004,59316071,HepG2|chr14:103528061-103528117,chr14,103528061,103528117,0,44212057
HepG2|chr14:59368211-59368310,chr14,59368211,59368310,HepG2|chr14:103528089-103528117,chr14,103528089,103528117,0,44159878
HepG2|chr14:59395351-59395416,chr14,59395351,59395416,HepG2|chr14:74082193-74082343,chr14,74082193,74082343,0,14686842
HepG2|chr14:59725556-59725652,chr14,59725556,59725652,HepG2|chr14:24456820-24456874,chr14,24456820,24456874,0,35268736
HepG2|chr14:59823973-59824002,chr14,59823973,59824002,HepG2|chr14:50103716-50103837,chr14,50103716,50103837,0,9720257
HepG2|chr14:59935365-59935400,chr14,59935365,59935400,HepG2|chr14:103528002-103528117,chr14,103528002,103528117,0,43592637
HepG2|chr14:59975131-59975217,chr14,59975131,59975217,HepG2|chr14:50104615-50104679,chr14,50104615,50104679,0,9870516
HepG2|chr14:60365026-60365094,chr14,60365026,60365094,HepG2|chr14:51414408-51414485,chr14,51414408,51414485,0,8950618
HepG2|chr14:60365884-60365985,chr14,60365884,60365985,HepG2|chr14:103528070-103528117,chr14,103528070,103528117,0,43162186
HepG2|chr14:60607710-60607738,chr14,60607710,60607738,HepG2|chr14:103527995-103528117,chr14,103527995,103528117,0,42920285
HepG2|chr14:60705036-60705161,chr14,60705036,60705161,HepG2|chr14:103055800-103055825,chr14,103055800,103055825,0,42350764
HepG2|chr14:60750881-60750933,chr14,60750881,60750933,HepG2|chr14:50105666-50105750,chr14,50105666,50105750,0,10645215
HepG2|chr14:60812077-60812152,chr14,60812077,60812152,HepG2|chr14:24052969-24053042,chr14,24052969,24053042,0,36759108
HepG2|chr14:61176110-61176171,chr14,61176110,61176171,HepG2|chr14:103528002-103528117,chr14,103528002,103528117,0,42351892
HepG2|chr14:61177163-61177275,chr14,61177163,61177275,HepG2|chr14:103527996-103528117,chr14,103527996,103528117,0,42350833
HepG2|chr14:61253745-61253769,chr14,61253745,61253769,HepG2|chr14:103527996-103528117,chr14,103527996,103528117,0,42274251
HepG2|chr14:61467654-61467732,chr14,61467654,61467732,HepG2|chr14:51414430-51414485,chr14,51414430,51414485,0,10053224
HepG2|chr14:61564045-61564194,chr14,61564045,61564194,HepG2|chr14:103528002-103528117,chr14,103528002,103528117,0,41963957
HepG2|chr14:61598084-61598118,chr14,61598084,61598118,HepG2|chr14:50103498-50103580,chr14,50103498,50103580,0,11494586
HepG2|chr14:61772733-61772815,chr14,61772733,61772815,HepG2|chr14:51414428-51414485,chr14,51414428,51414485,0,10358305
HepG2|chr14:61898545-61898625,chr14,61898545,61898625,HepG2|chr14:24421833-24421983,chr14,24421833,24421983,0,37476712
HepG2|chr14:62047749-62047899,chr14,62047749,62047899,HepG2|chr14:24421928-24422078,chr14,24421928,24422078,0,37625821
HepG2|chr14:62056610-62056715,chr14,62056610,62056715,HepG2|chr14:50106504-50106531,chr14,50106504,50106531,0,11950106
HepG2|chr14:62526909-62527059,chr14,62526909,62527059,HepG2|chr14:24421937-24422084,chr14,24421937,24422084,0,38104972
HepG2|chr14:62712255-62712347,chr14,62712255,62712347,HepG2|chr14:103528061-103528117,chr14,103528061,103528117,0,40815806
HepG2|chr14:62790579-62790614,chr14,62790579,62790614,HepG2|chr14:73495321-73495390,chr14,73495321,73495390,0,10704742
HepG2|chr14:62816665-62816815,chr14,62816665,62816815,HepG2|chr14:50103975-50104059,chr14,50103975,50104059,0,12712690
HepG2|chr14:62960870-62960981,chr14,62960870,62960981,HepG2|chr14:51414880-51414899,chr14,51414880,51414899,0,11545990
HepG2|chr14:62997282-62997316,chr14,62997282,62997316,HepG2|chr14:103527996-103528112,chr14,103527996,103528112,0,40530714
HepG2|chr14:63282811-63282961,chr14,63282811,63282961,HepG2|chr14:103527996-103528117,chr14,103527996,103528117,0,40245185
HepG2|chr14:63316091-63316122,chr14,63316091,63316122,HepG2|chr14:103528002-103528117,chr14,103528002,103528117,0,40211911
HepG2|chr14:63587395-63587461,chr14,63587395,63587461,HepG2|chr14:24456790-24456874,chr14,24456790,24456874,0,39130605
HepG2|chr14:63836621-63836744,chr14,63836621,63836744,HepG2|chr14:51414405-51414485,chr14,51414405,51414485,0,12422216
HepG2|chr14:63858934-63859005,chr14,63858934,63859005,HepG2|chr14:103528038-103528117,chr14,103528038,103528117,0,39669104
HepG2|chr14:64036588-64036738,chr14,64036588,64036738,HepG2|chr14:24421935-24422084,chr14,24421935,24422084,0,39614653
HepG2|chr14:64128608-64128712,chr14,64128608,64128712,HepG2|chr14:103528041-103528117,chr14,103528041,103528117,0,39399433
HepG2|chr14:64155509-64155607,chr14,64155509,64155607,HepG2|chr14:35185974-35186042,chr14,35185974,35186042,0,28969535
HepG2|chr14:64285273-64285347,chr14,64285273,64285347,HepG2|chr14:103528041-103528117,chr14,103528041,103528117,0,39242768
HepG2|chr14:64353797-64353927,chr14,64353797,64353927,HepG2|chr14:24456796-24456874,chr14,24456796,24456874,0,39897001
HepG2|chr14:64465506-64465653,chr14,64465506,64465653,HepG2|chr14:24456364-24456421,chr14,24456364,24456421,0,40009142
HepG2|chr14:64607449-64607500,chr14,64607449,64607500,HepG2|chr14:103528022-103528057,chr14,103528022,103528057,0,38920573
HepG2|chr14:65098575-65098673,chr14,65098575,65098673,HepG2|chr14:103528065-103528117,chr14,103528065,103528117,0,38429490
HepG2|chr14:65101191-65101341,chr14,65101191,65101341,HepG2|chr14:103055800-103055846,chr14,103055800,103055846,0,37954609
HepG2|chr14:65118622-65118643,chr14,65118622,65118643,HepG2|chr14:51415074-51415221,chr14,51415074,51415221,0,13703548
HepG2|chr14:65325626-65325776,chr14,65325626,65325776,HepG2|chr14:24438712-24438862,chr14,24438712,24438862,0,40886914
HepG2|chr14:65647012-65647146,chr14,65647012,65647146,HepG2|chr14:103055806-103055956,chr14,103055806,103055956,0,37408794
HepG2|chr14:65861671-65861728,chr14,65861671,65861728,HepG2|chr14:24456364-24456440,chr14,24456364,24456440,0,41405307
HepG2|chr14:65880759-65880786,chr14,65880759,65880786,HepG2|chr14:51414682-51414832,chr14,51414682,51414832,0,14466077
HepG2|chr14:65944441-65944469,chr14,65944441,65944469,HepG2|chr14:103527995-103528117,chr14,103527995,103528117,0,37583554
HepG2|chr14:66099571-66099659,chr14,66099571,66099659,HepG2|chr14:103528059-103528117,chr14,103528059,103528117,0,37428488
HepG2|chr14:66203240-66203372,chr14,66203240,66203372,HepG2|chr14:51414879-51414899,chr14,51414879,51414899,0,14788361
HepG2|chr14:66253930-66254009,chr14,66253930,66254009,HepG2|chr14:103055800-103055822,chr14,103055800,103055822,0,36801870
HepG2|chr14:66348039-66348140,chr14,66348039,66348140,HepG2|chr14:21925862-21925880,chr14,21925862,21925880,0,44422177
HepG2|chr14:66376591-66376663,chr14,66376591,66376663,HepG2|chr14:103528001-103528117,chr14,103528001,103528117,0,37151410
HepG2|chr14:66394882-66394975,chr14,66394882,66394975,HepG2|chr14:51414857-51414899,chr14,51414857,51414899,0,14980025
HepG2|chr14:66557887-66557959,chr14,66557887,66557959,HepG2|chr14:103528001-103528117,chr14,103528001,103528117,0,36970114
HepG2|chr14:66625779-66625888,chr14,66625779,66625888,HepG2|chr14:61791725-61791828,chr14,61791725,61791828,0,4834054
HepG2|chr14:66722076-66722104,chr14,66722076,66722104,HepG2|chr14:103527995-103528117,chr14,103527995,103528117,0,36805919
HepG2|chr14:67135159-67135309,chr14,67135159,67135309,HepG2|chr14:103528002-103528117,chr14,103528002,103528117,0,36392843
HepG2|chr14:67186290-67186397,chr14,67186290,67186397,HepG2|chr14:61791725-61791828,chr14,61791725,61791828,0,5394565
HepG2|chr14:67636170-67636273,chr14,67636170,67636273,HepG2|chr14:50104615-50104679,chr14,50104615,50104679,0,17531555
HepG2|chr14:67679132-67679264,chr14,67679132,67679264,HepG2|chr14:103527995-103528117,chr14,103527995,103528117,0,35848863
HepG2|chr14:67707474-67707520,chr14,67707474,67707520,HepG2|chr14:103527996-103528117,chr14,103527996,103528117,0,35820522
HepG2|chr14:67736033-67736154,chr14,67736033,67736154,HepG2|chr14:103528088-103528117,chr14,103528088,103528117,0,35792055
HepG2|chr14:67814923-67814989,chr14,67814923,67814989,HepG2|chr14:50106299-50106393,chr14,50106299,50106393,0,17708624
HepG2|chr14:67829389-67829471,chr14,67829389,67829471,HepG2|chr14:51414428-51414485,chr14,51414428,51414485,0,16414961
HepG2|chr14:67988828-67988923,chr14,67988828,67988923,HepG2|chr14:51414857-51414899,chr14,51414857,51414899,0,16573971
HepG2|chr14:68129908-68130005,chr14,68129908,68130005,HepG2|chr14:103055800-103055822,chr14,103055800,103055822,0,34925892
HepG2|chr14:68304546-68304614,chr14,68304546,68304614,HepG2|chr14:103527996-103528117,chr14,103527996,103528117,0,35223450
HepG2|chr14:69288889-69288959,chr14,69288889,69288959,HepG2|chr14:21922461-21922547,chr14,21922461,21922547,0,47366428
HepG2|chr14:70069592-70069741,chr14,70069592,70069741,HepG2|chr14:24438713-24438844,chr14,24438713,24438844,0,45630879
HepG2|chr14:70144469-70144611,chr14,70144469,70144611,HepG2|chr14:24456364-24456440,chr14,24456364,24456440,0,45688105
HepG2|chr14:70200627-70200657,chr14,70200627,70200657,HepG2|chr14:50105214-50105336,chr14,50105214,50105336,0,20095413
HepG2|chr14:70358122-70358224,chr14,70358122,70358224,HepG2|chr14:103055800-103055903,chr14,103055800,103055903,0,32697678
HepG2|chr14:70762164-70762263,chr14,70762164,70762263,HepG2|chr14:103528097-103528117,chr14,103528097,103528117,0,32765933
HepG2|chr14:70818814-70818962,chr14,70818814,70818962,HepG2|chr14:24421917-24422067,chr14,24421917,24422067,0,46396897
HepG2|chr14:71014691-71014781,chr14,71014691,71014781,HepG2|chr14:102772492-102772530,chr14,102772492,102772530,0,31757801
HepG2|chr14:71402653-71402675,chr14,71402653,71402675,HepG2|chr14:51414771-51414899,chr14,51414771,51414899,0,19987882
HepG2|chr14:71433917-71433998,chr14,71433917,71433998,HepG2|chr14:103528061-103528117,chr14,103528061,103528117,0,32094144
HepG2|chr14:71806843-71806899,chr14,71806843,71806899,HepG2|chr14:103522997-103523059,chr14,103522997,103523059,0,31716154
HepG2|chr14:71986401-71986502,chr14,71986401,71986502,HepG2|chr14:51414708-51414858,chr14,51414708,51414858,0,20571693
HepG2|chr14:72111756-72111840,chr14,72111756,72111840,HepG2|chr14:103528050-103528115,chr14,103528050,103528115,0,31416294
HepG2|chr14:72192261-72192313,chr14,72192261,72192313,HepG2|chr14:103527996-103528117,chr14,103527996,103528117,0,31335735
HepG2|chr14:72290718-72290758,chr14,72290718,72290758,HepG2|chr14:24421535-24421685,chr14,24421535,24421685,0,47869183
HepG2|chr14:72294524-72294577,chr14,72294524,72294577,HepG2|chr14:103527996-103528112,chr14,103527996,103528112,0,31233472
HepG2|chr14:72344807-72344912,chr14,72344807,72344912,HepG2|chr14:50102369-50102414,chr14,50102369,50102414,0,22242438
HepG2|chr14:72800592-72800710,chr14,72800592,72800710,HepG2|chr14:50106165-50106197,chr14,50106165,50106197,0,22694427
HepG2|chr14:72875746-72875842,chr14,72875746,72875842,HepG2|chr14:24439679-24439824,chr14,24439679,24439824,0,48436067
HepG2|chr14:73044892-73045023,chr14,73044892,73045023,HepG2|chr14:50103330-50103393,chr14,50103330,50103393,0,22941562
HepG2|chr14:73059173-73059236,chr14,73059173,73059236,HepG2|chr14:103055803-103055953,chr14,103055803,103055953,0,29996630
HepG2|chr14:73277437-73277543,chr14,73277437,73277543,HepG2|chr14:103527995-103528117,chr14,103527995,103528117,0,30250558
HepG2|chr14:73583927-73583966,chr14,73583927,73583966,HepG2|chr14:34932120-34932156,chr14,34932120,34932156,0,38651807
HepG2|chr14:73690739-73690889,chr14,73690739,73690889,HepG2|chr14:24421938-24422084,chr14,24421938,24422084,0,49268801
HepG2|chr14:73720538-73720574,chr14,73720538,73720574,HepG2|chr14:50106648-50106737,chr14,50106648,50106737,0,23613890
HepG2|chr14:73738878-73739028,chr14,73738878,73739028,HepG2|chr14:103527996-103528117,chr14,103527996,103528117,0,29789118
HepG2|chr14:73781733-73781883,chr14,73781733,73781883,HepG2|chr14:24421916-24422066,chr14,24421916,24422066,0,49359817
HepG2|chr14:74233626-74233771,chr14,74233626,74233771,HepG2|chr14:35186424-35186505,chr14,35186424,35186505,0,39047202
HepG2|chr14:74478148-74478191,chr14,74478148,74478191,HepG2|chr14:103528040-103528117,chr14,103528040,103528117,0,29049892
HepG2|chr14:74888988-74889026,chr14,74888988,74889026,HepG2|chr14:24456762-24456874,chr14,24456762,24456874,0,50432226
HepG2|chr14:75046813-75046848,chr14,75046813,75046848,HepG2|chr14:103528061-103528117,chr14,103528061,103528117,0,28481248
HepG2|chr14:75607339-75607394,chr14,75607339,75607394,HepG2|chr14:103528023-103528117,chr14,103528023,103528117,0,27920684
HepG2|chr14:75736034-75736077,chr14,75736034,75736077,HepG2|chr14:103528040-103528117,chr14,103528040,103528117,0,27792006
HepG2|chr14:76058347-76058441,chr14,76058347,76058441,HepG2|chr14:50102242-50102392,chr14,50102242,50102392,0,25956105
HepG2|chr14:76319199-76319305,chr14,76319199,76319305,HepG2|chr14:51414855-51414899,chr14,51414855,51414899,0,24904344
HepG2|chr14:76404046-76404136,chr14,76404046,76404136,HepG2|chr14:51414417-51414485,chr14,51414417,51414485,0,24989629
HepG2|chr14:76473642-76473767,chr14,76473642,76473767,HepG2|chr14:50105562-50105587,chr14,50105562,50105587,0,26368080
HepG2|chr14:76581604-76581754,chr14,76581604,76581754,HepG2|chr14:24421938-24422084,chr14,24421938,24422084,0,52159666
HepG2|chr14:76730718-76730829,chr14,76730718,76730829,HepG2|chr14:51414880-51414899,chr14,51414880,51414899,0,25315838
HepG2|chr14:76836910-76836958,chr14,76836910,76836958,HepG2|chr14:51414852-51414899,chr14,51414852,51414899,0,25422058
HepG2|chr14:77151826-77151874,chr14,77151826,77151874,HepG2|chr14:51414852-51414899,chr14,51414852,51414899,0,25736974
HepG2|chr14:77316175-77316204,chr14,77316175,77316204,HepG2|chr14:50105433-50105572,chr14,50105433,50105572,0,27210742
HepG2|chr14:77499902-77500022,chr14,77499902,77500022,HepG2|chr14:50103478-50103497,chr14,50103478,50103497,0,27396424
HepG2|chr14:77704947-77704994,chr14,77704947,77704994,HepG2|chr14:103528013-103528116,chr14,103528013,103528116,0,25823066
HepG2|chr14:77759588-77759691,chr14,77759588,77759691,HepG2|chr14:103055797-103055826,chr14,103055797,103055826,0,25296209
HepG2|chr14:77903339-77903432,chr14,77903339,77903432,HepG2|chr14:103528061-103528117,chr14,103528061,103528117,0,25624722
HepG2|chr14:78548820-78548893,chr14,78548820,78548893,HepG2|chr14:51414408-51414485,chr14,51414408,51414485,0,27134412
HepG2|chr14:78634103-78634204,chr14,78634103,78634204,HepG2|chr14:103528038-103528117,chr14,103528038,103528117,0,24893935
HepG2|chr14:78929064-78929142,chr14,78929064,78929142,HepG2|chr14:51414430-51414485,chr14,51414430,51414485,0,27514634
HepG2|chr14:78936550-78936602,chr14,78936550,78936602,HepG2|chr14:51414759-51414900,chr14,51414759,51414900,0,27521791
HepG2|chr14:79067289-79067439,chr14,79067289,79067439,HepG2|chr14:24439764-24439797,chr14,24439764,24439797,0,54627525
HepG2|chr14:79641607-79641753,chr14,79641607,79641753,HepG2|chr14:102775106-102775139,chr14,102775106,102775139,0,23133499
HepG2|chr14:80222473-80222558,chr14,80222473,80222558,HepG2|chr14:50103330-50103393,chr14,50103330,50103393,0,30119143
HepG2|chr14:80305273-80305370,chr14,80305273,80305370,HepG2|chr14:50106698-50106840,chr14,50106698,50106840,0,30198575
HepG2|chr14:80520754-80520866,chr14,80520754,80520866,HepG2|chr14:103527996-103528117,chr14,103527996,103528117,0,23007242
HepG2|chr14:80542388-80542537,chr14,80542388,80542537,HepG2|chr14:103528002-103528117,chr14,103528002,103528117,0,22985614
HepG2|chr14:80722220-80722305,chr14,80722220,80722305,HepG2|chr14:51414424-51414485,chr14,51414424,51414485,0,29307796
HepG2|chr14:80848979-80849129,chr14,80848979,80849129,HepG2|chr14:24421917-24422067,chr14,24421917,24422067,0,56427062
HepG2|chr14:80874730-80874785,chr14,80874730,80874785,HepG2|chr14:103527523-103527673,chr14,103527523,103527673,0,22652793
HepG2|chr14:81085267-81085417,chr14,81085267,81085417,HepG2|chr14:24421935-24422084,chr14,24421935,24422084,0,56663332
HepG2|chr14:81358825-81358847,chr14,81358825,81358847,HepG2|chr14:103527990-103528117,chr14,103527990,103528117,0,22169165
HepG2|chr14:81396597-81396726,chr14,81396597,81396726,HepG2|chr14:50106676-50106697,chr14,50106676,50106697,0,31289921
HepG2|chr14:81664045-81664105,chr14,81664045,81664105,HepG2|chr14:24456363-24456448,chr14,24456363,24456448,0,57207682
HepG2|chr14:81941313-81941446,chr14,81941313,81941446,HepG2|chr14:51414855-51414899,chr14,51414855,51414899,0,30526458
HepG2|chr14:82558612-82558703,chr14,82558612,82558703,HepG2|chr14:103527990-103528117,chr14,103527990,103528117,0,20969378
HepG2|chr14:82750582-82750612,chr14,82750582,82750612,HepG2|chr14:50105214-50105336,chr14,50105214,50105336,0,32645368
HepG2|chr14:82948530-82948565,chr14,82948530,82948565,HepG2|chr14:103528002-103528117,chr14,103528002,103528117,0,20579472
HepG2|chr14:83002180-83002303,chr14,83002180,83002303,HepG2|chr14:103528090-103528117,chr14,103528090,103528117,0,20525910
HepG2|chr14:83087607-83087641,chr14,83087607,83087641,HepG2|chr14:50103498-50103580,chr14,50103498,50103580,0,32984109
HepG2|chr14:83248546-83248600,chr14,83248546,83248600,HepG2|chr14:103527992-103528117,chr14,103527992,103528117,0,20279446
HepG2|chr14:83516722-83516782,chr14,83516722,83516782,HepG2|chr14:103528000-103528117,chr14,103528000,103528117,0,20011278
HepG2|chr14:83617140-83617290,chr14,83617140,83617290,HepG2|chr14:24421924-24422071,chr14,24421924,24422071,0,59195216
HepG2|chr14:83622702-83622772,chr14,83622702,83622772,HepG2|chr14:103527990-103528117,chr14,103527990,103528117,0,19905288
HepG2|chr14:83860615-83860763,chr14,83860615,83860763,HepG2|chr14:24422582-24422732,chr14,24422582,24422732,0,59438033
HepG2|chr14:84345143-84345229,chr14,84345143,84345229,HepG2|chr14:103527996-103528117,chr14,103527996,103528117,0,19182853
HepG2|chr14:84373271-84373351,chr14,84373271,84373351,HepG2|chr14:24421522-24421672,chr14,24421522,24421672,0,59951749
HepG2|chr14:84644249-84644399,chr14,84644249,84644399,HepG2|chr14:50106676-50106697,chr14,50106676,50106697,0,34537573
HepG2|chr14:85085880-85085921,chr14,85085880,85085921,HepG2|chr14:50105976-50105998,chr14,50105976,50105998,0,34979904
HepG2|chr14:85383067-85383125,chr14,85383067,85383125,HepG2|chr14:51414428-51414485,chr14,51414428,51414485,0,33968639
HepG2|chr14:85459724-85459808,chr14,85459724,85459808,HepG2|chr14:103528050-103528115,chr14,103528050,103528115,0,18068326
HepG2|chr14:85605324-85605437,chr14,85605324,85605437,HepG2|chr14:24456835-24456874,chr14,24456835,24456874,0,61148489
HepG2|chr14:85692237-85692322,chr14,85692237,85692322,HepG2|chr14:50103330-50103393,chr14,50103330,50103393,0,35588907
HepG2|chr14:85703861-85703918,chr14,85703861,85703918,HepG2|chr14:103528002-103528117,chr14,103528002,103528117,0,17824141
HepG2|chr14:85830016-85830104,chr14,85830016,85830104,HepG2|chr14:103528075-103528117,chr14,103528075,103528117,0,17698059
HepG2|chr14:86063762-86063855,chr14,86063762,86063855,HepG2|chr14:103528000-103528117,chr14,103528000,103528117,0,17464238
HepG2|chr14:86309745-86309848,chr14,86309745,86309848,HepG2|chr14:51414853-51414899,chr14,51414853,51414899,0,34894892
HepG2|chr14:86492427-86492495,chr14,86492427,86492495,HepG2|chr14:103527996-103528117,chr14,103527996,103528117,0,17035569
HepG2|chr14:86513554-86513603,chr14,86513554,86513603,HepG2|chr14:103528038-103528117,chr14,103528038,103528117,0,17014484
HepG2|chr14:86807154-86807234,chr14,86807154,86807234,HepG2|chr14:103528047-103528117,chr14,103528047,103528117,0,16720893
HepG2|chr14:86894498-86894618,chr14,86894498,86894618,HepG2|chr14:50106165-50106197,chr14,50106165,50106197,0,36788333
HepG2|chr14:87251442-87251494,chr14,87251442,87251494,HepG2|chr14:50106580-50106730,chr14,50106580,50106730,0,37144862
HepG2|chr14:87356179-87356228,chr14,87356179,87356228,HepG2|chr14:103528013-103528116,chr14,103528013,103528116,0,16171834
HepG2|chr14:87411824-87411952,chr14,87411824,87411952,HepG2|chr14:103055800-103055822,chr14,103055800,103055822,0,15643976
HepG2|chr14:87500767-87500836,chr14,87500767,87500836,HepG2|chr14:35186424-35186505,chr14,35186424,35186505,0,52314343
HepG2|chr14:87571073-87571220,chr14,87571073,87571220,HepG2|chr14:24421922-24422072,chr14,24421922,24422072,0,63149151
HepG2|chr14:88183160-88183207,chr14,88183160,88183207,HepG2|chr14:50106776-50106827,chr14,50106776,50106827,0,38076384
HepG2|chr14:88369462-88369612,chr14,88369462,88369612,HepG2|chr14:103527996-103528117,chr14,103527996,103528117,0,15158534
HepG2|chr14:88409758-88409792,chr14,88409758,88409792,HepG2|chr14:103528001-103528117,chr14,103528001,103528117,0,15118243
HepG2|chr14:88538701-88538734,chr14,88538701,88538734,HepG2|chr14:103528002-103528117,chr14,103528002,103528117,0,14989301
HepG2|chr14:88603174-88603201,chr14,88603174,88603201,HepG2|chr14:103528044-103528117,chr14,103528044,103528117,0,14924870
HepG2|chr14:88775256-88775273,chr14,88775256,88775273,HepG2|chr14:51413005-51413150,chr14,51413005,51413150,0,37362251
HepG2|chr14:88778067-88778217,chr14,88778067,88778217,HepG2|chr14:24421939-24422084,chr14,24421939,24422084,0,64356128
HepG2|chr14:88956075-88956170,chr14,88956075,88956170,HepG2|chr14:103528062-103528117,chr14,103528062,103528117,0,14571987
HepG2|chr14:89201291-89201367,chr14,89201291,89201367,HepG2|chr14:103528044-103528117,chr14,103528044,103528117,0,14326753
HepG2|chr14:89472091-89472147,chr14,89472091,89472147,HepG2|chr14:75510486-75510549,chr14,75510486,75510549,0,13961605
HepG2|chr14:89505652-89505736,chr14,89505652,89505736,HepG2|chr14:103527995-103528117,chr14,103527995,103528117,0,14022343
HepG2|chr14:89525363-89525405,chr14,89525363,89525405,HepG2|chr14:50106423-50106531,chr14,50106423,50106531,0,39418940
HepG2|chr14:89573377-89573527,chr14,89573377,89573527,HepG2|chr14:103055800-103055846,chr14,103055800,103055846,0,13482423
HepG2|chr14:89628001-89628041,chr14,89628001,89628041,HepG2|chr14:51414408-51414485,chr14,51414408,51414485,0,38213593
HepG2|chr14:90053346-90053404,chr14,90053346,90053404,HepG2|chr14:103527995-103528117,chr14,103527995,103528117,0,13474649
HepG2|chr14:90109537-90109600,chr14,90109537,90109600,HepG2|chr14:103055803-103055953,chr14,103055803,103055953,0,12946266
HepG2|chr14:90345451-90345545,chr14,90345451,90345545,HepG2|chr14:103528061-103528117,chr14,103528061,103528117,0,13182610
HepG2|chr14:90367445-90367595,chr14,90367445,90367595,HepG2|chr14:103527996-103528117,chr14,103527996,103528117,0,13160551
HepG2|chr14:90431502-90431522,chr14,90431502,90431522,HepG2|chr14:103527996-103528117,chr14,103527996,103528117,0,13096494
HepG2|chr14:90534680-90534769,chr14,90534680,90534769,HepG2|chr14:51414370-51414413,chr14,51414370,51414413,0,39120310
HepG2|chr14:90566321-90566417,chr14,90566321,90566417,HepG2|chr14:24456820-24456874,chr14,24456820,24456874,0,66109501
HepG2|chr14:90858406-90858503,chr14,90858406,90858503,HepG2|chr14:103528064-103528117,chr14,103528064,103528117,0,12669658
HepG2|chr14:91012966-91013116,chr14,91012966,91013116,HepG2|chr14:50105562-50105587,chr14,50105562,50105587,0,40907404
HepG2|chr14:92056810-92056864,chr14,92056810,92056864,HepG2|chr14:50106787-50106937,chr14,50106787,50106937,0,41950023
HepG2|chr14:92815685-92815742,chr14,92815685,92815742,HepG2|chr14:24456364-24456440,chr14,24456364,24456440,0,68359321
HepG2|chr14:93080634-93080736,chr14,93080634,93080736,HepG2|chr14:51414855-51414899,chr14,51414855,51414899,0,41665779
HepG2|chr14:93276223-93276282,chr14,93276223,93276282,HepG2|chr14:103527996-103528117,chr14,103527996,103528117,0,10251773
HepG2|chr14:93489736-93489843,chr14,93489736,93489843,HepG2|chr14:61791725-61791828,chr14,61791725,61791828,0,31698011
HepG2|chr14:93639258-93639317,chr14,93639258,93639317,HepG2|chr14:103528048-103528113,chr14,103528048,103528113,0,9888790
HepG2|chr14:93817250-93817346,chr14,93817250,93817346,HepG2|chr14:103055800-103055846,chr14,103055800,103055846,0,9238550
HepG2|chr14:94017651-94017737,chr14,94017651,94017737,HepG2|chr14:50104615-50104679,chr14,50104615,50104679,0,43913036
HepG2|chr14:94130452-94130602,chr14,94130452,94130602,HepG2|chr14:103527999-103528117,chr14,103527999,103528117,0,9397547
HepG2|chr14:94233710-94233756,chr14,94233710,94233756,HepG2|chr14:51414791-51414895,chr14,51414791,51414895,0,42818919
HepG2|chr14:94286903-94286969,chr14,94286903,94286969,HepG2|chr14:50103975-50104059,chr14,50103975,50104059,0,44182928
HepG2|chr14:94546957-94547047,chr14,94546957,94547047,HepG2|chr14:51414417-51414485,chr14,51414417,51414485,0,43132540
HepG2|chr14:94661702-94661744,chr14,94661702,94661744,HepG2|chr14:51414791-51414899,chr14,51414791,51414899,0,43246911
HepG2|chr14:95167253-95167270,chr14,95167253,95167270,HepG2|chr14:75510675-75510804,chr14,75510675,75510804,0,19656578
HepG2|chr14:95387246-95387396,chr14,95387246,95387396,HepG2|chr14:103055800-103055839,chr14,103055800,103055839,0,7668554
HepG2|chr14:95390133-95390238,chr14,95390133,95390238,HepG2|chr14:50106504-50106531,chr14,50106504,50106531,0,45283629
HepG2|chr14:95913747-95913822,chr14,95913747,95913822,HepG2|chr14:102790469-102790532,chr14,102790469,102790532,0,6876722
HepG2|chr14:96069960-96070037,chr14,96069960,96070037,HepG2|chr14:103528059-103528117,chr14,103528059,103528117,0,7458099
HepG2|chr14:96092481-96092630,chr14,96092481,96092630,HepG2|chr14:103527996-103528117,chr14,103527996,103528117,0,7435515
HepG2|chr14:96172540-96172634,chr14,96172540,96172634,HepG2|chr14:50102242-50102392,chr14,50102242,50102392,0,46070298
HepG2|chr14:96274877-96274905,chr14,96274877,96274905,HepG2|chr14:103527995-103528117,chr14,103527995,103528117,0,7253118
HepG2|chr14:96532991-96533038,chr14,96532991,96533038,HepG2|chr14:50106776-50106827,chr14,50106776,50106827,0,46426215
HepG2|chr14:96717693-96717843,chr14,96717693,96717843,HepG2|chr14:103055800-103055822,chr14,103055800,103055822,0,6338107
HepG2|chr14:96786103-96786172,chr14,96786103,96786172,HepG2|chr14:103528036-103528117,chr14,103528036,103528117,0,6741933
HepG2|chr14:96800270-96800346,chr14,96800270,96800346,HepG2|chr14:103528044-103528117,chr14,103528044,103528117,0,6727774
HepG2|chr14:96805411-96805542,chr14,96805411,96805542,HepG2|chr14:103528089-103528117,chr14,103528089,103528117,0,6722678
HepG2|chr14:96992434-96992566,chr14,96992434,96992566,HepG2|chr14:103055800-103055826,chr14,103055800,103055826,0,6063366
HepG2|chr14:97236123-97236273,chr14,97236123,97236273,HepG2|chr14:103527996-103528117,chr14,103527996,103528117,0,6291873
HepG2|chr14:97941783-97941892,chr14,97941783,97941892,HepG2|chr14:103528088-103528117,chr14,103528088,103528117,0,5586305
HepG2|chr14:98129601-98129722,chr14,98129601,98129722,HepG2|chr14:103528088-103528117,chr14,103528088,103528117,0,5398487
HepG2|chr14:98264855-98264979,chr14,98264855,98264979,HepG2|chr14:103055800-103055826,chr14,103055800,103055826,0,4790945
HepG2|chr14:98309796-98309915,chr14,98309796,98309915,HepG2|chr14:103528064-103528117,chr14,103528064,103528117,0,5218268
HepG2|chr14:98362706-98362764,chr14,98362706,98362764,HepG2|chr14:51414428-51414485,chr14,51414428,51414485,0,46948278
HepG2|chr14:98390405-98390461,chr14,98390405,98390461,HepG2|chr14:75510486-75510549,chr14,75510486,75510549,0,22879919
HepG2|chr14:98491781-98491849,chr14,98491781,98491849,HepG2|chr14:24456792-24456874,chr14,24456792,24456874,0,74034989
HepG2|chr14:98582859-98582890,chr14,98582859,98582890,HepG2|chr14:50105976-50105998,chr14,50105976,50105998,0,48476883
HepG2|chr14:98723152-98723265,chr14,98723152,98723265,HepG2|chr14:24456835-24456874,chr14,24456835,24456874,0,74266317
HepG2|chr14:98767450-98767539,chr14,98767450,98767539,HepG2|chr14:103528056-103528117,chr14,103528056,103528117,0,4760606
HepG2|chr14:98826936-98827027,chr14,98826936,98827027,HepG2|chr14:50103716-50103837,chr14,50103716,50103837,0,48723220
HepG2|chr14:98841354-98841483,chr14,98841354,98841483,HepG2|chr14:51414879-51414899,chr14,51414879,51414899,0,47426475
HepG2|chr14:98901209-98901289,chr14,98901209,98901289,HepG2|chr14:24421833-24421983,chr14,24421833,24421983,0,74479376
HepG2|chr14:98997834-98997888,chr14,98997834,98997888,HepG2|chr14:50106787-50106937,chr14,50106787,50106937,0,48891047
HepG2|chr14:99272508-99272630,chr14,99272508,99272630,HepG2|chr14:103528056-103528117,chr14,103528056,103528117,0,4255548
HepG2|chr14:99482482-99482632,chr14,99482482,99482632,HepG2|chr14:24421932-24422082,chr14,24421932,24422082,0,75060550
HepG2|chr14:99562701-99562812,chr14,99562701,99562812,HepG2|chr14:103055800-103055839,chr14,103055800,103055839,0,3493099
HepG2|chr14:99580004-99580122,chr14,99580004,99580122,HepG2|chr14:50106165-50106197,chr14,50106165,50106197,0,49473839
HepG2|chr14:99675143-99675225,chr14,99675143,99675225,HepG2|chr14:24456762-24456874,chr14,24456762,24456874,0,75218381
HepG2|chr14:99932511-99932553,chr14,99932511,99932553,HepG2|chr14:103528002-103528117,chr14,103528002,103528117,0,3595491
HepG2|chr14:100075657-100075701,chr14,100075657,100075701,HepG2|chr14:51414380-51414485,chr14,51414380,51414485,0,48661277
HepG2|chr14:100224828-100224978,chr14,100224828,100224978,HepG2|chr14:24421932-24422082,chr14,24421932,24422082,0,75802896
HepG2|chr14:100702363-100702511,chr14,100702363,100702511,HepG2|chr14:24422582-24422732,chr14,24422582,24422732,0,76279781
HepG2|chr14:100775920-100775972,chr14,100775920,100775972,HepG2|chr14:103527996-103528117,chr14,103527996,103528117,0,2752076
HepG2|chr14:100920456-100920606,chr14,100920456,100920606,HepG2|chr14:24422737-24422778,chr14,24422737,24422778,0,76497719
HepG2|chr14:101052465-101052516,chr14,101052465,101052516,HepG2|chr14:103528022-103528057,chr14,103528022,103528057,0,2475557
HepG2|chr14:101228423-101228475,chr14,101228423,101228475,HepG2|chr14:50106580-50106730,chr14,50106580,50106730,0,51121843
HepG2|chr14:101300739-101300760,chr14,101300739,101300760,HepG2|chr14:103528005-103528117,chr14,103528005,103528117,0,2227266
HepG2|chr14:101479229-101479325,chr14,101479229,101479325,HepG2|chr14:103528063-103528117,chr14,103528063,103528117,0,2048834
HepG2|chr14:101758020-101758047,chr14,101758020,101758047,HepG2|chr14:50105214-50105336,chr14,50105214,50105336,0,51652806
HepG2|chr14:101819216-101819272,chr14,101819216,101819272,HepG2|chr14:50106299-50106393,chr14,50106299,50106393,0,51712917
HepG2|chr14:101972990-101973136,chr14,101972990,101973136,HepG2|chr14:24421818-24421968,chr14,24421818,24421968,0,77551172
HepG2|chr14:102123027-102123053,chr14,102123027,102123053,HepG2|chr14:103527996-103528117,chr14,103527996,103528117,0,1404969
HepG2|chr14:102242318-102242462,chr14,102242318,102242462,HepG2|chr14:24421917-24422067,chr14,24421917,24422067,0,77820401
HepG2|chr14:102292437-102292482,chr14,102292437,102292482,HepG2|chr14:103527997-103528117,chr14,103527997,103528117,0,1235560
HepG2|chr14:102441500-102441650,chr14,102441500,102441650,HepG2|chr14:103527996-103528117,chr14,103527996,103528117,0,1086496
HepG2|chr14:102572666-102572775,chr14,102572666,102572775,HepG2|chr14:51414858-51414899,chr14,51414858,51414899,0,51157808
HepG2|chr14:102901059-102901098,chr14,102901059,102901098,HepG2|chr14:103528002-103528117,chr14,103528002,103528117,0,626943
HepG2|chr14:103284924-103285017,chr14,103284924,103285017,HepG2|chr14:103528061-103528117,chr14,103528061,103528117,0,243137
HepG2|chr14:103319225-103319375,chr14,103319225,103319375,HepG2|chr14:103527999-103528117,chr14,103527999,103528117,0,208774
HepG2|chr14:103745237-103745263,chr14,103745237,103745263,HepG2|chr14:73730088-73730203,chr14,73730088,73730203,0,30015149
HepG2|chr14:104100667-104100686,chr14,104100667,104100686,HepG2|chr14:103527997-103528117,chr14,103527997,103528117,0,572670
HepG2|chr14:104637761-104637801,chr14,104637761,104637801,HepG2|chr14:103527995-103528117,chr14,103527995,103528117,0,1109766
HepG2|chr14:104646604-104646631,chr14,104646604,104646631,HepG2|chr14:50106604-50106747,chr14,50106604,50106747,0,54540000
HepG2|chr14:104921763-104921812,chr14,104921763,104921812,HepG2|chr14:103528038-103528117,chr14,103528038,103528117,0,1393725
HepG2|chr14:104945939-104946008,chr14,104945939,104946008,HepG2|chr14:103528036-103528117,chr14,103528036,103528117,0,1417903
HepG2|chr14:104997379-104997415,chr14,104997379,104997415,HepG2|chr14:51414371-51414485,chr14,51414371,51414485,0,53583008
HepG2|chr14:105242423-105242573,chr14,105242423,105242573,HepG2|chr14:50105562-50105587,chr14,50105562,50105587,0,55136861
HepG2|chr14:105332050-105332200,chr14,105332050,105332200,HepG2|chr14:24438712-24438862,chr14,24438712,24438862,0,80893338
HepG2|chr14:105690372-105690460,chr14,105690372,105690460,HepG2|chr14:103528059-103528117,chr14,103528059,103528117,0,2162313
HepG2|chr14:106049232-106049311,chr14,106049232,106049311,HepG2|chr14:50105052-50105117,chr14,50105052,50105117,0,55944180
HepG2|chr14:106140443-106140554,chr14,106140443,106140554,HepG2|chr14:103055800-103055839,chr14,103055800,103055839,0,3084643
HepG2|chr14:106239850-106240000,chr14,106239850,106240000,HepG2|chr14:103528059-103528117,chr14,103528059,103528117,0,2711791
HepG2|chr14:106295961-106296054,chr14,106295961,106296054,HepG2|chr14:103528000-103528117,chr14,103528000,103528117,0,2767961
HepG2|chr14:106427066-106427150,chr14,106427066,106427150,HepG2|chr14:103527995-103528117,chr14,103527995,103528117,0,2899071
HepG2|chr14:106445394-106445464,chr14,106445394,106445464,HepG2|chr14:51414371-51414485,chr14,51414371,51414485,0,55031023
HepG2|chr14:106658014-106658067,chr14,106658014,106658067,HepG2|chr14:103527996-103528112,chr14,103527996,103528112,0,3130018
HepG2|chr14:106914642-106914710,chr14,106914642,106914710,HepG2|chr14:51414408-51414485,chr14,51414408,51414485,0,55500234
HepG2|chr14:107080251-107080364,chr14,107080251,107080364,HepG2|chr14:51414412-51414429,chr14,51414412,51414429,0,55665839
HepG2|chr14:107153336-107153453,chr14,107153336,107153453,HepG2|chr14:102775106-102775139,chr14,102775106,102775139,0,4378230
HepG2|chr14:107165812-107165891,chr14,107165812,107165891,HepG2|chr14:35185974-35186042,chr14,35185974,35186042,0,71979838
HepG2|chr14:107296054-107296095,chr14,107296054,107296095,HepG2|chr14:50105976-50105998,chr14,50105976,50105998,0,57190078
HepG2|chr14:107329432-107329582,chr14,107329432,107329582,HepG2|chr14:103055800-103055846,chr14,103055800,103055846,0,4273632
HepG2|chr15:158387-158431,chr15,158387,158431,HepG2|chr15:72522241-72522388,chr15,72522241,72522388,0,72363854
HepG2|chr15:248946-249096,chr15,248946,249096,HepG2|chr15:28566878-28567028,chr15,28566878,28567028,0,28317932
HepG2|chr15:623943-624090,chr15,623943,624090,HepG2|chr15:28566824-28566974,chr15,28566824,28566974,0,27942881
HepG2|chr15:639827-639977,chr15,639827,639977,HepG2|chr15:28566818-28566968,chr15,28566818,28566968,0,27926991
HepG2|chr15:1108886-1108974,chr15,1108886,1108974,HepG2|chr15:93445963-93446011,chr15,93445963,93446011,0,92337077
HepG2|chr15:1154856-1155006,chr15,1154856,1155006,HepG2|chr15:28566933-28567043,chr15,28566933,28567043,0,27412077
HepG2|chr15:1495613-1495763,chr15,1495613,1495763,HepG2|chr15:28566829-28566979,chr15,28566829,28566979,0,27071216
HepG2|chr15:1716637-1716787,chr15,1716637,1716787,HepG2|chr15:28566903-28567050,chr15,28566903,28567050,0,26850266
HepG2|chr15:1792879-1793023,chr15,1792879,1793023,HepG2|chr15:28566814-28566963,chr15,28566814,28566963,0,26773935
HepG2|chr15:1831887-1832028,chr15,1831887,1832028,HepG2|chr15:28566835-28566985,chr15,28566835,28566985,0,26734948
HepG2|chr15:2280544-2280693,chr15,2280544,2280693,HepG2|chr15:28566840-28566990,chr15,28566840,28566990,0,26286296
HepG2|chr15:3213479-3213623,chr15,3213479,3213623,HepG2|chr15:28566823-28566972,chr15,28566823,28566972,0,25353344
HepG2|chr15:3548525-3548672,chr15,3548525,3548672,HepG2|chr15:28566917-28567067,chr15,28566917,28567067,0,25018392
HepG2|chr15:6523731-6523799,chr15,6523731,6523799,HepG2|chr15:37396775-37396822,chr15,37396775,37396822,0,30873044
HepG2|chr15:6616275-6616416,chr15,6616275,6616416,HepG2|chr15:28566831-28566978,chr15,28566831,28566978,0,21950556
HepG2|chr15:6905573-6905615,chr15,6905573,6905615,HepG2|chr15:85259914-85260063,chr15,85259914,85260063,0,78354341
HepG2|chr15:7933236-7933386,chr15,7933236,7933386,HepG2|chr15:28566823-28566973,chr15,28566823,28566973,0,20633587
HepG2|chr15:9220790-9220934,chr15,9220790,9220934,HepG2|chr15:28566814-28566963,chr15,28566814,28566963,0,19346024
HepG2|chr15:9374894-9374982,chr15,9374894,9374982,HepG2|chr15:37394931-37394968,chr15,37394931,37394968,0,28020037
HepG2|chr15:9712514-9712556,chr15,9712514,9712556,HepG2|chr15:85259914-85260063,chr15,85259914,85260063,0,75547400
HepG2|chr15:10080516-10080666,chr15,10080516,10080666,HepG2|chr15:28566829-28566979,chr15,28566829,28566979,0,18486313
HepG2|chr15:10719722-10719872,chr15,10719722,10719872,HepG2|chr15:28566830-28566980,chr15,28566830,28566980,0,17847108
HepG2|chr15:11331594-11331744,chr15,11331594,11331744,HepG2|chr15:28566881-28567031,chr15,28566881,28567031,0,17235287
HepG2|chr15:11704979-11705129,chr15,11704979,11705129,HepG2|chr15:28566903-28567050,chr15,28566903,28567050,0,16861924
HepG2|chr15:11743568-11743707,chr15,11743568,11743707,HepG2|chr15:28566322-28566472,chr15,28566322,28566472,0,16822754
HepG2|chr15:12145316-12145466,chr15,12145316,12145466,HepG2|chr15:28566876-28567025,chr15,28566876,28567025,0,16421560
HepG2|chr15:12159298-12159362,chr15,12159298,12159362,HepG2|chr15:51200748-51200832,chr15,51200748,51200832,0,39041450
HepG2|chr15:12766169-12766316,chr15,12766169,12766316,HepG2|chr15:28566865-28567011,chr15,28566865,28567011,0,15800696
HepG2|chr15:12932976-12933085,chr15,12932976,12933085,HepG2|chr15:85722513-85722622,chr15,85722513,85722622,0,72789537
HepG2|chr15:13328506-13328596,chr15,13328506,13328596,HepG2|chr15:37397989-37398050,chr15,37397989,37398050,0,24069483
HepG2|chr15:13366151-13366301,chr15,13366151,13366301,HepG2|chr15:28566883-28567033,chr15,28566883,28567033,0,15200732
HepG2|chr15:13575244-13575389,chr15,13575244,13575389,HepG2|chr15:28566817-28566967,chr15,28566817,28566967,0,14991573
HepG2|chr15:14091095-14091245,chr15,14091095,14091245,HepG2|chr15:28566883-28567033,chr15,28566883,28567033,0,14475788
HepG2|chr15:14552514-14552577,chr15,14552514,14552577,HepG2|chr15:37394907-37394963,chr15,37394907,37394963,0,22842393
HepG2|chr15:15212273-15212336,chr15,15212273,15212336,HepG2|chr15:51200748-51200832,chr15,51200748,51200832,0,35988475
HepG2|chr15:15487707-15487853,chr15,15487707,15487853,HepG2|chr15:28566834-28566984,chr15,28566834,28566984,0,13079127
HepG2|chr15:16041638-16041788,chr15,16041638,16041788,HepG2|chr15:45316646-45316796,chr15,45316646,45316796,0,29275008
HepG2|chr15:16323020-16323166,chr15,16323020,16323166,HepG2|chr15:28566831-28566978,chr15,28566831,28566978,0,12243811
HepG2|chr15:16725041-16725191,chr15,16725041,16725191,HepG2|chr15:45317075-45317225,chr15,45317075,45317225,0,28592034
HepG2|chr15:17124008-17124030,chr15,17124008,17124030,HepG2|chr15:37394874-37394968,chr15,37394874,37394968,0,20270866
HepG2|chr15:17223931-17224081,chr15,17223931,17224081,HepG2|chr15:28566831-28566978,chr15,28566831,28566978,0,11342900
HepG2|chr15:17873291-17873441,chr15,17873291,17873441,HepG2|chr15:28566903-28567050,chr15,28566903,28567050,0,10693612
HepG2|chr15:18085676-18085826,chr15,18085676,18085826,HepG2|chr15:28566831-28566978,chr15,28566831,28566978,0,10481155
HepG2|chr15:18652844-18652900,chr15,18652844,18652900,HepG2|chr15:45316567-45316659,chr15,45316567,45316659,0,26663723
HepG2|chr15:19291828-19291978,chr15,19291828,19291978,HepG2|chr15:28566896-28567046,chr15,28566896,28567046,0,9275068
HepG2|chr15:19760429-19760579,chr15,19760429,19760579,HepG2|chr15:28566831-28566978,chr15,28566831,28566978,0,8806402
HepG2|chr15:20196293-20196443,chr15,20196293,20196443,HepG2|chr15:28566831-28566978,chr15,28566831,28566978,0,8370538
HepG2|chr15:21150255-21150403,chr15,21150255,21150403,HepG2|chr15:28566834-28566984,chr15,28566834,28566984,0,7416579
HepG2|chr15:21620958-21621030,chr15,21620958,21621030,HepG2|chr15:72525500-72525624,chr15,72525500,72525624,0,50904542
HepG2|chr15:21833658-21833808,chr15,21833658,21833808,HepG2|chr15:28566819-28566969,chr15,28566819,28566969,0,6733161
HepG2|chr15:21996666-21996813,chr15,21996666,21996813,HepG2|chr15:28566820-28566970,chr15,28566820,28566970,0,6570154
HepG2|chr15:23767919-23768065,chr15,23767919,23768065,HepG2|chr15:28566818-28566968,chr15,28566818,28566968,0,4798899
HepG2|chr15:23898847-23898997,chr15,23898847,23898997,HepG2|chr15:28566822-28566972,chr15,28566822,28566972,0,4667975
HepG2|chr15:24252347-24252493,chr15,24252347,24252493,HepG2|chr15:28566888-28567038,chr15,28566888,28567038,0,4314541
HepG2|chr15:24300214-24300360,chr15,24300214,24300360,HepG2|chr15:28566845-28566995,chr15,28566845,28566995,0,4266631
HepG2|chr15:24905022-24905172,chr15,24905022,24905172,HepG2|chr15:28566819-28566969,chr15,28566819,28566969,0,3661797
HepG2|chr15:25318812-25318961,chr15,25318812,25318961,HepG2|chr15:28566904-28567054,chr15,28566904,28567054,0,3248092
HepG2|chr15:25920607-25920752,chr15,25920607,25920752,HepG2|chr15:28566817-28566967,chr15,28566817,28566967,0,2646210
HepG2|chr15:26082718-26082828,chr15,26082718,26082828,HepG2|chr15:51200748-51200788,chr15,51200748,51200788,0,25118030
HepG2|chr15:26968332-26968482,chr15,26968332,26968482,HepG2|chr15:45316972-45317121,chr15,45316972,45317121,0,18348640
HepG2|chr15:27079940-27080090,chr15,27079940,27080090,HepG2|chr15:28566326-28566473,chr15,28566326,28566473,0,1486386
HepG2|chr15:27567785-27567935,chr15,27567785,27567935,HepG2|chr15:28566831-28566978,chr15,28566831,28566978,0,999046
HepG2|chr15:27740057-27740206,chr15,27740057,27740206,HepG2|chr15:28566670-28566820,chr15,28566670,28566820,0,826613
HepG2|chr15:28152421-28152568,chr15,28152421,28152568,HepG2|chr15:28566869-28567019,chr15,28566869,28567019,0,414448
HepG2|chr15:28181169-28181195,chr15,28181169,28181195,HepG2|chr15:72525500-72525624,chr15,72525500,72525624,0,44344331
HepG2|chr15:29774991-29775040,chr15,29774991,29775040,HepG2|chr15:101816426-101816524,chr15,101816426,101816524,0,72041435
HepG2|chr15:29940613-29940661,chr15,29940613,29940661,HepG2|chr15:72522241-72522388,chr15,72522241,72522388,0,42581628
HepG2|chr15:30240095-30240234,chr15,30240095,30240234,HepG2|chr15:28566322-28566472,chr15,28566322,28566472,0,1673773
HepG2|chr15:31199433-31199583,chr15,31199433,31199583,HepG2|chr15:28566822-28566972,chr15,28566822,28566972,0,2632611
HepG2|chr15:32386200-32386350,chr15,32386200,32386350,HepG2|chr15:28566643-28566790,chr15,28566643,28566790,0,3819557
HepG2|chr15:32421476-32421626,chr15,32421476,32421626,HepG2|chr15:28566878-28567028,chr15,28566878,28567028,0,3854598
HepG2|chr15:33175686-33175836,chr15,33175686,33175836,HepG2|chr15:28566936-28567085,chr15,28566936,28567085,0,4608750
HepG2|chr15:33576502-33576652,chr15,33576502,33576652,HepG2|chr15:28566831-28566978,chr15,28566831,28566978,0,5009671
HepG2|chr15:33794086-33794234,chr15,33794086,33794234,HepG2|chr15:28566834-28566984,chr15,28566834,28566984,0,5227252
HepG2|chr15:33894669-33894819,chr15,33894669,33894819,HepG2|chr15:28566845-28566995,chr15,28566845,28566995,0,5327824
HepG2|chr15:33925310-33925454,chr15,33925310,33925454,HepG2|chr15:28566836-28566986,chr15,28566836,28566986,0,5358474
HepG2|chr15:34797518-34797664,chr15,34797518,34797664,HepG2|chr15:28566834-28566984,chr15,28566834,28566984,0,6230684
HepG2|chr15:35240267-35240289,chr15,35240267,35240289,HepG2|chr15:85262213-85262315,chr15,85262213,85262315,0,50021946
HepG2|chr15:35389789-35389939,chr15,35389789,35389939,HepG2|chr15:28566881-28567031,chr15,28566881,28567031,0,6822908
HepG2|chr15:35501022-35501172,chr15,35501022,35501172,HepG2|chr15:28566833-28566980,chr15,28566833,28566980,0,6934189
HepG2|chr15:35509894-35509983,chr15,35509894,35509983,HepG2|chr15:37397989-37398050,chr15,37397989,37398050,0,1888095
HepG2|chr15:35579204-35579255,chr15,35579204,35579255,HepG2|chr15:37394907-37394966,chr15,37394907,37394966,0,1815703
HepG2|chr15:35694191-35694340,chr15,35694191,35694340,HepG2|chr15:28566840-28566990,chr15,28566840,28566990,0,7127351
HepG2|chr15:36013732-36013882,chr15,36013732,36013882,HepG2|chr15:28566896-28567046,chr15,28566896,28567046,0,7446836
HepG2|chr15:36186369-36186510,chr15,36186369,36186510,HepG2|chr15:28566831-28566978,chr15,28566831,28566978,0,7619538
HepG2|chr15:37043463-37043612,chr15,37043463,37043612,HepG2|chr15:28566631-28566781,chr15,28566631,28566781,0,8476832
HepG2|chr15:37761494-37761637,chr15,37761494,37761637,HepG2|chr15:28566908-28567052,chr15,28566908,28567052,0,9194586
HepG2|chr15:38129284-38129434,chr15,38129284,38129434,HepG2|chr15:28566881-28567031,chr15,28566881,28567031,0,9562403
HepG2|chr15:39721207-39721357,chr15,39721207,39721357,HepG2|chr15:28566917-28567067,chr15,28566917,28567067,0,11154290
HepG2|chr15:39816135-39816199,chr15,39816135,39816199,HepG2|chr15:51200748-51200832,chr15,51200748,51200832,0,11384613
HepG2|chr15:40011702-40011848,chr15,40011702,40011848,HepG2|chr15:28566831-28566978,chr15,28566831,28566978,0,11444871
HepG2|chr15:40104755-40104899,chr15,40104755,40104899,HepG2|chr15:28566667-28566817,chr15,28566667,28566817,0,11538088
HepG2|chr15:40322919-40323069,chr15,40322919,40323069,HepG2|chr15:45316976-45317126,chr15,45316976,45317126,0,4994057
HepG2|chr15:41111062-41111212,chr15,41111062,41111212,HepG2|chr15:28566890-28567040,chr15,28566890,28567040,0,12544172
HepG2|chr15:41514086-41514236,chr15,41514086,41514236,HepG2|chr15:28566831-28566981,chr15,28566831,28566981,0,12947255
HepG2|chr15:41618904-41619054,chr15,41618904,41619054,HepG2|chr15:28566818-28566968,chr15,28566818,28566968,0,13052086
HepG2|chr15:41804566-41804707,chr15,41804566,41804707,HepG2|chr15:28566896-28567046,chr15,28566896,28567046,0,13237670
HepG2|chr15:41830584-41830734,chr15,41830584,41830734,HepG2|chr15:45317030-45317126,chr15,45317030,45317126,0,3486446
HepG2|chr15:42349670-42349779,chr15,42349670,42349779,HepG2|chr15:85722513-85722622,chr15,85722513,85722622,0,43372843
HepG2|chr15:42867477-42867587,chr15,42867477,42867587,HepG2|chr15:51200748-51200788,chr15,51200748,51200788,0,8333271
HepG2|chr15:44591934-44592084,chr15,44591934,44592084,HepG2|chr15:28566643-28566790,chr15,28566643,28566790,0,16025291
HepG2|chr15:44699130-44699280,chr15,44699130,44699280,HepG2|chr15:28566876-28567023,chr15,28566876,28567023,0,16132254
HepG2|chr15:48385684-48385728,chr15,48385684,48385728,HepG2|chr15:41408864-41408889,chr15,41408864,41408889,0,6976820
HepG2|chr15:48397048-48397192,chr15,48397048,48397192,HepG2|chr15:28566853-28567003,chr15,28566853,28567003,0,19830195
HepG2|chr15:48731076-48731225,chr15,48731076,48731225,HepG2|chr15:28566831-28566978,chr15,28566831,28566978,0,20164245
HepG2|chr15:48869651-48869801,chr15,48869651,48869801,HepG2|chr15:28566831-28566978,chr15,28566831,28566978,0,20302820
HepG2|chr15:48921790-48921812,chr15,48921790,48921812,HepG2|chr15:85262213-85262315,chr15,85262213,85262315,0,36340423
HepG2|chr15:49622714-49622864,chr15,49622714,49622864,HepG2|chr15:28566831-28566978,chr15,28566831,28566978,0,21055883
HepG2|chr15:49674901-49675051,chr15,49674901,49675051,HepG2|chr15:28566823-28566973,chr15,28566823,28566973,0,21108078
HepG2|chr15:51174649-51174799,chr15,51174649,51174799,HepG2|chr15:28566876-28567023,chr15,28566876,28567023,0,22607773
HepG2|chr15:51486751-51486901,chr15,51486751,51486901,HepG2|chr15:28566830-28566980,chr15,28566830,28566980,0,22919921
HepG2|chr15:51594603-51594753,chr15,51594603,51594753,HepG2|chr15:28566881-28567031,chr15,28566881,28567031,0,23027722
HepG2|chr15:52021449-52021598,chr15,52021449,52021598,HepG2|chr15:28566831-28566978,chr15,28566831,28566978,0,23454618
HepG2|chr15:52086734-52086881,chr15,52086734,52086881,HepG2|chr15:28566917-28567067,chr15,28566917,28567067,0,23519817
HepG2|chr15:53328321-53328471,chr15,53328321,53328471,HepG2|chr15:28566883-28567033,chr15,28566883,28567033,0,24761438
HepG2|chr15:53455193-53455342,chr15,53455193,53455342,HepG2|chr15:28566669-28566691,chr15,28566669,28566691,0,24888524
HepG2|chr15:53533623-53533669,chr15,53533623,53533669,HepG2|chr15:85259189-85259264,chr15,85259189,85259264,0,31725566
HepG2|chr15:53803553-53803696,chr15,53803553,53803696,HepG2|chr15:28566908-28567052,chr15,28566908,28567052,0,25236645
HepG2|chr15:54172665-54172687,chr15,54172665,54172687,HepG2|chr15:37394874-37394968,chr15,37394874,37394968,0,16777791
HepG2|chr15:54223845-54223908,chr15,54223845,54223908,HepG2|chr15:51200748-51200832,chr15,51200748,51200832,0,3023097
HepG2|chr15:54265889-54266039,chr15,54265889,54266039,HepG2|chr15:28566936-28567085,chr15,28566936,28567085,0,25698953
HepG2|chr15:54393880-54393951,chr15,54393880,54393951,HepG2|chr15:41408756-41408889,chr15,41408756,41408889,0,12985124
HepG2|chr15:55502766-55502805,chr15,55502766,55502805,HepG2|chr15:90439217-90439328,chr15,90439217,90439328,0,34936451
HepG2|chr15:56160702-56160851,chr15,56160702,56160851,HepG2|chr15:28566904-28567054,chr15,28566904,28567054,0,27593798
HepG2|chr15:56189395-56189539,chr15,56189395,56189539,HepG2|chr15:28566831-28566978,chr15,28566831,28566978,0,27622564
HepG2|chr15:56259186-56259336,chr15,56259186,56259336,HepG2|chr15:28566326-28566473,chr15,28566326,28566473,0,27692860
HepG2|chr15:56592799-56592949,chr15,56592799,56592949,HepG2|chr15:28566833-28566980,chr15,28566833,28566980,0,28025966
HepG2|chr15:56902659-56902809,chr15,56902659,56902809,HepG2|chr15:28566829-28566979,chr15,28566829,28566979,0,28335830
HepG2|chr15:57844083-57844127,chr15,57844083,57844127,HepG2|chr15:72522241-72522388,chr15,72522241,72522388,0,14678158
HepG2|chr15:59354532-59354682,chr15,59354532,59354682,HepG2|chr15:45316976-45317126,chr15,45316976,45317126,0,14037556
HepG2|chr15:59442609-59442758,chr15,59442609,59442758,HepG2|chr15:28566631-28566781,chr15,28566631,28566781,0,30875978
HepG2|chr15:59478051-59478140,chr15,59478051,59478140,HepG2|chr15:37397989-37398050,chr15,37397989,37398050,0,22080062
HepG2|chr15:60499518-60499665,chr15,60499518,60499665,HepG2|chr15:28566865-28567011,chr15,28566865,28567011,0,31932653
HepG2|chr15:61175231-61175381,chr15,61175231,61175381,HepG2|chr15:28566883-28567033,chr15,28566883,28567033,0,32608348
HepG2|chr15:61725713-61725863,chr15,61725713,61725863,HepG2|chr15:85722540-85722689,chr15,85722540,85722689,0,23996827
HepG2|chr15:61829703-61829853,chr15,61829703,61829853,HepG2|chr15:28566845-28566995,chr15,28566845,28566995,0,33262858
HepG2|chr15:62238415-62238565,chr15,62238415,62238565,HepG2|chr15:45316976-45317126,chr15,45316976,45317126,0,16921439
HepG2|chr15:62558713-62558860,chr15,62558713,62558860,HepG2|chr15:28566845-28566994,chr15,28566845,28566994,0,33991868
HepG2|chr15:63289927-63290077,chr15,63289927,63290077,HepG2|chr15:85722540-85722689,chr15,85722540,85722689,0,22432613
HepG2|chr15:63461572-63461718,chr15,63461572,63461718,HepG2|chr15:28566831-28566978,chr15,28566831,28566978,0,34894741
HepG2|chr15:63617508-63617651,chr15,63617508,63617651,HepG2|chr15:28566898-28567047,chr15,28566898,28567047,0,35050610
HepG2|chr15:64122805-64122830,chr15,64122805,64122830,HepG2|chr15:37394752-37394889,chr15,37394752,37394889,0,26728053
HepG2|chr15:64252920-64253061,chr15,64252920,64253061,HepG2|chr15:28566661-28566811,chr15,28566661,28566811,0,35686259
HepG2|chr15:65312023-65312117,chr15,65312023,65312117,HepG2|chr15:101816426-101816524,chr15,101816426,101816524,0,36504403
HepG2|chr15:66045799-66045825,chr15,66045799,66045825,HepG2|chr15:85260661-85260785,chr15,85260661,85260785,0,19214862
HepG2|chr15:66147117-66147207,chr15,66147117,66147207,HepG2|chr15:37397989-37398050,chr15,37397989,37398050,0,28749128
HepG2|chr15:66273331-66273380,chr15,66273331,66273380,HepG2|chr15:101816426-101816524,chr15,101816426,101816524,0,35543095
HepG2|chr15:66820174-66820318,chr15,66820174,66820318,HepG2|chr15:28566853-28567003,chr15,28566853,28567003,0,38253321
HepG2|chr15:66987630-66987773,chr15,66987630,66987773,HepG2|chr15:28566831-28566976,chr15,28566831,28566976,0,38420799
HepG2|chr15:67110575-67110621,chr15,67110575,67110621,HepG2|chr15:85259189-85259264,chr15,85259189,85259264,0,18148614
HepG2|chr15:67678768-67678912,chr15,67678768,67678912,HepG2|chr15:28566836-28566986,chr15,28566836,28566986,0,39111932
HepG2|chr15:68101356-68101436,chr15,68101356,68101436,HepG2|chr15:28566879-28566937,chr15,28566879,28566937,0,39534477
HepG2|chr15:68204348-68204498,chr15,68204348,68204498,HepG2|chr15:28566577-28566727,chr15,28566577,28566727,0,39637771
HepG2|chr15:68234198-68234345,chr15,68234198,68234345,HepG2|chr15:28566820-28566970,chr15,28566820,28566970,0,39667378
HepG2|chr15:68806148-68806203,chr15,68806148,68806203,HepG2|chr15:37394907-37394968,chr15,37394907,37394968,0,31411241
HepG2|chr15:68861642-68861792,chr15,68861642,68861792,HepG2|chr15:28566917-28567067,chr15,28566917,28567067,0,40294725
HepG2|chr15:69776983-69777126,chr15,69776983,69777126,HepG2|chr15:28566898-28567047,chr15,28566898,28567047,0,41210085
HepG2|chr15:69797872-69798021,chr15,69797872,69798021,HepG2|chr15:28566939-28567088,chr15,28566939,28567088,0,41230933
HepG2|chr15:69856331-69856411,chr15,69856331,69856411,HepG2|chr15:52473435-52473500,chr15,52473435,52473500,0,17382896
HepG2|chr15:69894236-69894288,chr15,69894236,69894288,HepG2|chr15:37393620-37393739,chr15,37393620,37393739,0,32500616
HepG2|chr15:70283917-70284064,chr15,70283917,70284064,HepG2|chr15:28566824-28566974,chr15,28566824,28566974,0,41717093
HepG2|chr15:72494565-72494706,chr15,72494565,72494706,HepG2|chr15:28566835-28566985,chr15,28566835,28566985,0,43927730
HepG2|chr15:72574416-72574566,chr15,72574416,72574566,HepG2|chr15:28566833-28566980,chr15,28566833,28566980,0,44007583
HepG2|chr15:72707642-72707784,chr15,72707642,72707784,HepG2|chr15:28566831-28566978,chr15,28566831,28566978,0,44140811
HepG2|chr15:72992403-72992428,chr15,72992403,72992428,HepG2|chr15:37394752-37394889,chr15,37394752,37394889,0,35597651
HepG2|chr15:73714221-73714365,chr15,73714221,73714365,HepG2|chr15:28566667-28566817,chr15,28566667,28566817,0,45147554
HepG2|chr15:73770880-73771030,chr15,73770880,73771030,HepG2|chr15:28566878-28567028,chr15,28566878,28567028,0,45204002
HepG2|chr15:75438455-75438605,chr15,75438455,75438605,HepG2|chr15:28566933-28567043,chr15,28566933,28567043,0,46871522
HepG2|chr15:76447976-76448126,chr15,76447976,76448126,HepG2|chr15:28566903-28567050,chr15,28566903,28567050,0,47881073
HepG2|chr15:76710634-76710673,chr15,76710634,76710673,HepG2|chr15:90439217-90439328,chr15,90439217,90439328,0,13728583
HepG2|chr15:76779706-76779732,chr15,76779706,76779732,HepG2|chr15:72525500-72525624,chr15,72525500,72525624,0,4254206
HepG2|chr15:76894824-76894965,chr15,76894824,76894965,HepG2|chr15:28566661-28566811,chr15,28566661,28566811,0,48328163
HepG2|chr15:77161024-77161135,chr15,77161024,77161135,HepG2|chr15:28566937-28567021,chr15,28566937,28567021,0,48594087
HepG2|chr15:77257367-77257451,chr15,77257367,77257451,HepG2|chr15:52473435-52473500,chr15,52473435,52473500,0,24783932
HepG2|chr15:77372786-77372875,chr15,77372786,77372875,HepG2|chr15:93445963-93446011,chr15,93445963,93446011,0,16073177
HepG2|chr15:77662100-77662241,chr15,77662100,77662241,HepG2|chr15:28566896-28567046,chr15,28566896,28567046,0,49095204
HepG2|chr15:77730614-77730677,chr15,77730614,77730677,HepG2|chr15:37394907-37394963,chr15,37394907,37394963,0,40335707
HepG2|chr15:78245114-78245203,chr15,78245114,78245203,HepG2|chr15:93445963-93446011,chr15,93445963,93446011,0,15200849
HepG2|chr15:79140077-79140145,chr15,79140077,79140145,HepG2|chr15:37396775-37396822,chr15,37396775,37396822,0,41743302
HepG2|chr15:79244730-79244761,chr15,79244730,79244761,HepG2|chr15:41408864-41408889,chr15,41408864,41408889,0,37835866
HepG2|chr15:79893172-79893228,chr15,79893172,79893228,HepG2|chr15:45316567-45316659,chr15,45316567,45316659,0,34576605
HepG2|chr15:80255377-80255527,chr15,80255377,80255527,HepG2|chr15:45317075-45317225,chr15,45317075,45317225,0,34938302
HepG2|chr15:80393322-80393471,chr15,80393322,80393471,HepG2|chr15:28566669-28566691,chr15,28566669,28566691,0,51826653
HepG2|chr15:80426059-80426205,chr15,80426059,80426205,HepG2|chr15:28566831-28566978,chr15,28566831,28566978,0,51859228
HepG2|chr15:81599086-81599109,chr15,81599086,81599109,HepG2|chr15:72524537-72524687,chr15,72524537,72524687,0,9074549
HepG2|chr15:81607615-81607695,chr15,81607615,81607695,HepG2|chr15:28566879-28566937,chr15,28566879,28566937,0,53040736
HepG2|chr15:81615511-81615661,chr15,81615511,81615661,HepG2|chr15:28566896-28567046,chr15,28566896,28567046,0,53048615
HepG2|chr15:82222325-82222471,chr15,82222325,82222471,HepG2|chr15:28566888-28567038,chr15,28566888,28567038,0,53655437
HepG2|chr15:83154296-83154367,chr15,83154296,83154367,HepG2|chr15:41408756-41408889,chr15,41408756,41408889,0,41745540
HepG2|chr15:83353390-83353540,chr15,83353390,83353540,HepG2|chr15:28566831-28566978,chr15,28566831,28566978,0,54786559
HepG2|chr15:83599761-83599911,chr15,83599761,83599911,HepG2|chr15:28566831-28566978,chr15,28566831,28566978,0,55032930
HepG2|chr15:83758017-83758167,chr15,83758017,83758167,HepG2|chr15:28566831-28566981,chr15,28566831,28566981,0,55191186
HepG2|chr15:84180255-84180405,chr15,84180255,84180405,HepG2|chr15:28566890-28567040,chr15,28566890,28567040,0,55613365
HepG2|chr15:84563842-84563989,chr15,84563842,84563989,HepG2|chr15:28566869-28567019,chr15,28566869,28567019,0,55996973
HepG2|chr15:84636188-84636236,chr15,84636188,84636236,HepG2|chr15:72522241-72522388,chr15,72522241,72522388,0,12113947
HepG2|chr15:87048055-87048201,chr15,87048055,87048201,HepG2|chr15:28566845-28566995,chr15,28566845,28566995,0,58481210
HepG2|chr15:87130399-87130510,chr15,87130399,87130510,HepG2|chr15:28566937-28567021,chr15,28566937,28567021,0,58563462
HepG2|chr15:87431373-87431523,chr15,87431373,87431523,HepG2|chr15:28566876-28567025,chr15,28566876,28567025,0,58864497
HepG2|chr15:88547211-88547291,chr15,88547211,88547291,HepG2|chr15:52473435-52473500,chr15,52473435,52473500,0,36073776
HepG2|chr15:89144440-89144590,chr15,89144440,89144590,HepG2|chr15:45316646-45316796,chr15,45316646,45316796,0,43827794
HepG2|chr15:89331348-89331497,chr15,89331348,89331497,HepG2|chr15:28566820-28566970,chr15,28566820,28566970,0,60764528
HepG2|chr15:89727469-89727524,chr15,89727469,89727524,HepG2|chr15:37394907-37394968,chr15,37394907,37394968,0,52332562
HepG2|chr15:89907682-89907831,chr15,89907682,89907831,HepG2|chr15:28566670-28566820,chr15,28566670,28566820,0,61341012
HepG2|chr15:90407612-90407762,chr15,90407612,90407762,HepG2|chr15:45316976-45317126,chr15,45316976,45317126,0,45090636
HepG2|chr15:90828405-90828457,chr15,90828405,90828457,HepG2|chr15:37393620-37393739,chr15,37393620,37393739,0,53434785
HepG2|chr15:90973980-90974019,chr15,90973980,90974019,HepG2|chr15:85260677-85260785,chr15,85260677,85260785,0,5713303
HepG2|chr15:91201629-91201717,chr15,91201629,91201717,HepG2|chr15:37394931-37394968,chr15,37394931,37394968,0,53806698
HepG2|chr15:91431937-91431981,chr15,91431937,91431981,HepG2|chr15:41408864-41408889,chr15,41408864,41408889,0,50023073
HepG2|chr15:91834126-91834272,chr15,91834126,91834272,HepG2|chr15:28566818-28566968,chr15,28566818,28566968,0,63267308
HepG2|chr15:91931115-91931265,chr15,91931115,91931265,HepG2|chr15:28566896-28567046,chr15,28566896,28567046,0,63364219
HepG2|chr15:91942210-91942249,chr15,91942210,91942249,HepG2|chr15:85260677-85260785,chr15,85260677,85260785,0,6681533
HepG2|chr15:92107097-92107169,chr15,92107097,92107169,HepG2|chr15:72525500-72525624,chr15,72525500,72525624,0,19581597
HepG2|chr15:92680908-92681057,chr15,92680908,92681057,HepG2|chr15:28566939-28567088,chr15,28566939,28567088,0,64113969
HepG2|chr15:93242192-93242276,chr15,93242192,93242276,HepG2|chr15:52473435-52473500,chr15,52473435,52473500,0,40768757
HepG2|chr15:93418548-93418698,chr15,93418548,93418698,HepG2|chr15:28566831-28566978,chr15,28566831,28566978,0,64851717
HepG2|chr15:93675205-93675347,chr15,93675205,93675347,HepG2|chr15:28566831-28566978,chr15,28566831,28566978,0,65108374
HepG2|chr15:94116313-94116463,chr15,94116313,94116463,HepG2|chr15:28566833-28566980,chr15,28566833,28566980,0,65549480
HepG2|chr15:95088516-95088542,chr15,95088516,95088542,HepG2|chr15:85260661-85260785,chr15,85260661,85260785,0,9827855
HepG2|chr15:96087730-96087818,chr15,96087730,96087818,HepG2|chr15:93445963-93446011,chr15,93445963,93446011,0,2641767
HepG2|chr15:96255825-96255975,chr15,96255825,96255975,HepG2|chr15:28566829-28566979,chr15,28566829,28566979,0,67688996
HepG2|chr15:96442018-96442168,chr15,96442018,96442168,HepG2|chr15:28566577-28566727,chr15,28566577,28566727,0,67875441
HepG2|chr15:96687362-96687505,chr15,96687362,96687505,HepG2|chr15:28566831-28566976,chr15,28566831,28566976,0,68120531
HepG2|chr15:97069972-97070122,chr15,97069972,97070122,HepG2|chr15:28566831-28566978,chr15,28566831,28566978,0,68503141
HepG2|chr15:97363857-97364004,chr15,97363857,97364004,HepG2|chr15:28566845-28566994,chr15,28566845,28566994,0,68797012
HepG2|chr15:97596388-97596411,chr15,97596388,97596411,HepG2|chr15:72524537-72524687,chr15,72524537,72524687,0,25071851
HepG2|chr15:97623318-97623468,chr15,97623318,97623468,HepG2|chr15:28566831-28566978,chr15,28566831,28566978,0,69056487
HepG2|chr15:97758657-97758801,chr15,97758657,97758801,HepG2|chr15:28566831-28566978,chr15,28566831,28566978,0,69191826
HepG2|chr15:97799834-97799984,chr15,97799834,97799984,HepG2|chr15:45317030-45317126,chr15,45317030,45317126,0,52482804
HepG2|chr15:98262377-98262527,chr15,98262377,98262527,HepG2|chr15:45316972-45317121,chr15,45316972,45317121,0,52945405
HepG2|chr15:98571024-98571173,chr15,98571024,98571173,HepG2|chr15:28566820-28566970,chr15,28566820,28566970,0,70004204
HepG2|chr15:99029561-99029655,chr15,99029561,99029655,HepG2|chr15:101816426-101816524,chr15,101816426,101816524,0,2786865
HepG2|chr15:99592902-99593021,chr15,99592902,99593021,HepG2|chr15:51200748-51200788,chr15,51200748,51200788,0,48392154
HepG2|chr15:100803921-100804071,chr15,100803921,100804071,HepG2|chr15:28566878-28567028,chr15,28566878,28567028,0,72237043
HepG2|chr15:101166268-101166319,chr15,101166268,101166319,HepG2|chr15:37394907-37394966,chr15,37394907,37394966,0,63771361
HepG2|chr15:101348359-101348478,chr15,101348359,101348478,HepG2|chr15:51200748-51200788,chr15,51200748,51200788,0,50147611
HepG2|chr15:101847989-101848133,chr15,101847989,101848133,HepG2|chr15:28566823-28566972,chr15,28566823,28566972,0,73281166
HepG2|chr15:102195117-102195267,chr15,102195117,102195267,HepG2|chr15:28566831-28566978,chr15,28566831,28566978,0,73628286
HepG2|chr15:102360709-102360740,chr15,102360709,102360740,HepG2|chr15:41408864-41408889,chr15,41408864,41408889,0,60951845
HepG2|chr16:145247-145397,chr16,145247,145397,HepG2|chr16:2591081-2591231,chr16,2591081,2591231,0,2445834
HepG2|chr16:278943-278975,chr16,278943,278975,HepG2|chr16:28836138-28836288,chr16,28836138,28836288,0,28557195
HepG2|chr16:463999-464132,chr16,463999,464132,HepG2|chr16:22553131-22553276,chr16,22553131,22553276,0,22089132
HepG2|chr16:626023-626081,chr16,626023,626081,HepG2|chr16:15071129-15071264,chr16,15071129,15071264,0,14445106
HepG2|chr16:696478-696529,chr16,696478,696529,HepG2|chr16:56899985-56900135,chr16,56899985,56900135,0,56203507
HepG2|chr16:767732-767765,chr16,767732,767765,HepG2|chr16:15073139-15073289,chr16,15073139,15073289,0,14305407
HepG2|chr16:931959-932001,chr16,931959,932001,HepG2|chr16:85644407-85644492,chr16,85644407,85644492,0,84712448
HepG2|chr16:987636-987733,chr16,987636,987733,HepG2|chr16:85641106-85641159,chr16,85641106,85641159,0,84653470
HepG2|chr16:996814-996911,chr16,996814,996911,HepG2|chr16:19124755-19124830,chr16,19124755,19124830,0,18127941
HepG2|chr16:1022440-1022567,chr16,1022440,1022567,HepG2|chr16:22553108-22553245,chr16,22553108,22553245,0,21530668
HepG2|chr16:1324608-1324672,chr16,1324608,1324672,HepG2|chr16:4512185-4512259,chr16,4512185,4512259,0,3187577
HepG2|chr16:1365027-1365177,chr16,1365027,1365177,HepG2|chr16:2590047-2590187,chr16,2590047,2590187,0,1225020
HepG2|chr16:1493001-1493114,chr16,1493001,1493114,HepG2|chr16:70284100-70284137,chr16,70284100,70284137,0,68791099
HepG2|chr16:1831873-1831978,chr16,1831873,1831978,HepG2|chr16:18937918-18938063,chr16,18937918,18938063,0,17106045
HepG2|chr16:1869332-1869482,chr16,1869332,1869482,HepG2|chr16:2590261-2590382,chr16,2590261,2590382,0,720929
HepG2|chr16:1969788-1969938,chr16,1969788,1969938,HepG2|chr16:2590072-2590222,chr16,2590072,2590222,0,620284
HepG2|chr16:1981751-1981901,chr16,1981751,1981901,HepG2|chr16:2734020-2734167,chr16,2734020,2734167,0,752269
HepG2|chr16:2036898-2037044,chr16,2036898,2037044,HepG2|chr16:2589845-2589995,chr16,2589845,2589995,0,552947
HepG2|chr16:2117476-2117546,chr16,2117476,2117546,HepG2|chr16:2957684-2957791,chr16,2957684,2957791,0,840208
HepG2|chr16:2223819-2223912,chr16,2223819,2223912,HepG2|chr16:70281072-70281221,chr16,70281072,70281221,0,68057253
HepG2|chr16:2229655-2229753,chr16,2229655,2229753,HepG2|chr16:22553234-22553380,chr16,22553234,22553380,0,20323579
HepG2|chr16:2235558-2235708,chr16,2235558,2235708,HepG2|chr16:2590838-2590954,chr16,2590838,2590954,0,355280
HepG2|chr16:2242974-2243123,chr16,2242974,2243123,HepG2|chr16:15069125-15069271,chr16,15069125,15069271,0,12826151
HepG2|chr16:2289239-2289386,chr16,2289239,2289386,HepG2|chr16:87902056-87902198,chr16,87902056,87902198,0,85612817
HepG2|chr16:2347166-2347282,chr16,2347166,2347282,HepG2|chr16:15071118-15071140,chr16,15071118,15071140,0,12723952
HepG2|chr16:2634188-2634237,chr16,2634188,2634237,HepG2|chr16:56899989-56900139,chr16,56899989,56900139,0,54265801
HepG2|chr16:2782079-2782135,chr16,2782079,2782135,HepG2|chr16:22553231-22553369,chr16,22553231,22553369,0,19771152
HepG2|chr16:2796406-2796453,chr16,2796406,2796453,HepG2|chr16:56899989-56900139,chr16,56899989,56900139,0,54103583
HepG2|chr16:2853244-2853394,chr16,2853244,2853394,HepG2|chr16:2603313-2603460,chr16,2603313,2603460,0,249931
HepG2|chr16:2893778-2893870,chr16,2893778,2893870,HepG2|chr16:33950163-33950218,chr16,33950163,33950218,0,31056385
HepG2|chr16:2926133-2926182,chr16,2926133,2926182,HepG2|chr16:56899989-56900139,chr16,56899989,56900139,0,53973856
HepG2|chr16:3126408-3126488,chr16,3126408,3126488,HepG2|chr16:10835795-10835862,chr16,10835795,10835862,0,7709387
HepG2|chr16:3146361-3146444,chr16,3146361,3146444,HepG2|chr16:10835795-10835862,chr16,10835795,10835862,0,7689434
HepG2|chr16:3338361-3338424,chr16,3338361,3338424,HepG2|chr16:33950169-33950256,chr16,33950169,33950256,0,30611808
HepG2|chr16:3340516-3340606,chr16,3340516,3340606,HepG2|chr16:18937914-18938064,chr16,18937914,18938064,0,15597398
HepG2|chr16:3351950-3351989,chr16,3351950,3351989,HepG2|chr16:68350418-68350449,chr16,68350418,68350449,0,64998468
HepG2|chr16:3473568-3473607,chr16,3473568,3473607,HepG2|chr16:21453547-21453654,chr16,21453547,21453654,0,17979979
HepG2|chr16:3516385-3516428,chr16,3516385,3516428,HepG2|chr16:2957203-2957323,chr16,2957203,2957323,0,559182
HepG2|chr16:3597928-3597990,chr16,3597928,3597990,HepG2|chr16:2183007-2183106,chr16,2183007,2183106,0,1414921
HepG2|chr16:3653906-3653985,chr16,3653906,3653985,HepG2|chr16:87899763-87899845,chr16,87899763,87899845,0,84245857
HepG2|chr16:3749338-3749423,chr16,3749338,3749423,HepG2|chr16:18937922-18937982,chr16,18937922,18937982,0,15188584
HepG2|chr16:3766426-3766538,chr16,3766426,3766538,HepG2|chr16:11886267-11886305,chr16,11886267,11886305,0,8119841
HepG2|chr16:3780611-3780687,chr16,3780611,3780687,HepG2|chr16:18937912-18938061,chr16,18937912,18938061,0,15157301
HepG2|chr16:3876791-3876931,chr16,3876791,3876931,HepG2|chr16:75497163-75497204,chr16,75497163,75497204,0,71620372
HepG2|chr16:4090851-4090959,chr16,4090851,4090959,HepG2|chr16:19124281-19124431,chr16,19124281,19124431,0,15033430
HepG2|chr16:4097838-4097910,chr16,4097838,4097910,HepG2|chr16:87967905-87967975,chr16,87967905,87967975,0,83870067
HepG2|chr16:4100596-4100746,chr16,4100596,4100746,HepG2|chr16:19122827-19122862,chr16,19122827,19122862,0,15022231
HepG2|chr16:4197178-4197298,chr16,4197178,4197298,HepG2|chr16:87893657-87893755,chr16,87893657,87893755,0,83696479
HepG2|chr16:4281859-4281990,chr16,4281859,4281990,HepG2|chr16:10835795-10835862,chr16,10835795,10835862,0,6553936
HepG2|chr16:4337330-4337416,chr16,4337330,4337416,HepG2|chr16:18937922-18937982,chr16,18937922,18937982,0,14600592
HepG2|chr16:4486740-4486823,chr16,4486740,4486823,HepG2|chr16:10835795-10835862,chr16,10835795,10835862,0,6349055
HepG2|chr16:4813824-4813974,chr16,4813824,4813974,HepG2|chr16:18937861-18937990,chr16,18937861,18937990,0,14124037
HepG2|chr16:4843664-4843767,chr16,4843664,4843767,HepG2|chr16:2183011-2183113,chr16,2183011,2183113,0,2660653
HepG2|chr16:4875775-4875925,chr16,4875775,4875925,HepG2|chr16:15069095-15069236,chr16,15069095,15069236,0,10193320
HepG2|chr16:5458770-5458920,chr16,5458770,5458920,HepG2|chr16:87900190-87900334,chr16,87900190,87900334,0,82441420
HepG2|chr16:5770376-5770470,chr16,5770376,5770470,HepG2|chr16:33950337-33950381,chr16,33950337,33950381,0,28179961
HepG2|chr16:5923183-5923283,chr16,5923183,5923283,HepG2|chr16:31192170-31192320,chr16,31192170,31192320,0,25268987
HepG2|chr16:5938832-5938857,chr16,5938832,5938857,HepG2|chr16:2732203-2732350,chr16,2732203,2732350,0,3206629
HepG2|chr16:5960328-5960415,chr16,5960328,5960415,HepG2|chr16:57021741-57021804,chr16,57021741,57021804,0,51061413
HepG2|chr16:5995395-5995545,chr16,5995395,5995545,HepG2|chr16:2590362-2590512,chr16,2590362,2590512,0,3405033
HepG2|chr16:6175556-6175663,chr16,6175556,6175663,HepG2|chr16:70559075-70559103,chr16,70559075,70559103,0,64383519
HepG2|chr16:6299068-6299218,chr16,6299068,6299218,HepG2|chr16:15073143-15073263,chr16,15073143,15073263,0,8774075
HepG2|chr16:6303016-6303042,chr16,6303016,6303042,HepG2|chr16:1873276-1873358,chr16,1873276,1873358,0,4429740
HepG2|chr16:6310553-6310703,chr16,6310553,6310703,HepG2|chr16:15069113-15069263,chr16,15069113,15069263,0,8758560
HepG2|chr16:6390724-6390798,chr16,6390724,6390798,HepG2|chr16:33950163-33950218,chr16,33950163,33950218,0,27559439
HepG2|chr16:6499495-6499603,chr16,6499495,6499603,HepG2|chr16:18937861-18937988,chr16,18937861,18937988,0,12438366
HepG2|chr16:6561004-6561037,chr16,6561004,6561037,HepG2|chr16:15073139-15073289,chr16,15073139,15073289,0,8512135
HepG2|chr16:6661561-6661685,chr16,6661561,6661685,HepG2|chr16:15072063-15072100,chr16,15072063,15072100,0,8410502
HepG2|chr16:6740896-6741046,chr16,6740896,6741046,HepG2|chr16:22553196-22553261,chr16,22553196,22553261,0,15812300
HepG2|chr16:6855232-6855336,chr16,6855232,6855336,HepG2|chr16:85641310-85641356,chr16,85641310,85641356,0,78786078
HepG2|chr16:6910074-6910224,chr16,6910074,6910224,HepG2|chr16:2589880-2590030,chr16,2589880,2590030,0,4320194
HepG2|chr16:6961758-6961907,chr16,6961758,6961907,HepG2|chr16:2590099-2590202,chr16,2590099,2590202,0,4371659
HepG2|chr16:6983405-6983549,chr16,6983405,6983549,HepG2|chr16:2732140-2732196,chr16,2732140,2732196,0,4251265
HepG2|chr16:7012251-7012401,chr16,7012251,7012401,HepG2|chr16:15069094-15069244,chr16,15069094,15069244,0,8056843
HepG2|chr16:7167480-7167521,chr16,7167480,7167521,HepG2|chr16:2957087-2957203,chr16,2957087,2957203,0,4210393
HepG2|chr16:7287931-7288049,chr16,7287931,7288049,HepG2|chr16:22553234-22553380,chr16,22553234,22553380,0,15265303
HepG2|chr16:7289447-7289597,chr16,7289447,7289597,HepG2|chr16:18937861-18937989,chr16,18937861,18937989,0,11648414
HepG2|chr16:7293656-7293788,chr16,7293656,7293788,HepG2|chr16:22553213-22553260,chr16,22553213,22553260,0,15259557
HepG2|chr16:7367816-7367926,chr16,7367816,7367926,HepG2|chr16:15073124-15073190,chr16,15073124,15073190,0,7705308
HepG2|chr16:7435523-7435570,chr16,7435523,7435570,HepG2|chr16:680863-680883,chr16,680863,680883,0,6754660
HepG2|chr16:7465508-7465658,chr16,7465508,7465658,HepG2|chr16:87899949-87900089,chr16,87899949,87900089,0,80434441
HepG2|chr16:7503899-7504045,chr16,7503899,7504045,HepG2|chr16:2589845-2589995,chr16,2589845,2589995,0,4914054
HepG2|chr16:7642796-7642878,chr16,7642796,7642878,HepG2|chr16:33950176-33950205,chr16,33950176,33950205,0,26307380
HepG2|chr16:7896584-7896677,chr16,7896584,7896677,HepG2|chr16:18492508-18492581,chr16,18492508,18492581,0,10595924
HepG2|chr16:7955188-7955246,chr16,7955188,7955246,HepG2|chr16:15071129-15071264,chr16,15071129,15071264,0,7115941
HepG2|chr16:7974046-7974124,chr16,7974046,7974124,HepG2|chr16:2733865-2733955,chr16,2733865,2733955,0,5240181
HepG2|chr16:7994776-7994923,chr16,7994776,7994923,HepG2|chr16:2591022-2591172,chr16,2591022,2591172,0,5403754
HepG2|chr16:8120140-8120287,chr16,8120140,8120287,HepG2|chr16:87902207-87902357,chr16,87902207,87902357,0,79782067
HepG2|chr16:8152909-8153059,chr16,8152909,8153059,HepG2|chr16:87896061-87896156,chr16,87896061,87896156,0,79743152
HepG2|chr16:8226182-8226281,chr16,8226182,8226281,HepG2|chr16:15071126-15071248,chr16,15071126,15071248,0,6844944
HepG2|chr16:8381636-8381734,chr16,8381636,8381734,HepG2|chr16:18937922-18937974,chr16,18937922,18937974,0,10556286
HepG2|chr16:8430147-8430233,chr16,8430147,8430233,HepG2|chr16:18937922-18937982,chr16,18937922,18937982,0,10507775
HepG2|chr16:8450222-8450310,chr16,8450222,8450310,HepG2|chr16:85644584-85644651,chr16,85644584,85644651,0,77194362
HepG2|chr16:8463376-8463526,chr16,8463376,8463526,HepG2|chr16:2590053-2590203,chr16,2590053,2590203,0,5873323
HepG2|chr16:8514448-8514563,chr16,8514448,8514563,HepG2|chr16:15071128-15071238,chr16,15071128,15071238,0,6556680
HepG2|chr16:8686563-8686626,chr16,8686563,8686626,HepG2|chr16:33950169-33950256,chr16,33950169,33950256,0,25263606
HepG2|chr16:9153868-9153961,chr16,9153868,9153961,HepG2|chr16:15071112-15071262,chr16,15071112,15071262,0,5917244
HepG2|chr16:9202725-9202875,chr16,9202725,9202875,HepG2|chr16:75497286-75497436,chr16,75497286,75497436,0,66294561
HepG2|chr16:9204387-9204537,chr16,9204387,9204537,HepG2|chr16:87893793-87893890,chr16,87893793,87893890,0,78689406
HepG2|chr16:9265946-9265976,chr16,9265946,9265976,HepG2|chr16:2732178-2732328,chr16,2732178,2732328,0,6533768
HepG2|chr16:9281135-9281162,chr16,9281135,9281162,HepG2|chr16:11890539-11890662,chr16,11890539,11890662,0,2609404
HepG2|chr16:9314472-9314519,chr16,9314472,9314519,HepG2|chr16:87899717-87899863,chr16,87899717,87899863,0,78585245
HepG2|chr16:9502788-9502807,chr16,9502788,9502807,HepG2|chr16:2732325-2732358,chr16,2732325,2732358,0,6770463
HepG2|chr16:9722296-9722365,chr16,9722296,9722365,HepG2|chr16:85641560-85641641,chr16,85641560,85641641,0,75919264
HepG2|chr16:9727014-9727101,chr16,9727014,9727101,HepG2|chr16:18937922-18937982,chr16,18937922,18937982,0,9210908
HepG2|chr16:9744997-9745037,chr16,9744997,9745037,HepG2|chr16:10835795-10835905,chr16,10835795,10835905,0,1090798
HepG2|chr16:9946193-9946343,chr16,9946193,9946343,HepG2|chr16:2590838-2590954,chr16,2590838,2590954,0,7355355
HepG2|chr16:10006499-10006647,chr16,10006499,10006647,HepG2|chr16:87899695-87899822,chr16,87899695,87899822,0,77893196
HepG2|chr16:10240917-10241042,chr16,10240917,10241042,HepG2|chr16:15189687-15189711,chr16,15189687,15189711,0,4948770
HepG2|chr16:10323064-10323155,chr16,10323064,10323155,HepG2|chr16:33950176-33950217,chr16,33950176,33950217,0,23627112
HepG2|chr16:10330957-10331084,chr16,10330957,10331084,HepG2|chr16:22553108-22553245,chr16,22553108,22553245,0,12222151
HepG2|chr16:10408749-10408899,chr16,10408749,10408899,HepG2|chr16:22553245-22553359,chr16,22553245,22553359,0,12144496
HepG2|chr16:10465239-10465341,chr16,10465239,10465341,HepG2|chr16:33950176-33950218,chr16,33950176,33950218,0,23484937
HepG2|chr16:10491320-10491425,chr16,10491320,10491425,HepG2|chr16:19124234-19124384,chr16,19124234,19124384,0,8632914
HepG2|chr16:10673406-10673550,chr16,10673406,10673550,HepG2|chr16:2601680-2601782,chr16,2601680,2601782,0,8071726
HepG2|chr16:10740034-10740179,chr16,10740034,10740179,HepG2|chr16:85641140-85641176,chr16,85641140,85641176,0,74901106
HepG2|chr16:10843823-10843973,chr16,10843823,10843973,HepG2|chr16:87899704-87899822,chr16,87899704,87899822,0,77055881
HepG2|chr16:10884903-10885048,chr16,10884903,10885048,HepG2|chr16:87899043-87899193,chr16,87899043,87899193,0,77014140
HepG2|chr16:10989075-10989225,chr16,10989075,10989225,HepG2|chr16:2590048-2590198,chr16,2590048,2590198,0,8399027
HepG2|chr16:11037623-11037743,chr16,11037623,11037743,HepG2|chr16:81031540-81031570,chr16,81031540,81031570,0,69993917
HepG2|chr16:11047923-11047988,chr16,11047923,11047988,HepG2|chr16:33950176-33950211,chr16,33950176,33950211,0,22902253
HepG2|chr16:11090512-11090662,chr16,11090512,11090662,HepG2|chr16:2589739-2589889,chr16,2589739,2589889,0,8500773
HepG2|chr16:11124320-11124398,chr16,11124320,11124398,HepG2|chr16:18937922-18938068,chr16,18937922,18938068,0,7813602
HepG2|chr16:11255622-11255717,chr16,11255622,11255717,HepG2|chr16:33950163-33950214,chr16,33950163,33950214,0,22694541
HepG2|chr16:11358488-11358637,chr16,11358488,11358637,HepG2|chr16:87902007-87902157,chr16,87902007,87902157,0,76543519
HepG2|chr16:11409222-11409300,chr16,11409222,11409300,HepG2|chr16:33950176-33950217,chr16,33950176,33950217,0,22540954
HepG2|chr16:11541700-11541788,chr16,11541700,11541788,HepG2|chr16:30963026-30963082,chr16,30963026,30963082,0,19421326
HepG2|chr16:11549893-11549996,chr16,11549893,11549996,HepG2|chr16:22553220-22553260,chr16,22553220,22553260,0,11003327
HepG2|chr16:11584788-11584845,chr16,11584788,11584845,HepG2|chr16:81031797-81031890,chr16,81031797,81031890,0,69447009
HepG2|chr16:11611332-11611482,chr16,11611332,11611482,HepG2|chr16:75497186-75497336,chr16,75497186,75497336,0,63885854
HepG2|chr16:11729620-11729731,chr16,11729620,11729731,HepG2|chr16:87894238-87894297,chr16,87894238,87894297,0,76164618
HepG2|chr16:11915617-11915767,chr16,11915617,11915767,HepG2|chr16:87899704-87899822,chr16,87899704,87899822,0,75984087
HepG2|chr16:12267343-12267474,chr16,12267343,12267474,HepG2|chr16:22553240-22553381,chr16,22553240,22553381,0,10285897
HepG2|chr16:12317829-12317925,chr16,12317829,12317925,HepG2|chr16:18937922-18937976,chr16,18937922,18937976,0,6620093
HepG2|chr16:12358272-12358307,chr16,12358272,12358307,HepG2|chr16:87895659-87895773,chr16,87895659,87895773,0,75537387
HepG2|chr16:12728082-12728232,chr16,12728082,12728232,HepG2|chr16:87899721-87899854,chr16,87899721,87899854,0,75171639
HepG2|chr16:12797520-12797632,chr16,12797520,12797632,HepG2|chr16:11886267-11886305,chr16,11886267,11886305,0,911253
HepG2|chr16:12844384-12844534,chr16,12844384,12844534,HepG2|chr16:2589854-2590001,chr16,2589854,2590001,0,10254530
HepG2|chr16:13246577-13246711,chr16,13246577,13246711,HepG2|chr16:2934254-2934270,chr16,2934254,2934270,0,10312323
HepG2|chr16:13261442-13261499,chr16,13261442,13261499,HepG2|chr16:81031797-81031890,chr16,81031797,81031890,0,67770355
HepG2|chr16:13266561-13266651,chr16,13266561,13266651,HepG2|chr16:33950163-33950222,chr16,33950163,33950222,0,20683602
HepG2|chr16:13331287-13331437,chr16,13331287,13331437,HepG2|chr16:2590052-2590202,chr16,2590052,2590202,0,10741235
HepG2|chr16:13365926-13365989,chr16,13365926,13365989,HepG2|chr16:89693524-89693611,chr16,89693524,89693611,0,76327598
HepG2|chr16:13482380-13482473,chr16,13482380,13482473,HepG2|chr16:33950176-33950207,chr16,33950176,33950207,0,20467796
HepG2|chr16:13511633-13511665,chr16,13511633,13511665,HepG2|chr16:19124350-19124494,chr16,19124350,19124494,0,5612717
HepG2|chr16:13559644-13559691,chr16,13559644,13559691,HepG2|chr16:15071131-15071262,chr16,15071131,15071262,0,1511487
HepG2|chr16:14007491-14007541,chr16,14007491,14007541,HepG2|chr16:56899915-56900045,chr16,56899915,56900045,0,42892424
HepG2|chr16:14007830-14007971,chr16,14007830,14007971,HepG2|chr16:2590879-2590909,chr16,2590879,2590909,0,11416951
HepG2|chr16:14379673-14379823,chr16,14379673,14379823,HepG2|chr16:2590420-2590570,chr16,2590420,2590570,0,11789253
HepG2|chr16:14506582-14506632,chr16,14506582,14506632,HepG2|chr16:56899915-56900045,chr16,56899915,56900045,0,42393333
HepG2|chr16:14554208-14554358,chr16,14554208,14554358,HepG2|chr16:87899060-87899144,chr16,87899060,87899144,0,73344852
HepG2|chr16:14688513-14688593,chr16,14688513,14688593,HepG2|chr16:15071118-15071262,chr16,15071118,15071262,0,382605
HepG2|chr16:14712532-14712682,chr16,14712532,14712682,HepG2|chr16:15069113-15069263,chr16,15069113,15069263,0,356581
HepG2|chr16:14759164-14759257,chr16,14759164,14759257,HepG2|chr16:70281072-70281221,chr16,70281072,70281221,0,55521908
HepG2|chr16:14826543-14826574,chr16,14826543,14826574,HepG2|chr16:31121861-31121980,chr16,31121861,31121980,0,16295318
HepG2|chr16:14894207-14894307,chr16,14894207,14894307,HepG2|chr16:81029792-81029836,chr16,81029792,81029836,0,66135585
HepG2|chr16:14919381-14919531,chr16,14919381,14919531,HepG2|chr16:2591235-2591385,chr16,2591235,2591385,0,12328146
HepG2|chr16:14930854-14930942,chr16,14930854,14930942,HepG2|chr16:70284035-70284062,chr16,70284035,70284062,0,55353181
HepG2|chr16:14940851-14940969,chr16,14940851,14940969,HepG2|chr16:2957632-2957675,chr16,2957632,2957675,0,11983219
HepG2|chr16:15138774-15138824,chr16,15138774,15138824,HepG2|chr16:19124222-19124298,chr16,19124222,19124298,0,3985448
HepG2|chr16:15144816-15144942,chr16,15144816,15144942,HepG2|chr16:30759404-30759436,chr16,30759404,30759436,0,15614588
HepG2|chr16:15275715-15275831,chr16,15275715,15275831,HepG2|chr16:15071129-15071268,chr16,15071129,15071268,0,204586
HepG2|chr16:15295077-15295215,chr16,15295077,15295215,HepG2|chr16:87900121-87900271,chr16,87900121,87900271,0,72605044
HepG2|chr16:15385120-15385268,chr16,15385120,15385268,HepG2|chr16:21455187-21455250,chr16,21455187,21455250,0,6070067
HepG2|chr16:15416451-15416575,chr16,15416451,15416575,HepG2|chr16:15072063-15072100,chr16,15072063,15072100,0,344388
HepG2|chr16:15507739-15507889,chr16,15507739,15507889,HepG2|chr16:87899075-87899167,chr16,87899075,87899167,0,72391336
HepG2|chr16:15546042-15546192,chr16,15546042,15546192,HepG2|chr16:15069087-15069237,chr16,15069087,15069237,0,476955
HepG2|chr16:15548287-15548379,chr16,15548287,15548379,HepG2|chr16:33950176-33950205,chr16,33950176,33950205,0,18401889
HepG2|chr16:15569810-15569932,chr16,15569810,15569932,HepG2|chr16:2725992-2726046,chr16,2725992,2726046,0,12843818
HepG2|chr16:15603964-15604110,chr16,15603964,15604110,HepG2|chr16:2733040-2733190,chr16,2733040,2733190,0,12870924
HepG2|chr16:15709170-15709243,chr16,15709170,15709243,HepG2|chr16:3696369-3696446,chr16,3696369,3696446,0,12012801
HepG2|chr16:15920168-15920228,chr16,15920168,15920228,HepG2|chr16:30763530-30763605,chr16,30763530,30763605,0,14843362
HepG2|chr16:16067929-16068060,chr16,16067929,16068060,HepG2|chr16:4512488-4512595,chr16,4512488,4512595,0,11555441
HepG2|chr16:16071585-16071672,chr16,16071585,16071672,HepG2|chr16:57021741-57021804,chr16,57021741,57021804,0,40950156
HepG2|chr16:16423667-16423723,chr16,16423667,16423723,HepG2|chr16:2957524-2957598,chr16,2957524,2957598,0,13466143
HepG2|chr16:16503667-16503816,chr16,16503667,16503816,HepG2|chr16:87900133-87900280,chr16,87900133,87900280,0,71396466
HepG2|chr16:16593539-16593689,chr16,16593539,16593689,HepG2|chr16:15187589-15187739,chr16,15187589,15187739,0,1405950
HepG2|chr16:16725260-16725316,chr16,16725260,16725316,HepG2|chr16:30908977-30909018,chr16,30908977,30909018,0,14183717
HepG2|chr16:17039986-17040136,chr16,17039986,17040136,HepG2|chr16:75497186-75497336,chr16,75497186,75497336,0,58457200
HepG2|chr16:17079535-17079685,chr16,17079535,17079685,HepG2|chr16:87897906-87898053,chr16,87897906,87898053,0,70818371
HepG2|chr16:17265362-17265412,chr16,17265362,17265412,HepG2|chr16:19123383-19123408,chr16,19123383,19123408,0,1858021
HepG2|chr16:17532114-17532251,chr16,17532114,17532251,HepG2|chr16:22553211-22553265,chr16,22553211,22553265,0,5021097
HepG2|chr16:17699443-17699547,chr16,17699443,17699547,HepG2|chr16:85641310-85641356,chr16,85641310,85641356,0,67941867
HepG2|chr16:17702629-17702703,chr16,17702629,17702703,HepG2|chr16:2933994-2934070,chr16,2933994,2934070,0,14768635
HepG2|chr16:17856116-17856266,chr16,17856116,17856266,HepG2|chr16:15071957-15072107,chr16,15071957,15072107,0,2784159
HepG2|chr16:17927695-17927800,chr16,17927695,17927800,HepG2|chr16:85645585-85645657,chr16,85645585,85645657,0,67717890
HepG2|chr16:17952488-17952638,chr16,17952488,17952638,HepG2|chr16:15073580-15073727,chr16,15073580,15073727,0,2878908
HepG2|chr16:18064046-18064144,chr16,18064046,18064144,HepG2|chr16:31121861-31121980,chr16,31121861,31121980,0,13057815
HepG2|chr16:18155958-18156066,chr16,18155958,18156066,HepG2|chr16:3032807-3032880,chr16,3032807,3032880,0,15123151
HepG2|chr16:18156555-18156705,chr16,18156555,18156705,HepG2|chr16:2590051-2590201,chr16,2590051,2590201,0,15566504
HepG2|chr16:18197052-18197107,chr16,18197052,18197107,HepG2|chr16:1873276-1873348,chr16,1873276,1873348,0,16323776
HepG2|chr16:18329903-18330053,chr16,18329903,18330053,HepG2|chr16:15187544-15187691,chr16,15187544,15187691,0,3142359
HepG2|chr16:18397708-18397802,chr16,18397708,18397802,HepG2|chr16:33950337-33950381,chr16,33950337,33950381,0,15552629
HepG2|chr16:18554356-18554432,chr16,18554356,18554432,HepG2|chr16:56900034-56900142,chr16,56900034,56900142,0,38345678
HepG2|chr16:18587745-18587892,chr16,18587745,18587892,HepG2|chr16:87902011-87902161,chr16,87902011,87902161,0,69314266
HepG2|chr16:18744076-18744168,chr16,18744076,18744168,HepG2|chr16:33950163-33950218,chr16,33950163,33950218,0,15206087
HepG2|chr16:18748933-18749015,chr16,18748933,18749015,HepG2|chr16:30763468-30763536,chr16,30763468,30763536,0,12014535
HepG2|chr16:18965466-18965489,chr16,18965466,18965489,HepG2|chr16:10834191-10834309,chr16,10834191,10834309,0,8131275
HepG2|chr16:18968369-18968426,chr16,18968369,18968426,HepG2|chr16:18937861-18937987,chr16,18937861,18937987,0,30508
HepG2|chr16:18995576-18995726,chr16,18995576,18995726,HepG2|chr16:15069140-15069290,chr16,15069140,15069290,0,3926436
HepG2|chr16:19252374-19252519,chr16,19252374,19252519,HepG2|chr16:87902214-87902364,chr16,87902214,87902364,0,68649840
HepG2|chr16:19326085-19326235,chr16,19326085,19326235,HepG2|chr16:87902007-87902157,chr16,87902007,87902157,0,68575922
HepG2|chr16:19393250-19393400,chr16,19393250,19393400,HepG2|chr16:2590293-2590329,chr16,2590293,2590329,0,16802957
HepG2|chr16:19631354-19631461,chr16,19631354,19631461,HepG2|chr16:70559075-70559103,chr16,70559075,70559103,0,50927721
HepG2|chr16:19772764-19772902,chr16,19772764,19772902,HepG2|chr16:87900121-87900271,chr16,87900121,87900271,0,68127357
HepG2|chr16:19844516-19844665,chr16,19844516,19844665,HepG2|chr16:18937934-18937970,chr16,18937934,18937970,0,906582
HepG2|chr16:20228425-20228508,chr16,20228425,20228508,HepG2|chr16:85644584-85644651,chr16,85644584,85644651,0,65416159
HepG2|chr16:20279193-20279277,chr16,20279193,20279277,HepG2|chr16:22448233-22448320,chr16,22448233,22448320,0,2169040
HepG2|chr16:20352211-20352361,chr16,20352211,20352361,HepG2|chr16:2590053-2590203,chr16,2590053,2590203,0,17762158
HepG2|chr16:20425003-20425064,chr16,20425003,20425064,HepG2|chr16:89693524-89693613,chr16,89693524,89693613,0,69268521
HepG2|chr16:20582654-20582716,chr16,20582654,20582716,HepG2|chr16:71845090-71845157,chr16,71845090,71845157,0,51262436
HepG2|chr16:20613650-20613730,chr16,20613650,20613730,HepG2|chr16:15071118-15071262,chr16,15071118,15071262,0,5542532
HepG2|chr16:20624822-20624878,chr16,20624822,20624878,HepG2|chr16:1873276-1873360,chr16,1873276,1873360,0,18751546
HepG2|chr16:20728575-20728626,chr16,20728575,20728626,HepG2|chr16:56899985-56900135,chr16,56899985,56900135,0,36171410
HepG2|chr16:20729536-20729644,chr16,20729536,20729644,HepG2|chr16:18935971-18936048,chr16,18935971,18936048,0,1793565
HepG2|chr16:20762792-20762940,chr16,20762792,20762940,HepG2|chr16:2590053-2590203,chr16,2590053,2590203,0,18172739
HepG2|chr16:20821436-20821547,chr16,20821436,20821547,HepG2|chr16:2732140-2732179,chr16,2732140,2732179,0,18089296
HepG2|chr16:20936874-20936953,chr16,20936874,20936953,HepG2|chr16:33950176-33950205,chr16,33950176,33950205,0,13013302
HepG2|chr16:20972082-20972165,chr16,20972082,20972165,HepG2|chr16:56899915-56900060,chr16,56899915,56900060,0,35927833
HepG2|chr16:20988209-20988359,chr16,20988209,20988359,HepG2|chr16:15187589-15187739,chr16,15187589,15187739,0,5800620
HepG2|chr16:21303442-21303562,chr16,21303442,21303562,HepG2|chr16:87894254-87894282,chr16,87894254,87894282,0,66590812
HepG2|chr16:21371829-21371974,chr16,21371829,21371974,HepG2|chr16:87899043-87899193,chr16,87899043,87899193,0,66527214
HepG2|chr16:21411148-21411195,chr16,21411148,21411195,HepG2|chr16:18937861-18937989,chr16,18937861,18937989,0,2473287
HepG2|chr16:21419063-21419195,chr16,21419063,21419195,HepG2|chr16:22553213-22553260,chr16,22553213,22553260,0,1134150
HepG2|chr16:21462488-21462613,chr16,21462488,21462613,HepG2|chr16:15071129-15071264,chr16,15071129,15071264,0,6391359
HepG2|chr16:21538748-21538898,chr16,21538748,21538898,HepG2|chr16:15069094-15069244,chr16,15069094,15069244,0,6469654
HepG2|chr16:21549687-21549757,chr16,21549687,21549757,HepG2|chr16:18937899-18937980,chr16,18937899,18937980,0,2611788
HepG2|chr16:21638269-21638345,chr16,21638269,21638345,HepG2|chr16:18937912-18938061,chr16,18937912,18938061,0,2700357
HepG2|chr16:21650611-21650747,chr16,21650611,21650747,HepG2|chr16:22553241-22553380,chr16,22553241,22553380,0,902630
HepG2|chr16:21838306-21838397,chr16,21838306,21838397,HepG2|chr16:33950176-33950217,chr16,33950176,33950217,0,12111870
HepG2|chr16:21936459-21936609,chr16,21936459,21936609,HepG2|chr16:87900190-87900334,chr16,87900190,87900334,0,65963731
HepG2|chr16:21948311-21948429,chr16,21948311,21948429,HepG2|chr16:56899985-56900135,chr16,56899985,56900135,0,34951674
HepG2|chr16:21982747-21982839,chr16,21982747,21982839,HepG2|chr16:2733051-2733200,chr16,2733051,2733200,0,19249696
HepG2|chr16:22297090-22297182,chr16,22297090,22297182,HepG2|chr16:2183000-2183135,chr16,2183000,2183135,0,20114090
HepG2|chr16:22655345-22655420,chr16,22655345,22655420,HepG2|chr16:10835795-10835851,chr16,10835795,10835851,0,11819550
HepG2|chr16:22689361-22689482,chr16,22689361,22689482,HepG2|chr16:18937929-18938063,chr16,18937929,18938063,0,3751432
HepG2|chr16:22732580-22732730,chr16,22732580,22732730,HepG2|chr16:2589868-2590018,chr16,2589868,2590018,0,20142712
HepG2|chr16:22877947-22878097,chr16,22877947,22878097,HepG2|chr16:87902290-87902440,chr16,87902290,87902440,0,65024343
HepG2|chr16:22906385-22906532,chr16,22906385,22906532,HepG2|chr16:85644118-85644136,chr16,85644118,85644136,0,62737733
HepG2|chr16:22933313-22933393,chr16,22933313,22933393,HepG2|chr16:33950176-33950207,chr16,33950176,33950207,0,11016863
HepG2|chr16:22971268-22971337,chr16,22971268,22971337,HepG2|chr16:4512185-4512259,chr16,4512185,4512259,0,18459083
HepG2|chr16:22999052-22999184,chr16,22999052,22999184,HepG2|chr16:18937924-18938063,chr16,18937924,18938063,0,4061128
HepG2|chr16:23261928-23262077,chr16,23261928,23262077,HepG2|chr16:15072183-15072333,chr16,15072183,15072333,0,8189745
HepG2|chr16:23271944-23272094,chr16,23271944,23272094,HepG2|chr16:2590072-2590222,chr16,2590072,2590222,0,20681872
HepG2|chr16:23308991-23309016,chr16,23308991,23309016,HepG2|chr16:30963026-30963082,chr16,30963026,30963082,0,7654035
HepG2|chr16:23399245-23399394,chr16,23399245,23399394,HepG2|chr16:87892764-87892860,chr16,87892764,87892860,0,64493519
HepG2|chr16:23404227-23404314,chr16,23404227,23404314,HepG2|chr16:2957414-2957525,chr16,2957414,2957525,0,20446813
HepG2|chr16:23416212-23416289,chr16,23416212,23416289,HepG2|chr16:15071126-15071267,chr16,15071126,15071267,0,8345086
HepG2|chr16:23477429-23477536,chr16,23477429,23477536,HepG2|chr16:2957632-2957675,chr16,2957632,2957675,0,20519797
HepG2|chr16:23546636-23546734,chr16,23546636,23546734,HepG2|chr16:2957033-2957153,chr16,2957033,2957153,0,20589603
HepG2|chr16:23613701-23613850,chr16,23613701,23613850,HepG2|chr16:2590824-2590974,chr16,2590824,2590974,0,21022877
HepG2|chr16:23678117-23678214,chr16,23678117,23678214,HepG2|chr16:85641106-85641159,chr16,85641106,85641159,0,61962989
HepG2|chr16:23716760-23716906,chr16,23716760,23716906,HepG2|chr16:87902206-87902356,chr16,87902206,87902356,0,64185446
HepG2|chr16:23738705-23738855,chr16,23738705,23738855,HepG2|chr16:15071116-15071154,chr16,15071116,15071154,0,8667589
HepG2|chr16:23754161-23754241,chr16,23754161,23754241,HepG2|chr16:56899985-56900135,chr16,56899985,56900135,0,33145824
HepG2|chr16:23845316-23845436,chr16,23845316,23845436,HepG2|chr16:2933994-2934070,chr16,2933994,2934070,0,20911322
HepG2|chr16:23908624-23908704,chr16,23908624,23908704,HepG2|chr16:56899985-56900135,chr16,56899985,56900135,0,32991361
HepG2|chr16:23947844-23947909,chr16,23947844,23947909,HepG2|chr16:10835810-10835960,chr16,10835810,10835960,0,13112034
HepG2|chr16:23979861-23980011,chr16,23979861,23980011,HepG2|chr16:87899949-87900089,chr16,87899949,87900089,0,63920088
HepG2|chr16:23988005-23988119,chr16,23988005,23988119,HepG2|chr16:85641140-85641176,chr16,85641140,85641176,0,61653135
HepG2|chr16:24090265-24090412,chr16,24090265,24090412,HepG2|chr16:87902207-87902357,chr16,87902207,87902357,0,63811942
HepG2|chr16:24197050-24197200,chr16,24197050,24197200,HepG2|chr16:2590420-2590570,chr16,2590420,2590570,0,21606630
HepG2|chr16:24229403-24229451,chr16,24229403,24229451,HepG2|chr16:30908977-30909018,chr16,30908977,30909018,0,6679574
HepG2|chr16:24267915-24267979,chr16,24267915,24267979,HepG2|chr16:29830398-29830464,chr16,29830398,29830464,0,5562483
HepG2|chr16:24274813-24274933,chr16,24274813,24274933,HepG2|chr16:87893657-87893755,chr16,87893657,87893755,0,63618844
HepG2|chr16:24319448-24319527,chr16,24319448,24319527,HepG2|chr16:18937922-18937993,chr16,18937922,18937993,0,5381526
HepG2|chr16:24411723-24411848,chr16,24411723,24411848,HepG2|chr16:2183056-2183111,chr16,2183056,2183111,0,22228667
HepG2|chr16:24546858-24546970,chr16,24546858,24546970,HepG2|chr16:18935929-18936068,chr16,18935929,18936068,0,5610929
HepG2|chr16:24587218-24587368,chr16,24587218,24587368,HepG2|chr16:11886267-11886305,chr16,11886267,11886305,0,12700951
HepG2|chr16:24739207-24739232,chr16,24739207,24739232,HepG2|chr16:21456003-21456122,chr16,21456003,21456122,0,3283204
HepG2|chr16:24772821-24772862,chr16,24772821,24772862,HepG2|chr16:10835795-10835904,chr16,10835795,10835904,0,13937026
HepG2|chr16:24822943-24822978,chr16,24822943,24822978,HepG2|chr16:3696369-3696481,chr16,3696369,3696481,0,21126574
HepG2|chr16:24908883-24909033,chr16,24908883,24909033,HepG2|chr16:15069096-15069245,chr16,15069096,15069245,0,9839787
HepG2|chr16:24930903-24931002,chr16,24930903,24931002,HepG2|chr16:18937922-18937973,chr16,18937922,18937973,0,5992981
HepG2|chr16:24936654-24936804,chr16,24936654,24936804,HepG2|chr16:2590053-2590203,chr16,2590053,2590203,0,22346601
HepG2|chr16:24939272-24939402,chr16,24939272,24939402,HepG2|chr16:18937924-18938063,chr16,18937924,18938063,0,6001348
HepG2|chr16:25052780-25052895,chr16,25052780,25052895,HepG2|chr16:87894255-87894277,chr16,87894255,87894277,0,62841475
HepG2|chr16:25096181-25096306,chr16,25096181,25096306,HepG2|chr16:15189687-15189711,chr16,15189687,15189711,0,9906494
HepG2|chr16:25267083-25267223,chr16,25267083,25267223,HepG2|chr16:75497163-75497204,chr16,75497163,75497204,0,50230080
HepG2|chr16:25537179-25537328,chr16,25537179,25537328,HepG2|chr16:2590513-2590663,chr16,2590513,2590663,0,22946666
HepG2|chr16:25570098-25570223,chr16,25570098,25570223,HepG2|chr16:15073139-15073289,chr16,15073139,15073289,0,10496959
HepG2|chr16:25650283-25650365,chr16,25650283,25650365,HepG2|chr16:18937922-18937987,chr16,18937922,18937987,0,6712361
HepG2|chr16:25726598-25726688,chr16,25726598,25726688,HepG2|chr16:19124755-19124830,chr16,19124755,19124830,0,6601843
HepG2|chr16:25856282-25856432,chr16,25856282,25856432,HepG2|chr16:15071127-15071264,chr16,15071127,15071264,0,10785155
HepG2|chr16:25872084-25872234,chr16,25872084,25872234,HepG2|chr16:87897906-87898053,chr16,87897906,87898053,0,62025822
HepG2|chr16:25877688-25877838,chr16,25877688,25877838,HepG2|chr16:87899721-87899854,chr16,87899721,87899854,0,62022033
HepG2|chr16:25952186-25952331,chr16,25952186,25952331,HepG2|chr16:2590048-2590198,chr16,2590048,2590198,0,23362138
HepG2|chr16:26054679-26054754,chr16,26054679,26054754,HepG2|chr16:56899992-56900142,chr16,56899992,56900142,0,30845313
HepG2|chr16:26125188-26125338,chr16,26125188,26125338,HepG2|chr16:2590048-2590198,chr16,2590048,2590198,0,23535140
HepG2|chr16:26139669-26139772,chr16,26139669,26139772,HepG2|chr16:85641310-85641356,chr16,85641310,85641356,0,59501641
HepG2|chr16:26305269-26305413,chr16,26305269,26305413,HepG2|chr16:2590040-2590187,chr16,2590040,2590187,0,23715229
HepG2|chr16:26355945-26356095,chr16,26355945,26356095,HepG2|chr16:87902009-87902159,chr16,87902009,87902159,0,61546064
HepG2|chr16:26356349-26356396,chr16,26356349,26356396,HepG2|chr16:680863-680883,chr16,680863,680883,0,25675486
HepG2|chr16:26465036-26465186,chr16,26465036,26465186,HepG2|chr16:15073136-15073164,chr16,15073136,15073164,0,11391900
HepG2|chr16:26579994-26580112,chr16,26579994,26580112,HepG2|chr16:87899716-87899866,chr16,87899716,87899866,0,61319722
HepG2|chr16:26644771-26644796,chr16,26644771,26644796,HepG2|chr16:21456003-21456122,chr16,21456003,21456122,0,5188768
HepG2|chr16:26673469-26673548,chr16,26673469,26673548,HepG2|chr16:19124222-19124293,chr16,19124222,19124293,0,7549247
HepG2|chr16:26692061-26692211,chr16,26692061,26692211,HepG2|chr16:22553196-22553261,chr16,22553196,22553261,0,4138865
HepG2|chr16:26743923-26744039,chr16,26743923,26744039,HepG2|chr16:15071129-15071268,chr16,15071129,15071268,0,11672794
HepG2|chr16:26912719-26912766,chr16,26912719,26912766,HepG2|chr16:15071131-15071262,chr16,15071131,15071262,0,11841588
HepG2|chr16:27161207-27161338,chr16,27161207,27161338,HepG2|chr16:87893916-87893947,chr16,87893916,87893947,0,60732709
HepG2|chr16:27232033-27232083,chr16,27232033,27232083,HepG2|chr16:2732140-2732235,chr16,2732140,2732235,0,24499893
HepG2|chr16:27389967-27390066,chr16,27389967,27390066,HepG2|chr16:15071126-15071248,chr16,15071126,15071248,0,12318841
HepG2|chr16:27400639-27400744,chr16,27400639,27400744,HepG2|chr16:87900102-87900247,chr16,87900102,87900247,0,60499463
HepG2|chr16:27414478-27414572,chr16,27414478,27414572,HepG2|chr16:686732-686781,chr16,686732,686781,0,26727746
HepG2|chr16:27448644-27448741,chr16,27448644,27448741,HepG2|chr16:3032807-3032880,chr16,3032807,3032880,0,24415837
HepG2|chr16:27622478-27622618,chr16,27622478,27622618,HepG2|chr16:22553245-22553384,chr16,22553245,22553384,0,5069233
HepG2|chr16:27725376-27725439,chr16,27725376,27725439,HepG2|chr16:2590535-2590685,chr16,2590535,2590685,0,25134841
HepG2|chr16:27808421-27808490,chr16,27808421,27808490,HepG2|chr16:15073139-15073289,chr16,15073139,15073289,0,12735282
HepG2|chr16:27947360-27947478,chr16,27947360,27947478,HepG2|chr16:22553234-22553380,chr16,22553234,22553380,0,5394126
HepG2|chr16:28107800-28107888,chr16,28107800,28107888,HepG2|chr16:70284035-70284062,chr16,70284035,70284062,0,42176235
HepG2|chr16:28389682-28389775,chr16,28389682,28389775,HepG2|chr16:18937927-18938063,chr16,18937927,18938063,0,9451755
HepG2|chr16:28445326-28445368,chr16,28445326,28445368,HepG2|chr16:88631910-88632018,chr16,88631910,88632018,0,60186584
HepG2|chr16:28489074-28489163,chr16,28489074,28489163,HepG2|chr16:33950163-33950218,chr16,33950163,33950218,0,5461089
HepG2|chr16:28499770-28499913,chr16,28499770,28499913,HepG2|chr16:15008685-15008822,chr16,15008685,15008822,0,13491085
HepG2|chr16:28572657-28572807,chr16,28572657,28572807,HepG2|chr16:15069096-15069245,chr16,15069096,15069245,0,13503561
HepG2|chr16:28776443-28776593,chr16,28776443,28776593,HepG2|chr16:15071957-15072107,chr16,15071957,15072107,0,13704486
HepG2|chr16:28912295-28912411,chr16,28912295,28912411,HepG2|chr16:87892606-87892722,chr16,87892606,87892722,0,58980311
HepG2|chr16:29137008-29137052,chr16,29137008,29137052,HepG2|chr16:2603162-2603282,chr16,2603162,2603282,0,26533846
HepG2|chr16:29340795-29340856,chr16,29340795,29340856,HepG2|chr16:30763530-30763605,chr16,30763530,30763605,0,1422735
HepG2|chr16:29365647-29365698,chr16,29365647,29365698,HepG2|chr16:4237007-4237106,chr16,4237007,4237106,0,25128640
HepG2|chr16:29611338-29611379,chr16,29611338,29611379,HepG2|chr16:10835795-10835904,chr16,10835795,10835904,0,18775543
HepG2|chr16:29640664-29640794,chr16,29640664,29640794,HepG2|chr16:10835794-10835944,chr16,10835794,10835944,0,18804870
HepG2|chr16:29651398-29651429,chr16,29651398,29651429,HepG2|chr16:15074180-15074283,chr16,15074180,15074283,0,14577218
HepG2|chr16:29720799-29720949,chr16,29720799,29720949,HepG2|chr16:2590047-2590187,chr16,2590047,2590187,0,27130752
HepG2|chr16:29734888-29734973,chr16,29734888,29734973,HepG2|chr16:22448157-22448286,chr16,22448157,22448286,0,7286731
HepG2|chr16:29751307-29751389,chr16,29751307,29751389,HepG2|chr16:30763468-30763536,chr16,30763468,30763536,0,1012161
HepG2|chr16:29904089-29904239,chr16,29904089,29904239,HepG2|chr16:16317399-16317548,chr16,16317399,16317548,0,13586690
HepG2|chr16:29971956-29972085,chr16,29971956,29972085,HepG2|chr16:15189687-15189711,chr16,15189687,15189711,0,14782269
HepG2|chr16:30038711-30038857,chr16,30038711,30038857,HepG2|chr16:75497162-75497311,chr16,75497162,75497311,0,45458451
HepG2|chr16:30050258-30050314,chr16,30050258,30050314,HepG2|chr16:30908977-30909018,chr16,30908977,30909018,0,858719
HepG2|chr16:30151744-30151860,chr16,30151744,30151860,HepG2|chr16:87892606-87892722,chr16,87892606,87892722,0,57740862
HepG2|chr16:30191940-30192013,chr16,30191940,30192013,HepG2|chr16:30963473-30963547,chr16,30963473,30963547,0,771533
HepG2|chr16:30441645-30441795,chr16,30441645,30441795,HepG2|chr16:18937861-18937989,chr16,18937861,18937989,0,11503784
HepG2|chr16:30454966-30455053,chr16,30454966,30455053,HepG2|chr16:22553238-22553359,chr16,22553238,22553359,0,7901728
HepG2|chr16:30469342-30469420,chr16,30469342,30469420,HepG2|chr16:85645585-85645657,chr16,85645585,85645657,0,55176243
HepG2|chr16:30500113-30500149,chr16,30500113,30500149,HepG2|chr16:75274996-75275080,chr16,75274996,75275080,0,44774883
HepG2|chr16:30752512-30752662,chr16,30752512,30752662,HepG2|chr16:15187544-15187691,chr16,15187544,15187691,0,15564968
HepG2|chr16:30759983-30760094,chr16,30759983,30760094,HepG2|chr16:85641106-85641159,chr16,85641106,85641159,0,54881123
HepG2|chr16:31030269-31030415,chr16,31030269,31030415,HepG2|chr16:87901972-87902121,chr16,87901972,87902121,0,56871703
HepG2|chr16:31088246-31088392,chr16,31088246,31088392,HepG2|chr16:87901972-87902121,chr16,87901972,87902121,0,56813726
HepG2|chr16:31218923-31218978,chr16,31218923,31218978,HepG2|chr16:1873276-1873348,chr16,1873276,1873348,0,29345647
HepG2|chr16:31283598-31283677,chr16,31283598,31283677,HepG2|chr16:56899842-56899876,chr16,56899842,56899876,0,25616244
HepG2|chr16:31371315-31371462,chr16,31371315,31371462,HepG2|chr16:2180902-2181052,chr16,2180902,2181052,0,29190413
HepG2|chr16:31601014-31601043,chr16,31601014,31601043,HepG2|chr16:81029386-81029533,chr16,81029386,81029533,0,49428372
HepG2|chr16:31607164-31607313,chr16,31607164,31607313,HepG2|chr16:2590099-2590202,chr16,2590099,2590202,0,29017065
HepG2|chr16:31649823-31649877,chr16,31649823,31649877,HepG2|chr16:87901578-87901721,chr16,87901578,87901721,0,56251755
HepG2|chr16:31736127-31736236,chr16,31736127,31736236,HepG2|chr16:89626851-89626882,chr16,89626851,89626882,0,57890724
HepG2|chr16:31856682-31856739,chr16,31856682,31856739,HepG2|chr16:1873276-1873360,chr16,1873276,1873360,0,29983406
HepG2|chr16:32056373-32056488,chr16,32056373,32056488,HepG2|chr16:22553154-22553264,chr16,22553154,22553264,0,9503219
HepG2|chr16:32217307-32217457,chr16,32217307,32217457,HepG2|chr16:15187532-15187679,chr16,15187532,15187679,0,17029775
HepG2|chr16:32252207-32252304,chr16,32252207,32252304,HepG2|chr16:19124755-19124830,chr16,19124755,19124830,0,13127452
HepG2|chr16:32394851-32394870,chr16,32394851,32394870,HepG2|chr16:2732325-2732358,chr16,2732325,2732358,0,29662526
HepG2|chr16:32462309-32462450,chr16,32462309,32462450,HepG2|chr16:22448138-22448227,chr16,22448138,22448227,0,10014171
HepG2|chr16:32672896-32673028,chr16,32672896,32673028,HepG2|chr16:18937924-18938063,chr16,18937924,18938063,0,13734972
HepG2|chr16:32677001-32677058,chr16,32677001,32677058,HepG2|chr16:18937861-18937982,chr16,18937861,18937982,0,13739140
HepG2|chr16:32745962-32746111,chr16,32745962,32746111,HepG2|chr16:87900133-87900280,chr16,87900133,87900280,0,55154171
HepG2|chr16:32756267-32756374,chr16,32756267,32756374,HepG2|chr16:33950337-33950379,chr16,33950337,33950379,0,1194070
HepG2|chr16:33085289-33085439,chr16,33085289,33085439,HepG2|chr16:87899056-87899206,chr16,87899056,87899206,0,54813767
HepG2|chr16:33108853-33109003,chr16,33108853,33109003,HepG2|chr16:2589739-2589886,chr16,2589739,2589886,0,30519114
HepG2|chr16:33349859-33350009,chr16,33349859,33350009,HepG2|chr16:2589880-2590030,chr16,2589880,2590030,0,30759979
HepG2|chr16:33405055-33405132,chr16,33405055,33405132,HepG2|chr16:18938019-18938063,chr16,18938019,18938063,0,14467036
HepG2|chr16:33565218-33565324,chr16,33565218,33565324,HepG2|chr16:89626851-89626882,chr16,89626851,89626882,0,56061633
HepG2|chr16:33629682-33629739,chr16,33629682,33629739,HepG2|chr16:18937861-18937982,chr16,18937861,18937982,0,14691821
HepG2|chr16:33726213-33726359,chr16,33726213,33726359,HepG2|chr16:85647510-85647660,chr16,85647510,85647660,0,51921297
HepG2|chr16:33738594-33738631,chr16,33738594,33738631,HepG2|chr16:69222722-69222870,chr16,69222722,69222870,0,35484128
HepG2|chr16:33744928-33745078,chr16,33744928,33745078,HepG2|chr16:18937922-18937982,chr16,18937922,18937982,0,14807006
HepG2|chr16:33949115-33949231,chr16,33949115,33949231,HepG2|chr16:15071118-15071140,chr16,15071118,15071140,0,18877997
HepG2|chr16:34014556-34014627,chr16,34014556,34014627,HepG2|chr16:87899129-87899279,chr16,87899129,87899279,0,53884573
HepG2|chr16:34134869-34134940,chr16,34134869,34134940,HepG2|chr16:87899129-87899279,chr16,87899129,87899279,0,53764260
HepG2|chr16:34138710-34138857,chr16,34138710,34138857,HepG2|chr16:87902011-87902161,chr16,87902011,87902161,0,53763301
HepG2|chr16:34256672-34256745,chr16,34256672,34256745,HepG2|chr16:30963473-30963547,chr16,30963473,30963547,0,3293199
HepG2|chr16:34300045-34300195,chr16,34300045,34300195,HepG2|chr16:2590053-2590203,chr16,2590053,2590203,0,31709992
HepG2|chr16:34382249-34382343,chr16,34382249,34382343,HepG2|chr16:56900100-56900250,chr16,56900100,56900250,0,22517851
HepG2|chr16:34471959-34472109,chr16,34471959,34472109,HepG2|chr16:18937912-18938060,chr16,18937912,18938060,0,15534047
HepG2|chr16:34539622-34539769,chr16,34539622,34539769,HepG2|chr16:87900038-87900089,chr16,87900038,87900089,0,53360416
HepG2|chr16:34556279-34556339,chr16,34556279,34556339,HepG2|chr16:2733865-2733955,chr16,2733865,2733955,0,31822414
HepG2|chr16:34632653-34632802,chr16,34632653,34632802,HepG2|chr16:2590513-2590663,chr16,2590513,2590663,0,32042140
HepG2|chr16:34688270-34688340,chr16,34688270,34688340,HepG2|chr16:2957684-2957791,chr16,2957684,2957791,0,31730586
HepG2|chr16:34777914-34777961,chr16,34777914,34777961,HepG2|chr16:87899717-87899863,chr16,87899717,87899863,0,53121803
HepG2|chr16:34855346-34855496,chr16,34855346,34855496,HepG2|chr16:2589739-2589886,chr16,2589739,2589886,0,32265607
HepG2|chr16:34921631-34921741,chr16,34921631,34921741,HepG2|chr16:19124717-19124832,chr16,19124717,19124832,0,15796914
HepG2|chr16:35019033-35019164,chr16,35019033,35019164,HepG2|chr16:22553240-22553381,chr16,22553240,22553381,0,12465793
HepG2|chr16:35045672-35045759,chr16,35045672,35045759,HepG2|chr16:18937922-18937982,chr16,18937922,18937982,0,16107750
HepG2|chr16:35079606-35079753,chr16,35079606,35079753,HepG2|chr16:15187544-15187691,chr16,15187544,15187691,0,19892062
HepG2|chr16:35323123-35323234,chr16,35323123,35323234,HepG2|chr16:87894238-87894297,chr16,87894238,87894297,0,52571115
HepG2|chr16:35336003-35336064,chr16,35336003,35336064,HepG2|chr16:15071126-15071262,chr16,15071126,15071262,0,20264877
HepG2|chr16:35511418-35511565,chr16,35511418,35511565,HepG2|chr16:22553238-22553358,chr16,22553238,22553358,0,12958180
HepG2|chr16:35573267-35573303,chr16,35573267,35573303,HepG2|chr16:15189687-15189716,chr16,15189687,15189716,0,20383580
HepG2|chr16:35654371-35654427,chr16,35654371,35654427,HepG2|chr16:22553231-22553369,chr16,22553231,22553369,0,13101140
HepG2|chr16:35741744-35741779,chr16,35741744,35741779,HepG2|chr16:87893913-87893948,chr16,87893913,87893948,0,52152169
HepG2|chr16:35960486-35960636,chr16,35960486,35960636,HepG2|chr16:75497186-75497336,chr16,75497186,75497336,0,39536700
HepG2|chr16:36053587-36053625,chr16,36053587,36053625,HepG2|chr16:75274996-75275080,chr16,75274996,75275080,0,39221409
HepG2|chr16:36141603-36141708,chr16,36141603,36141708,HepG2|chr16:18937912-18938062,chr16,18937912,18938062,0,17203691
HepG2|chr16:36200779-36200929,chr16,36200779,36200929,HepG2|chr16:2389957-2390085,chr16,2389957,2390085,0,33810822
HepG2|chr16:36364525-36364585,chr16,36364525,36364585,HepG2|chr16:30763530-30763605,chr16,30763530,30763605,0,5600995
HepG2|chr16:36466790-36466825,chr16,36466790,36466825,HepG2|chr16:87895659-87895773,chr16,87895659,87895773,0,51428869
HepG2|chr16:36543846-36543976,chr16,36543846,36543976,HepG2|chr16:66634026-66634147,chr16,66634026,66634147,0,30090180
HepG2|chr16:36564892-36564942,chr16,36564892,36564942,HepG2|chr16:19124222-19124298,chr16,19124222,19124298,0,17440670
HepG2|chr16:36665277-36665375,chr16,36665277,36665375,HepG2|chr16:2957033-2957153,chr16,2957033,2957153,0,33708244
HepG2|chr16:36722864-36722921,chr16,36722864,36722921,HepG2|chr16:18937861-18937987,chr16,18937861,18937987,0,17785003
HepG2|chr16:36962289-36962351,chr16,36962289,36962351,HepG2|chr16:15071112-15071262,chr16,15071112,15071262,0,21891177
HepG2|chr16:37018609-37018705,chr16,37018609,37018705,HepG2|chr16:33950337-33950382,chr16,33950337,33950382,0,3068272
HepG2|chr16:37082673-37082776,chr16,37082673,37082776,HepG2|chr16:18937916-18938063,chr16,18937916,18938063,0,18144757
HepG2|chr16:37116886-37117036,chr16,37116886,37117036,HepG2|chr16:18937926-18937970,chr16,18937926,18937970,0,18178960
HepG2|chr16:37120632-37120694,chr16,37120632,37120694,HepG2|chr16:2183007-2183106,chr16,2183007,2183106,0,34937625
HepG2|chr16:37360671-37360812,chr16,37360671,37360812,HepG2|chr16:2590879-2590909,chr16,2590879,2590909,0,34769792
HepG2|chr16:37363554-37363701,chr16,37363554,37363701,HepG2|chr16:87900038-87900089,chr16,87900038,87900089,0,50536484
HepG2|chr16:37379903-37380039,chr16,37379903,37380039,HepG2|chr16:87895666-87895811,chr16,87895666,87895811,0,50515763
HepG2|chr16:37405391-37405539,chr16,37405391,37405539,HepG2|chr16:81031540-81031570,chr16,81031540,81031570,0,43626149
HepG2|chr16:37486011-37486088,chr16,37486011,37486088,HepG2|chr16:18938019-18938063,chr16,18938019,18938063,0,18547992
HepG2|chr16:37559756-37559906,chr16,37559756,37559906,HepG2|chr16:15073136-15073164,chr16,15073136,15073164,0,22486620
HepG2|chr16:37626779-37626915,chr16,37626779,37626915,HepG2|chr16:87895666-87895811,chr16,87895666,87895811,0,50268887
HepG2|chr16:37715308-37715458,chr16,37715308,37715458,HepG2|chr16:2589868-2590018,chr16,2589868,2590018,0,35125440
HepG2|chr16:37776978-37777040,chr16,37776978,37777040,HepG2|chr16:33950143-33950227,chr16,33950143,33950227,0,3826835
HepG2|chr16:38027995-38028064,chr16,38027995,38028064,HepG2|chr16:19124755-19124830,chr16,19124755,19124830,0,18903240
HepG2|chr16:38031227-38031355,chr16,38031227,38031355,HepG2|chr16:22553239-22553383,chr16,22553239,22553383,0,15477988
HepG2|chr16:38130471-38130587,chr16,38130471,38130587,HepG2|chr16:18492489-18492566,chr16,18492489,18492566,0,19637982
HepG2|chr16:38278317-38278378,chr16,38278317,38278378,HepG2|chr16:30763530-30763605,chr16,30763530,30763605,0,7514787
HepG2|chr16:38336365-38336515,chr16,38336365,38336515,HepG2|chr16:15069095-15069245,chr16,15069095,15069245,0,23267270
HepG2|chr16:38443506-38443609,chr16,38443506,38443609,HepG2|chr16:18937916-18938063,chr16,18937916,18938063,0,19505590
HepG2|chr16:38462042-38462067,chr16,38462042,38462067,HepG2|chr16:2732203-2732350,chr16,2732203,2732350,0,35729839
HepG2|chr16:38483305-38483455,chr16,38483305,38483455,HepG2|chr16:18937922-18937973,chr16,18937922,18937973,0,19545383
HepG2|chr16:38498598-38498633,chr16,38498598,38498633,HepG2|chr16:22553238-22553378,chr16,22553238,22553378,0,15945360
HepG2|chr16:38533380-38533496,chr16,38533380,38533496,HepG2|chr16:87893916-87893947,chr16,87893916,87893947,0,49360536
HepG2|chr16:38544061-38544149,chr16,38544061,38544149,HepG2|chr16:30963026-30963082,chr16,30963026,30963082,0,7581035
HepG2|chr16:38700205-38700302,chr16,38700205,38700302,HepG2|chr16:19122860-19122913,chr16,19122860,19122913,0,19577345
HepG2|chr16:38790452-38790564,chr16,38790452,38790564,HepG2|chr16:18935929-18936068,chr16,18935929,18936068,0,19854523
HepG2|chr16:38800509-38800639,chr16,38800509,38800639,HepG2|chr16:10835794-10835944,chr16,10835794,10835944,0,27964715
HepG2|chr16:38901071-38901176,chr16,38901071,38901176,HepG2|chr16:33950176-33950205,chr16,33950176,33950205,0,4950895
HepG2|chr16:39114609-39114649,chr16,39114609,39114649,HepG2|chr16:10835795-10835905,chr16,10835795,10835905,0,28278814
HepG2|chr16:39146992-39147055,chr16,39146992,39147055,HepG2|chr16:33950163-33950214,chr16,33950163,33950214,0,5196829
HepG2|chr16:39172089-39172153,chr16,39172089,39172153,HepG2|chr16:4512185-4512259,chr16,4512185,4512259,0,34659904
HepG2|chr16:39204733-39204759,chr16,39204733,39204759,HepG2|chr16:1873276-1873358,chr16,1873276,1873358,0,37331457
HepG2|chr16:39213046-39213120,chr16,39213046,39213120,HepG2|chr16:33950177-33950213,chr16,33950177,33950213,0,5262869
HepG2|chr16:39361837-39361884,chr16,39361837,39361884,HepG2|chr16:4512282-4512305,chr16,4512282,4512305,0,34849555
HepG2|chr16:39438687-39438743,chr16,39438687,39438743,HepG2|chr16:2957524-2957598,chr16,2957524,2957598,0,36481163
HepG2|chr16:39479036-39479117,chr16,39479036,39479117,HepG2|chr16:87893914-87893948,chr16,87893914,87893948,0,48414878
HepG2|chr16:39780544-39780644,chr16,39780544,39780644,HepG2|chr16:81029792-81029836,chr16,81029792,81029836,0,41249248
HepG2|chr16:39854862-39855012,chr16,39854862,39855012,HepG2|chr16:15071957-15072107,chr16,15071957,15072107,0,24782905
HepG2|chr16:39963729-39963807,chr16,39963729,39963807,HepG2|chr16:33950176-33950211,chr16,33950176,33950211,0,6013553
HepG2|chr16:40050035-40050163,chr16,40050035,40050163,HepG2|chr16:22553239-22553383,chr16,22553239,22553383,0,17496796
HepG2|chr16:40050932-40051001,chr16,40050932,40051001,HepG2|chr16:19124755-19124830,chr16,19124755,19124830,0,20926177
HepG2|chr16:40212100-40212184,chr16,40212100,40212184,HepG2|chr16:15071126-15071175,chr16,15071126,15071175,0,25140974
HepG2|chr16:40301234-40301367,chr16,40301234,40301367,HepG2|chr16:87899720-87899870,chr16,87899720,87899870,0,47598486
HepG2|chr16:40577778-40577880,chr16,40577778,40577880,HepG2|chr16:56900025-56900175,chr16,56900025,56900175,0,16322247
HepG2|chr16:40628045-40628176,chr16,40628045,40628176,HepG2|chr16:70284035-70284127,chr16,70284035,70284127,0,29655990
HepG2|chr16:40736580-40736730,chr16,40736580,40736730,HepG2|chr16:87899823-87899949,chr16,87899823,87899949,0,47163243
HepG2|chr16:40915715-40915817,chr16,40915715,40915817,HepG2|chr16:33950176-33950218,chr16,33950176,33950218,0,6965539
HepG2|chr16:41088964-41089035,chr16,41088964,41089035,HepG2|chr16:85641560-85641641,chr16,85641560,85641641,0,44552596
HepG2|chr16:41142832-41142933,chr16,41142832,41142933,HepG2|chr16:81029792-81029836,chr16,81029792,81029836,0,39886960
HepG2|chr16:41261479-41261629,chr16,41261479,41261629,HepG2|chr16:15073141-15073291,chr16,15073141,15073291,0,26188338
HepG2|chr16:41382221-41382284,chr16,41382221,41382284,HepG2|chr16:33950163-33950214,chr16,33950163,33950214,0,7432058
HepG2|chr16:41383290-41383332,chr16,41383290,41383332,HepG2|chr16:85644407-85644492,chr16,85644407,85644492,0,44261117
HepG2|chr16:41545328-41545353,chr16,41545328,41545353,HepG2|chr16:30963026-30963082,chr16,30963026,30963082,0,10582302
HepG2|chr16:41683189-41683339,chr16,41683189,41683339,HepG2|chr16:87897768-87897915,chr16,87897768,87897915,0,46214579
HepG2|chr16:41694380-41694473,chr16,41694380,41694473,HepG2|chr16:18492508-18492581,chr16,18492508,18492581,0,23201872
HepG2|chr16:41816285-41816390,chr16,41816285,41816390,HepG2|chr16:15071085-15071151,chr16,15071085,15071151,0,26745200
HepG2|chr16:41859478-41859599,chr16,41859478,41859599,HepG2|chr16:70284114-70284152,chr16,70284114,70284152,0,28424636
HepG2|chr16:42008387-42008476,chr16,42008387,42008476,HepG2|chr16:33950163-33950218,chr16,33950163,33950218,0,8058224
HepG2|chr16:42153461-42153568,chr16,42153461,42153568,HepG2|chr16:2182472-2182622,chr16,2182472,2182622,0,39970989
HepG2|chr16:42453390-42453540,chr16,42453390,42453540,HepG2|chr16:2389957-2390085,chr16,2389957,2390085,0,40063433
HepG2|chr16:42466990-42467097,chr16,42466990,42467097,HepG2|chr16:33950337-33950379,chr16,33950337,33950379,0,8516653
HepG2|chr16:42501550-42501651,chr16,42501550,42501651,HepG2|chr16:57022100-57022137,chr16,57022100,57022137,0,14520550
HepG2|chr16:42696459-42696609,chr16,42696459,42696609,HepG2|chr16:2591235-2591385,chr16,2591235,2591385,0,40105224
HepG2|chr16:42697752-42697810,chr16,42697752,42697810,HepG2|chr16:15073146-15073155,chr16,15073146,15073155,0,27624606
HepG2|chr16:42705298-42705448,chr16,42705298,42705448,HepG2|chr16:15071944-15072094,chr16,15071944,15072094,0,27633354
HepG2|chr16:42764999-42765149,chr16,42764999,42765149,HepG2|chr16:15069122-15069171,chr16,15069122,15069171,0,27695877
HepG2|chr16:42783759-42783791,chr16,42783759,42783791,HepG2|chr16:15074180-15074283,chr16,15074180,15074283,0,27709579
HepG2|chr16:42789321-42789471,chr16,42789321,42789471,HepG2|chr16:15073580-15073727,chr16,15073580,15073727,0,27715741
HepG2|chr16:42863905-42863956,chr16,42863905,42863956,HepG2|chr16:4237007-4237106,chr16,4237007,4237106,0,38626898
HepG2|chr16:42902267-42902318,chr16,42902267,42902318,HepG2|chr16:33950338-33950416,chr16,33950338,33950416,0,8951929
HepG2|chr16:42908819-42908907,chr16,42908819,42908907,HepG2|chr16:85644584-85644651,chr16,85644584,85644651,0,42735765
HepG2|chr16:42911564-42911714,chr16,42911564,42911714,HepG2|chr16:2590047-2590192,chr16,2590047,2590192,0,40321517
HepG2|chr16:42958500-42958618,chr16,42958500,42958618,HepG2|chr16:87899716-87899866,chr16,87899716,87899866,0,44941216
HepG2|chr16:43047567-43047649,chr16,43047567,43047649,HepG2|chr16:71845090-71845158,chr16,71845090,71845158,0,28797523
HepG2|chr16:43195728-43195793,chr16,43195728,43195793,HepG2|chr16:87900371-87900521,chr16,87900371,87900521,0,44704643
HepG2|chr16:43200293-43200443,chr16,43200293,43200443,HepG2|chr16:2590052-2590202,chr16,2590052,2590202,0,40610241
HepG2|chr16:43366982-43367106,chr16,43366982,43367106,HepG2|chr16:2601629-2601677,chr16,2601629,2601677,0,40765353
HepG2|chr16:43434783-43434825,chr16,43434783,43434825,HepG2|chr16:88631910-88632018,chr16,88631910,88632018,0,45197127
HepG2|chr16:43465028-43465176,chr16,43465028,43465176,HepG2|chr16:81031540-81031570,chr16,81031540,81031570,0,37566512
HepG2|chr16:43483237-43483277,chr16,43483237,43483277,HepG2|chr16:15073139-15073289,chr16,15073139,15073289,0,28410098
HepG2|chr16:43523294-43523344,chr16,43523294,43523344,HepG2|chr16:15071133-15071265,chr16,15071133,15071265,0,28452161
HepG2|chr16:43574745-43574895,chr16,43574745,43574895,HepG2|chr16:2589854-2590001,chr16,2589854,2590001,0,40984891
HepG2|chr16:43619007-43619044,chr16,43619007,43619044,HepG2|chr16:69222722-69222870,chr16,69222722,69222870,0,25603715
HepG2|chr16:43750209-43750289,chr16,43750209,43750289,HepG2|chr16:15009697-15009731,chr16,15009697,15009731,0,28740512
HepG2|chr16:43829752-43829902,chr16,43829752,43829902,HepG2|chr16:15187589-15187739,chr16,15187589,15187739,0,28642163
HepG2|chr16:43842459-43842604,chr16,43842459,43842604,HepG2|chr16:18937922-18937974,chr16,18937922,18937974,0,24904537
HepG2|chr16:44073386-44073536,chr16,44073386,44073536,HepG2|chr16:16317399-16317548,chr16,16317399,16317548,0,27755987
HepG2|chr16:44100801-44100874,chr16,44100801,44100874,HepG2|chr16:2590840-2590990,chr16,2590840,2590990,0,41509961
HepG2|chr16:44111114-44111262,chr16,44111114,44111262,HepG2|chr16:15189687-15189716,chr16,15189687,15189716,0,28921427
HepG2|chr16:44165203-44165302,chr16,44165203,44165302,HepG2|chr16:18937922-18937973,chr16,18937922,18937973,0,25227281
HepG2|chr16:44166180-44166287,chr16,44166180,44166287,HepG2|chr16:2957632-2957675,chr16,2957632,2957675,0,41208548
HepG2|chr16:44171891-44171971,chr16,44171891,44171971,HepG2|chr16:87894260-87894290,chr16,87894260,87894290,0,43722369
HepG2|chr16:44270385-44270532,chr16,44270385,44270532,HepG2|chr16:87899017-87899167,chr16,87899017,87899167,0,43628632
HepG2|chr16:44328927-44328977,chr16,44328927,44328977,HepG2|chr16:2732140-2732235,chr16,2732140,2732235,0,41596787
HepG2|chr16:44369458-44369608,chr16,44369458,44369608,HepG2|chr16:22553168-22553279,chr16,22553168,22553279,0,21816290
HepG2|chr16:44386233-44386371,chr16,44386233,44386371,HepG2|chr16:2181698-2181821,chr16,2181698,2181821,0,42204535
HepG2|chr16:44433236-44433324,chr16,44433236,44433324,HepG2|chr16:33950163-33950218,chr16,33950163,33950218,0,10483073
HepG2|chr16:44441017-44441138,chr16,44441017,44441138,HepG2|chr16:18937929-18938063,chr16,18937929,18938063,0,25503088
HepG2|chr16:44504837-44504959,chr16,44504837,44504959,HepG2|chr16:75497196-75497250,chr16,75497196,75497250,0,30992359
HepG2|chr16:44529082-44529140,chr16,44529082,44529140,HepG2|chr16:15073146-15073155,chr16,15073146,15073155,0,29455936
HepG2|chr16:44626989-44627075,chr16,44626989,44627075,HepG2|chr16:31126625-31126669,chr16,31126625,31126669,0,13500364
HepG2|chr16:44665286-44665392,chr16,44665286,44665392,HepG2|chr16:70559075-70559103,chr16,70559075,70559103,0,25893789
HepG2|chr16:44728016-44728165,chr16,44728016,44728165,HepG2|chr16:87902007-87902157,chr16,87902007,87902157,0,43173991
HepG2|chr16:44795926-44796076,chr16,44795926,44796076,HepG2|chr16:18937922-18937973,chr16,18937922,18937973,0,25858004
HepG2|chr16:44819098-44819244,chr16,44819098,44819244,HepG2|chr16:15187811-15187959,chr16,15187811,15187959,0,29631287
HepG2|chr16:44830476-44830626,chr16,44830476,44830626,HepG2|chr16:87902237-87902386,chr16,87902237,87902386,0,43071761
HepG2|chr16:44851773-44851895,chr16,44851773,44851895,HepG2|chr16:2725992-2726046,chr16,2725992,2726046,0,42125781
HepG2|chr16:44905868-44905912,chr16,44905868,44905912,HepG2|chr16:10835795-10835905,chr16,10835795,10835905,0,34070073
HepG2|chr16:45044918-45045011,chr16,45044918,45045011,HepG2|chr16:15071112-15071262,chr16,15071112,15071262,0,29973806
HepG2|chr16:45150006-45150067,chr16,45150006,45150067,HepG2|chr16:89693524-89693613,chr16,89693524,89693613,0,44543518
HepG2|chr16:45164003-45164020,chr16,45164003,45164020,HepG2|chr16:11832518-11832613,chr16,11832518,11832613,0,33331485
HepG2|chr16:45196118-45196268,chr16,45196118,45196268,HepG2|chr16:2590053-2590203,chr16,2590053,2590203,0,42606065
HepG2|chr16:45284712-45284799,chr16,45284712,45284799,HepG2|chr16:2957414-2957525,chr16,2957414,2957525,0,42327298
HepG2|chr16:45306247-45306397,chr16,45306247,45306397,HepG2|chr16:11886267-11886305,chr16,11886267,11886305,0,33419980
HepG2|chr16:45432550-45432700,chr16,45432550,45432700,HepG2|chr16:2590036-2590186,chr16,2590036,2590186,0,42842514
HepG2|chr16:45491822-45491883,chr16,45491822,45491883,HepG2|chr16:15008121-15008255,chr16,15008121,15008255,0,30483701
HepG2|chr16:45643128-45643171,chr16,45643128,45643171,HepG2|chr16:2957203-2957323,chr16,2957203,2957323,0,42685925
HepG2|chr16:45656482-45656574,chr16,45656482,45656574,HepG2|chr16:2733051-2733200,chr16,2733051,2733200,0,42923431
HepG2|chr16:45700527-45700622,chr16,45700527,45700622,HepG2|chr16:33950176-33950211,chr16,33950176,33950211,0,11750351
HepG2|chr16:45718604-45718735,chr16,45718604,45718735,HepG2|chr16:18937922-18937976,chr16,18937922,18937976,0,26780682
HepG2|chr16:46634862-46634987,chr16,46634862,46634987,HepG2|chr16:15071129-15071264,chr16,15071129,15071264,0,31563733
HepG2|chr16:46660565-46660625,chr16,46660565,46660625,HepG2|chr16:75255733-75255804,chr16,75255733,75255804,0,28595168
HepG2|chr16:46690281-46690350,chr16,46690281,46690350,HepG2|chr16:4512185-4512259,chr16,4512185,4512259,0,42178096
HepG2|chr16:46806321-46806380,chr16,46806321,46806380,HepG2|chr16:4326635-4326761,chr16,4326635,4326761,0,42479686
HepG2|chr16:46835723-46835839,chr16,46835723,46835839,HepG2|chr16:11892422-11892523,chr16,11892422,11892523,0,34943301
HepG2|chr16:46926835-46926944,chr16,46926835,46926944,HepG2|chr16:75497163-75497204,chr16,75497163,75497204,0,28570328
HepG2|chr16:46940837-46940869,chr16,46940837,46940869,HepG2|chr16:15074180-15074283,chr16,15074180,15074283,0,31866657
HepG2|chr16:47097067-47097216,chr16,47097067,47097216,HepG2|chr16:2734021-2734167,chr16,2734021,2734167,0,44363046
HepG2|chr16:47123943-47124093,chr16,47123943,47124093,HepG2|chr16:15187532-15187679,chr16,15187532,15187679,0,31936411
HepG2|chr16:47505254-47505277,chr16,47505254,47505277,HepG2|chr16:10834191-10834309,chr16,10834191,10834309,0,36671063
HepG2|chr16:47600138-47600215,chr16,47600138,47600215,HepG2|chr16:15073032-15073182,chr16,15073032,15073182,0,32527106
HepG2|chr16:47824406-47824551,chr16,47824406,47824551,HepG2|chr16:11890539-11890662,chr16,11890539,11890662,0,35933867
HepG2|chr16:47898559-47898639,chr16,47898559,47898639,HepG2|chr16:10835795-10835862,chr16,10835795,10835862,0,37062764
HepG2|chr16:48062959-48063037,chr16,48062959,48063037,HepG2|chr16:10835795-10835904,chr16,10835795,10835904,0,37227164
HepG2|chr16:48126838-48126988,chr16,48126838,48126988,HepG2|chr16:15069087-15069237,chr16,15069087,15069237,0,33057751
HepG2|chr16:48244229-48244320,chr16,48244229,48244320,HepG2|chr16:33950163-33950218,chr16,33950163,33950218,0,14294066
HepG2|chr16:48376646-48376789,chr16,48376646,48376789,HepG2|chr16:15073242-15073389,chr16,15073242,15073389,0,33303404
HepG2|chr16:48410281-48410353,chr16,48410281,48410353,HepG2|chr16:87967905-87967975,chr16,87967905,87967975,0,39557624
HepG2|chr16:48452926-48453076,chr16,48452926,48453076,HepG2|chr16:2589851-2590001,chr16,2589851,2590001,0,45863075
HepG2|chr16:48478051-48478078,chr16,48478051,48478078,HepG2|chr16:11890539-11890662,chr16,11890539,11890662,0,36587512
HepG2|chr16:48577282-48577411,chr16,48577282,48577411,HepG2|chr16:15189687-15189711,chr16,15189687,15189711,0,33387595
HepG2|chr16:48627846-48627915,chr16,48627846,48627915,HepG2|chr16:85641560-85641641,chr16,85641560,85641641,0,37013714
HepG2|chr16:48656326-48656447,chr16,48656326,48656447,HepG2|chr16:70284114-70284152,chr16,70284114,70284152,0,21627788
HepG2|chr16:48729007-48729093,chr16,48729007,48729093,HepG2|chr16:31126625-31126669,chr16,31126625,31126669,0,17602382
HepG2|chr16:49081136-49081168,chr16,49081136,49081168,HepG2|chr16:87896930-87897080,chr16,87896930,87897080,0,38815794
HepG2|chr16:49097666-49097815,chr16,49097666,49097815,HepG2|chr16:87902204-87902353,chr16,87902204,87902353,0,38804538
HepG2|chr16:49218168-49218318,chr16,49218168,49218318,HepG2|chr16:2590053-2590203,chr16,2590053,2590203,0,46628115
HepG2|chr16:49539740-49539890,chr16,49539740,49539890,HepG2|chr16:15072178-15072328,chr16,15072178,15072328,0,34467562
HepG2|chr16:49685307-49685423,chr16,49685307,49685423,HepG2|chr16:87893916-87893947,chr16,87893916,87893947,0,38208609
HepG2|chr16:49705907-49705943,chr16,49705907,49705943,HepG2|chr16:75274996-75275080,chr16,75274996,75275080,0,25569089
HepG2|chr16:49831067-49831145,chr16,49831067,49831145,HepG2|chr16:2590054-2590201,chr16,2590054,2590201,0,47241013
HepG2|chr16:49902985-49903058,chr16,49902985,49903058,HepG2|chr16:2590840-2590990,chr16,2590840,2590990,0,47312145
HepG2|chr16:49988019-49988049,chr16,49988019,49988049,HepG2|chr16:28836231-28836378,chr16,28836231,28836378,0,21151788
HepG2|chr16:50074206-50074332,chr16,50074206,50074332,HepG2|chr16:30759404-30759436,chr16,30759404,30759436,0,19314802
HepG2|chr16:50120827-50120977,chr16,50120827,50120977,HepG2|chr16:2590052-2590202,chr16,2590052,2590202,0,47530775
HepG2|chr16:50246376-50246478,chr16,50246376,50246478,HepG2|chr16:56900025-56900175,chr16,56900025,56900175,0,6653649
HepG2|chr16:50439260-50439410,chr16,50439260,50439410,HepG2|chr16:2591099-2591249,chr16,2591099,2591249,0,47848161
HepG2|chr16:50779794-50779912,chr16,50779794,50779912,HepG2|chr16:30759404-30759436,chr16,30759404,30759436,0,20020390
HepG2|chr16:50956638-50956735,chr16,50956638,50956735,HepG2|chr16:19122860-19122913,chr16,19122860,19122913,0,31833778
HepG2|chr16:50978356-50978433,chr16,50978356,50978433,HepG2|chr16:33950337-33950379,chr16,33950337,33950379,0,17028019
HepG2|chr16:51087316-51087376,chr16,51087316,51087376,HepG2|chr16:2733865-2733955,chr16,2733865,2733955,0,48353451
HepG2|chr16:51096710-51096817,chr16,51096710,51096817,HepG2|chr16:2182472-2182622,chr16,2182472,2182622,0,48914238
HepG2|chr16:51127835-51127915,chr16,51127835,51127915,HepG2|chr16:33950176-33950207,chr16,33950176,33950207,0,17177659
HepG2|chr16:51288374-51288430,chr16,51288374,51288430,HepG2|chr16:22448157-22448219,chr16,22448157,22448219,0,28840217
HepG2|chr16:51326117-51326188,chr16,51326117,51326188,HepG2|chr16:2182602-2182752,chr16,2182602,2182752,0,49143515
HepG2|chr16:51488081-51488218,chr16,51488081,51488218,HepG2|chr16:22553211-22553265,chr16,22553211,22553265,0,28934870
HepG2|chr16:51822247-51822396,chr16,51822247,51822396,HepG2|chr16:87892764-87892860,chr16,87892764,87892860,0,36070517
HepG2|chr16:51948543-51948663,chr16,51948543,51948663,HepG2|chr16:2933994-2934070,chr16,2933994,2934070,0,49014549
HepG2|chr16:52352793-52352844,chr16,52352793,52352844,HepG2|chr16:33950133-33950227,chr16,33950133,33950227,0,18402660
HepG2|chr16:52372953-52373103,chr16,52372953,52373103,HepG2|chr16:15069095-15069236,chr16,15069095,15069236,0,37303858
HepG2|chr16:52391688-52391838,chr16,52391688,52391838,HepG2|chr16:87902009-87902159,chr16,87902009,87902159,0,35510321
HepG2|chr16:52501444-52501500,chr16,52501444,52501500,HepG2|chr16:71845090-71845157,chr16,71845090,71845157,0,19343646
HepG2|chr16:52603273-52603411,chr16,52603273,52603411,HepG2|chr16:15071126-15071258,chr16,15071126,15071258,0,37532147
HepG2|chr16:52603668-52603769,chr16,52603668,52603769,HepG2|chr16:57022100-57022137,chr16,57022100,57022137,0,4418432
HepG2|chr16:52630642-52630773,chr16,52630642,52630773,HepG2|chr16:70284035-70284127,chr16,70284035,70284127,0,17653393
HepG2|chr16:52654965-52655027,chr16,52654965,52655027,HepG2|chr16:15071128-15071249,chr16,15071128,15071249,0,37583837
HepG2|chr16:52688971-52689117,chr16,52688971,52689117,HepG2|chr16:15187811-15187959,chr16,15187811,15187959,0,37501160
HepG2|chr16:52750834-52750964,chr16,52750834,52750964,HepG2|chr16:18937924-18938063,chr16,18937924,18938063,0,33812910
HepG2|chr16:52775637-52775787,chr16,52775637,52775787,HepG2|chr16:15069140-15069290,chr16,15069140,15069290,0,37706497
HepG2|chr16:52850586-52850678,chr16,52850586,52850678,HepG2|chr16:2183000-2183135,chr16,2183000,2183135,0,50667586
HepG2|chr16:52876472-52876622,chr16,52876472,52876622,HepG2|chr16:15071118-15071264,chr16,15071118,15071264,0,37805354
HepG2|chr16:52935900-52936050,chr16,52935900,52936050,HepG2|chr16:2590050-2590200,chr16,2590050,2590200,0,50345850
HepG2|chr16:53025823-53025858,chr16,53025823,53025858,HepG2|chr16:87893913-87893948,chr16,87893913,87893948,0,34868090
HepG2|chr16:53131702-53131849,chr16,53131702,53131849,HepG2|chr16:87899017-87899167,chr16,87899017,87899167,0,34767315
HepG2|chr16:53189081-53189193,chr16,53189081,53189193,HepG2|chr16:19122827-19122862,chr16,19122827,19122862,0,34066254
HepG2|chr16:53242468-53242613,chr16,53242468,53242613,HepG2|chr16:11890539-11890662,chr16,11890539,11890662,0,41351929
HepG2|chr16:53309759-53309881,chr16,53309759,53309881,HepG2|chr16:75497196-75497250,chr16,75497196,75497250,0,22187437
HepG2|chr16:53456654-53456711,chr16,53456654,53456711,HepG2|chr16:10835795-10835933,chr16,10835795,10835933,0,42620859
HepG2|chr16:53720011-53720161,chr16,53720011,53720161,HepG2|chr16:2603313-2603460,chr16,2603313,2603460,0,51116698
HepG2|chr16:53773511-53773547,chr16,53773511,53773547,HepG2|chr16:15189687-15189716,chr16,15189687,15189716,0,38583824
HepG2|chr16:53821133-53821241,chr16,53821133,53821241,HepG2|chr16:19124281-19124431,chr16,19124281,19124431,0,34696852
HepG2|chr16:53949529-53949678,chr16,53949529,53949678,HepG2|chr16:2590073-2590198,chr16,2590073,2590198,0,51359456
HepG2|chr16:54035485-54035550,chr16,54035485,54035550,HepG2|chr16:10835810-10835960,chr16,10835810,10835960,0,43199675
HepG2|chr16:54196165-54196200,chr16,54196165,54196200,HepG2|chr16:22553238-22553378,chr16,22553238,22553378,0,31642927
HepG2|chr16:54226591-54226741,chr16,54226591,54226741,HepG2|chr16:75497286-75497436,chr16,75497286,75497436,0,21270695
HepG2|chr16:54292450-54292501,chr16,54292450,54292501,HepG2|chr16:21454614-21454713,chr16,21454614,21454713,0,32837836
HepG2|chr16:54361444-54361594,chr16,54361444,54361594,HepG2|chr16:15071127-15071264,chr16,15071127,15071264,0,39290317
HepG2|chr16:54363162-54363279,chr16,54363162,54363279,HepG2|chr16:2183013-2183113,chr16,2183013,2183113,0,52180149
HepG2|chr16:54403452-54403600,chr16,54403452,54403600,HepG2|chr16:2957295-2957334,chr16,2957295,2957334,0,51446157
HepG2|chr16:54508050-54508200,chr16,54508050,54508200,HepG2|chr16:15072179-15072328,chr16,15072179,15072328,0,39435871
HepG2|chr16:54570980-54571086,chr16,54570980,54571086,HepG2|chr16:70559075-70559103,chr16,70559075,70559103,0,15988095
HepG2|chr16:54826704-54826781,chr16,54826704,54826781,HepG2|chr16:15071126-15071267,chr16,15071126,15071267,0,39755578
HepG2|chr16:54842279-54842429,chr16,54842279,54842429,HepG2|chr16:15071118-15071264,chr16,15071118,15071264,0,39771161
HepG2|chr16:54922991-54923048,chr16,54922991,54923048,HepG2|chr16:87893916-87893947,chr16,87893916,87893947,0,32970925
HepG2|chr16:54970048-54970164,chr16,54970048,54970164,HepG2|chr16:18492489-18492566,chr16,18492489,18492566,0,36477559
HepG2|chr16:55033219-55033322,chr16,55033219,55033322,HepG2|chr16:33950176-33950208,chr16,33950176,33950208,0,21083043
HepG2|chr16:55121482-55121630,chr16,55121482,55121630,HepG2|chr16:2957295-2957334,chr16,2957295,2957334,0,52164187
HepG2|chr16:55142163-55142217,chr16,55142163,55142217,HepG2|chr16:15071116-15071265,chr16,15071116,15071265,0,40071047
HepG2|chr16:55204528-55204677,chr16,55204528,55204677,HepG2|chr16:15071944-15072094,chr16,15071944,15072094,0,40132584
HepG2|chr16:55413355-55413479,chr16,55413355,55413479,HepG2|chr16:2601629-2601677,chr16,2601629,2601677,0,52811726
HepG2|chr16:55509414-55509517,chr16,55509414,55509517,HepG2|chr16:22553220-22553260,chr16,22553220,22553260,0,32956194
HepG2|chr16:55524828-55524867,chr16,55524828,55524867,HepG2|chr16:15073072-15073146,chr16,15073072,15073146,0,40451756
HepG2|chr16:55568805-55568955,chr16,55568805,55568955,HepG2|chr16:87893793-87893890,chr16,87893793,87893890,0,32324988
HepG2|chr16:55582099-55582156,chr16,55582099,55582156,HepG2|chr16:87893916-87893947,chr16,87893916,87893947,0,32311817
HepG2|chr16:55686354-55686439,chr16,55686354,55686439,HepG2|chr16:22448157-22448286,chr16,22448157,22448286,0,33238197
HepG2|chr16:55689799-55689949,chr16,55689799,55689949,HepG2|chr16:2590048-2590198,chr16,2590048,2590198,0,53099751
HepG2|chr16:55826541-55826624,chr16,55826541,55826624,HepG2|chr16:75281029-75281096,chr16,75281029,75281096,0,19454488
HepG2|chr16:55935513-55935535,chr16,55935513,55935535,HepG2|chr16:2732140-2732196,chr16,2732140,2732196,0,53203373
HepG2|chr16:55944084-55944132,chr16,55944084,55944132,HepG2|chr16:30908977-30909018,chr16,30908977,30909018,0,25035107
HepG2|chr16:55947778-55947911,chr16,55947778,55947911,HepG2|chr16:87899720-87899870,chr16,87899720,87899870,0,31951942
HepG2|chr16:56032197-56032304,chr16,56032197,56032304,HepG2|chr16:56899894-56900040,chr16,56899894,56900040,0,867697
HepG2|chr16:56062802-56062919,chr16,56062802,56062919,HepG2|chr16:2183013-2183113,chr16,2183013,2183113,0,53879789
HepG2|chr16:56088023-56088173,chr16,56088023,56088173,HepG2|chr16:15073164-15073298,chr16,15073164,15073298,0,41014859
HepG2|chr16:56099537-56099568,chr16,56099537,56099568,HepG2|chr16:31121861-31121980,chr16,31121861,31121980,0,24977676
HepG2|chr16:56132671-56132817,chr16,56132671,56132817,HepG2|chr16:75497162-75497311,chr16,75497162,75497311,0,19364491
HepG2|chr16:56133237-56133347,chr16,56133237,56133347,HepG2|chr16:18937915-18938064,chr16,18937915,18938064,0,37195322
HepG2|chr16:56147710-56147860,chr16,56147710,56147860,HepG2|chr16:2591099-2591249,chr16,2591099,2591249,0,53556611
HepG2|chr16:56150851-56150997,chr16,56150851,56150997,HepG2|chr16:15071128-15071262,chr16,15071128,15071262,0,41079723
HepG2|chr16:56180327-56180387,chr16,56180327,56180387,HepG2|chr16:18938019-18938063,chr16,18938019,18938063,0,37242308
HepG2|chr16:56271559-56271601,chr16,56271559,56271601,HepG2|chr16:89626637-89626787,chr16,89626637,89626787,0,33355078
HepG2|chr16:56346285-56346365,chr16,56346285,56346365,HepG2|chr16:15009697-15009731,chr16,15009697,15009731,0,41336588
HepG2|chr16:56438536-56438575,chr16,56438536,56438575,HepG2|chr16:15073072-15073146,chr16,15073072,15073146,0,41365464
HepG2|chr16:56538724-56538775,chr16,56538724,56538775,HepG2|chr16:21454614-21454713,chr16,21454614,21454713,0,35084110
HepG2|chr16:56604694-56604844,chr16,56604694,56604844,HepG2|chr16:87900178-87900328,chr16,87900178,87900328,0,31295484
HepG2|chr16:56649265-56649368,chr16,56649265,56649368,HepG2|chr16:33950176-33950208,chr16,33950176,33950208,0,22699089
HepG2|chr16:56705988-56706138,chr16,56705988,56706138,HepG2|chr16:87902290-87902440,chr16,87902290,87902440,0,31196302
HepG2|chr16:56783433-56783579,chr16,56783433,56783579,HepG2|chr16:85647510-85647660,chr16,85647510,85647660,0,28864077
HepG2|chr16:56795580-56795644,chr16,56795580,56795644,HepG2|chr16:29830398-29830464,chr16,29830398,29830464,0,26965182
HepG2|chr16:56814472-56814617,chr16,56814472,56814617,HepG2|chr16:2590056-2590201,chr16,2590056,2590201,0,54224416
HepG2|chr16:57010564-57010641,chr16,57010564,57010641,HepG2|chr16:3032807-3032880,chr16,3032807,3032880,0,53977757
HepG2|chr16:57036745-57036771,chr16,57036745,57036771,HepG2|chr16:11678998-11679104,chr16,11678998,11679104,0,45357747
HepG2|chr16:57050523-57050660,chr16,57050523,57050660,HepG2|chr16:71845090-71845158,chr16,71845090,71845158,0,14794567
HepG2|chr16:57058868-57058958,chr16,57058868,57058958,HepG2|chr16:33950163-33950222,chr16,33950163,33950222,0,23108705
HepG2|chr16:57169100-57169225,chr16,57169100,57169225,HepG2|chr16:87899729-87899879,chr16,87899729,87899879,0,30730629
HepG2|chr16:57257643-57257793,chr16,57257643,57257793,HepG2|chr16:87899717-87899863,chr16,87899717,87899863,0,30642074
HepG2|chr16:57305374-57305482,chr16,57305374,57305482,HepG2|chr16:33950337-33950371,chr16,33950337,33950371,0,23355037
HepG2|chr16:57418958-57419108,chr16,57418958,57419108,HepG2|chr16:15071971-15072121,chr16,15071971,15072121,0,42346987
HepG2|chr16:57532057-57532099,chr16,57532057,57532099,HepG2|chr16:15069413-15069562,chr16,15069413,15069562,0,42462644
HepG2|chr16:57565375-57565504,chr16,57565375,57565504,HepG2|chr16:66634026-66634147,chr16,66634026,66634147,0,9068651
HepG2|chr16:57565747-57565791,chr16,57565747,57565791,HepG2|chr16:10835795-10835905,chr16,10835795,10835905,0,46729952
HepG2|chr16:57570472-57570580,chr16,57570472,57570580,HepG2|chr16:18937861-18937988,chr16,18937861,18937988,0,38632611
HepG2|chr16:57625672-57625701,chr16,57625672,57625701,HepG2|chr16:81029386-81029533,chr16,81029386,81029533,0,23403714
HepG2|chr16:57679868-57680018,chr16,57679868,57680018,HepG2|chr16:87897768-87897915,chr16,87897768,87897915,0,30217900
HepG2|chr16:57751456-57751601,chr16,57751456,57751601,HepG2|chr16:85641140-85641176,chr16,85641140,85641176,0,27889684
HepG2|chr16:57834445-57834508,chr16,57834445,57834508,HepG2|chr16:89693524-89693611,chr16,89693524,89693611,0,31859079
HepG2|chr16:57996275-57996379,chr16,57996275,57996379,HepG2|chr16:22448198-22448227,chr16,22448198,22448227,0,35548077
HepG2|chr16:58045341-58045491,chr16,58045341,58045491,HepG2|chr16:18937861-18937988,chr16,18937861,18937988,0,39107480
HepG2|chr16:58144046-58144189,chr16,58144046,58144189,HepG2|chr16:15073242-15073389,chr16,15073242,15073389,0,43070804
HepG2|chr16:58474905-58475052,chr16,58474905,58475052,HepG2|chr16:2589804-2589882,chr16,2589804,2589882,0,55885101
HepG2|chr16:58576540-58576643,chr16,58576540,58576643,HepG2|chr16:85641310-85641356,chr16,85641310,85641356,0,27064770
HepG2|chr16:58661538-58661688,chr16,58661538,58661688,HepG2|chr16:2589832-2589982,chr16,2589832,2589982,0,56071706
HepG2|chr16:58673549-58673699,chr16,58673549,58673699,HepG2|chr16:2590051-2590201,chr16,2590051,2590201,0,56083498
HepG2|chr16:58684200-58684235,chr16,58684200,58684235,HepG2|chr16:18937924-18938063,chr16,18937924,18938063,0,39746276
HepG2|chr16:58696637-58696787,chr16,58696637,58696787,HepG2|chr16:87899823-87899949,chr16,87899823,87899949,0,29203186
HepG2|chr16:58912383-58912514,chr16,58912383,58912514,HepG2|chr16:10835795-10835862,chr16,10835795,10835862,0,48076588
HepG2|chr16:59111551-59111644,chr16,59111551,59111644,HepG2|chr16:18937927-18938063,chr16,18937927,18938063,0,40173624
HepG2|chr16:59257191-59257321,chr16,59257191,59257321,HepG2|chr16:87901411-87901537,chr16,87901411,87901537,0,28644220
HepG2|chr16:59298365-59298515,chr16,59298365,59298515,HepG2|chr16:2589739-2589889,chr16,2589739,2589889,0,56708626
HepG2|chr16:59340261-59340291,chr16,59340261,59340291,HepG2|chr16:28836231-28836378,chr16,28836231,28836378,0,30504030
HepG2|chr16:59454541-59454671,chr16,59454541,59454671,HepG2|chr16:2183074-2183120,chr16,2183074,2183120,0,57271467
HepG2|chr16:59458742-59458770,chr16,59458742,59458770,HepG2|chr16:71843772-71843810,chr16,71843772,71843810,0,12385030
HepG2|chr16:59504262-59504343,chr16,59504262,59504343,HepG2|chr16:87893914-87893948,chr16,87893914,87893948,0,28389652
HepG2|chr16:59571494-59571644,chr16,59571494,59571644,HepG2|chr16:15071116-15071154,chr16,15071116,15071154,0,44500378
HepG2|chr16:59655695-59655755,chr16,59655695,59655755,HepG2|chr16:15008119-15008264,chr16,15008119,15008264,0,44647576
HepG2|chr16:59661932-59662082,chr16,59661932,59662082,HepG2|chr16:15069104-15069252,chr16,15069104,15069252,0,44592828
HepG2|chr16:59835441-59835537,chr16,59835441,59835537,HepG2|chr16:33950337-33950382,chr16,33950337,33950382,0,25885104
HepG2|chr16:59836828-59836909,chr16,59836828,59836909,HepG2|chr16:8957891-8957960,chr16,8957891,8957960,0,50878937
HepG2|chr16:59894675-59894825,chr16,59894675,59894825,HepG2|chr16:2589851-2590000,chr16,2589851,2590000,0,57304824
HepG2|chr16:59922287-59922345,chr16,59922287,59922345,HepG2|chr16:30763617-30763767,chr16,30763617,30763767,0,29158670
HepG2|chr16:59986146-59986193,chr16,59986146,59986193,HepG2|chr16:4512282-4512305,chr16,4512282,4512305,0,55473864
HepG2|chr16:59993022-59993151,chr16,59993022,59993151,HepG2|chr16:66634026-66634147,chr16,66634026,66634147,0,6641004
HepG2|chr16:60046341-60046450,chr16,60046341,60046450,HepG2|chr16:89626851-89626882,chr16,89626851,89626882,0,29580510
HepG2|chr16:60089863-60090013,chr16,60089863,60090013,HepG2|chr16:87896061-87896156,chr16,87896061,87896156,0,27806198
HepG2|chr16:60321082-60321158,chr16,60321082,60321158,HepG2|chr16:56900034-56900142,chr16,56900034,56900142,0,3421048
HepG2|chr16:60460800-60460940,chr16,60460800,60460940,HepG2|chr16:87899720-87899870,chr16,87899720,87899870,0,27438920
HepG2|chr16:60517283-60517348,chr16,60517283,60517348,HepG2|chr16:87900371-87900521,chr16,87900371,87900521,0,27383088
HepG2|chr16:60521279-60521353,chr16,60521279,60521353,HepG2|chr16:2933994-2934070,chr16,2933994,2934070,0,57587285
HepG2|chr16:60762262-60762292,chr16,60762262,60762292,HepG2|chr16:15073139-15073289,chr16,15073139,15073289,0,45689123
HepG2|chr16:60801509-60801649,chr16,60801509,60801649,HepG2|chr16:87899720-87899870,chr16,87899720,87899870,0,27098211
HepG2|chr16:60919891-60919953,chr16,60919891,60919953,HepG2|chr16:15071112-15071262,chr16,15071112,15071262,0,45848779
HepG2|chr16:60992203-60992353,chr16,60992203,60992353,HepG2|chr16:2734020-2734167,chr16,2734020,2734167,0,58258183
HepG2|chr16:61096269-61096419,chr16,61096269,61096419,HepG2|chr16:18935933-18936076,chr16,18935933,18936076,0,42160336
HepG2|chr16:61101035-61101185,chr16,61101035,61101185,HepG2|chr16:2732140-2732179,chr16,2732140,2732179,0,58368895
HepG2|chr16:61249685-61249816,chr16,61249685,61249816,HepG2|chr16:4512488-4512595,chr16,4512488,4512595,0,56737197
HepG2|chr16:61279549-61279633,chr16,61279549,61279633,HepG2|chr16:22448233-22448320,chr16,22448233,22448320,0,38831316
HepG2|chr16:61333856-61333903,chr16,61333856,61333903,HepG2|chr16:56899989-56900139,chr16,56899989,56900139,0,4433867
HepG2|chr16:61438539-61438600,chr16,61438539,61438600,HepG2|chr16:15071126-15071262,chr16,15071126,15071262,0,46367413
HepG2|chr16:61532692-61532802,chr16,61532692,61532802,HepG2|chr16:15073124-15073190,chr16,15073124,15073190,0,46459568
HepG2|chr16:61619228-61619307,chr16,61619228,61619307,HepG2|chr16:18937922-18937993,chr16,18937922,18937993,0,42681306
HepG2|chr16:61687624-61687674,chr16,61687624,61687674,HepG2|chr16:15071133-15071265,chr16,15071133,15071265,0,46616491
HepG2|chr16:61699503-61699532,chr16,61699503,61699532,HepG2|chr16:2957203-2957323,chr16,2957203,2957323,0,58742300
HepG2|chr16:61806065-61806162,chr16,61806065,61806162,HepG2|chr16:15189676-15189712,chr16,15189676,15189712,0,46616389
HepG2|chr16:61902680-61902825,chr16,61902680,61902825,HepG2|chr16:2590056-2590201,chr16,2590056,2590201,0,59312624
HepG2|chr16:62005958-62006027,chr16,62005958,62006027,HepG2|chr16:19124755-19124830,chr16,19124755,19124830,0,42881203
HepG2|chr16:62228334-62228376,chr16,62228334,62228376,HepG2|chr16:89626637-89626787,chr16,89626637,89626787,0,27398303
HepG2|chr16:62235629-62235770,chr16,62235629,62235770,HepG2|chr16:22448138-22448227,chr16,22448138,22448227,0,39787491
HepG2|chr16:62286112-62286252,chr16,62286112,62286252,HepG2|chr16:22553245-22553384,chr16,22553245,22553384,0,39732867
HepG2|chr16:62329610-62329685,chr16,62329610,62329685,HepG2|chr16:56899992-56900142,chr16,56899992,56900142,0,5429618
HepG2|chr16:62515676-62515719,chr16,62515676,62515719,HepG2|chr16:4512488-4512595,chr16,4512488,4512595,0,58003188
HepG2|chr16:62884037-62884120,chr16,62884037,62884120,HepG2|chr16:85644584-85644651,chr16,85644584,85644651,0,22760547
HepG2|chr16:63225999-63226149,chr16,63225999,63226149,HepG2|chr16:2590048-2590198,chr16,2590048,2590198,0,60635951
HepG2|chr16:63320389-63320502,chr16,63320389,63320502,HepG2|chr16:70284091-70284152,chr16,70284091,70284152,0,6963702
HepG2|chr16:63402553-63402666,chr16,63402553,63402666,HepG2|chr16:70284091-70284152,chr16,70284091,70284152,0,6881538
HepG2|chr16:63839141-63839214,chr16,63839141,63839214,HepG2|chr16:33950176-33950206,chr16,33950176,33950206,0,29888965
HepG2|chr16:63840496-63840646,chr16,63840496,63840646,HepG2|chr16:2589780-2589927,chr16,2589780,2589927,0,61250716
HepG2|chr16:63843859-63843996,chr16,63843859,63843996,HepG2|chr16:18937906-18938056,chr16,18937906,18938056,0,44905953
HepG2|chr16:64081697-64081728,chr16,64081697,64081728,HepG2|chr16:15074180-15074283,chr16,15074180,15074283,0,49007517
HepG2|chr16:64104374-64104432,chr16,64104374,64104432,HepG2|chr16:15073139-15073289,chr16,15073139,15073289,0,49031235
HepG2|chr16:64120561-64120635,chr16,64120561,64120635,HepG2|chr16:33950177-33950213,chr16,33950177,33950213,0,30170384
HepG2|chr16:64141863-64142011,chr16,64141863,64142011,HepG2|chr16:21455187-21455250,chr16,21455187,21455250,0,42686676
HepG2|chr16:64161976-64162113,chr16,64161976,64162113,HepG2|chr16:18937906-18938056,chr16,18937906,18938056,0,45224070
HepG2|chr16:64376287-64376313,chr16,64376287,64376313,HepG2|chr16:21456052-21456122,chr16,21456052,21456122,0,42920235
HepG2|chr16:64393725-64393871,chr16,64393725,64393871,HepG2|chr16:15071128-15071262,chr16,15071128,15071262,0,49322597
HepG2|chr16:64414351-64414462,chr16,64414351,64414462,HepG2|chr16:2957295-2957334,chr16,2957295,2957334,0,61457056
HepG2|chr16:64455904-64455987,chr16,64455904,64455987,HepG2|chr16:33950176-33950206,chr16,33950176,33950206,0,30505728
HepG2|chr16:64629466-64629525,chr16,64629466,64629525,HepG2|chr16:4326635-4326761,chr16,4326635,4326761,0,60302831
HepG2|chr16:64650005-64650125,chr16,64650005,64650125,HepG2|chr16:87894254-87894282,chr16,87894254,87894282,0,23244249
HepG2|chr16:64704014-64704042,chr16,64704014,64704042,HepG2|chr16:71843772-71843810,chr16,71843772,71843810,0,7139758
HepG2|chr16:64756209-64756278,chr16,64756209,64756278,HepG2|chr16:19124755-19124830,chr16,19124755,19124830,0,45631454
HepG2|chr16:64929658-64929788,chr16,64929658,64929788,HepG2|chr16:87901411-87901537,chr16,87901411,87901537,0,22971753
HepG2|chr16:65168415-65168485,chr16,65168415,65168485,HepG2|chr16:18937899-18937980,chr16,18937899,18937980,0,46230516
HepG2|chr16:65350574-65350699,chr16,65350574,65350699,HepG2|chr16:15073139-15073289,chr16,15073139,15073289,0,50277435
HepG2|chr16:65390873-65390991,chr16,65390873,65390991,HepG2|chr16:2957632-2957675,chr16,2957632,2957675,0,62433241
HepG2|chr16:65450267-65450340,chr16,65450267,65450340,HepG2|chr16:3696369-3696446,chr16,3696369,3696446,0,61753898
HepG2|chr16:65612841-65612957,chr16,65612841,65612957,HepG2|chr16:28700229-28700262,chr16,28700229,28700262,0,36912612
HepG2|chr16:65714912-65714994,chr16,65714912,65714994,HepG2|chr16:74736480-74736539,chr16,74736480,74736539,0,9021568
HepG2|chr16:65941925-65941972,chr16,65941925,65941972,HepG2|chr16:18937861-18937989,chr16,18937861,18937989,0,47004064
HepG2|chr16:66160555-66160634,chr16,66160555,66160634,HepG2|chr16:87898759-87898803,chr16,87898759,87898803,0,21738204
HepG2|chr16:66237892-66238035,chr16,66237892,66238035,HepG2|chr16:15008685-15008822,chr16,15008685,15008822,0,51229207
HepG2|chr16:66363205-66363349,chr16,66363205,66363349,HepG2|chr16:2590040-2590187,chr16,2590040,2590187,0,63773165
HepG2|chr16:66440466-66440584,chr16,66440466,66440584,HepG2|chr16:56899985-56900135,chr16,56899985,56900135,0,9540481
HepG2|chr16:66462030-66462180,chr16,66462030,66462180,HepG2|chr16:87902237-87902386,chr16,87902237,87902386,0,21440207
HepG2|chr16:66487018-66487168,chr16,66487018,66487168,HepG2|chr16:2589851-2590001,chr16,2589851,2590001,0,63897167
HepG2|chr16:66532692-66532782,chr16,66532692,66532782,HepG2|chr16:18937914-18938064,chr16,18937914,18938064,0,47594778
HepG2|chr16:66548561-66548710,chr16,66548561,66548710,HepG2|chr16:2590073-2590198,chr16,2590073,2590198,0,63958488
HepG2|chr16:66658494-66658578,chr16,66658494,66658578,HepG2|chr16:15071126-15071175,chr16,15071126,15071175,0,51587368
HepG2|chr16:66806170-66806199,chr16,66806170,66806199,HepG2|chr16:2957203-2957323,chr16,2957203,2957323,0,63848967
HepG2|chr16:66854471-66854621,chr16,66854471,66854621,HepG2|chr16:2590048-2590198,chr16,2590048,2590198,0,64264423
HepG2|chr16:66924247-66924273,chr16,66924247,66924273,HepG2|chr16:21456052-21456122,chr16,21456052,21456122,0,45468195
HepG2|chr16:66947473-66947588,chr16,66947473,66947588,HepG2|chr16:22553154-22553264,chr16,22553154,22553264,0,44394319
HepG2|chr16:67052174-67052251,chr16,67052174,67052251,HepG2|chr16:3032807-3032880,chr16,3032807,3032880,0,64019367
HepG2|chr16:67058649-67058764,chr16,67058649,67058764,HepG2|chr16:87894255-87894277,chr16,87894255,87894277,0,20835606
HepG2|chr16:67112433-67112570,chr16,67112433,67112570,HepG2|chr16:81031797-81031890,chr16,81031797,81031890,0,13919364
HepG2|chr16:67208199-67208349,chr16,67208199,67208349,HepG2|chr16:15072178-15072328,chr16,15072178,15072328,0,52136021
HepG2|chr16:67279208-67279287,chr16,67279208,67279287,HepG2|chr16:33950176-33950205,chr16,33950176,33950205,0,33329032
HepG2|chr16:67564564-67564604,chr16,67564564,67564604,HepG2|chr16:15073139-15073289,chr16,15073139,15073289,0,52491425
HepG2|chr16:67697188-67697250,chr16,67697188,67697250,HepG2|chr16:33950143-33950227,chr16,33950143,33950227,0,33747045
HepG2|chr16:67730944-67730965,chr16,67730944,67730965,HepG2|chr16:87985386-87985536,chr16,87985386,87985536,0,20254442
HepG2|chr16:67755150-67755258,chr16,67755150,67755258,HepG2|chr16:18935971-18936048,chr16,18935971,18936048,0,48819179
HepG2|chr16:67773054-67773203,chr16,67773054,67773203,HepG2|chr16:3032807-3032880,chr16,3032807,3032880,0,64740247
HepG2|chr16:67897772-67897920,chr16,67897772,67897920,HepG2|chr16:87899695-87899822,chr16,87899695,87899822,0,20001923
HepG2|chr16:67997709-67997859,chr16,67997709,67997859,HepG2|chr16:18937912-18938060,chr16,18937912,18938060,0,49059797
HepG2|chr16:68063724-68063873,chr16,68063724,68063873,HepG2|chr16:3032807-3032880,chr16,3032807,3032880,0,65030917
HepG2|chr16:68118675-68118825,chr16,68118675,68118825,HepG2|chr16:22553245-22553359,chr16,22553245,22553359,0,45565430
HepG2|chr16:68176715-68176830,chr16,68176715,68176830,HepG2|chr16:28700229-28700261,chr16,28700229,28700261,0,39476486
HepG2|chr16:68183184-68183248,chr16,68183184,68183248,HepG2|chr16:22553244-22553370,chr16,22553244,22553370,0,45629940
HepG2|chr16:68239560-68239634,chr16,68239560,68239634,HepG2|chr16:33950163-33950218,chr16,33950163,33950218,0,34289397
HepG2|chr16:68442127-68442238,chr16,68442127,68442238,HepG2|chr16:85641106-85641159,chr16,85641106,85641159,0,17198979
HepG2|chr16:68576926-68577022,chr16,68576926,68577022,HepG2|chr16:18937922-18937976,chr16,18937922,18937976,0,49639004
HepG2|chr16:68912787-68912937,chr16,68912787,68912937,HepG2|chr16:18937936-18937990,chr16,18937936,18937990,0,49974851
HepG2|chr16:68938346-68938389,chr16,68938346,68938389,HepG2|chr16:4512488-4512595,chr16,4512488,4512595,0,64425858
HepG2|chr16:68963030-68963138,chr16,68963030,68963138,HepG2|chr16:33950337-33950371,chr16,33950337,33950371,0,35012693
HepG2|chr16:69087897-69088047,chr16,69087897,69088047,HepG2|chr16:2591081-2591231,chr16,2591081,2591231,0,66496816
HepG2|chr16:69107336-69107436,chr16,69107336,69107436,HepG2|chr16:31192170-31192320,chr16,31192170,31192320,0,37915166
HepG2|chr16:69223494-69223644,chr16,69223494,69223644,HepG2|chr16:15072179-15072328,chr16,15072179,15072328,0,54151315
HepG2|chr16:69296950-69297100,chr16,69296950,69297100,HepG2|chr16:2590053-2590203,chr16,2590053,2590203,0,66706897
HepG2|chr16:69337623-69337754,chr16,69337623,69337754,HepG2|chr16:18937922-18937976,chr16,18937922,18937976,0,50399701
HepG2|chr16:69352981-69353110,chr16,69352981,69353110,HepG2|chr16:85644118-85644136,chr16,85644118,85644136,0,16291137
HepG2|chr16:69388020-69388165,chr16,69388020,69388165,HepG2|chr16:2589901-2590017,chr16,2589901,2590017,0,66798119
HepG2|chr16:69399689-69399839,chr16,69399689,69399839,HepG2|chr16:22553168-22553279,chr16,22553168,22553279,0,46846521
HepG2|chr16:69416579-69416629,chr16,69416579,69416629,HepG2|chr16:19123383-19123408,chr16,19123383,19123408,0,50293196
HepG2|chr16:69442683-69442754,chr16,69442683,69442754,HepG2|chr16:2182602-2182752,chr16,2182602,2182752,0,67260081
HepG2|chr16:69504409-69504553,chr16,69504409,69504553,HepG2|chr16:2601680-2601782,chr16,2601680,2601782,0,66902729
HepG2|chr16:69514077-69514227,chr16,69514077,69514227,HepG2|chr16:2589832-2589982,chr16,2589832,2589982,0,66924245
HepG2|chr16:69597473-69597598,chr16,69597473,69597598,HepG2|chr16:87899729-87899879,chr16,87899729,87899879,0,18302256
HepG2|chr16:69609925-69609960,chr16,69609925,69609960,HepG2|chr16:18937924-18938063,chr16,18937924,18938063,0,50672001
HepG2|chr16:69643480-69643614,chr16,69643480,69643614,HepG2|chr16:2934254-2934270,chr16,2934254,2934270,0,66709226
HepG2|chr16:69764961-69765111,chr16,69764961,69765111,HepG2|chr16:87899075-87899167,chr16,87899075,87899167,0,18134114
HepG2|chr16:69832093-69832243,chr16,69832093,69832243,HepG2|chr16:22448135-22448270,chr16,22448135,22448270,0,47383958
HepG2|chr16:69880321-69880437,chr16,69880321,69880437,HepG2|chr16:11892422-11892523,chr16,11892422,11892523,0,57987899
HepG2|chr16:69880454-69880601,chr16,69880454,69880601,HepG2|chr16:87902056-87902198,chr16,87902056,87902198,0,18021602
HepG2|chr16:70013693-70013712,chr16,70013693,70013712,HepG2|chr16:88634184-88634244,chr16,88634184,88634244,0,18620491
HepG2|chr16:70071521-70071671,chr16,70071521,70071671,HepG2|chr16:18937861-18937988,chr16,18937861,18937988,0,51133660
HepG2|chr16:70100837-70100938,chr16,70100837,70100938,HepG2|chr16:8957891-8957960,chr16,8957891,8957960,0,61142946
HepG2|chr16:70157839-70157944,chr16,70157839,70157944,HepG2|chr16:15071085-15071151,chr16,15071085,15071151,0,55086754
HepG2|chr16:70416517-70416577,chr16,70416517,70416577,HepG2|chr16:15008119-15008264,chr16,15008119,15008264,0,55408398
HepG2|chr16:70555761-70555823,chr16,70555761,70555823,HepG2|chr16:15071128-15071249,chr16,15071128,15071249,0,55484633
HepG2|chr16:70612311-70612461,chr16,70612311,70612461,HepG2|chr16:2589851-2590000,chr16,2589851,2590000,0,68022460
HepG2|chr16:70642655-70642805,chr16,70642655,70642805,HepG2|chr16:4237007-4237106,chr16,4237007,4237106,0,66405648
HepG2|chr16:70668736-70668826,chr16,70668736,70668826,HepG2|chr16:19124755-19124830,chr16,19124755,19124830,0,51543981
HepG2|chr16:70671008-70671034,chr16,70671008,70671034,HepG2|chr16:11678998-11679104,chr16,11678998,11679104,0,58992010
HepG2|chr16:70791472-70791622,chr16,70791472,70791622,HepG2|chr16:2590048-2590198,chr16,2590048,2590198,0,68201424
HepG2|chr16:70886632-70886745,chr16,70886632,70886745,HepG2|chr16:70284100-70284137,chr16,70284100,70284137,0,602532
HepG2|chr16:71055286-71055435,chr16,71055286,71055435,HepG2|chr16:15069125-15069271,chr16,15069125,15069271,0,55986161
HepG2|chr16:71109858-71110008,chr16,71109858,71110008,HepG2|chr16:15073164-15073298,chr16,15073164,15073298,0,56036694
HepG2|chr16:71510722-71510764,chr16,71510722,71510764,HepG2|chr16:15069413-15069562,chr16,15069413,15069562,0,56441309
HepG2|chr16:71538318-71538430,chr16,71538318,71538430,HepG2|chr16:57021741-57021804,chr16,57021741,57021804,0,14516577
HepG2|chr16:71554632-71554782,chr16,71554632,71554782,HepG2|chr16:18937926-18937970,chr16,18937926,18937970,0,52616706
HepG2|chr16:71617795-71617942,chr16,71617795,71617942,HepG2|chr16:15187544-15187691,chr16,15187544,15187691,0,56430251
HepG2|chr16:71627985-71628067,chr16,71627985,71628067,HepG2|chr16:18937922-18937987,chr16,18937922,18937987,0,52690063
HepG2|chr16:71732972-71733057,chr16,71732972,71733057,HepG2|chr16:18937922-18937982,chr16,18937922,18937982,0,52795050
HepG2|chr16:71762673-71762773,chr16,71762673,71762773,HepG2|chr16:22448198-22448227,chr16,22448198,22448227,0,49314475
HepG2|chr16:71877848-71877931,chr16,71877848,71877931,HepG2|chr16:15189676-15189712,chr16,15189676,15189712,0,56688172
HepG2|chr16:71956482-71956559,chr16,71956482,71956559,HepG2|chr16:15073032-15073182,chr16,15073032,15073182,0,56883450
HepG2|chr16:71984552-71984689,chr16,71984552,71984689,HepG2|chr16:81031797-81031890,chr16,81031797,81031890,0,9047245
HepG2|chr16:72105261-72105322,chr16,72105261,72105322,HepG2|chr16:18937861-18937983,chr16,18937861,18937983,0,53167400
HepG2|chr16:72258074-72258221,chr16,72258074,72258221,HepG2|chr16:2591022-2591172,chr16,2591022,2591172,0,69667052
HepG2|chr16:72260365-72260463,chr16,72260365,72260463,HepG2|chr16:22553234-22553380,chr16,22553234,22553380,0,49707131
HepG2|chr16:72319946-72320028,chr16,72319946,72320028,HepG2|chr16:33950176-33950205,chr16,33950176,33950205,0,38369770
HepG2|chr16:72349625-72349657,chr16,72349625,72349657,HepG2|chr16:28836138-28836288,chr16,28836138,28836288,0,43513487
HepG2|chr16:72693539-72693672,chr16,72693539,72693672,HepG2|chr16:22553131-22553276,chr16,22553131,22553276,0,50140408
HepG2|chr16:72745107-72745257,chr16,72745107,72745257,HepG2|chr16:22448135-22448270,chr16,22448135,22448270,0,50296972
HepG2|chr16:72745635-72745779,chr16,72745635,72745779,HepG2|chr16:2732140-2732196,chr16,2732140,2732196,0,70013495
HepG2|chr16:72852453-72852563,chr16,72852453,72852563,HepG2|chr16:18937915-18938064,chr16,18937915,18938064,0,53914538
HepG2|chr16:73098512-73098577,chr16,73098512,73098577,HepG2|chr16:33950176-33950211,chr16,33950176,33950211,0,39148336
HepG2|chr16:73229773-73229874,chr16,73229773,73229874,HepG2|chr16:81029792-81029836,chr16,81029792,81029836,0,7800019
HepG2|chr16:73486165-73486247,chr16,73486165,73486247,HepG2|chr16:74736480-74736539,chr16,74736480,74736539,0,1250315
HepG2|chr16:73558144-73558293,chr16,73558144,73558293,HepG2|chr16:87895657-87895803,chr16,87895657,87895803,0,14337513
HepG2|chr16:73611647-73611792,chr16,73611647,73611792,HepG2|chr16:18937922-18937974,chr16,18937922,18937974,0,54673725
HepG2|chr16:73730001-73730151,chr16,73730001,73730151,HepG2|chr16:18937861-18937990,chr16,18937861,18937990,0,54792140
HepG2|chr16:74009976-74010071,chr16,74009976,74010071,HepG2|chr16:33950163-33950214,chr16,33950163,33950214,0,40059813
HepG2|chr16:74303623-74303773,chr16,74303623,74303773,HepG2|chr16:2590047-2590192,chr16,2590047,2590192,0,71713576
HepG2|chr16:74341871-74341903,chr16,74341871,74341903,HepG2|chr16:19124350-19124494,chr16,19124350,19124494,0,55217521
HepG2|chr16:74462325-74462423,chr16,74462325,74462423,HepG2|chr16:31121861-31121980,chr16,31121861,31121980,0,43340464
HepG2|chr16:74468290-74468370,chr16,74468290,74468370,HepG2|chr16:33950337-33950383,chr16,33950337,33950383,0,40517953
HepG2|chr16:74531386-74531457,chr16,74531386,74531457,HepG2|chr16:85641560-85641641,chr16,85641560,85641641,0,11110174
HepG2|chr16:74699130-74699235,chr16,74699130,74699235,HepG2|chr16:19124234-19124384,chr16,19124234,19124384,0,55574896
HepG2|chr16:74927314-74927464,chr16,74927314,74927464,HepG2|chr16:15187589-15187739,chr16,15187589,15187739,0,59739725
HepG2|chr16:75424933-75425016,chr16,75424933,75425016,HepG2|chr16:75281029-75281096,chr16,75281029,75281096,0,143904
HepG2|chr16:75442155-75442305,chr16,75442155,75442305,HepG2|chr16:2590050-2590200,chr16,2590050,2590200,0,72852105
HepG2|chr16:75461255-75461366,chr16,75461255,75461366,HepG2|chr16:2732140-2732179,chr16,2732140,2732179,0,72729115
HepG2|chr16:75469534-75469630,chr16,75469534,75469630,HepG2|chr16:2725992-2726046,chr16,2725992,2726046,0,72743542
HepG2|chr16:75569045-75569103,chr16,75569045,75569103,HepG2|chr16:70284035-70284127,chr16,70284035,70284127,0,5285010
HepG2|chr16:75605921-75606071,chr16,75605921,75606071,HepG2|chr16:87902007-87902157,chr16,87902007,87902157,0,12296086
HepG2|chr16:75783899-75784049,chr16,75783899,75784049,HepG2|chr16:19122827-19122862,chr16,19122827,19122862,0,56661072
HepG2|chr16:75940548-75940628,chr16,75940548,75940628,HepG2|chr16:33950337-33950383,chr16,33950337,33950383,0,41990211
HepG2|chr16:75992073-75992203,chr16,75992073,75992203,HepG2|chr16:66634026-66634147,chr16,66634026,66634147,0,9358047
HepG2|chr16:76101027-76101153,chr16,76101027,76101153,HepG2|chr16:87900451-87900545,chr16,87900451,87900545,0,11799424
HepG2|chr16:76200006-76200050,chr16,76200006,76200050,HepG2|chr16:2603162-2603282,chr16,2603162,2603282,0,73596844
HepG2|chr16:76222112-76222262,chr16,76222112,76222262,HepG2|chr16:15069095-15069245,chr16,15069095,15069245,0,61153017
HepG2|chr16:76313632-76313781,chr16,76313632,76313781,HepG2|chr16:18937934-18937970,chr16,18937934,18937970,0,57375698
HepG2|chr16:76413031-76413178,chr16,76413031,76413178,HepG2|chr16:2180902-2181052,chr16,2180902,2181052,0,74232129
HepG2|chr16:76425898-76425977,chr16,76425898,76425977,HepG2|chr16:56899842-56899876,chr16,56899842,56899876,0,19526056
HepG2|chr16:76454341-76454471,chr16,76454341,76454471,HepG2|chr16:2183074-2183120,chr16,2183074,2183120,0,74271267
HepG2|chr16:76465583-76465615,chr16,76465583,76465615,HepG2|chr16:87896930-87897080,chr16,87896930,87897080,0,11431347
HepG2|chr16:76487890-76487996,chr16,76487890,76487996,HepG2|chr16:89626851-89626882,chr16,89626851,89626882,0,13138961
HepG2|chr16:76500807-76500950,chr16,76500807,76500950,HepG2|chr16:2590840-2590990,chr16,2590840,2590990,0,73909967
HepG2|chr16:76542317-76542418,chr16,76542317,76542418,HepG2|chr16:8957891-8957960,chr16,8957891,8957960,0,67584426
HepG2|chr16:76565048-76565164,chr16,76565048,76565164,HepG2|chr16:28700229-28700262,chr16,28700229,28700262,0,47864819
HepG2|chr16:76721365-76721422,chr16,76721365,76721422,HepG2|chr16:10835795-10835933,chr16,10835795,10835933,0,65885570
HepG2|chr16:76808408-76808462,chr16,76808408,76808462,HepG2|chr16:15071116-15071265,chr16,15071116,15071265,0,61737292
HepG2|chr16:76900237-76900323,chr16,76900237,76900323,HepG2|chr16:33950176-33950206,chr16,33950176,33950206,0,42950061
HepG2|chr16:76920793-76920938,chr16,76920793,76920938,HepG2|chr16:87902214-87902364,chr16,87902214,87902364,0,10981421
HepG2|chr16:76927270-76927420,chr16,76927270,76927420,HepG2|chr16:15071944-15072094,chr16,15071944,15072094,0,61855326
HepG2|chr16:77002786-77002891,chr16,77002786,77002891,HepG2|chr16:18937912-18938062,chr16,18937912,18938062,0,58064874
HepG2|chr16:77137798-77137828,chr16,77137798,77137828,HepG2|chr16:2732178-2732328,chr16,2732178,2732328,0,74405620
HepG2|chr16:77297602-77297707,chr16,77297602,77297707,HepG2|chr16:87900102-87900247,chr16,87900102,87900247,0,10602500
HepG2|chr16:77493378-77493417,chr16,77493378,77493417,HepG2|chr16:2957348-2957432,chr16,2957348,2957432,0,74536030
HepG2|chr16:77553486-77553633,chr16,77553486,77553633,HepG2|chr16:2589804-2589882,chr16,2589804,2589882,0,74963682
HepG2|chr16:77633563-77633704,chr16,77633563,77633704,HepG2|chr16:18935920-18936066,chr16,18935920,18936066,0,58697643
HepG2|chr16:77645824-77645974,chr16,77645824,77645974,HepG2|chr16:2590261-2590382,chr16,2590261,2590382,0,75055563
HepG2|chr16:77656865-77656886,chr16,77656865,77656886,HepG2|chr16:87985386-87985536,chr16,87985386,87985536,0,10328521
HepG2|chr16:77670206-77670311,chr16,77670206,77670311,HepG2|chr16:85645585-85645657,chr16,85645585,85645657,0,7975379
HepG2|chr16:77739218-77739368,chr16,77739218,77739368,HepG2|chr16:18935933-18936076,chr16,18935933,18936076,0,58803285
HepG2|chr16:77741679-77741804,chr16,77741679,77741804,HepG2|chr16:2183056-2183111,chr16,2183056,2183111,0,75558623
HepG2|chr16:77785561-77785668,chr16,77785561,77785668,HepG2|chr16:56899894-56900040,chr16,56899894,56900040,0,20885667
HepG2|chr16:78122482-78122542,chr16,78122482,78122542,HepG2|chr16:18938019-18938063,chr16,18938019,18938063,0,59184463
HepG2|chr16:78188401-78188461,chr16,78188401,78188461,HepG2|chr16:75255733-75255804,chr16,75255733,75255804,0,2932668
HepG2|chr16:78212189-78212289,chr16,78212189,78212289,HepG2|chr16:22448135-22448274,chr16,22448135,22448274,0,55764054
HepG2|chr16:78216600-78216749,chr16,78216600,78216749,HepG2|chr16:2734021-2734167,chr16,2734021,2734167,0,75482579
HepG2|chr16:78236830-78236871,chr16,78236830,78236871,HepG2|chr16:2957087-2957203,chr16,2957087,2957203,0,75279743
HepG2|chr16:78315017-78315105,chr16,78315017,78315105,HepG2|chr16:67145690-67145752,chr16,67145690,67145752,0,11169327
HepG2|chr16:78379525-78379675,chr16,78379525,78379675,HepG2|chr16:15069122-15069171,chr16,15069122,15069171,0,63310403
HepG2|chr16:78393577-78393657,chr16,78393577,78393657,HepG2|chr16:87894260-87894290,chr16,87894260,87894290,0,9500683
HepG2|chr16:78422379-78422529,chr16,78422379,78422529,HepG2|chr16:2589780-2589927,chr16,2589780,2589927,0,75832599
HepG2|chr16:78531261-78531317,chr16,78531261,78531317,HepG2|chr16:1873276-1873360,chr16,1873276,1873360,0,76657985
HepG2|chr16:78609005-78609088,chr16,78609005,78609088,HepG2|chr16:56899915-56900060,chr16,56899915,56900060,0,21709090
HepG2|chr16:78615443-78615553,chr16,78615443,78615553,HepG2|chr16:19124717-19124832,chr16,19124717,19124832,0,59490726
HepG2|chr16:78875396-78875539,chr16,78875396,78875539,HepG2|chr16:2590840-2590990,chr16,2590840,2590990,0,76284556
HepG2|chr16:78955030-78955106,chr16,78955030,78955106,HepG2|chr16:33950176-33950205,chr16,33950176,33950205,0,45004854
HepG2|chr16:79086909-79086985,chr16,79086909,79086985,HepG2|chr16:33950176-33950205,chr16,33950176,33950205,0,45136733
HepG2|chr16:79161085-79161234,chr16,79161085,79161234,HepG2|chr16:15072183-15072333,chr16,15072183,15072333,0,64088902
HepG2|chr16:79189972-79190110,chr16,79189972,79190110,HepG2|chr16:15071126-15071258,chr16,15071126,15071258,0,64118846
HepG2|chr16:79307864-79308014,chr16,79307864,79308014,HepG2|chr16:18937936-18937990,chr16,18937936,18937990,0,60369928
HepG2|chr16:79406015-79406112,chr16,79406015,79406112,HepG2|chr16:3032807-3032880,chr16,3032807,3032880,0,76373208
HepG2|chr16:79483261-79483344,chr16,79483261,79483344,HepG2|chr16:15189676-15189712,chr16,15189676,15189712,0,64293585
HepG2|chr16:79509275-79509425,chr16,79509275,79509425,HepG2|chr16:87899056-87899206,chr16,87899056,87899206,0,8389781
HepG2|chr16:79511798-79511876,chr16,79511798,79511876,HepG2|chr16:2590054-2590201,chr16,2590054,2590201,0,76921744
HepG2|chr16:79616424-79616574,chr16,79616424,79616574,HepG2|chr16:87899717-87899863,chr16,87899717,87899863,0,8283293
HepG2|chr16:80049725-80049803,chr16,80049725,80049803,HepG2|chr16:18937922-18938068,chr16,18937922,18938068,0,61111803
HepG2|chr16:80294260-80294371,chr16,80294260,80294371,HepG2|chr16:2957295-2957334,chr16,2957295,2957334,0,77336965
HepG2|chr16:80415220-80415367,chr16,80415220,80415367,HepG2|chr16:85644118-85644136,chr16,85644118,85644136,0,5228898
HepG2|chr16:80608083-80608141,chr16,80608083,80608141,HepG2|chr16:30763617-30763767,chr16,30763617,30763767,0,49844466
HepG2|chr16:80652097-80652235,chr16,80652097,80652235,HepG2|chr16:2181698-2181821,chr16,2181698,2181821,0,78470399
HepG2|chr16:80786283-80786361,chr16,80786283,80786361,HepG2|chr16:2733865-2733955,chr16,2733865,2733955,0,78052418
HepG2|chr16:80813697-80813758,chr16,80813697,80813758,HepG2|chr16:15008121-15008255,chr16,15008121,15008255,0,65805576
HepG2|chr16:81052313-81052463,chr16,81052313,81052463,HepG2|chr16:87900178-87900328,chr16,87900178,87900328,0,6847865
HepG2|chr16:81096601-81096695,chr16,81096601,81096695,HepG2|chr16:686732-686781,chr16,686732,686781,0,80409869
HepG2|chr16:81105532-81105570,chr16,81105532,81105570,HepG2|chr16:75274996-75275080,chr16,75274996,75275080,0,5830536
HepG2|chr16:81127673-81127727,chr16,81127673,81127727,HepG2|chr16:87901578-87901721,chr16,87901578,87901721,0,6773905
HepG2|chr16:81173119-81173269,chr16,81173119,81173269,HepG2|chr16:15071957-15072107,chr16,15071957,15072107,0,66101162
HepG2|chr16:81182097-81182174,chr16,81182097,81182174,HepG2|chr16:33950337-33950379,chr16,33950337,33950379,0,47231760
HepG2|chr16:81194806-81194952,chr16,81194806,81194952,HepG2|chr16:87902206-87902356,chr16,87902206,87902356,0,6707400
HepG2|chr16:81235881-81235960,chr16,81235881,81235960,HepG2|chr16:87898759-87898803,chr16,87898759,87898803,0,6662878
HepG2|chr16:81260954-81261063,chr16,81260954,81261063,HepG2|chr16:75497163-75497204,chr16,75497163,75497204,0,5763791
HepG2|chr16:81282089-81282220,chr16,81282089,81282220,HepG2|chr16:87893916-87893947,chr16,87893916,87893947,0,6611827
HepG2|chr16:81417658-81417795,chr16,81417658,81417795,HepG2|chr16:71845090-71845158,chr16,71845090,71845158,0,9572568
HepG2|chr16:81627576-81627638,chr16,81627576,81627638,HepG2|chr16:71845090-71845157,chr16,71845090,71845157,0,9782486
HepG2|chr16:81658109-81658155,chr16,81658109,81658155,HepG2|chr16:15008690-15008840,chr16,15008690,15008840,0,66649419
HepG2|chr16:81669239-81669317,chr16,81669239,81669317,HepG2|chr16:33950176-33950211,chr16,33950176,33950211,0,47719063
HepG2|chr16:81727745-81727824,chr16,81727745,81727824,HepG2|chr16:19124222-19124293,chr16,19124222,19124293,0,62603523
HepG2|chr16:81758267-81758403,chr16,81758267,81758403,HepG2|chr16:22553241-22553380,chr16,22553241,22553380,0,59205026
HepG2|chr16:81835346-81835424,chr16,81835346,81835424,HepG2|chr16:10835795-10835904,chr16,10835795,10835904,0,70999551
HepG2|chr16:81872305-81872455,chr16,81872305,81872455,HepG2|chr16:87899060-87899144,chr16,87899060,87899144,0,6026755
HepG2|chr16:81933590-81933654,chr16,81933590,81933654,HepG2|chr16:22553244-22553370,chr16,22553244,22553370,0,59380346
HepG2|chr16:81967730-81967752,chr16,81967730,81967752,HepG2|chr16:2732140-2732196,chr16,2732140,2732196,0,79235590
HepG2|chr16:82130860-82130895,chr16,82130860,82130895,HepG2|chr16:3696369-3696481,chr16,3696369,3696481,0,78434491
HepG2|chr16:82190207-82190322,chr16,82190207,82190322,HepG2|chr16:15071128-15071238,chr16,15071128,15071238,0,67119079
HepG2|chr16:82279628-82279716,chr16,82279628,82279716,HepG2|chr16:67145690-67145752,chr16,67145690,67145752,0,15133938
HepG2|chr16:82297936-82298086,chr16,82297936,82298086,HepG2|chr16:4237007-4237106,chr16,4237007,4237106,0,78060929
HepG2|chr16:82334391-82334408,chr16,82334391,82334408,HepG2|chr16:11832518-11832613,chr16,11832518,11832613,0,70501873
HepG2|chr16:82356124-82356239,chr16,82356124,82356239,HepG2|chr16:28700229-28700261,chr16,28700229,28700261,0,53655895
HepG2|chr16:82420726-82420812,chr16,82420726,82420812,HepG2|chr16:33950176-33950206,chr16,33950176,33950206,0,48470550
HepG2|chr16:82481864-82481959,chr16,82481864,82481959,HepG2|chr16:33950176-33950211,chr16,33950176,33950211,0,48531688
HepG2|chr16:82596140-82596227,chr16,82596140,82596227,HepG2|chr16:22553238-22553359,chr16,22553238,22553359,0,60042902
HepG2|chr16:82623252-82623401,chr16,82623252,82623401,HepG2|chr16:87895657-87895803,chr16,87895657,87895803,0,5272405
HepG2|chr16:82701791-82701842,chr16,82701791,82701842,HepG2|chr16:33950133-33950227,chr16,33950133,33950227,0,48751658
HepG2|chr16:82776051-82776124,chr16,82776051,82776124,HepG2|chr16:33950176-33950206,chr16,33950176,33950206,0,48825875
HepG2|chr16:82803823-82803886,chr16,82803823,82803886,HepG2|chr16:2590535-2590685,chr16,2590535,2590685,0,80213288
HepG2|chr16:83208461-83208575,chr16,83208461,83208575,HepG2|chr16:85641140-85641176,chr16,85641140,85641176,0,2432679
HepG2|chr16:83378743-83378846,chr16,83378743,83378846,HepG2|chr16:2183011-2183113,chr16,2183011,2183113,0,81195732
HepG2|chr16:83447922-83448022,chr16,83447922,83448022,HepG2|chr16:22448198-22448227,chr16,22448198,22448227,0,60999724
HepG2|chr16:83645661-83645810,chr16,83645661,83645810,HepG2|chr16:2590824-2590974,chr16,2590824,2590974,0,81054837
HepG2|chr16:83683208-83683355,chr16,83683208,83683355,HepG2|chr16:22553238-22553358,chr16,22553238,22553358,0,61129970
HepG2|chr16:83708890-83708983,chr16,83708890,83708983,HepG2|chr16:33950176-33950207,chr16,33950176,33950207,0,49758714
HepG2|chr16:83767693-83767841,chr16,83767693,83767841,HepG2|chr16:2590053-2590203,chr16,2590053,2590203,0,81177640
HepG2|chr16:83806472-83806564,chr16,83806472,83806564,HepG2|chr16:33950176-33950205,chr16,33950176,33950205,0,49856296
HepG2|chr16:83921989-83922139,chr16,83921989,83922139,HepG2|chr16:15071958-15072108,chr16,15071958,15072108,0,68850031
HepG2|chr16:84278000-84278100,chr16,84278000,84278100,HepG2|chr16:22448135-22448274,chr16,22448135,22448274,0,61829865
HepG2|chr16:84334650-84334800,chr16,84334650,84334800,HepG2|chr16:15073141-15073291,chr16,15073141,15073291,0,69261509
HepG2|chr16:84352390-84352448,chr16,84352390,84352448,HepG2|chr16:70284035-70284127,chr16,70284035,70284127,0,14068355
HepG2|chr16:84480411-84480529,chr16,84480411,84480529,HepG2|chr16:30759404-30759436,chr16,30759404,30759436,0,53721007
HepG2|chr16:84595469-84595550,chr16,84595469,84595550,HepG2|chr16:8957891-8957960,chr16,8957891,8957960,0,75637578
HepG2|chr16:84785574-84785724,chr16,84785574,84785724,HepG2|chr16:2590293-2590329,chr16,2590293,2590329,0,82195281
HepG2|chr16:84821172-84821223,chr16,84821172,84821223,HepG2|chr16:33950338-33950416,chr16,33950338,33950416,0,50870834
HepG2|chr16:85117467-85117545,chr16,85117467,85117545,HepG2|chr16:33950176-33950217,chr16,33950176,33950217,0,51167291
HepG2|chr16:85118203-85118347,chr16,85118203,85118347,HepG2|chr16:2589784-2589934,chr16,2589784,2589934,0,82528419
HepG2|chr16:85149723-85149873,chr16,85149723,85149873,HepG2|chr16:2590053-2590203,chr16,2590053,2590203,0,82559670
HepG2|chr16:85176348-85176496,chr16,85176348,85176496,HepG2|chr16:15189687-15189716,chr16,15189687,15189716,0,69986661
HepG2|chr16:85199302-85199371,chr16,85199302,85199371,HepG2|chr16:15073139-15073289,chr16,15073139,15073289,0,70126163
HepG2|chr16:85200078-85200207,chr16,85200078,85200207,HepG2|chr16:85644118-85644136,chr16,85644118,85644136,0,444040
HepG2|chr16:85270567-85270717,chr16,85270567,85270717,HepG2|chr16:15071971-15072121,chr16,15071971,15072121,0,70198596
HepG2|chr16:85277820-85277895,chr16,85277820,85277895,HepG2|chr16:10835795-10835851,chr16,10835795,10835851,0,74442025
HepG2|chr16:85396914-85397040,chr16,85396914,85397040,HepG2|chr16:87900451-87900545,chr16,87900451,87900545,0,2503537
HepG2|chr16:85478655-85478713,chr16,85478655,85478713,HepG2|chr16:15073139-15073289,chr16,15073139,15073289,0,70405516
HepG2|chr16:85584488-85584545,chr16,85584488,85584545,HepG2|chr16:1873276-1873360,chr16,1873276,1873360,0,83711212
HepG2|chr16:85619871-85620021,chr16,85619871,85620021,HepG2|chr16:2590052-2590202,chr16,2590052,2590202,0,83029819
HepG2|chr16:85737161-85737217,chr16,85737161,85737217,HepG2|chr16:22448157-22448219,chr16,22448157,22448219,0,63289004
HepG2|chr16:85974947-85975097,chr16,85974947,85975097,HepG2|chr16:15071958-15072108,chr16,15071958,15072108,0,70902989
HepG2|chr16:86036136-86036192,chr16,86036136,86036192,HepG2|chr16:71845090-71845157,chr16,71845090,71845157,0,14191046
HepG2|chr16:86183420-86183570,chr16,86183420,86183570,HepG2|chr16:18937922-18937982,chr16,18937922,18937982,0,67245498
HepG2|chr16:86740860-86741009,chr16,86740860,86741009,HepG2|chr16:87902204-87902353,chr16,87902204,87902353,0,1161344
HepG2|chr16:86920495-86920640,chr16,86920495,86920640,HepG2|chr16:2589901-2590017,chr16,2589901,2590017,0,84330594
HepG2|chr16:87001524-87001674,chr16,87001524,87001674,HepG2|chr16:15069104-15069252,chr16,15069104,15069252,0,71932420
HepG2|chr16:87012641-87012680,chr16,87012641,87012680,HepG2|chr16:68350418-68350449,chr16,68350418,68350449,0,18662223
HepG2|chr16:87180377-87180497,chr16,87180377,87180497,HepG2|chr16:81031540-81031570,chr16,81031540,81031570,0,6148837
HepG2|chr16:87237467-87237579,chr16,87237467,87237579,HepG2|chr16:57021741-57021804,chr16,57021741,57021804,0,30215726
HepG2|chr16:87282734-87282825,chr16,87282734,87282825,HepG2|chr16:33950163-33950218,chr16,33950163,33950218,0,53332571
HepG2|chr16:87492934-87493084,chr16,87492934,87493084,HepG2|chr16:2732140-2732179,chr16,2732140,2732179,0,84760794
HepG2|chr16:87515496-87515535,chr16,87515496,87515535,HepG2|chr16:2957348-2957432,chr16,2957348,2957432,0,84558148
HepG2|chr16:87525983-87526129,chr16,87525983,87526129,HepG2|chr16:2733040-2733190,chr16,2733040,2733190,0,84792943
HepG2|chr16:87753639-87753722,chr16,87753639,87753722,HepG2|chr16:33950176-33950206,chr16,33950176,33950206,0,53803463
HepG2|chr16:87960184-87960280,chr16,87960184,87960280,HepG2|chr16:2725992-2726046,chr16,2725992,2726046,0,85234192
HepG2|chr16:87980218-87980296,chr16,87980218,87980296,HepG2|chr16:85645585-85645657,chr16,85645585,85645657,0,2334633
HepG2|chr16:88091077-88091171,chr16,88091077,88091171,HepG2|chr16:56900100-56900250,chr16,56900100,56900250,0,31190977
HepG2|chr16:88125871-88125953,chr16,88125871,88125953,HepG2|chr16:71845090-71845158,chr16,71845090,71845158,0,16280781
HepG2|chr16:88186979-88187084,chr16,88186979,88187084,HepG2|chr16:33950176-33950205,chr16,33950176,33950205,0,54236803
HepG2|chr16:88240120-88240208,chr16,88240120,88240208,HepG2|chr16:33950163-33950218,chr16,33950163,33950218,0,54289957
HepG2|chr16:88336061-88336100,chr16,88336061,88336100,HepG2|chr16:21453547-21453654,chr16,21453547,21453654,0,66882514
HepG2|chr16:88442649-88442710,chr16,88442649,88442710,HepG2|chr16:18937861-18937983,chr16,18937861,18937983,0,69504788
HepG2|chr16:88825402-88825507,chr16,88825402,88825507,HepG2|chr16:18937918-18938063,chr16,18937918,18938063,0,69887484
HepG2|chr16:88829224-88829321,chr16,88829224,88829321,HepG2|chr16:15189676-15189712,chr16,15189676,15189712,0,73639548
HepG2|chr16:88830605-88830635,chr16,88830605,88830635,HepG2|chr16:15073139-15073289,chr16,15073139,15073289,0,73757466
HepG2|chr16:88871936-88872081,chr16,88871936,88872081,HepG2|chr16:2590048-2590198,chr16,2590048,2590198,0,86281888
HepG2|chr16:88877805-88877955,chr16,88877805,88877955,HepG2|chr16:2590047-2590194,chr16,2590047,2590194,0,86287758
HepG2|chr16:88903888-88904029,chr16,88903888,88904029,HepG2|chr16:18935920-18936066,chr16,18935920,18936066,0,69967968
HepG2|chr16:89130461-89130611,chr16,89130461,89130611,HepG2|chr16:2590362-2590512,chr16,2590362,2590512,0,86540099
HepG2|chr16:89158178-89158282,chr16,89158178,89158282,HepG2|chr16:22448198-22448227,chr16,22448198,22448227,0,66709980
HepG2|chr16:89225884-89226034,chr16,89225884,89226034,HepG2|chr16:15073143-15073263,chr16,15073143,15073263,0,74152741
HepG2|chr16:89229738-89229888,chr16,89229738,89229888,HepG2|chr16:75497186-75497336,chr16,75497186,75497336,0,13732552
HepG2|chr16:89285373-89285523,chr16,89285373,89285523,HepG2|chr16:2590047-2590194,chr16,2590047,2590194,0,86695326
HepG2|chr16:89306446-89306558,chr16,89306446,89306558,HepG2|chr16:19122827-19122862,chr16,19122827,19122862,0,70183619
HepG2|chr16:89531293-89531443,chr16,89531293,89531443,HepG2|chr16:2590036-2590186,chr16,2590036,2590186,0,86941257
HepG2|chr16:89565824-89565870,chr16,89565824,89565870,HepG2|chr16:15008690-15008840,chr16,15008690,15008840,0,74557134
HepG2|chr16:89577460-89577539,chr16,89577460,89577539,HepG2|chr16:87899763-87899845,chr16,87899763,87899845,0,1677697
HepG2|chr16:89952069-89952218,chr16,89952069,89952218,HepG2|chr16:15071944-15072094,chr16,15071944,15072094,0,74880125
HepG2|chr16:90033655-90033799,chr16,90033655,90033799,HepG2|chr16:2589784-2589934,chr16,2589784,2589934,0,87443871
HepG2|chr16:90097341-90097439,chr16,90097341,90097439,HepG2|chr16:18937922-18937974,chr16,18937922,18937974,0,71159419
HepG2|chr16:90151222-90151241,chr16,90151222,90151241,HepG2|chr16:88634184-88634244,chr16,88634184,88634244,0,1517038
HepG2|chr16:90258699-90258807,chr16,90258699,90258807,HepG2|chr16:3032807-3032880,chr16,3032807,3032880,0,87225892
HepG2|chr17:61590-61740,chr17,61590,61740,HepG2|chr17:62915436-62915570,chr17,62915436,62915570,0,62853846
HepG2|chr17:123599-123733,chr17,123599,123733,HepG2|chr17:62915925-62915968,chr17,62915925,62915968,0,62792326
HepG2|chr17:326177-326301,chr17,326177,326301,HepG2|chr17:40576999-40577080,chr17,40576999,40577080,0,40250822
HepG2|chr17:356436-356487,chr17,356436,356487,HepG2|chr17:43570304-43570373,chr17,43570304,43570373,0,43213868
HepG2|chr17:480264-480310,chr17,480264,480310,HepG2|chr17:76926315-76926347,chr17,76926315,76926347,0,76446051
HepG2|chr17:591840-591879,chr17,591840,591879,HepG2|chr17:80194728-80194839,chr17,80194728,80194839,0,79602888
HepG2|chr17:608322-608472,chr17,608322,608472,HepG2|chr17:62915754-62915900,chr17,62915754,62915900,0,62307432
HepG2|chr17:661046-661085,chr17,661046,661085,HepG2|chr17:4616127-4616238,chr17,4616127,4616238,0,3955081
HepG2|chr17:802498-802587,chr17,802498,802587,HepG2|chr17:41003143-41003161,chr17,41003143,41003161,0,40200645
HepG2|chr17:821511-821566,chr17,821511,821566,HepG2|chr17:40576999-40577080,chr17,40576999,40577080,0,39755488
HepG2|chr17:905580-905597,chr17,905580,905597,HepG2|chr17:79921808-79921910,chr17,79921808,79921910,0,79016228
HepG2|chr17:1017727-1017797,chr17,1017727,1017797,HepG2|chr17:77005132-77005243,chr17,77005132,77005243,0,75987405
HepG2|chr17:1103983-1104128,chr17,1103983,1104128,HepG2|chr17:62915431-62915523,chr17,62915431,62915523,0,61811448
HepG2|chr17:1550286-1550378,chr17,1550286,1550378,HepG2|chr17:40577023-40577080,chr17,40577023,40577080,0,39026737
HepG2|chr17:1583957-1584004,chr17,1583957,1584004,HepG2|chr17:73452030-73452130,chr17,73452030,73452130,0,71868073
HepG2|chr17:1717739-1717861,chr17,1717739,1717861,HepG2|chr17:41320976-41321001,chr17,41320976,41321001,0,39603237
HepG2|chr17:1736931-1736966,chr17,1736931,1736966,HepG2|chr17:60549413-60549558,chr17,60549413,60549558,0,58812482
HepG2|chr17:1821190-1821306,chr17,1821190,1821306,HepG2|chr17:79759465-79759507,chr17,79759465,79759507,0,77938275
HepG2|chr17:2046959-2046997,chr17,2046959,2046997,HepG2|chr17:6602978-6603071,chr17,6602978,6603071,0,4556019
HepG2|chr17:2083830-2083854,chr17,2083830,2083854,HepG2|chr17:8278247-8278283,chr17,8278247,8278283,0,6194417
HepG2|chr17:2325672-2325817,chr17,2325672,2325817,HepG2|chr17:62918768-62918883,chr17,62918768,62918883,0,60593096
HepG2|chr17:2398254-2398404,chr17,2398254,2398404,HepG2|chr17:7833642-7833681,chr17,7833642,7833681,0,5435388
HepG2|chr17:2569201-2569322,chr17,2569201,2569322,HepG2|chr17:79759465-79759584,chr17,79759465,79759584,0,77190264
HepG2|chr17:2606055-2606073,chr17,2606055,2606073,HepG2|chr17:79759465-79759584,chr17,79759465,79759584,0,77153410
HepG2|chr17:2659838-2659907,chr17,2659838,2659907,HepG2|chr17:62916169-62916250,chr17,62916169,62916250,0,60256331
HepG2|chr17:2746661-2746768,chr17,2746661,2746768,HepG2|chr17:7833642-7833681,chr17,7833642,7833681,0,5086981
HepG2|chr17:2855802-2855861,chr17,2855802,2855861,HepG2|chr17:16942916-16943026,chr17,16942916,16943026,0,14087114
HepG2|chr17:3024785-3024900,chr17,3024785,3024900,HepG2|chr17:79759465-79759500,chr17,79759465,79759500,0,76734680
HepG2|chr17:3133820-3133930,chr17,3133820,3133930,HepG2|chr17:62915395-62915538,chr17,62915395,62915538,0,59781575
HepG2|chr17:3136625-3136693,chr17,3136625,3136693,HepG2|chr17:57969931-57970013,chr17,57969931,57970013,0,54833306
HepG2|chr17:3487320-3487443,chr17,3487320,3487443,HepG2|chr17:60142725-60142752,chr17,60142725,60142752,0,56655405
HepG2|chr17:3515813-3515873,chr17,3515813,3515873,HepG2|chr17:40575671-40575760,chr17,40575671,40575760,0,37059858
HepG2|chr17:3572674-3572735,chr17,3572674,3572735,HepG2|chr17:19549541-19549628,chr17,19549541,19549628,0,15976867
HepG2|chr17:3663187-3663229,chr17,3663187,3663229,HepG2|chr17:41129340-41129417,chr17,41129340,41129417,0,37466153
HepG2|chr17:3722006-3722052,chr17,3722006,3722052,HepG2|chr17:76926315-76926347,chr17,76926315,76926347,0,73204309
HepG2|chr17:3867440-3867544,chr17,3867440,3867544,HepG2|chr17:7833642-7833681,chr17,7833642,7833681,0,3966202
HepG2|chr17:3898493-3898573,chr17,3898493,3898573,HepG2|chr17:80290507-80290580,chr17,80290507,80290580,0,76392014
HepG2|chr17:4205240-4205299,chr17,4205240,4205299,HepG2|chr17:19549541-19549628,chr17,19549541,19549628,0,15344301
HepG2|chr17:4276796-4276835,chr17,4276796,4276835,HepG2|chr17:77005132-77005243,chr17,77005132,77005243,0,72728336
HepG2|chr17:4327214-4327299,chr17,4327214,4327299,HepG2|chr17:73454368-73454433,chr17,73454368,73454433,0,69127154
HepG2|chr17:4483468-4483511,chr17,4483468,4483511,HepG2|chr17:57969931-57970038,chr17,57969931,57970038,0,53486463
HepG2|chr17:4542552-4542570,chr17,4542552,4542570,HepG2|chr17:80290448-80290580,chr17,80290448,80290580,0,75747896
HepG2|chr17:4588121-4588230,chr17,4588121,4588230,HepG2|chr17:29336284-29336325,chr17,29336284,29336325,0,24748163
HepG2|chr17:4597654-4597759,chr17,4597654,4597759,HepG2|chr17:80290535-80290580,chr17,80290535,80290580,0,75692881
HepG2|chr17:4881205-4881352,chr17,4881205,4881352,HepG2|chr17:60549417-60549563,chr17,60549417,60549563,0,55668212
HepG2|chr17:5101732-5101805,chr17,5101732,5101805,HepG2|chr17:71188310-71188361,chr17,71188310,71188361,0,66086578
HepG2|chr17:5115222-5115346,chr17,5115222,5115346,HepG2|chr17:40576999-40577080,chr17,40576999,40577080,0,35461777
HepG2|chr17:5159929-5160001,chr17,5159929,5160001,HepG2|chr17:62915431-62915519,chr17,62915431,62915519,0,57755502
HepG2|chr17:5352210-5352293,chr17,5352210,5352293,HepG2|chr17:35853859-35853926,chr17,35853859,35853926,0,30501649
HepG2|chr17:5705036-5705093,chr17,5705036,5705093,HepG2|chr17:40575671-40575760,chr17,40575671,40575760,0,34870635
HepG2|chr17:5745557-5745651,chr17,5745557,5745651,HepG2|chr17:40577024-40577080,chr17,40577024,40577080,0,34831467
HepG2|chr17:5874897-5875031,chr17,5874897,5875031,HepG2|chr17:73454368-73454433,chr17,73454368,73454433,0,67579471
HepG2|chr17:5936599-5936640,chr17,5936599,5936640,HepG2|chr17:6602978-6603067,chr17,6602978,6603067,0,666379
HepG2|chr17:6276961-6276989,chr17,6276961,6276989,HepG2|chr17:40580073-40580195,chr17,40580073,40580195,0,34303112
HepG2|chr17:6279950-6280020,chr17,6279950,6280020,HepG2|chr17:40580341-40580471,chr17,40580341,40580471,0,34300391
HepG2|chr17:6306240-6306290,chr17,6306240,6306290,HepG2|chr17:79759465-79759537,chr17,79759465,79759537,0,73453225
HepG2|chr17:6307184-6307333,chr17,6307184,6307333,HepG2|chr17:62917327-62917410,chr17,62917327,62917410,0,56610143
HepG2|chr17:6346672-6346822,chr17,6346672,6346822,HepG2|chr17:62915431-62915576,chr17,62915431,62915576,0,56568759
HepG2|chr17:6425926-6426036,chr17,6425926,6426036,HepG2|chr17:4610971-4611011,chr17,4610971,4611011,0,1814955
HepG2|chr17:6625486-6625597,chr17,6625486,6625597,HepG2|chr17:7382014-7382053,chr17,7382014,7382053,0,756528
HepG2|chr17:6637199-6637349,chr17,6637199,6637349,HepG2|chr17:62915389-62915539,chr17,62915389,62915539,0,56278190
HepG2|chr17:6867616-6867681,chr17,6867616,6867681,HepG2|chr17:79759461-79759488,chr17,79759461,79759488,0,72891845
HepG2|chr17:6965861-6965937,chr17,6965861,6965937,HepG2|chr17:62916130-62916250,chr17,62916130,62916250,0,55950269
HepG2|chr17:6982553-6982635,chr17,6982553,6982635,HepG2|chr17:62916191-62916250,chr17,62916191,62916250,0,55933638
HepG2|chr17:7071340-7071487,chr17,7071340,7071487,HepG2|chr17:33899360-33899507,chr17,33899360,33899507,0,26828020
HepG2|chr17:7214566-7214612,chr17,7214566,7214612,HepG2|chr17:39932722-39932855,chr17,39932722,39932855,0,32718156
HepG2|chr17:7262350-7262482,chr17,7262350,7262482,HepG2|chr17:7833642-7833681,chr17,7833642,7833681,0,571292
HepG2|chr17:7446819-7446949,chr17,7446819,7446949,HepG2|chr17:3601635-3601653,chr17,3601635,3601653,0,3845184
HepG2|chr17:7505560-7505591,chr17,7505560,7505591,HepG2|chr17:79759465-79759584,chr17,79759465,79759584,0,72253905
HepG2|chr17:7577209-7577354,chr17,7577209,7577354,HepG2|chr17:41320976-41321001,chr17,41320976,41321001,0,33743767
HepG2|chr17:7623201-7623231,chr17,7623201,7623231,HepG2|chr17:60700530-60700667,chr17,60700530,60700667,0,53077329
HepG2|chr17:7928268-7928394,chr17,7928268,7928394,HepG2|chr17:62657641-62657750,chr17,62657641,62657750,0,54729373
HepG2|chr17:7941028-7941099,chr17,7941028,7941099,HepG2|chr17:19549874-19549923,chr17,19549874,19549923,0,11608846
HepG2|chr17:7971687-7971746,chr17,7971687,7971746,HepG2|chr17:40575678-40575760,chr17,40575678,40575760,0,32603991
HepG2|chr17:7975891-7975941,chr17,7975891,7975941,HepG2|chr17:6602978-6603071,chr17,6602978,6603071,0,1372913
HepG2|chr17:8013695-8013732,chr17,8013695,8013732,HepG2|chr17:43567663-43567813,chr17,43567663,43567813,0,35553968
HepG2|chr17:8133685-8133814,chr17,8133685,8133814,HepG2|chr17:43572642-43572732,chr17,43572642,43572732,0,35438957
HepG2|chr17:8145741-8145886,chr17,8145741,8145886,HepG2|chr17:62915431-62915523,chr17,62915431,62915523,0,54769690
HepG2|chr17:8146977-8147127,chr17,8146977,8147127,HepG2|chr17:79759465-79759539,chr17,79759465,79759539,0,71612488
HepG2|chr17:8160542-8160588,chr17,8160542,8160588,HepG2|chr17:39932722-39932855,chr17,39932722,39932855,0,31772180
HepG2|chr17:8272118-8272258,chr17,8272118,8272258,HepG2|chr17:29336387-29336537,chr17,29336387,29336537,0,21064269
HepG2|chr17:8415543-8415644,chr17,8415543,8415644,HepG2|chr17:7833642-7833679,chr17,7833642,7833679,0,581901
HepG2|chr17:8418101-8418165,chr17,8418101,8418165,HepG2|chr17:75317414-75317478,chr17,75317414,75317478,0,66899313
HepG2|chr17:8514287-8514437,chr17,8514287,8514437,HepG2|chr17:62915754-62915900,chr17,62915754,62915900,0,54401467
HepG2|chr17:8551427-8551448,chr17,8551427,8551448,HepG2|chr17:80290451-80290580,chr17,80290451,80290580,0,71739024
HepG2|chr17:8562401-8562551,chr17,8562401,8562551,HepG2|chr17:8096414-8096528,chr17,8096414,8096528,0,465987
HepG2|chr17:8632764-8632861,chr17,8632764,8632861,HepG2|chr17:40577040-40577080,chr17,40577040,40577080,0,31944276
HepG2|chr17:8655208-8655264,chr17,8655208,8655264,HepG2|chr17:62657708-62657858,chr17,62657708,62657858,0,54002500
HepG2|chr17:8752255-8752338,chr17,8752255,8752338,HepG2|chr17:62657504-62657654,chr17,62657504,62657654,0,53905249
HepG2|chr17:8766617-8766747,chr17,8766617,8766747,HepG2|chr17:79305556-79305573,chr17,79305556,79305573,0,70538939
HepG2|chr17:8785072-8785222,chr17,8785072,8785222,HepG2|chr17:62915825-62915975,chr17,62915825,62915975,0,54130753
HepG2|chr17:8792401-8792474,chr17,8792401,8792474,HepG2|chr17:17203927-17204004,chr17,17203927,17204004,0,8411526
HepG2|chr17:9015113-9015203,chr17,9015113,9015203,HepG2|chr17:57969931-57969991,chr17,57969931,57969991,0,48954818
HepG2|chr17:9131898-9132038,chr17,9131898,9132038,HepG2|chr17:80290460-80290580,chr17,80290460,80290580,0,71158562
HepG2|chr17:9399540-9399644,chr17,9399540,9399644,HepG2|chr17:62915431-62915538,chr17,62915431,62915538,0,53515891
HepG2|chr17:9746731-9746801,chr17,9746731,9746801,HepG2|chr17:79759461-79759572,chr17,79759461,79759572,0,70012730
HepG2|chr17:9914290-9914311,chr17,9914290,9914311,HepG2|chr17:80290451-80290580,chr17,80290451,80290580,0,70376161
HepG2|chr17:10617401-10617444,chr17,10617401,10617444,HepG2|chr17:80290493-80290580,chr17,80290493,80290580,0,69673092
HepG2|chr17:10668046-10668196,chr17,10668046,10668196,HepG2|chr17:42832587-42832617,chr17,42832587,42832617,0,32164541
HepG2|chr17:10668285-10668385,chr17,10668285,10668385,HepG2|chr17:79759461-79759537,chr17,79759461,79759537,0,69091176
HepG2|chr17:10724025-10724069,chr17,10724025,10724069,HepG2|chr17:80290506-80290580,chr17,80290506,80290580,0,69566481
HepG2|chr17:10743155-10743206,chr17,10743155,10743206,HepG2|chr17:38293577-38293727,chr17,38293577,38293727,0,27550422
HepG2|chr17:10756102-10756153,chr17,10756102,10756153,HepG2|chr17:4456397-4456490,chr17,4456397,4456490,0,6299705
HepG2|chr17:10795830-10795980,chr17,10795830,10795980,HepG2|chr17:57970945-57971074,chr17,57970945,57971074,0,47175115
HepG2|chr17:10969851-10969895,chr17,10969851,10969895,HepG2|chr17:76491430-76491535,chr17,76491430,76491535,0,65521579
HepG2|chr17:10973111-10973162,chr17,10973111,10973162,HepG2|chr17:7382014-7382053,chr17,7382014,7382053,0,3591097
HepG2|chr17:11040992-11041104,chr17,11040992,11041104,HepG2|chr17:1550429-1550467,chr17,1550429,1550467,0,9490563
HepG2|chr17:11139991-11140056,chr17,11139991,11140056,HepG2|chr17:79759461-79759488,chr17,79759461,79759488,0,68619470
HepG2|chr17:11280454-11280491,chr17,11280454,11280491,HepG2|chr17:79759461-79759548,chr17,79759461,79759548,0,68479007
HepG2|chr17:11295618-11295694,chr17,11295618,11295694,HepG2|chr17:8095775-8095818,chr17,8095775,8095818,0,3199843
HepG2|chr17:11313475-11313537,chr17,11313475,11313537,HepG2|chr17:16942916-16943004,chr17,16942916,16943004,0,5629441
HepG2|chr17:11399132-11399243,chr17,11399132,11399243,HepG2|chr17:57969931-57969970,chr17,57969931,57969970,0,46570799
HepG2|chr17:11417244-11417308,chr17,11417244,11417308,HepG2|chr17:75317414-75317478,chr17,75317414,75317478,0,63900170
HepG2|chr17:11424811-11424923,chr17,11424811,11424923,HepG2|chr17:39931016-39931054,chr17,39931016,39931054,0,28506205
HepG2|chr17:11568974-11569097,chr17,11568974,11569097,HepG2|chr17:60142725-60142752,chr17,60142725,60142752,0,48573751
HepG2|chr17:11729161-11729250,chr17,11729161,11729250,HepG2|chr17:41003143-41003161,chr17,41003143,41003161,0,29273982
HepG2|chr17:11761046-11761105,chr17,11761046,11761105,HepG2|chr17:28256726-28256817,chr17,28256726,28256817,0,16495680
HepG2|chr17:11924675-11924725,chr17,11924675,11924725,HepG2|chr17:79759507-79759656,chr17,79759507,79759656,0,67834832
HepG2|chr17:11994241-11994391,chr17,11994241,11994391,HepG2|chr17:80290535-80290580,chr17,80290535,80290580,0,68296294
HepG2|chr17:12190457-12190507,chr17,12190457,12190507,HepG2|chr17:79759507-79759656,chr17,79759507,79759656,0,67569050
HepG2|chr17:12207722-12207797,chr17,12207722,12207797,HepG2|chr17:79759465-79759537,chr17,79759465,79759537,0,67551743
HepG2|chr17:12250378-12250428,chr17,12250378,12250428,HepG2|chr17:62916023-62916152,chr17,62916023,62916152,0,50665645
HepG2|chr17:12394616-12394706,chr17,12394616,12394706,HepG2|chr17:16942916-16942987,chr17,16942916,16942987,0,4548300
HepG2|chr17:12446835-12446980,chr17,12446835,12446980,HepG2|chr17:62915432-62915570,chr17,62915432,62915570,0,50468597
HepG2|chr17:12660717-12660864,chr17,12660717,12660864,HepG2|chr17:16942916-16942990,chr17,16942916,16942990,0,4282199
HepG2|chr17:12911484-12911525,chr17,12911484,12911525,HepG2|chr17:41129340-41129419,chr17,41129340,41129419,0,28217856
HepG2|chr17:13039300-13039375,chr17,13039300,13039375,HepG2|chr17:80290303-80290453,chr17,80290303,80290453,0,67251003
HepG2|chr17:13178312-13178378,chr17,13178312,13178378,HepG2|chr17:62916166-62916250,chr17,62916166,62916250,0,49737854
HepG2|chr17:13447264-13447370,chr17,13447264,13447370,HepG2|chr17:57969931-57969970,chr17,57969931,57969970,0,44522667
HepG2|chr17:13499195-13499246,chr17,13499195,13499246,HepG2|chr17:38293577-38293727,chr17,38293577,38293727,0,24794382
HepG2|chr17:13693836-13693888,chr17,13693836,13693888,HepG2|chr17:40576982-40577080,chr17,40576982,40577080,0,26883146
HepG2|chr17:13843912-13843941,chr17,13843912,13843941,HepG2|chr17:4618713-4618813,chr17,4618713,4618813,0,9225199
HepG2|chr17:14055490-14055510,chr17,14055490,14055510,HepG2|chr17:40580341-40580471,chr17,40580341,40580471,0,26524851
HepG2|chr17:14087785-14087873,chr17,14087785,14087873,HepG2|chr17:57969931-57969978,chr17,57969931,57969978,0,43882146
HepG2|chr17:14102439-14102512,chr17,14102439,14102512,HepG2|chr17:16942916-16942990,chr17,16942916,16942990,0,2840477
HepG2|chr17:14396221-14396334,chr17,14396221,14396334,HepG2|chr17:7833639-7833676,chr17,7833639,7833676,0,6562582
HepG2|chr17:14480587-14480658,chr17,14480587,14480658,HepG2|chr17:71188310-71188361,chr17,71188310,71188361,0,56707723
HepG2|chr17:14547503-14547653,chr17,14547503,14547653,HepG2|chr17:1550430-1550471,chr17,1550430,1550471,0,12997073
HepG2|chr17:14617782-14617886,chr17,14617782,14617886,HepG2|chr17:57969931-57969974,chr17,57969931,57969974,0,43352149
HepG2|chr17:14643088-14643131,chr17,14643088,14643131,HepG2|chr17:80290493-80290580,chr17,80290493,80290580,0,65647405
HepG2|chr17:14810282-14810432,chr17,14810282,14810432,HepG2|chr17:62915752-62915902,chr17,62915752,62915902,0,48105470
HepG2|chr17:14855325-14855410,chr17,14855325,14855410,HepG2|chr17:4456392-4456491,chr17,4456392,4456491,0,10398933
HepG2|chr17:14859648-14859683,chr17,14859648,14859683,HepG2|chr17:79759465-79759587,chr17,79759465,79759587,0,64899817
HepG2|chr17:14938483-14938592,chr17,14938483,14938592,HepG2|chr17:35853859-35853926,chr17,35853859,35853926,0,20915376
HepG2|chr17:14952338-14952426,chr17,14952338,14952426,HepG2|chr17:8105619-8105648,chr17,8105619,8105648,0,6846719
HepG2|chr17:14984265-14984382,chr17,14984265,14984382,HepG2|chr17:28256546-28256579,chr17,28256546,28256579,0,13272281
HepG2|chr17:15092066-15092181,chr17,15092066,15092181,HepG2|chr17:57969931-57970013,chr17,57969931,57970013,0,42877865
HepG2|chr17:15193009-15193065,chr17,15193009,15193065,HepG2|chr17:77706759-77706830,chr17,77706759,77706830,0,62513750
HepG2|chr17:15366661-15366786,chr17,15366661,15366786,HepG2|chr17:43572737-43572887,chr17,43572737,43572887,0,28206076
HepG2|chr17:15373464-15373577,chr17,15373464,15373577,HepG2|chr17:43572704-43572851,chr17,43572704,43572851,0,28199240
HepG2|chr17:15411361-15411412,chr17,15411361,15411412,HepG2|chr17:57969931-57970022,chr17,57969931,57970022,0,42558570
HepG2|chr17:15457562-15457711,chr17,15457562,15457711,HepG2|chr17:42832587-42832617,chr17,42832587,42832617,0,27375025
HepG2|chr17:15579731-15579816,chr17,15579731,15579816,HepG2|chr17:4456392-4456491,chr17,4456392,4456491,0,11123339
HepG2|chr17:15585622-15585662,chr17,15585622,15585662,HepG2|chr17:57969931-57970041,chr17,57969931,57970041,0,42384309
HepG2|chr17:15630051-15630071,chr17,15630051,15630071,HepG2|chr17:40580341-40580471,chr17,40580341,40580471,0,24950290
HepG2|chr17:15653985-15654065,chr17,15653985,15654065,HepG2|chr17:80290507-80290580,chr17,80290507,80290580,0,64636522
HepG2|chr17:15664157-15664265,chr17,15664157,15664265,HepG2|chr17:79759465-79759507,chr17,79759465,79759507,0,64095308
HepG2|chr17:15783933-15784034,chr17,15783933,15784034,HepG2|chr17:6940680-6940807,chr17,6940680,6940807,0,8843253
HepG2|chr17:16041802-16041918,chr17,16041802,16041918,HepG2|chr17:66193037-66193085,chr17,66193037,66193085,0,50151235
HepG2|chr17:16165578-16165655,chr17,16165578,16165655,HepG2|chr17:62915431-62915514,chr17,62915431,62915514,0,46749853
HepG2|chr17:16326223-16326275,chr17,16326223,16326275,HepG2|chr17:57969479-57969629,chr17,57969479,57969629,0,41643256
HepG2|chr17:16328468-16328520,chr17,16328468,16328520,HepG2|chr17:40576982-40577080,chr17,40576982,40577080,0,24248514
HepG2|chr17:16546242-16546260,chr17,16546242,16546260,HepG2|chr17:79759537-79759626,chr17,79759537,79759626,0,63213295
HepG2|chr17:16553243-16553314,chr17,16553243,16553314,HepG2|chr17:73107426-73107505,chr17,73107426,73107505,0,56554183
HepG2|chr17:16736125-16736179,chr17,16736125,16736179,HepG2|chr17:62915291-62915333,chr17,62915291,62915333,0,46179166
HepG2|chr17:16899073-16899177,chr17,16899073,16899177,HepG2|chr17:7833642-7833679,chr17,7833642,7833679,0,9065431
HepG2|chr17:16964850-16964923,chr17,16964850,16964923,HepG2|chr17:71188310-71188361,chr17,71188310,71188361,0,54223460
HepG2|chr17:17095109-17095146,chr17,17095109,17095146,HepG2|chr17:79759461-79759548,chr17,79759461,79759548,0,62664352
HepG2|chr17:17208196-17208282,chr17,17208196,17208282,HepG2|chr17:74705629-74705753,chr17,74705629,74705753,0,57497433
HepG2|chr17:17343882-17344017,chr17,17343882,17344017,HepG2|chr17:36453770-36453913,chr17,36453770,36453913,0,19109888
HepG2|chr17:17357287-17357362,chr17,17357287,17357362,HepG2|chr17:80290303-80290453,chr17,80290303,80290453,0,62933016
HepG2|chr17:17502696-17502782,chr17,17502696,17502782,HepG2|chr17:73455220-73455370,chr17,73455220,73455370,0,55952524
HepG2|chr17:17575106-17575219,chr17,17575106,17575219,HepG2|chr17:62488938-62488975,chr17,62488938,62488975,0,44913832
HepG2|chr17:17595875-17595926,chr17,17595875,17595926,HepG2|chr17:73081842-73081989,chr17,73081842,73081989,0,55485967
HepG2|chr17:17634363-17634464,chr17,17634363,17634464,HepG2|chr17:7833642-7833679,chr17,7833642,7833679,0,9800721
HepG2|chr17:17794135-17794180,chr17,17794135,17794180,HepG2|chr17:73455569-73455718,chr17,73455569,73455718,0,55661434
HepG2|chr17:17809670-17809691,chr17,17809670,17809691,HepG2|chr17:80290451-80290580,chr17,80290451,80290580,0,62480781
HepG2|chr17:17880890-17881000,chr17,17880890,17881000,HepG2|chr17:79759461-79759523,chr17,79759461,79759523,0,61878571
HepG2|chr17:17885845-17885949,chr17,17885845,17885949,HepG2|chr17:79759542-79759585,chr17,79759542,79759585,0,61873697
HepG2|chr17:17941869-17941900,chr17,17941869,17941900,HepG2|chr17:79759465-79759584,chr17,79759465,79759584,0,61817596
HepG2|chr17:17981915-17981979,chr17,17981915,17981979,HepG2|chr17:73452030-73452130,chr17,73452030,73452130,0,55470115
HepG2|chr17:18026706-18026833,chr17,18026706,18026833,HepG2|chr17:40167162-40167298,chr17,40167162,40167298,0,22140456
HepG2|chr17:18036258-18036378,chr17,18036258,18036378,HepG2|chr17:80290553-80290580,chr17,80290553,80290580,0,62254295
HepG2|chr17:18111513-18111638,chr17,18111513,18111638,HepG2|chr17:43572737-43572887,chr17,43572737,43572887,0,25461224
HepG2|chr17:18155288-18155434,chr17,18155288,18155434,HepG2|chr17:3631919-3632011,chr17,3631919,3632011,0,14523369
HepG2|chr17:18390074-18390194,chr17,18390074,18390194,HepG2|chr17:7382014-7382053,chr17,7382014,7382053,0,11008060
HepG2|chr17:18398251-18398401,chr17,18398251,18398401,HepG2|chr17:28256546-28256579,chr17,28256546,28256579,0,9858295
HepG2|chr17:18403121-18403178,chr17,18403121,18403178,HepG2|chr17:8095701-8095818,chr17,8095701,8095818,0,10307420
HepG2|chr17:18469472-18469512,chr17,18469472,18469512,HepG2|chr17:16942916-16943026,chr17,16942916,16943026,0,1526556
HepG2|chr17:18517581-18517620,chr17,18517581,18517620,HepG2|chr17:41129340-41129417,chr17,41129340,41129417,0,22611759
HepG2|chr17:18553685-18553771,chr17,18553685,18553771,HepG2|chr17:62915431-62915518,chr17,62915431,62915518,0,44361746
HepG2|chr17:18797833-18797961,chr17,18797833,18797961,HepG2|chr17:79886333-79886355,chr17,79886333,79886355,0,61088500
HepG2|chr17:18853689-18853766,chr17,18853689,18853766,HepG2|chr17:79759461-79759548,chr17,79759461,79759548,0,60905772
HepG2|chr17:18896586-18896700,chr17,18896586,18896700,HepG2|chr17:62915431-62915538,chr17,62915431,62915538,0,44018845
HepG2|chr17:18941223-18941249,chr17,18941223,18941249,HepG2|chr17:8095694-8095753,chr17,8095694,8095753,0,10845529
HepG2|chr17:18967756-18967855,chr17,18967756,18967855,HepG2|chr17:79759461-79759480,chr17,79759461,79759480,0,60791705
HepG2|chr17:18970271-18970329,chr17,18970271,18970329,HepG2|chr17:43570304-43570373,chr17,43570304,43570373,0,24600033
HepG2|chr17:19119970-19119994,chr17,19119970,19119994,HepG2|chr17:73083354-73083499,chr17,73083354,73083499,0,53963384
HepG2|chr17:19168170-19168245,chr17,19168170,19168245,HepG2|chr17:77005132-77005243,chr17,77005132,77005243,0,57836962
HepG2|chr17:19207262-19207407,chr17,19207262,19207407,HepG2|chr17:65273802-65273892,chr17,65273802,65273892,0,46066540
HepG2|chr17:19346123-19346211,chr17,19346123,19346211,HepG2|chr17:57969931-57969978,chr17,57969931,57969978,0,38623808
HepG2|chr17:19358868-19358920,chr17,19358868,19358920,HepG2|chr17:79759465-79759584,chr17,79759465,79759584,0,60400597
HepG2|chr17:19398046-19398136,chr17,19398046,19398136,HepG2|chr17:40576982-40577080,chr17,40576982,40577080,0,21178936
HepG2|chr17:19526765-19526835,chr17,19526765,19526835,HepG2|chr17:40580341-40580471,chr17,40580341,40580471,0,21053576
HepG2|chr17:19568399-19568496,chr17,19568399,19568496,HepG2|chr17:40577040-40577080,chr17,40577040,40577080,0,21008641
HepG2|chr17:19723805-19723955,chr17,19723805,19723955,HepG2|chr17:62915635-62915782,chr17,62915635,62915782,0,43191830
HepG2|chr17:19825207-19825236,chr17,19825207,19825236,HepG2|chr17:4618713-4618813,chr17,4618713,4618813,0,15206494
HepG2|chr17:19902594-19902680,chr17,19902594,19902680,HepG2|chr17:77005132-77005243,chr17,77005132,77005243,0,57102538
HepG2|chr17:19952384-19952468,chr17,19952384,19952468,HepG2|chr17:80290517-80290580,chr17,80290517,80290580,0,60338133
HepG2|chr17:20039131-20039261,chr17,20039131,20039261,HepG2|chr17:7382014-7382053,chr17,7382014,7382053,0,12657117
HepG2|chr17:20099754-20099782,chr17,20099754,20099782,HepG2|chr17:79759465-79759587,chr17,79759465,79759587,0,59659711
HepG2|chr17:20198010-20198093,chr17,20198010,20198093,HepG2|chr17:62657504-62657654,chr17,62657504,62657654,0,42459494
HepG2|chr17:20290713-20290742,chr17,20290713,20290742,HepG2|chr17:72980696-72980846,chr17,72980696,72980846,0,52689983
HepG2|chr17:20371987-20372137,chr17,20371987,20372137,HepG2|chr17:39931016-39931054,chr17,39931016,39931054,0,19559029
HepG2|chr17:20538555-20538618,chr17,20538555,20538618,HepG2|chr17:57971859-57971939,chr17,57971859,57971939,0,37433304
HepG2|chr17:20578264-20578302,chr17,20578264,20578302,HepG2|chr17:57969931-57970040,chr17,57969931,57970040,0,37391667
HepG2|chr17:20589578-20589692,chr17,20589578,20589692,HepG2|chr17:36453701-36453815,chr17,36453701,36453815,0,15864123
HepG2|chr17:20596376-20596434,chr17,20596376,20596434,HepG2|chr17:43570304-43570373,chr17,43570304,43570373,0,22973928
HepG2|chr17:20741532-20741682,chr17,20741532,20741682,HepG2|chr17:62915765-62915912,chr17,62915765,62915912,0,42174233
HepG2|chr17:20741885-20742035,chr17,20741885,20742035,HepG2|chr17:80290535-80290580,chr17,80290535,80290580,0,59548650
HepG2|chr17:20761031-20761052,chr17,20761031,20761052,HepG2|chr17:63556481-63556501,chr17,63556481,63556501,0,42795450
HepG2|chr17:20854687-20854761,chr17,20854687,20854761,HepG2|chr17:72980668-72980745,chr17,72980668,72980745,0,52125981
HepG2|chr17:20894084-20894174,chr17,20894084,20894174,HepG2|chr17:57969931-57969991,chr17,57969931,57969991,0,37075847
HepG2|chr17:20973676-20973787,chr17,20973676,20973787,HepG2|chr17:7382014-7382053,chr17,7382014,7382053,0,13591662
HepG2|chr17:21005236-21005352,chr17,21005236,21005352,HepG2|chr17:79759465-79759507,chr17,79759465,79759507,0,58754229
HepG2|chr17:21286139-21286289,chr17,21286139,21286289,HepG2|chr17:42832587-42832617,chr17,42832587,42832617,0,21546448
HepG2|chr17:21457442-21457546,chr17,21457442,21457546,HepG2|chr17:62915431-62915538,chr17,62915431,62915538,0,41457989
HepG2|chr17:21539960-21540103,chr17,21539960,21540103,HepG2|chr17:75317356-75317418,chr17,75317356,75317418,0,53777396
HepG2|chr17:21577825-21577955,chr17,21577825,21577955,HepG2|chr17:38274577-38274610,chr17,38274577,38274610,0,16696752
HepG2|chr17:21580911-21580961,chr17,21580911,21580961,HepG2|chr17:79759465-79759537,chr17,79759465,79759537,0,58178554
HepG2|chr17:21742088-21742238,chr17,21742088,21742238,HepG2|chr17:57970945-57971074,chr17,57970945,57971074,0,36228857
HepG2|chr17:21986367-21986477,chr17,21986367,21986477,HepG2|chr17:57969931-57969971,chr17,57969931,57969971,0,35983564
HepG2|chr17:21988951-21989050,chr17,21988951,21989050,HepG2|chr17:40577029-40577080,chr17,40577029,40577080,0,18588078
HepG2|chr17:22109843-22109980,chr17,22109843,22109980,HepG2|chr17:79759461-79759486,chr17,79759461,79759486,0,57649618
HepG2|chr17:22159020-22159142,chr17,22159020,22159142,HepG2|chr17:80194728-80194839,chr17,80194728,80194839,0,58035708
HepG2|chr17:22166023-22166138,chr17,22166023,22166138,HepG2|chr17:57969931-57970013,chr17,57969931,57970013,0,35803908
HepG2|chr17:22316150-22316267,chr17,22316150,22316267,HepG2|chr17:29336284-29336325,chr17,29336284,29336325,0,7020134
HepG2|chr17:22329182-22329246,chr17,22329182,22329246,HepG2|chr17:57969931-57970017,chr17,57969931,57970017,0,35640749
HepG2|chr17:22466489-22466522,chr17,22466489,22466522,HepG2|chr17:8095660-8095810,chr17,8095660,8095810,0,14370829
HepG2|chr17:22614674-22614745,chr17,22614674,22614745,HepG2|chr17:79759461-79759537,chr17,79759461,79759537,0,57144787
HepG2|chr17:22770925-22770964,chr17,22770925,22770964,HepG2|chr17:80290460-80290571,chr17,80290460,80290571,0,57519535
HepG2|chr17:22844171-22844301,chr17,22844171,22844301,HepG2|chr17:7382014-7382053,chr17,7382014,7382053,0,15462157
HepG2|chr17:22925666-22925747,chr17,22925666,22925747,HepG2|chr17:1550429-1550470,chr17,1550429,1550470,0,21375237
HepG2|chr17:22927332-22927463,chr17,22927332,22927463,HepG2|chr17:65273799-65273893,chr17,65273799,65273893,0,42346467
HepG2|chr17:23049802-23049859,chr17,23049802,23049859,HepG2|chr17:38221511-38221604,chr17,38221511,38221604,0,15171709
HepG2|chr17:23147870-23147943,chr17,23147870,23147943,HepG2|chr17:57969931-57969978,chr17,57969931,57969978,0,34822061
HepG2|chr17:23306432-23306472,chr17,23306432,23306472,HepG2|chr17:73081829-73081937,chr17,73081829,73081937,0,49775397
HepG2|chr17:23367727-23367844,chr17,23367727,23367844,HepG2|chr17:38274577-38274610,chr17,38274577,38274610,0,14906850
HepG2|chr17:23387751-23387826,chr17,23387751,23387826,HepG2|chr17:76925161-76925236,chr17,76925161,76925236,0,53537410
HepG2|chr17:23392334-23392362,chr17,23392334,23392362,HepG2|chr17:8095649-8095799,chr17,8095649,8095799,0,15296685
HepG2|chr17:23703303-23703448,chr17,23703303,23703448,HepG2|chr17:62918768-62918883,chr17,62918768,62918883,0,39215465
HepG2|chr17:23768469-23768548,chr17,23768469,23768548,HepG2|chr17:16942916-16942987,chr17,16942916,16942987,0,6825553
HepG2|chr17:23838715-23838818,chr17,23838715,23838818,HepG2|chr17:57969931-57969973,chr17,57969931,57969973,0,34131216
HepG2|chr17:24036670-24036820,chr17,24036670,24036820,HepG2|chr17:76491738-76491861,chr17,76491738,76491861,0,52455068
HepG2|chr17:24113283-24113313,chr17,24113283,24113313,HepG2|chr17:60700530-60700667,chr17,60700530,60700667,0,36587247
HepG2|chr17:24113552-24113607,chr17,24113552,24113607,HepG2|chr17:80290518-80290580,chr17,80290518,80290580,0,56176966
HepG2|chr17:24119237-24119276,chr17,24119237,24119276,HepG2|chr17:80290460-80290571,chr17,80290460,80290571,0,56171223
HepG2|chr17:24191621-24191742,chr17,24191621,24191742,HepG2|chr17:76722982-76723132,chr17,76722982,76723132,0,52531361
HepG2|chr17:24322100-24322178,chr17,24322100,24322178,HepG2|chr17:8095755-8095818,chr17,8095755,8095818,0,16226345
HepG2|chr17:24346334-24346391,chr17,24346334,24346391,HepG2|chr17:8095701-8095818,chr17,8095701,8095818,0,16250633
HepG2|chr17:24545134-24545227,chr17,24545134,24545227,HepG2|chr17:79759461-79759518,chr17,79759461,79759518,0,55214327
HepG2|chr17:24701467-24701577,chr17,24701467,24701577,HepG2|chr17:57969931-57969971,chr17,57969931,57969971,0,33268464
HepG2|chr17:24730997-24731033,chr17,24730997,24731033,HepG2|chr17:79759465-79759500,chr17,79759465,79759500,0,55028468
HepG2|chr17:24732663-24732691,chr17,24732663,24732691,HepG2|chr17:40580073-40580195,chr17,40580073,40580195,0,15847410
HepG2|chr17:24775583-24775671,chr17,24775583,24775671,HepG2|chr17:79759461-79759523,chr17,79759461,79759523,0,54983878
HepG2|chr17:24780389-24780475,chr17,24780389,24780475,HepG2|chr17:62657607-62657756,chr17,62657607,62657756,0,37877218
HepG2|chr17:24871973-24872059,chr17,24871973,24872059,HepG2|chr17:79848098-79848135,chr17,79848098,79848135,0,54976125
HepG2|chr17:24949430-24949580,chr17,24949430,24949580,HepG2|chr17:79759542-79759585,chr17,79759542,79759585,0,54810112
HepG2|chr17:24958667-24958800,chr17,24958667,24958800,HepG2|chr17:62915431-62915575,chr17,62915431,62915575,0,37956764
HepG2|chr17:24998439-24998551,chr17,24998439,24998551,HepG2|chr17:80290517-80290580,chr17,80290517,80290580,0,55292078
HepG2|chr17:25087283-25087428,chr17,25087283,25087428,HepG2|chr17:41320976-41321001,chr17,41320976,41321001,0,16233693
HepG2|chr17:25242086-25242113,chr17,25242086,25242113,HepG2|chr17:79759464-79759603,chr17,79759464,79759603,0,54517378
HepG2|chr17:25279363-25279419,chr17,25279363,25279419,HepG2|chr17:38221511-38221604,chr17,38221511,38221604,0,12942148
HepG2|chr17:25467816-25467925,chr17,25467816,25467925,HepG2|chr17:40577024-40577080,chr17,40577024,40577080,0,15109208
HepG2|chr17:25562483-25562546,chr17,25562483,25562546,HepG2|chr17:38221511-38221604,chr17,38221511,38221604,0,12659028
HepG2|chr17:25625153-25625298,chr17,25625153,25625298,HepG2|chr17:62915432-62915570,chr17,62915432,62915570,0,37290279
HepG2|chr17:25646188-25646269,chr17,25646188,25646269,HepG2|chr17:57969930-57970076,chr17,57969930,57970076,0,32323742
HepG2|chr17:25933544-25933615,chr17,25933544,25933615,HepG2|chr17:73107426-73107505,chr17,73107426,73107505,0,47173882
HepG2|chr17:26138611-26138671,chr17,26138611,26138671,HepG2|chr17:79759465-79759524,chr17,79759465,79759524,0,53620854
HepG2|chr17:26208327-26208354,chr17,26208327,26208354,HepG2|chr17:4618690-4618793,chr17,4618690,4618793,0,21589637
HepG2|chr17:26216169-26216257,chr17,26216169,26216257,HepG2|chr17:57969354-57969400,chr17,57969354,57969400,0,31753185
HepG2|chr17:26307652-26307802,chr17,26307652,26307802,HepG2|chr17:79759542-79759585,chr17,79759542,79759585,0,53451890
HepG2|chr17:26365914-26365978,chr17,26365914,26365978,HepG2|chr17:57969931-57970017,chr17,57969931,57970017,0,31604017
HepG2|chr17:26381706-26381779,chr17,26381706,26381779,HepG2|chr17:17203927-17204004,chr17,17203927,17204004,0,9177779
HepG2|chr17:26453509-26453597,chr17,26453509,26453597,HepG2|chr17:57969354-57969400,chr17,57969354,57969400,0,31515845
HepG2|chr17:26701313-26701395,chr17,26701313,26701395,HepG2|chr17:62916191-62916250,chr17,62916191,62916250,0,36214878
HepG2|chr17:26824582-26824627,chr17,26824582,26824627,HepG2|chr17:73455569-73455718,chr17,73455569,73455718,0,46630987
HepG2|chr17:26864347-26864445,chr17,26864347,26864445,HepG2|chr17:62916110-62916170,chr17,62916110,62916170,0,36051763
HepG2|chr17:26947575-26947642,chr17,26947575,26947642,HepG2|chr17:57969931-57969993,chr17,57969931,57969993,0,31022356
HepG2|chr17:27063734-27063795,chr17,27063734,27063795,HepG2|chr17:79759460-79759507,chr17,79759460,79759507,0,52695726
HepG2|chr17:27216321-27216449,chr17,27216321,27216449,HepG2|chr17:79759482-79759632,chr17,79759482,79759632,0,52543161
HepG2|chr17:27364686-27364704,chr17,27364686,27364704,HepG2|chr17:79759465-79759584,chr17,79759465,79759584,0,52394779
HepG2|chr17:27421479-27421628,chr17,27421479,27421628,HepG2|chr17:62917327-62917410,chr17,62917327,62917410,0,35495848
HepG2|chr17:27467919-27468069,chr17,27467919,27468069,HepG2|chr17:29336385-29336535,chr17,29336385,29336535,0,1868466
HepG2|chr17:27555895-27556011,chr17,27555895,27556011,HepG2|chr17:80290460-80290571,chr17,80290460,80290571,0,52734565
HepG2|chr17:27560818-27560894,chr17,27560818,27560894,HepG2|chr17:62916130-62916250,chr17,62916130,62916250,0,35355312
HepG2|chr17:27689429-27689468,chr17,27689429,27689468,HepG2|chr17:48799789-48799904,chr17,48799789,48799904,0,21110360
HepG2|chr17:27800135-27800238,chr17,27800135,27800238,HepG2|chr17:80290533-80290580,chr17,80290533,80290580,0,52490398
HepG2|chr17:27864425-27864468,chr17,27864425,27864468,HepG2|chr17:29897401-29897508,chr17,29897401,29897508,0,2032976
HepG2|chr17:28104839-28104976,chr17,28104839,28104976,HepG2|chr17:79759461-79759486,chr17,79759461,79759486,0,51654622
HepG2|chr17:28323735-28323842,chr17,28323735,28323842,HepG2|chr17:7833642-7833681,chr17,7833642,7833681,0,20490093
HepG2|chr17:28336707-28336793,chr17,28336707,28336793,HepG2|chr17:62657607-62657756,chr17,62657607,62657756,0,34320900
HepG2|chr17:28366914-28366954,chr17,28366914,28366954,HepG2|chr17:57969931-57970041,chr17,57969931,57970041,0,29603017
HepG2|chr17:28406185-28406271,chr17,28406185,28406271,HepG2|chr17:57971859-57971939,chr17,57971859,57971939,0,29565674
HepG2|chr17:28409001-28409103,chr17,28409001,28409103,HepG2|chr17:79759461-79759488,chr17,79759461,79759488,0,51350460
HepG2|chr17:28418285-28418408,chr17,28418285,28418408,HepG2|chr17:76722982-76723132,chr17,76722982,76723132,0,48304697
HepG2|chr17:28452569-28452594,chr17,28452569,28452594,HepG2|chr17:4618819-4618879,chr17,4618819,4618879,0,23833750
HepG2|chr17:28630127-28630237,chr17,28630127,28630237,HepG2|chr17:4610971-4611011,chr17,4610971,4611011,0,24019156
HepG2|chr17:28746626-28746712,chr17,28746626,28746712,HepG2|chr17:74705629-74705753,chr17,74705629,74705753,0,45959003
HepG2|chr17:28775303-28775358,chr17,28775303,28775358,HepG2|chr17:62915431-62915538,chr17,62915431,62915538,0,34140128
HepG2|chr17:28796250-28796397,chr17,28796250,28796397,HepG2|chr17:16942916-16942990,chr17,16942916,16942990,0,11853334
HepG2|chr17:28985193-28985318,chr17,28985193,28985318,HepG2|chr17:79759461-79759486,chr17,79759461,79759486,0,50774268
HepG2|chr17:29081426-29081455,chr17,29081426,29081455,HepG2|chr17:57969663-57969736,chr17,57969663,57969736,0,28888237
HepG2|chr17:29374225-29374270,chr17,29374225,29374270,HepG2|chr17:76974353-76974496,chr17,76974353,76974496,0,47600128
HepG2|chr17:29430820-29430970,chr17,29430820,29430970,HepG2|chr17:79955352-79955392,chr17,79955352,79955392,0,50524532
HepG2|chr17:29474624-29474648,chr17,29474624,29474648,HepG2|chr17:8278247-8278283,chr17,8278247,8278283,0,21196377
HepG2|chr17:29483850-29483920,chr17,29483850,29483920,HepG2|chr17:79759461-79759541,chr17,79759461,79759541,0,50275611
HepG2|chr17:29504614-29504716,chr17,29504614,29504716,HepG2|chr17:40577035-40577080,chr17,40577035,40577080,0,11072421
HepG2|chr17:29547503-29547527,chr17,29547503,29547527,HepG2|chr17:4618671-4618811,chr17,4618671,4618811,0,24928832
HepG2|chr17:29835723-29835827,chr17,29835723,29835827,HepG2|chr17:79759461-79759507,chr17,79759461,79759507,0,49923738
HepG2|chr17:30336401-30336531,chr17,30336401,30336531,HepG2|chr17:79305556-79305573,chr17,79305556,79305573,0,48969155
HepG2|chr17:30604452-30604538,chr17,30604452,30604538,HepG2|chr17:79822988-79823135,chr17,79822988,79823135,0,49218536
HepG2|chr17:30770283-30770328,chr17,30770283,30770328,HepG2|chr17:57969931-57970040,chr17,57969931,57970040,0,27199648
HepG2|chr17:30938328-30938443,chr17,30938328,30938443,HepG2|chr17:79759461-79759523,chr17,79759461,79759523,0,48821133
HepG2|chr17:30955988-30956037,chr17,30955988,30956037,HepG2|chr17:40575719-40575760,chr17,40575719,40575760,0,9619731
HepG2|chr17:30961699-30961813,chr17,30961699,30961813,HepG2|chr17:36453701-36453815,chr17,36453701,36453815,0,5492002
HepG2|chr17:31034716-31034797,chr17,31034716,31034797,HepG2|chr17:57969930-57970076,chr17,57969930,57970076,0,26935214
HepG2|chr17:31061411-31061429,chr17,31061411,31061429,HepG2|chr17:79759537-79759626,chr17,79759537,79759626,0,48698126
HepG2|chr17:31165499-31165541,chr17,31165499,31165541,HepG2|chr17:41129340-41129417,chr17,41129340,41129417,0,9963841
HepG2|chr17:31176438-31176583,chr17,31176438,31176583,HepG2|chr17:65273802-65273892,chr17,65273802,65273892,0,34097364
HepG2|chr17:31358375-31358495,chr17,31358375,31358495,HepG2|chr17:62488938-62488975,chr17,62488938,62488975,0,31130563
HepG2|chr17:31439165-31439276,chr17,31439165,31439276,HepG2|chr17:79759461-79759537,chr17,79759461,79759537,0,48320296
HepG2|chr17:31456027-31456098,chr17,31456027,31456098,HepG2|chr17:39930555-39930630,chr17,39930555,39930630,0,8474528
HepG2|chr17:31481097-31481247,chr17,31481097,31481247,HepG2|chr17:36452432-36452518,chr17,36452432,36452518,0,4971335
HepG2|chr17:31542014-31542089,chr17,31542014,31542089,HepG2|chr17:76925161-76925236,chr17,76925161,76925236,0,45383147
HepG2|chr17:31546723-31546752,chr17,31546723,31546752,HepG2|chr17:57969663-57969736,chr17,57969663,57969736,0,26422940
HepG2|chr17:31673521-31673613,chr17,31673521,31673613,HepG2|chr17:79759461-79759509,chr17,79759461,79759509,0,48085940
HepG2|chr17:31776945-31777057,chr17,31776945,31777057,HepG2|chr17:8203079-8203163,chr17,8203079,8203163,0,23573866
HepG2|chr17:31915595-31915629,chr17,31915595,31915629,HepG2|chr17:8278245-8278283,chr17,8278245,8278283,0,23637350
HepG2|chr17:31920068-31920123,chr17,31920068,31920123,HepG2|chr17:40576999-40577080,chr17,40576999,40577080,0,8656931
HepG2|chr17:31924071-31924123,chr17,31924071,31924123,HepG2|chr17:38277477-38277627,chr17,38277477,38277627,0,6353406
HepG2|chr17:32031674-32031729,chr17,32031674,32031729,HepG2|chr17:6602978-6603045,chr17,6602978,6603045,0,25428696
HepG2|chr17:32041141-32041291,chr17,32041141,32041291,HepG2|chr17:80290451-80290580,chr17,80290451,80290580,0,48249310
HepG2|chr17:32166143-32166293,chr17,32166143,32166293,HepG2|chr17:1550430-1550471,chr17,1550430,1550471,0,30615713
HepG2|chr17:32190519-32190609,chr17,32190519,32190609,HepG2|chr17:43570440-43570590,chr17,43570440,43570590,0,11379921
HepG2|chr17:32442241-32442309,chr17,32442241,32442309,HepG2|chr17:4618837-4618899,chr17,4618837,4618899,0,27823404
HepG2|chr17:32447655-32447683,chr17,32447655,32447683,HepG2|chr17:8278246-8278283,chr17,8278246,8278283,0,24169409
HepG2|chr17:32778347-32778406,chr17,32778347,32778406,HepG2|chr17:62915309-62915422,chr17,62915309,62915422,0,30136962
HepG2|chr17:32807414-32807536,chr17,32807414,32807536,HepG2|chr17:62491962-62491990,chr17,62491962,62491990,0,29684548
HepG2|chr17:32844525-32844670,chr17,32844525,32844670,HepG2|chr17:80290461-80290580,chr17,80290461,80290580,0,47445936
HepG2|chr17:32888869-32888898,chr17,32888869,32888898,HepG2|chr17:35851219-35851340,chr17,35851219,35851340,0,2962350
HepG2|chr17:32944461-32944547,chr17,32944461,32944547,HepG2|chr17:57969366-57969408,chr17,57969366,57969408,0,25024905
HepG2|chr17:33024165-33024183,chr17,33024165,33024183,HepG2|chr17:57971614-57971716,chr17,57971614,57971716,0,24947449
HepG2|chr17:33258649-33258698,chr17,33258649,33258698,HepG2|chr17:48799355-48799505,chr17,48799355,48799505,0,15540706
HepG2|chr17:33353842-33353909,chr17,33353842,33353909,HepG2|chr17:35851219-35851340,chr17,35851219,35851340,0,2497377
HepG2|chr17:33465781-33465836,chr17,33465781,33465836,HepG2|chr17:79759465-79759548,chr17,79759465,79759548,0,46293684
HepG2|chr17:33474357-33474440,chr17,33474357,33474440,HepG2|chr17:40577013-40577080,chr17,40577013,40577080,0,7102656
HepG2|chr17:33521950-33522062,chr17,33521950,33522062,HepG2|chr17:1550429-1550467,chr17,1550429,1550467,0,31971521
HepG2|chr17:33667301-33667359,chr17,33667301,33667359,HepG2|chr17:33896999-33897128,chr17,33896999,33897128,0,229698
HepG2|chr17:34012161-34012267,chr17,34012161,34012267,HepG2|chr17:57969931-57969970,chr17,57969931,57969970,0,23957770
HepG2|chr17:34030732-34030851,chr17,34030732,34030851,HepG2|chr17:38803125-38803167,chr17,38803125,38803167,0,4772393
HepG2|chr17:34078623-34078658,chr17,34078623,34078658,HepG2|chr17:60549413-60549558,chr17,60549413,60549558,0,26470790
HepG2|chr17:34291865-34291953,chr17,34291865,34291953,HepG2|chr17:79759461-79759523,chr17,79759461,79759523,0,45467596
HepG2|chr17:34631913-34632004,chr17,34631913,34632004,HepG2|chr17:79759461-79759520,chr17,79759461,79759520,0,45127548
HepG2|chr17:34761820-34761939,chr17,34761820,34761939,HepG2|chr17:38803125-38803167,chr17,38803125,38803167,0,4041305
HepG2|chr17:34841064-34841142,chr17,34841064,34841142,HepG2|chr17:62917246-62917315,chr17,62917246,62917315,0,28076182
HepG2|chr17:34983548-34983578,chr17,34983548,34983578,HepG2|chr17:80290460-80290580,chr17,80290460,80290580,0,45306912
HepG2|chr17:35188847-35188928,chr17,35188847,35188928,HepG2|chr17:16942916-16943004,chr17,16942916,16943004,0,18245931
HepG2|chr17:35262187-35262215,chr17,35262187,35262215,HepG2|chr17:79759465-79759587,chr17,79759465,79759587,0,44497278
HepG2|chr17:35545436-35545558,chr17,35545436,35545558,HepG2|chr17:62491962-62491990,chr17,62491962,62491990,0,26946526
HepG2|chr17:35566831-35566849,chr17,35566831,35566849,HepG2|chr17:80290448-80290580,chr17,80290448,80290580,0,44723617
HepG2|chr17:35576837-35576884,chr17,35576837,35576884,HepG2|chr17:73452030-73452130,chr17,73452030,73452130,0,37875193
HepG2|chr17:35577608-35577718,chr17,35577608,35577718,HepG2|chr17:62915395-62915538,chr17,62915395,62915538,0,27337787
HepG2|chr17:35589500-35589539,chr17,35589500,35589539,HepG2|chr17:80194728-80194839,chr17,80194728,80194839,0,44605228
HepG2|chr17:35653405-35653456,chr17,35653405,35653456,HepG2|chr17:7382014-7382053,chr17,7382014,7382053,0,28271391
HepG2|chr17:35662580-35662597,chr17,35662580,35662597,HepG2|chr17:79921808-79921910,chr17,79921808,79921910,0,44259228
HepG2|chr17:35768372-35768413,chr17,35768372,35768413,HepG2|chr17:76491426-76491534,chr17,76491426,76491534,0,40723054
HepG2|chr17:35851922-35851974,chr17,35851922,35851974,HepG2|chr17:79759465-79759584,chr17,79759465,79759584,0,43907543
HepG2|chr17:35956953-35957053,chr17,35956953,35957053,HepG2|chr17:62915431-62915544,chr17,62915431,62915544,0,26958478
HepG2|chr17:36264763-36264880,chr17,36264763,36264880,HepG2|chr17:29336284-29336325,chr17,29336284,29336325,0,6928479
HepG2|chr17:36269269-36269419,chr17,36269269,36269419,HepG2|chr17:62915593-62915741,chr17,62915593,62915741,0,26646324
HepG2|chr17:36320370-36320474,chr17,36320370,36320474,HepG2|chr17:79759461-79759507,chr17,79759461,79759507,0,43439091
HepG2|chr17:36482086-36482157,chr17,36482086,36482157,HepG2|chr17:43572502-43572617,chr17,43572502,43572617,0,7090416
HepG2|chr17:36492614-36492673,chr17,36492614,36492673,HepG2|chr17:28256726-28256817,chr17,28256726,28256817,0,8235888
HepG2|chr17:36553539-36553647,chr17,36553539,36553647,HepG2|chr17:8203079-8203163,chr17,8203079,8203163,0,28350460
HepG2|chr17:36861437-36861587,chr17,36861437,36861587,HepG2|chr17:62915753-62915900,chr17,62915753,62915900,0,26054316
HepG2|chr17:36946290-36946323,chr17,36946290,36946323,HepG2|chr17:40719994-40720130,chr17,40719994,40720130,0,3773704
HepG2|chr17:36960110-36960139,chr17,36960110,36960139,HepG2|chr17:40577023-40577080,chr17,40577023,40577080,0,3616913
HepG2|chr17:37091264-37091373,chr17,37091264,37091373,HepG2|chr17:29336284-29336325,chr17,29336284,29336325,0,7754980
HepG2|chr17:37193401-37193427,chr17,37193401,37193427,HepG2|chr17:8095694-8095753,chr17,8095694,8095753,0,29097707
HepG2|chr17:37278068-37278145,chr17,37278068,37278145,HepG2|chr17:62915431-62915514,chr17,62915431,62915514,0,25637363
HepG2|chr17:37388302-37388358,chr17,37388302,37388358,HepG2|chr17:28256726-28256817,chr17,28256726,28256817,0,9131576
HepG2|chr17:37411711-37411814,chr17,37411711,37411814,HepG2|chr17:6940732-6940754,chr17,6940732,6940754,0,30470979
HepG2|chr17:37423635-37423739,chr17,37423635,37423739,HepG2|chr17:7833642-7833681,chr17,7833642,7833681,0,29589993
HepG2|chr17:37432658-37432743,chr17,37432658,37432743,HepG2|chr17:7833642-7833664,chr17,7833642,7833664,0,29599016
HepG2|chr17:37686701-37686803,chr17,37686701,37686803,HepG2|chr17:40577035-40577080,chr17,40577035,40577080,0,2890334
HepG2|chr17:37825758-37825819,chr17,37825758,37825819,HepG2|chr17:79759460-79759507,chr17,79759460,79759507,0,41933702
HepG2|chr17:37885458-37885496,chr17,37885458,37885496,HepG2|chr17:40576968-40577080,chr17,40576968,40577080,0,2691510
HepG2|chr17:37984633-37984696,chr17,37984633,37984696,HepG2|chr17:57971859-57971939,chr17,57971859,57971939,0,19987226
HepG2|chr17:38092650-38092772,chr17,38092650,38092772,HepG2|chr17:41320976-41321001,chr17,41320976,41321001,0,3228326
HepG2|chr17:38113918-38113961,chr17,38113918,38113961,HepG2|chr17:29897401-29897508,chr17,29897401,29897508,0,8216517
HepG2|chr17:38115735-38115748,chr17,38115735,38115748,HepG2|chr17:29898000-29898025,chr17,29898000,29898025,0,8217735
HepG2|chr17:38235584-38235670,chr17,38235584,38235670,HepG2|chr17:79822988-79823135,chr17,79822988,79823135,0,41587404
HepG2|chr17:38511684-38511834,chr17,38511684,38511834,HepG2|chr17:76925161-76925236,chr17,76925161,76925236,0,38413477
HepG2|chr17:38602943-38603024,chr17,38602943,38603024,HepG2|chr17:16942916-16943004,chr17,16942916,16943004,0,21660027
HepG2|chr17:39620398-39620416,chr17,39620398,39620416,HepG2|chr17:57971614-57971716,chr17,57971614,57971716,0,18351216
HepG2|chr17:39626838-39626872,chr17,39626838,39626872,HepG2|chr17:48799789-48799904,chr17,48799789,48799904,0,9172951
HepG2|chr17:39796213-39796315,chr17,39796213,39796315,HepG2|chr17:79759461-79759488,chr17,79759461,79759488,0,39963248
HepG2|chr17:39950513-39950653,chr17,39950513,39950653,HepG2|chr17:29336387-29336537,chr17,29336387,29336537,0,10614126
HepG2|chr17:40024174-40024291,chr17,40024174,40024291,HepG2|chr17:72980242-72980277,chr17,72980242,72980277,0,32956068
HepG2|chr17:40179878-40180028,chr17,40179878,40180028,HepG2|chr17:60142725-60142752,chr17,60142725,60142752,0,19962847
HepG2|chr17:40440532-40440606,chr17,40440532,40440606,HepG2|chr17:42297808-42297873,chr17,42297808,42297873,0,1857276
HepG2|chr17:40483434-40483527,chr17,40483434,40483527,HepG2|chr17:79759461-79759518,chr17,79759461,79759518,0,39276027
HepG2|chr17:40618433-40618551,chr17,40618433,40618551,HepG2|chr17:17584695-17584725,chr17,17584695,17584725,0,23033738
HepG2|chr17:40756868-40756947,chr17,40756868,40756947,HepG2|chr17:16942916-16942987,chr17,16942916,16942987,0,23813952
HepG2|chr17:40761436-40761475,chr17,40761436,40761475,HepG2|chr17:79759461-79759572,chr17,79759461,79759572,0,38998025
HepG2|chr17:40792869-40792960,chr17,40792869,40792960,HepG2|chr17:40577023-40577080,chr17,40577023,40577080,0,215846
HepG2|chr17:40913317-40913432,chr17,40913317,40913432,HepG2|chr17:79759465-79759500,chr17,79759465,79759500,0,38846148
HepG2|chr17:40946120-40946174,chr17,40946120,40946174,HepG2|chr17:62915291-62915333,chr17,62915291,62915333,0,21969171
HepG2|chr17:41006871-41006923,chr17,41006871,41006923,HepG2|chr17:38277477-38277627,chr17,38277477,38277627,0,2729394
HepG2|chr17:41398962-41399052,chr17,41398962,41399052,HepG2|chr17:40576982-40577080,chr17,40576982,40577080,0,821980
HepG2|chr17:41432632-41432665,chr17,41432632,41432665,HepG2|chr17:8095660-8095810,chr17,8095660,8095810,0,33336972
HepG2|chr17:41618361-41618379,chr17,41618361,41618379,HepG2|chr17:57969931-57970053,chr17,57969931,57970053,0,16351570
HepG2|chr17:41882825-41882967,chr17,41882825,41882967,HepG2|chr17:75317356-75317418,chr17,75317356,75317418,0,33434531
HepG2|chr17:41960974-41961024,chr17,41960974,41961024,HepG2|chr17:6602978-6603071,chr17,6602978,6603071,0,35357996
HepG2|chr17:42021366-42021478,chr17,42021366,42021478,HepG2|chr17:62915864-62915968,chr17,62915864,62915968,0,20894498
HepG2|chr17:42055421-42055462,chr17,42055421,42055462,HepG2|chr17:80290505-80290580,chr17,80290505,80290580,0,38235084
HepG2|chr17:42130337-42130394,chr17,42130337,42130394,HepG2|chr17:38221511-38221604,chr17,38221511,38221604,0,3908826
HepG2|chr17:42208220-42208282,chr17,42208220,42208282,HepG2|chr17:16942916-16943004,chr17,16942916,16943004,0,25265304
HepG2|chr17:42333527-42333676,chr17,42333527,42333676,HepG2|chr17:79759465-79759514,chr17,79759465,79759514,0,37425938
HepG2|chr17:42335501-42335539,chr17,42335501,42335539,HepG2|chr17:76370443-76370506,chr17,76370443,76370506,0,34034942
HepG2|chr17:42725449-42725526,chr17,42725449,42725526,HepG2|chr17:80290507-80290580,chr17,80290507,80290580,0,37565058
HepG2|chr17:42765773-42765833,chr17,42765773,42765833,HepG2|chr17:40575671-40575760,chr17,40575671,40575760,0,2190102
HepG2|chr17:43066035-43066177,chr17,43066035,43066177,HepG2|chr17:75317356-75317418,chr17,75317356,75317418,0,32251321
HepG2|chr17:43135576-43135726,chr17,43135576,43135726,HepG2|chr17:80290489-80290580,chr17,80290489,80290580,0,37154913
HepG2|chr17:43264326-43264425,chr17,43264326,43264425,HepG2|chr17:79759461-79759480,chr17,79759461,79759480,0,36495135
HepG2|chr17:43347484-43347504,chr17,43347484,43347504,HepG2|chr17:80290466-80290580,chr17,80290466,80290580,0,36942982
HepG2|chr17:43465389-43465534,chr17,43465389,43465534,HepG2|chr17:80290461-80290580,chr17,80290461,80290580,0,36825072
HepG2|chr17:43508038-43508184,chr17,43508038,43508184,HepG2|chr17:62915431-62915570,chr17,62915431,62915570,0,19407393
HepG2|chr17:43678464-43678511,chr17,43678464,43678511,HepG2|chr17:77706730-77706830,chr17,77706730,77706830,0,34028266
HepG2|chr17:43797101-43797153,chr17,43797101,43797153,HepG2|chr17:57969479-57969629,chr17,57969479,57969629,0,14172378
HepG2|chr17:43816214-43816363,chr17,43816214,43816363,HepG2|chr17:42832587-42832617,chr17,42832587,42832617,0,983627
HepG2|chr17:43842019-43842121,chr17,43842019,43842121,HepG2|chr17:66193037-66193085,chr17,66193037,66193085,0,22351018
HepG2|chr17:43994016-43994040,chr17,43994016,43994040,HepG2|chr17:73083354-73083499,chr17,73083354,73083499,0,29089338
HepG2|chr17:44089988-44090047,chr17,44089988,44090047,HepG2|chr17:62915309-62915422,chr17,62915309,62915422,0,18825321
HepG2|chr17:44166245-44166369,chr17,44166245,44166369,HepG2|chr17:80198990-80199012,chr17,80198990,80199012,0,36032745
HepG2|chr17:44215046-44215087,chr17,44215046,44215087,HepG2|chr17:41129340-41129419,chr17,41129340,41129419,0,3085706
HepG2|chr17:44220208-44220358,chr17,44220208,44220358,HepG2|chr17:79759465-79759539,chr17,79759465,79759539,0,35539257
HepG2|chr17:44239488-44239527,chr17,44239488,44239527,HepG2|chr17:41129340-41129417,chr17,41129340,41129417,0,3110148
HepG2|chr17:44258272-44258330,chr17,44258272,44258330,HepG2|chr17:33896999-33897128,chr17,33896999,33897128,0,10361273
HepG2|chr17:44352121-44352271,chr17,44352121,44352271,HepG2|chr17:62915431-62915514,chr17,62915431,62915514,0,18563310
HepG2|chr17:44385554-44385704,chr17,44385554,44385704,HepG2|chr17:57969931-57970038,chr17,57969931,57970038,0,13584377
HepG2|chr17:44541223-44541350,chr17,44541223,44541350,HepG2|chr17:40167162-40167298,chr17,40167162,40167298,0,4374061
HepG2|chr17:44668584-44668734,chr17,44668584,44668734,HepG2|chr17:62915593-62915741,chr17,62915593,62915741,0,18247009
HepG2|chr17:44707454-44707574,chr17,44707454,44707574,HepG2|chr17:80290553-80290580,chr17,80290553,80290580,0,35583099
HepG2|chr17:44833122-44833216,chr17,44833122,44833216,HepG2|chr17:40577024-40577080,chr17,40577024,40577080,0,4256098
HepG2|chr17:44913268-44913389,chr17,44913268,44913389,HepG2|chr17:76722982-76723132,chr17,76722982,76723132,0,31809714
HepG2|chr17:44930241-44930349,chr17,44930241,44930349,HepG2|chr17:62915890-62915968,chr17,62915890,62915968,0,17985649
HepG2|chr17:45082586-45082646,chr17,45082586,45082646,HepG2|chr17:79759465-79759524,chr17,79759465,79759524,0,34676879
HepG2|chr17:45104651-45104694,chr17,45104651,45104694,HepG2|chr17:41129340-41129403,chr17,41129340,41129403,0,3975311
HepG2|chr17:45243445-45243525,chr17,45243445,45243525,HepG2|chr17:41324497-41324550,chr17,41324497,41324550,0,3918948
HepG2|chr17:45355551-45355575,chr17,45355551,45355575,HepG2|chr17:38277503-38277629,chr17,38277503,38277629,0,7078048
HepG2|chr17:45450836-45450873,chr17,45450836,45450873,HepG2|chr17:43567663-43567813,chr17,43567663,43567813,0,1883173
HepG2|chr17:45578085-45578171,chr17,45578085,45578171,HepG2|chr17:57969366-57969408,chr17,57969366,57969408,0,12391281
HepG2|chr17:45636895-45636916,chr17,45636895,45636916,HepG2|chr17:63556481-63556501,chr17,63556481,63556501,0,17919586
HepG2|chr17:45649641-45649756,chr17,45649641,45649756,HepG2|chr17:79759547-79759582,chr17,79759547,79759582,0,34109906
HepG2|chr17:45907102-45907231,chr17,45907102,45907231,HepG2|chr17:72980566-72980707,chr17,72980566,72980707,0,27073464
HepG2|chr17:46046708-46046846,chr17,46046708,46046846,HepG2|chr17:79759481-79759631,chr17,79759481,79759631,0,33712773
HepG2|chr17:46131337-46131448,chr17,46131337,46131448,HepG2|chr17:79759461-79759537,chr17,79759461,79759537,0,33628124
HepG2|chr17:46230463-46230573,chr17,46230463,46230573,HepG2|chr17:40576934-40577080,chr17,40576934,40577080,0,5653529
HepG2|chr17:46353806-46353856,chr17,46353806,46353856,HepG2|chr17:40576990-40577080,chr17,40576990,40577080,0,5776816
HepG2|chr17:46555221-46555322,chr17,46555221,46555322,HepG2|chr17:79759465-79759514,chr17,79759465,79759514,0,33204244
HepG2|chr17:46657321-46657432,chr17,46657321,46657432,HepG2|chr17:79955347-79955395,chr17,79955347,79955395,0,33298026
HepG2|chr17:46713396-46713454,chr17,46713396,46713454,HepG2|chr17:3631919-3632011,chr17,3631919,3632011,0,43081477
HepG2|chr17:46725414-46725564,chr17,46725414,46725564,HepG2|chr17:42832580-42832617,chr17,42832580,42832617,0,3892834
HepG2|chr17:46936299-46936446,chr17,46936299,46936446,HepG2|chr17:60549426-60549563,chr17,60549426,60549563,0,13613127
HepG2|chr17:46979624-46979774,chr17,46979624,46979774,HepG2|chr17:80290489-80290580,chr17,80290489,80290580,0,33310865
HepG2|chr17:46988548-46988606,chr17,46988548,46988606,HepG2|chr17:79759461-79759527,chr17,79759461,79759527,0,32770913
HepG2|chr17:47006576-47006625,chr17,47006576,47006625,HepG2|chr17:48799355-48799505,chr17,48799355,48799505,0,1792779
HepG2|chr17:47229683-47229833,chr17,47229683,47229833,HepG2|chr17:42832580-42832617,chr17,42832580,42832617,0,4397103
HepG2|chr17:47267944-47268056,chr17,47267944,47268056,HepG2|chr17:80290517-80290580,chr17,80290517,80290580,0,33022573
HepG2|chr17:47482440-47482480,chr17,47482440,47482480,HepG2|chr17:79759461-79759584,chr17,79759461,79759584,0,32277021
HepG2|chr17:47585536-47585612,chr17,47585536,47585612,HepG2|chr17:35853859-35853926,chr17,35853859,35853926,0,11731677
HepG2|chr17:47634654-47634803,chr17,47634654,47634803,HepG2|chr17:79759465-79759514,chr17,79759465,79759514,0,32124811
HepG2|chr17:47692114-47692247,chr17,47692114,47692247,HepG2|chr17:62915431-62915575,chr17,62915431,62915575,0,15223317
HepG2|chr17:47701432-47701549,chr17,47701432,47701549,HepG2|chr17:3601635-3601653,chr17,3601635,3601653,0,44099797
HepG2|chr17:47701674-47701757,chr17,47701674,47701757,HepG2|chr17:57969931-57969998,chr17,57969931,57969998,0,10268257
HepG2|chr17:47744930-47745015,chr17,47744930,47745015,HepG2|chr17:73454368-73454433,chr17,73454368,73454433,0,25709438
HepG2|chr17:47761006-47761125,chr17,47761006,47761125,HepG2|chr17:17203927-17204004,chr17,17203927,17204004,0,30557079
HepG2|chr17:47815713-47815858,chr17,47815713,47815858,HepG2|chr17:62916003-62916153,chr17,62916003,62916153,0,15100290
HepG2|chr17:47879190-47879230,chr17,47879190,47879230,HepG2|chr17:73081829-73081937,chr17,73081829,73081937,0,25202639
HepG2|chr17:47905874-47905921,chr17,47905874,47905921,HepG2|chr17:57969931-57970036,chr17,57969931,57970036,0,10064057
HepG2|chr17:47906789-47906851,chr17,47906789,47906851,HepG2|chr17:72978819-72978907,chr17,72978819,72978907,0,25072030
HepG2|chr17:48076929-48076956,chr17,48076929,48076956,HepG2|chr17:79759461-79759525,chr17,79759461,79759525,0,31682532
HepG2|chr17:48336312-48336359,chr17,48336312,48336359,HepG2|chr17:77706730-77706830,chr17,77706730,77706830,0,29370418
HepG2|chr17:48456203-48456254,chr17,48456203,48456254,HepG2|chr17:57969931-57970022,chr17,57969931,57970022,0,9513728
HepG2|chr17:48510828-48510911,chr17,48510828,48510911,HepG2|chr17:35853859-35853926,chr17,35853859,35853926,0,12656969
HepG2|chr17:48574217-48574275,chr17,48574217,48574275,HepG2|chr17:3631919-3632011,chr17,3631919,3632011,0,44942298
HepG2|chr17:48648115-48648196,chr17,48648115,48648196,HepG2|chr17:1550429-1550470,chr17,1550429,1550470,0,47097686
HepG2|chr17:48668069-48668219,chr17,48668069,48668219,HepG2|chr17:62915635-62915782,chr17,62915635,62915782,0,14247566
HepG2|chr17:48806988-48807052,chr17,48806988,48807052,HepG2|chr17:77005132-77005243,chr17,77005132,77005243,0,28198144
HepG2|chr17:48870218-48870289,chr17,48870218,48870289,HepG2|chr17:40575719-40575760,chr17,40575719,40575760,0,8294499
HepG2|chr17:48936370-48936482,chr17,48936370,48936482,HepG2|chr17:62915864-62915968,chr17,62915864,62915968,0,13979494
HepG2|chr17:49030010-49030157,chr17,49030010,49030157,HepG2|chr17:60549426-60549563,chr17,60549426,60549563,0,11519416
HepG2|chr17:49156971-49157071,chr17,49156971,49157071,HepG2|chr17:4610961-4611011,chr17,4610961,4611011,0,44546010
HepG2|chr17:49205955-49206064,chr17,49205955,49206064,HepG2|chr17:35853859-35853926,chr17,35853859,35853926,0,13352096
HepG2|chr17:49255254-49255287,chr17,49255254,49255287,HepG2|chr17:40719994-40720130,chr17,40719994,40720130,0,8535260
HepG2|chr17:49687894-49688025,chr17,49687894,49688025,HepG2|chr17:65273799-65273893,chr17,65273799,65273893,0,15585905
HepG2|chr17:49706587-49706673,chr17,49706587,49706673,HepG2|chr17:73455220-73455370,chr17,73455220,73455370,0,23748633
HepG2|chr17:49942184-49942242,chr17,49942184,49942242,HepG2|chr17:8105619-8105648,chr17,8105619,8105648,0,41836565
HepG2|chr17:50067367-50067484,chr17,50067367,50067484,HepG2|chr17:28256546-28256579,chr17,28256546,28256579,0,21810821
HepG2|chr17:50203622-50203656,chr17,50203622,50203656,HepG2|chr17:80290495-80290580,chr17,80290495,80290580,0,30086873
HepG2|chr17:50238131-50238276,chr17,50238131,50238276,HepG2|chr17:62916003-62916153,chr17,62916003,62916153,0,12677872
HepG2|chr17:50374075-50374152,chr17,50374075,50374152,HepG2|chr17:38277503-38277629,chr17,38277503,38277629,0,12096572
HepG2|chr17:50553253-50553358,chr17,50553253,50553358,HepG2|chr17:38803125-38803167,chr17,38803125,38803167,0,11750128
HepG2|chr17:50965792-50965892,chr17,50965792,50965892,HepG2|chr17:4610961-4611011,chr17,4610961,4611011,0,46354831
HepG2|chr17:51001341-51001412,chr17,51001341,51001412,HepG2|chr17:71188310-71188361,chr17,71188310,71188361,0,20186969
HepG2|chr17:51032389-51032475,chr17,51032389,51032475,HepG2|chr17:79759461-79759525,chr17,79759461,79759525,0,28727072
HepG2|chr17:51264292-51264439,chr17,51264292,51264439,HepG2|chr17:77706730-77706830,chr17,77706730,77706830,0,26442438
HepG2|chr17:51358909-51358960,chr17,51358909,51358960,HepG2|chr17:29897401-29897508,chr17,29897401,29897508,0,21461508
HepG2|chr17:51384601-51384641,chr17,51384601,51384641,HepG2|chr17:41129340-41129419,chr17,41129340,41129419,0,10255261
HepG2|chr17:51495634-51495701,chr17,51495634,51495701,HepG2|chr17:57969663-57969736,chr17,57969663,57969736,0,6474029
HepG2|chr17:51500998-51501119,chr17,51500998,51501119,HepG2|chr17:80290426-80290567,chr17,80290426,80290567,0,28789428
HepG2|chr17:51602606-51602640,chr17,51602606,51602640,HepG2|chr17:40719993-40720130,chr17,40719993,40720130,0,10882613
HepG2|chr17:51628678-51628726,chr17,51628678,51628726,HepG2|chr17:57969663-57969736,chr17,57969663,57969736,0,6340985
HepG2|chr17:51693942-51694051,chr17,51693942,51694051,HepG2|chr17:80290533-80290580,chr17,80290533,80290580,0,28596591
HepG2|chr17:51901078-51901111,chr17,51901078,51901111,HepG2|chr17:80290427-80290574,chr17,80290427,80290574,0,28389349
HepG2|chr17:52016332-52016435,chr17,52016332,52016435,HepG2|chr17:80290533-80290580,chr17,80290533,80290580,0,28274201
HepG2|chr17:52022462-52022612,chr17,52022462,52022612,HepG2|chr17:8105619-8105645,chr17,8105619,8105645,0,43916843
HepG2|chr17:52045062-52045098,chr17,52045062,52045098,HepG2|chr17:4618786-4618847,chr17,4618786,4618847,0,47426276
HepG2|chr17:52051509-52051578,chr17,52051509,52051578,HepG2|chr17:40576999-40577080,chr17,40576999,40577080,0,11474510
HepG2|chr17:52159607-52159666,chr17,52159607,52159666,HepG2|chr17:19549541-19549628,chr17,19549541,19549628,0,32610066
HepG2|chr17:52186704-52186805,chr17,52186704,52186805,HepG2|chr17:79759465-79759514,chr17,79759465,79759514,0,27572761
HepG2|chr17:52295065-52295185,chr17,52295065,52295185,HepG2|chr17:7382014-7382053,chr17,7382014,7382053,0,44913051
HepG2|chr17:52322802-52322872,chr17,52322802,52322872,HepG2|chr17:77005132-77005243,chr17,77005132,77005243,0,24682330
HepG2|chr17:52451419-52451569,chr17,52451419,52451569,HepG2|chr17:62916169-62916250,chr17,62916169,62916250,0,10464750
HepG2|chr17:52458408-52458512,chr17,52458408,52458512,HepG2|chr17:79759542-79759585,chr17,79759542,79759585,0,27301134
HepG2|chr17:52563125-52563275,chr17,52563125,52563275,HepG2|chr17:62915765-62915912,chr17,62915765,62915912,0,10352640
HepG2|chr17:52593980-52594000,chr17,52593980,52594000,HepG2|chr17:80290466-80290580,chr17,80290466,80290580,0,27696486
HepG2|chr17:52692676-52692703,chr17,52692676,52692703,HepG2|chr17:77706759-77706830,chr17,77706759,77706830,0,25014083
HepG2|chr17:52932312-52932427,chr17,52932312,52932427,HepG2|chr17:79759547-79759582,chr17,79759547,79759582,0,26827235
HepG2|chr17:53093266-53093296,chr17,53093266,53093296,HepG2|chr17:80290460-80290580,chr17,80290460,80290580,0,27197194
HepG2|chr17:53200867-53200884,chr17,53200867,53200884,HepG2|chr17:34100241-34100350,chr17,34100241,34100350,0,19100626
HepG2|chr17:53202486-53202515,chr17,53202486,53202515,HepG2|chr17:72980696-72980846,chr17,72980696,72980846,0,19778210
HepG2|chr17:53341739-53341822,chr17,53341739,53341822,HepG2|chr17:57969931-57969998,chr17,57969931,57969998,0,4628192
HepG2|chr17:53362899-53363049,chr17,53362899,53363049,HepG2|chr17:62915753-62915900,chr17,62915753,62915900,0,9552854
HepG2|chr17:53518720-53518823,chr17,53518720,53518823,HepG2|chr17:6940732-6940754,chr17,6940732,6940754,0,46577988
HepG2|chr17:53561967-53562105,chr17,53561967,53562105,HepG2|chr17:79759547-79759582,chr17,79759547,79759582,0,26197580
HepG2|chr17:53568372-53568401,chr17,53568372,53568401,HepG2|chr17:40577023-40577080,chr17,40577023,40577080,0,12991349
HepG2|chr17:53608851-53609001,chr17,53608851,53609001,HepG2|chr17:62915431-62915514,chr17,62915431,62915514,0,9306580
HepG2|chr17:53676834-53676929,chr17,53676834,53676929,HepG2|chr17:40576968-40577080,chr17,40576968,40577080,0,13099866
HepG2|chr17:53828742-53828817,chr17,53828742,53828817,HepG2|chr17:79759465-79759537,chr17,79759465,79759537,0,25930723
HepG2|chr17:53852750-53852790,chr17,53852750,53852790,HepG2|chr17:41129340-41129419,chr17,41129340,41129419,0,12723410
HepG2|chr17:53934623-53934726,chr17,53934623,53934726,HepG2|chr17:79759465-79759537,chr17,79759465,79759537,0,25824842
HepG2|chr17:53940895-53940930,chr17,53940895,53940930,HepG2|chr17:79759465-79759584,chr17,79759465,79759584,0,25818570
HepG2|chr17:53969075-53969224,chr17,53969075,53969224,HepG2|chr17:62915431-62915575,chr17,62915431,62915575,0,8946356
HepG2|chr17:54065830-54065934,chr17,54065830,54065934,HepG2|chr17:57969931-57969974,chr17,57969931,57969974,0,3904101
HepG2|chr17:54250173-54250208,chr17,54250173,54250208,HepG2|chr17:79759465-79759587,chr17,79759465,79759587,0,25509292
HepG2|chr17:54299247-54299397,chr17,54299247,54299397,HepG2|chr17:79955352-79955392,chr17,79955352,79955392,0,25656105
HepG2|chr17:54395525-54395552,chr17,54395525,54395552,HepG2|chr17:79759461-79759525,chr17,79759461,79759525,0,25363936
HepG2|chr17:54427040-54427071,chr17,54427040,54427071,HepG2|chr17:79759465-79759584,chr17,79759465,79759584,0,25332425
HepG2|chr17:54540781-54540807,chr17,54540781,54540807,HepG2|chr17:4618830-4618881,chr17,4618830,4618881,0,49921951
HepG2|chr17:54793781-54793884,chr17,54793781,54793884,HepG2|chr17:57969931-57969973,chr17,57969931,57969973,0,3176150
HepG2|chr17:54931827-54931844,chr17,54931827,54931844,HepG2|chr17:8095775-8095818,chr17,8095775,8095818,0,46836052
HepG2|chr17:55021494-55021530,chr17,55021494,55021530,HepG2|chr17:4618786-4618847,chr17,4618786,4618847,0,50402708
HepG2|chr17:55162471-55162518,chr17,55162471,55162518,HepG2|chr17:57969931-57970036,chr17,57969931,57970036,0,2807460
HepG2|chr17:55175215-55175315,chr17,55175215,55175315,HepG2|chr17:79759461-79759537,chr17,79759461,79759537,0,24584246
HepG2|chr17:55231261-55231411,chr17,55231261,55231411,HepG2|chr17:62916169-62916250,chr17,62916169,62916250,0,7684908
HepG2|chr17:55235791-55235910,chr17,55235791,55235910,HepG2|chr17:17584695-17584724,chr17,17584695,17584724,0,37651096
HepG2|chr17:55328282-55328321,chr17,55328282,55328321,HepG2|chr17:48799789-48799904,chr17,48799789,48799904,0,6528493
HepG2|chr17:55477532-55477573,chr17,55477532,55477573,HepG2|chr17:76491426-76491534,chr17,76491426,76491534,0,21013894
HepG2|chr17:55500662-55500689,chr17,55500662,55500689,HepG2|chr17:79759464-79759603,chr17,79759464,79759603,0,24258802
HepG2|chr17:55501169-55501313,chr17,55501169,55501313,HepG2|chr17:42832580-42832617,chr17,42832580,42832617,0,12668589
HepG2|chr17:55577675-55577744,chr17,55577675,55577744,HepG2|chr17:62916169-62916250,chr17,62916169,62916250,0,7338494
HepG2|chr17:55659572-55659722,chr17,55659572,55659722,HepG2|chr17:76925161-76925236,chr17,76925161,76925236,0,21265589
HepG2|chr17:55692540-55692564,chr17,55692540,55692564,HepG2|chr17:38277503-38277629,chr17,38277503,38277629,0,17415037
HepG2|chr17:55911824-55911974,chr17,55911824,55911974,HepG2|chr17:62915389-62915539,chr17,62915389,62915539,0,7003565
HepG2|chr17:55977677-55977748,chr17,55977677,55977748,HepG2|chr17:19549874-19549923,chr17,19549874,19549923,0,36427803
HepG2|chr17:56107559-56107586,chr17,56107559,56107586,HepG2|chr17:77706759-77706830,chr17,77706759,77706830,0,21599200
HepG2|chr17:56198162-56198292,chr17,56198162,56198292,HepG2|chr17:3601635-3601653,chr17,3601635,3601653,0,52596527
HepG2|chr17:56250431-56250495,chr17,56250431,56250495,HepG2|chr17:77005132-77005243,chr17,77005132,77005243,0,20754701
HepG2|chr17:56328305-56328380,chr17,56328305,56328380,HepG2|chr17:77005132-77005243,chr17,77005132,77005243,0,20676827
HepG2|chr17:56406725-56406830,chr17,56406725,56406830,HepG2|chr17:80290535-80290580,chr17,80290535,80290580,0,23883810
HepG2|chr17:56433569-56433612,chr17,56433569,56433612,HepG2|chr17:57969931-57970038,chr17,57969931,57970038,0,1536362
HepG2|chr17:56440140-56440226,chr17,56440140,56440226,HepG2|chr17:79759461-79759525,chr17,79759461,79759525,0,23319321
HepG2|chr17:56474131-56474238,chr17,56474131,56474238,HepG2|chr17:40577055-40577080,chr17,40577055,40577080,0,15897076
HepG2|chr17:56503522-56503626,chr17,56503522,56503626,HepG2|chr17:7833642-7833679,chr17,7833642,7833679,0,48669880
HepG2|chr17:56977217-56977348,chr17,56977217,56977348,HepG2|chr17:57969979-57969998,chr17,57969979,57969998,0,992762
HepG2|chr17:56989236-56989322,chr17,56989236,56989322,HepG2|chr17:62915431-62915518,chr17,62915431,62915518,0,5926195
HepG2|chr17:56996405-56996497,chr17,56996405,56996497,HepG2|chr17:79759461-79759509,chr17,79759461,79759509,0,22763056
HepG2|chr17:57356308-57356458,chr17,57356308,57356458,HepG2|chr17:62915752-62915902,chr17,62915752,62915902,0,5559444
HepG2|chr17:57371958-57372025,chr17,57371958,57372025,HepG2|chr17:57969931-57969993,chr17,57969931,57969993,0,597973
HepG2|chr17:57407480-57407551,chr17,57407480,57407551,HepG2|chr17:43572502-43572617,chr17,43572502,43572617,0,13834978
HepG2|chr17:57469173-57469297,chr17,57469173,57469297,HepG2|chr17:80198990-80199012,chr17,80198990,80199012,0,22729817
HepG2|chr17:57549033-57549138,chr17,57549033,57549138,HepG2|chr17:65823086-65823149,chr17,65823086,65823149,0,8274053
HepG2|chr17:57645411-57645455,chr17,57645411,57645455,HepG2|chr17:76491430-76491535,chr17,76491430,76491535,0,18846019
HepG2|chr17:57676908-57677019,chr17,57676908,57677019,HepG2|chr17:79955347-79955395,chr17,79955347,79955395,0,22278439
HepG2|chr17:57878448-57878519,chr17,57878448,57878519,HepG2|chr17:65823086-65823149,chr17,65823086,65823149,0,7944638
HepG2|chr17:57962874-57962979,chr17,57962874,57962979,HepG2|chr17:38803125-38803167,chr17,38803125,38803167,0,19159749
HepG2|chr17:58271653-58271693,chr17,58271653,58271693,HepG2|chr17:16942916-16943026,chr17,16942916,16943026,0,41328737
HepG2|chr17:58439752-58439807,chr17,58439752,58439807,HepG2|chr17:79759465-79759548,chr17,79759465,79759548,0,21319713
HepG2|chr17:58509878-58509933,chr17,58509878,58509933,HepG2|chr17:80290518-80290580,chr17,80290518,80290580,0,21780640
HepG2|chr17:58554887-58555037,chr17,58554887,58555037,HepG2|chr17:80290535-80290580,chr17,80290535,80290580,0,21735648
HepG2|chr17:58594539-58594574,chr17,58594539,58594574,HepG2|chr17:62917246-62917315,chr17,62917246,62917315,0,4322707
HepG2|chr17:58596208-58596338,chr17,58596208,58596338,HepG2|chr17:38274577-38274610,chr17,38274577,38274610,0,20321631
HepG2|chr17:58685646-58685685,chr17,58685646,58685685,HepG2|chr17:80198990-80199012,chr17,80198990,80199012,0,21513344
HepG2|chr17:58791173-58791233,chr17,58791173,58791233,HepG2|chr17:65822575-65822605,chr17,65822575,65822605,0,7031402
HepG2|chr17:58890101-58890189,chr17,58890101,58890189,HepG2|chr17:79874666-79874774,chr17,79874666,79874774,0,20984565
HepG2|chr17:59222654-59222763,chr17,59222654,59222763,HepG2|chr17:80290533-80290580,chr17,80290533,80290580,0,21067879
HepG2|chr17:59321368-59321508,chr17,59321368,59321508,HepG2|chr17:80290460-80290580,chr17,80290460,80290580,0,20969092
HepG2|chr17:59388583-59388657,chr17,59388583,59388657,HepG2|chr17:42297808-42297873,chr17,42297808,42297873,0,17090775
HepG2|chr17:59530342-59530439,chr17,59530342,59530439,HepG2|chr17:62915310-62915422,chr17,62915310,62915422,0,3384968
HepG2|chr17:59587622-59587696,chr17,59587622,59587696,HepG2|chr17:72980668-72980745,chr17,72980668,72980745,0,13393046
HepG2|chr17:59703431-59703491,chr17,59703431,59703491,HepG2|chr17:65822575-65822605,chr17,65822575,65822605,0,6119144
HepG2|chr17:60059867-60059884,chr17,60059867,60059884,HepG2|chr17:34100241-34100350,chr17,34100241,34100350,0,25959626
HepG2|chr17:60299178-60299328,chr17,60299178,60299328,HepG2|chr17:8096414-8096528,chr17,8096414,8096528,0,52202764
HepG2|chr17:60318612-60318731,chr17,60318612,60318731,HepG2|chr17:17584695-17584724,chr17,17584695,17584724,0,42733917
HepG2|chr17:60338353-60338402,chr17,60338353,60338402,HepG2|chr17:40575719-40575760,chr17,40575719,40575760,0,19762634
HepG2|chr17:60386297-60386359,chr17,60386297,60386359,HepG2|chr17:72978819-72978907,chr17,72978819,72978907,0,12592522
HepG2|chr17:60580408-60580437,chr17,60580408,60580437,HepG2|chr17:35851219-35851340,chr17,35851219,35851340,0,24729189
HepG2|chr17:60621527-60621648,chr17,60621527,60621648,HepG2|chr17:79759465-79759584,chr17,79759465,79759584,0,19137938
HepG2|chr17:60673863-60673888,chr17,60673863,60673888,HepG2|chr17:4618819-4618879,chr17,4618819,4618879,0,56055044
HepG2|chr17:60736572-60736631,chr17,60736572,60736631,HepG2|chr17:80290489-80290580,chr17,80290489,80290580,0,19553917
HepG2|chr17:60774771-60774917,chr17,60774771,60774917,HepG2|chr17:62915431-62915570,chr17,62915431,62915570,0,2140660
HepG2|chr17:60857460-60857573,chr17,60857460,60857573,HepG2|chr17:7833639-7833676,chr17,7833639,7833676,0,53023821
HepG2|chr17:60927829-60927921,chr17,60927829,60927921,HepG2|chr17:40577023-40577080,chr17,40577023,40577080,0,20350806
HepG2|chr17:61206876-61206956,chr17,61206876,61206956,HepG2|chr17:41324497-41324550,chr17,41324497,41324550,0,19882379
HepG2|chr17:61241736-61241774,chr17,61241736,61241774,HepG2|chr17:40576968-40577080,chr17,40576968,40577080,0,20664768
HepG2|chr17:61391079-61391207,chr17,61391079,61391207,HepG2|chr17:79886333-79886355,chr17,79886333,79886355,0,18495254
HepG2|chr17:61409024-61409138,chr17,61409024,61409138,HepG2|chr17:62915431-62915538,chr17,62915431,62915538,0,1506407
HepG2|chr17:61459758-61459796,chr17,61459758,61459796,HepG2|chr17:57969931-57970040,chr17,57969931,57970040,0,3489827
HepG2|chr17:61656250-61656268,chr17,61656250,61656268,HepG2|chr17:57969931-57970053,chr17,57969931,57970053,0,3686319
HepG2|chr17:61665605-61665690,chr17,61665605,61665690,HepG2|chr17:7833642-7833664,chr17,7833642,7833664,0,53831963
HepG2|chr17:61687652-61687786,chr17,61687652,61687786,HepG2|chr17:62915925-62915968,chr17,62915925,62915968,0,1228273
HepG2|chr17:61747680-61747731,chr17,61747680,61747731,HepG2|chr17:4456397-4456490,chr17,4456397,4456490,0,57291283
HepG2|chr17:61900938-61901088,chr17,61900938,61901088,HepG2|chr17:62915752-62915902,chr17,62915752,62915902,0,1014814
HepG2|chr17:61918777-61918926,chr17,61918777,61918926,HepG2|chr17:62915431-62915575,chr17,62915431,62915575,0,996654
HepG2|chr17:61946502-61946560,chr17,61946502,61946560,HepG2|chr17:79759461-79759527,chr17,79759461,79759527,0,17812959
HepG2|chr17:61977500-61977568,chr17,61977500,61977568,HepG2|chr17:76370443-76370465,chr17,76370443,76370465,0,14392943
HepG2|chr17:62016077-62016188,chr17,62016077,62016188,HepG2|chr17:7833642-7833681,chr17,7833642,7833681,0,54182435
HepG2|chr17:62043005-62043114,chr17,62043005,62043114,HepG2|chr17:40577024-40577080,chr17,40577024,40577080,0,21465981
HepG2|chr17:62182262-62182335,chr17,62182262,62182335,HepG2|chr17:57969931-57969978,chr17,57969931,57969978,0,4212331
HepG2|chr17:62195883-62195959,chr17,62195883,62195959,HepG2|chr17:35853859-35853926,chr17,35853859,35853926,0,26342024
HepG2|chr17:62247460-62247577,chr17,62247460,62247577,HepG2|chr17:72980242-72980277,chr17,72980242,72980277,0,10732782
HepG2|chr17:62370694-62370763,chr17,62370694,62370763,HepG2|chr17:40576999-40577080,chr17,40576999,40577080,0,21793695
HepG2|chr17:62391883-62391950,chr17,62391883,62391950,HepG2|chr17:35851219-35851340,chr17,35851219,35851340,0,26540664
HepG2|chr17:62485389-62485470,chr17,62485389,62485470,HepG2|chr17:41326896-41326965,chr17,41326896,41326965,0,21158493
HepG2|chr17:62748992-62749109,chr17,62748992,62749109,HepG2|chr17:3601635-3601653,chr17,3601635,3601653,0,59147357
HepG2|chr17:62754532-62754682,chr17,62754532,62754682,HepG2|chr17:7833642-7833681,chr17,7833642,7833681,0,54920890
HepG2|chr17:62898224-62898252,chr17,62898224,62898252,HepG2|chr17:8095649-8095799,chr17,8095649,8095799,0,54802575
HepG2|chr17:63226528-63226563,chr17,63226528,63226563,HepG2|chr17:62917246-62917315,chr17,62917246,62917315,0,309282
HepG2|chr17:63364052-63364168,chr17,63364052,63364168,HepG2|chr17:80290460-80290571,chr17,80290460,80290571,0,16926408
HepG2|chr17:63384072-63384222,chr17,63384072,63384222,HepG2|chr17:36452432-36452518,chr17,36452432,36452518,0,26931640
HepG2|chr17:63712435-63712459,chr17,63712435,63712459,HepG2|chr17:4618671-4618811,chr17,4618671,4618811,0,59093764
HepG2|chr17:63901664-63901689,chr17,63901664,63901689,HepG2|chr17:80290451-80290580,chr17,80290451,80290580,0,16388787
HepG2|chr17:63914439-63914474,chr17,63914439,63914474,HepG2|chr17:79759465-79759584,chr17,79759465,79759584,0,15845026
HepG2|chr17:63943088-63943235,chr17,63943088,63943235,HepG2|chr17:33899360-33899507,chr17,33899360,33899507,0,30043728
HepG2|chr17:63950020-63950135,chr17,63950020,63950135,HepG2|chr17:72980242-72980277,chr17,72980242,72980277,0,9030222
HepG2|chr17:63976540-63976618,chr17,63976540,63976618,HepG2|chr17:57969931-57970038,chr17,57969931,57970038,0,6006609
HepG2|chr17:64076389-64076508,chr17,64076389,64076508,HepG2|chr17:17203927-17204004,chr17,17203927,17204004,0,46872462
HepG2|chr17:64284264-64284355,chr17,64284264,64284355,HepG2|chr17:66193034-66193174,chr17,66193034,66193174,0,1908770
HepG2|chr17:64306360-64306418,chr17,64306360,64306418,HepG2|chr17:80290489-80290580,chr17,80290489,80290580,0,15984129
HepG2|chr17:64408586-64408683,chr17,64408586,64408683,HepG2|chr17:62915310-62915422,chr17,62915310,62915422,0,1493276
HepG2|chr17:64457211-64457361,chr17,64457211,64457361,HepG2|chr17:39931016-39931054,chr17,39931016,39931054,0,24526195
HepG2|chr17:64488055-64488089,chr17,64488055,64488089,HepG2|chr17:48799789-48799904,chr17,48799789,48799904,0,15688266
HepG2|chr17:64582683-64582833,chr17,64582683,64582833,HepG2|chr17:62915765-62915912,chr17,62915765,62915912,0,1666918
HepG2|chr17:64756589-64756650,chr17,64756589,64756650,HepG2|chr17:57969931-57970020,chr17,57969931,57970020,0,6786658
HepG2|chr17:64861272-64861306,chr17,64861272,64861306,HepG2|chr17:40719993-40720130,chr17,40719993,40720130,0,24141279
HepG2|chr17:64899596-64899743,chr17,64899596,64899743,HepG2|chr17:60549417-60549563,chr17,60549417,60549563,0,4350179
HepG2|chr17:64993183-64993263,chr17,64993183,64993263,HepG2|chr17:40576940-40577008,chr17,40576940,40577008,0,24416243
HepG2|chr17:65207756-65207806,chr17,65207756,65207806,HepG2|chr17:40576990-40577080,chr17,40576990,40577080,0,24630766
HepG2|chr17:65337832-65337865,chr17,65337832,65337865,HepG2|chr17:80290427-80290574,chr17,80290427,80290574,0,14952595
HepG2|chr17:65359074-65359163,chr17,65359074,65359163,HepG2|chr17:57969931-57970017,chr17,57969931,57970017,0,7389143
HepG2|chr17:65487359-65487429,chr17,65487359,65487429,HepG2|chr17:79759461-79759572,chr17,79759461,79759572,0,14272102
HepG2|chr17:65526512-65526595,chr17,65526512,65526595,HepG2|chr17:40577013-40577080,chr17,40577013,40577080,0,24949499
HepG2|chr17:65562729-65562783,chr17,65562729,65562783,HepG2|chr17:42297808-42297873,chr17,42297808,42297873,0,23264921
HepG2|chr17:65619210-65619294,chr17,65619210,65619294,HepG2|chr17:62915431-62915529,chr17,62915431,62915529,0,2703779
HepG2|chr17:65660050-65660163,chr17,65660050,65660163,HepG2|chr17:57968929-57968948,chr17,57968929,57968948,0,7691121
HepG2|chr17:65783369-65783519,chr17,65783369,65783519,HepG2|chr17:62915801-62915951,chr17,62915801,62915951,0,2867568
HepG2|chr17:65847872-65848001,chr17,65847872,65848001,HepG2|chr17:72980566-72980707,chr17,72980566,72980707,0,7132694
HepG2|chr17:65891335-65891485,chr17,65891335,65891485,HepG2|chr17:29336385-29336535,chr17,29336385,29336535,0,36554950
HepG2|chr17:66015439-66015480,chr17,66015439,66015480,HepG2|chr17:80290505-80290580,chr17,80290505,80290580,0,14275066
HepG2|chr17:66070882-66071032,chr17,66070882,66071032,HepG2|chr17:62915431-62915531,chr17,62915431,62915531,0,3155451
HepG2|chr17:66171203-66171259,chr17,66171203,66171259,HepG2|chr17:62657708-62657858,chr17,62657708,62657858,0,3513495
HepG2|chr17:66249988-66250066,chr17,66249988,66250066,HepG2|chr17:8095755-8095818,chr17,8095755,8095818,0,58154233
HepG2|chr17:66253726-66253739,chr17,66253726,66253739,HepG2|chr17:29898000-29898025,chr17,29898000,29898025,0,36355726
HepG2|chr17:66296937-66297007,chr17,66296937,66297007,HepG2|chr17:60700097-60700161,chr17,60700097,60700161,0,5596840
HepG2|chr17:66542665-66542788,chr17,66542665,66542788,HepG2|chr17:76722982-76723132,chr17,76722982,76723132,0,10180317
HepG2|chr17:66849183-66849286,chr17,66849183,66849286,HepG2|chr17:79759465-79759537,chr17,79759465,79759537,0,12910282
HepG2|chr17:66901635-66901734,chr17,66901635,66901734,HepG2|chr17:40577029-40577080,chr17,40577029,40577080,0,26324606
HepG2|chr17:67306462-67306612,chr17,67306462,67306612,HepG2|chr17:62915801-62915951,chr17,62915801,62915951,0,4390661
HepG2|chr17:67309258-67309389,chr17,67309258,67309389,HepG2|chr17:57969979-57969998,chr17,57969979,57969998,0,9339279
HepG2|chr17:67456283-67456430,chr17,67456283,67456430,HepG2|chr17:77706730-77706830,chr17,77706730,77706830,0,10250447
HepG2|chr17:67513934-67514005,chr17,67513934,67514005,HepG2|chr17:79759461-79759537,chr17,79759461,79759537,0,12245527
HepG2|chr17:67623447-67623591,chr17,67623447,67623591,HepG2|chr17:42832580-42832617,chr17,42832580,42832617,0,24790867
HepG2|chr17:67633007-67633080,chr17,67633007,67633080,HepG2|chr17:16942916-16942990,chr17,16942916,16942990,0,50690091
HepG2|chr17:68039329-68039450,chr17,68039329,68039450,HepG2|chr17:80290426-80290567,chr17,80290426,80290567,0,12251097
HepG2|chr17:68440007-68440057,chr17,68440007,68440057,HepG2|chr17:62916023-62916152,chr17,62916023,62916152,0,5523984
HepG2|chr17:68520023-68520152,chr17,68520023,68520152,HepG2|chr17:43572642-43572732,chr17,43572642,43572732,0,24947381
HepG2|chr17:68547291-68547418,chr17,68547291,68547418,HepG2|chr17:40577035-40577080,chr17,40577035,40577080,0,27970256
HepG2|chr17:68573718-68573774,chr17,68573718,68573774,HepG2|chr17:77706759-77706830,chr17,77706759,77706830,0,9133041
HepG2|chr17:68925468-68925538,chr17,68925468,68925538,HepG2|chr17:60700097-60700161,chr17,60700097,60700161,0,8225371
HepG2|chr17:69068647-69068731,chr17,69068647,69068731,HepG2|chr17:80290517-80290580,chr17,80290517,80290580,0,11221870
HepG2|chr17:69130765-69130885,chr17,69130765,69130885,HepG2|chr17:62488938-62488975,chr17,62488938,62488975,0,6641827
HepG2|chr17:69236967-69237026,chr17,69236967,69237026,HepG2|chr17:16942916-16943026,chr17,16942916,16943026,0,52294051
HepG2|chr17:69241477-69241620,chr17,69241477,69241620,HepG2|chr17:75317356-75317418,chr17,75317356,75317418,0,6075879
HepG2|chr17:69281388-69281456,chr17,69281388,69281456,HepG2|chr17:62657518-62657647,chr17,62657518,62657647,0,6623870
HepG2|chr17:69299709-69299814,chr17,69299709,69299814,HepG2|chr17:65823086-65823149,chr17,65823086,65823149,0,3476623
HepG2|chr17:69324150-69324300,chr17,69324150,69324300,HepG2|chr17:8105619-8105645,chr17,8105619,8105645,0,61218531
HepG2|chr17:69508062-69508093,chr17,69508062,69508093,HepG2|chr17:79759465-79759584,chr17,79759465,79759584,0,10251403
HepG2|chr17:69625468-69625576,chr17,69625468,69625576,HepG2|chr17:8203079-8203163,chr17,8203079,8203163,0,61422389
HepG2|chr17:69632012-69632073,chr17,69632012,69632073,HepG2|chr17:19549541-19549628,chr17,19549541,19549628,0,50082471
HepG2|chr17:69732235-69732385,chr17,69732235,69732385,HepG2|chr17:80290553-80290580,chr17,80290553,80290580,0,10558318
HepG2|chr17:69734069-69734169,chr17,69734069,69734169,HepG2|chr17:62915431-62915544,chr17,62915431,62915544,0,6818638
HepG2|chr17:69907015-69907073,chr17,69907015,69907073,HepG2|chr17:8105619-8105648,chr17,8105619,8105648,0,61801396
HepG2|chr17:69922928-69923016,chr17,69922928,69923016,HepG2|chr17:79874666-79874774,chr17,79874666,79874774,0,9951738
HepG2|chr17:69942893-69942995,chr17,69942893,69942995,HepG2|chr17:66193037-66193085,chr17,66193037,66193085,0,3749856
HepG2|chr17:69980997-69981105,chr17,69980997,69981105,HepG2|chr17:62915890-62915968,chr17,62915890,62915968,0,7065107
HepG2|chr17:70060165-70060315,chr17,70060165,70060315,HepG2|chr17:62915752-62915902,chr17,62915752,62915902,0,7144413
HepG2|chr17:70082667-70082728,chr17,70082667,70082728,HepG2|chr17:57969931-57970020,chr17,57969931,57970020,0,12112736
HepG2|chr17:70195957-70196047,chr17,70195957,70196047,HepG2|chr17:43570440-43570590,chr17,43570440,43570590,0,26625517
HepG2|chr17:70267317-70267467,chr17,70267317,70267467,HepG2|chr17:57969931-57970038,chr17,57969931,57970038,0,12297386
HepG2|chr17:70342570-70342683,chr17,70342570,70342683,HepG2|chr17:57968929-57968948,chr17,57968929,57968948,0,12373641
HepG2|chr17:70358623-70358691,chr17,70358623,70358691,HepG2|chr17:57969931-57970013,chr17,57969931,57970013,0,12388692
HepG2|chr17:70456308-70456347,chr17,70456308,70456347,HepG2|chr17:4616127-4616238,chr17,4616127,4616238,0,65840181
HepG2|chr17:70575570-70575665,chr17,70575570,70575665,HepG2|chr17:40576968-40577080,chr17,40576968,40577080,0,29998602
HepG2|chr17:70734173-70734216,chr17,70734173,70734216,HepG2|chr17:41129340-41129403,chr17,41129340,41129403,0,29604833
HepG2|chr17:70772985-70773096,chr17,70772985,70773096,HepG2|chr17:57969931-57969970,chr17,57969931,57969970,0,12803054
HepG2|chr17:71245055-71245094,chr17,71245055,71245094,HepG2|chr17:77005132-77005243,chr17,77005132,77005243,0,5760077
HepG2|chr17:71256925-71257002,chr17,71256925,71257002,HepG2|chr17:38277503-38277629,chr17,38277503,38277629,0,32979422
HepG2|chr17:71296332-71296464,chr17,71296332,71296464,HepG2|chr17:57969979-57969998,chr17,57969979,57969998,0,13326353
HepG2|chr17:71338739-71338857,chr17,71338739,71338857,HepG2|chr17:17584695-17584725,chr17,17584695,17584725,0,53754044
HepG2|chr17:71364130-71364197,chr17,71364130,71364197,HepG2|chr17:57969663-57969736,chr17,57969663,57969736,0,13394467
HepG2|chr17:71403393-71403501,chr17,71403393,71403501,HepG2|chr17:79759465-79759507,chr17,79759465,79759507,0,8356072
HepG2|chr17:71414437-71414482,chr17,71414437,71414482,HepG2|chr17:57969931-57970040,chr17,57969931,57970040,0,13444506
HepG2|chr17:71559146-71559202,chr17,71559146,71559202,HepG2|chr17:28256726-28256817,chr17,28256726,28256817,0,43302420
HepG2|chr17:71561736-71561770,chr17,71561736,71561770,HepG2|chr17:80290495-80290580,chr17,80290495,80290580,0,8728759
HepG2|chr17:71594999-71595149,chr17,71594999,71595149,HepG2|chr17:60142725-60142752,chr17,60142725,60142752,0,11452274
HepG2|chr17:71961412-71961522,chr17,71961412,71961522,HepG2|chr17:79759461-79759523,chr17,79759461,79759523,0,7798049
HepG2|chr17:71978959-71979014,chr17,71978959,71979014,HepG2|chr17:62915431-62915538,chr17,62915431,62915538,0,9063528
HepG2|chr17:71999350-71999427,chr17,71999350,71999427,HepG2|chr17:80290507-80290580,chr17,80290507,80290580,0,8291157
HepG2|chr17:72017026-72017070,chr17,72017026,72017070,HepG2|chr17:80290506-80290580,chr17,80290506,80290580,0,8273480
HepG2|chr17:72073898-72073946,chr17,72073898,72073946,HepG2|chr17:57969663-57969736,chr17,57969663,57969736,0,14104235
HepG2|chr17:72091033-72091146,chr17,72091033,72091146,HepG2|chr17:43572704-43572851,chr17,43572704,43572851,0,28518329
HepG2|chr17:72279455-72279541,chr17,72279455,72279541,HepG2|chr17:79848098-79848135,chr17,79848098,79848135,0,7568643
HepG2|chr17:72317213-72317240,chr17,72317213,72317240,HepG2|chr17:4618690-4618793,chr17,4618690,4618793,0,67698523
HepG2|chr17:72396367-72396438,chr17,72396367,72396438,HepG2|chr17:39930555-39930630,chr17,39930555,39930630,0,32465812
HepG2|chr17:72585905-72586015,chr17,72585905,72586015,HepG2|chr17:40576934-40577080,chr17,40576934,40577080,0,32008971
HepG2|chr17:72661303-72661453,chr17,72661303,72661453,HepG2|chr17:62915436-62915570,chr17,62915436,62915570,0,9745867
HepG2|chr17:72713049-72713087,chr17,72713049,72713087,HepG2|chr17:76370443-76370506,chr17,76370443,76370506,0,3657394
HepG2|chr17:72937116-72937266,chr17,72937116,72937266,HepG2|chr17:62915431-62915531,chr17,62915431,62915531,0,10021685
HepG2|chr17:72986812-72986870,chr17,72986812,72986870,HepG2|chr17:79886333-79886355,chr17,79886333,79886355,0,6899521
HepG2|chr17:73174507-73174545,chr17,73174507,73174545,HepG2|chr17:6602978-6603071,chr17,6602978,6603071,0,66571529
HepG2|chr17:73273985-73274083,chr17,73273985,73274083,HepG2|chr17:62916110-62916170,chr17,62916110,62916170,0,10357875
HepG2|chr17:73304307-73304428,chr17,73304307,73304428,HepG2|chr17:62488938-62488975,chr17,62488938,62488975,0,10815369
HepG2|chr17:73627031-73627070,chr17,73627031,73627070,HepG2|chr17:79759461-79759572,chr17,79759461,79759572,0,6132430
HepG2|chr17:73648265-73648349,chr17,73648265,73648349,HepG2|chr17:62915431-62915529,chr17,62915431,62915529,0,10732834
HepG2|chr17:73719047-73719159,chr17,73719047,73719159,HepG2|chr17:8203079-8203163,chr17,8203079,8203163,0,65515968
HepG2|chr17:74030720-74030808,chr17,74030720,74030808,HepG2|chr17:8105619-8105648,chr17,8105619,8105648,0,65925101
HepG2|chr17:74052636-74052768,chr17,74052636,74052768,HepG2|chr17:7833642-7833681,chr17,7833642,7833681,0,66218994
HepG2|chr17:74124688-74124834,chr17,74124688,74124834,HepG2|chr17:3631919-3632011,chr17,3631919,3632011,0,70492769
HepG2|chr17:74190125-74190275,chr17,74190125,74190275,HepG2|chr17:80290553-80290580,chr17,80290553,80290580,0,6100428
HepG2|chr17:74282125-74282195,chr17,74282125,74282195,HepG2|chr17:79759461-79759541,chr17,79759461,79759541,0,5477336
HepG2|chr17:74402425-74402563,chr17,74402425,74402563,HepG2|chr17:79759481-79759631,chr17,79759481,79759631,0,5357056
HepG2|chr17:74453737-74453788,chr17,74453737,74453788,HepG2|chr17:29897401-29897508,chr17,29897401,29897508,0,44556336
HepG2|chr17:74473875-74473934,chr17,74473875,74473934,HepG2|chr17:40575678-40575760,chr17,40575678,40575760,0,33898197
HepG2|chr17:74478845-74478926,chr17,74478845,74478926,HepG2|chr17:41326896-41326965,chr17,41326896,41326965,0,33151949
HepG2|chr17:74521367-74521517,chr17,74521367,74521517,HepG2|chr17:80290535-80290580,chr17,80290535,80290580,0,5769168
HepG2|chr17:74650510-74650601,chr17,74650510,74650601,HepG2|chr17:40577023-40577080,chr17,40577023,40577080,0,34073487
HepG2|chr17:74695242-74695392,chr17,74695242,74695392,HepG2|chr17:72978819-72978907,chr17,72978819,72978907,0,1716423
HepG2|chr17:74748137-74748178,chr17,74748137,74748178,HepG2|chr17:6602978-6603067,chr17,6602978,6603067,0,68145159
HepG2|chr17:74779914-74780021,chr17,74779914,74780021,HepG2|chr17:40577055-40577080,chr17,40577055,40577080,0,34202859
HepG2|chr17:74824126-74824185,chr17,74824126,74824185,HepG2|chr17:80290489-80290580,chr17,80290489,80290580,0,5466363
HepG2|chr17:74899215-74899301,chr17,74899215,74899301,HepG2|chr17:77005132-77005243,chr17,77005132,77005243,0,2105917
HepG2|chr17:75049193-75049319,chr17,75049193,75049319,HepG2|chr17:62657641-62657750,chr17,62657641,62657750,0,12391552
HepG2|chr17:75094749-75094777,chr17,75094749,75094777,HepG2|chr17:8278246-8278283,chr17,8278246,8278283,0,66816503
HepG2|chr17:75124831-75124981,chr17,75124831,75124981,HepG2|chr17:80290451-80290580,chr17,80290451,80290580,0,5165620
HepG2|chr17:75200395-75200466,chr17,75200395,75200466,HepG2|chr17:65823086-65823149,chr17,65823086,65823149,0,9377309
HepG2|chr17:75204035-75204093,chr17,75204035,75204093,HepG2|chr17:79886333-79886355,chr17,79886333,79886355,0,4682298
HepG2|chr17:75349429-75349579,chr17,75349429,75349579,HepG2|chr17:72978819-72978907,chr17,72978819,72978907,0,2370610
HepG2|chr17:75371146-75371278,chr17,75371146,75371278,HepG2|chr17:57969979-57969998,chr17,57969979,57969998,0,17401167
HepG2|chr17:75460022-75460067,chr17,75460022,75460067,HepG2|chr17:76974353-76974496,chr17,76974353,76974496,0,1514331
HepG2|chr17:75472701-75472761,chr17,75472701,75472761,HepG2|chr17:62915431-62915538,chr17,62915431,62915538,0,12557270
HepG2|chr17:75593176-75593298,chr17,75593176,75593298,HepG2|chr17:80194728-80194839,chr17,80194728,80194839,0,4601552
HepG2|chr17:75604904-75604955,chr17,75604904,75604955,HepG2|chr17:43570304-43570373,chr17,43570304,43570373,0,32034600
HepG2|chr17:75646650-75646716,chr17,75646650,75646716,HepG2|chr17:62916166-62916250,chr17,62916166,62916250,0,12730484
HepG2|chr17:75702119-75702232,chr17,75702119,75702232,HepG2|chr17:62488938-62488975,chr17,62488938,62488975,0,13213181
HepG2|chr17:75707341-75707442,chr17,75707341,75707442,HepG2|chr17:6940680-6940807,chr17,6940680,6940807,0,68766661
HepG2|chr17:75732095-75732134,chr17,75732095,75732134,HepG2|chr17:80198990-80199012,chr17,80198990,80199012,0,4466895
HepG2|chr17:76134460-76134536,chr17,76134460,76134536,HepG2|chr17:8095775-8095818,chr17,8095775,8095818,0,68038685
HepG2|chr17:76336581-76336638,chr17,76336581,76336638,HepG2|chr17:40575671-40575760,chr17,40575671,40575760,0,35760910
HepG2|chr17:76524478-76524628,chr17,76524478,76524628,HepG2|chr17:62915825-62915975,chr17,62915825,62915975,0,13608653
HepG2|chr17:76643209-76643234,chr17,76643209,76643234,HepG2|chr17:80290451-80290580,chr17,80290451,80290580,0,3647242
HepG2|chr17:76695990-76696140,chr17,76695990,76696140,HepG2|chr17:28256546-28256579,chr17,28256546,28256579,0,48439444
HepG2|chr17:76768681-76768753,chr17,76768681,76768753,HepG2|chr17:62915431-62915519,chr17,62915431,62915519,0,13853250
HepG2|chr17:76867216-76867280,chr17,76867216,76867280,HepG2|chr17:73452030-73452130,chr17,73452030,73452130,0,3415186
HepG2|chr17:76897402-76897436,chr17,76897402,76897436,HepG2|chr17:8278245-8278283,chr17,8278245,8278283,0,68619157
HepG2|chr17:76912511-76912571,chr17,76912511,76912571,HepG2|chr17:62915431-62915538,chr17,62915431,62915538,0,13997080
HepG2|chr17:76949719-76949844,chr17,76949719,76949844,HepG2|chr17:79759461-79759486,chr17,79759461,79759486,0,2809742
HepG2|chr17:76984488-76984615,chr17,76984488,76984615,HepG2|chr17:40577035-40577080,chr17,40577035,40577080,0,36407453
HepG2|chr17:77056957-77057013,chr17,77056957,77057013,HepG2|chr17:38221511-38221604,chr17,38221511,38221604,0,38835446
HepG2|chr17:77190612-77190728,chr17,77190612,77190728,HepG2|chr17:66193037-66193085,chr17,66193037,66193085,0,10997575
HepG2|chr17:77366774-77366863,chr17,77366774,77366863,HepG2|chr17:57969931-57970017,chr17,57969931,57970017,0,19396843
HepG2|chr17:77549344-77549385,chr17,77549344,77549385,HepG2|chr17:30409660-30409769,chr17,30409660,30409769,0,47139684
HepG2|chr17:77560779-77560819,chr17,77560779,77560819,HepG2|chr17:79759461-79759584,chr17,79759461,79759584,0,2198682
HepG2|chr17:77623909-77623977,chr17,77623909,77623977,HepG2|chr17:4618837-4618899,chr17,4618837,4618899,0,73005072
HepG2|chr17:77842007-77842048,chr17,77842007,77842048,HepG2|chr17:30409660-30409769,chr17,30409660,30409769,0,47432347
HepG2|chr17:77915419-77915540,chr17,77915419,77915540,HepG2|chr17:62488938-62488975,chr17,62488938,62488975,0,15426481
HepG2|chr17:77924930-77925065,chr17,77924930,77925065,HepG2|chr17:36453770-36453913,chr17,36453770,36453913,0,41471160
HepG2|chr17:77954406-77954492,chr17,77954406,77954492,HepG2|chr17:57971859-57971939,chr17,57971859,57971939,0,19982547
HepG2|chr17:77996666-77996683,chr17,77996666,77996683,HepG2|chr17:8095775-8095818,chr17,8095775,8095818,0,69900891
HepG2|chr17:78022341-78022409,chr17,78022341,78022409,HepG2|chr17:76370443-76370465,chr17,76370443,76370465,0,1651898
HepG2|chr17:78043294-78043428,chr17,78043294,78043428,HepG2|chr17:73454368-73454433,chr17,73454368,73454433,0,4588926
HepG2|chr17:78228314-78228365,chr17,78228314,78228365,HepG2|chr17:73081842-73081989,chr17,73081842,73081989,0,5146472
HepG2|chr17:78259532-78259623,chr17,78259532,78259623,HepG2|chr17:79759461-79759520,chr17,79759461,79759520,0,1499929
HepG2|chr17:78305591-78305649,chr17,78305591,78305649,HepG2|chr17:80290489-80290580,chr17,80290489,80290580,0,1984898
HepG2|chr17:78342357-78342411,chr17,78342357,78342411,HepG2|chr17:42297808-42297873,chr17,42297808,42297873,0,36044549
HepG2|chr17:78500908-78500971,chr17,78500908,78500971,HepG2|chr17:38221511-38221604,chr17,38221511,38221604,0,40279397
HepG2|chr17:78536513-78536604,chr17,78536513,78536604,HepG2|chr17:66193034-66193174,chr17,66193034,66193174,0,12343479
HepG2|chr17:78638389-78638527,chr17,78638389,78638527,HepG2|chr17:79759547-79759582,chr17,79759547,79759582,0,1121158
HepG2|chr17:79146538-79146574,chr17,79146538,79146574,HepG2|chr17:79759465-79759500,chr17,79759465,79759500,0,612927
HepG2|chr17:79197247-79197397,chr17,79197247,79197397,HepG2|chr17:62915765-62915912,chr17,62915765,62915912,0,16281482
HepG2|chr17:79209371-79209486,chr17,79209371,79209486,HepG2|chr17:72980242-72980277,chr17,72980242,72980277,0,6229129
HepG2|chr17:79427412-79427562,chr17,79427412,79427562,HepG2|chr17:76491738-76491861,chr17,76491738,76491861,0,2935674
HepG2|chr17:79499281-79499393,chr17,79499281,79499393,HepG2|chr17:39931016-39931054,chr17,39931016,39931054,0,39568265
HepG2|chr17:79720249-79720366,chr17,79720249,79720366,HepG2|chr17:38274577-38274610,chr17,38274577,38274610,0,41445672
HepG2|chr17:79988580-79988708,chr17,79988580,79988708,HepG2|chr17:79759482-79759632,chr17,79759482,79759632,0,229098
HepG2|chr17:80051204-80051284,chr17,80051204,80051284,HepG2|chr17:40576940-40577008,chr17,40576940,40577008,0,39474264
HepG2|chr17:80057155-80057223,chr17,80057155,80057223,HepG2|chr17:62657518-62657647,chr17,62657518,62657647,0,17399637
HepG2|chr17:80214153-80214231,chr17,80214153,80214231,HepG2|chr17:62917246-62917315,chr17,62917246,62917315,0,17296907
HepG2|chr17:80272726-80272752,chr17,80272726,80272752,HepG2|chr17:4618830-4618881,chr17,4618830,4618881,0,75653896
HepG2|chr17:80320898-80320975,chr17,80320898,80320975,HepG2|chr17:79759461-79759548,chr17,79759461,79759548,0,561437
HepG2|chr17:80468845-80468960,chr17,80468845,80468960,HepG2|chr17:79759461-79759523,chr17,79759461,79759523,0,709384
HepG2|chr17:80475031-80475121,chr17,80475031,80475121,HepG2|chr17:16942916-16942987,chr17,16942916,16942987,0,63532115
HepG2|chr17:80577402-80577457,chr17,80577402,80577457,HepG2|chr17:6602978-6603045,chr17,6602978,6603045,0,73974424
HepG2|chr17:80632189-80632293,chr17,80632189,80632293,HepG2|chr17:57970982-57971009,chr17,57970982,57971009,0,22661207
HepG2|chr17:80644488-80644638,chr17,80644488,80644638,HepG2|chr17:62915431-62915576,chr17,62915431,62915576,0,17729057
HepG2|chr17:80718758-80718862,chr17,80718758,80718862,HepG2|chr17:57970982-57971009,chr17,57970982,57971009,0,22747776
HepG2|chr17:80753134-80753155,chr17,80753134,80753155,HepG2|chr17:80290451-80290580,chr17,80290451,80290580,0,462683
HepG2|chr17:80904682-80904753,chr17,80904682,80904753,HepG2|chr17:40575719-40575760,chr17,40575719,40575760,0,40328963
HepG2|chr17:81097995-81098073,chr17,81097995,81098073,HepG2|chr17:57969931-57970038,chr17,57969931,57970038,0,23128064
HepG2|chr17:81190205-81190316,chr17,81190205,81190316,HepG2|chr17:7833642-7833681,chr17,7833642,7833681,0,73356563
HepG2|chr18:5158983-5159033,chr18,5158983,5159033,HepG2|chr18:9102401-9102501,chr18,9102401,9102501,0,3943418
HepG2|chr18:13357431-13357498,chr18,13357431,13357498,HepG2|chr18:60189544-60189621,chr18,60189544,60189621,0,46832113
HepG2|chr18:14711272-14711422,chr18,14711272,14711422,HepG2|chr18:12992706-12992741,chr18,12992706,12992741,0,1718566
HepG2|chr18:18891038-18891065,chr18,18891038,18891065,HepG2|chr18:11983725-11983763,chr18,11983725,11983763,0,6907313
HepG2|chr18:19333837-19333904,chr18,19333837,19333904,HepG2|chr18:11978621-11978771,chr18,11978621,11978771,0,7355216
HepG2|chr18:21032965-21033037,chr18,21032965,21033037,HepG2|chr18:43655878-43655953,chr18,43655878,43655953,0,22622913
HepG2|chr18:22078668-22078757,chr18,22078668,22078757,HepG2|chr18:2845809-2845857,chr18,2845809,2845857,0,19232859
HepG2|chr18:23297649-23297733,chr18,23297649,23297733,HepG2|chr18:11888335-11888381,chr18,11888335,11888381,0,11409314
HepG2|chr18:23992095-23992184,chr18,23992095,23992184,HepG2|chr18:2845809-2845857,chr18,2845809,2845857,0,21146286
HepG2|chr18:25742274-25742322,chr18,25742274,25742322,HepG2|chr18:9102401-9102513,chr18,9102401,9102513,0,16639873
HepG2|chr18:26087640-26087790,chr18,26087640,26087790,HepG2|chr18:12992706-12992741,chr18,12992706,12992741,0,13094934
HepG2|chr18:27265268-27265348,chr18,27265268,27265348,HepG2|chr18:9102401-9102503,chr18,9102401,9102503,0,18162867
HepG2|chr18:28068338-28068365,chr18,28068338,28068365,HepG2|chr18:11983725-11983763,chr18,11983725,11983763,0,16084613
HepG2|chr18:28986264-28986350,chr18,28986264,28986350,HepG2|chr18:2842263-2842307,chr18,2842263,2842307,0,26144001
HepG2|chr18:34976757-34976869,chr18,34976757,34976869,HepG2|chr18:33876274-33876297,chr18,33876274,33876297,0,1100483
HepG2|chr18:38459343-38459378,chr18,38459343,38459378,HepG2|chr18:9102401-9102513,chr18,9102401,9102513,0,29356942
HepG2|chr18:45951277-45951401,chr18,45951277,45951401,HepG2|chr18:60185861-60185887,chr18,60185861,60185887,0,14234584
HepG2|chr18:46875519-46875634,chr18,46875519,46875634,HepG2|chr18:12992706-12992741,chr18,12992706,12992741,0,33882813
HepG2|chr18:49637610-49637690,chr18,49637610,49637690,HepG2|chr18:9102401-9102503,chr18,9102401,9102503,0,40535209
HepG2|chr18:49683313-49683428,chr18,49683313,49683428,HepG2|chr18:12992706-12992741,chr18,12992706,12992741,0,36690607
HepG2|chr18:50749993-50750077,chr18,50749993,50750077,HepG2|chr18:11888335-11888381,chr18,11888335,11888381,0,38861658
HepG2|chr18:51220168-51220212,chr18,51220168,51220212,HepG2|chr18:33079617-33079767,chr18,33079617,33079767,0,18140551
HepG2|chr18:51407923-51407967,chr18,51407923,51407967,HepG2|chr18:33079617-33079767,chr18,33079617,33079767,0,18328306
HepG2|chr18:53275392-53275440,chr18,53275392,53275440,HepG2|chr18:9102401-9102513,chr18,9102401,9102513,0,44172991
HepG2|chr18:53971041-53971108,chr18,53971041,53971108,HepG2|chr18:11978621-11978771,chr18,11978621,11978771,0,41992420
HepG2|chr18:54510215-54510282,chr18,54510215,54510282,HepG2|chr18:60189544-60189621,chr18,60189544,60189621,0,5679329
HepG2|chr18:55951292-55951378,chr18,55951292,55951378,HepG2|chr18:2842263-2842307,chr18,2842263,2842307,0,53109029
HepG2|chr18:57788522-57788667,chr18,57788522,57788667,HepG2|chr18:60185861-60185887,chr18,60185861,60185887,0,2397339
HepG2|chr18:60016236-60016348,chr18,60016236,60016348,HepG2|chr18:33876274-33876297,chr18,33876274,33876297,0,26139962
HepG2|chr18:61753651-61753715,chr18,61753651,61753715,HepG2|chr18:33079904-33080054,chr18,33079904,33080054,0,28673747
HepG2|chr18:64414167-64414282,chr18,64414167,64414282,HepG2|chr18:33876274-33876297,chr18,33876274,33876297,0,30537893
HepG2|chr18:68954132-68954196,chr18,68954132,68954196,HepG2|chr18:33079904-33080054,chr18,33079904,33080054,0,35874228
HepG2|chr18:69234053-69234177,chr18,69234053,69234177,HepG2|chr18:60185861-60185887,chr18,60185861,60185887,0,9048192
HepG2|chr18:72229254-72229326,chr18,72229254,72229326,HepG2|chr18:43655878-43655953,chr18,43655878,43655953,0,28573376
HepG2|chr18:73021941-73021991,chr18,73021941,73021991,HepG2|chr18:9102401-9102501,chr18,9102401,9102501,0,63919540
HepG2|chr18:76901385-76901500,chr18,76901385,76901500,HepG2|chr18:33876274-33876297,chr18,33876274,33876297,0,43025111
HepG2|chr18:76919719-76919864,chr18,76919719,76919864,HepG2|chr18:60185861-60185887,chr18,60185861,60185887,0,16733858
HepG2|chr18:77362195-77362230,chr18,77362195,77362230,HepG2|chr18:9102401-9102513,chr18,9102401,9102513,0,68259794
HepG2|chr19:6907-7005,chr19,6907,7005,HepG2|chr19:53971127-53971179,chr19,53971127,53971179,0,53964220
HepG2|chr19:17241-17347,chr19,17241,17347,HepG2|chr19:53193226-53193367,chr19,53193226,53193367,0,53175985
HepG2|chr19:84322-84364,chr19,84322,84364,HepG2|chr19:4637955-4638105,chr19,4637955,4638105,0,4553633
HepG2|chr19:155485-155563,chr19,155485,155563,HepG2|chr19:45248301-45248349,chr19,45248301,45248349,0,45092816
HepG2|chr19:207734-207772,chr19,207734,207772,HepG2|chr19:45248300-45248448,chr19,45248300,45248448,0,45040566
HepG2|chr19:335839-335872,chr19,335839,335872,HepG2|chr19:49864295-49864336,chr19,49864295,49864336,0,49528456
HepG2|chr19:347086-347155,chr19,347086,347155,HepG2|chr19:4634985-4635127,chr19,4634985,4635127,0,4287899
HepG2|chr19:347620-347679,chr19,347620,347679,HepG2|chr19:45248301-45248392,chr19,45248301,45248392,0,44900681
HepG2|chr19:389404-389472,chr19,389404,389472,HepG2|chr19:4634944-4635094,chr19,4634944,4635094,0,4245540
HepG2|chr19:446900-446947,chr19,446900,446947,HepG2|chr19:44599830-44599900,chr19,44599830,44599900,0,44152930
HepG2|chr19:512158-512189,chr19,512158,512189,HepG2|chr19:4634986-4635112,chr19,4634986,4635112,0,4122828
HepG2|chr19:531775-531822,chr19,531775,531822,HepG2|chr19:3553375-3553484,chr19,3553375,3553484,0,3021600
HepG2|chr19:543344-543444,chr19,543344,543444,HepG2|chr19:58893949-58893994,chr19,58893949,58893994,0,58350605
HepG2|chr19:548446-548533,chr19,548446,548533,HepG2|chr19:4393520-4393562,chr19,4393520,4393562,0,3845074
HepG2|chr19:613833-613954,chr19,613833,613954,HepG2|chr19:53899396-53899546,chr19,53899396,53899546,0,53285563
HepG2|chr19:698980-699043,chr19,698980,699043,HepG2|chr19:4637525-4637672,chr19,4637525,4637672,0,3938545
HepG2|chr19:714263-714305,chr19,714263,714305,HepG2|chr19:4634986-4635114,chr19,4634986,4635114,0,3920723
HepG2|chr19:756601-756648,chr19,756601,756648,HepG2|chr19:4634986-4635116,chr19,4634986,4635116,0,3878385
HepG2|chr19:772062-772204,chr19,772062,772204,HepG2|chr19:53899405-53899504,chr19,53899405,53899504,0,53127343
HepG2|chr19:811999-812091,chr19,811999,812091,HepG2|chr19:45248327-45248477,chr19,45248327,45248477,0,44436328
HepG2|chr19:819991-820045,chr19,819991,820045,HepG2|chr19:45247433-45247529,chr19,45247433,45247529,0,44427442
HepG2|chr19:864368-864446,chr19,864368,864446,HepG2|chr19:6741295-6741369,chr19,6741295,6741369,0,5876927
HepG2|chr19:959188-959296,chr19,959188,959296,HepG2|chr19:53899417-53899504,chr19,53899417,53899504,0,52940229
HepG2|chr19:984372-984426,chr19,984372,984426,HepG2|chr19:45247433-45247529,chr19,45247433,45247529,0,44263061
HepG2|chr19:1002207-1002263,chr19,1002207,1002263,HepG2|chr19:4399455-4399549,chr19,4399455,4399549,0,3397248
HepG2|chr19:1025849-1025999,chr19,1025849,1025999,HepG2|chr19:53899391-53899504,chr19,53899391,53899504,0,52873542
HepG2|chr19:1073259-1073381,chr19,1073259,1073381,HepG2|chr19:4634980-4635114,chr19,4634980,4635114,0,3561721
HepG2|chr19:1184266-1184413,chr19,1184266,1184413,HepG2|chr19:53192667-53192817,chr19,53192667,53192817,0,52008401
HepG2|chr19:1293857-1293957,chr19,1293857,1293957,HepG2|chr19:53899403-53899490,chr19,53899403,53899490,0,52605546
HepG2|chr19:1323117-1323267,chr19,1323117,1323267,HepG2|chr19:53971127-53971179,chr19,53971127,53971179,0,52648010
HepG2|chr19:1361463-1361501,chr19,1361463,1361501,HepG2|chr19:45248333-45248480,chr19,45248333,45248480,0,43886870
HepG2|chr19:1473704-1473749,chr19,1473704,1473749,HepG2|chr19:53869854-53869959,chr19,53869854,53869959,0,52396150
HepG2|chr19:1569745-1569794,chr19,1569745,1569794,HepG2|chr19:4634984-4635117,chr19,4634984,4635117,0,3065239
HepG2|chr19:1615480-1615543,chr19,1615480,1615543,HepG2|chr19:4635750-4635856,chr19,4635750,4635856,0,3020270
HepG2|chr19:1645546-1645594,chr19,1645546,1645594,HepG2|chr19:45248301-45248395,chr19,45248301,45248395,0,43602755
HepG2|chr19:1759257-1759348,chr19,1759257,1759348,HepG2|chr19:3573798-3573857,chr19,3573798,3573857,0,1814541
HepG2|chr19:1808363-1808437,chr19,1808363,1808437,HepG2|chr19:49864292-49864424,chr19,49864292,49864424,0,48055929
HepG2|chr19:1809732-1809765,chr19,1809732,1809765,HepG2|chr19:45248301-45248439,chr19,45248301,45248439,0,43438569
HepG2|chr19:1887134-1887182,chr19,1887134,1887182,HepG2|chr19:3553396-3553484,chr19,3553396,3553484,0,1666262
HepG2|chr19:1932779-1932885,chr19,1932779,1932885,HepG2|chr19:47293690-47293725,chr19,47293690,47293725,0,45360911
HepG2|chr19:2032133-2032180,chr19,2032133,2032180,HepG2|chr19:45248301-45248395,chr19,45248301,45248395,0,43216168
HepG2|chr19:2082401-2082551,chr19,2082401,2082551,HepG2|chr19:53899373-53899520,chr19,53899373,53899520,0,51816972
HepG2|chr19:2174154-2174219,chr19,2174154,2174219,HepG2|chr19:53869851-53869947,chr19,53869851,53869947,0,51695697
HepG2|chr19:2237712-2237830,chr19,2237712,2237830,HepG2|chr19:10361611-10361668,chr19,10361611,10361668,0,8123899
HepG2|chr19:2307289-2307373,chr19,2307289,2307373,HepG2|chr19:4634986-4635115,chr19,4634986,4635115,0,2327697
HepG2|chr19:2315639-2315712,chr19,2315639,2315712,HepG2|chr19:8583568-8583597,chr19,8583568,8583597,0,6267929
HepG2|chr19:2351024-2351044,chr19,2351024,2351044,HepG2|chr19:4634986-4635116,chr19,4634986,4635116,0,2283962
HepG2|chr19:2387018-2387121,chr19,2387018,2387121,HepG2|chr19:4634986-4635111,chr19,4634986,4635111,0,2247968
HepG2|chr19:2571710-2571860,chr19,2571710,2571860,HepG2|chr19:52488992-52489030,chr19,52488992,52489030,0,49917282
HepG2|chr19:2595417-2595479,chr19,2595417,2595479,HepG2|chr19:45248301-45248394,chr19,45248301,45248394,0,42652884
HepG2|chr19:2792289-2792395,chr19,2792289,2792395,HepG2|chr19:53193226-53193367,chr19,53193226,53193367,0,50400937
HepG2|chr19:2857559-2857582,chr19,2857559,2857582,HepG2|chr19:10361611-10361735,chr19,10361611,10361735,0,7504052
HepG2|chr19:2986395-2986424,chr19,2986395,2986424,HepG2|chr19:16736048-16736198,chr19,16736048,16736198,0,13749653
HepG2|chr19:3007009-3007152,chr19,3007009,3007152,HepG2|chr19:45248172-45248238,chr19,45248172,45248238,0,42241163
HepG2|chr19:3070307-3070338,chr19,3070307,3070338,HepG2|chr19:45251062-45251212,chr19,45251062,45251212,0,42180755
HepG2|chr19:3107620-3107721,chr19,3107620,3107721,HepG2|chr19:4634986-4635035,chr19,4634986,4635035,0,1527366
HepG2|chr19:3135059-3135144,chr19,3135059,3135144,HepG2|chr19:4637028-4637054,chr19,4637028,4637054,0,1501969
HepG2|chr19:3307931-3307955,chr19,3307931,3307955,HepG2|chr19:45248301-45248394,chr19,45248301,45248394,0,41940370
HepG2|chr19:3307983-3308056,chr19,3307983,3308056,HepG2|chr19:9549047-9549106,chr19,9549047,9549106,0,6241064
HepG2|chr19:3309275-3309367,chr19,3309275,3309367,HepG2|chr19:4634986-4635059,chr19,4634986,4635059,0,1325711
HepG2|chr19:3535356-3535412,chr19,3535356,3535412,HepG2|chr19:4635066-4635216,chr19,4635066,4635216,0,1099710
HepG2|chr19:3570130-3570246,chr19,3570130,3570246,HepG2|chr19:45248301-45248405,chr19,45248301,45248405,0,41678171
HepG2|chr19:3651601-3651666,chr19,3651601,3651666,HepG2|chr19:53869851-53869947,chr19,53869851,53869947,0,50218250
HepG2|chr19:3699805-3699874,chr19,3699805,3699874,HepG2|chr19:4634986-4635066,chr19,4634986,4635066,0,935181
HepG2|chr19:3718771-3718859,chr19,3718771,3718859,HepG2|chr19:45248301-45248394,chr19,45248301,45248394,0,41529530
HepG2|chr19:3835719-3835788,chr19,3835719,3835788,HepG2|chr19:45248407-45248557,chr19,45248407,45248557,0,41412688
HepG2|chr19:3991970-3991992,chr19,3991970,3991992,HepG2|chr19:4634986-4635114,chr19,4634986,4635114,0,643016
HepG2|chr19:4013046-4013063,chr19,4013046,4013063,HepG2|chr19:4637026-4637140,chr19,4637026,4637140,0,623980
HepG2|chr19:4035934-4036005,chr19,4035934,4036005,HepG2|chr19:4634986-4635065,chr19,4634986,4635065,0,599052
HepG2|chr19:4065197-4065291,chr19,4065197,4065291,HepG2|chr19:53971127-53971183,chr19,53971127,53971183,0,49905930
HepG2|chr19:4185029-4185090,chr19,4185029,4185090,HepG2|chr19:45248294-45248443,chr19,45248294,45248443,0,41063265
HepG2|chr19:4253356-4253506,chr19,4253356,4253506,HepG2|chr19:4634990-4635111,chr19,4634990,4635111,0,381634
HepG2|chr19:4332668-4332704,chr19,4332668,4332704,HepG2|chr19:4635381-4635495,chr19,4635381,4635495,0,302713
HepG2|chr19:4348404-4348424,chr19,4348404,4348424,HepG2|chr19:4634986-4635116,chr19,4634986,4635116,0,286582
HepG2|chr19:4484732-4484762,chr19,4484732,4484762,HepG2|chr19:3574259-3574317,chr19,3574259,3574317,0,910473
HepG2|chr19:4506631-4506769,chr19,4506631,4506769,HepG2|chr19:45251094-45251164,chr19,45251094,45251164,0,40744463
HepG2|chr19:4594557-4594590,chr19,4594557,4594590,HepG2|chr19:45251094-45251217,chr19,45251094,45251217,0,40656537
HepG2|chr19:4630883-4630975,chr19,4630883,4630975,HepG2|chr19:53971127-53971185,chr19,53971127,53971185,0,49340244
HepG2|chr19:4667729-4667795,chr19,4667729,4667795,HepG2|chr19:53971127-53971179,chr19,53971127,53971179,0,49303398
HepG2|chr19:4712691-4712722,chr19,4712691,4712722,HepG2|chr19:4635037-4635082,chr19,4635037,4635082,0,77654
HepG2|chr19:4807889-4807982,chr19,4807889,4807982,HepG2|chr19:10361611-10361668,chr19,10361611,10361668,0,5553722
HepG2|chr19:4811608-4811688,chr19,4811608,4811688,HepG2|chr19:4634985-4635127,chr19,4634985,4635127,0,176623
HepG2|chr19:4871145-4871255,chr19,4871145,4871255,HepG2|chr19:45248301-45248443,chr19,45248301,45248443,0,40377156
HepG2|chr19:5162958-5163078,chr19,5162958,5163078,HepG2|chr19:3573798-3573857,chr19,3573798,3573857,0,1589160
HepG2|chr19:5172851-5172925,chr19,5172851,5172925,HepG2|chr19:4634985-4635124,chr19,4634985,4635124,0,537866
HepG2|chr19:5186842-5186919,chr19,5186842,5186919,HepG2|chr19:793303-793453,chr19,793303,793453,0,4393539
HepG2|chr19:5344326-5344367,chr19,5344326,5344367,HepG2|chr19:13261789-13261864,chr19,13261789,13261864,0,7917463
HepG2|chr19:5445757-5445783,chr19,5445757,5445783,HepG2|chr19:45249866-45249896,chr19,45249866,45249896,0,39804109
HepG2|chr19:5503172-5503260,chr19,5503172,5503260,HepG2|chr19:58893949-58893994,chr19,58893949,58893994,0,53390777
HepG2|chr19:5520244-5520323,chr19,5520244,5520323,HepG2|chr19:53971127-53971183,chr19,53971127,53971183,0,48450883
HepG2|chr19:5563550-5563633,chr19,5563550,5563633,HepG2|chr19:45247433-45247529,chr19,45247433,45247529,0,39683883
HepG2|chr19:5578929-5579054,chr19,5578929,5579054,HepG2|chr19:3553381-3553484,chr19,3553381,3553484,0,2025548
HepG2|chr19:5619545-5619584,chr19,5619545,5619584,HepG2|chr19:3553370-3553481,chr19,3553370,3553481,0,2066175
HepG2|chr19:5830242-5830261,chr19,5830242,5830261,HepG2|chr19:4636046-4636183,chr19,4636046,4636183,0,1194196
HepG2|chr19:5869895-5869966,chr19,5869895,5869966,HepG2|chr19:4634986-4635065,chr19,4634986,4635065,0,1234909
HepG2|chr19:6110839-6110989,chr19,6110839,6110989,HepG2|chr19:53192879-53192964,chr19,53192879,53192964,0,47082040
HepG2|chr19:6251537-6251547,chr19,6251537,6251547,HepG2|chr19:4634986-4635114,chr19,4634986,4635114,0,1616551
HepG2|chr19:6473085-6473137,chr19,6473085,6473137,HepG2|chr19:4634986-4635084,chr19,4634986,4635084,0,1838099
HepG2|chr19:6523043-6523065,chr19,6523043,6523065,HepG2|chr19:49864463-49864575,chr19,49864463,49864575,0,43341420
HepG2|chr19:6526308-6526401,chr19,6526308,6526401,HepG2|chr19:4639317-4639374,chr19,4639317,4639374,0,1886991
HepG2|chr19:6572988-6573099,chr19,6572988,6573099,HepG2|chr19:53192673-53192821,chr19,53192673,53192821,0,46619685
HepG2|chr19:6708457-6708582,chr19,6708457,6708582,HepG2|chr19:4634986-4635035,chr19,4634986,4635035,0,2073471
HepG2|chr19:6836495-6836618,chr19,6836495,6836618,HepG2|chr19:792365-792391,chr19,792365,792391,0,6044130
HepG2|chr19:6839463-6839569,chr19,6839463,6839569,HepG2|chr19:4634985-4635124,chr19,4634985,4635124,0,2204478
HepG2|chr19:7106862-7106928,chr19,7106862,7106928,HepG2|chr19:45250180-45250246,chr19,45250180,45250246,0,38143318
HepG2|chr19:7387829-7387858,chr19,7387829,7387858,HepG2|chr19:49863817-49863967,chr19,49863817,49863967,0,42475988
HepG2|chr19:7443868-7443998,chr19,7443868,7443998,HepG2|chr19:56058898-56058959,chr19,56058898,56058959,0,48615030
HepG2|chr19:7653259-7653300,chr19,7653259,7653300,HepG2|chr19:4634986-4635074,chr19,4634986,4635074,0,3018273
HepG2|chr19:7709247-7709309,chr19,7709247,7709309,HepG2|chr19:4635764-4635852,chr19,4635764,4635852,0,3073483
HepG2|chr19:7711122-7711271,chr19,7711122,7711271,HepG2|chr19:1070525-1070591,chr19,1070525,1070591,0,6640597
HepG2|chr19:7800199-7800256,chr19,7800199,7800256,HepG2|chr19:45248301-45248394,chr19,45248301,45248394,0,37448102
HepG2|chr19:7844256-7844299,chr19,7844256,7844299,HepG2|chr19:45249493-45249643,chr19,45249493,45249643,0,37405237
HepG2|chr19:7867349-7867444,chr19,7867349,7867444,HepG2|chr19:4634986-4635035,chr19,4634986,4635035,0,3232363
HepG2|chr19:7938215-7938365,chr19,7938215,7938365,HepG2|chr19:4634986-4635051,chr19,4634986,4635051,0,3303229
HepG2|chr19:7945577-7945672,chr19,7945577,7945672,HepG2|chr19:16298211-16298266,chr19,16298211,16298266,0,8352634
HepG2|chr19:7996236-7996302,chr19,7996236,7996302,HepG2|chr19:4634986-4635026,chr19,4634986,4635026,0,3361250
HepG2|chr19:8147820-8147876,chr19,8147820,8147876,HepG2|chr19:45248301-45248395,chr19,45248301,45248395,0,37100481
HepG2|chr19:8305313-8305359,chr19,8305313,8305359,HepG2|chr19:1595795-1595945,chr19,1595795,1595945,0,6709518
HepG2|chr19:8342287-8342334,chr19,8342287,8342334,HepG2|chr19:45248301-45248359,chr19,45248301,45248359,0,36906014
HepG2|chr19:8380531-8380597,chr19,8380531,8380597,HepG2|chr19:45247435-45247529,chr19,45247435,45247529,0,36866904
HepG2|chr19:8481757-8481800,chr19,8481757,8481800,HepG2|chr19:45248301-45248419,chr19,45248301,45248419,0,36766544
HepG2|chr19:8502476-8502561,chr19,8502476,8502561,HepG2|chr19:4637028-4637054,chr19,4637028,4637054,0,3865448
HepG2|chr19:8770049-8770157,chr19,8770049,8770157,HepG2|chr19:53898568-53898595,chr19,53898568,53898595,0,45128519
HepG2|chr19:8943175-8943213,chr19,8943175,8943213,HepG2|chr19:45248333-45248480,chr19,45248333,45248480,0,36305158
HepG2|chr19:8952330-8952477,chr19,8952330,8952477,HepG2|chr19:53192667-53192817,chr19,53192667,53192817,0,44240337
HepG2|chr19:9014914-9014982,chr19,9014914,9014982,HepG2|chr19:33789414-33789533,chr19,33789414,33789533,0,24774500
HepG2|chr19:9034741-9034844,chr19,9034741,9034844,HepG2|chr19:11195735-11195760,chr19,11195735,11195760,0,2160994
HepG2|chr19:9096386-9096513,chr19,9096386,9096513,HepG2|chr19:53192675-53192825,chr19,53192675,53192825,0,44096289
HepG2|chr19:9239587-9239646,chr19,9239587,9239646,HepG2|chr19:4634986-4635081,chr19,4634986,4635081,0,4604601
HepG2|chr19:9346833-9346956,chr19,9346833,9346956,HepG2|chr19:10361611-10361720,chr19,10361611,10361720,0,1014778
HepG2|chr19:9357820-9357934,chr19,9357820,9357934,HepG2|chr19:53899391-53899504,chr19,53899391,53899504,0,44541571
HepG2|chr19:9364289-9364330,chr19,9364289,9364330,HepG2|chr19:53971136-53971192,chr19,53971136,53971192,0,44606847
HepG2|chr19:9447007-9447098,chr19,9447007,9447098,HepG2|chr19:3573798-3573857,chr19,3573798,3573857,0,5873209
HepG2|chr19:9477761-9477907,chr19,9477761,9477907,HepG2|chr19:53899408-53899504,chr19,53899408,53899504,0,44421647
HepG2|chr19:9532769-9532872,chr19,9532769,9532872,HepG2|chr19:48393725-48393746,chr19,48393725,48393746,0,38860956
HepG2|chr19:9724202-9724229,chr19,9724202,9724229,HepG2|chr19:4634986-4635111,chr19,4634986,4635111,0,5089216
HepG2|chr19:9726763-9726869,chr19,9726763,9726869,HepG2|chr19:4634985-4635124,chr19,4634985,4635124,0,5091778
HepG2|chr19:9840352-9840370,chr19,9840352,9840370,HepG2|chr19:4634986-4635118,chr19,4634986,4635118,0,5205366
HepG2|chr19:9911242-9911364,chr19,9911242,9911364,HepG2|chr19:3553378-3553484,chr19,3553378,3553484,0,6357864
HepG2|chr19:10015142-10015198,chr19,10015142,10015198,HepG2|chr19:45248301-45248395,chr19,45248301,45248395,0,35233159
HepG2|chr19:10019800-10019829,chr19,10019800,10019829,HepG2|chr19:4634657-4634802,chr19,4634657,4634802,0,5385143
HepG2|chr19:10100472-10100521,chr19,10100472,10100521,HepG2|chr19:4634986-4635107,chr19,4634986,4635107,0,5465486
HepG2|chr19:10207995-10208145,chr19,10207995,10208145,HepG2|chr19:53192879-53192964,chr19,53192879,53192964,0,42984884
HepG2|chr19:10290242-10290265,chr19,10290242,10290265,HepG2|chr19:56058862-56058959,chr19,56058862,56058959,0,45768620
HepG2|chr19:10295125-10295144,chr19,10295125,10295144,HepG2|chr19:42757339-42757447,chr19,42757339,42757447,0,32462214
HepG2|chr19:10424833-10424870,chr19,10424833,10424870,HepG2|chr19:4634990-4635111,chr19,4634990,4635111,0,5789843
HepG2|chr19:10500156-10500173,chr19,10500156,10500173,HepG2|chr19:4634986-4635116,chr19,4634986,4635116,0,5865170
HepG2|chr19:10502859-10502891,chr19,10502859,10502891,HepG2|chr19:45251094-45251215,chr19,45251094,45251215,0,34748235
HepG2|chr19:10508214-10508304,chr19,10508214,10508304,HepG2|chr19:4635502-4635523,chr19,4635502,4635523,0,5872712
HepG2|chr19:10580854-10580909,chr19,10580854,10580909,HepG2|chr19:4634983-4635130,chr19,4634983,4635130,0,5945871
HepG2|chr19:10646978-10647023,chr19,10646978,10647023,HepG2|chr19:4635750-4635843,chr19,4635750,4635843,0,6011228
HepG2|chr19:10649070-10649102,chr19,10649070,10649102,HepG2|chr19:4634985-4635130,chr19,4634985,4635130,0,6014085
HepG2|chr19:10662619-10662739,chr19,10662619,10662739,HepG2|chr19:45248301-45248395,chr19,45248301,45248395,0,34585682
HepG2|chr19:10869413-10869493,chr19,10869413,10869493,HepG2|chr19:45248301-45248322,chr19,45248301,45248322,0,34378888
HepG2|chr19:11011843-11011949,chr19,11011843,11011949,HepG2|chr19:795103-795135,chr19,795103,795135,0,10216740
HepG2|chr19:11296241-11296360,chr19,11296241,11296360,HepG2|chr19:4634986-4635066,chr19,4634986,4635066,0,6661255
HepG2|chr19:11349888-11349934,chr19,11349888,11349934,HepG2|chr19:49864556-49864706,chr19,49864556,49864706,0,38514668
HepG2|chr19:11438307-11438364,chr19,11438307,11438364,HepG2|chr19:45248301-45248404,chr19,45248301,45248404,0,33809994
HepG2|chr19:11513439-11513512,chr19,11513439,11513512,HepG2|chr19:8583568-8583597,chr19,8583568,8583597,0,2929871
HepG2|chr19:11629177-11629232,chr19,11629177,11629232,HepG2|chr19:3569261-3569331,chr19,3569261,3569331,0,8059916
HepG2|chr19:11637608-11637712,chr19,11637608,11637712,HepG2|chr19:35604250-35604269,chr19,35604250,35604269,0,23966642
HepG2|chr19:11657718-11657806,chr19,11657718,11657806,HepG2|chr19:58893949-58893994,chr19,58893949,58893994,0,47236231
HepG2|chr19:11687792-11687845,chr19,11687792,11687845,HepG2|chr19:45248303-45248450,chr19,45248303,45248450,0,33560511
HepG2|chr19:11724625-11724690,chr19,11724625,11724690,HepG2|chr19:4634988-4635124,chr19,4634988,4635124,0,7089637
HepG2|chr19:11791193-11791294,chr19,11791193,11791294,HepG2|chr19:4639119-4639164,chr19,4639119,4639164,0,7152074
HepG2|chr19:11808002-11808042,chr19,11808002,11808042,HepG2|chr19:45202176-45202325,chr19,45202176,45202325,0,33394174
HepG2|chr19:11865180-11865330,chr19,11865180,11865330,HepG2|chr19:53899373-53899520,chr19,53899373,53899520,0,42034193
HepG2|chr19:11888883-11888993,chr19,11888883,11888993,HepG2|chr19:45248328-45248478,chr19,45248328,45248478,0,33359445
HepG2|chr19:11942669-11942731,chr19,11942669,11942731,HepG2|chr19:4635764-4635852,chr19,4635764,4635852,0,7306905
HepG2|chr19:12262481-12262541,chr19,12262481,12262541,HepG2|chr19:4634986-4635076,chr19,4634986,4635076,0,7627495
HepG2|chr19:12283865-12283892,chr19,12283865,12283892,HepG2|chr19:49863920-49863986,chr19,49863920,49863986,0,37580055
HepG2|chr19:12293948-12294037,chr19,12293948,12294037,HepG2|chr19:4634990-4635090,chr19,4634990,4635090,0,7658958
HepG2|chr19:12333572-12333633,chr19,12333572,12333633,HepG2|chr19:56058870-56058959,chr19,56058870,56058959,0,43725298
HepG2|chr19:12377229-12377263,chr19,12377229,12377263,HepG2|chr19:4831150-4831261,chr19,4831150,4831261,0,7546079
HepG2|chr19:12585045-12585080,chr19,12585045,12585080,HepG2|chr19:45248301-45248394,chr19,45248301,45248394,0,32663256
HepG2|chr19:12633253-12633269,chr19,12633253,12633269,HepG2|chr19:4634986-4635117,chr19,4634986,4635117,0,7998267
HepG2|chr19:12658289-12658428,chr19,12658289,12658428,HepG2|chr19:45248924-45248966,chr19,45248924,45248966,0,32590635
HepG2|chr19:12771279-12771319,chr19,12771279,12771319,HepG2|chr19:45251094-45251164,chr19,45251094,45251164,0,32479815
HepG2|chr19:12778392-12778448,chr19,12778392,12778448,HepG2|chr19:4634990-4635084,chr19,4634990,4635084,0,8143402
HepG2|chr19:12826110-12826144,chr19,12826110,12826144,HepG2|chr19:4634986-4635111,chr19,4634986,4635111,0,8191124
HepG2|chr19:12879815-12879892,chr19,12879815,12879892,HepG2|chr19:4634986-4635059,chr19,4634986,4635059,0,8244829
HepG2|chr19:13028751-13028825,chr19,13028751,13028825,HepG2|chr19:9549047-9549106,chr19,9549047,9549106,0,3479704
HepG2|chr19:13067432-13067458,chr19,13067432,13067458,HepG2|chr19:45251094-45251195,chr19,45251094,45251195,0,32183662
HepG2|chr19:13072134-13072209,chr19,13072134,13072209,HepG2|chr19:4634986-4635035,chr19,4634986,4635035,0,8437148
HepG2|chr19:13132936-13132992,chr19,13132936,13132992,HepG2|chr19:45248299-45248447,chr19,45248299,45248447,0,32115363
HepG2|chr19:13199742-13199818,chr19,13199742,13199818,HepG2|chr19:4634985-4635118,chr19,4634985,4635118,0,8564757
HepG2|chr19:13209640-13209689,chr19,13209640,13209689,HepG2|chr19:45202246-45202396,chr19,45202246,45202396,0,31992606
HepG2|chr19:13268238-13268384,chr19,13268238,13268384,HepG2|chr19:53971127-53971178,chr19,53971127,53971178,0,40702889
HepG2|chr19:13312660-13312756,chr19,13312660,13312756,HepG2|chr19:53971127-53971181,chr19,53971127,53971181,0,40658467
HepG2|chr19:13460864-13460892,chr19,13460864,13460892,HepG2|chr19:45248301-45248395,chr19,45248301,45248395,0,31787437
HepG2|chr19:13519473-13519536,chr19,13519473,13519536,HepG2|chr19:39615716-39615782,chr19,39615716,39615782,0,26096243
HepG2|chr19:13525379-13525529,chr19,13525379,13525529,HepG2|chr19:9251948-9252026,chr19,9251948,9252026,0,4273431
HepG2|chr19:13556008-13556078,chr19,13556008,13556078,HepG2|chr19:4634985-4635124,chr19,4634985,4635124,0,8921023
HepG2|chr19:13571622-13571734,chr19,13571622,13571734,HepG2|chr19:10361611-10361735,chr19,10361611,10361735,0,3210011
HepG2|chr19:13613703-13613746,chr19,13613703,13613746,HepG2|chr19:4634985-4635125,chr19,4634985,4635125,0,8978718
HepG2|chr19:13691076-13691175,chr19,13691076,13691175,HepG2|chr19:4634986-4635066,chr19,4634986,4635066,0,9056090
HepG2|chr19:13695238-13695348,chr19,13695238,13695348,HepG2|chr19:10361611-10361694,chr19,10361611,10361694,0,3333627
HepG2|chr19:13731533-13731563,chr19,13731533,13731563,HepG2|chr19:53192905-53193055,chr19,53192905,53193055,0,39461372
HepG2|chr19:13757745-13757891,chr19,13757745,13757891,HepG2|chr19:53899393-53899504,chr19,53899393,53899504,0,40141648
HepG2|chr19:13859509-13859536,chr19,13859509,13859536,HepG2|chr19:4634985-4635127,chr19,4634985,4635127,0,9224524
HepG2|chr19:13895378-13895401,chr19,13895378,13895401,HepG2|chr19:4635121-4635271,chr19,4635121,4635271,0,9260257
HepG2|chr19:13940490-13940522,chr19,13940490,13940522,HepG2|chr19:45251094-45251215,chr19,45251094,45251215,0,31310604
HepG2|chr19:14001755-14001817,chr19,14001755,14001817,HepG2|chr19:45248301-45248394,chr19,45248301,45248394,0,31246546
HepG2|chr19:14024326-14024450,chr19,14024326,14024450,HepG2|chr19:3553382-3553484,chr19,3553382,3553484,0,10470944
HepG2|chr19:14110780-14110809,chr19,14110780,14110809,HepG2|chr19:4635039-4635189,chr19,4635039,4635189,0,9475741
HepG2|chr19:14210064-14210192,chr19,14210064,14210192,HepG2|chr19:56058665-56058687,chr19,56058665,56058687,0,41848601
HepG2|chr19:14250841-14250964,chr19,14250841,14250964,HepG2|chr19:10361611-10361720,chr19,10361611,10361720,0,3889230
HepG2|chr19:14330797-14330853,chr19,14330797,14330853,HepG2|chr19:45248301-45248395,chr19,45248301,45248395,0,30917504
HepG2|chr19:14338769-14338840,chr19,14338769,14338840,HepG2|chr19:4634986-4635063,chr19,4634986,4635063,0,9703783
HepG2|chr19:14543039-14543082,chr19,14543039,14543082,HepG2|chr19:45249493-45249643,chr19,45249493,45249643,0,30706454
HepG2|chr19:14690212-14690247,chr19,14690212,14690247,HepG2|chr19:45249883-45250033,chr19,45249883,45250033,0,30559671
HepG2|chr19:14738754-14738895,chr19,14738754,14738895,HepG2|chr19:4634986-4635114,chr19,4634986,4635114,0,10103768
HepG2|chr19:14766288-14766350,chr19,14766288,14766350,HepG2|chr19:4634986-4635074,chr19,4634986,4635074,0,10131302
HepG2|chr19:14779502-14779613,chr19,14779502,14779613,HepG2|chr19:53869718-53869792,chr19,53869718,53869792,0,39090216
HepG2|chr19:14830150-14830199,chr19,14830150,14830199,HepG2|chr19:4634985-4635086,chr19,4634985,4635086,0,10195165
HepG2|chr19:14903574-14903601,chr19,14903574,14903601,HepG2|chr19:49863920-49863986,chr19,49863920,49863986,0,34960346
HepG2|chr19:14955815-14955860,chr19,14955815,14955860,HepG2|chr19:4634487-4634590,chr19,4634487,4634590,0,10321328
HepG2|chr19:14974634-14974711,chr19,14974634,14974711,HepG2|chr19:47352234-47352267,chr19,47352234,47352267,0,32377600
HepG2|chr19:14992961-14993007,chr19,14992961,14993007,HepG2|chr19:4634986-4635117,chr19,4634986,4635117,0,10357975
HepG2|chr19:15002851-15002917,chr19,15002851,15002917,HepG2|chr19:45248300-45248446,chr19,45248300,45248446,0,30245449
HepG2|chr19:15076036-15076102,chr19,15076036,15076102,HepG2|chr19:45248300-45248446,chr19,45248300,45248446,0,30172264
HepG2|chr19:15100468-15100555,chr19,15100468,15100555,HepG2|chr19:4634986-4635114,chr19,4634986,4635114,0,10465482
HepG2|chr19:15130201-15130249,chr19,15130201,15130249,HepG2|chr19:9546478-9546558,chr19,9546478,9546558,0,5583723
HepG2|chr19:15152911-15152962,chr19,15152911,15152962,HepG2|chr19:4831150-4831261,chr19,4831150,4831261,0,10321761
HepG2|chr19:15332175-15332244,chr19,15332175,15332244,HepG2|chr19:4634985-4635127,chr19,4634985,4635127,0,10697190
HepG2|chr19:15412447-15412480,chr19,15412447,15412480,HepG2|chr19:4634986-4635099,chr19,4634986,4635099,0,10777461
HepG2|chr19:15450097-15450131,chr19,15450097,15450131,HepG2|chr19:35604250-35604298,chr19,35604250,35604298,0,20154153
HepG2|chr19:15463681-15463698,chr19,15463681,15463698,HepG2|chr19:4634986-4635116,chr19,4634986,4635116,0,10828695
HepG2|chr19:15469514-15469558,chr19,15469514,15469558,HepG2|chr19:3553380-3553484,chr19,3553380,3553484,0,11916134
HepG2|chr19:15593615-15593656,chr19,15593615,15593656,HepG2|chr19:3553369-3553468,chr19,3553369,3553468,0,12040246
HepG2|chr19:15723565-15723711,chr19,15723565,15723711,HepG2|chr19:53971127-53971178,chr19,53971127,53971178,0,38247562
HepG2|chr19:15867577-15867646,chr19,15867577,15867646,HepG2|chr19:10361611-10361684,chr19,10361611,10361684,0,5505966
HepG2|chr19:15973674-15973820,chr19,15973674,15973820,HepG2|chr19:53899403-53899504,chr19,53899403,53899504,0,37925729
HepG2|chr19:16064104-16064158,chr19,16064104,16064158,HepG2|chr19:3553336-3553468,chr19,3553336,3553468,0,12510768
HepG2|chr19:16146912-16147050,chr19,16146912,16147050,HepG2|chr19:4639119-4639164,chr19,4639119,4639164,0,11507793
HepG2|chr19:16197255-16197298,chr19,16197255,16197298,HepG2|chr19:45251094-45251170,chr19,45251094,45251170,0,29053839
HepG2|chr19:16237017-16237115,chr19,16237017,16237115,HepG2|chr19:45248301-45248446,chr19,45248301,45248446,0,29011284
HepG2|chr19:16313749-16313848,chr19,16313749,16313848,HepG2|chr19:4635764-4635852,chr19,4635764,4635852,0,11677985
HepG2|chr19:16481106-16481154,chr19,16481106,16481154,HepG2|chr19:4634487-4634590,chr19,4634487,4634590,0,11846619
HepG2|chr19:16601865-16601975,chr19,16601865,16601975,HepG2|chr19:10361611-10361694,chr19,10361611,10361694,0,6240254
HepG2|chr19:16712901-16712928,chr19,16712901,16712928,HepG2|chr19:4634986-4635111,chr19,4634986,4635111,0,12077915
HepG2|chr19:16737657-16737688,chr19,16737657,16737688,HepG2|chr19:45248301-45248326,chr19,45248301,45248326,0,28510644
HepG2|chr19:16776298-16776341,chr19,16776298,16776341,HepG2|chr19:3553377-3553484,chr19,3553377,3553484,0,13222921
HepG2|chr19:16819885-16819964,chr19,16819885,16819964,HepG2|chr19:4634986-4635022,chr19,4634986,4635022,0,12184899
HepG2|chr19:16858708-16858804,chr19,16858708,16858804,HepG2|chr19:11195735-11195760,chr19,11195735,11195760,0,5662973
HepG2|chr19:16900889-16900949,chr19,16900889,16900949,HepG2|chr19:45248328-45248478,chr19,45248328,45248478,0,28347439
HepG2|chr19:17060480-17060628,chr19,17060480,17060628,HepG2|chr19:45249840-45249859,chr19,45249840,45249859,0,28189360
HepG2|chr19:17109070-17109162,chr19,17109070,17109162,HepG2|chr19:45248301-45248395,chr19,45248301,45248395,0,28139231
HepG2|chr19:17274261-17274400,chr19,17274261,17274400,HepG2|chr19:53193113-53193165,chr19,53193113,53193165,0,35918852
HepG2|chr19:17319620-17319646,chr19,17319620,17319646,HepG2|chr19:45249866-45249896,chr19,45249866,45249896,0,27930246
HepG2|chr19:17375207-17375284,chr19,17375207,17375284,HepG2|chr19:793303-793453,chr19,793303,793453,0,16581904
HepG2|chr19:17384730-17384771,chr19,17384730,17384771,HepG2|chr19:4399463-4399578,chr19,4399463,4399578,0,12985267
HepG2|chr19:17422114-17422129,chr19,17422114,17422129,HepG2|chr19:1868479-1868606,chr19,1868479,1868606,0,15553635
HepG2|chr19:17593944-17594080,chr19,17593944,17594080,HepG2|chr19:792365-792391,chr19,792365,792391,0,16801579
HepG2|chr19:17719193-17719256,chr19,17719193,17719256,HepG2|chr19:4634986-4635073,chr19,4634986,4635073,0,13084207
HepG2|chr19:17733978-17734034,chr19,17733978,17734034,HepG2|chr19:4634990-4635084,chr19,4634990,4635084,0,13098988
HepG2|chr19:17788588-17788666,chr19,17788588,17788666,HepG2|chr19:45248301-45248349,chr19,45248301,45248349,0,27459713
HepG2|chr19:17788870-17788966,chr19,17788870,17788966,HepG2|chr19:11195735-11195760,chr19,11195735,11195760,0,6593135
HepG2|chr19:17802817-17802940,chr19,17802817,17802940,HepG2|chr19:3574259-3574317,chr19,3574259,3574317,0,14228558
HepG2|chr19:17813374-17813477,chr19,17813374,17813477,HepG2|chr19:11195735-11195760,chr19,11195735,11195760,0,6617639
HepG2|chr19:17838830-17838879,chr19,17838830,17838879,HepG2|chr19:4634984-4635117,chr19,4634984,4635117,0,13203846
HepG2|chr19:17940521-17940561,chr19,17940521,17940561,HepG2|chr19:45202176-45202325,chr19,45202176,45202325,0,27261655
HepG2|chr19:17971440-17971541,chr19,17971440,17971541,HepG2|chr19:35604250-35604299,chr19,35604250,35604299,0,17632810
HepG2|chr19:17983349-17983384,chr19,17983349,17983384,HepG2|chr19:4637318-4637433,chr19,4637318,4637433,0,13346031
HepG2|chr19:18097752-18097863,chr19,18097752,18097863,HepG2|chr19:56058930-56058959,chr19,56058930,56058959,0,37961178
HepG2|chr19:18100818-18100890,chr19,18100818,18100890,HepG2|chr19:4634987-4635137,chr19,4634987,4635137,0,13465831
HepG2|chr19:18102751-18102845,chr19,18102751,18102845,HepG2|chr19:4634986-4635037,chr19,4634986,4635037,0,13467765
HepG2|chr19:18166516-18166563,chr19,18166516,18166563,HepG2|chr19:45248301-45248404,chr19,45248301,45248404,0,27081785
HepG2|chr19:18169732-18169750,chr19,18169732,18169750,HepG2|chr19:4634986-4635118,chr19,4634986,4635118,0,13534746
HepG2|chr19:18174374-18174482,chr19,18174374,18174482,HepG2|chr19:45248924-45248966,chr19,45248924,45248966,0,27074550
HepG2|chr19:18220320-18220390,chr19,18220320,18220390,HepG2|chr19:4634986-4635063,chr19,4634986,4635063,0,13585334
HepG2|chr19:18254900-18254977,chr19,18254900,18254977,HepG2|chr19:47352234-47352267,chr19,47352234,47352267,0,29097334
HepG2|chr19:18492574-18492724,chr19,18492574,18492724,HepG2|chr19:53899398-53899504,chr19,53899398,53899504,0,35406824
HepG2|chr19:18508387-18508444,chr19,18508387,18508444,HepG2|chr19:45248294-45248443,chr19,45248294,45248443,0,26739907
HepG2|chr19:18514445-18514470,chr19,18514445,18514470,HepG2|chr19:45248331-45248481,chr19,45248331,45248481,0,26733886
HepG2|chr19:18663036-18663182,chr19,18663036,18663182,HepG2|chr19:53899145-53899277,chr19,53899145,53899277,0,35236109
HepG2|chr19:18727270-18727354,chr19,18727270,18727354,HepG2|chr19:45248172-45248238,chr19,45248172,45248238,0,26520902
HepG2|chr19:18785071-18785182,chr19,18785071,18785182,HepG2|chr19:53192673-53192821,chr19,53192673,53192821,0,34407602
HepG2|chr19:18866472-18866621,chr19,18866472,18866621,HepG2|chr19:53192674-53192820,chr19,53192674,53192820,0,34326202
HepG2|chr19:18920630-18920666,chr19,18920630,18920666,HepG2|chr19:4637318-4637416,chr19,4637318,4637416,0,14283312
HepG2|chr19:18967093-18967118,chr19,18967093,18967118,HepG2|chr19:49864169-49864265,chr19,49864169,49864265,0,30897076
HepG2|chr19:19023161-19023229,chr19,19023161,19023229,HepG2|chr19:33789414-33789533,chr19,33789414,33789533,0,14766253
HepG2|chr19:19287877-19287995,chr19,19287877,19287995,HepG2|chr19:53899412-53899504,chr19,53899412,53899504,0,34611535
HepG2|chr19:19309068-19309137,chr19,19309068,19309137,HepG2|chr19:4634986-4635066,chr19,4634986,4635066,0,14674082
HepG2|chr19:19376697-19376753,chr19,19376697,19376753,HepG2|chr19:4399455-4399549,chr19,4399455,4399549,0,14977242
HepG2|chr19:19494937-19495009,chr19,19494937,19495009,HepG2|chr19:4634986-4635064,chr19,4634986,4635064,0,14859951
HepG2|chr19:19599543-19599597,chr19,19599543,19599597,HepG2|chr19:53869851-53869947,chr19,53869851,53869947,0,34270308
HepG2|chr19:19605576-19605674,chr19,19605576,19605674,HepG2|chr19:53971127-53971179,chr19,53971127,53971179,0,34365551
HepG2|chr19:19703894-19703975,chr19,19703894,19703975,HepG2|chr19:6741298-6741355,chr19,6741298,6741355,0,12962596
HepG2|chr19:19956952-19957057,chr19,19956952,19957057,HepG2|chr19:795103-795135,chr19,795103,795135,0,19161849
HepG2|chr19:20078928-20079078,chr19,20078928,20079078,HepG2|chr19:53899391-53899504,chr19,53899391,53899504,0,33820463
HepG2|chr19:20100397-20100543,chr19,20100397,20100543,HepG2|chr19:53971113-53971158,chr19,53971113,53971158,0,33870716
HepG2|chr19:20193716-20193840,chr19,20193716,20193840,HepG2|chr19:4634985-4635122,chr19,4634985,4635122,0,15558731
HepG2|chr19:20295307-20295355,chr19,20295307,20295355,HepG2|chr19:3553396-3553484,chr19,3553396,3553484,0,16741911
HepG2|chr19:20299262-20299398,chr19,20299262,20299398,HepG2|chr19:792365-792391,chr19,792365,792391,0,19506897
HepG2|chr19:20341690-20341738,chr19,20341690,20341738,HepG2|chr19:9546478-9546558,chr19,9546478,9546558,0,10795212
HepG2|chr19:20361875-20361903,chr19,20361875,20361903,HepG2|chr19:4387711-4387858,chr19,4387711,4387858,0,15974164
HepG2|chr19:20395471-20395536,chr19,20395471,20395536,HepG2|chr19:4634986-4635066,chr19,4634986,4635066,0,15760485
HepG2|chr19:20405426-20405576,chr19,20405426,20405576,HepG2|chr19:56058870-56058959,chr19,56058870,56058959,0,35653444
HepG2|chr19:20456072-20456169,chr19,20456072,20456169,HepG2|chr19:4634990-4635063,chr19,4634990,4635063,0,15821082
HepG2|chr19:20477806-20477938,chr19,20477806,20477938,HepG2|chr19:45248327-45248477,chr19,45248327,45248477,0,24770521
HepG2|chr19:20486646-20486695,chr19,20486646,20486695,HepG2|chr19:45202246-45202396,chr19,45202246,45202396,0,24715600
HepG2|chr19:20519690-20519738,chr19,20519690,20519738,HepG2|chr19:4634986-4635103,chr19,4634986,4635103,0,15884704
HepG2|chr19:20568225-20568256,chr19,20568225,20568256,HepG2|chr19:4634986-4635112,chr19,4634986,4635112,0,15933239
HepG2|chr19:20595002-20595028,chr19,20595002,20595028,HepG2|chr19:56058862-56058959,chr19,56058862,56058959,0,35463860
HepG2|chr19:20664539-20664564,chr19,20664539,20664564,HepG2|chr19:49864169-49864265,chr19,49864169,49864265,0,29199630
HepG2|chr19:20701403-20701447,chr19,20701403,20701447,HepG2|chr19:15616763-15616786,chr19,15616763,15616786,0,5084640
HepG2|chr19:20808560-20808586,chr19,20808560,20808586,HepG2|chr19:45251094-45251195,chr19,45251094,45251195,0,24442534
HepG2|chr19:20858854-20858919,chr19,20858854,20858919,HepG2|chr19:4634988-4635124,chr19,4634988,4635124,0,16223866
HepG2|chr19:20938386-20938434,chr19,20938386,20938434,HepG2|chr19:45248301-45248395,chr19,45248301,45248395,0,24309915
HepG2|chr19:21016602-21016633,chr19,21016602,21016633,HepG2|chr19:4635037-4635082,chr19,4635037,4635082,0,16381565
HepG2|chr19:21056189-21056327,chr19,21056189,21056327,HepG2|chr19:53192878-53192972,chr19,53192878,53192972,0,32136689
HepG2|chr19:21188022-21188102,chr19,21188022,21188102,HepG2|chr19:45248301-45248322,chr19,45248301,45248322,0,24060279
HepG2|chr19:21232029-21232071,chr19,21232029,21232071,HepG2|chr19:4637955-4638105,chr19,4637955,4638105,0,16594074
HepG2|chr19:21234818-21234846,chr19,21234818,21234846,HepG2|chr19:4634986-4635065,chr19,4634986,4635065,0,16599832
HepG2|chr19:21237810-21237901,chr19,21237810,21237901,HepG2|chr19:4634985-4635135,chr19,4634985,4635135,0,16602825
HepG2|chr19:21282744-21282894,chr19,21282744,21282894,HepG2|chr19:35604250-35604299,chr19,35604250,35604299,0,14321506
HepG2|chr19:21359050-21359143,chr19,21359050,21359143,HepG2|chr19:4639317-4639374,chr19,4639317,4639374,0,16719733
HepG2|chr19:21450555-21450650,chr19,21450555,21450650,HepG2|chr19:4634986-4635035,chr19,4634986,4635035,0,16815569
HepG2|chr19:21552384-21552413,chr19,21552384,21552413,HepG2|chr19:4634657-4634802,chr19,4634657,4634802,0,16917727
HepG2|chr19:21568756-21568846,chr19,21568756,21568846,HepG2|chr19:4635502-4635523,chr19,4635502,4635523,0,16933254
HepG2|chr19:21618179-21618277,chr19,21618179,21618277,HepG2|chr19:4634986-4635050,chr19,4634986,4635050,0,16983193
HepG2|chr19:21687022-21687098,chr19,21687022,21687098,HepG2|chr19:4634980-4635126,chr19,4634980,4635126,0,17052042
HepG2|chr19:21754681-21754725,chr19,21754681,21754725,HepG2|chr19:49864508-49864572,chr19,49864508,49864572,0,28109827
HepG2|chr19:21855745-21855807,chr19,21855745,21855807,HepG2|chr19:4634986-4635074,chr19,4634986,4635074,0,17220759
HepG2|chr19:21902280-21902313,chr19,21902280,21902313,HepG2|chr19:45251094-45251217,chr19,45251094,45251217,0,23348814
HepG2|chr19:21992706-21992734,chr19,21992706,21992734,HepG2|chr19:45248301-45248395,chr19,45248301,45248395,0,23255595
HepG2|chr19:22049562-22049680,chr19,22049562,22049680,HepG2|chr19:10361611-10361668,chr19,10361611,10361668,0,11687951
HepG2|chr19:22235469-22235527,chr19,22235469,22235527,HepG2|chr19:4634986-4635075,chr19,4634986,4635075,0,17600483
HepG2|chr19:22281135-22281224,chr19,22281135,22281224,HepG2|chr19:4634990-4635090,chr19,4634990,4635090,0,17646145
HepG2|chr19:22424520-22424596,chr19,22424520,22424596,HepG2|chr19:53869718-53869792,chr19,53869718,53869792,0,31445198
HepG2|chr19:22442826-22442862,chr19,22442826,22442862,HepG2|chr19:4635381-4635495,chr19,4635381,4635495,0,17807445
HepG2|chr19:22467647-22467740,chr19,22467647,22467740,HepG2|chr19:4634986-4635115,chr19,4634986,4635115,0,17832661
HepG2|chr19:22480684-22480757,chr19,22480684,22480757,HepG2|chr19:6741295-6741369,chr19,6741295,6741369,0,15739389
HepG2|chr19:22688113-22688161,chr19,22688113,22688161,HepG2|chr19:4634985-4635122,chr19,4634985,4635122,0,18053128
HepG2|chr19:22722271-22722396,chr19,22722271,22722396,HepG2|chr19:3553381-3553484,chr19,3553381,3553484,0,19168890
HepG2|chr19:22856351-22856501,chr19,22856351,22856501,HepG2|chr19:53971127-53971179,chr19,53971127,53971179,0,31114776
HepG2|chr19:22898550-22898603,chr19,22898550,22898603,HepG2|chr19:3553380-3553484,chr19,3553380,3553484,0,19345170
HepG2|chr19:22939368-22939464,chr19,22939368,22939464,HepG2|chr19:53971127-53971181,chr19,53971127,53971181,0,31031759
HepG2|chr19:22944121-22944166,chr19,22944121,22944166,HepG2|chr19:53869854-53869959,chr19,53869854,53869959,0,30925733
HepG2|chr19:22946314-22946390,chr19,22946314,22946390,HepG2|chr19:53869718-53869792,chr19,53869718,53869792,0,30923404
HepG2|chr19:23103480-23103526,chr19,23103480,23103526,HepG2|chr19:45248301-45248405,chr19,45248301,45248405,0,22144821
HepG2|chr19:23153212-23153311,chr19,23153212,23153311,HepG2|chr19:4634986-4635088,chr19,4634986,4635088,0,18518226
HepG2|chr19:23271508-23271612,chr19,23271508,23271612,HepG2|chr19:15447129-15447174,chr19,15447129,15447174,0,7824379
HepG2|chr19:23553237-23553324,chr19,23553237,23553324,HepG2|chr19:4393520-4393562,chr19,4393520,4393562,0,19159717
HepG2|chr19:23596443-23596519,chr19,23596443,23596519,HepG2|chr19:4634985-4635118,chr19,4634985,4635118,0,18961458
HepG2|chr19:23679173-23679281,chr19,23679173,23679281,HepG2|chr19:53899417-53899504,chr19,53899417,53899504,0,30220244
HepG2|chr19:23970598-23970642,chr19,23970598,23970642,HepG2|chr19:4634986-4635092,chr19,4634986,4635092,0,19335612
HepG2|chr19:23974178-23974257,chr19,23974178,23974257,HepG2|chr19:4634986-4635119,chr19,4634986,4635119,0,19339192
HepG2|chr19:23997828-23997909,chr19,23997828,23997909,HepG2|chr19:35604250-35604268,chr19,35604250,35604268,0,11606422
HepG2|chr19:24208649-24208718,chr19,24208649,24208718,HepG2|chr19:9546834-9546897,chr19,9546834,9546897,0,14661815
HepG2|chr19:24232883-24232944,chr19,24232883,24232944,HepG2|chr19:53899140-53899229,chr19,53899140,53899229,0,29666257
HepG2|chr19:24239928-24239958,chr19,24239928,24239958,HepG2|chr19:33789414-33789533,chr19,33789414,33789533,0,9549486
HepG2|chr19:24256297-24256405,chr19,24256297,24256405,HepG2|chr19:45248924-45248966,chr19,45248924,45248966,0,20992627
HepG2|chr19:24306637-24306750,chr19,24306637,24306750,HepG2|chr19:47289822-47289859,chr19,47289822,47289859,0,22983185
HepG2|chr19:24355184-24355217,chr19,24355184,24355217,HepG2|chr19:49864295-49864336,chr19,49864295,49864336,0,25509111
HepG2|chr19:24374713-24374742,chr19,24374713,24374742,HepG2|chr19:4634986-4635116,chr19,4634986,4635116,0,19739727
HepG2|chr19:24396070-24396097,chr19,24396070,24396097,HepG2|chr19:49864286-49864397,chr19,49864286,49864397,0,25468216
HepG2|chr19:24552948-24553054,chr19,24552948,24553054,HepG2|chr19:53898527-53898595,chr19,53898527,53898595,0,29345579
HepG2|chr19:24584241-24584298,chr19,24584241,24584298,HepG2|chr19:4634986-4635072,chr19,4634986,4635072,0,19949255
HepG2|chr19:24635519-24635548,chr19,24635519,24635548,HepG2|chr19:4634990-4635111,chr19,4634990,4635111,0,20000529
HepG2|chr19:24695744-24695803,chr19,24695744,24695803,HepG2|chr19:45248301-45248337,chr19,45248301,45248337,0,20552557
HepG2|chr19:24708423-24708483,chr19,24708423,24708483,HepG2|chr19:4634986-4635076,chr19,4634986,4635076,0,20073437
HepG2|chr19:24739133-24739208,chr19,24739133,24739208,HepG2|chr19:4634986-4635035,chr19,4634986,4635035,0,20104147
HepG2|chr19:24834670-24834754,chr19,24834670,24834754,HepG2|chr19:16298211-16298270,chr19,16298211,16298270,0,8536459
HepG2|chr19:24860179-24860204,chr19,24860179,24860204,HepG2|chr19:4634986-4635111,chr19,4634986,4635111,0,20225193
HepG2|chr19:24867485-24867597,chr19,24867485,24867597,HepG2|chr19:10361611-10361735,chr19,10361611,10361735,0,14505874
HepG2|chr19:24965329-24965394,chr19,24965329,24965394,HepG2|chr19:4634986-4635066,chr19,4634986,4635066,0,20330343
HepG2|chr19:24978643-24978723,chr19,24978643,24978723,HepG2|chr19:53898527-53898595,chr19,53898527,53898595,0,28919884
HepG2|chr19:25136410-25136477,chr19,25136410,25136477,HepG2|chr19:14531426-14531509,chr19,14531426,14531509,0,10604984
HepG2|chr19:25274502-25274559,chr19,25274502,25274559,HepG2|chr19:4634986-4635072,chr19,4634986,4635072,0,20639516
HepG2|chr19:25418738-25418888,chr19,25418738,25418888,HepG2|chr19:4634986-4635038,chr19,4634986,4635038,0,20783752
HepG2|chr19:25453396-25453431,chr19,25453396,25453431,HepG2|chr19:4634986-4635119,chr19,4634986,4635119,0,20818410
HepG2|chr19:25677530-25677602,chr19,25677530,25677602,HepG2|chr19:53971127-53971179,chr19,53971127,53971179,0,28293597
HepG2|chr19:25715524-25715590,chr19,25715524,25715590,HepG2|chr19:53971127-53971179,chr19,53971127,53971179,0,28255603
HepG2|chr19:25895594-25895655,chr19,25895594,25895655,HepG2|chr19:45248294-45248443,chr19,45248294,45248443,0,19352700
HepG2|chr19:25901424-25901453,chr19,25901424,25901453,HepG2|chr19:4635039-4635189,chr19,4635039,4635189,0,21266385
HepG2|chr19:25981245-25981273,chr19,25981245,25981273,HepG2|chr19:4634987-4635137,chr19,4634987,4635137,0,21346258
HepG2|chr19:26039536-26039685,chr19,26039536,26039685,HepG2|chr19:4634990-4635022,chr19,4634990,4635022,0,21404546
HepG2|chr19:26051926-26051953,chr19,26051926,26051953,HepG2|chr19:49864286-49864397,chr19,49864286,49864397,0,23812360
HepG2|chr19:26164916-26164962,chr19,26164916,26164962,HepG2|chr19:49864556-49864706,chr19,49864556,49864706,0,23699640
HepG2|chr19:26275280-26275408,chr19,26275280,26275408,HepG2|chr19:56058665-56058687,chr19,56058665,56058687,0,29783385
HepG2|chr19:26280402-26280443,chr19,26280402,26280443,HepG2|chr19:13261789-13261864,chr19,13261789,13261864,0,13018613
HepG2|chr19:26308753-26308819,chr19,26308753,26308819,HepG2|chr19:45247435-45247529,chr19,45247435,45247529,0,18938682
HepG2|chr19:26437367-26437443,chr19,26437367,26437443,HepG2|chr19:49864204-49864354,chr19,49864204,49864354,0,23426837
HepG2|chr19:26481056-26481172,chr19,26481056,26481172,HepG2|chr19:45248301-45248405,chr19,45248301,45248405,0,18767245
HepG2|chr19:26483153-26483284,chr19,26483153,26483284,HepG2|chr19:4634986-4635035,chr19,4634986,4635035,0,21848167
HepG2|chr19:26639366-26639515,chr19,26639366,26639515,HepG2|chr19:1070525-1070591,chr19,1070525,1070591,0,25568841
HepG2|chr19:26836206-26836243,chr19,26836206,26836243,HepG2|chr19:3553376-3553484,chr19,3553376,3553484,0,23282830
HepG2|chr19:26850732-26850784,chr19,26850732,26850784,HepG2|chr19:795189-795287,chr19,795189,795287,0,26055543
HepG2|chr19:26912113-26912240,chr19,26912113,26912240,HepG2|chr19:53192675-53192825,chr19,53192675,53192825,0,26280562
HepG2|chr19:26958857-26958898,chr19,26958857,26958898,HepG2|chr19:4634986-4635074,chr19,4634986,4635074,0,22323871
HepG2|chr19:27132696-27132834,chr19,27132696,27132834,HepG2|chr19:45251094-45251164,chr19,45251094,45251164,0,18118398
HepG2|chr19:27161238-27161295,chr19,27161238,27161295,HepG2|chr19:4634986-4635075,chr19,4634986,4635075,0,22526252
HepG2|chr19:27222322-27222458,chr19,27222322,27222458,HepG2|chr19:4634611-4634633,chr19,4634611,4634633,0,22587711
HepG2|chr19:27276040-27276093,chr19,27276040,27276093,HepG2|chr19:45248303-45248450,chr19,45248303,45248450,0,17972263
HepG2|chr19:27340064-27340169,chr19,27340064,27340169,HepG2|chr19:795103-795135,chr19,795103,795135,0,26544961
HepG2|chr19:27485190-27485244,chr19,27485190,27485244,HepG2|chr19:3553336-3553468,chr19,3553336,3553468,0,23931854
HepG2|chr19:27528052-27528108,chr19,27528052,27528108,HepG2|chr19:45248301-45248395,chr19,45248301,45248395,0,17720249
HepG2|chr19:27569978-27570026,chr19,27569978,27570026,HepG2|chr19:4634487-4634590,chr19,4634487,4634590,0,22935491
HepG2|chr19:27575196-27575346,chr19,27575196,27575346,HepG2|chr19:4634986-4635118,chr19,4634986,4635118,0,22940210
HepG2|chr19:27754261-27754324,chr19,27754261,27754324,HepG2|chr19:4634986-4635073,chr19,4634986,4635073,0,23119275
HepG2|chr19:27812136-27812181,chr19,27812136,27812181,HepG2|chr19:45249869-45249898,chr19,45249869,45249898,0,17437733
HepG2|chr19:27900680-27900739,chr19,27900680,27900739,HepG2|chr19:4634986-4635081,chr19,4634986,4635081,0,23265694
HepG2|chr19:27961213-27961278,chr19,27961213,27961278,HepG2|chr19:14176357-14176421,chr19,14176357,14176421,0,13784856
HepG2|chr19:27965833-27965880,chr19,27965833,27965880,HepG2|chr19:4634986-4635116,chr19,4634986,4635116,0,23330847
HepG2|chr19:27969413-27969436,chr19,27969413,27969436,HepG2|chr19:4635121-4635271,chr19,4635121,4635271,0,23334292
HepG2|chr19:28026588-28026632,chr19,28026588,28026632,HepG2|chr19:3499593-3499674,chr19,3499593,3499674,0,24526995
HepG2|chr19:28119320-28119429,chr19,28119320,28119429,HepG2|chr19:15447129-15447174,chr19,15447129,15447174,0,12672191
HepG2|chr19:28168028-28168081,chr19,28168028,28168081,HepG2|chr19:3553380-3553484,chr19,3553380,3553484,0,24614648
HepG2|chr19:28267856-28267973,chr19,28267856,28267973,HepG2|chr19:53192814-53192930,chr19,53192814,53192930,0,24924958
HepG2|chr19:28460321-28460361,chr19,28460321,28460361,HepG2|chr19:4634986-4635037,chr19,4634986,4635037,0,23825335
HepG2|chr19:28464943-28464987,chr19,28464943,28464987,HepG2|chr19:45248300-45248446,chr19,45248300,45248446,0,16783357
HepG2|chr19:28514695-28514805,chr19,28514695,28514805,HepG2|chr19:4634986-4635026,chr19,4634986,4635026,0,23879709
HepG2|chr19:28710830-28710852,chr19,28710830,28710852,HepG2|chr19:4634986-4635114,chr19,4634986,4635114,0,24075844
HepG2|chr19:28944083-28944118,chr19,28944083,28944118,HepG2|chr19:45249883-45250033,chr19,45249883,45250033,0,16305800
HepG2|chr19:29072692-29072722,chr19,29072692,29072722,HepG2|chr19:42746196-42746325,chr19,42746196,42746325,0,13673504
HepG2|chr19:29104516-29104558,chr19,29104516,29104558,HepG2|chr19:4634986-4635114,chr19,4634986,4635114,0,24469530
HepG2|chr19:29190676-29190753,chr19,29190676,29190753,HepG2|chr19:4634986-4635059,chr19,4634986,4635059,0,24555690
HepG2|chr19:29206285-29206317,chr19,29206285,29206317,HepG2|chr19:4634985-4635130,chr19,4634985,4635130,0,24571300
HepG2|chr19:29322875-29322955,chr19,29322875,29322955,HepG2|chr19:53898527-53898595,chr19,53898527,53898595,0,24575652
HepG2|chr19:29429877-29429900,chr19,29429877,29429900,HepG2|chr19:10361611-10361735,chr19,10361611,10361735,0,19068266
HepG2|chr19:29553372-29553400,chr19,29553372,29553400,HepG2|chr19:4634987-4635137,chr19,4634987,4635137,0,24918385
HepG2|chr19:29562978-29563108,chr19,29562978,29563108,HepG2|chr19:56058898-56058959,chr19,56058898,56058959,0,26495920
HepG2|chr19:29618212-29618270,chr19,29618212,29618270,HepG2|chr19:4637060-4637175,chr19,4637060,4637175,0,24981152
HepG2|chr19:29670560-29670621,chr19,29670560,29670621,HepG2|chr19:53869861-53869947,chr19,53869861,53869947,0,24199301
HepG2|chr19:29693908-29694007,chr19,29693908,29694007,HepG2|chr19:35604250-35604298,chr19,35604250,35604298,0,5910342
HepG2|chr19:29728113-29728170,chr19,29728113,29728170,HepG2|chr19:45248294-45248443,chr19,45248294,45248443,0,15520181
HepG2|chr19:29819385-29819535,chr19,29819385,29819535,HepG2|chr19:53899382-53899532,chr19,53899382,53899532,0,24079997
HepG2|chr19:29854309-29854342,chr19,29854309,29854342,HepG2|chr19:45248301-45248439,chr19,45248301,45248439,0,15393992
HepG2|chr19:29881561-29881704,chr19,29881561,29881704,HepG2|chr19:45248172-45248238,chr19,45248172,45248238,0,15366611
HepG2|chr19:29912618-29912750,chr19,29912618,29912750,HepG2|chr19:45248327-45248477,chr19,45248327,45248477,0,15335709
HepG2|chr19:29915663-29915717,chr19,29915663,29915717,HepG2|chr19:4634986-4635082,chr19,4634986,4635082,0,25280677
HepG2|chr19:29918937-29919087,chr19,29918937,29919087,HepG2|chr19:45248294-45248443,chr19,45248294,45248443,0,15329357
HepG2|chr19:29919771-29919804,chr19,29919771,29919804,HepG2|chr19:4634986-4635099,chr19,4634986,4635099,0,25284785
HepG2|chr19:29932473-29932623,chr19,29932473,29932623,HepG2|chr19:4634986-4635038,chr19,4634986,4635038,0,25297487
HepG2|chr19:29959093-29959134,chr19,29959093,29959134,HepG2|chr19:4399463-4399578,chr19,4399463,4399578,0,25559630
HepG2|chr19:30208640-30208734,chr19,30208640,30208734,HepG2|chr19:53971136-53971192,chr19,53971136,53971192,0,23762496
HepG2|chr19:30268472-30268596,chr19,30268472,30268596,HepG2|chr19:4634985-4635122,chr19,4634985,4635122,0,25633487
HepG2|chr19:30445002-30445046,chr19,30445002,30445046,HepG2|chr19:1595765-1595884,chr19,1595765,1595884,0,28849237
HepG2|chr19:30470067-30470136,chr19,30470067,30470136,HepG2|chr19:45249869-45249906,chr19,45249869,45249906,0,14779802
HepG2|chr19:30505519-30505560,chr19,30505519,30505560,HepG2|chr19:53971136-53971192,chr19,53971136,53971192,0,23465617
HepG2|chr19:30635053-30635072,chr19,30635053,30635072,HepG2|chr19:4634986-4635114,chr19,4634986,4635114,0,26000067
HepG2|chr19:30651013-30651042,chr19,30651013,30651042,HepG2|chr19:4634990-4635111,chr19,4634990,4635111,0,26016023
HepG2|chr19:30796579-30796648,chr19,30796579,30796648,HepG2|chr19:53236735-53236816,chr19,53236735,53236816,0,22440156
HepG2|chr19:30820479-30820558,chr19,30820479,30820558,HepG2|chr19:53971127-53971183,chr19,53971127,53971183,0,23150648
HepG2|chr19:30919894-30919962,chr19,30919894,30919962,HepG2|chr19:4634944-4635094,chr19,4634944,4635094,0,26284950
HepG2|chr19:30967923-30967987,chr19,30967923,30967987,HepG2|chr19:53867806-53867859,chr19,53867806,53867859,0,22899883
HepG2|chr19:31154804-31154829,chr19,31154804,31154829,HepG2|chr19:45248331-45248481,chr19,45248331,45248481,0,14093527
HepG2|chr19:31188720-31188870,chr19,31188720,31188870,HepG2|chr19:4639317-4639374,chr19,4639317,4639374,0,26549403
HepG2|chr19:31249453-31249477,chr19,31249453,31249477,HepG2|chr19:45248301-45248394,chr19,45248301,45248394,0,13998848
HepG2|chr19:31450633-31450783,chr19,31450633,31450783,HepG2|chr19:53899391-53899504,chr19,53899391,53899504,0,22448758
HepG2|chr19:31471179-31471262,chr19,31471179,31471262,HepG2|chr19:45247433-45247529,chr19,45247433,45247529,0,13776254
HepG2|chr19:31479189-31479213,chr19,31479189,31479213,HepG2|chr19:4634986-4635112,chr19,4634986,4635112,0,26844203
HepG2|chr19:31530632-31530711,chr19,31530632,31530711,HepG2|chr19:4634986-4635022,chr19,4634986,4635022,0,26895646
HepG2|chr19:31565323-31565432,chr19,31565323,31565432,HepG2|chr19:45248301-45248415,chr19,45248301,45248415,0,13682978
HepG2|chr19:31579947-31579971,chr19,31579947,31579971,HepG2|chr19:4634986-4635112,chr19,4634986,4635112,0,26944961
HepG2|chr19:31641323-31641378,chr19,31641323,31641378,HepG2|chr19:45249840-45249901,chr19,45249840,45249901,0,13608517
HepG2|chr19:31644022-31644080,chr19,31644022,31644080,HepG2|chr19:4635782-4635925,chr19,4635782,4635925,0,27008240
HepG2|chr19:31644126-31644160,chr19,31644126,31644160,HepG2|chr19:49864203-49864265,chr19,49864203,49864265,0,18220077
HepG2|chr19:31645406-31645459,chr19,31645406,31645459,HepG2|chr19:4634986-4635080,chr19,4634986,4635080,0,27010420
HepG2|chr19:31741354-31741423,chr19,31741354,31741423,HepG2|chr19:10361611-10361684,chr19,10361611,10361684,0,21379743
HepG2|chr19:31846240-31846300,chr19,31846240,31846300,HepG2|chr19:45248328-45248478,chr19,45248328,45248478,0,13402088
HepG2|chr19:31886442-31886526,chr19,31886442,31886526,HepG2|chr19:45248172-45248238,chr19,45248172,45248238,0,13361730
HepG2|chr19:31975943-31976034,chr19,31975943,31976034,HepG2|chr19:4634985-4635135,chr19,4634985,4635135,0,27340958
HepG2|chr19:31999440-31999488,chr19,31999440,31999488,HepG2|chr19:4634986-4635103,chr19,4634986,4635103,0,27364454
HepG2|chr19:32011619-32011670,chr19,32011619,32011670,HepG2|chr19:52488987-52489090,chr19,52488987,52489090,0,20477368
HepG2|chr19:32015763-32015848,chr19,32015763,32015848,HepG2|chr19:4634986-4635051,chr19,4634986,4635051,0,27380777
HepG2|chr19:32023468-32023484,chr19,32023468,32023484,HepG2|chr19:4634986-4635117,chr19,4634986,4635117,0,27388482
HepG2|chr19:32047830-32047877,chr19,32047830,32047877,HepG2|chr19:48388066-48388161,chr19,48388066,48388161,0,16340236
HepG2|chr19:32238337-32238415,chr19,32238337,32238415,HepG2|chr19:6741295-6741369,chr19,6741295,6741369,0,25497042
HepG2|chr19:32317160-32317191,chr19,32317160,32317191,HepG2|chr19:45251062-45251212,chr19,45251062,45251212,0,12933902
HepG2|chr19:32363777-32363923,chr19,32363777,32363923,HepG2|chr19:53899403-53899504,chr19,53899403,53899504,0,21535626
HepG2|chr19:32378896-32378931,chr19,32378896,32378931,HepG2|chr19:4637318-4637433,chr19,4637318,4637433,0,27741578
HepG2|chr19:32455389-32455426,chr19,32455389,32455426,HepG2|chr19:4634990-4635111,chr19,4634990,4635111,0,27820399
HepG2|chr19:32483560-32483652,chr19,32483560,32483652,HepG2|chr19:45248327-45248477,chr19,45248327,45248477,0,12764767
HepG2|chr19:32546741-32546759,chr19,32546741,32546759,HepG2|chr19:45251094-45251195,chr19,45251094,45251195,0,12704353
HepG2|chr19:32551467-32551497,chr19,32551467,32551497,HepG2|chr19:3574259-3574317,chr19,3574259,3574317,0,28977208
HepG2|chr19:32577775-32577913,chr19,32577775,32577913,HepG2|chr19:53192878-53192972,chr19,53192878,53192972,0,20615103
HepG2|chr19:32666591-32666741,chr19,32666591,32666741,HepG2|chr19:35604250-35604299,chr19,35604250,35604299,0,2937659
HepG2|chr19:32765089-32765187,chr19,32765089,32765187,HepG2|chr19:4634986-4635050,chr19,4634986,4635050,0,28130103
HepG2|chr19:32772364-32772408,chr19,32772364,32772408,HepG2|chr19:4634986-4635092,chr19,4634986,4635092,0,28137378
HepG2|chr19:33049609-33049665,chr19,33049609,33049665,HepG2|chr19:45248299-45248447,chr19,45248299,45248447,0,12198690
HepG2|chr19:33185213-33185355,chr19,33185213,33185355,HepG2|chr19:53899405-53899504,chr19,53899405,53899504,0,20714192
HepG2|chr19:33250359-33250423,chr19,33250359,33250423,HepG2|chr19:53867806-53867859,chr19,53867806,53867859,0,20617447
HepG2|chr19:33279083-33279138,chr19,33279083,33279138,HepG2|chr19:4634983-4635130,chr19,4634983,4635130,0,28644100
HepG2|chr19:33456076-33456147,chr19,33456076,33456147,HepG2|chr19:4634986-4635063,chr19,4634986,4635063,0,28821090
HepG2|chr19:33460146-33460239,chr19,33460146,33460239,HepG2|chr19:53971127-53971183,chr19,53971127,53971183,0,20510981
HepG2|chr19:33495589-33495720,chr19,33495589,33495720,HepG2|chr19:4634986-4635035,chr19,4634986,4635035,0,28860603
HepG2|chr19:33506186-33506332,chr19,33506186,33506332,HepG2|chr19:53971113-53971158,chr19,53971113,53971158,0,20464927
HepG2|chr19:33662675-33662722,chr19,33662675,33662722,HepG2|chr19:45248301-45248404,chr19,45248301,45248404,0,11585626
HepG2|chr19:33691399-33691431,chr19,33691399,33691431,HepG2|chr19:56058934-56058959,chr19,56058934,56058959,0,22367535
HepG2|chr19:33747844-33747896,chr19,33747844,33747896,HepG2|chr19:795189-795287,chr19,795189,795287,0,32952655
HepG2|chr19:33749383-33749498,chr19,33749383,33749498,HepG2|chr19:53899414-53899504,chr19,53899414,53899504,0,20150031
HepG2|chr19:33777998-33778017,chr19,33777998,33778017,HepG2|chr19:45248301-45248429,chr19,45248301,45248429,0,11470303
HepG2|chr19:33804602-33804640,chr19,33804602,33804640,HepG2|chr19:45248301-45248395,chr19,45248301,45248395,0,11443699
HepG2|chr19:33918493-33918614,chr19,33918493,33918614,HepG2|chr19:53899396-53899546,chr19,53899396,53899546,0,19980903
HepG2|chr19:33932851-33932924,chr19,33932851,33932924,HepG2|chr19:9549047-9549106,chr19,9549047,9549106,0,24383804
HepG2|chr19:34078826-34078896,chr19,34078826,34078896,HepG2|chr19:4634985-4635124,chr19,4634985,4635124,0,29443841
HepG2|chr19:34286176-34286271,chr19,34286176,34286271,HepG2|chr19:3500431-3500449,chr19,3500431,3500449,0,30785745
HepG2|chr19:34337957-34338014,chr19,34337957,34338014,HepG2|chr19:4634986-4635075,chr19,4634986,4635075,0,29702971
HepG2|chr19:34362589-34362676,chr19,34362589,34362676,HepG2|chr19:58893949-58893994,chr19,58893949,58893994,0,24531360
HepG2|chr19:34457362-34457462,chr19,34457362,34457462,HepG2|chr19:58893949-58893994,chr19,58893949,58893994,0,24436587
HepG2|chr19:34499728-34499797,chr19,34499728,34499797,HepG2|chr19:4635764-4635852,chr19,4635764,4635852,0,29863964
HepG2|chr19:34582273-34582288,chr19,34582273,34582288,HepG2|chr19:1868479-1868606,chr19,1868479,1868606,0,32713794
HepG2|chr19:34618480-34618517,chr19,34618480,34618517,HepG2|chr19:14534762-14534793,chr19,14534762,14534793,0,20083718
HepG2|chr19:34787173-34787314,chr19,34787173,34787314,HepG2|chr19:10361611-10361687,chr19,10361611,10361687,0,24425562
HepG2|chr19:34804456-34804498,chr19,34804456,34804498,HepG2|chr19:45248301-45248349,chr19,45248301,45248349,0,10443845
HepG2|chr19:35041003-35041069,chr19,35041003,35041069,HepG2|chr19:4634986-4635026,chr19,4634986,4635026,0,30406017
HepG2|chr19:35077764-35077837,chr19,35077764,35077837,HepG2|chr19:4634601-4634659,chr19,4634601,4634659,0,30443163
HepG2|chr19:35169559-35169596,chr19,35169559,35169596,HepG2|chr19:45248344-45248491,chr19,45248344,45248491,0,10078785
HepG2|chr19:35252562-35252584,chr19,35252562,35252584,HepG2|chr19:4634986-4635114,chr19,4634986,4635114,0,30617576
HepG2|chr19:35314549-35314575,chr19,35314549,35314575,HepG2|chr19:56058862-56058959,chr19,56058862,56058959,0,20744313
HepG2|chr19:35529826-35529864,chr19,35529826,35529864,HepG2|chr19:45248300-45248448,chr19,45248300,45248448,0,9718474
HepG2|chr19:35536195-35536239,chr19,35536195,35536239,HepG2|chr19:3553378-3553484,chr19,3553378,3553484,0,31982817
HepG2|chr19:35652407-35652454,chr19,35652407,35652454,HepG2|chr19:48388066-48388161,chr19,48388066,48388161,0,12735659
HepG2|chr19:35660905-35661034,chr19,35660905,35661034,HepG2|chr19:45248301-45248322,chr19,45248301,45248322,0,9587396
HepG2|chr19:35757797-35757844,chr19,35757797,35757844,HepG2|chr19:45248301-45248395,chr19,45248301,45248395,0,9490504
HepG2|chr19:35763256-35763300,chr19,35763256,35763300,HepG2|chr19:1595765-1595884,chr19,1595765,1595884,0,34167491
HepG2|chr19:35770465-35770539,chr19,35770465,35770539,HepG2|chr19:49864292-49864424,chr19,49864292,49864424,0,14093827
HepG2|chr19:36252374-36252478,chr19,36252374,36252478,HepG2|chr19:35604250-35604269,chr19,35604250,35604269,0,648124
HepG2|chr19:36276886-36276975,chr19,36276886,36276975,HepG2|chr19:4634985-4635124,chr19,4634985,4635124,0,31641901
HepG2|chr19:36365881-36365930,chr19,36365881,36365930,HepG2|chr19:45248301-45248391,chr19,45248301,45248391,0,8882420
HepG2|chr19:36442868-36442905,chr19,36442868,36442905,HepG2|chr19:14534762-14534793,chr19,14534762,14534793,0,21908106
HepG2|chr19:36535509-36535555,chr19,36535509,36535555,HepG2|chr19:45248301-45248395,chr19,45248301,45248395,0,8712792
HepG2|chr19:36599379-36599517,chr19,36599379,36599517,HepG2|chr19:4639119-4639164,chr19,4639119,4639164,0,31960260
HepG2|chr19:36693412-36693435,chr19,36693412,36693435,HepG2|chr19:56058862-56058959,chr19,56058862,56058959,0,19365450
HepG2|chr19:36776082-36776108,chr19,36776082,36776108,HepG2|chr19:4634990-4635117,chr19,4634990,4635117,0,32141092
HepG2|chr19:36986212-36986294,chr19,36986212,36986294,HepG2|chr19:58893949-58893994,chr19,58893949,58893994,0,21907737
HepG2|chr19:37323929-37323950,chr19,37323929,37323950,HepG2|chr19:4634986-4635115,chr19,4634986,4635115,0,32688943
HepG2|chr19:37400814-37400831,chr19,37400814,37400831,HepG2|chr19:4637026-4637140,chr19,4637026,4637140,0,32763788
HepG2|chr19:37494684-37494758,chr19,37494684,37494758,HepG2|chr19:9549047-9549106,chr19,9549047,9549106,0,27945637
HepG2|chr19:37533006-37533045,chr19,37533006,37533045,HepG2|chr19:45251094-45251195,chr19,45251094,45251195,0,7718088
HepG2|chr19:37687099-37687248,chr19,37687099,37687248,HepG2|chr19:53192674-53192820,chr19,53192674,53192820,0,15505575
HepG2|chr19:37845057-37845106,chr19,37845057,37845106,HepG2|chr19:4634986-4635107,chr19,4634986,4635107,0,33210071
HepG2|chr19:37858196-37858262,chr19,37858196,37858262,HepG2|chr19:45250180-45250246,chr19,45250180,45250246,0,7391984
HepG2|chr19:37899527-37899677,chr19,37899527,37899677,HepG2|chr19:52488992-52489030,chr19,52488992,52489030,0,14589465
HepG2|chr19:37956975-37957125,chr19,37956975,37957125,HepG2|chr19:4634986-4635051,chr19,4634986,4635051,0,33321989
HepG2|chr19:37968480-37968523,chr19,37968480,37968523,HepG2|chr19:45251094-45251170,chr19,45251094,45251170,0,7282614
HepG2|chr19:38054260-38054399,chr19,38054260,38054399,HepG2|chr19:45248320-45248470,chr19,45248320,45248470,0,7194060
HepG2|chr19:38095907-38095950,chr19,38095907,38095950,HepG2|chr19:4634985-4635135,chr19,4634985,4635135,0,33460922
HepG2|chr19:38234437-38234486,chr19,38234437,38234486,HepG2|chr19:53869726-53869780,chr19,53869726,53869780,0,15635289
HepG2|chr19:38237786-38237908,chr19,38237786,38237908,HepG2|chr19:4634980-4635114,chr19,4634980,4635114,0,33602806
HepG2|chr19:38256338-38256425,chr19,38256338,38256425,HepG2|chr19:58893949-58893994,chr19,58893949,58893994,0,20637611
HepG2|chr19:38277512-38277632,chr19,38277512,38277632,HepG2|chr19:9546418-9546448,chr19,9546418,9546448,0,28731094
HepG2|chr19:38375209-38375355,chr19,38375209,38375355,HepG2|chr19:53899145-53899277,chr19,53899145,53899277,0,15523936
HepG2|chr19:38435860-38435968,chr19,38435860,38435968,HepG2|chr19:53898568-53898595,chr19,53898568,53898595,0,15462708
HepG2|chr19:38467373-38467398,chr19,38467373,38467398,HepG2|chr19:4634986-4635111,chr19,4634986,4635111,0,33832387
HepG2|chr19:38490769-38490907,chr19,38490769,38490907,HepG2|chr19:1070469-1070589,chr19,1070469,1070589,0,37420300
HepG2|chr19:38549376-38549495,chr19,38549376,38549495,HepG2|chr19:53899391-53899504,chr19,53899391,53899504,0,15350015
HepG2|chr19:38614559-38614648,chr19,38614559,38614648,HepG2|chr19:4634985-4635124,chr19,4634985,4635124,0,33979574
HepG2|chr19:38632344-38632453,chr19,38632344,38632453,HepG2|chr19:15447129-15447174,chr19,15447129,15447174,0,23185215
HepG2|chr19:38647774-38647823,chr19,38647774,38647823,HepG2|chr19:4634985-4635086,chr19,4634985,4635086,0,34012789
HepG2|chr19:38697419-38697448,chr19,38697419,38697448,HepG2|chr19:16736048-16736198,chr19,16736048,16736198,0,21961371
HepG2|chr19:38710216-38710260,chr19,38710216,38710260,HepG2|chr19:49864508-49864572,chr19,49864508,49864572,0,11154292
HepG2|chr19:38733847-38733892,chr19,38733847,38733892,HepG2|chr19:4634487-4634590,chr19,4634487,4634590,0,34099360
HepG2|chr19:38926413-38926447,chr19,38926413,38926447,HepG2|chr19:4831150-4831261,chr19,4831150,4831261,0,34095263
HepG2|chr19:38972563-38972702,chr19,38972563,38972702,HepG2|chr19:53193113-53193165,chr19,53193113,53193165,0,14220550
HepG2|chr19:39095810-39095841,chr19,39095810,39095841,HepG2|chr19:33789414-33789533,chr19,33789414,33789533,0,5306396
HepG2|chr19:39097785-39097883,chr19,39097785,39097883,HepG2|chr19:4634986-4635038,chr19,4634986,4635038,0,34462799
HepG2|chr19:39136434-39136540,chr19,39136434,39136540,HepG2|chr19:795103-795135,chr19,795103,795135,0,38341331
HepG2|chr19:39260286-39260432,chr19,39260286,39260432,HepG2|chr19:53899408-53899504,chr19,53899408,53899504,0,14639122
HepG2|chr19:39385283-39385336,chr19,39385283,39385336,HepG2|chr19:4634986-4635080,chr19,4634986,4635080,0,34750297
HepG2|chr19:39410633-39410726,chr19,39410633,39410726,HepG2|chr19:56058898-56058959,chr19,56058898,56058959,0,16648265
HepG2|chr19:39428125-39428169,chr19,39428125,39428169,HepG2|chr19:3553380-3553484,chr19,3553380,3553484,0,35874745
HepG2|chr19:39615907-39615950,chr19,39615907,39615950,HepG2|chr19:4635750-4635856,chr19,4635750,4635856,0,34980157
HepG2|chr19:39786233-39786252,chr19,39786233,39786252,HepG2|chr19:4634986-4635114,chr19,4634986,4635114,0,35151247
HepG2|chr19:39802231-39802318,chr19,39802231,39802318,HepG2|chr19:4634986-4635114,chr19,4634986,4635114,0,35167245
HepG2|chr19:39817087-39817150,chr19,39817087,39817150,HepG2|chr19:45248332-45248480,chr19,45248332,45248480,0,5431245
HepG2|chr19:39869144-39869293,chr19,39869144,39869293,HepG2|chr19:4634986-4635073,chr19,4634986,4635073,0,35234158
HepG2|chr19:39894383-39894430,chr19,39894383,39894430,HepG2|chr19:3553375-3553484,chr19,3553375,3553484,0,36341008
HepG2|chr19:39983610-39983739,chr19,39983610,39983739,HepG2|chr19:45248301-45248322,chr19,45248301,45248322,0,5264691
HepG2|chr19:39987376-39987444,chr19,39987376,39987444,HepG2|chr19:45251094-45251164,chr19,45251094,45251164,0,5263718
HepG2|chr19:40068146-40068176,chr19,40068146,40068176,HepG2|chr19:53192905-53193055,chr19,53192905,53193055,0,13124759
HepG2|chr19:40129414-40129563,chr19,40129414,40129563,HepG2|chr19:4634990-4635022,chr19,4634990,4635022,0,35494424
HepG2|chr19:40474301-40474451,chr19,40474301,40474451,HepG2|chr19:4639317-4639374,chr19,4639317,4639374,0,35834984
HepG2|chr19:40492570-40492685,chr19,40492570,40492685,HepG2|chr19:53899414-53899504,chr19,53899414,53899504,0,13406844
HepG2|chr19:40531395-40531529,chr19,40531395,40531529,HepG2|chr19:45248343-45248493,chr19,45248343,45248493,0,4716948
HepG2|chr19:40552951-40552997,chr19,40552951,40552997,HepG2|chr19:45248301-45248405,chr19,45248301,45248405,0,4695350
HepG2|chr19:40688462-40688519,chr19,40688462,40688519,HepG2|chr19:4635205-4635298,chr19,4635205,4635298,0,36053257
HepG2|chr19:40689912-40690004,chr19,40689912,40690004,HepG2|chr19:4634986-4635059,chr19,4634986,4635059,0,36054926
HepG2|chr19:40817880-40817943,chr19,40817880,40817943,HepG2|chr19:53899403-53899490,chr19,53899403,53899490,0,13081523
HepG2|chr19:40833332-40833420,chr19,40833332,40833420,HepG2|chr19:45248301-45248394,chr19,45248301,45248394,0,4414969
HepG2|chr19:40839177-40839255,chr19,40839177,40839255,HepG2|chr19:45248301-45248337,chr19,45248301,45248337,0,4409124
HepG2|chr19:40850613-40850658,chr19,40850613,40850658,HepG2|chr19:45249869-45249898,chr19,45249869,45249898,0,4399256
HepG2|chr19:40853821-40853914,chr19,40853821,40853914,HepG2|chr19:53971127-53971183,chr19,53971127,53971183,0,13117306
HepG2|chr19:40907332-40907342,chr19,40907332,40907342,HepG2|chr19:4634986-4635114,chr19,4634986,4635114,0,36272346
HepG2|chr19:40971630-40971689,chr19,40971630,40971689,HepG2|chr19:45248301-45248392,chr19,45248301,45248392,0,4276671
HepG2|chr19:41066046-41066096,chr19,41066046,41066096,HepG2|chr19:3553386-3553484,chr19,3553386,3553484,0,37512660
HepG2|chr19:41127183-41127233,chr19,41127183,41127233,HepG2|chr19:4634985-4635117,chr19,4634985,4635117,0,36492198
HepG2|chr19:41216869-41216918,chr19,41216869,41216918,HepG2|chr19:53869726-53869780,chr19,53869726,53869780,0,12652857
HepG2|chr19:41298306-41298409,chr19,41298306,41298409,HepG2|chr19:48393725-48393746,chr19,48393725,48393746,0,7095419
HepG2|chr19:41320931-41321051,chr19,41320931,41321051,HepG2|chr19:9546418-9546448,chr19,9546418,9546448,0,31774513
HepG2|chr19:41338809-41338845,chr19,41338809,41338845,HepG2|chr19:45248301-45248395,chr19,45248301,45248395,0,3909492
HepG2|chr19:41359290-41359374,chr19,41359290,41359374,HepG2|chr19:15616687-15616728,chr19,15616687,15616728,0,25742603
HepG2|chr19:41364950-41365021,chr19,41364950,41365021,HepG2|chr19:45248301-45248326,chr19,45248301,45248326,0,3883351
HepG2|chr19:41409278-41409428,chr19,41409278,41409428,HepG2|chr19:45248301-45248370,chr19,45248301,45248370,0,3839023
HepG2|chr19:41818371-41818389,chr19,41818371,41818389,HepG2|chr19:45251094-45251195,chr19,45251094,45251195,0,3432723
HepG2|chr19:41891819-41891862,chr19,41891819,41891862,HepG2|chr19:4635750-4635856,chr19,4635750,4635856,0,37256069
HepG2|chr19:41998065-41998123,chr19,41998065,41998123,HepG2|chr19:4637060-4637175,chr19,4637060,4637175,0,37361005
HepG2|chr19:42023945-42024019,chr19,42023945,42024019,HepG2|chr19:10361611-10361687,chr19,10361611,10361687,0,31662334
HepG2|chr19:42086041-42086113,chr19,42086041,42086113,HepG2|chr19:4634986-4635064,chr19,4634986,4635064,0,37451055
HepG2|chr19:42142003-42142045,chr19,42142003,42142045,HepG2|chr19:45248294-45248443,chr19,45248294,45248443,0,3106291
HepG2|chr19:42176650-42176685,chr19,42176650,42176685,HepG2|chr19:4634986-4635119,chr19,4634986,4635119,0,37541664
HepG2|chr19:42313727-42313821,chr19,42313727,42313821,HepG2|chr19:4634986-4635037,chr19,4634986,4635037,0,37678741
HepG2|chr19:42440407-42440478,chr19,42440407,42440478,HepG2|chr19:53899387-53899512,chr19,53899387,53899512,0,11458980
HepG2|chr19:42470766-42470825,chr19,42470766,42470825,HepG2|chr19:45248301-45248337,chr19,45248301,45248337,0,2777535
HepG2|chr19:42515954-42515971,chr19,42515954,42515971,HepG2|chr19:4634986-4635119,chr19,4634986,4635119,0,37880968
HepG2|chr19:42521407-42521458,chr19,42521407,42521458,HepG2|chr19:52488987-52489090,chr19,52488987,52489090,0,9967580
HepG2|chr19:42568986-42569082,chr19,42568986,42569082,HepG2|chr19:4634986-4635080,chr19,4634986,4635080,0,37934000
HepG2|chr19:42571263-42571307,chr19,42571263,42571307,HepG2|chr19:3553378-3553484,chr19,3553378,3553484,0,39017885
HepG2|chr19:42672460-42672569,chr19,42672460,42672569,HepG2|chr19:45248301-45248415,chr19,45248301,45248415,0,2575841
HepG2|chr19:42867915-42867978,chr19,42867915,42867978,HepG2|chr19:4635750-4635856,chr19,4635750,4635856,0,38232165
HepG2|chr19:42901856-42901954,chr19,42901856,42901954,HepG2|chr19:4634986-4635038,chr19,4634986,4635038,0,38266870
HepG2|chr19:43041148-43041295,chr19,43041148,43041295,HepG2|chr19:53192674-53192821,chr19,53192674,53192821,0,10151526
HepG2|chr19:43273418-43273459,chr19,43273418,43273459,HepG2|chr19:3553369-3553468,chr19,3553369,3553468,0,39720049
HepG2|chr19:43307836-43307986,chr19,43307836,43307986,HepG2|chr19:4634990-4635111,chr19,4634990,4635111,0,38672846
HepG2|chr19:43406149-43406229,chr19,43406149,43406229,HepG2|chr19:4634985-4635127,chr19,4634985,4635127,0,38771164
HepG2|chr19:43441411-43441451,chr19,43441411,43441451,HepG2|chr19:45251094-45251164,chr19,45251094,45251164,0,1809683
HepG2|chr19:43514603-43514753,chr19,43514603,43514753,HepG2|chr19:9546418-9546448,chr19,9546418,9546448,0,33968185
HepG2|chr19:43572797-43572848,chr19,43572797,43572848,HepG2|chr19:4831150-4831261,chr19,4831150,4831261,0,38741647
HepG2|chr19:43650084-43650129,chr19,43650084,43650129,HepG2|chr19:4635750-4635843,chr19,4635750,4635843,0,39014334
HepG2|chr19:43717904-43718004,chr19,43717904,43718004,HepG2|chr19:53899403-53899490,chr19,53899403,53899490,0,10181499
HepG2|chr19:43727787-43727888,chr19,43727787,43727888,HepG2|chr19:4634986-4635035,chr19,4634986,4635035,0,39092801
HepG2|chr19:43937462-43937517,chr19,43937462,43937517,HepG2|chr19:45249840-45249901,chr19,45249840,45249901,0,1312378
HepG2|chr19:43938630-43938702,chr19,43938630,43938702,HepG2|chr19:4634987-4635137,chr19,4634987,4635137,0,39303643
HepG2|chr19:43952692-43952735,chr19,43952692,43952735,HepG2|chr19:3553377-3553484,chr19,3553377,3553484,0,40399315
HepG2|chr19:44118455-44118548,chr19,44118455,44118548,HepG2|chr19:10361611-10361668,chr19,10361611,10361668,0,33756844
HepG2|chr19:44241530-44241624,chr19,44241530,44241624,HepG2|chr19:53971136-53971192,chr19,53971136,53971192,0,9729606
HepG2|chr19:44355115-44355184,chr19,44355115,44355184,HepG2|chr19:45248407-45248557,chr19,45248407,45248557,0,893292
HepG2|chr19:44421614-44421682,chr19,44421614,44421682,HepG2|chr19:45251094-45251164,chr19,45251094,45251164,0,829480
HepG2|chr19:44532705-44532740,chr19,44532705,44532740,HepG2|chr19:830150-830196,chr19,830150,830196,0,43702555
HepG2|chr19:44616073-44616108,chr19,44616073,44616108,HepG2|chr19:830150-830196,chr19,830150,830196,0,43785923
HepG2|chr19:45030990-45031016,chr19,45030990,45031016,HepG2|chr19:4634990-4635117,chr19,4634990,4635117,0,40396000
HepG2|chr19:45036888-45036925,chr19,45036888,45036925,HepG2|chr19:45248344-45248491,chr19,45248344,45248491,0,211456
HepG2|chr19:45104095-45104117,chr19,45104095,45104117,HepG2|chr19:49864463-49864575,chr19,49864463,49864575,0,4760368
HepG2|chr19:45187275-45187418,chr19,45187275,45187418,HepG2|chr19:53192667-53192817,chr19,53192667,53192817,0,8005392
HepG2|chr19:45211906-45211979,chr19,45211906,45211979,HepG2|chr19:6741295-6741369,chr19,6741295,6741369,0,38470611
HepG2|chr19:45411286-45411322,chr19,45411286,45411322,HepG2|chr19:4637318-4637416,chr19,4637318,4637416,0,40773968
HepG2|chr19:45415675-45415748,chr19,45415675,45415748,HepG2|chr19:4634601-4634659,chr19,4634601,4634659,0,40781074
HepG2|chr19:45504217-45504252,chr19,45504217,45504252,HepG2|chr19:45248301-45248394,chr19,45248301,45248394,0,255916
HepG2|chr19:45650290-45650320,chr19,45650290,45650320,HepG2|chr19:42746196-42746325,chr19,42746196,42746325,0,2904094
HepG2|chr19:45656793-45656940,chr19,45656793,45656940,HepG2|chr19:53899391-53899504,chr19,53899391,53899504,0,8242598
HepG2|chr19:45667549-45667596,chr19,45667549,45667596,HepG2|chr19:44599830-44599900,chr19,44599830,44599900,0,1067719
HepG2|chr19:45724065-45724134,chr19,45724065,45724134,HepG2|chr19:9546834-9546897,chr19,9546834,9546897,0,36177231
HepG2|chr19:45758039-45758134,chr19,45758039,45758134,HepG2|chr19:16298211-16298266,chr19,16298211,16298266,0,29459828
HepG2|chr19:45766169-45766279,chr19,45766169,45766279,HepG2|chr19:4634986-4635026,chr19,4634986,4635026,0,41131183
HepG2|chr19:45819078-45819167,chr19,45819078,45819167,HepG2|chr19:56058898-56058959,chr19,56058898,56058959,0,10239820
HepG2|chr19:45832178-45832217,chr19,45832178,45832217,HepG2|chr19:45251094-45251195,chr19,45251094,45251195,0,581084
HepG2|chr19:45911141-45911220,chr19,45911141,45911220,HepG2|chr19:4634986-4635119,chr19,4634986,4635119,0,41276155
HepG2|chr19:45957373-45957416,chr19,45957373,45957416,HepG2|chr19:4634985-4635135,chr19,4634985,4635135,0,41322388
HepG2|chr19:45993129-45993186,chr19,45993129,45993186,HepG2|chr19:45248301-45248404,chr19,45248301,45248404,0,744828
HepG2|chr19:46230135-46230285,chr19,46230135,46230285,HepG2|chr19:53899391-53899504,chr19,53899391,53899504,0,7669256
HepG2|chr19:46242591-46242666,chr19,46242591,46242666,HepG2|chr19:45248301-45248370,chr19,45248301,45248370,0,994290
HepG2|chr19:46247434-46247537,chr19,46247434,46247537,HepG2|chr19:4634986-4635111,chr19,4634986,4635111,0,41612448
HepG2|chr19:46253532-46253601,chr19,46253532,46253601,HepG2|chr19:45249869-45249906,chr19,45249869,45249906,0,1003663
HepG2|chr19:46274303-46274442,chr19,46274303,46274442,HepG2|chr19:45248320-45248470,chr19,45248320,45248470,0,1025983
HepG2|chr19:46289188-46289272,chr19,46289188,46289272,HepG2|chr19:4634986-4635115,chr19,4634986,4635115,0,41654202
HepG2|chr19:46325002-46325080,chr19,46325002,46325080,HepG2|chr19:45248301-45248337,chr19,45248301,45248337,0,1076701
HepG2|chr19:46414094-46414220,chr19,46414094,46414220,HepG2|chr19:53898571-53898595,chr19,53898571,53898595,0,7484477
HepG2|chr19:46426135-46426234,chr19,46426135,46426234,HepG2|chr19:4634986-4635088,chr19,4634986,4635088,0,41791149
HepG2|chr19:46430156-46430306,chr19,46430156,46430306,HepG2|chr19:53899382-53899532,chr19,53899382,53899532,0,7469226
HepG2|chr19:46477608-46477649,chr19,46477608,46477649,HepG2|chr19:10361611-10361720,chr19,10361611,10361720,0,36115997
HepG2|chr19:46500968-46501028,chr19,46500968,46501028,HepG2|chr19:39612589-39612679,chr19,39612589,39612679,0,6888379
HepG2|chr19:46672539-46672680,chr19,46672539,46672680,HepG2|chr19:10361611-10361687,chr19,10361611,10361687,0,36310928
HepG2|chr19:46819966-46820116,chr19,46819966,46820116,HepG2|chr19:4635381-4635495,chr19,4635381,4635495,0,42184585
HepG2|chr19:46827277-46827302,chr19,46827277,46827302,HepG2|chr19:45248301-45248353,chr19,45248301,45248353,0,1578976
HepG2|chr19:46874437-46874504,chr19,46874437,46874504,HepG2|chr19:10361611-10361694,chr19,10361611,10361694,0,36512826
HepG2|chr19:46958759-46958782,chr19,46958759,46958782,HepG2|chr19:10358085-10358235,chr19,10358085,10358235,0,36600674
HepG2|chr19:46961917-46961957,chr19,46961917,46961957,HepG2|chr19:4634986-4635037,chr19,4634986,4635037,0,42326931
HepG2|chr19:47171625-47171731,chr19,47171625,47171731,HepG2|chr19:53898527-53898595,chr19,53898527,53898595,0,6726902
HepG2|chr19:47235427-47235552,chr19,47235427,47235552,HepG2|chr19:4634986-4635035,chr19,4634986,4635035,0,42600441
HepG2|chr19:47328399-47328505,chr19,47328399,47328505,HepG2|chr19:47293690-47293725,chr19,47293690,47293725,0,34709
HepG2|chr19:47452990-47453063,chr19,47452990,47453063,HepG2|chr19:45248301-45248322,chr19,45248301,45248322,0,2204689
HepG2|chr19:47585208-47585328,chr19,47585208,47585328,HepG2|chr19:3573798-3573857,chr19,3573798,3573857,0,44011410
HepG2|chr19:47596381-47596452,chr19,47596381,47596452,HepG2|chr19:53899387-53899512,chr19,53899387,53899512,0,6303006
HepG2|chr19:47724520-47724550,chr19,47724520,47724550,HepG2|chr19:33789414-33789533,chr19,33789414,33789533,0,13935106
HepG2|chr19:47726559-47726700,chr19,47726559,47726700,HepG2|chr19:4634986-4635114,chr19,4634986,4635114,0,43091573
HepG2|chr19:47773605-47773699,chr19,47773605,47773699,HepG2|chr19:53971127-53971183,chr19,53971127,53971183,0,6197522
HepG2|chr19:47820449-47820499,chr19,47820449,47820499,HepG2|chr19:3553386-3553484,chr19,3553386,3553484,0,44267063
HepG2|chr19:47922764-47922833,chr19,47922764,47922833,HepG2|chr19:53236735-53236816,chr19,53236735,53236816,0,5313971
HepG2|chr19:47960651-47960769,chr19,47960651,47960769,HepG2|chr19:53899412-53899504,chr19,53899412,53899504,0,5938761
HepG2|chr19:47981143-47981293,chr19,47981143,47981293,HepG2|chr19:4634986-4635118,chr19,4634986,4635118,0,43346157
HepG2|chr19:48020093-48020229,chr19,48020093,48020229,HepG2|chr19:4634611-4634633,chr19,4634611,4634633,0,43385482
HepG2|chr19:48137812-48137866,chr19,48137812,48137866,HepG2|chr19:53869851-53869947,chr19,53869851,53869947,0,5732039
HepG2|chr19:48146263-48146385,chr19,48146263,48146385,HepG2|chr19:3553378-3553484,chr19,3553378,3553484,0,44592885
HepG2|chr19:48226014-48226103,chr19,48226014,48226103,HepG2|chr19:56058898-56058959,chr19,56058898,56058959,0,7832884
HepG2|chr19:48303080-48303230,chr19,48303080,48303230,HepG2|chr19:45248294-45248443,chr19,45248294,45248443,0,3054786
HepG2|chr19:48330383-48330489,chr19,48330383,48330489,HepG2|chr19:53899391-53899504,chr19,53899391,53899504,0,5569008
HepG2|chr19:48482519-48482599,chr19,48482519,48482599,HepG2|chr19:3574259-3574317,chr19,3574259,3574317,0,44908260
HepG2|chr19:48505332-48505479,chr19,48505332,48505479,HepG2|chr19:53192876-53192963,chr19,53192876,53192963,0,4687544
HepG2|chr19:48648251-48648293,chr19,48648251,48648293,HepG2|chr19:45248301-45248349,chr19,45248301,45248349,0,3399950
HepG2|chr19:48700479-48700507,chr19,48700479,48700507,HepG2|chr19:4387711-4387858,chr19,4387711,4387858,0,44312768
HepG2|chr19:48715031-48715077,chr19,48715031,48715077,HepG2|chr19:4634986-4635117,chr19,4634986,4635117,0,44080045
HepG2|chr19:48793662-48793788,chr19,48793662,48793788,HepG2|chr19:53898571-53898595,chr19,53898571,53898595,0,5104909
HepG2|chr19:48819660-48819753,chr19,48819660,48819753,HepG2|chr19:8583568-8583597,chr19,8583568,8583597,0,40236092
HepG2|chr19:48955311-48955384,chr19,48955311,48955384,HepG2|chr19:45248301-45248322,chr19,45248301,45248322,0,3707010
HepG2|chr19:48975288-48975349,chr19,48975288,48975349,HepG2|chr19:56058870-56058959,chr19,56058870,56058959,0,7083582
HepG2|chr19:49008541-49008622,chr19,49008541,49008622,HepG2|chr19:35604250-35604268,chr19,35604250,35604268,0,13404291
HepG2|chr19:49030840-49030889,chr19,49030840,49030889,HepG2|chr19:44599830-44599900,chr19,44599830,44599900,0,4431010
HepG2|chr19:49038564-49038587,chr19,49038564,49038587,HepG2|chr19:4634999-4635122,chr19,4634999,4635122,0,44403565
HepG2|chr19:49112832-49112849,chr19,49112832,49112849,HepG2|chr19:4634986-4635119,chr19,4634986,4635119,0,44477846
HepG2|chr19:49154842-49154886,chr19,49154842,49154886,HepG2|chr19:45248300-45248446,chr19,45248300,45248446,0,3906542
HepG2|chr19:49183065-49183175,chr19,49183065,49183175,HepG2|chr19:45248301-45248443,chr19,45248301,45248443,0,3934764
HepG2|chr19:49190669-49190774,chr19,49190669,49190774,HepG2|chr19:15447129-15447174,chr19,15447129,15447174,0,33743540
HepG2|chr19:49218330-49218399,chr19,49218330,49218399,HepG2|chr19:4635764-4635852,chr19,4635764,4635852,0,44582566
HepG2|chr19:49294452-49294553,chr19,49294452,49294553,HepG2|chr19:35604250-35604299,chr19,35604250,35604299,0,13690202
HepG2|chr19:49372440-49372498,chr19,49372440,49372498,HepG2|chr19:4635782-4635925,chr19,4635782,4635925,0,44736658
HepG2|chr19:49392361-49392453,chr19,49392361,49392453,HepG2|chr19:45248301-45248395,chr19,45248301,45248395,0,4144060
HepG2|chr19:49457089-49457125,chr19,49457089,49457125,HepG2|chr19:45248301-45248395,chr19,45248301,45248395,0,4208788
HepG2|chr19:49473323-49473366,chr19,49473323,49473366,HepG2|chr19:45248301-45248419,chr19,45248301,45248419,0,4225022
HepG2|chr19:49489473-49489557,chr19,49489473,49489557,HepG2|chr19:16298211-16298270,chr19,16298211,16298270,0,33191262
HepG2|chr19:49623665-49623758,chr19,49623665,49623758,HepG2|chr19:8583568-8583597,chr19,8583568,8583597,0,41040097
HepG2|chr19:49772386-49772420,chr19,49772386,49772420,HepG2|chr19:49864203-49864265,chr19,49864203,49864265,0,91817
HepG2|chr19:50090812-50090882,chr19,50090812,50090882,HepG2|chr19:4634986-4635063,chr19,4634986,4635063,0,45455826
HepG2|chr19:50219561-50219635,chr19,50219561,50219635,HepG2|chr19:4634985-4635124,chr19,4634985,4635124,0,45584576
HepG2|chr19:50219760-50219824,chr19,50219760,50219824,HepG2|chr19:4638081-4638201,chr19,4638081,4638201,0,45581679
HepG2|chr19:50235582-50235664,chr19,50235582,50235664,HepG2|chr19:58893949-58893994,chr19,58893949,58893994,0,8658367
HepG2|chr19:50236444-50236516,chr19,50236444,50236516,HepG2|chr19:53971127-53971179,chr19,53971127,53971179,0,3734683
HepG2|chr19:50364841-50364904,chr19,50364841,50364904,HepG2|chr19:39615716-39615782,chr19,39615716,39615782,0,10749125
HepG2|chr19:50428977-50429038,chr19,50428977,50429038,HepG2|chr19:53869861-53869947,chr19,53869861,53869947,0,3440884
HepG2|chr19:50438272-50438301,chr19,50438272,50438301,HepG2|chr19:49863817-49863967,chr19,49863817,49863967,0,574455
HepG2|chr19:50540060-50540085,chr19,50540060,50540085,HepG2|chr19:45248301-45248353,chr19,45248301,45248353,0,5291759
HepG2|chr19:50852426-50852473,chr19,50852426,50852473,HepG2|chr19:45248301-45248359,chr19,45248301,45248359,0,5604125
HepG2|chr19:50893192-50893223,chr19,50893192,50893223,HepG2|chr19:33789414-33789533,chr19,33789414,33789533,0,17103778
HepG2|chr19:50899153-50899176,chr19,50899153,50899176,HepG2|chr19:4634999-4635122,chr19,4634999,4635122,0,46264154
HepG2|chr19:51064938-51064998,chr19,51064938,51064998,HepG2|chr19:39612589-39612679,chr19,39612589,39612679,0,11452349
HepG2|chr19:51121768-51121890,chr19,51121768,51121890,HepG2|chr19:4634986-4635026,chr19,4634986,4635026,0,46486782
HepG2|chr19:51226056-51226160,chr19,51226056,51226160,HepG2|chr19:15447129-15447174,chr19,15447129,15447174,0,35778927
HepG2|chr19:51328410-51328467,chr19,51328410,51328467,HepG2|chr19:45248301-45248394,chr19,45248301,45248394,0,6080109
HepG2|chr19:51366218-51366268,chr19,51366218,51366268,HepG2|chr19:4634985-4635117,chr19,4634985,4635117,0,46731233
HepG2|chr19:51422019-51422168,chr19,51422019,51422168,HepG2|chr19:4634986-4635073,chr19,4634986,4635073,0,46787033
HepG2|chr19:51496124-51496274,chr19,51496124,51496274,HepG2|chr19:9546418-9546448,chr19,9546418,9546448,0,41949706
HepG2|chr19:51523082-51523179,chr19,51523082,51523179,HepG2|chr19:53971127-53971179,chr19,53971127,53971179,0,2448045
HepG2|chr19:51568443-51568481,chr19,51568443,51568481,HepG2|chr19:45248301-45248395,chr19,45248301,45248395,0,6320142
HepG2|chr19:51625101-51625221,chr19,51625101,51625221,HepG2|chr19:45248301-45248395,chr19,45248301,45248395,0,6376800
HepG2|chr19:51662823-51662886,chr19,51662823,51662886,HepG2|chr19:4637525-4637672,chr19,4637525,4637672,0,47025298
HepG2|chr19:51679026-51679093,chr19,51679026,51679093,HepG2|chr19:33789414-33789533,chr19,33789414,33789533,0,17889612
HepG2|chr19:51688348-51688446,chr19,51688348,51688446,HepG2|chr19:45248301-45248446,chr19,45248301,45248446,0,6440047
HepG2|chr19:51770243-51770307,chr19,51770243,51770307,HepG2|chr19:4638081-4638201,chr19,4638081,4638201,0,47132162
HepG2|chr19:51802653-51802707,chr19,51802653,51802707,HepG2|chr19:45248301-45248395,chr19,45248301,45248395,0,6554352
HepG2|chr19:51926744-51926775,chr19,51926744,51926775,HepG2|chr19:4634986-4635114,chr19,4634986,4635114,0,47291758
HepG2|chr19:52100094-52100148,chr19,52100094,52100148,HepG2|chr19:4634986-4635082,chr19,4634986,4635082,0,47465108
HepG2|chr19:52116328-52116408,chr19,52116328,52116408,HepG2|chr19:3574259-3574317,chr19,3574259,3574317,0,48542069
HepG2|chr19:52162355-52162452,chr19,52162355,52162452,HepG2|chr19:53971127-53971179,chr19,53971127,53971179,0,1808772
HepG2|chr19:52247473-52247554,chr19,52247473,52247554,HepG2|chr19:6741298-6741355,chr19,6741298,6741355,0,45506175
HepG2|chr19:52518909-52519059,chr19,52518909,52519059,HepG2|chr19:53899398-53899504,chr19,53899398,53899504,0,1380489
HepG2|chr19:52529518-52529585,chr19,52529518,52529585,HepG2|chr19:33789414-33789533,chr19,33789414,33789533,0,18740104
HepG2|chr19:52559710-52559767,chr19,52559710,52559767,HepG2|chr19:4635205-4635298,chr19,4635205,4635298,0,47924505
HepG2|chr19:52578582-52578658,chr19,52578582,52578658,HepG2|chr19:4634980-4635126,chr19,4634980,4635126,0,47943602
HepG2|chr19:52684615-52684689,chr19,52684615,52684689,HepG2|chr19:10361611-10361687,chr19,10361611,10361687,0,42323004
HepG2|chr19:52923469-52923506,chr19,52923469,52923506,HepG2|chr19:3553376-3553484,chr19,3553376,3553484,0,49370093
HepG2|chr19:53024098-53024197,chr19,53024098,53024197,HepG2|chr19:35604250-35604298,chr19,35604250,35604298,0,17419848
HepG2|chr19:53190053-53190175,chr19,53190053,53190175,HepG2|chr19:4634986-4635026,chr19,4634986,4635026,0,48555067
HepG2|chr19:53200380-53200504,chr19,53200380,53200504,HepG2|chr19:3553382-3553484,chr19,3553382,3553484,0,49646998
HepG2|chr19:53207043-53207135,chr19,53207043,53207135,HepG2|chr19:53971127-53971185,chr19,53971127,53971185,0,764084
HepG2|chr19:53380215-53380320,chr19,53380215,53380320,HepG2|chr19:15447129-15447174,chr19,15447129,15447174,0,37933086
HepG2|chr19:53400516-53400666,chr19,53400516,53400666,HepG2|chr19:56058898-56058959,chr19,56058898,56058959,0,2658382
HepG2|chr19:53593327-53593450,chr19,53593327,53593450,HepG2|chr19:792365-792391,chr19,792365,792391,0,52800962
HepG2|chr19:53605483-53605626,chr19,53605483,53605626,HepG2|chr19:53192667-53192817,chr19,53192667,53192817,0,412816
HepG2|chr19:53606174-53606293,chr19,53606174,53606293,HepG2|chr19:4634986-4635066,chr19,4634986,4635066,0,48971188
HepG2|chr19:53623764-53623810,chr19,53623764,53623810,HepG2|chr19:1595795-1595945,chr19,1595795,1595945,0,52027969
HepG2|chr19:53679494-53679514,chr19,53679494,53679514,HepG2|chr19:45248344-45248491,chr19,45248344,45248491,0,8431150
HepG2|chr19:53692203-53692353,chr19,53692203,53692353,HepG2|chr19:56058898-56058959,chr19,56058898,56058959,0,2366695
HepG2|chr19:53820877-53820996,chr19,53820877,53820996,HepG2|chr19:53899391-53899504,chr19,53899391,53899504,0,78514
HepG2|chr19:53916738-53916772,chr19,53916738,53916772,HepG2|chr19:35604250-35604298,chr19,35604250,35604298,0,18312488
HepG2|chr19:54236135-54236285,chr19,54236135,54236285,HepG2|chr19:9251948-9252026,chr19,9251948,9252026,0,44984187
HepG2|chr19:54338334-54338457,chr19,54338334,54338457,HepG2|chr19:3574259-3574317,chr19,3574259,3574317,0,50764075
HepG2|chr19:54389652-54389701,chr19,54389652,54389701,HepG2|chr19:45248301-45248391,chr19,45248301,45248391,0,9141351
HepG2|chr19:54399723-54399790,chr19,54399723,54399790,HepG2|chr19:14531426-14531509,chr19,14531426,14531509,0,39868297
HepG2|chr19:54554510-54554658,chr19,54554510,54554658,HepG2|chr19:45249840-45249859,chr19,45249840,45249859,0,9304670
HepG2|chr19:54675493-54675541,chr19,54675493,54675541,HepG2|chr19:4634985-4635122,chr19,4634985,4635122,0,50040508
HepG2|chr19:54841850-54841913,chr19,54841850,54841913,HepG2|chr19:45248332-45248480,chr19,45248332,45248480,0,9593518
HepG2|chr19:54982725-54982875,chr19,54982725,54982875,HepG2|chr19:45248301-45248370,chr19,45248301,45248370,0,9734424
HepG2|chr19:55021214-55021310,chr19,55021214,55021310,HepG2|chr19:4634986-4635080,chr19,4634986,4635080,0,50386228
HepG2|chr19:55133748-55133833,chr19,55133748,55133833,HepG2|chr19:4634986-4635051,chr19,4634986,4635051,0,50498762
HepG2|chr19:55207154-55207195,chr19,55207154,55207195,HepG2|chr19:10361611-10361720,chr19,10361611,10361720,0,44845543
HepG2|chr19:55248007-55248070,chr19,55248007,55248070,HepG2|chr19:53899403-53899490,chr19,53899403,53899490,0,1348604
HepG2|chr19:55261226-55261246,chr19,55261226,55261246,HepG2|chr19:45248344-45248491,chr19,45248344,45248491,0,10012882
HepG2|chr19:55526069-55526100,chr19,55526069,55526100,HepG2|chr19:45248301-45248326,chr19,45248301,45248326,0,10277768
HepG2|chr19:55528145-55528213,chr19,55528145,55528213,HepG2|chr19:1864364-1864408,chr19,1864364,1864408,0,53663781
HepG2|chr19:55539631-55539730,chr19,55539631,55539730,HepG2|chr19:4635764-4635852,chr19,4635764,4635852,0,50903867
HepG2|chr19:55587040-55587111,chr19,55587040,55587111,HepG2|chr19:45248301-45248326,chr19,45248301,45248326,0,10338739
HepG2|chr19:55621343-55621411,chr19,55621343,55621411,HepG2|chr19:1864364-1864408,chr19,1864364,1864408,0,53756979
HepG2|chr19:55734546-55734696,chr19,55734546,55734696,HepG2|chr19:4635381-4635495,chr19,4635381,4635495,0,51099165
HepG2|chr19:55951925-55951990,chr19,55951925,55951990,HepG2|chr19:14176357-14176421,chr19,14176357,14176421,0,41775568
HepG2|chr19:55981289-55981382,chr19,55981289,55981382,HepG2|chr19:56058898-56058959,chr19,56058898,56058959,0,77609
HepG2|chr19:56074622-56074661,chr19,56074622,56074661,HepG2|chr19:3553370-3553481,chr19,3553370,3553481,0,52521252
HepG2|chr19:56149061-56149090,chr19,56149061,56149090,HepG2|chr19:4634986-4635116,chr19,4634986,4635116,0,51514075
HepG2|chr19:56207195-56207342,chr19,56207195,56207342,HepG2|chr19:53899391-53899504,chr19,53899391,53899504,0,2307804
HepG2|chr19:56211192-56211259,chr19,56211192,56211259,HepG2|chr19:10361611-10361694,chr19,10361611,10361694,0,45849581
HepG2|chr19:56302846-56302959,chr19,56302846,56302959,HepG2|chr19:47289822-47289859,chr19,47289822,47289859,0,9013024
HepG2|chr19:56379907-56379926,chr19,56379907,56379926,HepG2|chr19:42757339-42757447,chr19,42757339,42757447,0,13622568
HepG2|chr19:56432793-56432848,chr19,56432793,56432848,HepG2|chr19:3569261-3569331,chr19,3569261,3569331,0,52863532
HepG2|chr19:56468212-56468254,chr19,56468212,56468254,HepG2|chr19:45248294-45248443,chr19,45248294,45248443,0,11219918
HepG2|chr19:56487593-56487732,chr19,56487593,56487732,HepG2|chr19:45248924-45248966,chr19,45248924,45248966,0,11238669
HepG2|chr19:56504201-56504223,chr19,56504201,56504223,HepG2|chr19:4634986-4635114,chr19,4634986,4635114,0,51869215
HepG2|chr19:56522591-56522635,chr19,56522591,56522635,HepG2|chr19:3499593-3499674,chr19,3499593,3499674,0,53022998
HepG2|chr19:56541984-56542118,chr19,56541984,56542118,HepG2|chr19:45248343-45248493,chr19,45248343,45248493,0,11293641
HepG2|chr19:56645913-56645969,chr19,56645913,56645969,HepG2|chr19:4635066-4635216,chr19,4635066,4635216,0,52010847
HepG2|chr19:56730618-56730646,chr19,56730618,56730646,HepG2|chr19:4634986-4635065,chr19,4634986,4635065,0,52095632
HepG2|chr19:56753692-56753713,chr19,56753692,56753713,HepG2|chr19:4634986-4635115,chr19,4634986,4635115,0,52118706
HepG2|chr19:56816294-56816378,chr19,56816294,56816378,HepG2|chr19:15616687-15616728,chr19,15616687,15616728,0,41199607
HepG2|chr19:56817506-56817525,chr19,56817506,56817525,HepG2|chr19:4636046-4636183,chr19,4636046,4636183,0,52181460
HepG2|chr19:56897164-56897207,chr19,56897164,56897207,HepG2|chr19:4634985-4635125,chr19,4634985,4635125,0,52262179
HepG2|chr19:56973845-56973962,chr19,56973845,56973962,HepG2|chr19:53192814-53192930,chr19,53192814,53192930,0,3781031
HepG2|chr19:57007810-57007862,chr19,57007810,57007862,HepG2|chr19:4634986-4635084,chr19,4634986,4635084,0,52372824
HepG2|chr19:57071353-57071491,chr19,57071353,57071491,HepG2|chr19:1070469-1070589,chr19,1070469,1070589,0,56000884
HepG2|chr19:57083775-57083881,chr19,57083775,57083881,HepG2|chr19:53899391-53899504,chr19,53899391,53899504,0,3184384
HepG2|chr19:57201531-57201678,chr19,57201531,57201678,HepG2|chr19:53192674-53192821,chr19,53192674,53192821,0,4008857
HepG2|chr19:57208562-57208650,chr19,57208562,57208650,HepG2|chr19:53899518-53899580,chr19,53899518,53899580,0,3309044
HepG2|chr19:57266043-57266074,chr19,57266043,57266074,HepG2|chr19:4634986-4635114,chr19,4634986,4635114,0,52631057
HepG2|chr19:57287516-57287592,chr19,57287516,57287592,HepG2|chr19:49864204-49864354,chr19,49864204,49864354,0,7423312
HepG2|chr19:57291559-57291617,chr19,57291559,57291617,HepG2|chr19:4634986-4635075,chr19,4634986,4635075,0,52656573
HepG2|chr19:57622307-57622356,chr19,57622307,57622356,HepG2|chr19:44599830-44599900,chr19,44599830,44599900,0,13022477
HepG2|chr19:57694528-57694555,chr19,57694528,57694555,HepG2|chr19:4634985-4635127,chr19,4634985,4635127,0,53059543
HepG2|chr19:57899635-57899745,chr19,57899635,57899745,HepG2|chr19:45248328-45248478,chr19,45248328,45248478,0,12651307
HepG2|chr19:58046379-58046454,chr19,58046379,58046454,HepG2|chr19:45248301-45248370,chr19,45248301,45248370,0,12798078
HepG2|chr19:58057016-58057070,chr19,58057016,58057070,HepG2|chr19:45248301-45248395,chr19,45248301,45248395,0,12808715
HepG2|chr19:58071674-58071824,chr19,58071674,58071824,HepG2|chr19:56058870-56058959,chr19,56058870,56058959,0,2012804
HepG2|chr19:58186442-58186530,chr19,58186442,58186530,HepG2|chr19:53899518-53899580,chr19,53899518,53899580,0,4286924
HepG2|chr19:58241301-58241402,chr19,58241301,58241402,HepG2|chr19:4639119-4639164,chr19,4639119,4639164,0,53602182
HepG2|chr19:58338158-58338192,chr19,58338158,58338192,HepG2|chr19:4634986-4635111,chr19,4634986,4635111,0,53703172
HepG2|chr19:58512465-58512562,chr19,58512465,58512562,HepG2|chr19:4634990-4635063,chr19,4634990,4635063,0,53877475
HepG2|chr19:58572567-58572714,chr19,58572567,58572714,HepG2|chr19:53192876-53192963,chr19,53192876,53192963,0,5379691
HepG2|chr19:58602961-58602984,chr19,58602961,58602984,HepG2|chr19:10358085-10358235,chr19,10358085,10358235,0,48244876
HepG2|chr19:58624690-58624785,chr19,58624690,58624785,HepG2|chr19:3500431-3500449,chr19,3500431,3500449,0,55124259
HepG2|chr19:58649774-58649888,chr19,58649774,58649888,HepG2|chr19:53899391-53899504,chr19,53899391,53899504,0,4750383
HepG2|chr19:58662725-58662744,chr19,58662725,58662744,HepG2|chr19:45248301-45248429,chr19,45248301,45248429,0,13414424
HepG2|chr19:58716779-58716840,chr19,58716779,58716840,HepG2|chr19:53899140-53899229,chr19,53899140,53899229,0,4817639
HepG2|chr19:58784096-58784195,chr19,58784096,58784195,HepG2|chr19:4634986-4635066,chr19,4634986,4635066,0,54149110
HepG2|chr19:58794192-58794238,chr19,58794192,58794238,HepG2|chr19:45248301-45248395,chr19,45248301,45248395,0,13545891
HepG2|chr19:58806490-58806583,chr19,58806490,58806583,HepG2|chr19:4634986-4635115,chr19,4634986,4635115,0,54171504
HepG2|chr19:58901889-58902000,chr19,58901889,58902000,HepG2|chr19:56058930-56058959,chr19,56058930,56058959,0,2842959
HepG2|chr19:58914985-58915131,chr19,58914985,58915131,HepG2|chr19:53899393-53899504,chr19,53899393,53899504,0,5015592
HepG2|chr19:58916164-58916275,chr19,58916164,58916275,HepG2|chr19:53869718-53869792,chr19,53869718,53869792,0,5046446
HepG2|chr19:58923552-58923596,chr19,58923552,58923596,HepG2|chr19:15616763-15616786,chr19,15616763,15616786,0,43306789
HepG2|chr19:59000309-59000341,chr19,59000309,59000341,HepG2|chr19:56058934-56058959,chr19,56058934,56058959,0,2941375
HepG2|chr20:62537-62596,chr20,62537,62596,HepG2|chr20:50423067-50423131,chr20,50423067,50423131,0,50360530
HepG2|chr20:524253-524403,chr20,524253,524403,HepG2|chr20:30944720-30944782,chr20,30944720,30944782,0,30420467
HepG2|chr20:593537-593574,chr20,593537,593574,HepG2|chr20:50422723-50422847,chr20,50422723,50422847,0,49829186
HepG2|chr20:601881-601914,chr20,601881,601914,HepG2|chr20:50419564-50419678,chr20,50419564,50419678,0,49817683
HepG2|chr20:603272-603344,chr20,603272,603344,HepG2|chr20:19993228-19993365,chr20,19993228,19993365,0,19389956
HepG2|chr20:762574-762695,chr20,762574,762695,HepG2|chr20:60958862-60958887,chr20,60958862,60958887,0,60196288
HepG2|chr20:2101444-2101527,chr20,2101444,2101527,HepG2|chr20:50418466-50418530,chr20,50418466,50418530,0,48317022
HepG2|chr20:2246924-2246940,chr20,2246924,2246940,HepG2|chr20:61424930-61425007,chr20,61424930,61425007,0,59178006
HepG2|chr20:2840348-2840407,chr20,2840348,2840407,HepG2|chr20:35917220-35917261,chr20,35917220,35917261,0,33076872
HepG2|chr20:3613923-3614007,chr20,3613923,3614007,HepG2|chr20:60960557-60960609,chr20,60960557,60960609,0,57346634
HepG2|chr20:4325114-4325196,chr20,4325114,4325196,HepG2|chr20:3751714-3751777,chr20,3751714,3751777,0,573400
HepG2|chr20:4566260-4566300,chr20,4566260,4566300,HepG2|chr20:33265259-33265409,chr20,33265259,33265409,0,28698999
HepG2|chr20:4633039-4633060,chr20,4633039,4633060,HepG2|chr20:60732176-60732258,chr20,60732176,60732258,0,56099137
HepG2|chr20:6983184-6983334,chr20,6983184,6983334,HepG2|chr20:50423714-50423775,chr20,50423714,50423775,0,43440530
HepG2|chr20:6995426-6995487,chr20,6995426,6995487,HepG2|chr20:45147096-45147174,chr20,45147096,45147174,0,38151670
HepG2|chr20:7012497-7012581,chr20,7012497,7012581,HepG2|chr20:60960557-60960609,chr20,60960557,60960609,0,53948060
HepG2|chr20:7040220-7040265,chr20,7040220,7040265,HepG2|chr20:50422980-50423083,chr20,50422980,50423083,0,43382760
HepG2|chr20:7058065-7058105,chr20,7058065,7058105,HepG2|chr20:33265259-33265409,chr20,33265259,33265409,0,26207194
HepG2|chr20:7964255-7964314,chr20,7964255,7964314,HepG2|chr20:50423067-50423131,chr20,50423067,50423131,0,42458812
HepG2|chr20:8061879-8061940,chr20,8061879,8061940,HepG2|chr20:50420271-50420421,chr20,50420271,50420421,0,42358392
HepG2|chr20:8472651-8472706,chr20,8472651,8472706,HepG2|chr20:46616025-46616093,chr20,46616025,46616093,0,38143374
HepG2|chr20:8492252-8492303,chr20,8492252,8492303,HepG2|chr20:50423611-50423671,chr20,50423611,50423671,0,41931359
HepG2|chr20:9752471-9752559,chr20,9752471,9752559,HepG2|chr20:30944720-30944782,chr20,30944720,30944782,0,21192249
HepG2|chr20:9786765-9786786,chr20,9786765,9786786,HepG2|chr20:50423296-50423440,chr20,50423296,50423440,0,40636531
HepG2|chr20:10061654-10061730,chr20,10061654,10061730,HepG2|chr20:25569481-25569538,chr20,25569481,25569538,0,15507827
HepG2|chr20:10607916-10607947,chr20,10607916,10607947,HepG2|chr20:50421962-50422081,chr20,50421962,50422081,0,39814046
HepG2|chr20:10654143-10654212,chr20,10654143,10654212,HepG2|chr20:60959758-60959839,chr20,60959758,60959839,0,50305615
HepG2|chr20:10818221-10818272,chr20,10818221,10818272,HepG2|chr20:50423611-50423671,chr20,50423611,50423671,0,39605390
HepG2|chr20:10864898-10864985,chr20,10864898,10864985,HepG2|chr20:25569497-25569540,chr20,25569497,25569540,0,14704599
HepG2|chr20:12098341-12098439,chr20,12098341,12098439,HepG2|chr20:44558549-44558634,chr20,44558549,44558634,0,32460208
HepG2|chr20:12201184-12201204,chr20,12201184,12201204,HepG2|chr20:8111366-8111489,chr20,8111366,8111489,0,4089818
HepG2|chr20:12553154-12553175,chr20,12553154,12553175,HepG2|chr20:25840076-25840204,chr20,25840076,25840204,0,13286922
HepG2|chr20:12776333-12776431,chr20,12776333,12776431,HepG2|chr20:44558549-44558634,chr20,44558549,44558634,0,31782216
HepG2|chr20:12812399-12812468,chr20,12812399,12812468,HepG2|chr20:43972926-43972991,chr20,43972926,43972991,0,31160527
HepG2|chr20:12916206-12916248,chr20,12916206,12916248,HepG2|chr20:25840076-25840202,chr20,25840076,25840202,0,12923870
HepG2|chr20:13037467-13037554,chr20,13037467,13037554,HepG2|chr20:3751714-3751777,chr20,3751714,3751777,0,9285753
HepG2|chr20:13077199-13077250,chr20,13077199,13077250,HepG2|chr20:46616024-46616100,chr20,46616024,46616100,0,33538825
HepG2|chr20:14050822-14050843,chr20,14050822,14050843,HepG2|chr20:36660989-36661056,chr20,36660989,36661056,0,22610167
HepG2|chr20:14267297-14267384,chr20,14267297,14267384,HepG2|chr20:25569497-25569540,chr20,25569497,25569540,0,11302200
HepG2|chr20:14636865-14636952,chr20,14636865,14636952,HepG2|chr20:3751714-3751777,chr20,3751714,3751777,0,10885151
HepG2|chr20:14641868-14641917,chr20,14641868,14641917,HepG2|chr20:50423777-50423852,chr20,50423777,50423852,0,35781909
HepG2|chr20:16470265-16470370,chr20,16470265,16470370,HepG2|chr20:50422980-50423083,chr20,50422980,50423083,0,33952715
HepG2|chr20:17057080-17057125,chr20,17057080,17057125,HepG2|chr20:50422980-50423083,chr20,50422980,50423083,0,33365900
HepG2|chr20:17542258-17542294,chr20,17542258,17542294,HepG2|chr20:35500798-35500912,chr20,35500798,35500912,0,17958540
HepG2|chr20:17742053-17742076,chr20,17742053,17742076,HepG2|chr20:44558881-44559021,chr20,44558881,44559021,0,26816828
HepG2|chr20:18626388-18626538,chr20,18626388,18626538,HepG2|chr20:50423714-50423775,chr20,50423714,50423775,0,31797326
HepG2|chr20:19061329-19061357,chr20,19061329,19061357,HepG2|chr20:50419485-50419584,chr20,50419485,50419584,0,31358156
HepG2|chr20:19222256-19222312,chr20,19222256,19222312,HepG2|chr20:61424878-61424954,chr20,61424878,61424954,0,42202622
HepG2|chr20:19360232-19360253,chr20,19360232,19360253,HepG2|chr20:50423296-50423440,chr20,50423296,50423440,0,31063064
HepG2|chr20:20949312-20949462,chr20,20949312,20949462,HepG2|chr20:30944720-30944782,chr20,30944720,30944782,0,9995408
HepG2|chr20:20952959-20952981,chr20,20952959,20952981,HepG2|chr20:36660989-36661102,chr20,36660989,36661102,0,15708030
HepG2|chr20:20964520-20964556,chr20,20964520,20964556,HepG2|chr20:35500798-35500912,chr20,35500798,35500912,0,14536278
HepG2|chr20:21003279-21003336,chr20,21003279,21003336,HepG2|chr20:50423582-50423673,chr20,50423582,50423673,0,29420303
HepG2|chr20:21052987-21053076,chr20,21052987,21053076,HepG2|chr20:50423714-50423775,chr20,50423714,50423775,0,29370727
HepG2|chr20:21241382-21241438,chr20,21241382,21241438,HepG2|chr20:50418562-50418641,chr20,50418562,50418641,0,29177180
HepG2|chr20:21294061-21294140,chr20,21294061,21294140,HepG2|chr20:8111366-8111489,chr20,8111366,8111489,0,13182695
HepG2|chr20:21569452-21569534,chr20,21569452,21569534,HepG2|chr20:50418466-50418530,chr20,50418466,50418530,0,28849014
HepG2|chr20:22157809-22157840,chr20,22157809,22157840,HepG2|chr20:50421962-50422081,chr20,50421962,50422081,0,28264153
HepG2|chr20:22193583-22193638,chr20,22193583,22193638,HepG2|chr20:50422913-50423008,chr20,50422913,50423008,0,28229330
HepG2|chr20:22662849-22662932,chr20,22662849,22662932,HepG2|chr20:50419564-50419678,chr20,50419564,50419678,0,27756715
HepG2|chr20:23755906-23756028,chr20,23755906,23756028,HepG2|chr20:34333592-34333626,chr20,34333592,34333626,0,10577686
HepG2|chr20:23837587-23837648,chr20,23837587,23837648,HepG2|chr20:50420271-50420421,chr20,50420271,50420421,0,26582684
HepG2|chr20:24069577-24069646,chr20,24069577,24069646,HepG2|chr20:60959758-60959839,chr20,60959758,60959839,0,36890181
HepG2|chr20:24349165-24349263,chr20,24349165,24349263,HepG2|chr20:35917220-35917261,chr20,35917220,35917261,0,11568055
HepG2|chr20:24365539-24365618,chr20,24365539,24365618,HepG2|chr20:8111366-8111489,chr20,8111366,8111489,0,16254173
HepG2|chr20:25036559-25036631,chr20,25036559,25036631,HepG2|chr20:19993228-19993365,chr20,19993228,19993365,0,5043331
HepG2|chr20:25230558-25230708,chr20,25230558,25230708,HepG2|chr20:34333592-34333629,chr20,34333592,34333629,0,9103034
HepG2|chr20:25526406-25526536,chr20,25526406,25526536,HepG2|chr20:60958862-60958887,chr20,60958862,60958887,0,35432456
HepG2|chr20:26185821-26185916,chr20,26185821,26185916,HepG2|chr20:50418466-50418530,chr20,50418466,50418530,0,24232645
HepG2|chr20:26438552-26438682,chr20,26438552,26438682,HepG2|chr20:60958862-60958887,chr20,60958862,60958887,0,34520310
HepG2|chr20:26740209-26740230,chr20,26740209,26740230,HepG2|chr20:60732176-60732258,chr20,60732176,60732258,0,33991967
HepG2|chr20:26944907-26944940,chr20,26944907,26944940,HepG2|chr20:50419564-50419678,chr20,50419564,50419678,0,23474657
HepG2|chr20:27478781-27478841,chr20,27478781,27478841,HepG2|chr20:30941160-30941250,chr20,30941160,30941250,0,3462379
HepG2|chr20:27811563-27811640,chr20,27811563,27811640,HepG2|chr20:30941160-30941250,chr20,30941160,30941250,0,3129597
HepG2|chr20:27856786-27856881,chr20,27856786,27856881,HepG2|chr20:50418466-50418530,chr20,50418466,50418530,0,22561680
HepG2|chr20:28188756-28188815,chr20,28188756,28188815,HepG2|chr20:50423582-50423673,chr20,50423582,50423673,0,22234826
HepG2|chr20:28698129-28698278,chr20,28698129,28698278,HepG2|chr20:35500798-35500912,chr20,35500798,35500912,0,6802669
HepG2|chr20:30042505-30042594,chr20,30042505,30042594,HepG2|chr20:50423714-50423775,chr20,50423714,50423775,0,20381209
HepG2|chr20:30166507-30166583,chr20,30166507,30166583,HepG2|chr20:25569481-25569538,chr20,25569481,25569538,0,4597026
HepG2|chr20:30189743-30189876,chr20,30189743,30189876,HepG2|chr20:60960877-60961014,chr20,60960877,60961014,0,30771134
HepG2|chr20:30221766-30221855,chr20,30221766,30221855,HepG2|chr20:8109223-8109288,chr20,8109223,8109288,0,22112543
HepG2|chr20:30677799-30677823,chr20,30677799,30677823,HepG2|chr20:35917220-35917261,chr20,35917220,35917261,0,5239421
HepG2|chr20:30876482-30876503,chr20,30876482,30876503,HepG2|chr20:25840076-25840204,chr20,25840076,25840204,0,5036406
HepG2|chr20:30973856-30973968,chr20,30973856,30973968,HepG2|chr20:42939954-42940104,chr20,42939954,42940104,0,11966098
HepG2|chr20:31065345-31065492,chr20,31065345,31065492,HepG2|chr20:50419818-50419940,chr20,50419818,50419940,0,19354473
HepG2|chr20:31224498-31224563,chr20,31224498,31224563,HepG2|chr20:19993168-19993318,chr20,19993168,19993318,0,11231330
HepG2|chr20:32239247-32239306,chr20,32239247,32239306,HepG2|chr20:35917220-35917261,chr20,35917220,35917261,0,3677973
HepG2|chr20:32416860-32416945,chr20,32416860,32416945,HepG2|chr20:8109223-8109288,chr20,8109223,8109288,0,24307637
HepG2|chr20:33804285-33804322,chr20,33804285,33804322,HepG2|chr20:50422723-50422847,chr20,50422723,50422847,0,16618438
HepG2|chr20:33929569-33929683,chr20,33929569,33929683,HepG2|chr20:50421962-50422081,chr20,50421962,50422081,0,16492393
HepG2|chr20:34054880-34054949,chr20,34054880,34054949,HepG2|chr20:43972926-43972991,chr20,43972926,43972991,0,9918046
HepG2|chr20:34452699-34452848,chr20,34452699,34452848,HepG2|chr20:35500798-35500912,chr20,35500798,35500912,0,1048099
HepG2|chr20:34599777-34599839,chr20,34599777,34599839,HepG2|chr20:45147126-45147174,chr20,45147126,45147174,0,10547349
HepG2|chr20:34634983-34635043,chr20,34634983,34635043,HepG2|chr20:60960498-60960591,chr20,60960498,60960591,0,26325515
HepG2|chr20:35646008-35646158,chr20,35646008,35646158,HepG2|chr20:60959758-60959839,chr20,60959758,60959839,0,25313750
HepG2|chr20:36560586-36560642,chr20,36560586,36560642,HepG2|chr20:50418562-50418641,chr20,50418562,50418641,0,13857976
HepG2|chr20:36769917-36770000,chr20,36769917,36770000,HepG2|chr20:50419564-50419678,chr20,50419564,50419678,0,13649647
HepG2|chr20:37100570-37100627,chr20,37100570,37100627,HepG2|chr20:50423582-50423673,chr20,50423582,50423673,0,13323012
HepG2|chr20:37419577-37419660,chr20,37419577,37419660,HepG2|chr20:50422913-50423008,chr20,50422913,50423008,0,13003336
HepG2|chr20:38067575-38067638,chr20,38067575,38067638,HepG2|chr20:44558402-44558552,chr20,44558402,44558552,0,6490827
HepG2|chr20:38662712-38662760,chr20,38662712,38662760,HepG2|chr20:50423777-50423852,chr20,50423777,50423852,0,11761065
HepG2|chr20:38835825-38835853,chr20,38835825,38835853,HepG2|chr20:17946974-17947124,chr20,17946974,17947124,0,20888851
HepG2|chr20:39132668-39132687,chr20,39132668,39132687,HepG2|chr20:62579991-62580029,chr20,62579991,62580029,0,23447323
HepG2|chr20:39899233-39899294,chr20,39899233,39899294,HepG2|chr20:45147096-45147174,chr20,45147096,45147174,0,5247863
HepG2|chr20:40763902-40763967,chr20,40763902,40763967,HepG2|chr20:19993168-19993318,chr20,19993168,19993318,0,20770734
HepG2|chr20:41469592-41469614,chr20,41469592,41469614,HepG2|chr20:36660989-36661102,chr20,36660989,36661102,0,4808603
HepG2|chr20:41647192-41647208,chr20,41647192,41647208,HepG2|chr20:61424930-61425007,chr20,61424930,61425007,0,19777738
HepG2|chr20:42496084-42496152,chr20,42496084,42496152,HepG2|chr20:34205644-34205707,chr20,34205644,34205707,0,8290440
HepG2|chr20:42933380-42933475,chr20,42933380,42933475,HepG2|chr20:30941104-30941254,chr20,30941104,30941254,0,11992276
HepG2|chr20:43216143-43216204,chr20,43216143,43216204,HepG2|chr20:42940113-42940202,chr20,42940113,42940202,0,276030
HepG2|chr20:43347851-43347913,chr20,43347851,43347913,HepG2|chr20:45147126-45147174,chr20,45147126,45147174,0,1799275
HepG2|chr20:43527010-43527033,chr20,43527010,43527033,HepG2|chr20:44558881-44559021,chr20,44558881,44559021,0,1031871
HepG2|chr20:43941388-43941509,chr20,43941388,43941509,HepG2|chr20:60958862-60958887,chr20,60958862,60958887,0,17017474
HepG2|chr20:44138260-44138396,chr20,44138260,44138396,HepG2|chr20:61423257-61423407,chr20,61423257,61423407,0,17284997
HepG2|chr20:44394946-44395028,chr20,44394946,44395028,HepG2|chr20:3751714-3751777,chr20,3751714,3751777,0,40643232
HepG2|chr20:45041175-45041203,chr20,45041175,45041203,HepG2|chr20:17946974-17947124,chr20,17946974,17947124,0,27094201
HepG2|chr20:47136064-47136125,chr20,47136064,47136125,HepG2|chr20:42940113-42940202,chr20,42940113,42940202,0,4195951
HepG2|chr20:48322177-48322205,chr20,48322177,48322205,HepG2|chr20:50419485-50419584,chr20,50419485,50419584,0,2097308
HepG2|chr20:48463120-48463267,chr20,48463120,48463267,HepG2|chr20:50419818-50419940,chr20,50419818,50419940,0,1956698
HepG2|chr20:50060648-50060672,chr20,50060648,50060672,HepG2|chr20:35917220-35917261,chr20,35917220,35917261,0,14143428
HepG2|chr20:50219097-50219148,chr20,50219097,50219148,HepG2|chr20:46616024-46616100,chr20,46616024,46616100,0,3603073
HepG2|chr20:50484351-50484399,chr20,50484351,50484399,HepG2|chr20:50423777-50423852,chr20,50423777,50423852,0,60574
HepG2|chr20:50492972-50492999,chr20,50492972,50492999,HepG2|chr20:50422471-50422559,chr20,50422471,50422559,0,70501
HepG2|chr20:50801360-50801423,chr20,50801360,50801423,HepG2|chr20:44558402-44558552,chr20,44558402,44558552,0,6242958
HepG2|chr20:50810280-50810299,chr20,50810280,50810299,HepG2|chr20:62579991-62580029,chr20,62579991,62580029,0,11769711
HepG2|chr20:51022750-51022872,chr20,51022750,51022872,HepG2|chr20:34333592-34333626,chr20,34333592,34333626,0,16689158
HepG2|chr20:51320407-51320505,chr20,51320407,51320505,HepG2|chr20:35917220-35917261,chr20,35917220,35917261,0,15403187
HepG2|chr20:51436314-51436394,chr20,51436314,51436394,HepG2|chr20:42940113-42940202,chr20,42940113,42940202,0,8496201
HepG2|chr20:51727167-51727188,chr20,51727167,51727188,HepG2|chr20:36660989-36661056,chr20,36660989,36661056,0,15066178
HepG2|chr20:52194048-52194136,chr20,52194048,52194136,HepG2|chr20:30944720-30944782,chr20,30944720,30944782,0,21249328
HepG2|chr20:53055220-53055370,chr20,53055220,53055370,HepG2|chr20:34333592-34333629,chr20,34333592,34333629,0,18721628
HepG2|chr20:53179324-53179407,chr20,53179324,53179407,HepG2|chr20:50418466-50418530,chr20,50418466,50418530,0,2760858
HepG2|chr20:53449122-53449236,chr20,53449122,53449236,HepG2|chr20:50421962-50422081,chr20,50421962,50422081,0,3027160
HepG2|chr20:53696313-53696463,chr20,53696313,53696463,HepG2|chr20:60959758-60959839,chr20,60959758,60959839,0,7263445
HepG2|chr20:54507059-54507171,chr20,54507059,54507171,HepG2|chr20:42939954-42940104,chr20,42939954,42940104,0,11567105
HepG2|chr20:54653690-54653758,chr20,54653690,54653758,HepG2|chr20:34205644-34205707,chr20,34205644,34205707,0,20448046
HepG2|chr20:54782411-54782488,chr20,54782411,54782488,HepG2|chr20:30941160-30941250,chr20,30941160,30941250,0,23841251
HepG2|chr20:54965318-54965378,chr20,54965318,54965378,HepG2|chr20:60960498-60960591,chr20,60960498,60960591,0,5995180
HepG2|chr20:56221720-56221775,chr20,56221720,56221775,HepG2|chr20:46616025-46616093,chr20,46616025,46616093,0,9605695
HepG2|chr20:57244612-57244697,chr20,57244612,57244697,HepG2|chr20:8109223-8109288,chr20,8109223,8109288,0,49135389
HepG2|chr20:57918763-57918790,chr20,57918763,57918790,HepG2|chr20:50422471-50422559,chr20,50422471,50422559,0,7496292
HepG2|chr20:58046529-58046585,chr20,58046529,58046585,HepG2|chr20:61424878-61424954,chr20,61424878,61424954,0,3378349
HepG2|chr20:58078697-58078757,chr20,58078697,58078757,HepG2|chr20:30941160-30941250,chr20,30941160,30941250,0,27137537
HepG2|chr20:58445768-58445848,chr20,58445768,58445848,HepG2|chr20:42940113-42940202,chr20,42940113,42940202,0,15505655
HepG2|chr20:58572999-58573019,chr20,58572999,58573019,HepG2|chr20:8111366-8111489,chr20,8111366,8111489,0,50461633
HepG2|chr20:58714255-58714344,chr20,58714255,58714344,HepG2|chr20:8109223-8109288,chr20,8109223,8109288,0,50605032
HepG2|chr20:59121498-59121557,chr20,59121498,59121557,HepG2|chr20:50423582-50423673,chr20,50423582,50423673,0,8697916
HepG2|chr20:59234268-59234323,chr20,59234268,59234323,HepG2|chr20:50422913-50423008,chr20,50422913,50423008,0,8811355
HepG2|chr20:59498193-59498242,chr20,59498193,59498242,HepG2|chr20:50423777-50423852,chr20,50423777,50423852,0,9074416
HepG2|chr20:59898566-59898702,chr20,59898566,59898702,HepG2|chr20:61423257-61423407,chr20,61423257,61423407,0,1524691
HepG2|chr20:60411653-60411707,chr20,60411653,60411707,HepG2|chr20:60960498-60960591,chr20,60960498,60960591,0,548845
HepG2|chr20:60677922-60678055,chr20,60677922,60678055,HepG2|chr20:60960877-60961014,chr20,60960877,60961014,0,282955
HepG2|chr20:61037318-61037400,chr20,61037318,61037400,HepG2|chr20:50418466-50418530,chr20,50418466,50418530,0,10618852
HepG2|chr20:61200488-61200530,chr20,61200488,61200530,HepG2|chr20:25840076-25840202,chr20,25840076,25840202,0,35360412
HepG2|chr20:61208307-61208412,chr20,61208307,61208412,HepG2|chr20:50422980-50423083,chr20,50422980,50423083,0,10785327
HepG2|chr20:61586543-61586638,chr20,61586543,61586638,HepG2|chr20:30941104-30941254,chr20,30941104,30941254,0,30645439
HepG2|chr20:61732560-61732643,chr20,61732560,61732643,HepG2|chr20:50422913-50423008,chr20,50422913,50423008,0,11309647
HepG2|chr20:61970882-61970936,chr20,61970882,61970936,HepG2|chr20:60960498-60960591,chr20,60960498,60960591,0,1010384
HepG2|chr21:191684-191799,chr21,191684,191799,HepG2|chr21:45134992-45135058,chr21,45134992,45135058,0,44943308
HepG2|chr21:225202-225325,chr21,225202,225325,HepG2|chr21:45158817-45158916,chr21,45158817,45158916,0,44933615
HepG2|chr21:244206-244304,chr21,244206,244304,HepG2|chr21:18884652-18884720,chr21,18884652,18884720,0,18640446
HepG2|chr21:281762-281859,chr21,281762,281859,HepG2|chr21:45136941-45137084,chr21,45136941,45137084,0,44855179
HepG2|chr21:501877-501989,chr21,501877,501989,HepG2|chr21:44842514-44842541,chr21,44842514,44842541,0,44340637
HepG2|chr21:2217970-2218080,chr21,2217970,2218080,HepG2|chr21:45136944-45136983,chr21,45136944,45136983,0,42918974
HepG2|chr21:3398233-3398340,chr21,3398233,3398340,HepG2|chr21:44846605-44846638,chr21,44846605,44846638,0,41448372
HepG2|chr21:3936302-3936400,chr21,3936302,3936400,HepG2|chr21:45159015-45159066,chr21,45159015,45159066,0,41222713
HepG2|chr21:4898949-4898995,chr21,4898949,4898995,HepG2|chr21:45136944-45136983,chr21,45136944,45136983,0,40237995
HepG2|chr21:6960219-6960268,chr21,6960219,6960268,HepG2|chr21:44843752-44843825,chr21,44843752,44843825,0,37883533
HepG2|chr21:7358777-7358887,chr21,7358777,7358887,HepG2|chr21:47878264-47878345,chr21,47878264,47878345,0,40519487
HepG2|chr21:7397645-7397711,chr21,7397645,7397711,HepG2|chr21:18884652-18884715,chr21,18884652,18884715,0,11487007
HepG2|chr21:9148095-9148145,chr21,9148095,9148145,HepG2|chr21:44529461-44529611,chr21,44529461,44529611,0,35381366
HepG2|chr21:10311501-10311620,chr21,10311501,10311620,HepG2|chr21:18884652-18884720,chr21,18884652,18884720,0,8573151
HepG2|chr21:10442115-10442213,chr21,10442115,10442213,HepG2|chr21:47878239-47878272,chr21,47878239,47878272,0,37436124
HepG2|chr21:11172326-11172476,chr21,11172326,11172476,HepG2|chr21:45158712-45158831,chr21,45158712,45158831,0,33986386
HepG2|chr21:11300502-11300630,chr21,11300502,11300630,HepG2|chr21:45158817-45158935,chr21,45158817,45158935,0,33858315
HepG2|chr21:11399791-11399879,chr21,11399791,11399879,HepG2|chr21:45159495-45159557,chr21,45159495,45159557,0,33759704
HepG2|chr21:11862100-11862197,chr21,11862100,11862197,HepG2|chr21:45136941-45137084,chr21,45136941,45137084,0,33274841
HepG2|chr21:12027559-12027669,chr21,12027559,12027669,HepG2|chr21:18884652-18884721,chr21,18884652,18884721,0,6857093
HepG2|chr21:12428604-12428651,chr21,12428604,12428651,HepG2|chr21:45158831-45158972,chr21,45158831,45158972,0,32730227
HepG2|chr21:13150731-13150838,chr21,13150731,13150838,HepG2|chr21:44846605-44846638,chr21,44846605,44846638,0,31695874
HepG2|chr21:13461830-13461912,chr21,13461830,13461912,HepG2|chr21:18884652-18884720,chr21,18884652,18884720,0,5422822
HepG2|chr21:13711016-13711135,chr21,13711016,13711135,HepG2|chr21:18884652-18884720,chr21,18884652,18884720,0,5173636
HepG2|chr21:13795055-13795121,chr21,13795055,13795121,HepG2|chr21:18884652-18884715,chr21,18884652,18884715,0,5089597
HepG2|chr21:17934266-17934364,chr21,17934266,17934364,HepG2|chr21:18884652-18884720,chr21,18884652,18884720,0,950386
HepG2|chr21:17964219-17964307,chr21,17964219,17964307,HepG2|chr21:45159495-45159557,chr21,45159495,45159557,0,27195276
HepG2|chr21:18497883-18497930,chr21,18497883,18497930,HepG2|chr21:45158831-45158972,chr21,45158831,45158972,0,26660948
HepG2|chr21:18596809-18596877,chr21,18596809,18596877,HepG2|chr21:18884652-18884721,chr21,18884652,18884721,0,287843
HepG2|chr21:18651959-18652069,chr21,18651959,18652069,HepG2|chr21:18884652-18884721,chr21,18884652,18884721,0,232693
HepG2|chr21:18742089-18742236,chr21,18742089,18742236,HepG2|chr21:45159015-45159066,chr21,45159015,45159066,0,26416926
HepG2|chr21:18752421-18752549,chr21,18752421,18752549,HepG2|chr21:45158817-45158935,chr21,45158817,45158935,0,26406396
HepG2|chr21:19062009-19062123,chr21,19062009,19062123,HepG2|chr21:44842514-44842541,chr21,44842514,44842541,0,25780505
HepG2|chr21:19191412-19191527,chr21,19191412,19191527,HepG2|chr21:45134992-45135058,chr21,45134992,45135058,0,25943580
HepG2|chr21:19895630-19895712,chr21,19895630,19895712,HepG2|chr21:18884652-18884720,chr21,18884652,18884720,0,1010978
HepG2|chr21:19898229-19898260,chr21,19898229,19898260,HepG2|chr21:44529458-44529608,chr21,44529458,44529608,0,24631229
HepG2|chr21:20185262-20185360,chr21,20185262,20185360,HepG2|chr21:47878239-47878272,chr21,47878239,47878272,0,27692977
HepG2|chr21:20634277-20634323,chr21,20634277,20634323,HepG2|chr21:45136944-45136983,chr21,45136944,45136983,0,24502667
HepG2|chr21:21021256-21021287,chr21,21021256,21021287,HepG2|chr21:44529458-44529608,chr21,44529458,44529608,0,23508202
HepG2|chr21:22438956-22439042,chr21,22438956,22439042,HepG2|chr21:18884652-18884711,chr21,18884652,18884711,0,3554304
HepG2|chr21:22680556-22680679,chr21,22680556,22680679,HepG2|chr21:45158786-45158825,chr21,45158786,45158825,0,22478230
HepG2|chr21:23202506-23202616,chr21,23202506,23202616,HepG2|chr21:45136944-45136983,chr21,45136944,45136983,0,21934438
HepG2|chr21:26031378-26031478,chr21,26031378,26031478,HepG2|chr21:47875243-47875274,chr21,47875243,47875274,0,21843865
HepG2|chr21:26204904-26205004,chr21,26204904,26205004,HepG2|chr21:47875243-47875274,chr21,47875243,47875274,0,21670339
HepG2|chr21:26498608-26498706,chr21,26498608,26498706,HepG2|chr21:45159015-45159066,chr21,45159015,45159066,0,18660407
HepG2|chr21:27701075-27701225,chr21,27701075,27701225,HepG2|chr21:45158712-45158831,chr21,45158712,45158831,0,17457637
HepG2|chr21:28148385-28148466,chr21,28148385,28148466,HepG2|chr21:44529557-44529626,chr21,44529557,44529626,0,16381172
HepG2|chr21:28167537-28167659,chr21,28167537,28167659,HepG2|chr21:45158831-45158968,chr21,45158831,45158968,0,16991294
HepG2|chr21:28797532-28797581,chr21,28797532,28797581,HepG2|chr21:44843752-44843825,chr21,44843752,44843825,0,16046220
HepG2|chr21:28932274-28932345,chr21,28932274,28932345,HepG2|chr21:45135095-45135159,chr21,45135095,45135159,0,16202821
HepG2|chr21:29090062-29090184,chr21,29090062,29090184,HepG2|chr21:45158831-45158968,chr21,45158831,45158968,0,16068769
HepG2|chr21:29579489-29579557,chr21,29579489,29579557,HepG2|chr21:18884652-18884721,chr21,18884652,18884721,0,10694837
HepG2|chr21:29695575-29695658,chr21,29695575,29695658,HepG2|chr21:45134992-45135058,chr21,45134992,45135058,0,15439417
HepG2|chr21:29713587-29713624,chr21,29713587,29713624,HepG2|chr21:18884652-18884737,chr21,18884652,18884737,0,10828935
HepG2|chr21:29727692-29727744,chr21,29727692,29727744,HepG2|chr21:47875324-47875421,chr21,47875324,47875421,0,18147632
HepG2|chr21:29858346-29858432,chr21,29858346,29858432,HepG2|chr21:18884652-18884711,chr21,18884652,18884711,0,10973694
HepG2|chr21:30362870-30363017,chr21,30362870,30363017,HepG2|chr21:45159015-45159066,chr21,45159015,45159066,0,14796145
HepG2|chr21:30406750-30406900,chr21,30406750,30406900,HepG2|chr21:45158817-45158927,chr21,45158817,45158927,0,14752067
HepG2|chr21:30777487-30777609,chr21,30777487,30777609,HepG2|chr21:45158783-45158831,chr21,45158783,45158831,0,14381296
HepG2|chr21:30915655-30915805,chr21,30915655,30915805,HepG2|chr21:45158805-45158888,chr21,45158805,45158888,0,14243150
HepG2|chr21:30947371-30947494,chr21,30947371,30947494,HepG2|chr21:45158817-45158916,chr21,45158817,45158916,0,14211446
HepG2|chr21:31578568-31578718,chr21,31578568,31578718,HepG2|chr21:44529557-44529626,chr21,44529557,44529626,0,12950989
HepG2|chr21:31860330-31860440,chr21,31860330,31860440,HepG2|chr21:47878264-47878345,chr21,47878264,47878345,0,16017934
HepG2|chr21:32170567-32170684,chr21,32170567,32170684,HepG2|chr21:45158831-45158974,chr21,45158831,45158974,0,12988264
HepG2|chr21:32438326-32438405,chr21,32438326,32438405,HepG2|chr21:18884652-18884707,chr21,18884652,18884707,0,13553674
HepG2|chr21:33204715-33204767,chr21,33204715,33204767,HepG2|chr21:47875324-47875421,chr21,47875324,47875421,0,14670609
HepG2|chr21:33468091-33468241,chr21,33468091,33468241,HepG2|chr21:45158805-45158888,chr21,45158805,45158888,0,11690714
HepG2|chr21:33559980-33560110,chr21,33559980,33560110,HepG2|chr21:45158831-45158974,chr21,45158831,45158974,0,11598851
HepG2|chr21:33991898-33992028,chr21,33991898,33992028,HepG2|chr21:45158831-45158974,chr21,45158831,45158974,0,11166933
HepG2|chr21:37347461-37347586,chr21,37347461,37347586,HepG2|chr21:45158781-45158931,chr21,45158781,45158931,0,7811320
HepG2|chr21:37420986-37421107,chr21,37420986,37421107,HepG2|chr21:45158783-45158831,chr21,45158783,45158831,0,7737797
HepG2|chr21:38673780-38673851,chr21,38673780,38673851,HepG2|chr21:45135095-45135159,chr21,45135095,45135159,0,6461315
HepG2|chr21:39770476-39770526,chr21,39770476,39770526,HepG2|chr21:44529461-44529611,chr21,44529461,44529611,0,4758985
HepG2|chr21:40293663-40293746,chr21,40293663,40293746,HepG2|chr21:45134992-45135058,chr21,45134992,45135058,0,4841329
HepG2|chr21:40416210-40416322,chr21,40416210,40416322,HepG2|chr21:44842514-44842541,chr21,44842514,44842541,0,4426304
HepG2|chr21:40956558-40956627,chr21,40956558,40956627,HepG2|chr21:44843752-44843825,chr21,44843752,44843825,0,3887194
HepG2|chr21:41629053-41629132,chr21,41629053,41629132,HepG2|chr21:18884652-18884707,chr21,18884652,18884707,0,22744401
HepG2|chr21:42805046-42805163,chr21,42805046,42805163,HepG2|chr21:45158831-45158974,chr21,45158831,45158974,0,2353785
HepG2|chr21:43034576-43034690,chr21,43034576,43034690,HepG2|chr21:44842514-44842541,chr21,44842514,44842541,0,1807938
HepG2|chr21:43207496-43207619,chr21,43207496,43207619,HepG2|chr21:45158786-45158825,chr21,45158786,45158825,0,1951290
HepG2|chr21:43286875-43286997,chr21,43286875,43286997,HepG2|chr21:45158783-45158831,chr21,45158783,45158831,0,1871908
HepG2|chr21:43626572-43626722,chr21,43626572,43626722,HepG2|chr21:44529557-44529626,chr21,44529557,44529626,0,902985
HepG2|chr21:44607107-44607176,chr21,44607107,44607176,HepG2|chr21:44843752-44843825,chr21,44843752,44843825,0,236645
HepG2|chr21:45008438-45008563,chr21,45008438,45008563,HepG2|chr21:45158781-45158931,chr21,45158781,45158931,0,150343
HepG2|chr21:45818670-45818791,chr21,45818670,45818791,HepG2|chr21:45158783-45158831,chr21,45158783,45158831,0,659887
HepG2|chr21:45992702-45992783,chr21,45992702,45992783,HepG2|chr21:44842928-44843066,chr21,44842928,44843066,0,1149774
HepG2|chr21:46090336-46090486,chr21,46090336,46090486,HepG2|chr21:45158817-45158927,chr21,45158817,45158927,0,931519
HepG2|chr21:46112231-46112312,chr21,46112231,46112312,HepG2|chr21:44842928-44843066,chr21,44842928,44843066,0,1269303
HepG2|chr21:47366594-47366675,chr21,47366594,47366675,HepG2|chr21:44529557-44529626,chr21,44529557,44529626,0,2837037
HepG2|chr21:48071825-48071862,chr21,48071825,48071862,HepG2|chr21:18884652-18884737,chr21,18884652,18884737,0,29187173
HepG2|chr22:283582-283731,chr22,283582,283731,HepG2|chr22:25002547-25002697,chr22,25002547,25002697,0,24718965
HepG2|chr22:336933-337043,chr22,336933,337043,HepG2|chr22:42527691-42527824,chr22,42527691,42527824,0,42190758
HepG2|chr22:908344-908460,chr22,908344,908460,HepG2|chr22:42914836-42914986,chr22,42914836,42914986,0,42006492
HepG2|chr22:1867956-1868087,chr22,1867956,1868087,HepG2|chr22:42915384-42915469,chr22,42915384,42915469,0,41047428
HepG2|chr22:2363393-2363430,chr22,2363393,2363430,HepG2|chr22:41953302-41953416,chr22,41953302,41953416,0,39589909
HepG2|chr22:2659517-2659558,chr22,2659517,2659558,HepG2|chr22:24998801-24998910,chr22,24998801,24998910,0,22339284
HepG2|chr22:2660026-2660121,chr22,2660026,2660121,HepG2|chr22:42914754-42914904,chr22,42914754,42914904,0,40254728
HepG2|chr22:2804074-2804223,chr22,2804074,2804223,HepG2|chr22:21775824-21775974,chr22,21775824,21775974,0,18971750
HepG2|chr22:3858309-3858456,chr22,3858309,3858456,HepG2|chr22:24998781-24998920,chr22,24998781,24998920,0,21140472
HepG2|chr22:4247014-4247086,chr22,4247014,4247086,HepG2|chr22:24098515-24098593,chr22,24098515,24098593,0,19851501
HepG2|chr22:4361946-4362047,chr22,4361946,4362047,HepG2|chr22:42914694-42914841,chr22,42914694,42914841,0,38552748
HepG2|chr22:5879490-5879567,chr22,5879490,5879567,HepG2|chr22:41984068-41984139,chr22,41984068,41984139,0,36104578
HepG2|chr22:5888928-5888991,chr22,5888928,5888991,HepG2|chr22:42526924-42527008,chr22,42526924,42527008,0,36637996
HepG2|chr22:5899333-5899398,chr22,5899333,5899398,HepG2|chr22:36879531-36879681,chr22,36879531,36879681,0,30980198
HepG2|chr22:6312543-6312693,chr22,6312543,6312693,HepG2|chr22:24998746-24998896,chr22,24998746,24998896,0,18686203
HepG2|chr22:7129759-7129906,chr22,7129759,7129906,HepG2|chr22:25002746-25002896,chr22,25002746,25002896,0,17872987
HepG2|chr22:7249892-7250042,chr22,7249892,7250042,HepG2|chr22:38144566-38144583,chr22,38144566,38144583,0,30894674
HepG2|chr22:7525641-7525713,chr22,7525641,7525713,HepG2|chr22:41983964-41984042,chr22,41983964,41984042,0,34458323
HepG2|chr22:7617936-7618046,chr22,7617936,7618046,HepG2|chr22:42527691-42527824,chr22,42527691,42527824,0,34909755
HepG2|chr22:7905234-7905384,chr22,7905234,7905384,HepG2|chr22:24998823-24998973,chr22,24998823,24998973,0,17093589
HepG2|chr22:8296159-8296309,chr22,8296159,8296309,HepG2|chr22:25002768-25002918,chr22,25002768,25002918,0,16706609
HepG2|chr22:8793705-8793855,chr22,8793705,8793855,HepG2|chr22:25002768-25002918,chr22,25002768,25002918,0,16209063
HepG2|chr22:9165574-9165720,chr22,9165574,9165720,HepG2|chr22:24998774-24998920,chr22,24998774,24998920,0,15833200
HepG2|chr22:9394873-9395020,chr22,9394873,9395020,HepG2|chr22:24998772-24998922,chr22,24998772,24998922,0,15603899
HepG2|chr22:9562111-9562261,chr22,9562111,9562261,HepG2|chr22:21775824-21775974,chr22,21775824,21775974,0,12213713
HepG2|chr22:9622459-9622609,chr22,9622459,9622609,HepG2|chr22:24998765-24998915,chr22,24998765,24998915,0,15376306
HepG2|chr22:9625402-9625479,chr22,9625402,9625479,HepG2|chr22:41984068-41984139,chr22,41984068,41984139,0,32358666
HepG2|chr22:10002158-10002308,chr22,10002158,10002308,HepG2|chr22:24998819-24998969,chr22,24998819,24998969,0,14996661
HepG2|chr22:10047006-10047074,chr22,10047006,10047074,HepG2|chr22:41983965-41984047,chr22,41983965,41984047,0,31936959
HepG2|chr22:10542025-10542175,chr22,10542025,10542175,HepG2|chr22:21474734-21474884,chr22,21474734,21474884,0,10932709
HepG2|chr22:10606679-10606774,chr22,10606679,10606774,HepG2|chr22:42914754-42914904,chr22,42914754,42914904,0,32308075
HepG2|chr22:10628809-10628843,chr22,10628809,10628843,HepG2|chr22:50244729-50244812,chr22,50244729,50244812,0,39615920
HepG2|chr22:10825607-10825649,chr22,10825607,10825649,HepG2|chr22:30644472-30644622,chr22,30644472,30644622,0,19818865
HepG2|chr22:11347225-11347353,chr22,11347225,11347353,HepG2|chr22:50246083-50246137,chr22,50246083,50246137,0,38898858
HepG2|chr22:11349673-11349745,chr22,11349673,11349745,HepG2|chr22:41983964-41984042,chr22,41983964,41984042,0,30634291
HepG2|chr22:11436910-11437020,chr22,11436910,11437020,HepG2|chr22:38205134-38205191,chr22,38205134,38205191,0,26768224
HepG2|chr22:11586390-11586450,chr22,11586390,11586450,HepG2|chr22:42915419-42915509,chr22,42915419,42915509,0,31329029
HepG2|chr22:12006020-12006170,chr22,12006020,12006170,HepG2|chr22:24998798-24998948,chr22,24998798,24998948,0,12992778
HepG2|chr22:12071547-12071659,chr22,12071547,12071659,HepG2|chr22:46664558-46664595,chr22,46664558,46664595,0,34593011
HepG2|chr22:12236165-12236198,chr22,12236165,12236198,HepG2|chr22:50244729-50244812,chr22,50244729,50244812,0,38008564
HepG2|chr22:12954808-12954918,chr22,12954808,12954918,HepG2|chr22:42528347-42528399,chr22,42528347,42528399,0,29573539
HepG2|chr22:13130962-13131084,chr22,13130962,13131084,HepG2|chr22:25002745-25002895,chr22,25002745,25002895,0,11871783
HepG2|chr22:13635070-13635217,chr22,13635070,13635217,HepG2|chr22:24998795-24998942,chr22,24998795,24998942,0,11363725
HepG2|chr22:13760690-13760840,chr22,13760690,13760840,HepG2|chr22:24998785-24998932,chr22,24998785,24998932,0,11238095
HepG2|chr22:13960051-13960201,chr22,13960051,13960201,HepG2|chr22:24998822-24998972,chr22,24998822,24998972,0,11038771
HepG2|chr22:13970040-13970190,chr22,13970040,13970190,HepG2|chr22:25002509-25002659,chr22,25002509,25002659,0,11032469
HepG2|chr22:14043455-14043605,chr22,14043455,14043605,HepG2|chr22:24998822-24998972,chr22,24998822,24998972,0,10955367
HepG2|chr22:14190510-14190660,chr22,14190510,14190660,HepG2|chr22:24998795-24998939,chr22,24998795,24998939,0,10808285
HepG2|chr22:14757967-14758117,chr22,14757967,14758117,HepG2|chr22:24998823-24998973,chr22,24998823,24998973,0,10240856
HepG2|chr22:14810094-14810244,chr22,14810094,14810244,HepG2|chr22:21474736-21474881,chr22,21474736,21474881,0,6664642
HepG2|chr22:15702927-15703015,chr22,15702927,15703015,HepG2|chr22:42081561-42081604,chr22,42081561,42081604,0,26378634
HepG2|chr22:15876652-15876802,chr22,15876652,15876802,HepG2|chr22:24998760-24998910,chr22,24998760,24998910,0,9122108
HepG2|chr22:15937945-15938020,chr22,15937945,15938020,HepG2|chr22:41956723-41956783,chr22,41956723,41956783,0,26018778
HepG2|chr22:16043597-16043690,chr22,16043597,16043690,HepG2|chr22:38205134-38205191,chr22,38205134,38205191,0,22161537
HepG2|chr22:16238991-16239056,chr22,16238991,16239056,HepG2|chr22:50244729-50244812,chr22,50244729,50244812,0,34005738
HepG2|chr22:16531660-16531807,chr22,16531660,16531807,HepG2|chr22:24998795-24998942,chr22,24998795,24998942,0,8467135
HepG2|chr22:16901197-16901347,chr22,16901197,16901347,HepG2|chr22:24998746-24998896,chr22,24998746,24998896,0,8097549
HepG2|chr22:17081802-17081950,chr22,17081802,17081950,HepG2|chr22:24998822-24998972,chr22,24998822,24998972,0,7917020
HepG2|chr22:17313050-17313122,chr22,17313050,17313122,HepG2|chr22:41956723-41956801,chr22,41956723,41956801,0,24643673
HepG2|chr22:17316956-17317016,chr22,17316956,17317016,HepG2|chr22:42915419-42915509,chr22,42915419,42915509,0,25598463
HepG2|chr22:17404343-17404435,chr22,17404343,17404435,HepG2|chr22:24998719-24998869,chr22,24998719,24998869,0,7594376
HepG2|chr22:19415509-19415659,chr22,19415509,19415659,HepG2|chr22:24998819-24998969,chr22,24998819,24998969,0,5583310
HepG2|chr22:19503899-19504046,chr22,19503899,19504046,HepG2|chr22:25002746-25002896,chr22,25002746,25002896,0,5498847
HepG2|chr22:19596555-19596705,chr22,19596555,19596705,HepG2|chr22:21775824-21775974,chr22,21775824,21775974,0,2179269
HepG2|chr22:19898191-19898287,chr22,19898191,19898287,HepG2|chr22:42915415-42915469,chr22,42915415,42915469,0,23017224
HepG2|chr22:20337217-20337327,chr22,20337217,20337327,HepG2|chr22:38205134-38205191,chr22,38205134,38205191,0,17867917
HepG2|chr22:20526808-20526929,chr22,20526808,20526929,HepG2|chr22:38144566-38144583,chr22,38144566,38144583,0,17617758
HepG2|chr22:21404552-21404620,chr22,21404552,21404620,HepG2|chr22:41983965-41984047,chr22,41983965,41984047,0,20579413
HepG2|chr22:21789334-21789484,chr22,21789334,21789484,HepG2|chr22:24998756-24998906,chr22,24998756,24998906,0,3209422
HepG2|chr22:21986846-21986996,chr22,21986846,21986996,HepG2|chr22:21474736-21474881,chr22,21474736,21474881,0,512110
HepG2|chr22:22463985-22464132,chr22,22463985,22464132,HepG2|chr22:25002581-25002731,chr22,25002581,25002731,0,2538596
HepG2|chr22:22466199-22466271,chr22,22466199,22466271,HepG2|chr22:24098515-24098593,chr22,24098515,24098593,0,1632316
HepG2|chr22:22546865-22547001,chr22,22546865,22547001,HepG2|chr22:41984068-41984139,chr22,41984068,41984139,0,19437203
HepG2|chr22:23679866-23679908,chr22,23679866,23679908,HepG2|chr22:30644472-30644622,chr22,30644472,30644622,0,6964606
HepG2|chr22:24042774-24042886,chr22,24042774,24042886,HepG2|chr22:46664558-46664595,chr22,46664558,46664595,0,22621784
HepG2|chr22:24503585-24503657,chr22,24503585,24503657,HepG2|chr22:24098515-24098593,chr22,24098515,24098593,0,405070
HepG2|chr22:24868501-24868565,chr22,24868501,24868565,HepG2|chr22:42526924-42527008,chr22,42526924,42527008,0,17658423
HepG2|chr22:24962802-24962867,chr22,24962802,24962867,HepG2|chr22:50244729-50244812,chr22,50244729,50244812,0,25281927
HepG2|chr22:24984743-24984874,chr22,24984743,24984874,HepG2|chr22:41956723-41956742,chr22,41956723,41956742,0,16971980
HepG2|chr22:25203073-25203168,chr22,25203073,25203168,HepG2|chr22:42528347-42528399,chr22,42528347,42528399,0,17325274
HepG2|chr22:26102419-26102456,chr22,26102419,26102456,HepG2|chr22:41953302-41953416,chr22,41953302,41953416,0,15850883
HepG2|chr22:26251897-26252028,chr22,26251897,26252028,HepG2|chr22:24098515-24098593,chr22,24098515,24098593,0,2153382
HepG2|chr22:27363962-27364060,chr22,27363962,27364060,HepG2|chr22:46440735-46440786,chr22,46440735,46440786,0,19076773
HepG2|chr22:27431790-27431919,chr22,27431790,27431919,HepG2|chr22:39092810-39092960,chr22,39092810,39092960,0,11661020
HepG2|chr22:27876546-27876675,chr22,27876546,27876675,HepG2|chr22:42526898-42526982,chr22,42526898,42526982,0,14650352
HepG2|chr22:28338068-28338160,chr22,28338068,28338160,HepG2|chr22:38205134-38205191,chr22,38205134,38205191,0,9867066
HepG2|chr22:28456722-28456832,chr22,28456722,28456832,HepG2|chr22:42528347-42528399,chr22,42528347,42528399,0,14071625
HepG2|chr22:28803843-28803989,chr22,28803843,28803989,HepG2|chr22:25002741-25002891,chr22,25002741,25002891,0,3801102
HepG2|chr22:29960728-29960780,chr22,29960728,29960780,HepG2|chr22:42088521-42088580,chr22,42088521,42088580,0,12127793
HepG2|chr22:30088811-30088886,chr22,30088811,30088886,HepG2|chr22:41956723-41956783,chr22,41956723,41956783,0,11867912
HepG2|chr22:30120010-30120159,chr22,30120010,30120159,HepG2|chr22:25002547-25002697,chr22,25002547,25002697,0,5117463
HepG2|chr22:30284726-30284872,chr22,30284726,30284872,HepG2|chr22:42914806-42914956,chr22,42914806,42914956,0,12630080
HepG2|chr22:30460778-30460811,chr22,30460778,30460811,HepG2|chr22:50244729-50244812,chr22,50244729,50244812,0,19783951
HepG2|chr22:30494959-30495041,chr22,30494959,30495041,HepG2|chr22:42915410-42915478,chr22,42915410,42915478,0,12420451
HepG2|chr22:30958255-30958405,chr22,30958255,30958405,HepG2|chr22:25002509-25002659,chr22,25002509,25002659,0,5955746
HepG2|chr22:31185675-31185770,chr22,31185675,31185770,HepG2|chr22:42528347-42528399,chr22,42528347,42528399,0,11342672
HepG2|chr22:31247864-31247960,chr22,31247864,31247960,HepG2|chr22:46440734-46440786,chr22,46440734,46440786,0,15192870
HepG2|chr22:31261338-31261488,chr22,31261338,31261488,HepG2|chr22:24998798-24998948,chr22,24998798,24998948,0,6262540
HepG2|chr22:31264694-31264815,chr22,31264694,31264815,HepG2|chr22:38144566-38144583,chr22,38144566,38144583,0,6879872
HepG2|chr22:31365425-31365556,chr22,31365425,31365556,HepG2|chr22:41956723-41956742,chr22,41956723,41956742,0,10591298
HepG2|chr22:32990942-32991040,chr22,32990942,32991040,HepG2|chr22:46440735-46440786,chr22,46440735,46440786,0,13449793
HepG2|chr22:33235488-33235615,chr22,33235488,33235615,HepG2|chr22:42528199-42528222,chr22,42528199,42528222,0,9292711
HepG2|chr22:33293019-33293120,chr22,33293019,33293120,HepG2|chr22:42914694-42914841,chr22,42914694,42914841,0,9621675
HepG2|chr22:33452245-33452395,chr22,33452245,33452395,HepG2|chr22:38144566-38144583,chr22,38144566,38144583,0,4692321
HepG2|chr22:33521123-33521249,chr22,33521123,33521249,HepG2|chr22:42915436-42915562,chr22,42915436,42915562,0,9394313
HepG2|chr22:33706231-33706272,chr22,33706231,33706272,HepG2|chr22:24998801-24998910,chr22,24998801,24998910,0,8707430
HepG2|chr22:34183962-34184112,chr22,34183962,34184112,HepG2|chr22:24998820-24998967,chr22,24998820,24998967,0,9185142
HepG2|chr22:34721950-34722099,chr22,34721950,34722099,HepG2|chr22:21775824-21775974,chr22,21775824,21775974,0,12946126
HepG2|chr22:35076847-35076963,chr22,35076847,35076963,HepG2|chr22:42914836-42914986,chr22,42914836,42914986,0,7837989
HepG2|chr22:35161916-35161980,chr22,35161916,35161980,HepG2|chr22:42526924-42527008,chr22,42526924,42527008,0,7365008
HepG2|chr22:35566154-35566250,chr22,35566154,35566250,HepG2|chr22:42915415-42915469,chr22,42915415,42915469,0,7349261
HepG2|chr22:35594694-35594844,chr22,35594694,35594844,HepG2|chr22:24998749-24998899,chr22,24998749,24998899,0,10595945
HepG2|chr22:35779504-35779650,chr22,35779504,35779650,HepG2|chr22:24998785-24998932,chr22,24998785,24998932,0,10780719
HepG2|chr22:35829168-35829294,chr22,35829168,35829294,HepG2|chr22:42915436-42915562,chr22,42915436,42915562,0,7086268
HepG2|chr22:36340699-36340830,chr22,36340699,36340830,HepG2|chr22:24098515-24098593,chr22,24098515,24098593,0,12242184
HepG2|chr22:36724869-36724996,chr22,36724869,36724996,HepG2|chr22:42528199-42528222,chr22,42528199,42528222,0,5803330
HepG2|chr22:36728560-36728648,chr22,36728560,36728648,HepG2|chr22:42081561-42081604,chr22,42081561,42081604,0,5353001
HepG2|chr22:36737375-36737468,chr22,36737375,36737468,HepG2|chr22:41956723-41956746,chr22,41956723,41956746,0,5219348
HepG2|chr22:37252191-37252283,chr22,37252191,37252283,HepG2|chr22:24998719-24998869,chr22,24998719,24998869,0,12253472
HepG2|chr22:37276294-37276408,chr22,37276294,37276408,HepG2|chr22:30643813-30643848,chr22,30643813,30643848,0,6632481
HepG2|chr22:37286850-37286979,chr22,37286850,37286979,HepG2|chr22:39092810-39092960,chr22,39092810,39092960,0,1805960
HepG2|chr22:37556298-37556448,chr22,37556298,37556448,HepG2|chr22:21474734-21474884,chr22,21474734,21474884,0,16081564
HepG2|chr22:37814191-37814233,chr22,37814191,37814233,HepG2|chr22:42915443-42915591,chr22,42915443,42915591,0,5101252
HepG2|chr22:37994045-37994078,chr22,37994045,37994078,HepG2|chr22:41953302-41953416,chr22,41953302,41953416,0,3959257
HepG2|chr22:38004036-38004069,chr22,38004036,38004069,HepG2|chr22:41953302-41953416,chr22,41953302,41953416,0,3949266
HepG2|chr22:38205239-38205389,chr22,38205239,38205389,HepG2|chr22:24998820-24998967,chr22,24998820,24998967,0,13206419
HepG2|chr22:38609017-38609110,chr22,38609017,38609110,HepG2|chr22:41956723-41956746,chr22,41956723,41956746,0,3347706
HepG2|chr22:38659569-38659719,chr22,38659569,38659719,HepG2|chr22:24998760-24998910,chr22,24998760,24998910,0,13660809
HepG2|chr22:38797968-38798118,chr22,38797968,38798118,HepG2|chr22:24998765-24998915,chr22,24998765,24998915,0,13799203
HepG2|chr22:39302517-39302665,chr22,39302517,39302665,HepG2|chr22:24998822-24998972,chr22,24998822,24998972,0,14303695
HepG2|chr22:39424917-39425067,chr22,39424917,39425067,HepG2|chr22:24998785-24998932,chr22,24998785,24998932,0,14426132
HepG2|chr22:39518171-39518307,chr22,39518171,39518307,HepG2|chr22:41984068-41984139,chr22,41984068,41984139,0,2465897
HepG2|chr22:40013167-40013298,chr22,40013167,40013298,HepG2|chr22:42915384-42915469,chr22,42915384,42915469,0,2902217
HepG2|chr22:40786646-40786793,chr22,40786646,40786793,HepG2|chr22:24998781-24998920,chr22,24998781,24998920,0,15787865
HepG2|chr22:41069816-41069962,chr22,41069816,41069962,HepG2|chr22:25002741-25002891,chr22,25002741,25002891,0,16067075
HepG2|chr22:41177076-41177223,chr22,41177076,41177223,HepG2|chr22:24998772-24998922,chr22,24998772,24998922,0,16178304
HepG2|chr22:41637236-41637306,chr22,41637236,41637306,HepG2|chr22:42526940-42527015,chr22,42526940,42527015,0,889704
HepG2|chr22:41748404-41748497,chr22,41748404,41748497,HepG2|chr22:38205134-38205191,chr22,38205134,38205191,0,3543270
HepG2|chr22:42817394-42817464,chr22,42817394,42817464,HepG2|chr22:42526940-42527015,chr22,42526940,42527015,0,290454
HepG2|chr22:43150039-43150091,chr22,43150039,43150091,HepG2|chr22:42088521-42088580,chr22,42088521,42088580,0,1061518
HepG2|chr22:43237577-43237642,chr22,43237577,43237642,HepG2|chr22:36879531-36879681,chr22,36879531,36879681,0,6358046
HepG2|chr22:43777513-43777659,chr22,43777513,43777659,HepG2|chr22:42914806-42914956,chr22,42914806,42914956,0,862707
HepG2|chr22:44145922-44146071,chr22,44145922,44146071,HepG2|chr22:42914801-42914949,chr22,42914801,42914949,0,1231121
HepG2|chr22:44297488-44297596,chr22,44297488,44297596,HepG2|chr22:46664559-46664593,chr22,46664559,46664593,0,2367071
HepG2|chr22:45212041-45212191,chr22,45212041,45212191,HepG2|chr22:24998749-24998899,chr22,24998749,24998899,0,20213292
HepG2|chr22:46178556-46178664,chr22,46178556,46178664,HepG2|chr22:46664559-46664593,chr22,46664559,46664593,0,486003
HepG2|chr22:46490432-46490546,chr22,46490432,46490546,HepG2|chr22:30643813-30643848,chr22,30643813,30643848,0,15846619
HepG2|chr22:47388919-47389048,chr22,47388919,47389048,HepG2|chr22:42526898-42526982,chr22,42526898,42526982,0,4862021
HepG2|chr22:47584663-47584813,chr22,47584663,47584813,HepG2|chr22:24998756-24998906,chr22,24998756,24998906,0,22585907
HepG2|chr22:47773828-47773862,chr22,47773828,47773862,HepG2|chr22:50244729-50244812,chr22,50244729,50244812,0,2470901
HepG2|chr22:47851035-47851077,chr22,47851035,47851077,HepG2|chr22:42915443-42915591,chr22,42915443,42915591,0,4935592
HepG2|chr22:48151508-48151630,chr22,48151508,48151630,HepG2|chr22:25002745-25002895,chr22,25002745,25002895,0,23148763
HepG2|chr22:48284305-48284454,chr22,48284305,48284454,HepG2|chr22:42914801-42914949,chr22,42914801,42914949,0,5369504
HepG2|chr22:48808922-48809050,chr22,48808922,48809050,HepG2|chr22:50246083-50246137,chr22,50246083,50246137,0,1437161
HepG2|chr22:49179497-49179579,chr22,49179497,49179579,HepG2|chr22:42915410-42915478,chr22,42915410,42915478,0,6264087
HepG2|chr22:49330651-49330743,chr22,49330651,49330743,HepG2|chr22:38205134-38205191,chr22,38205134,38205191,0,11125517
HepG2|chr22:49697210-49697282,chr22,49697210,49697282,HepG2|chr22:41956723-41956801,chr22,41956723,41956801,0,7740487
HepG2|chr22:49737922-49738068,chr22,49737922,49738068,HepG2|chr22:24998774-24998920,chr22,24998774,24998920,0,24739148
HepG2|chr22:49931847-49931919,chr22,49931847,49931919,HepG2|chr22:24098515-24098593,chr22,24098515,24098593,0,25833332
HepG2|chr22:49947169-49947316,chr22,49947169,49947316,HepG2|chr22:25002581-25002731,chr22,25002581,25002731,0,24944588
HepG2|chr22:50395411-50395561,chr22,50395411,50395561,HepG2|chr22:24998795-24998939,chr22,24998795,24998939,0,25396616
HepG2|chr22:50399919-50400015,chr22,50399919,50400015,HepG2|chr22:46440734-46440786,chr22,46440734,46440786,0,3959185
HepG2|chr22:50882962-50883108,chr22,50882962,50883108,HepG2|chr22:24998785-24998932,chr22,24998785,24998932,0,25884177
HepG2|chr22:51228903-51228966,chr22,51228903,51228966,HepG2|chr22:42526924-42527008,chr22,42526924,42527008,0,8701979
