enhancer_name,enhancer_chrom,enhancer_start,enhancer_end,promoter_name,promoter_chrom,promoter_start,promoter_end,label,enhancer_distance_to_promoter
IMR90|chr1:1187194-1187331,chr1,1187194,1187331,IMR90|chr1:1202058-1202123,chr1,1202058,1202123,1,14864
IMR90|chr1:1187961-1187987,chr1,1187961,1187987,IMR90|chr1:1204953-1205100,chr1,1204953,1205100,1,16992
IMR90|chr1:1188678-1188772,chr1,1188678,1188772,IMR90|chr1:1206366-1206422,chr1,1206366,1206422,1,17688
IMR90|chr1:1188684-1188834,chr1,1188684,1188834,IMR90|chr1:1206366-1206422,chr1,1206366,1206422,1,17682
IMR90|chr1:1194281-1194363,chr1,1194281,1194363,IMR90|chr1:1292611-1292677,chr1,1292611,1292677,1,98330
IMR90|chr1:1253491-1253556,chr1,1253491,1253556,IMR90|chr1:26852979-26853022,chr1,26852979,26853022,1,25599488
IMR90|chr1:1793438-1793564,chr1,1793438,1793564,IMR90|chr1:224372297-224372406,chr1,224372297,224372406,1,222578859
IMR90|chr1:1797045-1797195,chr1,1797045,1797195,IMR90|chr1:1843065-1843117,chr1,1843065,1843117,1,46020
IMR90|chr1:1798258-1798346,chr1,1798258,1798346,IMR90|chr1:1311281-1311334,chr1,1311281,1311334,1,486977
IMR90|chr1:1798258-1798345,chr1,1798258,1798345,IMR90|chr1:1311281-1311334,chr1,1311281,1311334,1,486977
IMR90|chr1:1799670-1799755,chr1,1799670,1799755,IMR90|chr1:1311281-1311334,chr1,1311281,1311334,1,488389
IMR90|chr1:1800452-1800569,chr1,1800452,1800569,IMR90|chr1:1844308-1844341,chr1,1844308,1844341,1,43856
IMR90|chr1:1803682-1803762,chr1,1803682,1803762,IMR90|chr1:1709363-1709384,chr1,1709363,1709384,1,94319
IMR90|chr1:1805397-1805430,chr1,1805397,1805430,IMR90|chr1:1715650-1715774,chr1,1715650,1715774,1,89747
IMR90|chr1:2170690-2170840,chr1,2170690,2170840,IMR90|chr1:2323674-2323720,chr1,2323674,2323720,1,152984
IMR90|chr1:2170690-2170784,chr1,2170690,2170784,IMR90|chr1:2323674-2323720,chr1,2323674,2323720,1,152984
IMR90|chr1:2171814-2171845,chr1,2171814,2171845,IMR90|chr1:36788493-36788575,chr1,36788493,36788575,1,34616679
IMR90|chr1:2174026-2174099,chr1,2174026,2174099,IMR90|chr1:2322239-2322287,chr1,2322239,2322287,1,148213
IMR90|chr1:2174026-2174098,chr1,2174026,2174098,IMR90|chr1:2322239-2322287,chr1,2322239,2322287,1,148213
IMR90|chr1:2175041-2175150,chr1,2175041,2175150,IMR90|chr1:24974523-24974583,chr1,24974523,24974583,1,22799482
IMR90|chr1:2175041-2175097,chr1,2175041,2175097,IMR90|chr1:24974523-24974583,chr1,24974523,24974583,1,22799482
IMR90|chr1:2175063-2175150,chr1,2175063,2175150,IMR90|chr1:24974523-24974583,chr1,24974523,24974583,1,22799460
IMR90|chr1:2178405-2178482,chr1,2178405,2178482,IMR90|chr1:38455059-38455132,chr1,38455059,38455132,1,36276654
IMR90|chr1:2178406-2178487,chr1,2178406,2178487,IMR90|chr1:38455059-38455132,chr1,38455059,38455132,1,36276653
IMR90|chr1:2184086-2184107,chr1,2184086,2184107,IMR90|chr1:85932324-85932432,chr1,85932324,85932432,1,83748238
IMR90|chr1:2187165-2187233,chr1,2187165,2187233,IMR90|chr1:2325080-2325149,chr1,2325080,2325149,1,137915
IMR90|chr1:6925495-6925525,chr1,6925495,6925525,IMR90|chr1:8936517-8936568,chr1,8936517,8936568,1,2011022
IMR90|chr1:8457779-8457808,chr1,8457779,8457808,IMR90|chr1:8083827-8083927,chr1,8083827,8083927,1,373952
IMR90|chr1:8468698-8468745,chr1,8468698,8468745,IMR90|chr1:8084794-8084894,chr1,8084794,8084894,1,383904
IMR90|chr1:8468702-8468739,chr1,8468702,8468739,IMR90|chr1:8084836-8084896,chr1,8084836,8084896,1,383866
IMR90|chr1:8538513-8538551,chr1,8538513,8538551,IMR90|chr1:27324345-27324363,chr1,27324345,27324363,1,18785832
IMR90|chr1:8931685-8931764,chr1,8931685,8931764,IMR90|chr1:39736176-39736247,chr1,39736176,39736247,1,30804491
IMR90|chr1:8931688-8931764,chr1,8931688,8931764,IMR90|chr1:39736176-39736247,chr1,39736176,39736247,1,30804488
IMR90|chr1:8931705-8931764,chr1,8931705,8931764,IMR90|chr1:39736176-39736247,chr1,39736176,39736247,1,30804471
IMR90|chr1:9205307-9205377,chr1,9205307,9205377,IMR90|chr1:9194007-9194036,chr1,9194007,9194036,1,11300
IMR90|chr1:9205735-9205872,chr1,9205735,9205872,IMR90|chr1:9192620-9192731,chr1,9192620,9192731,1,13115
IMR90|chr1:9205830-9205869,chr1,9205830,9205869,IMR90|chr1:9192620-9192731,chr1,9192620,9192731,1,13210
IMR90|chr1:9206014-9206068,chr1,9206014,9206068,IMR90|chr1:9191845-9191901,chr1,9191845,9191901,1,14169
IMR90|chr1:9206014-9206067,chr1,9206014,9206067,IMR90|chr1:9191845-9191901,chr1,9191845,9191901,1,14169
IMR90|chr1:9206510-9206568,chr1,9206510,9206568,IMR90|chr1:9190714-9190814,chr1,9190714,9190814,1,15796
IMR90|chr1:9209035-9209138,chr1,9209035,9209138,IMR90|chr1:24972876-24972912,chr1,24972876,24972912,1,15763841
IMR90|chr1:9209051-9209140,chr1,9209051,9209140,IMR90|chr1:24972863-24972910,chr1,24972863,24972910,1,15763812
IMR90|chr1:9209071-9209143,chr1,9209071,9209143,IMR90|chr1:24972872-24972910,chr1,24972872,24972910,1,15763801
IMR90|chr1:9210443-9210534,chr1,9210443,9210534,IMR90|chr1:151139498-151139526,chr1,151139498,151139526,1,141929055
IMR90|chr1:9210463-9210535,chr1,9210463,9210535,IMR90|chr1:151139498-151139526,chr1,151139498,151139526,1,141929035
IMR90|chr1:9219080-9219209,chr1,9219080,9219209,IMR90|chr1:78245486-78245585,chr1,78245486,78245585,1,69026406
IMR90|chr1:9219080-9219208,chr1,9219080,9219208,IMR90|chr1:78245486-78245585,chr1,78245486,78245585,1,69026406
IMR90|chr1:9219158-9219209,chr1,9219158,9219209,IMR90|chr1:78245486-78245585,chr1,78245486,78245585,1,69026328
IMR90|chr1:9222336-9222407,chr1,9222336,9222407,IMR90|chr1:9193785-9193860,chr1,9193785,9193860,1,28551
IMR90|chr1:9240589-9240651,chr1,9240589,9240651,IMR90|chr1:29507193-29507231,chr1,29507193,29507231,1,20266604
IMR90|chr1:9248169-9248205,chr1,9248169,9248205,IMR90|chr1:9296989-9297086,chr1,9296989,9297086,1,48820
IMR90|chr1:9250142-9250192,chr1,9250142,9250192,IMR90|chr1:7834703-7834748,chr1,7834703,7834748,1,1415439
IMR90|chr1:9250143-9250192,chr1,9250143,9250192,IMR90|chr1:7834703-7834748,chr1,7834703,7834748,1,1415440
IMR90|chr1:9251834-9251895,chr1,9251834,9251895,IMR90|chr1:12037560-12037643,chr1,12037560,12037643,1,2785726
IMR90|chr1:9251834-9251890,chr1,9251834,9251890,IMR90|chr1:12037560-12037643,chr1,12037560,12037643,1,2785726
IMR90|chr1:9254982-9255123,chr1,9254982,9255123,IMR90|chr1:7832457-7832479,chr1,7832457,7832479,1,1422525
IMR90|chr1:9254982-9255110,chr1,9254982,9255110,IMR90|chr1:7832457-7832479,chr1,7832457,7832479,1,1422525
IMR90|chr1:9255495-9255643,chr1,9255495,9255643,IMR90|chr1:29506951-29506994,chr1,29506951,29506994,1,20251456
IMR90|chr1:9255571-9255659,chr1,9255571,9255659,IMR90|chr1:29506951-29506994,chr1,29506951,29506994,1,20251380
IMR90|chr1:9257428-9257490,chr1,9257428,9257490,IMR90|chr1:1820996-1821054,chr1,1820996,1821054,1,7436432
IMR90|chr1:9257428-9257489,chr1,9257428,9257489,IMR90|chr1:1820995-1821055,chr1,1820995,1821055,1,7436433
IMR90|chr1:9259375-9259440,chr1,9259375,9259440,IMR90|chr1:9296188-9296256,chr1,9296188,9296256,1,36813
IMR90|chr1:9259375-9259430,chr1,9259375,9259430,IMR90|chr1:9296188-9296256,chr1,9296188,9296256,1,36813
IMR90|chr1:9259375-9259428,chr1,9259375,9259428,IMR90|chr1:9296188-9296254,chr1,9296188,9296254,1,36813
IMR90|chr1:9758338-9758441,chr1,9758338,9758441,IMR90|chr1:8083490-8083537,chr1,8083490,8083537,1,1674848
IMR90|chr1:9758339-9758436,chr1,9758339,9758436,IMR90|chr1:8083490-8083537,chr1,8083490,8083537,1,1674849
IMR90|chr1:9763008-9763073,chr1,9763008,9763073,IMR90|chr1:78472831-78472901,chr1,78472831,78472901,1,68709823
IMR90|chr1:9763008-9763068,chr1,9763008,9763068,IMR90|chr1:78472831-78472901,chr1,78472831,78472901,1,68709823
IMR90|chr1:9944222-9944307,chr1,9944222,9944307,IMR90|chr1:156085784-156085817,chr1,156085784,156085817,1,146141562
IMR90|chr1:9944222-9944304,chr1,9944222,9944304,IMR90|chr1:156085784-156085817,chr1,156085784,156085817,1,146141562
IMR90|chr1:11213870-11213946,chr1,11213870,11213946,IMR90|chr1:36027532-36027582,chr1,36027532,36027582,1,24813662
IMR90|chr1:15744677-15744795,chr1,15744677,15744795,IMR90|chr1:112302487-112302617,chr1,112302487,112302617,1,96557810
IMR90|chr1:15744697-15744795,chr1,15744697,15744795,IMR90|chr1:112302467-112302595,chr1,112302467,112302595,1,96557770
IMR90|chr1:15744748-15744795,chr1,15744748,15744795,IMR90|chr1:112302467-112302595,chr1,112302467,112302595,1,96557719
IMR90|chr1:15744751-15744817,chr1,15744751,15744817,IMR90|chr1:112302480-112302618,chr1,112302480,112302618,1,96557729
IMR90|chr1:15744761-15744817,chr1,15744761,15744817,IMR90|chr1:112302467-112302595,chr1,112302467,112302595,1,96557706
IMR90|chr1:15744770-15744801,chr1,15744770,15744801,IMR90|chr1:112302470-112302618,chr1,112302470,112302618,1,96557700
IMR90|chr1:15744782-15744819,chr1,15744782,15744819,IMR90|chr1:112302465-112302595,chr1,112302465,112302595,1,96557683
IMR90|chr1:15748803-15748953,chr1,15748803,15748953,IMR90|chr1:19811544-19811577,chr1,19811544,19811577,1,4062741
IMR90|chr1:15748803-15748894,chr1,15748803,15748894,IMR90|chr1:19811544-19811577,chr1,19811544,19811577,1,4062741
IMR90|chr1:15748886-15749003,chr1,15748886,15749003,IMR90|chr1:19811544-19811577,chr1,19811544,19811577,1,4062658
IMR90|chr1:16285871-16285946,chr1,16285871,16285946,IMR90|chr1:1820471-1820522,chr1,1820471,1820522,1,14465400
IMR90|chr1:16285876-16285946,chr1,16285876,16285946,IMR90|chr1:1820471-1820522,chr1,1820471,1820522,1,14465405
IMR90|chr1:16492150-16492219,chr1,16492150,16492219,IMR90|chr1:16483819-16483907,chr1,16483819,16483907,1,8331
IMR90|chr1:16492150-16492212,chr1,16492150,16492212,IMR90|chr1:16483819-16483907,chr1,16483819,16483907,1,8331
IMR90|chr1:16498662-16498802,chr1,16498662,16498802,IMR90|chr1:16485516-16485545,chr1,16485516,16485545,1,13146
IMR90|chr1:16498662-16498769,chr1,16498662,16498769,IMR90|chr1:16485516-16485545,chr1,16485516,16485545,1,13146
IMR90|chr1:16587225-16587263,chr1,16587225,16587263,IMR90|chr1:16479875-16479973,chr1,16479875,16479973,1,107350
IMR90|chr1:16702158-16702213,chr1,16702158,16702213,IMR90|chr1:16302213-16302286,chr1,16302213,16302286,1,399945
IMR90|chr1:16708129-16708199,chr1,16708129,16708199,IMR90|chr1:12041831-12041911,chr1,12041831,12041911,1,4666298
IMR90|chr1:16708129-16708189,chr1,16708129,16708189,IMR90|chr1:12041821-12041911,chr1,12041821,12041911,1,4666308
IMR90|chr1:16840582-16840653,chr1,16840582,16840653,IMR90|chr1:8936920-8937010,chr1,8936920,8937010,1,7903662
IMR90|chr1:19262852-19262968,chr1,19262852,19262968,IMR90|chr1:12037941-12037960,chr1,12037941,12037960,1,7224911
IMR90|chr1:19262853-19262968,chr1,19262853,19262968,IMR90|chr1:12037941-12037960,chr1,12037941,12037960,1,7224912
IMR90|chr1:19530088-19530165,chr1,19530088,19530165,IMR90|chr1:8938147-8938208,chr1,8938147,8938208,1,10591941
IMR90|chr1:19719449-19719529,chr1,19719449,19719529,IMR90|chr1:19814850-19814881,chr1,19814850,19814881,1,95401
IMR90|chr1:19726373-19726467,chr1,19726373,19726467,IMR90|chr1:64240364-64240433,chr1,64240364,64240433,1,44513991
IMR90|chr1:19726389-19726467,chr1,19726389,19726467,IMR90|chr1:64240364-64240433,chr1,64240364,64240433,1,44513975
IMR90|chr1:19788719-19788869,chr1,19788719,19788869,IMR90|chr1:19813989-19814048,chr1,19813989,19814048,1,25270
IMR90|chr1:19788787-19788874,chr1,19788787,19788874,IMR90|chr1:19813989-19814048,chr1,19813989,19814048,1,25202
IMR90|chr1:21340936-21341075,chr1,21340936,21341075,IMR90|chr1:43422850-43422882,chr1,43422850,43422882,1,22081914
IMR90|chr1:21341002-21341062,chr1,21341002,21341062,IMR90|chr1:43422847-43422882,chr1,43422847,43422882,1,22081845
IMR90|chr1:21395440-21395492,chr1,21395440,21395492,IMR90|chr1:2118077-2118142,chr1,2118077,2118142,1,19277363
IMR90|chr1:21631387-21631436,chr1,21631387,21631436,IMR90|chr1:16570495-16570573,chr1,16570495,16570573,1,5060892
IMR90|chr1:21631388-21631436,chr1,21631388,21631436,IMR90|chr1:16570495-16570573,chr1,16570495,16570573,1,5060893
IMR90|chr1:21631389-21631436,chr1,21631389,21631436,IMR90|chr1:16570495-16570573,chr1,16570495,16570573,1,5060894
IMR90|chr1:22247086-22247159,chr1,22247086,22247159,IMR90|chr1:22382044-22382121,chr1,22382044,22382121,1,134958
IMR90|chr1:22247086-22247158,chr1,22247086,22247158,IMR90|chr1:22382044-22382121,chr1,22382044,22382121,1,134958
IMR90|chr1:23068358-23068476,chr1,23068358,23068476,IMR90|chr1:1711936-1711957,chr1,1711936,1711957,1,21356422
IMR90|chr1:23079306-23079428,chr1,23079306,23079428,IMR90|chr1:156089263-156089359,chr1,156089263,156089359,1,133009957
IMR90|chr1:23079306-23079360,chr1,23079306,23079360,IMR90|chr1:156089263-156089359,chr1,156089263,156089359,1,133009957
IMR90|chr1:23079306-23079341,chr1,23079306,23079341,IMR90|chr1:156089263-156089359,chr1,156089263,156089359,1,133009957
IMR90|chr1:23607562-23607624,chr1,23607562,23607624,IMR90|chr1:154958258-154958346,chr1,154958258,154958346,1,131350696
IMR90|chr1:23653169-23653268,chr1,23653169,23653268,IMR90|chr1:15481761-15481812,chr1,15481761,15481812,1,8171408
IMR90|chr1:23653173-23653269,chr1,23653173,23653269,IMR90|chr1:15481761-15481812,chr1,15481761,15481812,1,8171412
IMR90|chr1:23653173-23653268,chr1,23653173,23653268,IMR90|chr1:15481761-15481812,chr1,15481761,15481812,1,8171412
IMR90|chr1:24049697-24049777,chr1,24049697,24049777,IMR90|chr1:24066936-24067026,chr1,24066936,24067026,1,17239
IMR90|chr1:24049916-24049981,chr1,24049916,24049981,IMR90|chr1:24066677-24066725,chr1,24066677,24066725,1,16761
IMR90|chr1:24050655-24050710,chr1,24050655,24050710,IMR90|chr1:24065100-24065195,chr1,24065100,24065195,1,14445
IMR90|chr1:24051042-24051097,chr1,24051042,24051097,IMR90|chr1:24071154-24071201,chr1,24071154,24071201,1,20112
IMR90|chr1:24051042-24051063,chr1,24051042,24051063,IMR90|chr1:24071154-24071201,chr1,24071154,24071201,1,20112
IMR90|chr1:24051699-24051738,chr1,24051699,24051738,IMR90|chr1:24068069-24068219,chr1,24068069,24068219,1,16370
IMR90|chr1:24051886-24051991,chr1,24051886,24051991,IMR90|chr1:24067913-24068063,chr1,24067913,24068063,1,16027
IMR90|chr1:24055087-24055142,chr1,24055087,24055142,IMR90|chr1:24066174-24066269,chr1,24066174,24066269,1,11087
IMR90|chr1:24055669-24055722,chr1,24055669,24055722,IMR90|chr1:24067821-24067952,chr1,24067821,24067952,1,12152
IMR90|chr1:24055999-24056102,chr1,24055999,24056102,IMR90|chr1:24065933-24065972,chr1,24065933,24065972,1,9934
IMR90|chr1:24055999-24056053,chr1,24055999,24056053,IMR90|chr1:24065933-24065972,chr1,24065933,24065972,1,9934
IMR90|chr1:24057156-24057203,chr1,24057156,24057203,IMR90|chr1:24067634-24067735,chr1,24067634,24067735,1,10478
IMR90|chr1:24057235-24057379,chr1,24057235,24057379,IMR90|chr1:24066527-24066564,chr1,24066527,24066564,1,9292
IMR90|chr1:24057235-24057345,chr1,24057235,24057345,IMR90|chr1:24066527-24066564,chr1,24066527,24066564,1,9292
IMR90|chr1:24058562-24058637,chr1,24058562,24058637,IMR90|chr1:24064903-24065053,chr1,24064903,24065053,1,6341
IMR90|chr1:25033998-25034130,chr1,25033998,25034130,IMR90|chr1:45310665-45310683,chr1,45310665,45310683,1,20276667
IMR90|chr1:25033998-25034129,chr1,25033998,25034129,IMR90|chr1:45310665-45310683,chr1,45310665,45310683,1,20276667
IMR90|chr1:25034000-25034128,chr1,25034000,25034128,IMR90|chr1:45310665-45310683,chr1,45310665,45310683,1,20276665
IMR90|chr1:25034069-25034126,chr1,25034069,25034126,IMR90|chr1:45310665-45310683,chr1,45310665,45310683,1,20276596
IMR90|chr1:25060300-25060371,chr1,25060300,25060371,IMR90|chr1:25074776-25074827,chr1,25074776,25074827,1,14476
IMR90|chr1:25060300-25060367,chr1,25060300,25060367,IMR90|chr1:25074776-25074827,chr1,25074776,25074827,1,14476
IMR90|chr1:25061517-25061600,chr1,25061517,25061600,IMR90|chr1:25068789-25068844,chr1,25068789,25068844,1,7272
IMR90|chr1:25080429-25080448,chr1,25080429,25080448,IMR90|chr1:27321695-27321733,chr1,27321695,27321733,1,2241266
IMR90|chr1:25081081-25081160,chr1,25081081,25081160,IMR90|chr1:24968881-24968952,chr1,24968881,24968952,1,112200
IMR90|chr1:25085730-25085765,chr1,25085730,25085765,IMR90|chr1:27323713-27323806,chr1,27323713,27323806,1,2237983
IMR90|chr1:25085731-25085765,chr1,25085731,25085765,IMR90|chr1:27323713-27323806,chr1,27323713,27323806,1,2237982
IMR90|chr1:25095303-25095386,chr1,25095303,25095386,IMR90|chr1:27323912-27324052,chr1,27323912,27324052,1,2228609
IMR90|chr1:25098525-25098614,chr1,25098525,25098614,IMR90|chr1:32480973-32481056,chr1,32480973,32481056,1,7382448
IMR90|chr1:25098525-25098585,chr1,25098525,25098585,IMR90|chr1:32480973-32481055,chr1,32480973,32481055,1,7382448
IMR90|chr1:25098526-25098571,chr1,25098526,25098571,IMR90|chr1:32480973-32481056,chr1,32480973,32481056,1,7382447
IMR90|chr1:25101800-25101836,chr1,25101800,25101836,IMR90|chr1:24972816-24972942,chr1,24972816,24972942,1,128984
IMR90|chr1:25101800-25101824,chr1,25101800,25101824,IMR90|chr1:24972816-24972942,chr1,24972816,24972942,1,128984
IMR90|chr1:25101800-25101822,chr1,25101800,25101822,IMR90|chr1:24972816-24972942,chr1,24972816,24972942,1,128984
IMR90|chr1:25125598-25125748,chr1,25125598,25125748,IMR90|chr1:24970815-24970843,chr1,24970815,24970843,1,154783
IMR90|chr1:25128340-25128422,chr1,25128340,25128422,IMR90|chr1:223901130-223901223,chr1,223901130,223901223,1,198772790
IMR90|chr1:25128373-25128422,chr1,25128373,25128422,IMR90|chr1:223901130-223901223,chr1,223901130,223901223,1,198772757
IMR90|chr1:25566023-25566070,chr1,25566023,25566070,IMR90|chr1:25563127-25563169,chr1,25563127,25563169,1,2896
IMR90|chr1:25566462-25566604,chr1,25566462,25566604,IMR90|chr1:25561485-25561513,chr1,25561485,25561513,1,4977
IMR90|chr1:25566468-25566590,chr1,25566468,25566590,IMR90|chr1:25561485-25561513,chr1,25561485,25561513,1,4983
IMR90|chr1:27027899-27027919,chr1,27027899,27027919,IMR90|chr1:42800126-42800256,chr1,42800126,42800256,1,15772227
IMR90|chr1:27027900-27027925,chr1,27027900,27027925,IMR90|chr1:42800126-42800256,chr1,42800126,42800256,1,15772226
IMR90|chr1:27041925-27042009,chr1,27041925,27042009,IMR90|chr1:42799717-42799734,chr1,42799717,42799734,1,15757792
IMR90|chr1:27042652-27042707,chr1,27042652,27042707,IMR90|chr1:203832414-203832483,chr1,203832414,203832483,1,176789762
IMR90|chr1:27042792-27042868,chr1,27042792,27042868,IMR90|chr1:85724919-85724954,chr1,85724919,85724954,1,58682127
IMR90|chr1:27042792-27042866,chr1,27042792,27042866,IMR90|chr1:85724919-85724954,chr1,85724919,85724954,1,58682127
IMR90|chr1:27048820-27048873,chr1,27048820,27048873,IMR90|chr1:27323706-27323778,chr1,27323706,27323778,1,274886
IMR90|chr1:27048984-27049037,chr1,27048984,27049037,IMR90|chr1:27323540-27323619,chr1,27323540,27323619,1,274556
IMR90|chr1:27063003-27063116,chr1,27063003,27063116,IMR90|chr1:156714265-156714302,chr1,156714265,156714302,1,129651262
IMR90|chr1:27327400-27327498,chr1,27327400,27327498,IMR90|chr1:27323337-27323389,chr1,27323337,27323389,1,4063
IMR90|chr1:27327423-27327501,chr1,27327423,27327501,IMR90|chr1:27324285-27324337,chr1,27324285,27324337,1,3138
IMR90|chr1:27327423-27327500,chr1,27327423,27327500,IMR90|chr1:27324285-27324337,chr1,27324285,27324337,1,3138
IMR90|chr1:27327441-27327479,chr1,27327441,27327479,IMR90|chr1:27321347-27321392,chr1,27321347,27321392,1,6094
IMR90|chr1:27327572-27327617,chr1,27327572,27327617,IMR90|chr1:27322903-27322930,chr1,27322903,27322930,1,4669
IMR90|chr1:27327606-27327713,chr1,27327606,27327713,IMR90|chr1:27322312-27322394,chr1,27322312,27322394,1,5294
IMR90|chr1:27327606-27327674,chr1,27327606,27327674,IMR90|chr1:27322312-27322394,chr1,27322312,27322394,1,5294
IMR90|chr1:27327609-27327724,chr1,27327609,27327724,IMR90|chr1:27322196-27322275,chr1,27322196,27322275,1,5413
IMR90|chr1:27327616-27327706,chr1,27327616,27327706,IMR90|chr1:27324368-27324398,chr1,27324368,27324398,1,3248
IMR90|chr1:27327693-27327785,chr1,27327693,27327785,IMR90|chr1:27322971-27322990,chr1,27322971,27322990,1,4722
IMR90|chr1:27327701-27327745,chr1,27327701,27327745,IMR90|chr1:27322379-27322431,chr1,27322379,27322431,1,5322
IMR90|chr1:27327702-27327745,chr1,27327702,27327745,IMR90|chr1:27321519-27321553,chr1,27321519,27321553,1,6183
IMR90|chr1:27327731-27327848,chr1,27327731,27327848,IMR90|chr1:27323942-27323975,chr1,27323942,27323975,1,3789
IMR90|chr1:27327731-27327819,chr1,27327731,27327819,IMR90|chr1:27323936-27323975,chr1,27323936,27323975,1,3795
IMR90|chr1:27327961-27328007,chr1,27327961,27328007,IMR90|chr1:27323730-27323795,chr1,27323730,27323795,1,4231
IMR90|chr1:27327966-27328029,chr1,27327966,27328029,IMR90|chr1:27322713-27322775,chr1,27322713,27322775,1,5253
IMR90|chr1:27327997-27328035,chr1,27327997,27328035,IMR90|chr1:27322133-27322242,chr1,27322133,27322242,1,5864
IMR90|chr1:27328030-27328098,chr1,27328030,27328098,IMR90|chr1:27322348-27322427,chr1,27322348,27322427,1,5682
IMR90|chr1:27328036-27328182,chr1,27328036,27328182,IMR90|chr1:27322348-27322427,chr1,27322348,27322427,1,5688
IMR90|chr1:27328037-27328100,chr1,27328037,27328100,IMR90|chr1:27323379-27323427,chr1,27323379,27323427,1,4658
IMR90|chr1:27328054-27328192,chr1,27328054,27328192,IMR90|chr1:27323962-27324002,chr1,27323962,27324002,1,4092
IMR90|chr1:27328076-27328178,chr1,27328076,27328178,IMR90|chr1:27322294-27322382,chr1,27322294,27322382,1,5782
IMR90|chr1:27328076-27328138,chr1,27328076,27328138,IMR90|chr1:27322294-27322382,chr1,27322294,27322382,1,5782
IMR90|chr1:27328126-27328196,chr1,27328126,27328196,IMR90|chr1:27321204-27321224,chr1,27321204,27321224,1,6922
IMR90|chr1:27328126-27328193,chr1,27328126,27328193,IMR90|chr1:27321204-27321224,chr1,27321204,27321224,1,6922
IMR90|chr1:27328130-27328240,chr1,27328130,27328240,IMR90|chr1:27323962-27324002,chr1,27323962,27324002,1,4168
IMR90|chr1:27328157-27328198,chr1,27328157,27328198,IMR90|chr1:27321825-27321925,chr1,27321825,27321925,1,6332
IMR90|chr1:27328157-27328196,chr1,27328157,27328196,IMR90|chr1:27321825-27321925,chr1,27321825,27321925,1,6332
IMR90|chr1:27328250-27328309,chr1,27328250,27328309,IMR90|chr1:27323235-27323299,chr1,27323235,27323299,1,5015
IMR90|chr1:27328250-27328308,chr1,27328250,27328308,IMR90|chr1:27323235-27323322,chr1,27323235,27323322,1,5015
IMR90|chr1:27328259-27328344,chr1,27328259,27328344,IMR90|chr1:27321289-27321398,chr1,27321289,27321398,1,6970
IMR90|chr1:27328259-27328297,chr1,27328259,27328297,IMR90|chr1:27321289-27321398,chr1,27321289,27321398,1,6970
IMR90|chr1:27328260-27328309,chr1,27328260,27328309,IMR90|chr1:27323235-27323321,chr1,27323235,27323321,1,5025
IMR90|chr1:27328266-27328369,chr1,27328266,27328369,IMR90|chr1:27324051-27324080,chr1,27324051,27324080,1,4215
IMR90|chr1:27328357-27328379,chr1,27328357,27328379,IMR90|chr1:27322687-27322775,chr1,27322687,27322775,1,5670
IMR90|chr1:27328411-27328447,chr1,27328411,27328447,IMR90|chr1:27323768-27323819,chr1,27323768,27323819,1,4643
IMR90|chr1:27328479-27328543,chr1,27328479,27328543,IMR90|chr1:27321501-27321538,chr1,27321501,27321538,1,6978
IMR90|chr1:27328479-27328540,chr1,27328479,27328540,IMR90|chr1:27321501-27321538,chr1,27321501,27321538,1,6978
IMR90|chr1:27328528-27328551,chr1,27328528,27328551,IMR90|chr1:27321973-27322065,chr1,27321973,27322065,1,6555
IMR90|chr1:27328585-27328691,chr1,27328585,27328691,IMR90|chr1:27322689-27322718,chr1,27322689,27322718,1,5896
IMR90|chr1:27328654-27328700,chr1,27328654,27328700,IMR90|chr1:27323746-27323807,chr1,27323746,27323807,1,4908
IMR90|chr1:27328824-27328859,chr1,27328824,27328859,IMR90|chr1:27321217-27321243,chr1,27321217,27321243,1,7607
IMR90|chr1:27328843-27328912,chr1,27328843,27328912,IMR90|chr1:27323394-27323490,chr1,27323394,27323490,1,5449
IMR90|chr1:27328856-27328910,chr1,27328856,27328910,IMR90|chr1:27323394-27323490,chr1,27323394,27323490,1,5462
IMR90|chr1:27329097-27329169,chr1,27329097,27329169,IMR90|chr1:27322227-27322305,chr1,27322227,27322305,1,6870
IMR90|chr1:27329163-27329227,chr1,27329163,27329227,IMR90|chr1:27323539-27323633,chr1,27323539,27323633,1,5624
IMR90|chr1:27329192-27329243,chr1,27329192,27329243,IMR90|chr1:27322133-27322232,chr1,27322133,27322232,1,7059
IMR90|chr1:27329195-27329243,chr1,27329195,27329243,IMR90|chr1:27322133-27322232,chr1,27322133,27322232,1,7062
IMR90|chr1:27329232-27329257,chr1,27329232,27329257,IMR90|chr1:27322150-27322242,chr1,27322150,27322242,1,7082
IMR90|chr1:27329398-27329425,chr1,27329398,27329425,IMR90|chr1:27322159-27322279,chr1,27322159,27322279,1,7239
IMR90|chr1:27329401-27329459,chr1,27329401,27329459,IMR90|chr1:27322431-27322483,chr1,27322431,27322483,1,6970
IMR90|chr1:27329568-27329666,chr1,27329568,27329666,IMR90|chr1:27321344-27321368,chr1,27321344,27321368,1,8224
IMR90|chr1:27329569-27329666,chr1,27329569,27329666,IMR90|chr1:27321344-27321368,chr1,27321344,27321368,1,8225
IMR90|chr1:27329767-27329818,chr1,27329767,27329818,IMR90|chr1:27323746-27323807,chr1,27323746,27323807,1,6021
IMR90|chr1:27329806-27329822,chr1,27329806,27329822,IMR90|chr1:27321387-27321417,chr1,27321387,27321417,1,8419
IMR90|chr1:27329848-27329943,chr1,27329848,27329943,IMR90|chr1:27323761-27323794,chr1,27323761,27323794,1,6087
IMR90|chr1:27329849-27329946,chr1,27329849,27329946,IMR90|chr1:27323757-27323789,chr1,27323757,27323789,1,6092
IMR90|chr1:27329904-27329957,chr1,27329904,27329957,IMR90|chr1:27323706-27323778,chr1,27323706,27323778,1,6198
IMR90|chr1:27330252-27330386,chr1,27330252,27330386,IMR90|chr1:27323233-27323269,chr1,27323233,27323269,1,7019
IMR90|chr1:27330272-27330386,chr1,27330272,27330386,IMR90|chr1:27323233-27323269,chr1,27323233,27323269,1,7039
IMR90|chr1:27330876-27331026,chr1,27330876,27331026,IMR90|chr1:27323900-27323926,chr1,27323900,27323926,1,6976
IMR90|chr1:27330931-27330964,chr1,27330931,27330964,IMR90|chr1:27321788-27321862,chr1,27321788,27321862,1,9143
IMR90|chr1:27330931-27330963,chr1,27330931,27330963,IMR90|chr1:27321788-27321862,chr1,27321788,27321862,1,9143
IMR90|chr1:27330960-27331084,chr1,27330960,27331084,IMR90|chr1:27323900-27323926,chr1,27323900,27323926,1,7060
IMR90|chr1:27331301-27331359,chr1,27331301,27331359,IMR90|chr1:27322728-27322761,chr1,27322728,27322761,1,8573
IMR90|chr1:27331301-27331358,chr1,27331301,27331358,IMR90|chr1:27322728-27322761,chr1,27322728,27322761,1,8573
IMR90|chr1:27430977-27431004,chr1,27430977,27431004,IMR90|chr1:27322472-27322540,chr1,27322472,27322540,1,108505
IMR90|chr1:27443060-27443078,chr1,27443060,27443078,IMR90|chr1:27323908-27324058,chr1,27323908,27324058,1,119152
IMR90|chr1:27444564-27444678,chr1,27444564,27444678,IMR90|chr1:212965674-212965691,chr1,212965674,212965691,1,185521110
IMR90|chr1:27469946-27470031,chr1,27469946,27470031,IMR90|chr1:27930330-27930392,chr1,27930330,27930392,1,460384
IMR90|chr1:27469946-27470030,chr1,27469946,27470030,IMR90|chr1:27930330-27930392,chr1,27930330,27930392,1,460384
IMR90|chr1:27758074-27758163,chr1,27758074,27758163,IMR90|chr1:10005637-10005739,chr1,10005637,10005739,1,17752437
IMR90|chr1:27758074-27758122,chr1,27758074,27758122,IMR90|chr1:10005637-10005739,chr1,10005637,10005739,1,17752437
IMR90|chr1:27869324-27869371,chr1,27869324,27869371,IMR90|chr1:27324174-27324210,chr1,27324174,27324210,1,545150
IMR90|chr1:27890286-27890353,chr1,27890286,27890353,IMR90|chr1:27323236-27323307,chr1,27323236,27323307,1,567050
IMR90|chr1:27894811-27894855,chr1,27894811,27894855,IMR90|chr1:27321407-27321473,chr1,27321407,27321473,1,573404
IMR90|chr1:28144787-28144903,chr1,28144787,28144903,IMR90|chr1:40508198-40508263,chr1,40508198,40508263,1,12363411
IMR90|chr1:28144818-28144903,chr1,28144818,28144903,IMR90|chr1:40508198-40508263,chr1,40508198,40508263,1,12363380
IMR90|chr1:28355427-28355543,chr1,28355427,28355543,IMR90|chr1:173986494-173986535,chr1,173986494,173986535,1,145631067
IMR90|chr1:28355436-28355545,chr1,28355436,28355545,IMR90|chr1:173986494-173986535,chr1,173986494,173986535,1,145631058
IMR90|chr1:28355508-28355545,chr1,28355508,28355545,IMR90|chr1:173986494-173986535,chr1,173986494,173986535,1,145630986
IMR90|chr1:28396969-28397090,chr1,28396969,28397090,IMR90|chr1:28558788-28558899,chr1,28558788,28558899,1,161819
IMR90|chr1:28397051-28397090,chr1,28397051,28397090,IMR90|chr1:28558788-28558899,chr1,28558788,28558899,1,161737
IMR90|chr1:28906324-28906405,chr1,28906324,28906405,IMR90|chr1:173836015-173836065,chr1,173836015,173836065,1,144929691
IMR90|chr1:28906326-28906406,chr1,28906326,28906406,IMR90|chr1:173836013-173836060,chr1,173836013,173836060,1,144929687
IMR90|chr1:28906326-28906405,chr1,28906326,28906405,IMR90|chr1:173836013-173836060,chr1,173836013,173836060,1,144929687
IMR90|chr1:28906329-28906405,chr1,28906329,28906405,IMR90|chr1:173836015-173836065,chr1,173836015,173836065,1,144929686
IMR90|chr1:31359908-31359937,chr1,31359908,31359937,IMR90|chr1:1205326-1205380,chr1,1205326,1205380,1,30154582
IMR90|chr1:31402212-31402256,chr1,31402212,31402256,IMR90|chr1:861899-862049,chr1,861899,862049,1,30540313
IMR90|chr1:31519760-31519821,chr1,31519760,31519821,IMR90|chr1:40941437-40941526,chr1,40941437,40941526,1,9421677
IMR90|chr1:31519762-31519840,chr1,31519762,31519840,IMR90|chr1:40941437-40941526,chr1,40941437,40941526,1,9421675
IMR90|chr1:32528127-32528175,chr1,32528127,32528175,IMR90|chr1:202112228-202112312,chr1,202112228,202112312,1,169584101
IMR90|chr1:32587618-32587720,chr1,32587618,32587720,IMR90|chr1:22384154-22384174,chr1,22384154,22384174,1,10203464
IMR90|chr1:32588680-32588723,chr1,32588680,32588723,IMR90|chr1:32401156-32401230,chr1,32401156,32401230,1,187524
IMR90|chr1:32588682-32588723,chr1,32588682,32588723,IMR90|chr1:32401156-32401230,chr1,32401156,32401230,1,187526
IMR90|chr1:32597333-32597412,chr1,32597333,32597412,IMR90|chr1:32477894-32477958,chr1,32477894,32477958,1,119439
IMR90|chr1:32599013-32599097,chr1,32599013,32599097,IMR90|chr1:32480002-32480064,chr1,32480002,32480064,1,119011
IMR90|chr1:32599017-32599099,chr1,32599017,32599099,IMR90|chr1:32480002-32480064,chr1,32480002,32480064,1,119015
IMR90|chr1:32601203-32601234,chr1,32601203,32601234,IMR90|chr1:27323944-27324067,chr1,27323944,27324067,1,5277259
IMR90|chr1:32602962-32603014,chr1,32602962,32603014,IMR90|chr1:32481719-32481792,chr1,32481719,32481792,1,121243
IMR90|chr1:32602962-32603013,chr1,32602962,32603013,IMR90|chr1:32481719-32481792,chr1,32481719,32481792,1,121243
IMR90|chr1:33797404-33797447,chr1,33797404,33797447,IMR90|chr1:32167805-32167863,chr1,32167805,32167863,1,1629599
IMR90|chr1:33800219-33800325,chr1,33800219,33800325,IMR90|chr1:33167689-33167732,chr1,33167689,33167732,1,632530
IMR90|chr1:33800280-33800328,chr1,33800280,33800328,IMR90|chr1:33167634-33167732,chr1,33167634,33167732,1,632646
IMR90|chr1:33801781-33801898,chr1,33801781,33801898,IMR90|chr1:155881927-155881974,chr1,155881927,155881974,1,122080146
IMR90|chr1:33801798-33801898,chr1,33801798,33801898,IMR90|chr1:155881927-155881974,chr1,155881927,155881974,1,122080129
IMR90|chr1:33807862-33807940,chr1,33807862,33807940,IMR90|chr1:32174218-32174239,chr1,32174218,32174239,1,1633644
IMR90|chr1:33830221-33830320,chr1,33830221,33830320,IMR90|chr1:33938332-33938394,chr1,33938332,33938394,1,108111
IMR90|chr1:33830221-33830306,chr1,33830221,33830306,IMR90|chr1:33938332-33938365,chr1,33938332,33938365,1,108111
IMR90|chr1:33849577-33849664,chr1,33849577,33849664,IMR90|chr1:182993725-182993776,chr1,182993725,182993776,1,149144148
IMR90|chr1:33849622-33849665,chr1,33849622,33849665,IMR90|chr1:182993725-182993776,chr1,182993725,182993776,1,149144103
IMR90|chr1:33884467-33884543,chr1,33884467,33884543,IMR90|chr1:76253362-76253386,chr1,76253362,76253386,1,42368895
IMR90|chr1:33886406-33886447,chr1,33886406,33886447,IMR90|chr1:76254147-76254208,chr1,76254147,76254208,1,42367741
IMR90|chr1:36834438-36834473,chr1,36834438,36834473,IMR90|chr1:2323403-2323527,chr1,2323403,2323527,1,34511035
IMR90|chr1:36834447-36834473,chr1,36834447,36834473,IMR90|chr1:2323403-2323527,chr1,2323403,2323527,1,34511044
IMR90|chr1:36837636-36837686,chr1,36837636,36837686,IMR90|chr1:8584810-8584907,chr1,8584810,8584907,1,28252826
IMR90|chr1:38462327-38462362,chr1,38462327,38462362,IMR90|chr1:38459894-38459983,chr1,38459894,38459983,1,2433
IMR90|chr1:38463898-38463966,chr1,38463898,38463966,IMR90|chr1:38461304-38461342,chr1,38461304,38461342,1,2594
IMR90|chr1:38463908-38463964,chr1,38463908,38463964,IMR90|chr1:38461304-38461342,chr1,38461304,38461342,1,2604
IMR90|chr1:38486693-38486765,chr1,38486693,38486765,IMR90|chr1:38257546-38257602,chr1,38257546,38257602,1,229147
IMR90|chr1:39579390-39579407,chr1,39579390,39579407,IMR90|chr1:33812543-33812603,chr1,33812543,33812603,1,5766847
IMR90|chr1:39584641-39584785,chr1,39584641,39584785,IMR90|chr1:52826922-52827001,chr1,52826922,52827001,1,13242281
IMR90|chr1:39589276-39589375,chr1,39589276,39589375,IMR90|chr1:21111658-21111706,chr1,21111658,21111706,1,18477618
IMR90|chr1:39595625-39595654,chr1,39595625,39595654,IMR90|chr1:27155691-27155814,chr1,27155691,27155814,1,12439934
IMR90|chr1:39595628-39595655,chr1,39595628,39595655,IMR90|chr1:27155691-27155814,chr1,27155691,27155814,1,12439937
IMR90|chr1:39598410-39598448,chr1,39598410,39598448,IMR90|chr1:52832302-52832380,chr1,52832302,52832380,1,13233892
IMR90|chr1:39598413-39598448,chr1,39598413,39598448,IMR90|chr1:52832302-52832380,chr1,52832302,52832380,1,13233889
IMR90|chr1:39599959-39600060,chr1,39599959,39600060,IMR90|chr1:244618197-244618244,chr1,244618197,244618244,1,205018238
IMR90|chr1:39599990-39600060,chr1,39599990,39600060,IMR90|chr1:244618197-244618256,chr1,244618197,244618256,1,205018207
IMR90|chr1:39605644-39605734,chr1,39605644,39605734,IMR90|chr1:31851907-31851960,chr1,31851907,31851960,1,7753737
IMR90|chr1:39612366-39612409,chr1,39612366,39612409,IMR90|chr1:33813881-33813977,chr1,33813881,33813977,1,5798485
IMR90|chr1:39624094-39624154,chr1,39624094,39624154,IMR90|chr1:33818414-33818478,chr1,33818414,33818478,1,5805680
IMR90|chr1:39641517-39641632,chr1,39641517,39641632,IMR90|chr1:27150392-27150428,chr1,27150392,27150428,1,12491125
IMR90|chr1:39658690-39658762,chr1,39658690,39658762,IMR90|chr1:21115769-21115891,chr1,21115769,21115891,1,18542921
IMR90|chr1:39677919-39678013,chr1,39677919,39678013,IMR90|chr1:33812388-33812496,chr1,33812388,33812496,1,5865531
IMR90|chr1:39677971-39678013,chr1,39677971,39678013,IMR90|chr1:33812388-33812496,chr1,33812388,33812496,1,5865583
IMR90|chr1:39680689-39680727,chr1,39680689,39680727,IMR90|chr1:33814741-33814826,chr1,33814741,33814826,1,5865948
IMR90|chr1:39860202-39860300,chr1,39860202,39860300,IMR90|chr1:40045466-40045524,chr1,40045466,40045524,1,185264
IMR90|chr1:39860212-39860304,chr1,39860212,39860304,IMR90|chr1:40045466-40045524,chr1,40045466,40045524,1,185254
IMR90|chr1:40315056-40315095,chr1,40315056,40315095,IMR90|chr1:27323884-27323955,chr1,27323884,27323955,1,12991172
IMR90|chr1:40315202-40315234,chr1,40315202,40315234,IMR90|chr1:27324398-27324525,chr1,27324398,27324525,1,12990804
IMR90|chr1:40315202-40315224,chr1,40315202,40315224,IMR90|chr1:27324398-27324525,chr1,27324398,27324525,1,12990804
IMR90|chr1:40315946-40315964,chr1,40315946,40315964,IMR90|chr1:27323333-27323435,chr1,27323333,27323435,1,12992613
IMR90|chr1:42092714-42092836,chr1,42092714,42092836,IMR90|chr1:150848144-150848172,chr1,150848144,150848172,1,108755430
IMR90|chr1:42243497-42243541,chr1,42243497,42243541,IMR90|chr1:41155932-41156015,chr1,41155932,41156015,1,1087565
IMR90|chr1:42728861-42728942,chr1,42728861,42728942,IMR90|chr1:43149374-43149461,chr1,43149374,43149461,1,420513
IMR90|chr1:42728881-42728944,chr1,42728881,42728944,IMR90|chr1:43149374-43149461,chr1,43149374,43149461,1,420493
IMR90|chr1:43838857-43838917,chr1,43838857,43838917,IMR90|chr1:43837390-43837431,chr1,43837390,43837431,1,1467
IMR90|chr1:43839595-43839685,chr1,43839595,43839685,IMR90|chr1:43837387-43837446,chr1,43837387,43837446,1,2208
IMR90|chr1:43839635-43839718,chr1,43839635,43839718,IMR90|chr1:43837259-43837327,chr1,43837259,43837327,1,2376
IMR90|chr1:43839635-43839713,chr1,43839635,43839713,IMR90|chr1:43837259-43837327,chr1,43837259,43837327,1,2376
IMR90|chr1:43839640-43839701,chr1,43839640,43839701,IMR90|chr1:43837267-43837323,chr1,43837267,43837323,1,2373
IMR90|chr1:43839654-43839760,chr1,43839654,43839760,IMR90|chr1:43837242-43837321,chr1,43837242,43837321,1,2412
IMR90|chr1:43839655-43839778,chr1,43839655,43839778,IMR90|chr1:43837293-43837329,chr1,43837293,43837329,1,2362
IMR90|chr1:43839655-43839769,chr1,43839655,43839769,IMR90|chr1:43837293-43837329,chr1,43837293,43837329,1,2362
IMR90|chr1:43839655-43839747,chr1,43839655,43839747,IMR90|chr1:43837162-43837306,chr1,43837162,43837306,1,2493
IMR90|chr1:44262112-44262259,chr1,44262112,44262259,IMR90|chr1:44396896-44396919,chr1,44396896,44396919,1,134784
IMR90|chr1:44262112-44262257,chr1,44262112,44262257,IMR90|chr1:44396896-44396919,chr1,44396896,44396919,1,134784
IMR90|chr1:44292695-44292805,chr1,44292695,44292805,IMR90|chr1:29064950-29064979,chr1,29064950,29064979,1,15227745
IMR90|chr1:44292696-44292805,chr1,44292696,44292805,IMR90|chr1:29064950-29064979,chr1,29064950,29064979,1,15227746
IMR90|chr1:46137269-46137334,chr1,46137269,46137334,IMR90|chr1:151225291-151225372,chr1,151225291,151225372,1,105088022
IMR90|chr1:46137302-46137452,chr1,46137302,46137452,IMR90|chr1:151225291-151225372,chr1,151225291,151225372,1,105087989
IMR90|chr1:46140719-46140750,chr1,46140719,46140750,IMR90|chr1:91360247-91360295,chr1,91360247,91360295,1,45219528
IMR90|chr1:46355381-46355511,chr1,46355381,46355511,IMR90|chr1:104068950-104068979,chr1,104068950,104068979,1,57713569
IMR90|chr1:46355381-46355456,chr1,46355381,46355456,IMR90|chr1:104068950-104068979,chr1,104068950,104068979,1,57713569
IMR90|chr1:46355382-46355511,chr1,46355382,46355511,IMR90|chr1:104068950-104068980,chr1,104068950,104068980,1,57713568
IMR90|chr1:47875670-47875688,chr1,47875670,47875688,IMR90|chr1:225965764-225965858,chr1,225965764,225965858,1,178090094
IMR90|chr1:52429781-52429835,chr1,52429781,52429835,IMR90|chr1:78471894-78471990,chr1,78471894,78471990,1,26042113
IMR90|chr1:52429782-52429873,chr1,52429782,52429873,IMR90|chr1:78471894-78471990,chr1,78471894,78471990,1,26042112
IMR90|chr1:52432923-52432972,chr1,52432923,52432972,IMR90|chr1:1820133-1820213,chr1,1820133,1820213,1,50612790
IMR90|chr1:52432924-52432972,chr1,52432924,52432972,IMR90|chr1:1820133-1820213,chr1,1820133,1820213,1,50612791
IMR90|chr1:54118799-54118831,chr1,54118799,54118831,IMR90|chr1:54203566-54203716,chr1,54203566,54203716,1,84767
IMR90|chr1:54120252-54120335,chr1,54120252,54120335,IMR90|chr1:54201826-54201925,chr1,54201826,54201925,1,81574
IMR90|chr1:54120284-54120335,chr1,54120284,54120335,IMR90|chr1:54201826-54201925,chr1,54201826,54201925,1,81542
IMR90|chr1:54121643-54121749,chr1,54121643,54121749,IMR90|chr1:54200818-54200846,chr1,54200818,54200846,1,79175
IMR90|chr1:54121644-54121749,chr1,54121644,54121749,IMR90|chr1:54200818-54200846,chr1,54200818,54200846,1,79174
IMR90|chr1:54151169-54151279,chr1,54151169,54151279,IMR90|chr1:54201565-54201613,chr1,54201565,54201613,1,50396
IMR90|chr1:54151177-54151279,chr1,54151177,54151279,IMR90|chr1:54201565-54201613,chr1,54201565,54201613,1,50388
IMR90|chr1:54151766-54151886,chr1,54151766,54151886,IMR90|chr1:54202144-54202180,chr1,54202144,54202180,1,50378
IMR90|chr1:54151772-54151886,chr1,54151772,54151886,IMR90|chr1:54202144-54202180,chr1,54202144,54202180,1,50372
IMR90|chr1:54152454-54152513,chr1,54152454,54152513,IMR90|chr1:54204471-54204525,chr1,54204471,54204525,1,52017
IMR90|chr1:54206217-54206311,chr1,54206217,54206311,IMR90|chr1:54203716-54203779,chr1,54203716,54203779,1,2501
IMR90|chr1:54206217-54206304,chr1,54206217,54206304,IMR90|chr1:54203716-54203779,chr1,54203716,54203779,1,2501
IMR90|chr1:54206217-54206249,chr1,54206217,54206249,IMR90|chr1:54203718-54203779,chr1,54203718,54203779,1,2499
IMR90|chr1:54746580-54746625,chr1,54746580,54746625,IMR90|chr1:205288085-205288193,chr1,205288085,205288193,1,150541505
IMR90|chr1:54746580-54746622,chr1,54746580,54746622,IMR90|chr1:205288085-205288193,chr1,205288085,205288193,1,150541505
IMR90|chr1:55674440-55674491,chr1,55674440,55674491,IMR90|chr1:32568964-32569063,chr1,32568964,32569063,1,23105476
IMR90|chr1:56904764-56904827,chr1,56904764,56904827,IMR90|chr1:78147419-78147499,chr1,78147419,78147499,1,21242655
IMR90|chr1:56904764-56904826,chr1,56904764,56904826,IMR90|chr1:78147419-78147499,chr1,78147419,78147499,1,21242655
IMR90|chr1:62154781-62154820,chr1,62154781,62154820,IMR90|chr1:25074422-25074529,chr1,25074422,25074529,1,37080359
IMR90|chr1:62154782-62154825,chr1,62154782,62154825,IMR90|chr1:25074422-25074529,chr1,25074422,25074529,1,37080360
IMR90|chr1:62154783-62154825,chr1,62154783,62154825,IMR90|chr1:25074422-25074529,chr1,25074422,25074529,1,37080361
IMR90|chr1:63204892-63205039,chr1,63204892,63205039,IMR90|chr1:63155856-63155895,chr1,63155856,63155895,1,49036
IMR90|chr1:63204943-63205054,chr1,63204943,63205054,IMR90|chr1:63155856-63155895,chr1,63155856,63155895,1,49087
IMR90|chr1:63206888-63206962,chr1,63206888,63206962,IMR90|chr1:63156306-63156358,chr1,63156306,63156358,1,50582
IMR90|chr1:63206992-63207142,chr1,63206992,63207142,IMR90|chr1:63156306-63156358,chr1,63156306,63156358,1,50686
IMR90|chr1:64368885-64368935,chr1,64368885,64368935,IMR90|chr1:201620360-201620460,chr1,201620360,201620460,1,137251475
IMR90|chr1:64368886-64368962,chr1,64368886,64368962,IMR90|chr1:201620360-201620460,chr1,201620360,201620460,1,137251474
IMR90|chr1:64399523-64399559,chr1,64399523,64399559,IMR90|chr1:171455337-171455427,chr1,171455337,171455427,1,107055814
IMR90|chr1:67008196-67008296,chr1,67008196,67008296,IMR90|chr1:33813206-33813246,chr1,33813206,33813246,1,33194990
IMR90|chr1:67010741-67010831,chr1,67010741,67010831,IMR90|chr1:162469031-162469071,chr1,162469031,162469071,1,95458290
IMR90|chr1:67010742-67010831,chr1,67010742,67010831,IMR90|chr1:162469031-162469071,chr1,162469031,162469071,1,95458289
IMR90|chr1:67014991-67015010,chr1,67014991,67015010,IMR90|chr1:33281457-33281552,chr1,33281457,33281552,1,33733534
IMR90|chr1:67014991-67015009,chr1,67014991,67015009,IMR90|chr1:33281457-33281552,chr1,33281457,33281552,1,33733534
IMR90|chr1:67023634-67023667,chr1,67023634,67023667,IMR90|chr1:33812801-33812902,chr1,33812801,33812902,1,33210833
IMR90|chr1:67038715-67038785,chr1,67038715,67038785,IMR90|chr1:45312634-45312678,chr1,45312634,45312678,1,21726081
IMR90|chr1:67038718-67038785,chr1,67038718,67038785,IMR90|chr1:45312634-45312678,chr1,45312634,45312678,1,21726084
IMR90|chr1:67066496-67066598,chr1,67066496,67066598,IMR90|chr1:67391702-67391724,chr1,67391702,67391724,1,325206
IMR90|chr1:67080640-67080748,chr1,67080640,67080748,IMR90|chr1:57043981-57044010,chr1,57043981,57044010,1,10036659
IMR90|chr1:67080641-67080748,chr1,67080641,67080748,IMR90|chr1:57043980-57044010,chr1,57043980,57044010,1,10036661
IMR90|chr1:67086962-67087003,chr1,67086962,67087003,IMR90|chr1:95004096-95004170,chr1,95004096,95004170,1,27917134
IMR90|chr1:67117349-67117396,chr1,67117349,67117396,IMR90|chr1:24068677-24068730,chr1,24068677,24068730,1,43048672
IMR90|chr1:68175196-68175255,chr1,68175196,68175255,IMR90|chr1:154958393-154958471,chr1,154958393,154958471,1,86783197
IMR90|chr1:68184454-68184475,chr1,68184454,68184475,IMR90|chr1:180125365-180125432,chr1,180125365,180125432,1,111940911
IMR90|chr1:68211871-68211911,chr1,68211871,68211911,IMR90|chr1:95003794-95003911,chr1,95003794,95003911,1,26791923
IMR90|chr1:68211879-68211912,chr1,68211879,68211912,IMR90|chr1:95003794-95003911,chr1,95003794,95003911,1,26791915
IMR90|chr1:68221483-68221546,chr1,68221483,68221546,IMR90|chr1:180126522-180126581,chr1,180126522,180126581,1,111905039
IMR90|chr1:68224518-68224591,chr1,68224518,68224591,IMR90|chr1:226067704-226067763,chr1,226067704,226067763,1,157843186
IMR90|chr1:68224518-68224549,chr1,68224518,68224549,IMR90|chr1:226067647-226067692,chr1,226067647,226067692,1,157843129
IMR90|chr1:68258056-68258086,chr1,68258056,68258086,IMR90|chr1:95005629-95005741,chr1,95005629,95005741,1,26747573
IMR90|chr1:68272882-68272960,chr1,68272882,68272960,IMR90|chr1:94703687-94703756,chr1,94703687,94703756,1,26430805
IMR90|chr1:68276973-68277031,chr1,68276973,68277031,IMR90|chr1:33814917-33815067,chr1,33814917,33815067,1,34462056
IMR90|chr1:68276973-68277024,chr1,68276973,68277024,IMR90|chr1:33814917-33815067,chr1,33814917,33815067,1,34462056
IMR90|chr1:68596412-68596522,chr1,68596412,68596522,IMR90|chr1:27322083-27322113,chr1,27322083,27322113,1,41274329
IMR90|chr1:68601991-68602067,chr1,68601991,68602067,IMR90|chr1:27322077-27322105,chr1,27322077,27322105,1,41279914
IMR90|chr1:68606923-68607014,chr1,68606923,68607014,IMR90|chr1:27323265-27323306,chr1,27323265,27323306,1,41283658
IMR90|chr1:68640765-68640822,chr1,68640765,68640822,IMR90|chr1:10093899-10093935,chr1,10093899,10093935,1,58546866
IMR90|chr1:68652808-68652869,chr1,68652808,68652869,IMR90|chr1:1255194-1255236,chr1,1255194,1255236,1,67397614
IMR90|chr1:68652813-68652869,chr1,68652813,68652869,IMR90|chr1:1255194-1255236,chr1,1255194,1255236,1,67397619
IMR90|chr1:68654915-68654947,chr1,68654915,68654947,IMR90|chr1:93300048-93300114,chr1,93300048,93300114,1,24645133
IMR90|chr1:68656921-68656954,chr1,68656921,68656954,IMR90|chr1:93299601-93299678,chr1,93299601,93299678,1,24642680
IMR90|chr1:68658429-68658521,chr1,68658429,68658521,IMR90|chr1:161118705-161118748,chr1,161118705,161118748,1,92460276
IMR90|chr1:68658472-68658521,chr1,68658472,68658521,IMR90|chr1:161118705-161118748,chr1,161118705,161118748,1,92460233
IMR90|chr1:68665517-68665546,chr1,68665517,68665546,IMR90|chr1:40421092-40421197,chr1,40421092,40421197,1,28244425
IMR90|chr1:68665517-68665544,chr1,68665517,68665544,IMR90|chr1:40421092-40421197,chr1,40421092,40421197,1,28244425
IMR90|chr1:68668372-68668422,chr1,68668372,68668422,IMR90|chr1:1241898-1241976,chr1,1241898,1241976,1,67426474
IMR90|chr1:68668375-68668422,chr1,68668375,68668422,IMR90|chr1:1241898-1241976,chr1,1241898,1241976,1,67426477
IMR90|chr1:68679125-68679170,chr1,68679125,68679170,IMR90|chr1:33814396-33814451,chr1,33814396,33814451,1,34864729
IMR90|chr1:68679139-68679200,chr1,68679139,68679200,IMR90|chr1:33814396-33814451,chr1,33814396,33814451,1,34864743
IMR90|chr1:68679159-68679200,chr1,68679159,68679200,IMR90|chr1:33814396-33814451,chr1,33814396,33814451,1,34864763
IMR90|chr1:77855535-77855605,chr1,77855535,77855605,IMR90|chr1:32806166-32806210,chr1,32806166,32806210,1,45049369
IMR90|chr1:77859767-77859900,chr1,77859767,77859900,IMR90|chr1:8083645-8083725,chr1,8083645,8083725,1,69776122
IMR90|chr1:77859767-77859820,chr1,77859767,77859820,IMR90|chr1:8083645-8083725,chr1,8083645,8083725,1,69776122
IMR90|chr1:77859831-77859901,chr1,77859831,77859901,IMR90|chr1:8083645-8083725,chr1,8083645,8083725,1,69776186
IMR90|chr1:77863323-77863388,chr1,77863323,77863388,IMR90|chr1:24067378-24067460,chr1,24067378,24067460,1,53795945
IMR90|chr1:77896855-77896924,chr1,77896855,77896924,IMR90|chr1:78150360-78150391,chr1,78150360,78150391,1,253505
IMR90|chr1:77896881-77896924,chr1,77896881,77896924,IMR90|chr1:78150360-78150391,chr1,78150360,78150391,1,253479
IMR90|chr1:78005242-78005315,chr1,78005242,78005315,IMR90|chr1:27322888-27322995,chr1,27322888,27322995,1,50682354
IMR90|chr1:78005275-78005315,chr1,78005275,78005315,IMR90|chr1:27322888-27322995,chr1,27322888,27322995,1,50682387
IMR90|chr1:78014341-78014377,chr1,78014341,78014377,IMR90|chr1:27323924-27323977,chr1,27323924,27323977,1,50690417
IMR90|chr1:84622984-84623016,chr1,84622984,84623016,IMR90|chr1:95003647-95003695,chr1,95003647,95003695,1,10380663
IMR90|chr1:84622985-84623016,chr1,84622985,84623016,IMR90|chr1:95003647-95003694,chr1,95003647,95003694,1,10380662
IMR90|chr1:94032457-94032582,chr1,94032457,94032582,IMR90|chr1:1259323-1259348,chr1,1259323,1259348,1,92773134
IMR90|chr1:94032458-94032583,chr1,94032458,94032583,IMR90|chr1:1259323-1259348,chr1,1259323,1259348,1,92773135
IMR90|chr1:94056663-94056697,chr1,94056663,94056697,IMR90|chr1:94702692-94702800,chr1,94702692,94702800,1,646029
IMR90|chr1:94056676-94056697,chr1,94056676,94056697,IMR90|chr1:94702692-94702800,chr1,94702692,94702800,1,646016
IMR90|chr1:94057305-94057343,chr1,94057305,94057343,IMR90|chr1:95005198-95005223,chr1,95005198,95005223,1,947893
IMR90|chr1:94058335-94058353,chr1,94058335,94058353,IMR90|chr1:94703420-94703508,chr1,94703420,94703508,1,645085
IMR90|chr1:94068650-94068762,chr1,94068650,94068762,IMR90|chr1:95003775-95003806,chr1,95003775,95003806,1,935125
IMR90|chr1:94068651-94068762,chr1,94068651,94068762,IMR90|chr1:95003775-95003806,chr1,95003775,95003806,1,935124
IMR90|chr1:94087897-94087945,chr1,94087897,94087945,IMR90|chr1:94705608-94705652,chr1,94705608,94705652,1,617711
IMR90|chr1:94122379-94122444,chr1,94122379,94122444,IMR90|chr1:46770222-46770302,chr1,46770222,46770302,1,47352157
IMR90|chr1:94136772-94136850,chr1,94136772,94136850,IMR90|chr1:95390033-95390105,chr1,95390033,95390105,1,1253261
IMR90|chr1:94993449-94993488,chr1,94993449,94993488,IMR90|chr1:95004029-95004071,chr1,95004029,95004071,1,10580
IMR90|chr1:94993623-94993645,chr1,94993623,94993645,IMR90|chr1:95006659-95006685,chr1,95006659,95006685,1,13036
IMR90|chr1:94999203-94999325,chr1,94999203,94999325,IMR90|chr1:46597443-46597471,chr1,46597443,46597471,1,48401760
IMR90|chr1:94999299-94999449,chr1,94999299,94999449,IMR90|chr1:46597443-46597471,chr1,46597443,46597471,1,48401856
IMR90|chr1:95413847-95413997,chr1,95413847,95413997,IMR90|chr1:28971639-28971740,chr1,28971639,28971740,1,66442208
IMR90|chr1:95413847-95413996,chr1,95413847,95413996,IMR90|chr1:28971639-28971740,chr1,28971639,28971740,1,66442208
IMR90|chr1:97608801-97608842,chr1,97608801,97608842,IMR90|chr1:113247346-113247398,chr1,113247346,113247398,1,15638545
IMR90|chr1:97608801-97608841,chr1,97608801,97608841,IMR90|chr1:113247345-113247397,chr1,113247345,113247397,1,15638544
IMR90|chr1:98263125-98263198,chr1,98263125,98263198,IMR90|chr1:151963735-151963765,chr1,151963735,151963765,1,53700610
IMR90|chr1:98459937-98460014,chr1,98459937,98460014,IMR90|chr1:78442905-78442960,chr1,78442905,78442960,1,20017032
IMR90|chr1:110137168-110137189,chr1,110137168,110137189,IMR90|chr1:110158302-110158427,chr1,110158302,110158427,1,21134
IMR90|chr1:110137544-110137571,chr1,110137544,110137571,IMR90|chr1:110158186-110158228,chr1,110158186,110158228,1,20642
IMR90|chr1:110137718-110137794,chr1,110137718,110137794,IMR90|chr1:110159274-110159315,chr1,110159274,110159315,1,21556
IMR90|chr1:110139178-110139258,chr1,110139178,110139258,IMR90|chr1:110158254-110158313,chr1,110158254,110158313,1,19076
IMR90|chr1:110139296-110139372,chr1,110139296,110139372,IMR90|chr1:110160070-110160106,chr1,110160070,110160106,1,20774
IMR90|chr1:112983363-112983391,chr1,112983363,112983391,IMR90|chr1:93302102-93302174,chr1,93302102,93302174,1,19681261
IMR90|chr1:112994880-112994915,chr1,112994880,112994915,IMR90|chr1:93301093-93301208,chr1,93301093,93301208,1,19693787
IMR90|chr1:114331900-114331955,chr1,114331900,114331955,IMR90|chr1:114302851-114302946,chr1,114302851,114302946,1,29049
IMR90|chr1:114331902-114331955,chr1,114331902,114331955,IMR90|chr1:114302851-114302946,chr1,114302851,114302946,1,29051
IMR90|chr1:114336362-114336453,chr1,114336362,114336453,IMR90|chr1:114303265-114303363,chr1,114303265,114303363,1,33097
IMR90|chr1:114336401-114336453,chr1,114336401,114336453,IMR90|chr1:114303265-114303363,chr1,114303265,114303363,1,33136
IMR90|chr1:120175157-120175203,chr1,120175157,120175203,IMR90|chr1:112939426-112939561,chr1,112939426,112939561,1,7235731
IMR90|chr1:120175171-120175203,chr1,120175171,120175203,IMR90|chr1:112939426-112939561,chr1,112939426,112939561,1,7235745
IMR90|chr1:120604357-120604418,chr1,120604357,120604418,IMR90|chr1:27322912-27322976,chr1,27322912,27322976,1,93281445
IMR90|chr1:120604357-120604408,chr1,120604357,120604408,IMR90|chr1:27322912-27322976,chr1,27322912,27322976,1,93281445
IMR90|chr1:144006539-144006614,chr1,144006539,144006614,IMR90|chr1:87790692-87790718,chr1,87790692,87790718,1,56215847
IMR90|chr1:144024822-144024868,chr1,144024822,144024868,IMR90|chr1:120837872-120837976,chr1,120837872,120837976,1,23186950
IMR90|chr1:144593718-144593868,chr1,144593718,144593868,IMR90|chr1:148556015-148556165,chr1,148556015,148556165,1,3962297
IMR90|chr1:144593721-144593863,chr1,144593721,144593863,IMR90|chr1:148556130-148556180,chr1,148556130,148556180,1,3962409
IMR90|chr1:144593725-144593875,chr1,144593725,144593875,IMR90|chr1:148556134-148556180,chr1,148556134,148556180,1,3962409
IMR90|chr1:144593744-144593875,chr1,144593744,144593875,IMR90|chr1:148556135-148556180,chr1,148556135,148556180,1,3962391
IMR90|chr1:144593745-144593875,chr1,144593745,144593875,IMR90|chr1:148556132-148556180,chr1,148556132,148556180,1,3962387
IMR90|chr1:144593757-144593867,chr1,144593757,144593867,IMR90|chr1:148556063-148556173,chr1,148556063,148556173,1,3962306
IMR90|chr1:144593760-144593875,chr1,144593760,144593875,IMR90|chr1:148556199-148556302,chr1,148556199,148556302,1,3962439
IMR90|chr1:144593761-144593836,chr1,144593761,144593836,IMR90|chr1:148558660-148558722,chr1,148558660,148558722,1,3964899
IMR90|chr1:144593767-144593874,chr1,144593767,144593874,IMR90|chr1:148556149-148556180,chr1,148556149,148556180,1,3962382
IMR90|chr1:144593769-144593874,chr1,144593769,144593874,IMR90|chr1:148556150-148556180,chr1,148556150,148556180,1,3962381
IMR90|chr1:144593772-144593875,chr1,144593772,144593875,IMR90|chr1:148556145-148556180,chr1,148556145,148556180,1,3962373
IMR90|chr1:144593774-144593874,chr1,144593774,144593874,IMR90|chr1:148556153-148556180,chr1,148556153,148556180,1,3962379
IMR90|chr1:144593781-144593875,chr1,144593781,144593875,IMR90|chr1:148556133-148556180,chr1,148556133,148556180,1,3962352
IMR90|chr1:144593784-144593874,chr1,144593784,144593874,IMR90|chr1:148556145-148556180,chr1,148556145,148556180,1,3962361
IMR90|chr1:144593785-144593875,chr1,144593785,144593875,IMR90|chr1:148556223-148556368,chr1,148556223,148556368,1,3962438
IMR90|chr1:144593788-144593875,chr1,144593788,144593875,IMR90|chr1:148556133-148556180,chr1,148556133,148556180,1,3962345
IMR90|chr1:144593789-144593875,chr1,144593789,144593875,IMR90|chr1:148556691-148556725,chr1,148556691,148556725,1,3962902
IMR90|chr1:144593792-144593875,chr1,144593792,144593875,IMR90|chr1:148556124-148556180,chr1,148556124,148556180,1,3962332
IMR90|chr1:144593794-144593874,chr1,144593794,144593874,IMR90|chr1:148556136-148556180,chr1,148556136,148556180,1,3962342
IMR90|chr1:144593796-144593874,chr1,144593796,144593874,IMR90|chr1:148556134-148556180,chr1,148556134,148556180,1,3962338
IMR90|chr1:144593798-144593874,chr1,144593798,144593874,IMR90|chr1:148556141-148556180,chr1,148556141,148556180,1,3962343
IMR90|chr1:144593801-144593875,chr1,144593801,144593875,IMR90|chr1:148556134-148556180,chr1,148556134,148556180,1,3962333
IMR90|chr1:144593804-144593875,chr1,144593804,144593875,IMR90|chr1:148556217-148556289,chr1,148556217,148556289,1,3962413
IMR90|chr1:144593805-144593874,chr1,144593805,144593874,IMR90|chr1:148556134-148556180,chr1,148556134,148556180,1,3962329
IMR90|chr1:144593806-144593875,chr1,144593806,144593875,IMR90|chr1:148556134-148556180,chr1,148556134,148556180,1,3962328
IMR90|chr1:144593806-144593874,chr1,144593806,144593874,IMR90|chr1:148556135-148556180,chr1,148556135,148556180,1,3962329
IMR90|chr1:144593814-144593875,chr1,144593814,144593875,IMR90|chr1:148556153-148556180,chr1,148556153,148556180,1,3962339
IMR90|chr1:144593832-144593875,chr1,144593832,144593875,IMR90|chr1:148556691-148556733,chr1,148556691,148556733,1,3962859
IMR90|chr1:144593834-144593875,chr1,144593834,144593875,IMR90|chr1:148556153-148556180,chr1,148556153,148556180,1,3962319
IMR90|chr1:144593838-144593875,chr1,144593838,144593875,IMR90|chr1:148556691-148556738,chr1,148556691,148556738,1,3962853
IMR90|chr1:144593839-144593875,chr1,144593839,144593875,IMR90|chr1:148556145-148556180,chr1,148556145,148556180,1,3962306
IMR90|chr1:144593850-144593875,chr1,144593850,144593875,IMR90|chr1:148556191-148556341,chr1,148556191,148556341,1,3962341
IMR90|chr1:144593854-144593875,chr1,144593854,144593875,IMR90|chr1:148556136-148556180,chr1,148556136,148556180,1,3962282
IMR90|chr1:144593856-144593875,chr1,144593856,144593875,IMR90|chr1:148556203-148556353,chr1,148556203,148556353,1,3962347
IMR90|chr1:144593857-144593875,chr1,144593857,144593875,IMR90|chr1:148556195-148556345,chr1,148556195,148556345,1,3962338
IMR90|chr1:144593858-144593875,chr1,144593858,144593875,IMR90|chr1:148556202-148556349,chr1,148556202,148556349,1,3962344
IMR90|chr1:144594012-144594162,chr1,144594012,144594162,IMR90|chr1:148556288-148556438,chr1,148556288,148556438,1,3962276
IMR90|chr1:144594031-144594175,chr1,144594031,144594175,IMR90|chr1:148556231-148556381,chr1,148556231,148556381,1,3962200
IMR90|chr1:144594041-144594182,chr1,144594041,144594182,IMR90|chr1:148556306-148556397,chr1,148556306,148556397,1,3962265
IMR90|chr1:144594056-144594149,chr1,144594056,144594149,IMR90|chr1:148556320-148556399,chr1,148556320,148556399,1,3962264
IMR90|chr1:144594059-144594186,chr1,144594059,144594186,IMR90|chr1:148556283-148556398,chr1,148556283,148556398,1,3962224
IMR90|chr1:144594059-144594156,chr1,144594059,144594156,IMR90|chr1:148556217-148556367,chr1,148556217,148556367,1,3962158
IMR90|chr1:144594064-144594149,chr1,144594064,144594149,IMR90|chr1:148556310-148556376,chr1,148556310,148556376,1,3962246
IMR90|chr1:144594068-144594212,chr1,144594068,144594212,IMR90|chr1:148556296-148556443,chr1,148556296,148556443,1,3962228
IMR90|chr1:144594094-144594205,chr1,144594094,144594205,IMR90|chr1:148556678-148556717,chr1,148556678,148556717,1,3962584
IMR90|chr1:144594094-144594202,chr1,144594094,144594202,IMR90|chr1:148556678-148556717,chr1,148556678,148556717,1,3962584
IMR90|chr1:144594099-144594172,chr1,144594099,144594172,IMR90|chr1:148556207-148556280,chr1,148556207,148556280,1,3962108
IMR90|chr1:144594100-144594250,chr1,144594100,144594250,IMR90|chr1:148556238-148556385,chr1,148556238,148556385,1,3962138
IMR90|chr1:144594103-144594253,chr1,144594103,144594253,IMR90|chr1:148556466-148556616,chr1,148556466,148556616,1,3962363
IMR90|chr1:144594106-144594251,chr1,144594106,144594251,IMR90|chr1:148556476-148556626,chr1,148556476,148556626,1,3962370
IMR90|chr1:144594110-144594157,chr1,144594110,144594157,IMR90|chr1:148556366-148556416,chr1,148556366,148556416,1,3962256
IMR90|chr1:144594111-144594157,chr1,144594111,144594157,IMR90|chr1:148556366-148556417,chr1,148556366,148556417,1,3962255
IMR90|chr1:144594135-144594198,chr1,144594135,144594198,IMR90|chr1:148558168-148558212,chr1,148558168,148558212,1,3964033
IMR90|chr1:144594140-144594216,chr1,144594140,144594216,IMR90|chr1:148556313-148556458,chr1,148556313,148556458,1,3962173
IMR90|chr1:144594183-144594218,chr1,144594183,144594218,IMR90|chr1:148556486-148556616,chr1,148556486,148556616,1,3962303
IMR90|chr1:144594183-144594215,chr1,144594183,144594215,IMR90|chr1:148556554-148556672,chr1,148556554,148556672,1,3962371
IMR90|chr1:144594183-144594214,chr1,144594183,144594214,IMR90|chr1:148556554-148556672,chr1,148556554,148556672,1,3962371
IMR90|chr1:144594468-144594483,chr1,144594468,144594483,IMR90|chr1:148558163-148558274,chr1,148558163,148558274,1,3963695
IMR90|chr1:144595214-144595319,chr1,144595214,144595319,IMR90|chr1:148557625-148557655,chr1,148557625,148557655,1,3962411
IMR90|chr1:144595266-144595320,chr1,144595266,144595320,IMR90|chr1:148557522-148557646,chr1,148557522,148557646,1,3962256
IMR90|chr1:144595290-144595355,chr1,144595290,144595355,IMR90|chr1:148557518-148557625,chr1,148557518,148557625,1,3962228
IMR90|chr1:144595295-144595372,chr1,144595295,144595372,IMR90|chr1:148557543-148557625,chr1,148557543,148557625,1,3962248
IMR90|chr1:144595295-144595346,chr1,144595295,144595346,IMR90|chr1:148557503-148557620,chr1,148557503,148557620,1,3962208
IMR90|chr1:144595295-144595325,chr1,144595295,144595325,IMR90|chr1:148557541-148557625,chr1,148557541,148557625,1,3962246
IMR90|chr1:144595324-144595346,chr1,144595324,144595346,IMR90|chr1:148557615-148557676,chr1,148557615,148557676,1,3962291
IMR90|chr1:144595747-144595891,chr1,144595747,144595891,IMR90|chr1:148557990-148558127,chr1,148557990,148558127,1,3962243
IMR90|chr1:144595760-144595910,chr1,144595760,144595910,IMR90|chr1:148558160-148558306,chr1,148558160,148558306,1,3962400
IMR90|chr1:144595760-144595867,chr1,144595760,144595867,IMR90|chr1:148558187-148558335,chr1,148558187,148558335,1,3962427
IMR90|chr1:144595782-144595820,chr1,144595782,144595820,IMR90|chr1:148558145-148558286,chr1,148558145,148558286,1,3962363
IMR90|chr1:144595783-144595928,chr1,144595783,144595928,IMR90|chr1:148558160-148558300,chr1,148558160,148558300,1,3962377
IMR90|chr1:144595783-144595863,chr1,144595783,144595863,IMR90|chr1:148558154-148558286,chr1,148558154,148558286,1,3962371
IMR90|chr1:144595783-144595831,chr1,144595783,144595831,IMR90|chr1:148558160-148558300,chr1,148558160,148558300,1,3962377
IMR90|chr1:144595789-144595939,chr1,144595789,144595939,IMR90|chr1:148558160-148558297,chr1,148558160,148558297,1,3962371
IMR90|chr1:144595789-144595820,chr1,144595789,144595820,IMR90|chr1:148558145-148558286,chr1,148558145,148558286,1,3962356
IMR90|chr1:144595799-144595949,chr1,144595799,144595949,IMR90|chr1:148558160-148558287,chr1,148558160,148558287,1,3962361
IMR90|chr1:144595800-144595942,chr1,144595800,144595942,IMR90|chr1:148558160-148558294,chr1,148558160,148558294,1,3962360
IMR90|chr1:144595800-144595841,chr1,144595800,144595841,IMR90|chr1:148558176-148558291,chr1,148558176,148558291,1,3962376
IMR90|chr1:144595800-144595835,chr1,144595800,144595835,IMR90|chr1:148558176-148558291,chr1,148558176,148558291,1,3962376
IMR90|chr1:144595801-144595951,chr1,144595801,144595951,IMR90|chr1:148558154-148558286,chr1,148558154,148558286,1,3962353
IMR90|chr1:144595803-144595952,chr1,144595803,144595952,IMR90|chr1:148558154-148558286,chr1,148558154,148558286,1,3962351
IMR90|chr1:144595803-144595950,chr1,144595803,144595950,IMR90|chr1:148558193-148558343,chr1,148558193,148558343,1,3962390
IMR90|chr1:144595804-144595849,chr1,144595804,144595849,IMR90|chr1:148558154-148558286,chr1,148558154,148558286,1,3962350
IMR90|chr1:144595829-144595952,chr1,144595829,144595952,IMR90|chr1:148556703-148556810,chr1,148556703,148556810,1,3960874
IMR90|chr1:144595883-144595953,chr1,144595883,144595953,IMR90|chr1:148558217-148558359,chr1,148558217,148558359,1,3962334
IMR90|chr1:144595909-144596057,chr1,144595909,144596057,IMR90|chr1:148558190-148558334,chr1,148558190,148558334,1,3962281
IMR90|chr1:144595910-144595952,chr1,144595910,144595952,IMR90|chr1:148558244-148558283,chr1,148558244,148558283,1,3962334
IMR90|chr1:144595912-144596062,chr1,144595912,144596062,IMR90|chr1:148558202-148558351,chr1,148558202,148558351,1,3962290
IMR90|chr1:144595920-144596070,chr1,144595920,144596070,IMR90|chr1:148558170-148558320,chr1,148558170,148558320,1,3962250
IMR90|chr1:144596011-144596116,chr1,144596011,144596116,IMR90|chr1:148558179-148558291,chr1,148558179,148558291,1,3962168
IMR90|chr1:144596218-144596368,chr1,144596218,144596368,IMR90|chr1:148558551-148558601,chr1,148558551,148558601,1,3962333
IMR90|chr1:144596230-144596279,chr1,144596230,144596279,IMR90|chr1:148558595-148558696,chr1,148558595,148558696,1,3962365
IMR90|chr1:144596253-144596349,chr1,144596253,144596349,IMR90|chr1:148558218-148558286,chr1,148558218,148558286,1,3961965
IMR90|chr1:144596259-144596309,chr1,144596259,144596309,IMR90|chr1:148556798-148556898,chr1,148556798,148556898,1,3960539
IMR90|chr1:144596264-144596297,chr1,144596264,144596297,IMR90|chr1:148558257-148558317,chr1,148558257,148558317,1,3961993
IMR90|chr1:144596305-144596454,chr1,144596305,144596454,IMR90|chr1:148558223-148558286,chr1,148558223,148558286,1,3961918
IMR90|chr1:144596308-144596454,chr1,144596308,144596454,IMR90|chr1:148558223-148558286,chr1,148558223,148558286,1,3961915
IMR90|chr1:144596312-144596462,chr1,144596312,144596462,IMR90|chr1:148558223-148558286,chr1,148558223,148558286,1,3961911
IMR90|chr1:144596321-144596465,chr1,144596321,144596465,IMR90|chr1:148556739-148556810,chr1,148556739,148556810,1,3960418
IMR90|chr1:144596326-144596476,chr1,144596326,144596476,IMR90|chr1:148558699-148558849,chr1,148558699,148558849,1,3962373
IMR90|chr1:144596335-144596474,chr1,144596335,144596474,IMR90|chr1:148558251-148558286,chr1,148558251,148558286,1,3961916
IMR90|chr1:144597134-144597213,chr1,144597134,144597213,IMR90|chr1:148559469-148559546,chr1,148559469,148559546,1,3962335
IMR90|chr1:144597138-144597213,chr1,144597138,144597213,IMR90|chr1:148559562-148559709,chr1,148559562,148559709,1,3962424
IMR90|chr1:144597270-144597420,chr1,144597270,144597420,IMR90|chr1:148559575-148559721,chr1,148559575,148559721,1,3962305
IMR90|chr1:144597271-144597421,chr1,144597271,144597421,IMR90|chr1:148559579-148559729,chr1,148559579,148559729,1,3962308
IMR90|chr1:144597297-144597447,chr1,144597297,144597447,IMR90|chr1:148559593-148559743,chr1,148559593,148559743,1,3962296
IMR90|chr1:144597298-144597448,chr1,144597298,144597448,IMR90|chr1:148559577-148559721,chr1,148559577,148559721,1,3962279
IMR90|chr1:144597904-144598051,chr1,144597904,144598051,IMR90|chr1:148560205-148560352,chr1,148560205,148560352,1,3962301
IMR90|chr1:144598043-144598193,chr1,144598043,144598193,IMR90|chr1:148560453-148560603,chr1,148560453,148560603,1,3962410
IMR90|chr1:144598044-144598194,chr1,144598044,144598194,IMR90|chr1:148560400-148560550,chr1,148560400,148560550,1,3962356
IMR90|chr1:144598044-144598175,chr1,144598044,144598175,IMR90|chr1:148560416-148560566,chr1,148560416,148560566,1,3962372
IMR90|chr1:144598055-144598171,chr1,144598055,144598171,IMR90|chr1:148560501-148560648,chr1,148560501,148560648,1,3962446
IMR90|chr1:144598216-144598352,chr1,144598216,144598352,IMR90|chr1:148560505-148560654,chr1,148560505,148560654,1,3962289
IMR90|chr1:144598512-144598661,chr1,144598512,144598661,IMR90|chr1:148558220-148558286,chr1,148558220,148558286,1,3959708
IMR90|chr1:144598512-144598530,chr1,144598512,144598530,IMR90|chr1:148558184-148558287,chr1,148558184,148558287,1,3959672
IMR90|chr1:144598529-144598679,chr1,144598529,144598679,IMR90|chr1:148558233-148558286,chr1,148558233,148558286,1,3959704
IMR90|chr1:144598544-144598694,chr1,144598544,144598694,IMR90|chr1:148556254-148556272,chr1,148556254,148556272,1,3957710
IMR90|chr1:144598555-144598705,chr1,144598555,144598705,IMR90|chr1:148558224-148558286,chr1,148558224,148558286,1,3959669
IMR90|chr1:144598561-144598711,chr1,144598561,144598711,IMR90|chr1:148556791-148556810,chr1,148556791,148556810,1,3958230
IMR90|chr1:144598564-144598714,chr1,144598564,144598714,IMR90|chr1:148558180-148558286,chr1,148558180,148558286,1,3959616
IMR90|chr1:144598564-144598713,chr1,144598564,144598713,IMR90|chr1:148558193-148558286,chr1,148558193,148558286,1,3959629
IMR90|chr1:144598571-144598721,chr1,144598571,144598721,IMR90|chr1:148558783-148558805,chr1,148558783,148558805,1,3960212
IMR90|chr1:144598573-144598723,chr1,144598573,144598723,IMR90|chr1:148558239-148558286,chr1,148558239,148558286,1,3959666
IMR90|chr1:144598584-144598731,chr1,144598584,144598731,IMR90|chr1:148558239-148558286,chr1,148558239,148558286,1,3959655
IMR90|chr1:144598588-144598650,chr1,144598588,144598650,IMR90|chr1:148556220-148556273,chr1,148556220,148556273,1,3957632
IMR90|chr1:144598612-144598762,chr1,144598612,144598762,IMR90|chr1:148558195-148558286,chr1,148558195,148558286,1,3959583
IMR90|chr1:144598619-144598769,chr1,144598619,144598769,IMR90|chr1:148558250-148558286,chr1,148558250,148558286,1,3959631
IMR90|chr1:144598650-144598771,chr1,144598650,144598771,IMR90|chr1:148556231-148556269,chr1,148556231,148556269,1,3957581
IMR90|chr1:144920348-144920422,chr1,144920348,144920422,IMR90|chr1:120189024-120189123,chr1,120189024,120189123,1,24731324
IMR90|chr1:144920375-144920422,chr1,144920375,144920422,IMR90|chr1:120189024-120189123,chr1,120189024,120189123,1,24731351
IMR90|chr1:145018089-145018137,chr1,145018089,145018137,IMR90|chr1:114304363-114304448,chr1,114304363,114304448,1,30713726
IMR90|chr1:145018116-145018137,chr1,145018116,145018137,IMR90|chr1:114304363-114304448,chr1,114304363,114304448,1,30713753
IMR90|chr1:150347075-150347146,chr1,150347075,150347146,IMR90|chr1:109633581-109633636,chr1,109633581,109633636,1,40713494
IMR90|chr1:150347076-150347146,chr1,150347076,150347146,IMR90|chr1:109633581-109633636,chr1,109633581,109633636,1,40713495
IMR90|chr1:150540255-150540377,chr1,150540255,150540377,IMR90|chr1:150550504-150550590,chr1,150550504,150550590,1,10249
IMR90|chr1:150540397-150540422,chr1,150540397,150540422,IMR90|chr1:150532448-150532496,chr1,150532448,150532496,1,7949
IMR90|chr1:150542019-150542096,chr1,150542019,150542096,IMR90|chr1:150550114-150550170,chr1,150550114,150550170,1,8095
IMR90|chr1:150543730-150543783,chr1,150543730,150543783,IMR90|chr1:150550983-150551045,chr1,150550983,150551045,1,7253
IMR90|chr1:150544809-150544885,chr1,150544809,150544885,IMR90|chr1:150534733-150534780,chr1,150534733,150534780,1,10076
IMR90|chr1:150576302-150576373,chr1,150576302,150576373,IMR90|chr1:150546164-150546266,chr1,150546164,150546266,1,30138
IMR90|chr1:150576302-150576348,chr1,150576302,150576348,IMR90|chr1:150546164-150546266,chr1,150546164,150546266,1,30138
IMR90|chr1:150576303-150576373,chr1,150576303,150576373,IMR90|chr1:150546164-150546266,chr1,150546164,150546266,1,30139
IMR90|chr1:150576303-150576349,chr1,150576303,150576349,IMR90|chr1:150546164-150546266,chr1,150546164,150546266,1,30139
IMR90|chr1:150579446-150579566,chr1,150579446,150579566,IMR90|chr1:150546478-150546523,chr1,150546478,150546523,1,32968
IMR90|chr1:151528188-151528272,chr1,151528188,151528272,IMR90|chr1:151122686-151122733,chr1,151122686,151122733,1,405502
IMR90|chr1:151953792-151953940,chr1,151953792,151953940,IMR90|chr1:151963626-151963648,chr1,151963626,151963648,1,9834
IMR90|chr1:151953810-151953938,chr1,151953810,151953938,IMR90|chr1:151963626-151963648,chr1,151963626,151963648,1,9816
IMR90|chr1:151953811-151953938,chr1,151953811,151953938,IMR90|chr1:151963626-151963648,chr1,151963626,151963648,1,9815
IMR90|chr1:153901108-153901232,chr1,153901108,153901232,IMR90|chr1:153896379-153896438,chr1,153896379,153896438,1,4729
IMR90|chr1:153901110-153901201,chr1,153901110,153901201,IMR90|chr1:153896379-153896438,chr1,153896379,153896438,1,4731
IMR90|chr1:153973303-153973351,chr1,153973303,153973351,IMR90|chr1:153964666-153964722,chr1,153964666,153964722,1,8637
IMR90|chr1:153973303-153973347,chr1,153973303,153973347,IMR90|chr1:153964673-153964721,chr1,153964673,153964721,1,8630
IMR90|chr1:154412231-154412280,chr1,154412231,154412280,IMR90|chr1:183442360-183442416,chr1,183442360,183442416,1,29030129
IMR90|chr1:154412231-154412277,chr1,154412231,154412277,IMR90|chr1:183442360-183442416,chr1,183442360,183442416,1,29030129
IMR90|chr1:160182012-160182038,chr1,160182012,160182038,IMR90|chr1:160258244-160258305,chr1,160258244,160258305,1,76232
IMR90|chr1:162627561-162627619,chr1,162627561,162627619,IMR90|chr1:162533461-162533518,chr1,162533461,162533518,1,94100
IMR90|chr1:162627561-162627612,chr1,162627561,162627612,IMR90|chr1:162533461-162533518,chr1,162533461,162533518,1,94100
IMR90|chr1:162632108-162632177,chr1,162632108,162632177,IMR90|chr1:162532404-162532477,chr1,162532404,162532477,1,99704
IMR90|chr1:162632108-162632174,chr1,162632108,162632174,IMR90|chr1:162532404-162532477,chr1,162532404,162532477,1,99704
IMR90|chr1:162884504-162884556,chr1,162884504,162884556,IMR90|chr1:200639527-200639605,chr1,200639527,200639605,1,37755023
IMR90|chr1:162884504-162884555,chr1,162884504,162884555,IMR90|chr1:200639527-200639605,chr1,200639527,200639605,1,37755023
IMR90|chr1:165811126-165811193,chr1,165811126,165811193,IMR90|chr1:151428933-151428993,chr1,151428933,151428993,1,14382193
IMR90|chr1:165811126-165811192,chr1,165811126,165811192,IMR90|chr1:151428933-151428993,chr1,151428933,151428993,1,14382193
IMR90|chr1:171462669-171462753,chr1,171462669,171462753,IMR90|chr1:178064523-178064589,chr1,178064523,178064589,1,6601854
IMR90|chr1:171462669-171462752,chr1,171462669,171462752,IMR90|chr1:178064523-178064589,chr1,178064523,178064589,1,6601854
IMR90|chr1:171462742-171462892,chr1,171462742,171462892,IMR90|chr1:178064523-178064589,chr1,178064523,178064589,1,6601781
IMR90|chr1:172963122-172963216,chr1,172963122,172963216,IMR90|chr1:40041095-40041153,chr1,40041095,40041153,1,132922027
IMR90|chr1:172963122-172963214,chr1,172963122,172963214,IMR90|chr1:40041095-40041153,chr1,40041095,40041153,1,132922027
IMR90|chr1:172963122-172963213,chr1,172963122,172963213,IMR90|chr1:40041095-40041153,chr1,40041095,40041153,1,132922027
IMR90|chr1:173366026-173366141,chr1,173366026,173366141,IMR90|chr1:16089475-16089505,chr1,16089475,16089505,1,157276551
IMR90|chr1:173372198-173372282,chr1,173372198,173372282,IMR90|chr1:173441697-173441747,chr1,173441697,173441747,1,69499
IMR90|chr1:173372968-173373053,chr1,173372968,173373053,IMR90|chr1:173831087-173831152,chr1,173831087,173831152,1,458119
IMR90|chr1:173378862-173378976,chr1,173378862,173378976,IMR90|chr1:173442090-173442110,chr1,173442090,173442110,1,63228
IMR90|chr1:173378863-173378976,chr1,173378863,173378976,IMR90|chr1:173442090-173442110,chr1,173442090,173442110,1,63227
IMR90|chr1:173431288-173431433,chr1,173431288,173431433,IMR90|chr1:173445770-173445865,chr1,173445770,173445865,1,14482
IMR90|chr1:173431413-173431563,chr1,173431413,173431563,IMR90|chr1:173445770-173445790,chr1,173445770,173445790,1,14357
IMR90|chr1:173431416-173431563,chr1,173431416,173431563,IMR90|chr1:173445770-173445797,chr1,173445770,173445797,1,14354
IMR90|chr1:173431418-173431568,chr1,173431418,173431568,IMR90|chr1:173445770-173445815,chr1,173445770,173445815,1,14352
IMR90|chr1:173431447-173431594,chr1,173431447,173431594,IMR90|chr1:173445770-173445797,chr1,173445770,173445797,1,14323
IMR90|chr1:173431452-173431594,chr1,173431452,173431594,IMR90|chr1:173445770-173445834,chr1,173445770,173445834,1,14318
IMR90|chr1:173431455-173431593,chr1,173431455,173431593,IMR90|chr1:173445770-173445797,chr1,173445770,173445797,1,14315
IMR90|chr1:173431457-173431593,chr1,173431457,173431593,IMR90|chr1:173445770-173445789,chr1,173445770,173445789,1,14313
IMR90|chr1:173431462-173431593,chr1,173431462,173431593,IMR90|chr1:173445770-173445788,chr1,173445770,173445788,1,14308
IMR90|chr1:173431466-173431593,chr1,173431466,173431593,IMR90|chr1:173445770-173445790,chr1,173445770,173445790,1,14304
IMR90|chr1:173431470-173431593,chr1,173431470,173431593,IMR90|chr1:173445770-173445797,chr1,173445770,173445797,1,14300
IMR90|chr1:173431471-173431593,chr1,173431471,173431593,IMR90|chr1:173445770-173445797,chr1,173445770,173445797,1,14299
IMR90|chr1:173431474-173431593,chr1,173431474,173431593,IMR90|chr1:173445770-173445801,chr1,173445770,173445801,1,14296
IMR90|chr1:173431477-173431593,chr1,173431477,173431593,IMR90|chr1:173445770-173445801,chr1,173445770,173445801,1,14293
IMR90|chr1:173431481-173431593,chr1,173431481,173431593,IMR90|chr1:173445770-173445786,chr1,173445770,173445786,1,14289
IMR90|chr1:173431482-173431593,chr1,173431482,173431593,IMR90|chr1:173445770-173445837,chr1,173445770,173445837,1,14288
IMR90|chr1:173431488-173431593,chr1,173431488,173431593,IMR90|chr1:173445770-173445815,chr1,173445770,173445815,1,14282
IMR90|chr1:173431489-173431593,chr1,173431489,173431593,IMR90|chr1:173445770-173445856,chr1,173445770,173445856,1,14281
IMR90|chr1:173431490-173431593,chr1,173431490,173431593,IMR90|chr1:173445770-173445817,chr1,173445770,173445817,1,14280
IMR90|chr1:173431491-173431593,chr1,173431491,173431593,IMR90|chr1:173445770-173445819,chr1,173445770,173445819,1,14279
IMR90|chr1:173431492-173431593,chr1,173431492,173431593,IMR90|chr1:173445770-173445819,chr1,173445770,173445819,1,14278
IMR90|chr1:173431495-173431593,chr1,173431495,173431593,IMR90|chr1:173445770-173445829,chr1,173445770,173445829,1,14275
IMR90|chr1:173431497-173431593,chr1,173431497,173431593,IMR90|chr1:173445770-173445839,chr1,173445770,173445839,1,14273
IMR90|chr1:173431500-173431593,chr1,173431500,173431593,IMR90|chr1:173445770-173445790,chr1,173445770,173445790,1,14270
IMR90|chr1:173431501-173431593,chr1,173431501,173431593,IMR90|chr1:173445770-173445808,chr1,173445770,173445808,1,14269
IMR90|chr1:173431502-173431593,chr1,173431502,173431593,IMR90|chr1:173445770-173445829,chr1,173445770,173445829,1,14268
IMR90|chr1:173431507-173431593,chr1,173431507,173431593,IMR90|chr1:173445770-173445819,chr1,173445770,173445819,1,14263
IMR90|chr1:173431509-173431588,chr1,173431509,173431588,IMR90|chr1:173446118-173446148,chr1,173446118,173446148,1,14609
IMR90|chr1:173431510-173431588,chr1,173431510,173431588,IMR90|chr1:173446118-173446148,chr1,173446118,173446148,1,14608
IMR90|chr1:173431511-173431593,chr1,173431511,173431593,IMR90|chr1:173445770-173445819,chr1,173445770,173445819,1,14259
IMR90|chr1:173431512-173431593,chr1,173431512,173431593,IMR90|chr1:173445770-173445819,chr1,173445770,173445819,1,14258
IMR90|chr1:173431513-173431593,chr1,173431513,173431593,IMR90|chr1:173445770-173445819,chr1,173445770,173445819,1,14257
IMR90|chr1:173431519-173431593,chr1,173431519,173431593,IMR90|chr1:173445770-173445811,chr1,173445770,173445811,1,14251
IMR90|chr1:173431520-173431593,chr1,173431520,173431593,IMR90|chr1:173445770-173445817,chr1,173445770,173445817,1,14250
IMR90|chr1:173431521-173431593,chr1,173431521,173431593,IMR90|chr1:173445770-173445845,chr1,173445770,173445845,1,14249
IMR90|chr1:173431525-173431593,chr1,173431525,173431593,IMR90|chr1:173445770-173445849,chr1,173445770,173445849,1,14245
IMR90|chr1:173431527-173431593,chr1,173431527,173431593,IMR90|chr1:173445770-173445819,chr1,173445770,173445819,1,14243
IMR90|chr1:173431529-173431593,chr1,173431529,173431593,IMR90|chr1:173445770-173445856,chr1,173445770,173445856,1,14241
IMR90|chr1:173431532-173431593,chr1,173431532,173431593,IMR90|chr1:173445770-173445808,chr1,173445770,173445808,1,14238
IMR90|chr1:173431533-173431593,chr1,173431533,173431593,IMR90|chr1:173445770-173445808,chr1,173445770,173445808,1,14237
IMR90|chr1:173431534-173431593,chr1,173431534,173431593,IMR90|chr1:173445770-173445812,chr1,173445770,173445812,1,14236
IMR90|chr1:173431536-173431593,chr1,173431536,173431593,IMR90|chr1:173445770-173445839,chr1,173445770,173445839,1,14234
IMR90|chr1:173431537-173431593,chr1,173431537,173431593,IMR90|chr1:173445770-173445849,chr1,173445770,173445849,1,14233
IMR90|chr1:173431539-173431593,chr1,173431539,173431593,IMR90|chr1:173445770-173445865,chr1,173445770,173445865,1,14231
IMR90|chr1:173431543-173431593,chr1,173431543,173431593,IMR90|chr1:173445770-173445835,chr1,173445770,173445835,1,14227
IMR90|chr1:173821906-173821945,chr1,173821906,173821945,IMR90|chr1:173827756-173827844,chr1,173827756,173827844,1,5850
IMR90|chr1:173823107-173823211,chr1,173823107,173823211,IMR90|chr1:173829382-173829432,chr1,173829382,173829432,1,6275
IMR90|chr1:173823111-173823211,chr1,173823111,173823211,IMR90|chr1:173829382-173829432,chr1,173829382,173829432,1,6271
IMR90|chr1:173823184-173823282,chr1,173823184,173823282,IMR90|chr1:173828321-173828353,chr1,173828321,173828353,1,5137
IMR90|chr1:173823242-173823280,chr1,173823242,173823280,IMR90|chr1:173827852-173827933,chr1,173827852,173827933,1,4610
IMR90|chr1:173823270-173823417,chr1,173823270,173823417,IMR90|chr1:173830748-173830859,chr1,173830748,173830859,1,7478
IMR90|chr1:173823340-173823380,chr1,173823340,173823380,IMR90|chr1:173827890-173827992,chr1,173827890,173827992,1,4550
IMR90|chr1:173823378-173823417,chr1,173823378,173823417,IMR90|chr1:173830748-173830859,chr1,173830748,173830859,1,7370
IMR90|chr1:173823449-173823555,chr1,173823449,173823555,IMR90|chr1:173829408-173829432,chr1,173829408,173829432,1,5959
IMR90|chr1:173824302-173824352,chr1,173824302,173824352,IMR90|chr1:173830841-173830954,chr1,173830841,173830954,1,6539
IMR90|chr1:173824303-173824367,chr1,173824303,173824367,IMR90|chr1:173828336-173828425,chr1,173828336,173828425,1,4033
IMR90|chr1:173824303-173824364,chr1,173824303,173824364,IMR90|chr1:173828336-173828425,chr1,173828336,173828425,1,4033
IMR90|chr1:173824910-173824962,chr1,173824910,173824962,IMR90|chr1:173830996-173831105,chr1,173830996,173831105,1,6086
IMR90|chr1:173824921-173824962,chr1,173824921,173824962,IMR90|chr1:173830996-173831105,chr1,173830996,173831105,1,6075
IMR90|chr1:173825029-173825101,chr1,173825029,173825101,IMR90|chr1:173828184-173828247,chr1,173828184,173828247,1,3155
IMR90|chr1:173826215-173826310,chr1,173826215,173826310,IMR90|chr1:173832265-173832320,chr1,173832265,173832320,1,6050
IMR90|chr1:173826216-173826310,chr1,173826216,173826310,IMR90|chr1:173832265-173832320,chr1,173832265,173832320,1,6049
IMR90|chr1:173972560-173972604,chr1,173972560,173972604,IMR90|chr1:173831348-173831494,chr1,173831348,173831494,1,141212
IMR90|chr1:173972853-173972957,chr1,173972853,173972957,IMR90|chr1:173834904-173834943,chr1,173834904,173834943,1,137949
IMR90|chr1:173973421-173973451,chr1,173973421,173973451,IMR90|chr1:173830781-173830869,chr1,173830781,173830869,1,142640
IMR90|chr1:178093435-178093556,chr1,178093435,178093556,IMR90|chr1:180470505-180470553,chr1,180470505,180470553,1,2377070
IMR90|chr1:178093435-178093538,chr1,178093435,178093538,IMR90|chr1:180470505-180470553,chr1,180470505,180470553,1,2377070
IMR90|chr1:178093454-178093556,chr1,178093454,178093556,IMR90|chr1:180470505-180470553,chr1,180470505,180470553,1,2377051
IMR90|chr1:178095856-178095898,chr1,178095856,178095898,IMR90|chr1:8936901-8936931,chr1,8936901,8936931,1,169158955
IMR90|chr1:178095856-178095897,chr1,178095856,178095897,IMR90|chr1:8936901-8936931,chr1,8936901,8936931,1,169158955
IMR90|chr1:179016014-179016089,chr1,179016014,179016089,IMR90|chr1:179047638-179047680,chr1,179047638,179047680,1,31624
IMR90|chr1:179017534-179017615,chr1,179017534,179017615,IMR90|chr1:179047351-179047384,chr1,179047351,179047384,1,29817
IMR90|chr1:179017534-179017614,chr1,179017534,179017614,IMR90|chr1:179048012-179048049,chr1,179048012,179048049,1,30478
IMR90|chr1:179094271-179094297,chr1,179094271,179094297,IMR90|chr1:44441395-44441480,chr1,44441395,44441480,1,134652876
IMR90|chr1:179094271-179094296,chr1,179094271,179094296,IMR90|chr1:44441395-44441480,chr1,44441395,44441480,1,134652876
IMR90|chr1:179094273-179094296,chr1,179094273,179094296,IMR90|chr1:44441395-44441481,chr1,44441395,44441481,1,134652878
IMR90|chr1:183000414-183000525,chr1,183000414,183000525,IMR90|chr1:27324578-27324617,chr1,27324578,27324617,1,155675836
IMR90|chr1:183000417-183000567,chr1,183000417,183000567,IMR90|chr1:27324578-27324617,chr1,27324578,27324617,1,155675839
IMR90|chr1:183010902-183010945,chr1,183010902,183010945,IMR90|chr1:205717808-205717907,chr1,205717808,205717907,1,22706906
IMR90|chr1:183013379-183013471,chr1,183013379,183013471,IMR90|chr1:182809209-182809342,chr1,182809209,182809342,1,204170
IMR90|chr1:183013379-183013396,chr1,183013379,183013396,IMR90|chr1:182809209-182809342,chr1,182809209,182809342,1,204170
IMR90|chr1:183021175-183021211,chr1,183021175,183021211,IMR90|chr1:182992242-182992365,chr1,182992242,182992365,1,28933
IMR90|chr1:183022659-183022708,chr1,183022659,183022708,IMR90|chr1:182810054-182810095,chr1,182810054,182810095,1,212605
IMR90|chr1:183022659-183022707,chr1,183022659,183022707,IMR90|chr1:182810054-182810095,chr1,182810054,182810095,1,212605
IMR90|chr1:183024645-183024709,chr1,183024645,183024709,IMR90|chr1:205718968-205719017,chr1,205718968,205719017,1,22694323
IMR90|chr1:183025627-183025676,chr1,183025627,183025676,IMR90|chr1:27324256-27324374,chr1,27324256,27324374,1,155701371
IMR90|chr1:183025646-183025678,chr1,183025646,183025678,IMR90|chr1:27324256-27324374,chr1,27324256,27324374,1,155701390
IMR90|chr1:183031128-183031201,chr1,183031128,183031201,IMR90|chr1:150126479-150126523,chr1,150126479,150126523,1,32904649
IMR90|chr1:183031128-183031200,chr1,183031128,183031200,IMR90|chr1:150126479-150126523,chr1,150126479,150126523,1,32904649
IMR90|chr1:183052525-183052624,chr1,183052525,183052624,IMR90|chr1:182809335-182809358,chr1,182809335,182809358,1,243190
IMR90|chr1:183057044-183057146,chr1,183057044,183057146,IMR90|chr1:205090786-205090834,chr1,205090786,205090834,1,22033742
IMR90|chr1:183057044-183057145,chr1,183057044,183057145,IMR90|chr1:205090786-205090834,chr1,205090786,205090834,1,22033742
IMR90|chr1:183057077-183057227,chr1,183057077,183057227,IMR90|chr1:205090786-205090834,chr1,205090786,205090834,1,22033709
IMR90|chr1:183073555-183073580,chr1,183073555,183073580,IMR90|chr1:150124614-150124702,chr1,150124614,150124702,1,32948941
IMR90|chr1:183108061-183108209,chr1,183108061,183108209,IMR90|chr1:1255670-1255710,chr1,1255670,1255710,1,181852391
IMR90|chr1:183108100-183108209,chr1,183108100,183108209,IMR90|chr1:1255670-1255710,chr1,1255670,1255710,1,181852430
IMR90|chr1:183108100-183108205,chr1,183108100,183108205,IMR90|chr1:1255669-1255713,chr1,1255669,1255713,1,181852431
IMR90|chr1:193184926-193185023,chr1,193184926,193185023,IMR90|chr1:223902186-223902267,chr1,223902186,223902267,1,30717260
IMR90|chr1:193184926-193184984,chr1,193184926,193184984,IMR90|chr1:223902186-223902267,chr1,223902186,223902267,1,30717260
IMR90|chr1:193184931-193185022,chr1,193184931,193185022,IMR90|chr1:223902186-223902267,chr1,223902186,223902267,1,30717255
IMR90|chr1:200384909-200384961,chr1,200384909,200384961,IMR90|chr1:200379821-200379880,chr1,200379821,200379880,1,5088
IMR90|chr1:200384909-200384958,chr1,200384909,200384958,IMR90|chr1:200381739-200381781,chr1,200381739,200381781,1,3170
IMR90|chr1:200386578-200386661,chr1,200386578,200386661,IMR90|chr1:200384029-200384172,chr1,200384029,200384172,1,2549
IMR90|chr1:200452229-200452316,chr1,200452229,200452316,IMR90|chr1:200381738-200381781,chr1,200381738,200381781,1,70491
IMR90|chr1:200452229-200452308,chr1,200452229,200452308,IMR90|chr1:200381748-200381781,chr1,200381748,200381781,1,70481
IMR90|chr1:200452229-200452288,chr1,200452229,200452288,IMR90|chr1:200379424-200379441,chr1,200379424,200379441,1,72805
IMR90|chr1:201423969-201424040,chr1,201423969,201424040,IMR90|chr1:162532853-162532902,chr1,162532853,162532902,1,38891116
IMR90|chr1:201423969-201424038,chr1,201423969,201424038,IMR90|chr1:162532853-162532902,chr1,162532853,162532902,1,38891116
IMR90|chr1:201504585-201504629,chr1,201504585,201504629,IMR90|chr1:201620789-201620875,chr1,201620789,201620875,1,116204
IMR90|chr1:201509473-201509595,chr1,201509473,201509595,IMR90|chr1:201434533-201434558,chr1,201434533,201434558,1,74940
IMR90|chr1:201509476-201509595,chr1,201509476,201509595,IMR90|chr1:201434533-201434558,chr1,201434533,201434558,1,74943
IMR90|chr1:201511884-201512001,chr1,201511884,201512001,IMR90|chr1:201708065-201708092,chr1,201708065,201708092,1,196181
IMR90|chr1:201511884-201512000,chr1,201511884,201512000,IMR90|chr1:201708065-201708092,chr1,201708065,201708092,1,196181
IMR90|chr1:201517900-201517930,chr1,201517900,201517930,IMR90|chr1:201707075-201707177,chr1,201707075,201707177,1,189175
IMR90|chr1:201530414-201530462,chr1,201530414,201530462,IMR90|chr1:180125883-180125941,chr1,180125883,180125941,1,21404531
IMR90|chr1:201530414-201530461,chr1,201530414,201530461,IMR90|chr1:180125883-180125941,chr1,180125883,180125941,1,21404531
IMR90|chr1:201547975-201548030,chr1,201547975,201548030,IMR90|chr1:201440319-201440404,chr1,201440319,201440404,1,107656
IMR90|chr1:201554206-201554300,chr1,201554206,201554300,IMR90|chr1:26147788-26147809,chr1,26147788,26147809,1,175406418
IMR90|chr1:201554206-201554299,chr1,201554206,201554299,IMR90|chr1:26147788-26147809,chr1,26147788,26147809,1,175406418
IMR90|chr1:201573903-201573939,chr1,201573903,201573939,IMR90|chr1:201619888-201619941,chr1,201619888,201619941,1,45985
IMR90|chr1:201600698-201600743,chr1,201600698,201600743,IMR90|chr1:179111360-179111403,chr1,179111360,179111403,1,22489338
IMR90|chr1:201603799-201603882,chr1,201603799,201603882,IMR90|chr1:221911416-221911435,chr1,221911416,221911435,1,20307617
IMR90|chr1:201603801-201603882,chr1,201603801,201603882,IMR90|chr1:221911416-221911435,chr1,221911416,221911435,1,20307615
IMR90|chr1:201605348-201605463,chr1,201605348,201605463,IMR90|chr1:165600519-165600565,chr1,165600519,165600565,1,36004829
IMR90|chr1:201605364-201605465,chr1,201605364,201605465,IMR90|chr1:165600519-165600565,chr1,165600519,165600565,1,36004845
IMR90|chr1:201629854-201629892,chr1,201629854,201629892,IMR90|chr1:221911147-221911227,chr1,221911147,221911227,1,20281293
IMR90|chr1:201629855-201629893,chr1,201629855,201629893,IMR90|chr1:221911147-221911227,chr1,221911147,221911227,1,20281292
IMR90|chr1:201672901-201672956,chr1,201672901,201672956,IMR90|chr1:212964775-212964840,chr1,212964775,212964840,1,11291874
IMR90|chr1:201673341-201673406,chr1,201673341,201673406,IMR90|chr1:57042661-57042705,chr1,57042661,57042705,1,144630680
IMR90|chr1:201673344-201673406,chr1,201673344,201673406,IMR90|chr1:57042661-57042705,chr1,57042661,57042705,1,144630683
IMR90|chr1:201683244-201683313,chr1,201683244,201683313,IMR90|chr1:1714214-1714244,chr1,1714214,1714244,1,199969030
IMR90|chr1:201683244-201683312,chr1,201683244,201683312,IMR90|chr1:1714214-1714244,chr1,1714214,1714244,1,199969030
IMR90|chr1:201693419-201693508,chr1,201693419,201693508,IMR90|chr1:203597399-203597440,chr1,203597399,203597440,1,1903980
IMR90|chr1:201718137-201718211,chr1,201718137,201718211,IMR90|chr1:22376429-22376471,chr1,22376429,22376471,1,179341708
IMR90|chr1:201728789-201728815,chr1,201728789,201728815,IMR90|chr1:227751790-227751894,chr1,227751790,227751894,1,26023001
IMR90|chr1:201740271-201740366,chr1,201740271,201740366,IMR90|chr1:173828380-173828444,chr1,173828380,173828444,1,27911891
IMR90|chr1:203612421-203612476,chr1,203612421,203612476,IMR90|chr1:145571705-145571750,chr1,145571705,145571750,1,58040716
IMR90|chr1:203614312-203614377,chr1,203614312,203614377,IMR90|chr1:8936518-8936542,chr1,8936518,8936542,1,194677794
IMR90|chr1:203645424-203645481,chr1,203645424,203645481,IMR90|chr1:203765175-203765226,chr1,203765175,203765226,1,119751
IMR90|chr1:203645425-203645481,chr1,203645425,203645481,IMR90|chr1:203765175-203765226,chr1,203765175,203765226,1,119750
IMR90|chr1:203661477-203661533,chr1,203661477,203661533,IMR90|chr1:95005545-95005610,chr1,95005545,95005610,1,108655932
IMR90|chr1:203661478-203661533,chr1,203661478,203661533,IMR90|chr1:95005560-95005610,chr1,95005560,95005610,1,108655918
IMR90|chr1:205158782-205158808,chr1,205158782,205158808,IMR90|chr1:1820119-1820266,chr1,1820119,1820266,1,203338663
IMR90|chr1:205172307-205172390,chr1,205172307,205172390,IMR90|chr1:23038661-23038694,chr1,23038661,23038694,1,182133646
IMR90|chr1:205172308-205172390,chr1,205172308,205172390,IMR90|chr1:23038661-23038694,chr1,23038661,23038694,1,182133647
IMR90|chr1:206129091-206129132,chr1,206129091,206129132,IMR90|chr1:156865818-156865863,chr1,156865818,156865863,1,49263273
IMR90|chr1:208265167-208265228,chr1,208265167,208265228,IMR90|chr1:227916656-227916729,chr1,227916656,227916729,1,19651489
IMR90|chr1:208265167-208265213,chr1,208265167,208265213,IMR90|chr1:227916656-227916729,chr1,227916656,227916729,1,19651489
IMR90|chr1:208279675-208279697,chr1,208279675,208279697,IMR90|chr1:29506313-29506406,chr1,29506313,29506406,1,178773362
IMR90|chr1:208284432-208284564,chr1,208284432,208284564,IMR90|chr1:27322363-27322422,chr1,27322363,27322422,1,180962069
IMR90|chr1:208284473-208284564,chr1,208284473,208284564,IMR90|chr1:27322363-27322422,chr1,27322363,27322422,1,180962110
IMR90|chr1:208287185-208287249,chr1,208287185,208287249,IMR90|chr1:27321406-27321497,chr1,27321406,27321497,1,180965779
IMR90|chr1:208287190-208287249,chr1,208287190,208287249,IMR90|chr1:27321406-27321497,chr1,27321406,27321497,1,180965784
IMR90|chr1:208372036-208372118,chr1,208372036,208372118,IMR90|chr1:162606170-162606204,chr1,162606170,162606204,1,45765866
IMR90|chr1:208372036-208372117,chr1,208372036,208372117,IMR90|chr1:162606170-162606204,chr1,162606170,162606204,1,45765866
IMR90|chr1:208375601-208375633,chr1,208375601,208375633,IMR90|chr1:220222335-220222402,chr1,220222335,220222402,1,11846734
IMR90|chr1:208375601-208375632,chr1,208375601,208375632,IMR90|chr1:220222336-220222402,chr1,220222336,220222402,1,11846735
IMR90|chr1:208385059-208385166,chr1,208385059,208385166,IMR90|chr1:173447038-173447112,chr1,173447038,173447112,1,34938021
IMR90|chr1:208385095-208385167,chr1,208385095,208385167,IMR90|chr1:173447038-173447112,chr1,173447038,173447112,1,34938057
IMR90|chr1:208398509-208398558,chr1,208398509,208398558,IMR90|chr1:173831389-173831460,chr1,173831389,173831460,1,34567120
IMR90|chr1:208398514-208398558,chr1,208398514,208398558,IMR90|chr1:173831389-173831460,chr1,173831389,173831460,1,34567125
IMR90|chr1:213268105-213268154,chr1,213268105,213268154,IMR90|chr1:33812912-33812993,chr1,33812912,33812993,1,179455193
IMR90|chr1:214571823-214571908,chr1,214571823,214571908,IMR90|chr1:25074383-25074420,chr1,25074383,25074420,1,189497440
IMR90|chr1:214571823-214571906,chr1,214571823,214571906,IMR90|chr1:25074383-25074420,chr1,25074383,25074420,1,189497440
IMR90|chr1:214574249-214574302,chr1,214574249,214574302,IMR90|chr1:243420113-243420166,chr1,243420113,243420166,1,28845864
IMR90|chr1:214574249-214574301,chr1,214574249,214574301,IMR90|chr1:243420113-243420167,chr1,243420113,243420167,1,28845864
IMR90|chr1:214576014-214576110,chr1,214576014,214576110,IMR90|chr1:214725857-214725909,chr1,214725857,214725909,1,149843
IMR90|chr1:214576020-214576110,chr1,214576020,214576110,IMR90|chr1:214725857-214725909,chr1,214725857,214725909,1,149837
IMR90|chr1:214594154-214594205,chr1,214594154,214594205,IMR90|chr1:33501974-33502007,chr1,33501974,33502007,1,181092180
IMR90|chr1:214608116-214608146,chr1,214608116,214608146,IMR90|chr1:173830433-173830545,chr1,173830433,173830545,1,40777683
IMR90|chr1:214608116-214608145,chr1,214608116,214608145,IMR90|chr1:173830433-173830545,chr1,173830433,173830545,1,40777683
IMR90|chr1:214612797-214612848,chr1,214612797,214612848,IMR90|chr1:220442805-220442941,chr1,220442805,220442941,1,5830008
IMR90|chr1:214615105-214615224,chr1,214615105,214615224,IMR90|chr1:94702468-94702554,chr1,94702468,94702554,1,119912637
IMR90|chr1:214615168-214615226,chr1,214615168,214615226,IMR90|chr1:94702468-94702554,chr1,94702468,94702554,1,119912700
IMR90|chr1:214615172-214615226,chr1,214615172,214615226,IMR90|chr1:94702468-94702554,chr1,94702468,94702554,1,119912704
IMR90|chr1:214618225-214618271,chr1,214618225,214618271,IMR90|chr1:220443595-220443660,chr1,220443595,220443660,1,5825370
IMR90|chr1:214618228-214618271,chr1,214618228,214618271,IMR90|chr1:220443595-220443660,chr1,220443595,220443660,1,5825367
IMR90|chr1:214625605-214625700,chr1,214625605,214625700,IMR90|chr1:173831991-173832013,chr1,173831991,173832013,1,40793614
IMR90|chr1:214683808-214683874,chr1,214683808,214683874,IMR90|chr1:213225449-213225500,chr1,213225449,213225500,1,1458359
IMR90|chr1:214683843-214683874,chr1,214683843,214683874,IMR90|chr1:213225449-213225500,chr1,213225449,213225500,1,1458394
IMR90|chr1:214690905-214691006,chr1,214690905,214691006,IMR90|chr1:243416615-243416651,chr1,243416615,243416651,1,28725710
IMR90|chr1:214690907-214691006,chr1,214690907,214691006,IMR90|chr1:243416615-243416651,chr1,243416615,243416651,1,28725708
IMR90|chr1:214705508-214705574,chr1,214705508,214705574,IMR90|chr1:154530175-154530228,chr1,154530175,154530228,1,60175333
IMR90|chr1:214812534-214812606,chr1,214812534,214812606,IMR90|chr1:214722548-214722600,chr1,214722548,214722600,1,89986
IMR90|chr1:223905367-223905390,chr1,223905367,223905390,IMR90|chr1:182993599-182993657,chr1,182993599,182993657,1,40911768
IMR90|chr1:223907086-223907167,chr1,223907086,223907167,IMR90|chr1:22380841-22380873,chr1,22380841,22380873,1,201526245
IMR90|chr1:223907088-223907167,chr1,223907088,223907167,IMR90|chr1:22380841-22380873,chr1,22380841,22380873,1,201526247
IMR90|chr1:223911140-223911161,chr1,223911140,223911161,IMR90|chr1:182993599-182993657,chr1,182993599,182993657,1,40917541
IMR90|chr1:223917485-223917534,chr1,223917485,223917534,IMR90|chr1:161086759-161086866,chr1,161086759,161086866,1,62830726
IMR90|chr1:223917485-223917526,chr1,223917485,223917526,IMR90|chr1:161086759-161086866,chr1,161086759,161086866,1,62830726
IMR90|chr1:223917491-223917534,chr1,223917491,223917534,IMR90|chr1:161086759-161086866,chr1,161086759,161086866,1,62830732
IMR90|chr1:223922492-223922642,chr1,223922492,223922642,IMR90|chr1:8085007-8085037,chr1,8085007,8085037,1,215837485
IMR90|chr1:223922644-223922764,chr1,223922644,223922764,IMR90|chr1:8085007-8085037,chr1,8085007,8085037,1,215837637
IMR90|chr1:223924187-223924260,chr1,223924187,223924260,IMR90|chr1:173175348-173175434,chr1,173175348,173175434,1,50748839
IMR90|chr1:223924187-223924251,chr1,223924187,223924251,IMR90|chr1:173175348-173175434,chr1,173175348,173175434,1,50748839
IMR90|chr1:223927388-223927457,chr1,223927388,223927457,IMR90|chr1:95003552-95003632,chr1,95003552,95003632,1,128923836
IMR90|chr1:223927388-223927420,chr1,223927388,223927420,IMR90|chr1:95003552-95003632,chr1,95003552,95003632,1,128923836
IMR90|chr1:223930453-223930528,chr1,223930453,223930528,IMR90|chr1:54406894-54406969,chr1,54406894,54406969,1,169523559
IMR90|chr1:223930492-223930528,chr1,223930492,223930528,IMR90|chr1:54406855-54406969,chr1,54406855,54406969,1,169523637
IMR90|chr1:223932682-223932744,chr1,223932682,223932744,IMR90|chr1:95006991-95007129,chr1,95006991,95007129,1,128925691
IMR90|chr1:223934407-223934481,chr1,223934407,223934481,IMR90|chr1:222881930-222881985,chr1,222881930,222881985,1,1052477
IMR90|chr1:223942112-223942163,chr1,223942112,223942163,IMR90|chr1:222884430-222884524,chr1,222884430,222884524,1,1057682
IMR90|chr1:223942811-223942893,chr1,223942811,223942893,IMR90|chr1:224620980-224621012,chr1,224620980,224621012,1,678169
IMR90|chr1:223942812-223942893,chr1,223942812,223942893,IMR90|chr1:224620980-224621012,chr1,224620980,224621012,1,678168
IMR90|chr1:223954640-223954760,chr1,223954640,223954760,IMR90|chr1:22384206-22384233,chr1,22384206,22384233,1,201570434
IMR90|chr1:223957348-223957397,chr1,223957348,223957397,IMR90|chr1:203599038-203599139,chr1,203599038,203599139,1,20358310
IMR90|chr1:223957348-223957396,chr1,223957348,223957396,IMR90|chr1:203599103-203599139,chr1,203599103,203599139,1,20358245
IMR90|chr1:223961197-223961233,chr1,223961197,223961233,IMR90|chr1:32574945-32575018,chr1,32574945,32575018,1,191386252
IMR90|chr1:223961198-223961233,chr1,223961198,223961233,IMR90|chr1:32574945-32575019,chr1,32574945,32575019,1,191386253
IMR90|chr1:224180983-224181083,chr1,224180983,224181083,IMR90|chr1:715919-715966,chr1,715919,715966,1,223465064
IMR90|chr1:224180988-224181051,chr1,224180988,224181051,IMR90|chr1:715921-715958,chr1,715921,715958,1,223465067
IMR90|chr1:224182174-224182285,chr1,224182174,224182285,IMR90|chr1:716005-716144,chr1,716005,716144,1,223466169
IMR90|chr1:224448148-224448264,chr1,224448148,224448264,IMR90|chr1:78227455-78227475,chr1,78227455,78227475,1,146220693
IMR90|chr1:224587517-224587568,chr1,224587517,224587568,IMR90|chr1:149283041-149283073,chr1,149283041,149283073,1,75304476
IMR90|chr1:224814913-224815060,chr1,224814913,224815060,IMR90|chr1:223901424-223901450,chr1,223901424,223901450,1,913489
IMR90|chr1:224814958-224815076,chr1,224814958,224815076,IMR90|chr1:223901424-223901450,chr1,223901424,223901450,1,913534
IMR90|chr1:224822613-224822690,chr1,224822613,224822690,IMR90|chr1:110282718-110282753,chr1,110282718,110282753,1,114539895
IMR90|chr1:224822613-224822689,chr1,224822613,224822689,IMR90|chr1:110282718-110282753,chr1,110282718,110282753,1,114539895
IMR90|chr1:224822618-224822690,chr1,224822618,224822690,IMR90|chr1:110282718-110282753,chr1,110282718,110282753,1,114539900
IMR90|chr1:224822664-224822690,chr1,224822664,224822690,IMR90|chr1:110282718-110282753,chr1,110282718,110282753,1,114539946
IMR90|chr1:224828134-224828190,chr1,224828134,224828190,IMR90|chr1:21502007-21502081,chr1,21502007,21502081,1,203326127
IMR90|chr1:224839551-224839595,chr1,224839551,224839595,IMR90|chr1:223901169-223901276,chr1,223901169,223901276,1,938382
IMR90|chr1:224839552-224839595,chr1,224839552,224839595,IMR90|chr1:223901169-223901276,chr1,223901169,223901276,1,938383
IMR90|chr1:225710231-225710302,chr1,225710231,225710302,IMR90|chr1:43313495-43313556,chr1,43313495,43313556,1,182396736
IMR90|chr1:225715004-225715022,chr1,225715004,225715022,IMR90|chr1:214724784-214724827,chr1,214724784,214724827,1,10990220
IMR90|chr1:225826378-225826458,chr1,225826378,225826458,IMR90|chr1:154196609-154196695,chr1,154196609,154196695,1,71629769
IMR90|chr1:225826378-225826438,chr1,225826378,225826438,IMR90|chr1:154196609-154196695,chr1,154196609,154196695,1,71629769
IMR90|chr1:225826390-225826458,chr1,225826390,225826458,IMR90|chr1:154196656-154196695,chr1,154196656,154196695,1,71629734
IMR90|chr1:227405183-227405246,chr1,227405183,227405246,IMR90|chr1:227128147-227128203,chr1,227128147,227128203,1,277036
IMR90|chr1:227956408-227956466,chr1,227956408,227956466,IMR90|chr1:57042363-57042383,chr1,57042363,57042383,1,170914045
IMR90|chr1:227956408-227956451,chr1,227956408,227956451,IMR90|chr1:57042363-57042383,chr1,57042363,57042383,1,170914045
IMR90|chr1:230218555-230218641,chr1,230218555,230218641,IMR90|chr1:67215309-67215341,chr1,67215309,67215341,1,163003246
IMR90|chr1:230218556-230218641,chr1,230218556,230218641,IMR90|chr1:67215309-67215341,chr1,67215309,67215341,1,163003247
IMR90|chr1:230218556-230218640,chr1,230218556,230218640,IMR90|chr1:67215310-67215341,chr1,67215310,67215341,1,163003246
IMR90|chr1:230242780-230242873,chr1,230242780,230242873,IMR90|chr1:173986948-173986990,chr1,173986948,173986990,1,56255832
IMR90|chr1:230254218-230254283,chr1,230254218,230254283,IMR90|chr1:156086701-156086805,chr1,156086701,156086805,1,74167517
IMR90|chr1:230254218-230254264,chr1,230254218,230254264,IMR90|chr1:156086701-156086805,chr1,156086701,156086805,1,74167517
IMR90|chr1:231537502-231537547,chr1,231537502,231537547,IMR90|chr1:24745522-24745589,chr1,24745522,24745589,1,206791980
IMR90|chr1:232053781-232053857,chr1,232053781,232053857,IMR90|chr1:219348136-219348172,chr1,219348136,219348172,1,12705645
IMR90|chr1:232053787-232053857,chr1,232053787,232053857,IMR90|chr1:219348136-219348172,chr1,219348136,219348172,1,12705651
IMR90|chr1:233324654-233324729,chr1,233324654,233324729,IMR90|chr1:235291849-235291916,chr1,235291849,235291916,1,1967195
IMR90|chr1:236199986-236200047,chr1,236199986,236200047,IMR90|chr1:221914345-221914398,chr1,221914345,221914398,1,14285641
IMR90|chr1:236199989-236200047,chr1,236199989,236200047,IMR90|chr1:221914345-221914379,chr1,221914345,221914379,1,14285644
IMR90|chr1:240465362-240465414,chr1,240465362,240465414,IMR90|chr1:8085007-8085064,chr1,8085007,8085064,1,232380355
IMR90|chr1:240465362-240465413,chr1,240465362,240465413,IMR90|chr1:8085007-8085064,chr1,8085007,8085064,1,232380355
IMR90|chr1:240553705-240553783,chr1,240553705,240553783,IMR90|chr1:162602442-162602510,chr1,162602442,162602510,1,77951263
IMR90|chr1:240553721-240553780,chr1,240553721,240553780,IMR90|chr1:162602439-162602530,chr1,162602439,162602530,1,77951282
IMR90|chr1:240553722-240553780,chr1,240553722,240553780,IMR90|chr1:162602439-162602530,chr1,162602439,162602530,1,77951283
IMR90|chr1:240762616-240762712,chr1,240762616,240762712,IMR90|chr1:182809177-182809215,chr1,182809177,182809215,1,57953439
IMR90|chr1:240762617-240762712,chr1,240762617,240762712,IMR90|chr1:182809177-182809215,chr1,182809177,182809215,1,57953440
IMR90|chr1:243405275-243405296,chr1,243405275,243405296,IMR90|chr1:205717706-205717800,chr1,205717706,205717800,1,37687569
IMR90|chr1:243408599-243408716,chr1,243408599,243408716,IMR90|chr1:219347314-219347352,chr1,219347314,219347352,1,24061285
IMR90|chr1:243408605-243408716,chr1,243408605,243408716,IMR90|chr1:219347314-219347352,chr1,219347314,219347352,1,24061291
IMR90|chr1:245958771-245958846,chr1,245958771,245958846,IMR90|chr1:156253166-156253241,chr1,156253166,156253241,1,89705605
IMR90|chr1:245958826-245958847,chr1,245958826,245958847,IMR90|chr1:156253167-156253293,chr1,156253167,156253293,1,89705659
IMR90|chr1:246158568-246158634,chr1,246158568,246158634,IMR90|chr1:27322903-27323053,chr1,27322903,27323053,1,218835665
IMR90|chr1:246303092-246303141,chr1,246303092,246303141,IMR90|chr1:155024646-155024750,chr1,155024646,155024750,1,91278446
IMR90|chr1:246305859-246305905,chr1,246305859,246305905,IMR90|chr1:155024646-155024750,chr1,155024646,155024750,1,91281213
IMR90|chr1:246341691-246341737,chr1,246341691,246341737,IMR90|chr1:2345970-2346065,chr1,2345970,2346065,1,243995721
IMR90|chr1:246341692-246341737,chr1,246341692,246341737,IMR90|chr1:2345970-2346065,chr1,2345970,2346065,1,243995722
IMR90|chr1:246796666-246796758,chr1,246796666,246796758,IMR90|chr1:1820362-1820411,chr1,1820362,1820411,1,244976304
IMR90|chr1:246936170-246936224,chr1,246936170,246936224,IMR90|chr1:247496642-247496700,chr1,247496642,247496700,1,560472
IMR90|chr1:246936170-246936204,chr1,246936170,246936204,IMR90|chr1:247496642-247496700,chr1,247496642,247496700,1,560472
IMR90|chr1:247502202-247502278,chr1,247502202,247502278,IMR90|chr1:247497847-247497917,chr1,247497847,247497917,1,4355
IMR90|chr1:247502973-247503050,chr1,247502973,247503050,IMR90|chr1:247498108-247498129,chr1,247498108,247498129,1,4865
IMR90|chr1:247502974-247503050,chr1,247502974,247503050,IMR90|chr1:247498108-247498130,chr1,247498108,247498130,1,4866
IMR90|chr1:247503161-247503277,chr1,247503161,247503277,IMR90|chr1:247498524-247498571,chr1,247498524,247498571,1,4637
IMR90|chr1:247503161-247503264,chr1,247503161,247503264,IMR90|chr1:247498524-247498571,chr1,247498524,247498571,1,4637
IMR90|chr1:247504495-247504593,chr1,247504495,247504593,IMR90|chr1:247495583-247495609,chr1,247495583,247495609,1,8912
IMR90|chr1:247504495-247504592,chr1,247504495,247504592,IMR90|chr1:247495583-247495609,chr1,247495583,247495609,1,8912
IMR90|chr1:247504775-247504876,chr1,247504775,247504876,IMR90|chr1:247499893-247499945,chr1,247499893,247499945,1,4882
IMR90|chr1:247504775-247504875,chr1,247504775,247504875,IMR90|chr1:247499894-247499945,chr1,247499894,247499945,1,4881
IMR90|chr1:247504775-247504873,chr1,247504775,247504873,IMR90|chr1:247499893-247499945,chr1,247499893,247499945,1,4882
IMR90|chr1:247504775-247504824,chr1,247504775,247504824,IMR90|chr1:247499893-247499945,chr1,247499893,247499945,1,4882
IMR90|chr1:247505038-247505123,chr1,247505038,247505123,IMR90|chr1:247498734-247498760,chr1,247498734,247498760,1,6304
IMR90|chr1:247506213-247506247,chr1,247506213,247506247,IMR90|chr1:43425569-43425682,chr1,43425569,43425682,1,204080644
IMR90|chr1:247506213-247506246,chr1,247506213,247506246,IMR90|chr1:43425601-43425682,chr1,43425601,43425682,1,204080612
IMR90|chr1:247506213-247506245,chr1,247506213,247506245,IMR90|chr1:43425569-43425682,chr1,43425569,43425682,1,204080644
IMR90|chr2:1708036-1708083,chr2,1708036,1708083,IMR90|chr2:47402043-47402128,chr2,47402043,47402128,1,45694007
IMR90|chr2:1708038-1708083,chr2,1708038,1708083,IMR90|chr2:47402043-47402128,chr2,47402043,47402128,1,45694005
IMR90|chr2:1709833-1709893,chr2,1709833,1709893,IMR90|chr2:192546902-192546936,chr2,192546902,192546936,1,190837069
IMR90|chr2:1709834-1709893,chr2,1709834,1709893,IMR90|chr2:192546902-192546936,chr2,192546902,192546936,1,190837068
IMR90|chr2:1741371-1741475,chr2,1741371,1741475,IMR90|chr2:192544209-192544263,chr2,192544209,192544263,1,190802838
IMR90|chr2:1741379-1741475,chr2,1741379,1741475,IMR90|chr2:192544209-192544263,chr2,192544209,192544263,1,190802830
IMR90|chr2:9389422-9389466,chr2,9389422,9389466,IMR90|chr2:36586611-36586694,chr2,36586611,36586694,1,27197189
IMR90|chr2:9400124-9400173,chr2,9400124,9400173,IMR90|chr2:73052647-73052742,chr2,73052647,73052742,1,63652523
IMR90|chr2:9400125-9400173,chr2,9400125,9400173,IMR90|chr2:73052647-73052742,chr2,73052647,73052742,1,63652522
IMR90|chr2:9400214-9400269,chr2,9400214,9400269,IMR90|chr2:73052647-73052742,chr2,73052647,73052742,1,63652433
IMR90|chr2:9428504-9428546,chr2,9428504,9428546,IMR90|chr2:265671-265752,chr2,265671,265752,1,9162833
IMR90|chr2:9451261-9451307,chr2,9451261,9451307,IMR90|chr2:9615848-9615918,chr2,9615848,9615918,1,164587
IMR90|chr2:9451262-9451307,chr2,9451262,9451307,IMR90|chr2:9615871-9615919,chr2,9615871,9615919,1,164609
IMR90|chr2:9473646-9473760,chr2,9473646,9473760,IMR90|chr2:242444044-242444120,chr2,242444044,242444120,1,232970398
IMR90|chr2:9473647-9473741,chr2,9473647,9473741,IMR90|chr2:242444044-242444120,chr2,242444044,242444120,1,232970397
IMR90|chr2:9473686-9473760,chr2,9473686,9473760,IMR90|chr2:242444044-242444120,chr2,242444044,242444120,1,232970358
IMR90|chr2:9473697-9473783,chr2,9473697,9473783,IMR90|chr2:85639845-85639891,chr2,85639845,85639891,1,76166148
IMR90|chr2:9473698-9473783,chr2,9473698,9473783,IMR90|chr2:85639845-85639892,chr2,85639845,85639892,1,76166147
IMR90|chr2:9480671-9480763,chr2,9480671,9480763,IMR90|chr2:232651695-232651771,chr2,232651695,232651771,1,223171024
IMR90|chr2:9480690-9480763,chr2,9480690,9480763,IMR90|chr2:232651695-232651771,chr2,232651695,232651771,1,223171005
IMR90|chr2:9480732-9480763,chr2,9480732,9480763,IMR90|chr2:232651695-232651771,chr2,232651695,232651771,1,223170963
IMR90|chr2:11384637-11384777,chr2,11384637,11384777,IMR90|chr2:55274729-55274771,chr2,55274729,55274771,1,43890092
IMR90|chr2:11384669-11384777,chr2,11384669,11384777,IMR90|chr2:55274729-55274771,chr2,55274729,55274771,1,43890060
IMR90|chr2:11444197-11444251,chr2,11444197,11444251,IMR90|chr2:174828255-174828303,chr2,174828255,174828303,1,163384058
IMR90|chr2:11476515-11476618,chr2,11476515,11476618,IMR90|chr2:198315923-198316073,chr2,198315923,198316073,1,186839408
IMR90|chr2:11476549-11476618,chr2,11476549,11476618,IMR90|chr2:198315923-198316073,chr2,198315923,198316073,1,186839374
IMR90|chr2:23631974-23632057,chr2,23631974,23632057,IMR90|chr2:43822657-43822774,chr2,43822657,43822774,1,20190683
IMR90|chr2:23631974-23632007,chr2,23631974,23632007,IMR90|chr2:43822657-43822774,chr2,43822657,43822774,1,20190683
IMR90|chr2:23631974-23632006,chr2,23631974,23632006,IMR90|chr2:43822657-43822774,chr2,43822657,43822774,1,20190683
IMR90|chr2:23977954-23978025,chr2,23977954,23978025,IMR90|chr2:24715112-24715160,chr2,24715112,24715160,1,737158
IMR90|chr2:24955120-24955254,chr2,24955120,24955254,IMR90|chr2:37383559-37383613,chr2,37383559,37383613,1,12428439
IMR90|chr2:24955158-24955254,chr2,24955158,24955254,IMR90|chr2:37383559-37383613,chr2,37383559,37383613,1,12428401
IMR90|chr2:32979266-32979291,chr2,32979266,32979291,IMR90|chr2:218766245-218766337,chr2,218766245,218766337,1,185786979
IMR90|chr2:32979267-32979291,chr2,32979267,32979291,IMR90|chr2:218766245-218766337,chr2,218766245,218766337,1,185786978
IMR90|chr2:33368962-33368986,chr2,33368962,33368986,IMR90|chr2:54197349-54197475,chr2,54197349,54197475,1,20828387
IMR90|chr2:33368963-33368987,chr2,33368963,33368987,IMR90|chr2:54197349-54197475,chr2,54197349,54197475,1,20828386
IMR90|chr2:33433754-33433778,chr2,33433754,33433778,IMR90|chr2:55273050-55273192,chr2,55273050,55273192,1,21839296
IMR90|chr2:33460676-33460785,chr2,33460676,33460785,IMR90|chr2:36586865-36586945,chr2,36586865,36586945,1,3126189
IMR90|chr2:36593032-36593069,chr2,36593032,36593069,IMR90|chr2:29095011-29095136,chr2,29095011,29095136,1,7498021
IMR90|chr2:36593033-36593069,chr2,36593033,36593069,IMR90|chr2:29095011-29095136,chr2,29095011,29095136,1,7498022
IMR90|chr2:36595074-36595130,chr2,36595074,36595130,IMR90|chr2:33362856-33362945,chr2,33362856,33362945,1,3232218
IMR90|chr2:36595074-36595129,chr2,36595074,36595129,IMR90|chr2:33362856-33362945,chr2,33362856,33362945,1,3232218
IMR90|chr2:36601135-36601224,chr2,36601135,36601224,IMR90|chr2:37894806-37894853,chr2,37894806,37894853,1,1293671
IMR90|chr2:36604268-36604333,chr2,36604268,36604333,IMR90|chr2:33822954-33823026,chr2,33822954,33823026,1,2781314
IMR90|chr2:36604580-36604656,chr2,36604580,36604656,IMR90|chr2:15733243-15733317,chr2,15733243,15733317,1,20871337
IMR90|chr2:36607758-36607822,chr2,36607758,36607822,IMR90|chr2:47400223-47400257,chr2,47400223,47400257,1,10792465
IMR90|chr2:36612756-36612779,chr2,36612756,36612779,IMR90|chr2:101868747-101868874,chr2,101868747,101868874,1,65255991
IMR90|chr2:36646123-36646194,chr2,36646123,36646194,IMR90|chr2:37898440-37898476,chr2,37898440,37898476,1,1252317
IMR90|chr2:36652057-36652085,chr2,36652057,36652085,IMR90|chr2:61698247-61698286,chr2,61698247,61698286,1,25046190
IMR90|chr2:36654072-36654142,chr2,36654072,36654142,IMR90|chr2:33361204-33361275,chr2,33361204,33361275,1,3292868
IMR90|chr2:36662178-36662243,chr2,36662178,36662243,IMR90|chr2:33360612-33360673,chr2,33360612,33360673,1,3301566
IMR90|chr2:36662179-36662243,chr2,36662179,36662243,IMR90|chr2:33360612-33360673,chr2,33360612,33360673,1,3301567
IMR90|chr2:36671883-36671968,chr2,36671883,36671968,IMR90|chr2:33822849-33822879,chr2,33822849,33822879,1,2849034
IMR90|chr2:36672181-36672264,chr2,36672181,36672264,IMR90|chr2:47400774-47400831,chr2,47400774,47400831,1,10728593
IMR90|chr2:36679554-36679618,chr2,36679554,36679618,IMR90|chr2:33361531-33361597,chr2,33361531,33361597,1,3318023
IMR90|chr2:36679585-36679618,chr2,36679585,36679618,IMR90|chr2:33361531-33361597,chr2,33361531,33361597,1,3318054
IMR90|chr2:36707202-36707246,chr2,36707202,36707246,IMR90|chr2:47402318-47402387,chr2,47402318,47402387,1,10695116
IMR90|chr2:36709005-36709080,chr2,36709005,36709080,IMR90|chr2:37898425-37898477,chr2,37898425,37898477,1,1189420
IMR90|chr2:36719829-36719945,chr2,36719829,36719945,IMR90|chr2:15732460-15732494,chr2,15732460,15732494,1,20987369
IMR90|chr2:36719829-36719930,chr2,36719829,36719930,IMR90|chr2:15732460-15732494,chr2,15732460,15732494,1,20987369
IMR90|chr2:36748875-36748927,chr2,36748875,36748927,IMR90|chr2:33823666-33823732,chr2,33823666,33823732,1,2925209
IMR90|chr2:36748875-36748925,chr2,36748875,36748925,IMR90|chr2:33823666-33823732,chr2,33823666,33823732,1,2925209
IMR90|chr2:36750660-36750740,chr2,36750660,36750740,IMR90|chr2:218767138-218767176,chr2,218767138,218767176,1,182016478
IMR90|chr2:36750660-36750739,chr2,36750660,36750739,IMR90|chr2:218767138-218767176,chr2,218767138,218767176,1,182016478
IMR90|chr2:36754812-36754862,chr2,36754812,36754862,IMR90|chr2:101868475-101868557,chr2,101868475,101868557,1,65113663
IMR90|chr2:36754813-36754862,chr2,36754813,36754862,IMR90|chr2:101868475-101868557,chr2,101868475,101868557,1,65113662
IMR90|chr2:36755178-36755206,chr2,36755178,36755206,IMR90|chr2:47400739-47400758,chr2,47400739,47400758,1,10645561
IMR90|chr2:36763793-36763891,chr2,36763793,36763891,IMR90|chr2:37894502-37894541,chr2,37894502,37894541,1,1130709
IMR90|chr2:36765109-36765159,chr2,36765109,36765159,IMR90|chr2:37898344-37898436,chr2,37898344,37898436,1,1133235
IMR90|chr2:36765110-36765159,chr2,36765110,36765159,IMR90|chr2:37898344-37898436,chr2,37898344,37898436,1,1133234
IMR90|chr2:36767801-36767887,chr2,36767801,36767887,IMR90|chr2:218768060-218768121,chr2,218768060,218768121,1,182000259
IMR90|chr2:36767818-36767888,chr2,36767818,36767888,IMR90|chr2:218768045-218768120,chr2,218768045,218768120,1,182000227
IMR90|chr2:36792709-36792791,chr2,36792709,36792791,IMR90|chr2:36584871-36584887,chr2,36584871,36584887,1,207838
IMR90|chr2:36793142-36793240,chr2,36793142,36793240,IMR90|chr2:36585525-36585645,chr2,36585525,36585645,1,207617
IMR90|chr2:36793213-36793240,chr2,36793213,36793240,IMR90|chr2:36585525-36585645,chr2,36585525,36585645,1,207688
IMR90|chr2:36793218-36793240,chr2,36793218,36793240,IMR90|chr2:36585525-36585645,chr2,36585525,36585645,1,207693
IMR90|chr2:37860896-37860938,chr2,37860896,37860938,IMR90|chr2:37898288-37898396,chr2,37898288,37898396,1,37392
IMR90|chr2:37860898-37860954,chr2,37860898,37860954,IMR90|chr2:37898288-37898396,chr2,37898288,37898396,1,37390
IMR90|chr2:37867560-37867620,chr2,37867560,37867620,IMR90|chr2:37894781-37894852,chr2,37894781,37894852,1,27221
IMR90|chr2:37867560-37867618,chr2,37867560,37867618,IMR90|chr2:37894781-37894852,chr2,37894781,37894852,1,27221
IMR90|chr2:37867757-37867859,chr2,37867757,37867859,IMR90|chr2:37894595-37894618,chr2,37894595,37894618,1,26838
IMR90|chr2:37867841-37867897,chr2,37867841,37867897,IMR90|chr2:37894595-37894618,chr2,37894595,37894618,1,26754
IMR90|chr2:37868737-37868841,chr2,37868737,37868841,IMR90|chr2:37895882-37895936,chr2,37895882,37895936,1,27145
IMR90|chr2:37868749-37868841,chr2,37868749,37868841,IMR90|chr2:37895882-37895936,chr2,37895882,37895936,1,27133
IMR90|chr2:39724235-39724264,chr2,39724235,39724264,IMR90|chr2:102091302-102091390,chr2,102091302,102091390,1,62367067
IMR90|chr2:40581929-40581964,chr2,40581929,40581964,IMR90|chr2:242629763-242629876,chr2,242629763,242629876,1,202047834
IMR90|chr2:40633756-40633819,chr2,40633756,40633819,IMR90|chr2:216300208-216300316,chr2,216300208,216300316,1,175666452
IMR90|chr2:40633756-40633785,chr2,40633756,40633785,IMR90|chr2:216300208-216300316,chr2,216300208,216300316,1,175666452
IMR90|chr2:40649521-40649539,chr2,40649521,40649539,IMR90|chr2:216298509-216298625,chr2,216298509,216298625,1,175648988
IMR90|chr2:42422582-42422648,chr2,42422582,42422648,IMR90|chr2:55513000-55513134,chr2,55513000,55513134,1,13090418
IMR90|chr2:42425638-42425751,chr2,42425638,42425751,IMR90|chr2:55512578-55512608,chr2,55512578,55512608,1,13086940
IMR90|chr2:42425638-42425747,chr2,42425638,42425747,IMR90|chr2:55512578-55512608,chr2,55512578,55512608,1,13086940
IMR90|chr2:46931576-46931681,chr2,46931576,46931681,IMR90|chr2:70121400-70121457,chr2,70121400,70121457,1,23189824
IMR90|chr2:46931588-46931681,chr2,46931588,46931681,IMR90|chr2:70121400-70121457,chr2,70121400,70121457,1,23189812
IMR90|chr2:46947361-46947459,chr2,46947361,46947459,IMR90|chr2:201451519-201451571,chr2,201451519,201451571,1,154504158
IMR90|chr2:46947380-46947459,chr2,46947380,46947459,IMR90|chr2:201451519-201451586,chr2,201451519,201451586,1,154504139
IMR90|chr2:47186598-47186686,chr2,47186598,47186686,IMR90|chr2:47139976-47140033,chr2,47139976,47140033,1,46622
IMR90|chr2:47186598-47186685,chr2,47186598,47186685,IMR90|chr2:47139976-47140033,chr2,47139976,47140033,1,46622
IMR90|chr2:47189750-47189779,chr2,47189750,47189779,IMR90|chr2:47141963-47142064,chr2,47141963,47142064,1,47787
IMR90|chr2:47274583-47274611,chr2,47274583,47274611,IMR90|chr2:73337978-73338045,chr2,73337978,73338045,1,26063395
IMR90|chr2:54750769-54750814,chr2,54750769,54750814,IMR90|chr2:33361796-33361836,chr2,33361796,33361836,1,21388973
IMR90|chr2:54818099-54818118,chr2,54818099,54818118,IMR90|chr2:74603693-74603771,chr2,74603693,74603771,1,19785594
IMR90|chr2:55220688-55220722,chr2,55220688,55220722,IMR90|chr2:242444561-242444656,chr2,242444561,242444656,1,187223873
IMR90|chr2:55220688-55220721,chr2,55220688,55220721,IMR90|chr2:242444561-242444656,chr2,242444561,242444656,1,187223873
IMR90|chr2:55261546-55261647,chr2,55261546,55261647,IMR90|chr2:85194668-85194732,chr2,85194668,85194732,1,29933122
IMR90|chr2:55261562-55261648,chr2,55261562,55261648,IMR90|chr2:85194668-85194732,chr2,85194668,85194732,1,29933106
IMR90|chr2:55261571-55261648,chr2,55261571,55261648,IMR90|chr2:85194668-85194732,chr2,85194668,85194732,1,29933097
IMR90|chr2:55264709-55264786,chr2,55264709,55264786,IMR90|chr2:64245367-64245404,chr2,64245367,64245404,1,8980658
IMR90|chr2:55264709-55264785,chr2,55264709,55264785,IMR90|chr2:64245367-64245404,chr2,64245367,64245404,1,8980658
IMR90|chr2:55360831-55360876,chr2,55360831,55360876,IMR90|chr2:55458808-55458830,chr2,55458808,55458830,1,97977
IMR90|chr2:55372727-55372801,chr2,55372727,55372801,IMR90|chr2:55458750-55458778,chr2,55458750,55458778,1,86023
IMR90|chr2:55382064-55382144,chr2,55382064,55382144,IMR90|chr2:55276763-55276810,chr2,55276763,55276810,1,105301
IMR90|chr2:55384225-55384308,chr2,55384225,55384308,IMR90|chr2:55273607-55273659,chr2,55273607,55273659,1,110618
IMR90|chr2:55385541-55385566,chr2,55385541,55385566,IMR90|chr2:55274389-55274463,chr2,55274389,55274463,1,111152
IMR90|chr2:61589887-61589937,chr2,61589887,61589937,IMR90|chr2:36586536-36586617,chr2,36586536,36586617,1,25003351
IMR90|chr2:61589889-61589937,chr2,61589889,61589937,IMR90|chr2:36586536-36586617,chr2,36586536,36586617,1,25003353
IMR90|chr2:63038480-63038530,chr2,63038480,63038530,IMR90|chr2:37192690-37192729,chr2,37192690,37192729,1,25845790
IMR90|chr2:63038481-63038530,chr2,63038481,63038530,IMR90|chr2:37192690-37192730,chr2,37192690,37192730,1,25845791
IMR90|chr2:64018170-64018250,chr2,64018170,64018250,IMR90|chr2:192546930-192546969,chr2,192546930,192546969,1,128528760
IMR90|chr2:65614922-65614993,chr2,65614922,65614993,IMR90|chr2:65356082-65356115,chr2,65356082,65356115,1,258840
IMR90|chr2:65614948-65615052,chr2,65614948,65615052,IMR90|chr2:65356082-65356115,chr2,65356082,65356115,1,258866
IMR90|chr2:65623326-65623405,chr2,65623326,65623405,IMR90|chr2:65356523-65356584,chr2,65356523,65356584,1,266803
IMR90|chr2:65623326-65623404,chr2,65623326,65623404,IMR90|chr2:65356523-65356584,chr2,65356523,65356584,1,266803
IMR90|chr2:67491712-67491745,chr2,67491712,67491745,IMR90|chr2:65659540-65659643,chr2,65659540,65659643,1,1832172
IMR90|chr2:67491713-67491745,chr2,67491713,67491745,IMR90|chr2:65659576-65659644,chr2,65659576,65659644,1,1832137
IMR90|chr2:67665726-67665792,chr2,67665726,67665792,IMR90|chr2:67620174-67620224,chr2,67620174,67620224,1,45552
IMR90|chr2:67665727-67665828,chr2,67665727,67665828,IMR90|chr2:67620175-67620224,chr2,67620175,67620224,1,45552
IMR90|chr2:67665727-67665800,chr2,67665727,67665800,IMR90|chr2:67620179-67620224,chr2,67620179,67620224,1,45548
IMR90|chr2:67665727-67665792,chr2,67665727,67665792,IMR90|chr2:67620174-67620224,chr2,67620174,67620224,1,45553
IMR90|chr2:67665727-67665784,chr2,67665727,67665784,IMR90|chr2:67620157-67620224,chr2,67620157,67620224,1,45570
IMR90|chr2:67665727-67665762,chr2,67665727,67665762,IMR90|chr2:67620110-67620224,chr2,67620110,67620224,1,45617
IMR90|chr2:67665727-67665749,chr2,67665727,67665749,IMR90|chr2:67620175-67620224,chr2,67620175,67620224,1,45552
IMR90|chr2:67670683-67670773,chr2,67670683,67670773,IMR90|chr2:67620174-67620224,chr2,67620174,67620224,1,50509
IMR90|chr2:67739907-67739933,chr2,67739907,67739933,IMR90|chr2:55274153-55274249,chr2,55274153,55274249,1,12465754
IMR90|chr2:67739907-67739930,chr2,67739907,67739930,IMR90|chr2:55274150-55274249,chr2,55274150,55274249,1,12465757
IMR90|chr2:67789281-67789326,chr2,67789281,67789326,IMR90|chr2:176046017-176046110,chr2,176046017,176046110,1,108256736
IMR90|chr2:68463253-68463290,chr2,68463253,68463290,IMR90|chr2:71298938-71298995,chr2,71298938,71298995,1,2835685
IMR90|chr2:68463253-68463289,chr2,68463253,68463289,IMR90|chr2:71298938-71298995,chr2,71298938,71298995,1,2835685
IMR90|chr2:68559788-68559898,chr2,68559788,68559898,IMR90|chr2:68478758-68478781,chr2,68478758,68478781,1,81030
IMR90|chr2:68559788-68559846,chr2,68559788,68559846,IMR90|chr2:68478758-68478781,chr2,68478758,68478781,1,81030
IMR90|chr2:69267044-69267120,chr2,69267044,69267120,IMR90|chr2:189162191-189162222,chr2,189162191,189162222,1,119895147
IMR90|chr2:69268288-69268333,chr2,69268288,69268333,IMR90|chr2:189162193-189162223,chr2,189162193,189162223,1,119893905
IMR90|chr2:69270703-69270750,chr2,69270703,69270750,IMR90|chr2:74782165-74782260,chr2,74782165,74782260,1,5511462
IMR90|chr2:69270703-69270749,chr2,69270703,69270749,IMR90|chr2:74782165-74782260,chr2,74782165,74782260,1,5511462
IMR90|chr2:69384232-69384352,chr2,69384232,69384352,IMR90|chr2:73299750-73299779,chr2,73299750,73299779,1,3915518
IMR90|chr2:69384249-69384399,chr2,69384249,69384399,IMR90|chr2:73299750-73299779,chr2,73299750,73299779,1,3915501
IMR90|chr2:69408266-69408363,chr2,69408266,69408363,IMR90|chr2:69869904-69869983,chr2,69869904,69869983,1,461638
IMR90|chr2:69408297-69408365,chr2,69408297,69408365,IMR90|chr2:69869904-69869983,chr2,69869904,69869983,1,461607
IMR90|chr2:69412005-69412073,chr2,69412005,69412073,IMR90|chr2:69869828-69869875,chr2,69869828,69869875,1,457823
IMR90|chr2:69433706-69433756,chr2,69433706,69433756,IMR90|chr2:183580326-183580384,chr2,183580326,183580384,1,114146620
IMR90|chr2:70337570-70337621,chr2,70337570,70337621,IMR90|chr2:70422531-70422594,chr2,70422531,70422594,1,84961
IMR90|chr2:70348875-70348936,chr2,70348875,70348936,IMR90|chr2:70422851-70422909,chr2,70422851,70422909,1,73976
IMR90|chr2:72458126-72458160,chr2,72458126,72458160,IMR90|chr2:37894517-37894559,chr2,37894517,37894559,1,34563609
IMR90|chr2:73044898-73044977,chr2,73044898,73044977,IMR90|chr2:71358457-71358519,chr2,71358457,71358519,1,1686441
IMR90|chr2:74213258-74213385,chr2,74213258,74213385,IMR90|chr2:74231016-74231036,chr2,74231016,74231036,1,17758
IMR90|chr2:74213263-74213380,chr2,74213263,74213380,IMR90|chr2:74231016-74231036,chr2,74231016,74231036,1,17753
IMR90|chr2:74213805-74213833,chr2,74213805,74213833,IMR90|chr2:74230260-74230330,chr2,74230260,74230330,1,16455
IMR90|chr2:74214522-74214594,chr2,74214522,74214594,IMR90|chr2:74227345-74227397,chr2,74227345,74227397,1,12823
IMR90|chr2:84672134-84672205,chr2,84672134,84672205,IMR90|chr2:66666918-66666940,chr2,66666918,66666940,1,18005216
IMR90|chr2:84672135-84672205,chr2,84672135,84672205,IMR90|chr2:66666918-66666940,chr2,66666918,66666940,1,18005217
IMR90|chr2:84709849-84709915,chr2,84709849,84709915,IMR90|chr2:84691003-84691031,chr2,84691003,84691031,1,18846
IMR90|chr2:84717932-84717992,chr2,84717932,84717992,IMR90|chr2:84687750-84687800,chr2,84687750,84687800,1,30182
IMR90|chr2:84717932-84717991,chr2,84717932,84717991,IMR90|chr2:84687750-84687800,chr2,84687750,84687800,1,30182
IMR90|chr2:85170914-85171016,chr2,85170914,85171016,IMR90|chr2:85195642-85195695,chr2,85195642,85195695,1,24728
IMR90|chr2:85173683-85173774,chr2,85173683,85173774,IMR90|chr2:85195578-85195672,chr2,85195578,85195672,1,21895
IMR90|chr2:85173718-85173774,chr2,85173718,85173774,IMR90|chr2:85195578-85195672,chr2,85195578,85195672,1,21860
IMR90|chr2:85174552-85174607,chr2,85174552,85174607,IMR90|chr2:85130191-85130286,chr2,85130191,85130286,1,44361
IMR90|chr2:85175321-85175424,chr2,85175321,85175424,IMR90|chr2:85193297-85193327,chr2,85193297,85193327,1,17976
IMR90|chr2:85175321-85175414,chr2,85175321,85175414,IMR90|chr2:85193297-85193327,chr2,85193297,85193327,1,17976
IMR90|chr2:85175849-85175909,chr2,85175849,85175909,IMR90|chr2:85194545-85194635,chr2,85194545,85194635,1,18696
IMR90|chr2:85175966-85176001,chr2,85175966,85176001,IMR90|chr2:85195580-85195624,chr2,85195580,85195624,1,19614
IMR90|chr2:85175969-85176000,chr2,85175969,85176000,IMR90|chr2:85195607-85195658,chr2,85195607,85195658,1,19638
IMR90|chr2:85177006-85177027,chr2,85177006,85177027,IMR90|chr2:85196761-85196843,chr2,85196761,85196843,1,19755
IMR90|chr2:85177145-85177248,chr2,85177145,85177248,IMR90|chr2:85197640-85197663,chr2,85197640,85197663,1,20495
IMR90|chr2:85177519-85177608,chr2,85177519,85177608,IMR90|chr2:85196204-85196223,chr2,85196204,85196223,1,18685
IMR90|chr2:85180069-85180113,chr2,85180069,85180113,IMR90|chr2:85194057-85194147,chr2,85194057,85194147,1,13988
IMR90|chr2:85182976-85183053,chr2,85182976,85183053,IMR90|chr2:85133262-85133313,chr2,85133262,85133313,1,49714
IMR90|chr2:85184499-85184583,chr2,85184499,85184583,IMR90|chr2:85194890-85195010,chr2,85194890,85195010,1,10391
IMR90|chr2:85184684-85184770,chr2,85184684,85184770,IMR90|chr2:85195016-85195054,chr2,85195016,85195054,1,10332
IMR90|chr2:85185330-85185346,chr2,85185330,85185346,IMR90|chr2:85194671-85194794,chr2,85194671,85194794,1,9341
IMR90|chr2:85186287-85186341,chr2,85186287,85186341,IMR90|chr2:85194423-85194504,chr2,85194423,85194504,1,8136
IMR90|chr2:85186288-85186341,chr2,85186288,85186341,IMR90|chr2:85194423-85194504,chr2,85194423,85194504,1,8135
IMR90|chr2:85186830-85186870,chr2,85186830,85186870,IMR90|chr2:85197526-85197671,chr2,85197526,85197671,1,10696
IMR90|chr2:85188448-85188507,chr2,85188448,85188507,IMR90|chr2:85194201-85194261,chr2,85194201,85194261,1,5753
IMR90|chr2:85188942-85189026,chr2,85188942,85189026,IMR90|chr2:85197658-85197701,chr2,85197658,85197701,1,8716
IMR90|chr2:85189311-85189394,chr2,85189311,85189394,IMR90|chr2:85195636-85195735,chr2,85195636,85195735,1,6325
IMR90|chr2:85189311-85189362,chr2,85189311,85189362,IMR90|chr2:85195636-85195735,chr2,85195636,85195735,1,6325
IMR90|chr2:85189320-85189361,chr2,85189320,85189361,IMR90|chr2:85195624-85195739,chr2,85195624,85195739,1,6304
IMR90|chr2:85189352-85189426,chr2,85189352,85189426,IMR90|chr2:85195689-85195764,chr2,85195689,85195764,1,6337
IMR90|chr2:85189387-85189487,chr2,85189387,85189487,IMR90|chr2:85194328-85194360,chr2,85194328,85194360,1,4941
IMR90|chr2:85190038-85190101,chr2,85190038,85190101,IMR90|chr2:85193944-85194004,chr2,85193944,85194004,1,3906
IMR90|chr2:85190123-85190178,chr2,85190123,85190178,IMR90|chr2:85197479-85197563,chr2,85197479,85197563,1,7356
IMR90|chr2:85190134-85190226,chr2,85190134,85190226,IMR90|chr2:85193944-85193968,chr2,85193944,85193968,1,3810
IMR90|chr2:85190135-85190226,chr2,85190135,85190226,IMR90|chr2:85193944-85193982,chr2,85193944,85193982,1,3809
IMR90|chr2:85190136-85190193,chr2,85190136,85190193,IMR90|chr2:85193944-85193998,chr2,85193944,85193998,1,3808
IMR90|chr2:85190143-85190226,chr2,85190143,85190226,IMR90|chr2:85193944-85194057,chr2,85193944,85194057,1,3801
IMR90|chr2:85190189-85190226,chr2,85190189,85190226,IMR90|chr2:85193944-85194057,chr2,85193944,85194057,1,3755
IMR90|chr2:85190195-85190226,chr2,85190195,85190226,IMR90|chr2:85193944-85193998,chr2,85193944,85193998,1,3749
IMR90|chr2:85190199-85190226,chr2,85190199,85190226,IMR90|chr2:85193944-85194005,chr2,85193944,85194005,1,3745
IMR90|chr2:85191018-85191045,chr2,85191018,85191045,IMR90|chr2:85193193-85193285,chr2,85193193,85193285,1,2175
IMR90|chr2:85191024-85191146,chr2,85191024,85191146,IMR90|chr2:85193395-85193491,chr2,85193395,85193491,1,2371
IMR90|chr2:85191051-85191129,chr2,85191051,85191129,IMR90|chr2:85193933-85194005,chr2,85193933,85194005,1,2882
IMR90|chr2:85191053-85191147,chr2,85191053,85191147,IMR90|chr2:85193933-85194005,chr2,85193933,85194005,1,2880
IMR90|chr2:85191053-85191146,chr2,85191053,85191146,IMR90|chr2:85193933-85194005,chr2,85193933,85194005,1,2880
IMR90|chr2:85191092-85191146,chr2,85191092,85191146,IMR90|chr2:85193395-85193491,chr2,85193395,85193491,1,2303
IMR90|chr2:85191366-85191480,chr2,85191366,85191480,IMR90|chr2:85195826-85195976,chr2,85195826,85195976,1,4460
IMR90|chr2:85191443-85191592,chr2,85191443,85191592,IMR90|chr2:85194342-85194403,chr2,85194342,85194403,1,2899
IMR90|chr2:85191570-85191659,chr2,85191570,85191659,IMR90|chr2:85194342-85194403,chr2,85194342,85194403,1,2772
IMR90|chr2:85191639-85191714,chr2,85191639,85191714,IMR90|chr2:85194921-85195015,chr2,85194921,85195015,1,3282
IMR90|chr2:85221521-85221637,chr2,85221521,85221637,IMR90|chr2:85195530-85195584,chr2,85195530,85195584,1,25991
IMR90|chr2:85221521-85221617,chr2,85221521,85221617,IMR90|chr2:85195530-85195584,chr2,85195530,85195584,1,25991
IMR90|chr2:85225110-85225178,chr2,85225110,85225178,IMR90|chr2:85195915-85195984,chr2,85195915,85195984,1,29195
IMR90|chr2:85237873-85237965,chr2,85237873,85237965,IMR90|chr2:85194317-85194362,chr2,85194317,85194362,1,43556
IMR90|chr2:85237902-85237997,chr2,85237902,85237997,IMR90|chr2:85194317-85194362,chr2,85194317,85194362,1,43585
IMR90|chr2:85992888-85992962,chr2,85992888,85992962,IMR90|chr2:75786736-75786802,chr2,75786736,75786802,1,10206152
IMR90|chr2:85992892-85992962,chr2,85992892,85992962,IMR90|chr2:75786722-75786802,chr2,75786722,75786802,1,10206170
IMR90|chr2:87758400-87758441,chr2,87758400,87758441,IMR90|chr2:96930792-96930909,chr2,96930792,96930909,1,9172392
IMR90|chr2:87758400-87758433,chr2,87758400,87758433,IMR90|chr2:96930792-96930909,chr2,96930792,96930909,1,9172392
IMR90|chr2:87768615-87768730,chr2,87768615,87768730,IMR90|chr2:66674189-66674224,chr2,66674189,66674224,1,21094426
IMR90|chr2:87768621-87768771,chr2,87768621,87768771,IMR90|chr2:66674189-66674224,chr2,66674189,66674224,1,21094432
IMR90|chr2:87776225-87776319,chr2,87776225,87776319,IMR90|chr2:66667525-66667581,chr2,66667525,66667581,1,21108700
IMR90|chr2:87780120-87780177,chr2,87780120,87780177,IMR90|chr2:231579012-231579105,chr2,231579012,231579105,1,143798892
IMR90|chr2:87780120-87780167,chr2,87780120,87780167,IMR90|chr2:231579013-231579116,chr2,231579013,231579116,1,143798893
IMR90|chr2:87780131-87780178,chr2,87780131,87780178,IMR90|chr2:231579013-231579116,chr2,231579013,231579116,1,143798882
IMR90|chr2:87786959-87787054,chr2,87786959,87787054,IMR90|chr2:65659417-65659486,chr2,65659417,65659486,1,22127542
IMR90|chr2:87786974-87787054,chr2,87786974,87787054,IMR90|chr2:65659417-65659486,chr2,65659417,65659486,1,22127557
IMR90|chr2:96907799-96907866,chr2,96907799,96907866,IMR90|chr2:219266714-219266783,chr2,219266714,219266783,1,122358915
IMR90|chr2:96907800-96907866,chr2,96907800,96907866,IMR90|chr2:219266714-219266783,chr2,219266714,219266783,1,122358914
IMR90|chr2:100590099-100590129,chr2,100590099,100590129,IMR90|chr2:105945430-105945499,chr2,105945430,105945499,1,5355331
IMR90|chr2:100590100-100590129,chr2,100590100,100590129,IMR90|chr2:105945430-105945499,chr2,105945430,105945499,1,5355330
IMR90|chr2:100598387-100598468,chr2,100598387,100598468,IMR90|chr2:64245740-64245791,chr2,64245740,64245791,1,36352647
IMR90|chr2:100598387-100598467,chr2,100598387,100598467,IMR90|chr2:64245721-64245791,chr2,64245721,64245791,1,36352666
IMR90|chr2:100598388-100598473,chr2,100598388,100598473,IMR90|chr2:64245721-64245791,chr2,64245721,64245791,1,36352667
IMR90|chr2:100696329-100696383,chr2,100696329,100696383,IMR90|chr2:190539728-190539789,chr2,190539728,190539789,1,89843399
IMR90|chr2:100696331-100696383,chr2,100696331,100696383,IMR90|chr2:190539728-190539789,chr2,190539728,190539789,1,89843397
IMR90|chr2:100696342-100696383,chr2,100696342,100696383,IMR90|chr2:190539728-190539789,chr2,190539728,190539789,1,89843386
IMR90|chr2:101552080-101552125,chr2,101552080,101552125,IMR90|chr2:112896668-112896713,chr2,112896668,112896713,1,11344588
IMR90|chr2:102062080-102062133,chr2,102062080,102062133,IMR90|chr2:64071740-64071819,chr2,64071740,64071819,1,37990340
IMR90|chr2:102320267-102320405,chr2,102320267,102320405,IMR90|chr2:26213000-26213022,chr2,26213000,26213022,1,76107267
IMR90|chr2:102320270-102320378,chr2,102320270,102320378,IMR90|chr2:26212997-26213030,chr2,26212997,26213030,1,76107273
IMR90|chr2:102320273-102320401,chr2,102320273,102320401,IMR90|chr2:26213000-26213022,chr2,26213000,26213022,1,76107273
IMR90|chr2:102323328-102323348,chr2,102323328,102323348,IMR90|chr2:106011919-106012069,chr2,106011919,106012069,1,3688591
IMR90|chr2:102332251-102332328,chr2,102332251,102332328,IMR90|chr2:48542494-48542595,chr2,48542494,48542595,1,53789757
IMR90|chr2:102332280-102332328,chr2,102332280,102332328,IMR90|chr2:48542494-48542595,chr2,48542494,48542595,1,53789786
IMR90|chr2:102338115-102338214,chr2,102338115,102338214,IMR90|chr2:203241438-203241520,chr2,203241438,203241520,1,100903323
IMR90|chr2:102338148-102338216,chr2,102338148,102338216,IMR90|chr2:203241438-203241520,chr2,203241438,203241520,1,100903290
IMR90|chr2:102338148-102338215,chr2,102338148,102338215,IMR90|chr2:203241437-203241520,chr2,203241437,203241520,1,100903289
IMR90|chr2:102362955-102363069,chr2,102362955,102363069,IMR90|chr2:106012209-106012270,chr2,106012209,106012270,1,3649254
IMR90|chr2:102362982-102363071,chr2,102362982,102363071,IMR90|chr2:106012209-106012270,chr2,106012209,106012270,1,3649227
IMR90|chr2:102374953-102375103,chr2,102374953,102375103,IMR90|chr2:102758193-102758229,chr2,102758193,102758229,1,383240
IMR90|chr2:102374991-102375105,chr2,102374991,102375105,IMR90|chr2:102758193-102758229,chr2,102758193,102758229,1,383202
IMR90|chr2:102461661-102461685,chr2,102461661,102461685,IMR90|chr2:218769260-218769343,chr2,218769260,218769343,1,116307599
IMR90|chr2:102461661-102461684,chr2,102461661,102461684,IMR90|chr2:218769260-218769343,chr2,218769260,218769343,1,116307599
IMR90|chr2:105986866-105986888,chr2,105986866,105986888,IMR90|chr2:230785874-230785988,chr2,230785874,230785988,1,124799008
IMR90|chr2:109781691-109781792,chr2,109781691,109781792,IMR90|chr2:74777010-74777066,chr2,74777010,74777066,1,35004681
IMR90|chr2:109781691-109781791,chr2,109781691,109781791,IMR90|chr2:74777010-74777065,chr2,74777010,74777065,1,35004681
IMR90|chr2:109781691-109781785,chr2,109781691,109781785,IMR90|chr2:74777010-74777066,chr2,74777010,74777066,1,35004681
IMR90|chr2:109781691-109781740,chr2,109781691,109781740,IMR90|chr2:74777010-74777065,chr2,74777010,74777065,1,35004681
IMR90|chr2:109937753-109937867,chr2,109937753,109937867,IMR90|chr2:190041054-190041089,chr2,190041054,190041089,1,80103301
IMR90|chr2:109937757-109937876,chr2,109937757,109937876,IMR90|chr2:190041054-190041089,chr2,190041054,190041089,1,80103297
IMR90|chr2:110062225-110062268,chr2,110062225,110062268,IMR90|chr2:151337708-151337779,chr2,151337708,151337779,1,41275483
IMR90|chr2:110062225-110062246,chr2,110062225,110062246,IMR90|chr2:151337708-151337779,chr2,151337708,151337779,1,41275483
IMR90|chr2:112226830-112226945,chr2,112226830,112226945,IMR90|chr2:170222336-170222371,chr2,170222336,170222371,1,57995506
IMR90|chr2:114727446-114727519,chr2,114727446,114727519,IMR90|chr2:112813985-112814079,chr2,112813985,112814079,1,1913461
IMR90|chr2:114727470-114727526,chr2,114727470,114727526,IMR90|chr2:112813985-112814079,chr2,112813985,112814079,1,1913485
IMR90|chr2:121501727-121501793,chr2,121501727,121501793,IMR90|chr2:106013771-106013857,chr2,106013771,106013857,1,15487956
IMR90|chr2:121501729-121501793,chr2,121501729,121501793,IMR90|chr2:106013771-106013857,chr2,106013771,106013857,1,15487958
IMR90|chr2:121522325-121522370,chr2,121522325,121522370,IMR90|chr2:106012711-106012818,chr2,106012711,106012818,1,15509614
IMR90|chr2:121522331-121522370,chr2,121522331,121522370,IMR90|chr2:106012711-106012818,chr2,106012711,106012818,1,15509620
IMR90|chr2:121565359-121565434,chr2,121565359,121565434,IMR90|chr2:109746699-109746774,chr2,109746699,109746774,1,11818660
IMR90|chr2:121565362-121565432,chr2,121565362,121565432,IMR90|chr2:109746699-109746777,chr2,109746699,109746777,1,11818663
IMR90|chr2:121611543-121611585,chr2,121611543,121611585,IMR90|chr2:84690368-84690428,chr2,84690368,84690428,1,36921175
IMR90|chr2:121611544-121611585,chr2,121611544,121611585,IMR90|chr2:84690368-84690428,chr2,84690368,84690428,1,36921176
IMR90|chr2:121671631-121671701,chr2,121671631,121671701,IMR90|chr2:36582962-36583024,chr2,36582962,36583024,1,85088669
IMR90|chr2:121671653-121671701,chr2,121671653,121671701,IMR90|chr2:36582962-36583064,chr2,36582962,36583064,1,85088691
IMR90|chr2:121692435-121692466,chr2,121692435,121692466,IMR90|chr2:36586197-36586228,chr2,36586197,36586228,1,85106238
IMR90|chr2:128523398-128523457,chr2,128523398,128523457,IMR90|chr2:86420526-86420654,chr2,86420526,86420654,1,42102872
IMR90|chr2:129059378-129059411,chr2,129059378,129059411,IMR90|chr2:242642493-242642529,chr2,242642493,242642529,1,113583115
IMR90|chr2:129059428-129059448,chr2,129059428,129059448,IMR90|chr2:128642983-128643069,chr2,128642983,128643069,1,416445
IMR90|chr2:129068884-129068931,chr2,129068884,129068931,IMR90|chr2:242642112-242642220,chr2,242642112,242642220,1,113573228
IMR90|chr2:129068889-129068931,chr2,129068889,129068931,IMR90|chr2:242642112-242642220,chr2,242642112,242642220,1,113573223
IMR90|chr2:133669684-133669758,chr2,133669684,133669758,IMR90|chr2:153031560-153031590,chr2,153031560,153031590,1,19361876
IMR90|chr2:133725448-133725534,chr2,133725448,133725534,IMR90|chr2:46927167-46927191,chr2,46927167,46927191,1,86798281
IMR90|chr2:133725448-133725532,chr2,133725448,133725532,IMR90|chr2:46927167-46927191,chr2,46927167,46927191,1,86798281
IMR90|chr2:133725486-133725534,chr2,133725486,133725534,IMR90|chr2:46927167-46927191,chr2,46927167,46927191,1,86798319
IMR90|chr2:134076378-134076447,chr2,134076378,134076447,IMR90|chr2:71358142-71358261,chr2,71358142,71358261,1,62718236
IMR90|chr2:134076378-134076409,chr2,134076378,134076409,IMR90|chr2:71358142-71358261,chr2,71358142,71358261,1,62718236
IMR90|chr2:134100204-134100270,chr2,134100204,134100270,IMR90|chr2:157294031-157294115,chr2,157294031,157294115,1,23193827
IMR90|chr2:134100205-134100280,chr2,134100205,134100280,IMR90|chr2:157294030-157294105,chr2,157294030,157294105,1,23193825
IMR90|chr2:134930991-134931095,chr2,134930991,134931095,IMR90|chr2:190041156-190041236,chr2,190041156,190041236,1,55110165
IMR90|chr2:134931028-134931095,chr2,134931028,134931095,IMR90|chr2:190041156-190041236,chr2,190041156,190041236,1,55110128
IMR90|chr2:134935824-134935882,chr2,134935824,134935882,IMR90|chr2:148779633-148779720,chr2,148779633,148779720,1,13843809
IMR90|chr2:134935824-134935881,chr2,134935824,134935881,IMR90|chr2:148779633-148779720,chr2,148779633,148779720,1,13843809
IMR90|chr2:134954874-134954908,chr2,134954874,134954908,IMR90|chr2:148777079-148777225,chr2,148777079,148777225,1,13822205
IMR90|chr2:134993483-134993593,chr2,134993483,134993593,IMR90|chr2:190042371-190042453,chr2,190042371,190042453,1,55048888
IMR90|chr2:134993526-134993594,chr2,134993526,134993594,IMR90|chr2:190042371-190042453,chr2,190042371,190042453,1,55048845
IMR90|chr2:135174401-135174447,chr2,135174401,135174447,IMR90|chr2:47400695-47400805,chr2,47400695,47400805,1,87773706
IMR90|chr2:135176418-135176480,chr2,135176418,135176480,IMR90|chr2:173293316-173293369,chr2,173293316,173293369,1,38116898
IMR90|chr2:135176419-135176480,chr2,135176419,135176480,IMR90|chr2:173293321-173293369,chr2,173293321,173293369,1,38116902
IMR90|chr2:135177257-135177322,chr2,135177257,135177322,IMR90|chr2:47401938-47401977,chr2,47401938,47401977,1,87775319
IMR90|chr2:135187284-135187301,chr2,135187284,135187301,IMR90|chr2:42276470-42276578,chr2,42276470,42276578,1,92910814
IMR90|chr2:135193815-135193877,chr2,135193815,135193877,IMR90|chr2:42276496-42276540,chr2,42276496,42276540,1,92917319
IMR90|chr2:135193825-135193851,chr2,135193825,135193851,IMR90|chr2:42276494-42276540,chr2,42276494,42276540,1,92917331
IMR90|chr2:145224352-145224445,chr2,145224352,145224445,IMR90|chr2:218866150-218866191,chr2,218866150,218866191,1,73641798
IMR90|chr2:145224352-145224442,chr2,145224352,145224442,IMR90|chr2:218866150-218866191,chr2,218866150,218866191,1,73641798
IMR90|chr2:149052699-149052784,chr2,149052699,149052784,IMR90|chr2:192545221-192545253,chr2,192545221,192545253,1,43492522
IMR90|chr2:149052702-149052784,chr2,149052702,149052784,IMR90|chr2:192545221-192545253,chr2,192545221,192545253,1,43492519
IMR90|chr2:153278469-153278583,chr2,153278469,153278583,IMR90|chr2:8823775-8823810,chr2,8823775,8823810,1,144454694
IMR90|chr2:160615155-160615181,chr2,160615155,160615181,IMR90|chr2:190306707-190306761,chr2,190306707,190306761,1,29691552
IMR90|chr2:161141967-161142068,chr2,161141967,161142068,IMR90|chr2:162017917-162017958,chr2,162017917,162017958,1,875950
IMR90|chr2:161141967-161142067,chr2,161141967,161142067,IMR90|chr2:162017917-162017958,chr2,162017917,162017958,1,875950
IMR90|chr2:161154559-161154615,chr2,161154559,161154615,IMR90|chr2:162017027-162017132,chr2,162017027,162017132,1,862468
IMR90|chr2:161154570-161154615,chr2,161154570,161154615,IMR90|chr2:162017027-162017132,chr2,162017027,162017132,1,862457
IMR90|chr2:161201697-161201759,chr2,161201697,161201759,IMR90|chr2:55273514-55273602,chr2,55273514,55273602,1,105928183
IMR90|chr2:161201698-161201759,chr2,161201698,161201759,IMR90|chr2:55273514-55273602,chr2,55273514,55273602,1,105928184
IMR90|chr2:161206644-161206728,chr2,161206644,161206728,IMR90|chr2:55276344-55276375,chr2,55276344,55276375,1,105930300
IMR90|chr2:161341199-161341333,chr2,161341199,161341333,IMR90|chr2:160472082-160472128,chr2,160472082,160472128,1,869117
IMR90|chr2:161341199-161341303,chr2,161341199,161341303,IMR90|chr2:160472082-160472128,chr2,160472082,160472128,1,869117
IMR90|chr2:169041792-169041883,chr2,169041792,169041883,IMR90|chr2:169311582-169311600,chr2,169311582,169311600,1,269790
IMR90|chr2:169041792-169041878,chr2,169041792,169041878,IMR90|chr2:169311582-169311600,chr2,169311582,169311600,1,269790
IMR90|chr2:169085021-169085079,chr2,169085021,169085079,IMR90|chr2:169309798-169309887,chr2,169309798,169309887,1,224777
IMR90|chr2:169085142-169085177,chr2,169085142,169085177,IMR90|chr2:169309798-169309887,chr2,169309798,169309887,1,224656
IMR90|chr2:173692655-173692743,chr2,173692655,173692743,IMR90|chr2:178079342-178079452,chr2,178079342,178079452,1,4386687
IMR90|chr2:173692703-173692743,chr2,173692703,173692743,IMR90|chr2:178079342-178079452,chr2,178079342,178079452,1,4386639
IMR90|chr2:174014708-174014823,chr2,174014708,174014823,IMR90|chr2:151340083-151340133,chr2,151340083,151340133,1,22674625
IMR90|chr2:174014708-174014801,chr2,174014708,174014801,IMR90|chr2:151340083-151340133,chr2,151340083,151340133,1,22674625
IMR90|chr2:174841096-174841195,chr2,174841096,174841195,IMR90|chr2:174829593-174829619,chr2,174829593,174829619,1,11503
IMR90|chr2:174842176-174842243,chr2,174842176,174842243,IMR90|chr2:174831520-174831552,chr2,174831520,174831552,1,10656
IMR90|chr2:175675690-175675772,chr2,175675690,175675772,IMR90|chr2:102315169-102315237,chr2,102315169,102315237,1,73360521
IMR90|chr2:175675695-175675786,chr2,175675695,175675786,IMR90|chr2:102315169-102315237,chr2,102315169,102315237,1,73360526
IMR90|chr2:178109470-178109526,chr2,178109470,178109526,IMR90|chr2:178080044-178080129,chr2,178080044,178080129,1,29426
IMR90|chr2:178115982-178116041,chr2,178115982,178116041,IMR90|chr2:170442006-170442077,chr2,170442006,170442077,1,7673976
IMR90|chr2:178121129-178121148,chr2,178121129,178121148,IMR90|chr2:178079438-178079545,chr2,178079438,178079545,1,41691
IMR90|chr2:178121129-178121146,chr2,178121129,178121146,IMR90|chr2:178079438-178079545,chr2,178079438,178079545,1,41691
IMR90|chr2:183811783-183811805,chr2,183811783,183811805,IMR90|chr2:219084303-219084395,chr2,219084303,219084395,1,35272520
IMR90|chr2:189973754-189973816,chr2,189973754,189973816,IMR90|chr2:113994707-113994817,chr2,113994707,113994817,1,75979047
IMR90|chr2:189973777-189973817,chr2,189973777,189973817,IMR90|chr2:113994707-113994817,chr2,113994707,113994817,1,75979070
IMR90|chr2:190212867-190212922,chr2,190212867,190212922,IMR90|chr2:190305748-190305822,chr2,190305748,190305822,1,92881
IMR90|chr2:192024122-192024185,chr2,192024122,192024185,IMR90|chr2:192020014-192020101,chr2,192020014,192020101,1,4108
IMR90|chr2:192024157-192024307,chr2,192024157,192024307,IMR90|chr2:192020014-192020101,chr2,192020014,192020101,1,4143
IMR90|chr2:192032304-192032356,chr2,192032304,192032356,IMR90|chr2:192020027-192020104,chr2,192020027,192020104,1,12277
IMR90|chr2:192032304-192032355,chr2,192032304,192032355,IMR90|chr2:192020028-192020104,chr2,192020028,192020104,1,12276
IMR90|chr2:192036064-192036142,chr2,192036064,192036142,IMR90|chr2:192019322-192019412,chr2,192019322,192019412,1,16742
IMR90|chr2:192036082-192036142,chr2,192036082,192036142,IMR90|chr2:192019322-192019412,chr2,192019322,192019412,1,16760
IMR90|chr2:192165497-192165551,chr2,192165497,192165551,IMR90|chr2:201172642-201172680,chr2,201172642,201172680,1,9007145
IMR90|chr2:197179667-197179692,chr2,197179667,197179692,IMR90|chr2:197664046-197664193,chr2,197664046,197664193,1,484379
IMR90|chr2:197189933-197189991,chr2,197189933,197189991,IMR90|chr2:238319732-238319798,chr2,238319732,238319798,1,41129799
IMR90|chr2:197999176-197999257,chr2,197999176,197999257,IMR90|chr2:197668622-197668687,chr2,197668622,197668687,1,330554
IMR90|chr2:197999176-197999256,chr2,197999176,197999256,IMR90|chr2:197668622-197668687,chr2,197668622,197668687,1,330554
IMR90|chr2:200302332-200302403,chr2,200302332,200302403,IMR90|chr2:201982448-201982495,chr2,201982448,201982495,1,1680116
IMR90|chr2:200302334-200302407,chr2,200302334,200302407,IMR90|chr2:201982446-201982471,chr2,201982446,201982471,1,1680112
IMR90|chr2:200302339-200302407,chr2,200302339,200302407,IMR90|chr2:201982448-201982495,chr2,201982448,201982495,1,1680109
IMR90|chr2:201228836-201228960,chr2,201228836,201228960,IMR90|chr2:238320005-238320028,chr2,238320005,238320028,1,37091169
IMR90|chr2:201287611-201287721,chr2,201287611,201287721,IMR90|chr2:70485992-70486046,chr2,70485992,70486046,1,130801619
IMR90|chr2:201287626-201287722,chr2,201287626,201287722,IMR90|chr2:70485992-70486046,chr2,70485992,70486046,1,130801634
IMR90|chr2:201310769-201310883,chr2,201310769,201310883,IMR90|chr2:218806753-218806788,chr2,218806753,218806788,1,17495984
IMR90|chr2:201310769-201310881,chr2,201310769,201310881,IMR90|chr2:218806753-218806788,chr2,218806753,218806788,1,17495984
IMR90|chr2:201310769-201310832,chr2,201310769,201310832,IMR90|chr2:218806753-218806788,chr2,218806753,218806788,1,17495984
IMR90|chr2:201614948-201614976,chr2,201614948,201614976,IMR90|chr2:201754967-201755063,chr2,201754967,201755063,1,140019
IMR90|chr2:201657269-201657333,chr2,201657269,201657333,IMR90|chr2:201754864-201754907,chr2,201754864,201754907,1,97595
IMR90|chr2:205421068-205421129,chr2,205421068,205421129,IMR90|chr2:134877594-134877626,chr2,134877594,134877626,1,70543474
IMR90|chr2:205421069-205421129,chr2,205421069,205421129,IMR90|chr2:134877594-134877626,chr2,134877594,134877626,1,70543475
IMR90|chr2:207993081-207993158,chr2,207993081,207993158,IMR90|chr2:208577289-208577344,chr2,208577289,208577344,1,584208
IMR90|chr2:207993128-207993160,chr2,207993128,207993160,IMR90|chr2:208577289-208577407,chr2,208577289,208577407,1,584161
IMR90|chr2:216231071-216231119,chr2,216231071,216231119,IMR90|chr2:74405670-74405739,chr2,74405670,74405739,1,141825401
IMR90|chr2:216231073-216231119,chr2,216231073,216231119,IMR90|chr2:74405670-74405739,chr2,74405670,74405739,1,141825403
IMR90|chr2:216231213-216231288,chr2,216231213,216231288,IMR90|chr2:19546935-19546974,chr2,19546935,19546974,1,196684278
IMR90|chr2:216231218-216231288,chr2,216231218,216231288,IMR90|chr2:19546935-19546974,chr2,19546935,19546974,1,196684283
IMR90|chr2:216231218-216231240,chr2,216231218,216231240,IMR90|chr2:19546935-19546979,chr2,19546935,19546979,1,196684283
IMR90|chr2:216263814-216263844,chr2,216263814,216263844,IMR90|chr2:47401329-47401364,chr2,47401329,47401364,1,168862485
IMR90|chr2:216266379-216266480,chr2,216266379,216266480,IMR90|chr2:47399892-47399932,chr2,47399892,47399932,1,168866487
IMR90|chr2:216266379-216266460,chr2,216266379,216266460,IMR90|chr2:47399863-47399932,chr2,47399863,47399932,1,168866516
IMR90|chr2:216275139-216275209,chr2,216275139,216275209,IMR90|chr2:242210100-242210146,chr2,242210100,242210146,1,25934961
IMR90|chr2:216275139-216275208,chr2,216275139,216275208,IMR90|chr2:242210100-242210146,chr2,242210100,242210146,1,25934961
IMR90|chr2:216275269-216275359,chr2,216275269,216275359,IMR90|chr2:27251841-27251882,chr2,27251841,27251882,1,189023428
IMR90|chr2:216275555-216275597,chr2,216275555,216275597,IMR90|chr2:47402402-47402477,chr2,47402402,47402477,1,168873153
IMR90|chr2:216276090-216276132,chr2,216276090,216276132,IMR90|chr2:27580352-27580460,chr2,27580352,27580460,1,188695738
IMR90|chr2:216276321-216276373,chr2,216276321,216276373,IMR90|chr2:242445945-242446095,chr2,242445945,242446095,1,26169624
IMR90|chr2:216276592-216276704,chr2,216276592,216276704,IMR90|chr2:242446514-242446571,chr2,242446514,242446571,1,26169922
IMR90|chr2:216276592-216276685,chr2,216276592,216276685,IMR90|chr2:242446514-242446571,chr2,242446514,242446571,1,26169922
IMR90|chr2:216276606-216276704,chr2,216276606,216276704,IMR90|chr2:242446514-242446571,chr2,242446514,242446571,1,26169908
IMR90|chr2:216276884-216276932,chr2,216276884,216276932,IMR90|chr2:192547939-192548038,chr2,192547939,192548038,1,23728945
IMR90|chr2:216276884-216276931,chr2,216276884,216276931,IMR90|chr2:192547939-192548038,chr2,192547939,192548038,1,23728945
IMR90|chr2:216278017-216278115,chr2,216278017,216278115,IMR90|chr2:85193640-85193697,chr2,85193640,85193697,1,131084377
IMR90|chr2:216278022-216278115,chr2,216278022,216278115,IMR90|chr2:85193640-85193697,chr2,85193640,85193697,1,131084382
IMR90|chr2:216278915-216278945,chr2,216278915,216278945,IMR90|chr2:242211243-242211340,chr2,242211243,242211340,1,25932328
IMR90|chr2:216278915-216278944,chr2,216278915,216278944,IMR90|chr2:242211243-242211340,chr2,242211243,242211340,1,25932328
IMR90|chr2:216279052-216279078,chr2,216279052,216279078,IMR90|chr2:85195073-85195115,chr2,85195073,85195115,1,131083979
IMR90|chr2:216279267-216279321,chr2,216279267,216279321,IMR90|chr2:219083852-219083914,chr2,219083852,219083914,1,2804585
IMR90|chr2:216279268-216279321,chr2,216279268,216279321,IMR90|chr2:219083852-219083914,chr2,219083852,219083914,1,2804584
IMR90|chr2:216279320-216279379,chr2,216279320,216279379,IMR90|chr2:192543583-192543650,chr2,192543583,192543650,1,23735737
IMR90|chr2:216282112-216282207,chr2,216282112,216282207,IMR90|chr2:201984547-201984660,chr2,201984547,201984660,1,14297565
IMR90|chr2:216282846-216282969,chr2,216282846,216282969,IMR90|chr2:201983145-201983170,chr2,201983145,201983170,1,14299701
IMR90|chr2:216282846-216282966,chr2,216282846,216282966,IMR90|chr2:201983145-201983170,chr2,201983145,201983170,1,14299701
IMR90|chr2:216284520-216284541,chr2,216284520,216284541,IMR90|chr2:27580364-27580482,chr2,27580364,27580482,1,188704156
IMR90|chr2:216285554-216285649,chr2,216285554,216285649,IMR90|chr2:47400765-47400789,chr2,47400765,47400789,1,168884789
IMR90|chr2:216285978-216286010,chr2,216285978,216286010,IMR90|chr2:190540934-190540964,chr2,190540934,190540964,1,25745044
IMR90|chr2:216287966-216288000,chr2,216287966,216288000,IMR90|chr2:3627267-3627322,chr2,3627267,3627322,1,212660699
IMR90|chr2:216290061-216290084,chr2,216290061,216290084,IMR90|chr2:27251981-27252089,chr2,27251981,27252089,1,189038080
IMR90|chr2:216290063-216290084,chr2,216290063,216290084,IMR90|chr2:27251981-27252089,chr2,27251981,27252089,1,189038082
IMR90|chr2:216290408-216290458,chr2,216290408,216290458,IMR90|chr2:27257518-27257618,chr2,27257518,27257618,1,189032890
IMR90|chr2:216291774-216291845,chr2,216291774,216291845,IMR90|chr2:216174161-216174224,chr2,216174161,216174224,1,117613
IMR90|chr2:216292046-216292072,chr2,216292046,216292072,IMR90|chr2:85194566-85194623,chr2,85194566,85194623,1,131097480
IMR90|chr2:216292402-216292441,chr2,216292402,216292441,IMR90|chr2:219084023-219084119,chr2,219084023,219084119,1,2791621
IMR90|chr2:216292403-216292441,chr2,216292403,216292441,IMR90|chr2:219084023-219084119,chr2,219084023,219084119,1,2791620
IMR90|chr2:216293228-216293253,chr2,216293228,216293253,IMR90|chr2:201989439-201989521,chr2,201989439,201989521,1,14303789
IMR90|chr2:216293230-216293253,chr2,216293230,216293253,IMR90|chr2:201989439-201989521,chr2,201989439,201989521,1,14303791
IMR90|chr2:217186156-217186283,chr2,217186156,217186283,IMR90|chr2:216298901-216298924,chr2,216298901,216298924,1,887255
IMR90|chr2:217186175-217186325,chr2,217186175,217186325,IMR90|chr2:216298901-216298924,chr2,216298901,216298924,1,887274
IMR90|chr2:217205702-217205822,chr2,217205702,217205822,IMR90|chr2:66672180-66672234,chr2,66672180,66672234,1,150533522
IMR90|chr2:217205729-217205822,chr2,217205729,217205822,IMR90|chr2:66672180-66672234,chr2,66672180,66672234,1,150533549
IMR90|chr2:217421039-217421153,chr2,217421039,217421153,IMR90|chr2:219193014-219193034,chr2,219193014,219193034,1,1771975
IMR90|chr2:217421039-217421152,chr2,217421039,217421152,IMR90|chr2:219193014-219193034,chr2,219193014,219193034,1,1771975
IMR90|chr2:218727150-218727188,chr2,218727150,218727188,IMR90|chr2:118572530-118572636,chr2,118572530,118572636,1,100154620
IMR90|chr2:218727150-218727187,chr2,218727150,218727187,IMR90|chr2:118572530-118572636,chr2,118572530,118572636,1,100154620
IMR90|chr2:219090262-219090308,chr2,219090262,219090308,IMR90|chr2:219156470-219156620,chr2,219156470,219156620,1,66208
IMR90|chr2:219092460-219092496,chr2,219092460,219092496,IMR90|chr2:219154109-219154208,chr2,219154109,219154208,1,61649
IMR90|chr2:223757121-223757170,chr2,223757121,223757170,IMR90|chr2:55273463-55273526,chr2,55273463,55273526,1,168483658
IMR90|chr2:224714159-224714240,chr2,224714159,224714240,IMR90|chr2:224705721-224705752,chr2,224705721,224705752,1,8438
IMR90|chr2:224714197-224714240,chr2,224714197,224714240,IMR90|chr2:224705721-224705752,chr2,224705721,224705752,1,8476
IMR90|chr2:224718976-224719110,chr2,224718976,224719110,IMR90|chr2:224707000-224707055,chr2,224707000,224707055,1,11976
IMR90|chr2:225385348-225385406,chr2,225385348,225385406,IMR90|chr2:131095684-131095751,chr2,131095684,131095751,1,94289664
IMR90|chr2:225385348-225385404,chr2,225385348,225385404,IMR90|chr2:131095684-131095751,chr2,131095684,131095751,1,94289664
IMR90|chr2:225804693-225804739,chr2,225804693,225804739,IMR90|chr2:54090720-54090790,chr2,54090720,54090790,1,171713973
IMR90|chr2:225804693-225804738,chr2,225804693,225804738,IMR90|chr2:54090720-54090790,chr2,54090720,54090790,1,171713973
IMR90|chr2:225864006-225864074,chr2,225864006,225864074,IMR90|chr2:201451422-201451544,chr2,201451422,201451544,1,24412584
IMR90|chr2:225864052-225864074,chr2,225864052,225864074,IMR90|chr2:201451422-201451544,chr2,201451422,201451544,1,24412630
IMR90|chr2:227627056-227627145,chr2,227627056,227627145,IMR90|chr2:203734353-203734409,chr2,203734353,203734409,1,23892703
IMR90|chr2:227627056-227627144,chr2,227627056,227627144,IMR90|chr2:203734353-203734409,chr2,203734353,203734409,1,23892703
IMR90|chr2:227627065-227627145,chr2,227627065,227627145,IMR90|chr2:203734353-203734405,chr2,203734353,203734405,1,23892712
IMR90|chr2:227627093-227627146,chr2,227627093,227627146,IMR90|chr2:203734353-203734405,chr2,203734353,203734405,1,23892740
IMR90|chr2:227634192-227634274,chr2,227634192,227634274,IMR90|chr2:242210704-242210725,chr2,242210704,242210725,1,14576512
IMR90|chr2:227634193-227634275,chr2,227634193,227634275,IMR90|chr2:242211534-242211552,chr2,242211534,242211552,1,14577341
IMR90|chr2:227634397-227634432,chr2,227634397,227634432,IMR90|chr2:242446858-242446945,chr2,242446858,242446945,1,14812461
IMR90|chr2:227639324-227639426,chr2,227639324,227639426,IMR90|chr2:27545005-27545073,chr2,27545005,27545073,1,200094319
IMR90|chr2:227639344-227639426,chr2,227639344,227639426,IMR90|chr2:27545005-27545073,chr2,27545005,27545073,1,200094339
IMR90|chr2:227761729-227761794,chr2,227761729,227761794,IMR90|chr2:227666226-227666246,chr2,227666226,227666246,1,95503
IMR90|chr2:227779467-227779558,chr2,227779467,227779558,IMR90|chr2:227659525-227659584,chr2,227659525,227659584,1,119942
IMR90|chr2:227779467-227779537,chr2,227779467,227779537,IMR90|chr2:227659525-227659602,chr2,227659525,227659602,1,119942
IMR90|chr2:231589432-231589483,chr2,231589432,231589483,IMR90|chr2:241529047-241529139,chr2,241529047,241529139,1,9939615
IMR90|chr2:231589432-231589482,chr2,231589432,231589482,IMR90|chr2:241529047-241529139,chr2,241529047,241529139,1,9939615
IMR90|chr2:231640025-231640086,chr2,231640025,231640086,IMR90|chr2:228334364-228334443,chr2,228334364,228334443,1,3305661
IMR90|chr2:231640025-231640085,chr2,231640025,231640085,IMR90|chr2:228334364-228334443,chr2,228334364,228334443,1,3305661
IMR90|chr2:231640026-231640085,chr2,231640026,231640085,IMR90|chr2:228334364-228334431,chr2,228334364,228334431,1,3305662
IMR90|chr2:231644855-231644895,chr2,231644855,231644895,IMR90|chr2:36586589-36586690,chr2,36586589,36586690,1,195058266
IMR90|chr2:231644856-231644895,chr2,231644856,231644895,IMR90|chr2:36586589-36586690,chr2,36586589,36586690,1,195058267
IMR90|chr2:231655911-231655983,chr2,231655911,231655983,IMR90|chr2:36587170-36587200,chr2,36587170,36587200,1,195068741
IMR90|chr2:232011690-232011814,chr2,232011690,232011814,IMR90|chr2:190047031-190047081,chr2,190047031,190047081,1,41964659
IMR90|chr2:232011690-232011790,chr2,232011690,232011790,IMR90|chr2:190047031-190047081,chr2,190047031,190047081,1,41964659
IMR90|chr2:232011691-232011814,chr2,232011691,232011814,IMR90|chr2:190047031-190047081,chr2,190047031,190047081,1,41964660
IMR90|chr2:235868360-235868464,chr2,235868360,235868464,IMR90|chr2:39662486-39662531,chr2,39662486,39662531,1,196205874
IMR90|chr2:235868360-235868462,chr2,235868360,235868462,IMR90|chr2:39662486-39662531,chr2,39662486,39662531,1,196205874
IMR90|chr2:235868431-235868581,chr2,235868431,235868581,IMR90|chr2:39662486-39662531,chr2,39662486,39662531,1,196205945
IMR90|chr2:235874893-235875015,chr2,235874893,235875015,IMR90|chr2:63820229-63820257,chr2,63820229,63820257,1,172054664
IMR90|chr2:235923234-235923303,chr2,235923234,235923303,IMR90|chr2:234474775-234474820,chr2,234474775,234474820,1,1448459
IMR90|chr2:235925215-235925304,chr2,235925215,235925304,IMR90|chr2:236403982-236404020,chr2,236403982,236404020,1,478767
IMR90|chr2:235927964-235928026,chr2,235927964,235928026,IMR90|chr2:236403672-236403712,chr2,236403672,236403712,1,475708
IMR90|chr2:238226584-238226648,chr2,238226584,238226648,IMR90|chr2:55275291-55275354,chr2,55275291,55275354,1,182951293
IMR90|chr2:238235582-238235639,chr2,238235582,238235639,IMR90|chr2:63821124-63821167,chr2,63821124,63821167,1,174414458
IMR90|chr2:238235582-238235638,chr2,238235582,238235638,IMR90|chr2:63821124-63821167,chr2,63821124,63821167,1,174414458
IMR90|chr2:238252796-238252825,chr2,238252796,238252825,IMR90|chr2:55274434-55274481,chr2,55274434,55274481,1,182978362
IMR90|chr2:238262751-238262814,chr2,238262751,238262814,IMR90|chr2:242446008-242446106,chr2,242446008,242446106,1,4183257
IMR90|chr2:238262751-238262803,chr2,238262751,238262803,IMR90|chr2:242446008-242446106,chr2,242446008,242446106,1,4183257
IMR90|chr2:238269210-238269309,chr2,238269210,238269309,IMR90|chr2:242443724-242443804,chr2,242443724,242443804,1,4174514
IMR90|chr2:238269245-238269310,chr2,238269245,238269310,IMR90|chr2:242443724-242443804,chr2,242443724,242443804,1,4174479
IMR90|chr2:238311721-238311793,chr2,238311721,238311793,IMR90|chr2:238537243-238537271,chr2,238537243,238537271,1,225522
IMR90|chr2:238311721-238311792,chr2,238311721,238311792,IMR90|chr2:238537243-238537271,chr2,238537243,238537271,1,225522
IMR90|chr2:238312797-238312866,chr2,238312797,238312866,IMR90|chr2:238536942-238537023,chr2,238536942,238537023,1,224145
IMR90|chr2:238312798-238312866,chr2,238312798,238312866,IMR90|chr2:238536942-238537023,chr2,238536942,238537023,1,224144
IMR90|chr2:238618578-238618651,chr2,238618578,238618651,IMR90|chr2:238880106-238880138,chr2,238880106,238880138,1,261528
IMR90|chr2:238618578-238618650,chr2,238618578,238618650,IMR90|chr2:238880103-238880138,chr2,238880103,238880138,1,261525
IMR90|chr2:238637936-238638013,chr2,238637936,238638013,IMR90|chr2:238876309-238876382,chr2,238876309,238876382,1,238373
IMR90|chr2:238925906-238925927,chr2,238925906,238925927,IMR90|chr2:47402593-47402682,chr2,47402593,47402682,1,191523313
IMR90|chr2:238925908-238925927,chr2,238925908,238925927,IMR90|chr2:47402593-47402682,chr2,47402593,47402682,1,191523315
IMR90|chr2:240248456-240248512,chr2,240248456,240248512,IMR90|chr2:26466923-26466974,chr2,26466923,26466974,1,213781533
IMR90|chr2:240248479-240248512,chr2,240248479,240248512,IMR90|chr2:26466923-26466974,chr2,26466923,26466974,1,213781556
IMR90|chr2:242282107-242282139,chr2,242282107,242282139,IMR90|chr2:242453415-242453533,chr2,242453415,242453533,1,171308
IMR90|chr2:242631733-242631837,chr2,242631733,242631837,IMR90|chr2:242640566-242640612,chr2,242640566,242640612,1,8833
IMR90|chr2:242631792-242631881,chr2,242631792,242631881,IMR90|chr2:242640566-242640612,chr2,242640566,242640612,1,8774
IMR90|chr3:9460181-9460204,chr3,9460181,9460204,IMR90|chr3:9435500-9435571,chr3,9435500,9435571,1,24681
IMR90|chr3:9460181-9460203,chr3,9460181,9460203,IMR90|chr3:9435500-9435571,chr3,9435500,9435571,1,24681
IMR90|chr3:9460357-9460456,chr3,9460357,9460456,IMR90|chr3:9434250-9434293,chr3,9434250,9434293,1,26107
IMR90|chr3:11341638-11341691,chr3,11341638,11341691,IMR90|chr3:9834968-9835002,chr3,9834968,9835002,1,1506670
IMR90|chr3:11341639-11341691,chr3,11341639,11341691,IMR90|chr3:9834968-9835002,chr3,9834968,9835002,1,1506671
IMR90|chr3:11399482-11399551,chr3,11399482,11399551,IMR90|chr3:48344455-48344503,chr3,48344455,48344503,1,36944973
IMR90|chr3:11399517-11399550,chr3,11399517,11399550,IMR90|chr3:48344454-48344503,chr3,48344454,48344503,1,36944937
IMR90|chr3:11502142-11502190,chr3,11502142,11502190,IMR90|chr3:9439681-9439783,chr3,9439681,9439783,1,2062461
IMR90|chr3:11502142-11502189,chr3,11502142,11502189,IMR90|chr3:9439681-9439783,chr3,9439681,9439783,1,2062461
IMR90|chr3:11505364-11505428,chr3,11505364,11505428,IMR90|chr3:98618883-98618920,chr3,98618883,98618920,1,87113519
IMR90|chr3:12611253-12611331,chr3,12611253,12611331,IMR90|chr3:12703605-12703720,chr3,12703605,12703720,1,92352
IMR90|chr3:12615151-12615208,chr3,12615151,12615208,IMR90|chr3:12709615-12709692,chr3,12709615,12709692,1,94464
IMR90|chr3:12688718-12688843,chr3,12688718,12688843,IMR90|chr3:10029172-10029200,chr3,10029172,10029200,1,2659546
IMR90|chr3:12688718-12688842,chr3,12688718,12688842,IMR90|chr3:10029172-10029200,chr3,10029172,10029200,1,2659546
IMR90|chr3:12688720-12688842,chr3,12688720,12688842,IMR90|chr3:10029172-10029200,chr3,10029172,10029200,1,2659548
IMR90|chr3:12691515-12691563,chr3,12691515,12691563,IMR90|chr3:12709716-12709788,chr3,12709716,12709788,1,18201
IMR90|chr3:12693792-12693866,chr3,12693792,12693866,IMR90|chr3:12706623-12706688,chr3,12706623,12706688,1,12831
IMR90|chr3:14465900-14465937,chr3,14465900,14465937,IMR90|chr3:150124331-150124396,chr3,150124331,150124396,1,135658431
IMR90|chr3:14479991-14480043,chr3,14479991,14480043,IMR90|chr3:52736430-52736511,chr3,52736430,52736511,1,38256439
IMR90|chr3:14479992-14480043,chr3,14479992,14480043,IMR90|chr3:52736430-52736511,chr3,52736430,52736511,1,38256438
IMR90|chr3:14503173-14503230,chr3,14503173,14503230,IMR90|chr3:150132709-150132782,chr3,150132709,150132782,1,135629536
IMR90|chr3:14503173-14503229,chr3,14503173,14503229,IMR90|chr3:150132709-150132782,chr3,150132709,150132782,1,135629536
IMR90|chr3:14507618-14507696,chr3,14507618,14507696,IMR90|chr3:64209975-64210009,chr3,64209975,64210009,1,49702357
IMR90|chr3:14507621-14507696,chr3,14507621,14507696,IMR90|chr3:64209975-64210009,chr3,64209975,64210009,1,49702354
IMR90|chr3:16069524-16069572,chr3,16069524,16069572,IMR90|chr3:184532447-184532496,chr3,184532447,184532496,1,168462923
IMR90|chr3:23301194-23301244,chr3,23301194,23301244,IMR90|chr3:38174529-38174619,chr3,38174529,38174619,1,14873335
IMR90|chr3:23490620-23490696,chr3,23490620,23490696,IMR90|chr3:15838596-15838677,chr3,15838596,15838677,1,7652024
IMR90|chr3:23643343-23643432,chr3,23643343,23643432,IMR90|chr3:50276512-50276573,chr3,50276512,50276573,1,26633169
IMR90|chr3:23643343-23643413,chr3,23643343,23643413,IMR90|chr3:50276499-50276573,chr3,50276499,50276573,1,26633156
IMR90|chr3:23915074-23915098,chr3,23915074,23915098,IMR90|chr3:23806602-23806642,chr3,23806602,23806642,1,108472
IMR90|chr3:23915109-23915175,chr3,23915109,23915175,IMR90|chr3:23805252-23805336,chr3,23805252,23805336,1,109857
IMR90|chr3:24037117-24037151,chr3,24037117,24037151,IMR90|chr3:37286000-37286104,chr3,37286000,37286104,1,13248883
IMR90|chr3:29330894-29330964,chr3,29330894,29330964,IMR90|chr3:196013388-196013427,chr3,196013388,196013427,1,166682494
IMR90|chr3:29367129-29367191,chr3,29367129,29367191,IMR90|chr3:27412253-27412308,chr3,27412253,27412308,1,1954876
IMR90|chr3:29367133-29367191,chr3,29367133,29367191,IMR90|chr3:27412251-27412308,chr3,27412251,27412308,1,1954882
IMR90|chr3:29419880-29419984,chr3,29419880,29419984,IMR90|chr3:50284087-50284146,chr3,50284087,50284146,1,20864207
IMR90|chr3:29419897-29419988,chr3,29419897,29419988,IMR90|chr3:50284087-50284146,chr3,50284087,50284146,1,20864190
IMR90|chr3:29686255-29686349,chr3,29686255,29686349,IMR90|chr3:27523973-27524082,chr3,27523973,27524082,1,2162282
IMR90|chr3:29686255-29686296,chr3,29686255,29686296,IMR90|chr3:27523973-27524082,chr3,27523973,27524082,1,2162282
IMR90|chr3:30660172-30660214,chr3,30660172,30660214,IMR90|chr3:69135147-69135214,chr3,69135147,69135214,1,38474975
IMR90|chr3:30660172-30660213,chr3,30660172,30660213,IMR90|chr3:69135147-69135214,chr3,69135147,69135214,1,38474975
IMR90|chr3:30660173-30660219,chr3,30660173,30660219,IMR90|chr3:48721772-48721821,chr3,48721772,48721821,1,18061599
IMR90|chr3:30692999-30693025,chr3,30692999,30693025,IMR90|chr3:185653759-185653833,chr3,185653759,185653833,1,154960760
IMR90|chr3:30710452-30710540,chr3,30710452,30710540,IMR90|chr3:183894158-183894188,chr3,183894158,183894188,1,153183706
IMR90|chr3:30710454-30710540,chr3,30710454,30710540,IMR90|chr3:183894158-183894188,chr3,183894158,183894188,1,153183704
IMR90|chr3:30725423-30725530,chr3,30725423,30725530,IMR90|chr3:15905455-15905545,chr3,15905455,15905545,1,14819968
IMR90|chr3:30725427-30725530,chr3,30725427,30725530,IMR90|chr3:15905455-15905546,chr3,15905455,15905546,1,14819972
IMR90|chr3:32455108-32455195,chr3,32455108,32455195,IMR90|chr3:185538858-185538921,chr3,185538858,185538921,1,153083750
IMR90|chr3:37963184-37963306,chr3,37963184,37963306,IMR90|chr3:38175002-38175030,chr3,38175002,38175030,1,211818
IMR90|chr3:37963196-37963346,chr3,37963196,37963346,IMR90|chr3:38175002-38175030,chr3,38175002,38175030,1,211806
IMR90|chr3:37990132-37990233,chr3,37990132,37990233,IMR90|chr3:38176981-38177019,chr3,38176981,38177019,1,186849
IMR90|chr3:37990132-37990232,chr3,37990132,37990232,IMR90|chr3:38176981-38177019,chr3,38176981,38177019,1,186849
IMR90|chr3:37990498-37990625,chr3,37990498,37990625,IMR90|chr3:38176772-38176790,chr3,38176772,38176790,1,186274
IMR90|chr3:37990498-37990624,chr3,37990498,37990624,IMR90|chr3:38176772-38176790,chr3,38176772,38176790,1,186274
IMR90|chr3:37992988-37993114,chr3,37992988,37993114,IMR90|chr3:48482766-48482873,chr3,48482766,48482873,1,10489778
IMR90|chr3:38254834-38254915,chr3,38254834,38254915,IMR90|chr3:141106420-141106462,chr3,141106420,141106462,1,102851586
IMR90|chr3:38254834-38254914,chr3,38254834,38254914,IMR90|chr3:141106420-141106462,chr3,141106420,141106462,1,102851586
IMR90|chr3:42096586-42096699,chr3,42096586,42096699,IMR90|chr3:39419991-39420027,chr3,39419991,39420027,1,2676595
IMR90|chr3:42096596-42096746,chr3,42096596,42096746,IMR90|chr3:39419991-39420027,chr3,39419991,39420027,1,2676605
IMR90|chr3:43432062-43432127,chr3,43432062,43432127,IMR90|chr3:44803609-44803699,chr3,44803609,44803699,1,1371547
IMR90|chr3:43432062-43432122,chr3,43432062,43432122,IMR90|chr3:44803609-44803699,chr3,44803609,44803699,1,1371547
IMR90|chr3:45555028-45555112,chr3,45555028,45555112,IMR90|chr3:45018176-45018249,chr3,45018176,45018249,1,536852
IMR90|chr3:45555036-45555113,chr3,45555036,45555113,IMR90|chr3:45018176-45018249,chr3,45018176,45018249,1,536860
IMR90|chr3:45555044-45555113,chr3,45555044,45555113,IMR90|chr3:45018176-45018249,chr3,45018176,45018249,1,536868
IMR90|chr3:45713648-45713724,chr3,45713648,45713724,IMR90|chr3:49447437-49447470,chr3,49447437,49447470,1,3733789
IMR90|chr3:45714114-45714142,chr3,45714114,45714142,IMR90|chr3:49447579-49447607,chr3,49447579,49447607,1,3733465
IMR90|chr3:48110800-48110836,chr3,48110800,48110836,IMR90|chr3:99981740-99981804,chr3,99981740,99981804,1,51870940
IMR90|chr3:48110800-48110835,chr3,48110800,48110835,IMR90|chr3:99981740-99981804,chr3,99981740,99981804,1,51870940
IMR90|chr3:48118149-48118207,chr3,48118149,48118207,IMR90|chr3:55521638-55521730,chr3,55521638,55521730,1,7403489
IMR90|chr3:48122543-48122693,chr3,48122543,48122693,IMR90|chr3:99982295-99982442,chr3,99982295,99982442,1,51859752
IMR90|chr3:49519822-49519874,chr3,49519822,49519874,IMR90|chr3:48129889-48130039,chr3,48129889,48130039,1,1389933
IMR90|chr3:49999463-49999583,chr3,49999463,49999583,IMR90|chr3:49974750-49974817,chr3,49974750,49974817,1,24713
IMR90|chr3:49999463-49999546,chr3,49999463,49999546,IMR90|chr3:49974750-49974817,chr3,49974750,49974817,1,24713
IMR90|chr3:50298919-50299049,chr3,50298919,50299049,IMR90|chr3:50394934-50394975,chr3,50394934,50394975,1,96015
IMR90|chr3:50298919-50299028,chr3,50298919,50299028,IMR90|chr3:50394934-50394975,chr3,50394934,50394975,1,96015
IMR90|chr3:50299120-50299215,chr3,50299120,50299215,IMR90|chr3:50276208-50276284,chr3,50276208,50276284,1,22912
IMR90|chr3:50299120-50299194,chr3,50299120,50299194,IMR90|chr3:50276208-50276284,chr3,50276208,50276284,1,22912
IMR90|chr3:50299378-50299426,chr3,50299378,50299426,IMR90|chr3:50274404-50274503,chr3,50274404,50274503,1,24974
IMR90|chr3:51620560-51620615,chr3,51620560,51620615,IMR90|chr3:51574100-51574137,chr3,51574100,51574137,1,46460
IMR90|chr3:51623275-51623397,chr3,51623275,51623397,IMR90|chr3:51574781-51574898,chr3,51574781,51574898,1,48494
IMR90|chr3:51623365-51623398,chr3,51623365,51623398,IMR90|chr3:51574781-51574898,chr3,51574781,51574898,1,48584
IMR90|chr3:51624214-51624303,chr3,51624214,51624303,IMR90|chr3:51574789-51574913,chr3,51574789,51574913,1,49425
IMR90|chr3:53299119-53299218,chr3,53299119,53299218,IMR90|chr3:53293642-53293679,chr3,53293642,53293679,1,5477
IMR90|chr3:53301650-53301712,chr3,53301650,53301712,IMR90|chr3:53287677-53287728,chr3,53287677,53287728,1,13973
IMR90|chr3:55499205-55499241,chr3,55499205,55499241,IMR90|chr3:55512651-55512729,chr3,55512651,55512729,1,13446
IMR90|chr3:55499247-55499325,chr3,55499247,55499325,IMR90|chr3:55514332-55514387,chr3,55514332,55514387,1,15085
IMR90|chr3:58149765-58149806,chr3,58149765,58149806,IMR90|chr3:71113758-71113807,chr3,71113758,71113807,1,12963993
IMR90|chr3:61607798-61607828,chr3,61607798,61607828,IMR90|chr3:48635844-48635929,chr3,48635844,48635929,1,12971954
IMR90|chr3:61607798-61607827,chr3,61607798,61607827,IMR90|chr3:48635844-48635929,chr3,48635844,48635929,1,12971954
IMR90|chr3:61608945-61609047,chr3,61608945,61609047,IMR90|chr3:58478568-58478616,chr3,58478568,58478616,1,3130377
IMR90|chr3:61608946-61609071,chr3,61608946,61609071,IMR90|chr3:58478568-58478616,chr3,58478568,58478616,1,3130378
IMR90|chr3:61801420-61801552,chr3,61801420,61801552,IMR90|chr3:187873055-187873155,chr3,187873055,187873155,1,126071635
IMR90|chr3:61801503-61801553,chr3,61801503,61801553,IMR90|chr3:187873055-187873155,chr3,187873055,187873155,1,126071552
IMR90|chr3:61809914-61809960,chr3,61809914,61809960,IMR90|chr3:64251823-64251893,chr3,64251823,64251893,1,2441909
IMR90|chr3:61833157-61833226,chr3,61833157,61833226,IMR90|chr3:55515632-55515701,chr3,55515632,55515701,1,6317525
IMR90|chr3:61848689-61848809,chr3,61848689,61848809,IMR90|chr3:55520410-55520454,chr3,55520410,55520454,1,6328279
IMR90|chr3:61848693-61848798,chr3,61848693,61848798,IMR90|chr3:55520410-55520454,chr3,55520410,55520454,1,6328283
IMR90|chr3:61864197-61864258,chr3,61864197,61864258,IMR90|chr3:64252603-64252638,chr3,64252603,64252638,1,2388406
IMR90|chr3:61864198-61864258,chr3,61864198,61864258,IMR90|chr3:64252609-64252638,chr3,64252609,64252638,1,2388411
IMR90|chr3:61864211-61864258,chr3,61864211,61864258,IMR90|chr3:64252603-64252638,chr3,64252603,64252638,1,2388392
IMR90|chr3:64169455-64169502,chr3,64169455,64169502,IMR90|chr3:50274025-50274128,chr3,50274025,50274128,1,13895430
IMR90|chr3:64180049-64180124,chr3,64180049,64180124,IMR90|chr3:69058994-69059029,chr3,69058994,69059029,1,4878945
IMR90|chr3:64180050-64180124,chr3,64180050,64180124,IMR90|chr3:69058994-69059029,chr3,69058994,69059029,1,4878944
IMR90|chr3:64199635-64199703,chr3,64199635,64199703,IMR90|chr3:50276031-50276127,chr3,50276031,50276127,1,13923604
IMR90|chr3:64199657-64199703,chr3,64199657,64199703,IMR90|chr3:50276031-50276127,chr3,50276031,50276127,1,13923626
IMR90|chr3:65984823-65984850,chr3,65984823,65984850,IMR90|chr3:99980791-99980874,chr3,99980791,99980874,1,33995968
IMR90|chr3:65992880-65992932,chr3,65992880,65992932,IMR90|chr3:57995891-57995991,chr3,57995891,57995991,1,7996989
IMR90|chr3:65992886-65992936,chr3,65992886,65992936,IMR90|chr3:57995891-57995991,chr3,57995891,57995991,1,7996995
IMR90|chr3:65999426-65999480,chr3,65999426,65999480,IMR90|chr3:99982366-99982437,chr3,99982366,99982437,1,33982940
IMR90|chr3:65999431-65999480,chr3,65999431,65999480,IMR90|chr3:99982366-99982437,chr3,99982366,99982437,1,33982935
IMR90|chr3:65999459-65999480,chr3,65999459,65999480,IMR90|chr3:99982366-99982437,chr3,99982366,99982437,1,33982907
IMR90|chr3:66535025-66535119,chr3,66535025,66535119,IMR90|chr3:51999437-51999471,chr3,51999437,51999471,1,14535588
IMR90|chr3:66535025-66535118,chr3,66535025,66535118,IMR90|chr3:51999437-51999471,chr3,51999437,51999471,1,14535588
IMR90|chr3:71032391-71032453,chr3,71032391,71032453,IMR90|chr3:48596796-48596866,chr3,48596796,48596866,1,22435595
IMR90|chr3:71032391-71032452,chr3,71032391,71032452,IMR90|chr3:48596796-48596866,chr3,48596796,48596866,1,22435595
IMR90|chr3:71103090-71103168,chr3,71103090,71103168,IMR90|chr3:73048230-73048298,chr3,73048230,73048298,1,1945140
IMR90|chr3:71103091-71103168,chr3,71103091,71103168,IMR90|chr3:73048228-73048298,chr3,73048228,73048298,1,1945137
IMR90|chr3:71104093-71104134,chr3,71104093,71104134,IMR90|chr3:73048924-73049027,chr3,73048924,73049027,1,1944831
IMR90|chr3:71104095-71104134,chr3,71104095,71104134,IMR90|chr3:73048924-73049027,chr3,73048924,73049027,1,1944829
IMR90|chr3:71306478-71306558,chr3,71306478,71306558,IMR90|chr3:39451399-39451524,chr3,39451399,39451524,1,31855079
IMR90|chr3:71306478-71306550,chr3,71306478,71306550,IMR90|chr3:39451399-39451524,chr3,39451399,39451524,1,31855079
IMR90|chr3:76097390-76097461,chr3,76097390,76097461,IMR90|chr3:63898642-63898705,chr3,63898642,63898705,1,12198748
IMR90|chr3:76421639-76421675,chr3,76421639,76421675,IMR90|chr3:37219605-37219753,chr3,37219605,37219753,1,39202034
IMR90|chr3:81776745-81776795,chr3,81776745,81776795,IMR90|chr3:120169088-120169148,chr3,120169088,120169148,1,38392343
IMR90|chr3:81786219-81786275,chr3,81786219,81786275,IMR90|chr3:123303123-123303173,chr3,123303123,123303173,1,41516904
IMR90|chr3:81786219-81786249,chr3,81786219,81786249,IMR90|chr3:123303123-123303173,chr3,123303123,123303173,1,41516904
IMR90|chr3:81786220-81786275,chr3,81786220,81786275,IMR90|chr3:123303123-123303173,chr3,123303123,123303173,1,41516903
IMR90|chr3:98595139-98595219,chr3,98595139,98595219,IMR90|chr3:39451564-39451603,chr3,39451564,39451603,1,59143575
IMR90|chr3:98596508-98596533,chr3,98596508,98596533,IMR90|chr3:39450784-39450934,chr3,39450784,39450934,1,59145724
IMR90|chr3:98599965-98600053,chr3,98599965,98600053,IMR90|chr3:110792095-110792145,chr3,110792095,110792145,1,12192130
IMR90|chr3:98600827-98600870,chr3,98600827,98600870,IMR90|chr3:44045137-44045188,chr3,44045137,44045188,1,54555690
IMR90|chr3:98600827-98600867,chr3,98600827,98600867,IMR90|chr3:44045137-44045188,chr3,44045137,44045188,1,54555690
IMR90|chr3:98603797-98603827,chr3,98603797,98603827,IMR90|chr3:110794368-110794466,chr3,110794368,110794466,1,12190571
IMR90|chr3:98604610-98604653,chr3,98604610,98604653,IMR90|chr3:123601986-123602136,chr3,123601986,123602136,1,24997376
IMR90|chr3:98610383-98610470,chr3,98610383,98610470,IMR90|chr3:123601382-123601445,chr3,123601382,123601445,1,24990999
IMR90|chr3:98610384-98610470,chr3,98610384,98610470,IMR90|chr3:123601382-123601445,chr3,123601382,123601445,1,24990998
IMR90|chr3:99373436-99373508,chr3,99373436,99373508,IMR90|chr3:47822986-47823035,chr3,47822986,47823035,1,51550450
IMR90|chr3:99411945-99412044,chr3,99411945,99412044,IMR90|chr3:124450613-124450713,chr3,124450613,124450713,1,25038668
IMR90|chr3:99411945-99412021,chr3,99411945,99412021,IMR90|chr3:124450613-124450713,chr3,124450613,124450713,1,25038668
IMR90|chr3:99411994-99412044,chr3,99411994,99412044,IMR90|chr3:124450613-124450713,chr3,124450613,124450713,1,25038619
IMR90|chr3:99505503-99505545,chr3,99505503,99505545,IMR90|chr3:52004387-52004422,chr3,52004387,52004422,1,47501116
IMR90|chr3:99505503-99505544,chr3,99505503,99505544,IMR90|chr3:52004387-52004422,chr3,52004387,52004422,1,47501116
IMR90|chr3:99586624-99586693,chr3,99586624,99586693,IMR90|chr3:186283889-186283968,chr3,186283889,186283968,1,86697265
IMR90|chr3:105108263-105108323,chr3,105108263,105108323,IMR90|chr3:9440162-9440213,chr3,9440162,9440213,1,95668101
IMR90|chr3:105108263-105108321,chr3,105108263,105108321,IMR90|chr3:9440162-9440213,chr3,9440162,9440213,1,95668101
IMR90|chr3:105134806-105134828,chr3,105134806,105134828,IMR90|chr3:98618335-98618457,chr3,98618335,98618457,1,6516471
IMR90|chr3:105134808-105134828,chr3,105134808,105134828,IMR90|chr3:98618335-98618457,chr3,98618335,98618457,1,6516473
IMR90|chr3:105217540-105217591,chr3,105217540,105217591,IMR90|chr3:98619232-98619309,chr3,98619232,98619309,1,6598308
IMR90|chr3:105226795-105226879,chr3,105226795,105226879,IMR90|chr3:9432286-9432345,chr3,9432286,9432345,1,95794509
IMR90|chr3:105538096-105538169,chr3,105538096,105538169,IMR90|chr3:98619393-98619448,chr3,98619393,98619448,1,6918703
IMR90|chr3:105538096-105538167,chr3,105538096,105538167,IMR90|chr3:98619393-98619448,chr3,98619393,98619448,1,6918703
IMR90|chr3:110822554-110822618,chr3,110822554,110822618,IMR90|chr3:184037367-184037446,chr3,184037367,184037446,1,73214813
IMR90|chr3:110822554-110822617,chr3,110822554,110822617,IMR90|chr3:184037367-184037446,chr3,184037367,184037446,1,73214813
IMR90|chr3:110920798-110920821,chr3,110920798,110920821,IMR90|chr3:14167589-14167698,chr3,14167589,14167698,1,96753209
IMR90|chr3:110920798-110920820,chr3,110920798,110920820,IMR90|chr3:14167589-14167698,chr3,14167589,14167698,1,96753209
IMR90|chr3:110920799-110920820,chr3,110920799,110920820,IMR90|chr3:14167589-14167698,chr3,14167589,14167698,1,96753210
IMR90|chr3:112350084-112350127,chr3,112350084,112350127,IMR90|chr3:128906788-128906846,chr3,128906788,128906846,1,16556704
IMR90|chr3:114307006-114307047,chr3,114307006,114307047,IMR90|chr3:128447458-128447593,chr3,128447458,128447593,1,14140452
IMR90|chr3:120147291-120147359,chr3,120147291,120147359,IMR90|chr3:132376918-132377014,chr3,132376918,132377014,1,12229627
IMR90|chr3:120147291-120147345,chr3,120147291,120147345,IMR90|chr3:132376918-132377014,chr3,132376918,132377014,1,12229627
IMR90|chr3:120148105-120148255,chr3,120148105,120148255,IMR90|chr3:132383837-132383858,chr3,132383837,132383858,1,12235732
IMR90|chr3:120148151-120148280,chr3,120148151,120148280,IMR90|chr3:132383837-132383858,chr3,132383837,132383858,1,12235686
IMR90|chr3:120184045-120184143,chr3,120184045,120184143,IMR90|chr3:120172388-120172514,chr3,120172388,120172514,1,11657
IMR90|chr3:120186871-120186978,chr3,120186871,120186978,IMR90|chr3:120170534-120170579,chr3,120170534,120170579,1,16337
IMR90|chr3:120186877-120186982,chr3,120186877,120186982,IMR90|chr3:120170534-120170579,chr3,120170534,120170579,1,16343
IMR90|chr3:123232994-123233040,chr3,123232994,123233040,IMR90|chr3:180630825-180630874,chr3,180630825,180630874,1,57397831
IMR90|chr3:123363591-123363627,chr3,123363591,123363627,IMR90|chr3:9440915-9441028,chr3,9440915,9441028,1,113922676
IMR90|chr3:123363594-123363631,chr3,123363594,123363631,IMR90|chr3:9440915-9441028,chr3,9440915,9441028,1,113922679
IMR90|chr3:123363595-123363631,chr3,123363595,123363631,IMR90|chr3:9440915-9441028,chr3,9440915,9441028,1,113922680
IMR90|chr3:123398424-123398478,chr3,123398424,123398478,IMR90|chr3:156270937-156271056,chr3,156270937,156271056,1,32872513
IMR90|chr3:123398425-123398478,chr3,123398425,123398478,IMR90|chr3:156270937-156271056,chr3,156270937,156271056,1,32872512
IMR90|chr3:123447110-123447178,chr3,123447110,123447178,IMR90|chr3:53287011-53287077,chr3,53287011,53287077,1,70160099
IMR90|chr3:123447111-123447178,chr3,123447111,123447178,IMR90|chr3:53287011-53287078,chr3,53287011,53287078,1,70160100
IMR90|chr3:123447111-123447177,chr3,123447111,123447177,IMR90|chr3:53287011-53287078,chr3,53287011,53287078,1,70160100
IMR90|chr3:123468006-123468116,chr3,123468006,123468116,IMR90|chr3:142720980-142721020,chr3,142720980,142721020,1,19252974
IMR90|chr3:123468007-123468117,chr3,123468007,123468117,IMR90|chr3:142720980-142721020,chr3,142720980,142721020,1,19252973
IMR90|chr3:123468007-123468115,chr3,123468007,123468115,IMR90|chr3:142720980-142721019,chr3,142720980,142721019,1,19252973
IMR90|chr3:123470242-123470352,chr3,123470242,123470352,IMR90|chr3:150131894-150131933,chr3,150131894,150131933,1,26661652
IMR90|chr3:123470249-123470348,chr3,123470249,123470348,IMR90|chr3:150131894-150131933,chr3,150131894,150131933,1,26661645
IMR90|chr3:123481606-123481641,chr3,123481606,123481641,IMR90|chr3:66023049-66023133,chr3,66023049,66023133,1,57458557
IMR90|chr3:123493904-123493967,chr3,123493904,123493967,IMR90|chr3:184036791-184036857,chr3,184036791,184036857,1,60542887
IMR90|chr3:123493920-123493967,chr3,123493920,123493967,IMR90|chr3:184036791-184036857,chr3,184036791,184036857,1,60542871
IMR90|chr3:123506923-123506992,chr3,123506923,123506992,IMR90|chr3:49132427-49132496,chr3,49132427,49132496,1,74374496
IMR90|chr3:123534359-123534465,chr3,123534359,123534465,IMR90|chr3:150129367-150129486,chr3,150129367,150129486,1,26595008
IMR90|chr3:123534436-123534467,chr3,123534436,123534467,IMR90|chr3:150129367-150129486,chr3,150129367,150129486,1,26594931
IMR90|chr3:123576764-123576883,chr3,123576764,123576883,IMR90|chr3:128901133-128901188,chr3,128901133,128901188,1,5324369
IMR90|chr3:123576789-123576883,chr3,123576789,123576883,IMR90|chr3:128901133-128901188,chr3,128901133,128901188,1,5324344
IMR90|chr3:123588035-123588138,chr3,123588035,123588138,IMR90|chr3:128886165-128886222,chr3,128886165,128886222,1,5298130
IMR90|chr3:123588035-123588128,chr3,123588035,123588128,IMR90|chr3:128886165-128886222,chr3,128886165,128886222,1,5298130
IMR90|chr3:124545550-124545634,chr3,124545550,124545634,IMR90|chr3:125092502-125092652,chr3,125092502,125092652,1,546952
IMR90|chr3:126575977-126576043,chr3,126575977,126576043,IMR90|chr3:99983035-99983129,chr3,99983035,99983129,1,26592942
IMR90|chr3:126575977-126576019,chr3,126575977,126576019,IMR90|chr3:99983035-99983143,chr3,99983035,99983143,1,26592942
IMR90|chr3:127513619-127513708,chr3,127513619,127513708,IMR90|chr3:112737635-112737709,chr3,112737635,112737709,1,14775984
IMR90|chr3:127513632-127513708,chr3,127513632,127513708,IMR90|chr3:112737635-112737709,chr3,112737635,112737709,1,14775997
IMR90|chr3:127829781-127829883,chr3,127829781,127829883,IMR90|chr3:48343475-48343514,chr3,48343475,48343514,1,79486306
IMR90|chr3:127829783-127829883,chr3,127829783,127829883,IMR90|chr3:48343475-48343514,chr3,48343475,48343514,1,79486308
IMR90|chr3:127934724-127934837,chr3,127934724,127934837,IMR90|chr3:48130118-48130149,chr3,48130118,48130149,1,79804606
IMR90|chr3:127934724-127934831,chr3,127934724,127934831,IMR90|chr3:48130118-48130149,chr3,48130118,48130149,1,79804606
IMR90|chr3:128521360-128521448,chr3,128521360,128521448,IMR90|chr3:128885943-128886005,chr3,128885943,128886005,1,364583
IMR90|chr3:128917980-128918114,chr3,128917980,128918114,IMR90|chr3:128903259-128903315,chr3,128903259,128903315,1,14721
IMR90|chr3:128917980-128918087,chr3,128917980,128918087,IMR90|chr3:128903265-128903315,chr3,128903265,128903315,1,14715
IMR90|chr3:128917980-128918074,chr3,128917980,128918074,IMR90|chr3:128903259-128903315,chr3,128903259,128903315,1,14721
IMR90|chr3:128917980-128918066,chr3,128917980,128918066,IMR90|chr3:128903255-128903315,chr3,128903255,128903315,1,14725
IMR90|chr3:128917980-128918058,chr3,128917980,128918058,IMR90|chr3:128903262-128903315,chr3,128903262,128903315,1,14718
IMR90|chr3:128917980-128918053,chr3,128917980,128918053,IMR90|chr3:128903216-128903315,chr3,128903216,128903315,1,14764
IMR90|chr3:128917980-128918031,chr3,128917980,128918031,IMR90|chr3:128903216-128903315,chr3,128903216,128903315,1,14764
IMR90|chr3:128919950-128920013,chr3,128919950,128920013,IMR90|chr3:128906088-128906141,chr3,128906088,128906141,1,13862
IMR90|chr3:132155109-132155160,chr3,132155109,132155160,IMR90|chr3:139107740-139107812,chr3,139107740,139107812,1,6952631
IMR90|chr3:132155109-132155159,chr3,132155109,132155159,IMR90|chr3:139107740-139107803,chr3,139107740,139107803,1,6952631
IMR90|chr3:135712484-135712538,chr3,135712484,135712538,IMR90|chr3:156394892-156394910,chr3,156394892,156394910,1,20682408
IMR90|chr3:135862170-135862202,chr3,135862170,135862202,IMR90|chr3:135913485-135913548,chr3,135913485,135913548,1,51315
IMR90|chr3:135867548-135867609,chr3,135867548,135867609,IMR90|chr3:135913101-135913128,chr3,135913101,135913128,1,45553
IMR90|chr3:137777808-137777865,chr3,137777808,137777865,IMR90|chr3:149686564-149686655,chr3,149686564,149686655,1,11908756
IMR90|chr3:137777809-137777864,chr3,137777809,137777864,IMR90|chr3:149686564-149686655,chr3,149686564,149686655,1,11908755
IMR90|chr3:141131367-141131425,chr3,141131367,141131425,IMR90|chr3:149687754-149687811,chr3,149687754,149687811,1,8556387
IMR90|chr3:141131367-141131423,chr3,141131367,141131423,IMR90|chr3:149687754-149687811,chr3,149687754,149687811,1,8556387
IMR90|chr3:141131368-141131425,chr3,141131368,141131425,IMR90|chr3:149687753-149687811,chr3,149687753,149687811,1,8556385
IMR90|chr3:141131368-141131423,chr3,141131368,141131423,IMR90|chr3:149687754-149687811,chr3,149687754,149687811,1,8556386
IMR90|chr3:141252171-141252220,chr3,141252171,141252220,IMR90|chr3:52566821-52566949,chr3,52566821,52566949,1,88685350
IMR90|chr3:149247807-149247915,chr3,149247807,149247915,IMR90|chr3:187461059-187461101,chr3,187461059,187461101,1,38213252
IMR90|chr3:149247845-149247995,chr3,149247845,149247995,IMR90|chr3:187461059-187461101,chr3,187461059,187461101,1,38213214
IMR90|chr3:149281839-149281900,chr3,149281839,149281900,IMR90|chr3:57581557-57581646,chr3,57581557,57581646,1,91700282
IMR90|chr3:149365542-149365692,chr3,149365542,149365692,IMR90|chr3:52347667-52347710,chr3,52347667,52347710,1,97017875
IMR90|chr3:149365623-149365730,chr3,149365623,149365730,IMR90|chr3:52347667-52347710,chr3,52347667,52347710,1,97017956
IMR90|chr3:152043802-152043821,chr3,152043802,152043821,IMR90|chr3:139107206-139107258,chr3,139107206,139107258,1,12936596
IMR90|chr3:152073834-152073948,chr3,152073834,152073948,IMR90|chr3:150132784-150132826,chr3,150132784,150132826,1,1941050
IMR90|chr3:152073854-152073949,chr3,152073854,152073949,IMR90|chr3:150132784-150132826,chr3,150132784,150132826,1,1941070
IMR90|chr3:152097397-152097455,chr3,152097397,152097455,IMR90|chr3:120169364-120169419,chr3,120169364,120169419,1,31928033
IMR90|chr3:152097397-152097454,chr3,152097397,152097454,IMR90|chr3:120169364-120169419,chr3,120169364,120169419,1,31928033
IMR90|chr3:152097397-152097452,chr3,152097397,152097452,IMR90|chr3:120169364-120169419,chr3,120169364,120169419,1,31928033
IMR90|chr3:152143989-152144092,chr3,152143989,152144092,IMR90|chr3:150263714-150263746,chr3,150263714,150263746,1,1880275
IMR90|chr3:152143989-152144091,chr3,152143989,152144091,IMR90|chr3:150263714-150263746,chr3,150263714,150263746,1,1880275
IMR90|chr3:152144008-152144092,chr3,152144008,152144092,IMR90|chr3:150263714-150263746,chr3,150263714,150263746,1,1880294
IMR90|chr3:155000743-155000788,chr3,155000743,155000788,IMR90|chr3:155027990-155028018,chr3,155027990,155028018,1,27247
IMR90|chr3:156407786-156407828,chr3,156407786,156407828,IMR90|chr3:156270010-156270080,chr3,156270010,156270080,1,137776
IMR90|chr3:156408471-156408619,chr3,156408471,156408619,IMR90|chr3:156270271-156270313,chr3,156270271,156270313,1,138200
IMR90|chr3:156408511-156408619,chr3,156408511,156408619,IMR90|chr3:156270271-156270313,chr3,156270271,156270313,1,138240
IMR90|chr3:156415182-156415276,chr3,156415182,156415276,IMR90|chr3:156272118-156272135,chr3,156272118,156272135,1,143064
IMR90|chr3:156415182-156415227,chr3,156415182,156415227,IMR90|chr3:156272118-156272135,chr3,156272118,156272135,1,143064
IMR90|chr3:159526136-159526201,chr3,159526136,159526201,IMR90|chr3:151987721-151987787,chr3,151987721,151987787,1,7538415
IMR90|chr3:159526136-159526200,chr3,159526136,159526200,IMR90|chr3:151987720-151987787,chr3,151987720,151987787,1,7538416
IMR90|chr3:159607336-159607363,chr3,159607336,159607363,IMR90|chr3:45270925-45271030,chr3,45270925,45271030,1,114336411
IMR90|chr3:168818162-168818208,chr3,168818162,168818208,IMR90|chr3:182512163-182512263,chr3,182512163,182512263,1,13694001
IMR90|chr3:171781530-171781660,chr3,171781530,171781660,IMR90|chr3:187454649-187454684,chr3,187454649,187454684,1,15673119
IMR90|chr3:171781530-171781614,chr3,171781530,171781614,IMR90|chr3:187454649-187454684,chr3,187454649,187454684,1,15673119
IMR90|chr3:171781545-171781660,chr3,171781545,171781660,IMR90|chr3:187454649-187454684,chr3,187454649,187454684,1,15673104
IMR90|chr3:171812516-171812552,chr3,171812516,171812552,IMR90|chr3:33479940-33480078,chr3,33479940,33480078,1,138332576
IMR90|chr3:171861547-171861596,chr3,171861547,171861596,IMR90|chr3:113463150-113463296,chr3,113463150,113463296,1,58398397
IMR90|chr3:171863569-171863618,chr3,171863569,171863618,IMR90|chr3:122916430-122916548,chr3,122916430,122916548,1,48947139
IMR90|chr3:171863666-171863815,chr3,171863666,171863815,IMR90|chr3:122916460-122916542,chr3,122916460,122916542,1,48947206
IMR90|chr3:171877772-171877811,chr3,171877772,171877811,IMR90|chr3:120462150-120462285,chr3,120462150,120462285,1,51415622
IMR90|chr3:171881266-171881374,chr3,171881266,171881374,IMR90|chr3:184034840-184034878,chr3,184034840,184034878,1,12153574
IMR90|chr3:171891695-171891792,chr3,171891695,171891792,IMR90|chr3:184034690-184034743,chr3,184034690,184034743,1,12142995
IMR90|chr3:171891696-171891809,chr3,171891696,171891809,IMR90|chr3:184034690-184034743,chr3,184034690,184034743,1,12142994
IMR90|chr3:171936509-171936568,chr3,171936509,171936568,IMR90|chr3:180632999-180633090,chr3,180632999,180633090,1,8696490
IMR90|chr3:171984339-171984369,chr3,171984339,171984369,IMR90|chr3:187873499-187873617,chr3,187873499,187873617,1,15889160
IMR90|chr3:171990208-171990312,chr3,171990208,171990312,IMR90|chr3:136581162-136581309,chr3,136581162,136581309,1,35409046
IMR90|chr3:171990208-171990302,chr3,171990208,171990302,IMR90|chr3:136581162-136581309,chr3,136581162,136581309,1,35409046
IMR90|chr3:171996005-171996108,chr3,171996005,171996108,IMR90|chr3:120166693-120166799,chr3,120166693,120166799,1,51829312
IMR90|chr3:171996076-171996114,chr3,171996076,171996114,IMR90|chr3:120166693-120166799,chr3,120166693,120166799,1,51829383
IMR90|chr3:172041097-172041173,chr3,172041097,172041173,IMR90|chr3:120168132-120168186,chr3,120168132,120168186,1,51872965
IMR90|chr3:176849118-176849178,chr3,176849118,176849178,IMR90|chr3:52721711-52721793,chr3,52721711,52721793,1,124127407
IMR90|chr3:176849118-176849176,chr3,176849118,176849176,IMR90|chr3:52721711-52721793,chr3,52721711,52721793,1,124127407
IMR90|chr3:176901105-176901170,chr3,176901105,176901170,IMR90|chr3:157154894-157155031,chr3,157154894,157155031,1,19746211
IMR90|chr3:176901663-176901715,chr3,176901663,176901715,IMR90|chr3:140951171-140951244,chr3,140951171,140951244,1,35950492
IMR90|chr3:183483676-183483735,chr3,183483676,183483735,IMR90|chr3:12328009-12328106,chr3,12328009,12328106,1,171155667
IMR90|chr3:183483683-183483736,chr3,183483683,183483736,IMR90|chr3:12328009-12328106,chr3,12328009,12328106,1,171155674
IMR90|chr3:183483690-183483736,chr3,183483690,183483736,IMR90|chr3:12328009-12328106,chr3,12328009,12328106,1,171155681
IMR90|chr3:185411909-185411988,chr3,185411909,185411988,IMR90|chr3:183896954-183896996,chr3,183896954,183896996,1,1514955
IMR90|chr3:185421089-185421137,chr3,185421089,185421137,IMR90|chr3:193311487-193311596,chr3,193311487,193311596,1,7890398
IMR90|chr3:185421096-185421137,chr3,185421096,185421137,IMR90|chr3:193311487-193311596,chr3,193311487,193311596,1,7890391
IMR90|chr3:185422562-185422608,chr3,185422562,185422608,IMR90|chr3:193311267-193311325,chr3,193311267,193311325,1,7888705
IMR90|chr3:185425539-185425595,chr3,185425539,185425595,IMR90|chr3:185653772-185653823,chr3,185653772,185653823,1,228233
IMR90|chr3:185440453-185440571,chr3,185440453,185440571,IMR90|chr3:50373516-50373549,chr3,50373516,50373549,1,135066937
IMR90|chr3:185440454-185440571,chr3,185440454,185440571,IMR90|chr3:50373516-50373549,chr3,50373516,50373549,1,135066938
IMR90|chr3:185441871-185441910,chr3,185441871,185441910,IMR90|chr3:185654845-185654946,chr3,185654845,185654946,1,212974
IMR90|chr3:185458985-185459093,chr3,185458985,185459093,IMR90|chr3:187931772-187931809,chr3,187931772,187931809,1,2472787
IMR90|chr3:185467047-185467110,chr3,185467047,185467110,IMR90|chr3:185543034-185543088,chr3,185543034,185543088,1,75987
IMR90|chr3:185467898-185467976,chr3,185467898,185467976,IMR90|chr3:183893432-183893470,chr3,183893432,183893470,1,1574466
IMR90|chr3:185467898-185467975,chr3,185467898,185467975,IMR90|chr3:183893432-183893470,chr3,183893432,183893470,1,1574466
IMR90|chr3:185467942-185467976,chr3,185467942,185467976,IMR90|chr3:183893432-183893470,chr3,183893432,183893470,1,1574510
IMR90|chr3:185470392-185470488,chr3,185470392,185470488,IMR90|chr3:52439622-52439681,chr3,52439622,52439681,1,133030770
IMR90|chr3:185470392-185470483,chr3,185470392,185470483,IMR90|chr3:52439622-52439681,chr3,52439622,52439681,1,133030770
IMR90|chr3:185472262-185472298,chr3,185472262,185472298,IMR90|chr3:184532282-184532328,chr3,184532282,184532328,1,939980
IMR90|chr3:185473736-185473781,chr3,185473736,185473781,IMR90|chr3:52442938-52443001,chr3,52442938,52443001,1,133030798
IMR90|chr3:185475032-185475069,chr3,185475032,185475069,IMR90|chr3:185653840-185653920,chr3,185653840,185653920,1,178808
IMR90|chr3:185476168-185476250,chr3,185476168,185476250,IMR90|chr3:185653718-185653807,chr3,185653718,185653807,1,177550
IMR90|chr3:185478306-185478384,chr3,185478306,185478384,IMR90|chr3:187929430-187929479,chr3,187929430,187929479,1,2451124
IMR90|chr3:185478885-185478944,chr3,185478885,185478944,IMR90|chr3:185653718-185653807,chr3,185653718,185653807,1,174833
IMR90|chr3:185482538-185482579,chr3,185482538,185482579,IMR90|chr3:159483750-159483818,chr3,159483750,159483818,1,25998788
IMR90|chr3:185482538-185482576,chr3,185482538,185482576,IMR90|chr3:159483750-159483818,chr3,159483750,159483818,1,25998788
IMR90|chr3:185490096-185490149,chr3,185490096,185490149,IMR90|chr3:75705090-75705169,chr3,75705090,75705169,1,109785006
IMR90|chr3:185490804-185490878,chr3,185490804,185490878,IMR90|chr3:185545025-185545087,chr3,185545025,185545087,1,54221
IMR90|chr3:185490806-185490878,chr3,185490806,185490878,IMR90|chr3:185545025-185545087,chr3,185545025,185545087,1,54219
IMR90|chr3:185505681-185505738,chr3,185505681,185505738,IMR90|chr3:185547403-185547472,chr3,185547403,185547472,1,41722
IMR90|chr3:185507319-185507363,chr3,185507319,185507363,IMR90|chr3:185544272-185544337,chr3,185544272,185544337,1,36953
IMR90|chr3:185511117-185511168,chr3,185511117,185511168,IMR90|chr3:50365013-50365105,chr3,50365013,50365105,1,135146104
IMR90|chr3:185511639-185511687,chr3,185511639,185511687,IMR90|chr3:159485657-159485755,chr3,159485657,159485755,1,26025982
IMR90|chr3:185511649-185511687,chr3,185511649,185511687,IMR90|chr3:159485657-159485755,chr3,159485657,159485755,1,26025992
IMR90|chr3:187949502-187949593,chr3,187949502,187949593,IMR90|chr3:51573466-51573521,chr3,51573466,51573521,1,136376036
IMR90|chr3:187949503-187949593,chr3,187949503,187949593,IMR90|chr3:51573466-51573521,chr3,51573466,51573521,1,136376037
IMR90|chr3:187952612-187952653,chr3,187952612,187952653,IMR90|chr3:141102642-141102705,chr3,141102642,141102705,1,46849970
IMR90|chr3:187967598-187967664,chr3,187967598,187967664,IMR90|chr3:186283762-186283807,chr3,186283762,186283807,1,1683836
IMR90|chr3:187967598-187967656,chr3,187967598,187967656,IMR90|chr3:186283762-186283807,chr3,186283762,186283807,1,1683836
IMR90|chr3:187967598-187967653,chr3,187967598,187967653,IMR90|chr3:186283762-186283807,chr3,186283762,186283807,1,1683836
IMR90|chr3:187967599-187967664,chr3,187967599,187967664,IMR90|chr3:186283762-186283807,chr3,186283762,186283807,1,1683837
IMR90|chr3:187967599-187967656,chr3,187967599,187967656,IMR90|chr3:186283762-186283807,chr3,186283762,186283807,1,1683837
IMR90|chr3:187969689-187969732,chr3,187969689,187969732,IMR90|chr3:141105962-141106069,chr3,141105962,141106069,1,46863727
IMR90|chr3:187969689-187969723,chr3,187969689,187969723,IMR90|chr3:141105953-141106069,chr3,141105953,141106069,1,46863736
IMR90|chr3:187981724-187981754,chr3,187981724,187981754,IMR90|chr3:184036609-184036743,chr3,184036609,184036743,1,3945115
IMR90|chr3:188012673-188012744,chr3,188012673,188012744,IMR90|chr3:37217153-37217222,chr3,37217153,37217222,1,150795520
IMR90|chr3:188023352-188023400,chr3,188023352,188023400,IMR90|chr3:37220179-37220307,chr3,37220179,37220307,1,150803173
IMR90|chr3:188023352-188023371,chr3,188023352,188023371,IMR90|chr3:37220179-37220307,chr3,37220179,37220307,1,150803173
IMR90|chr3:188342451-188342517,chr3,188342451,188342517,IMR90|chr3:187453784-187453832,chr3,187453784,187453832,1,888667
IMR90|chr3:188342622-188342729,chr3,188342622,188342729,IMR90|chr3:187454966-187454989,chr3,187454966,187454989,1,887656
IMR90|chr3:191056158-191056293,chr3,191056158,191056293,IMR90|chr3:150130198-150130280,chr3,150130198,150130280,1,40925960
IMR90|chr3:191056225-191056293,chr3,191056225,191056293,IMR90|chr3:150130198-150130280,chr3,150130198,150130280,1,40926027
IMR90|chr3:191095044-191095108,chr3,191095044,191095108,IMR90|chr3:15901802-15901838,chr3,15901802,15901838,1,175193242
IMR90|chr3:191095045-191095108,chr3,191095045,191095108,IMR90|chr3:15901802-15901838,chr3,15901802,15901838,1,175193243
IMR90|chr3:191097790-191097827,chr3,191097790,191097827,IMR90|chr3:128883602-128883706,chr3,128883602,128883706,1,62214188
IMR90|chr3:191097790-191097824,chr3,191097790,191097824,IMR90|chr3:128883602-128883706,chr3,128883602,128883706,1,62214188
IMR90|chr3:194194569-194194614,chr3,194194569,194194614,IMR90|chr3:17744788-17744887,chr3,17744788,17744887,1,176449781
IMR90|chr3:194194569-194194613,chr3,194194569,194194613,IMR90|chr3:17744788-17744807,chr3,17744788,17744807,1,176449781
IMR90|chr3:194194570-194194623,chr3,194194570,194194623,IMR90|chr3:17744788-17744887,chr3,17744788,17744887,1,176449782
IMR90|chr3:194305790-194305883,chr3,194305790,194305883,IMR90|chr3:157251197-157251225,chr3,157251197,157251225,1,37054593
IMR90|chr3:194305791-194305883,chr3,194305791,194305883,IMR90|chr3:157251197-157251224,chr3,157251197,157251224,1,37054594
IMR90|chr3:194307488-194307542,chr3,194307488,194307542,IMR90|chr3:194388130-194388244,chr3,194388130,194388244,1,80642
IMR90|chr3:194315079-194315166,chr3,194315079,194315166,IMR90|chr3:194388402-194388451,chr3,194388402,194388451,1,73323
IMR90|chr3:194922783-194922828,chr3,194922783,194922828,IMR90|chr3:194993434-194993504,chr3,194993434,194993504,1,70651
IMR90|chr3:194932467-194932499,chr3,194932467,194932499,IMR90|chr3:194993378-194993471,chr3,194993378,194993471,1,60911
IMR90|chr3:195417791-195417908,chr3,195417791,195417908,IMR90|chr3:195684405-195684447,chr3,195684405,195684447,1,266614
IMR90|chr3:195417797-195417926,chr3,195417797,195417926,IMR90|chr3:195684393-195684451,chr3,195684393,195684451,1,266596
IMR90|chr3:195417807-195417908,chr3,195417807,195417908,IMR90|chr3:195684406-195684447,chr3,195684406,195684447,1,266599
IMR90|chr3:195417823-195417908,chr3,195417823,195417908,IMR90|chr3:195684324-195684449,chr3,195684324,195684449,1,266501
IMR90|chr3:195418252-195418302,chr3,195418252,195418302,IMR90|chr3:195684350-195684373,chr3,195684350,195684373,1,266098
IMR90|chr3:196002526-196002584,chr3,196002526,196002584,IMR90|chr3:196227616-196227701,chr3,196227616,196227701,1,225090
IMR90|chr3:196005697-196005753,chr3,196005697,196005753,IMR90|chr3:196228677-196228785,chr3,196228677,196228785,1,222980
IMR90|chr3:196005697-196005752,chr3,196005697,196005752,IMR90|chr3:196228677-196228785,chr3,196228677,196228785,1,222980
IMR90|chr3:196005697-196005739,chr3,196005697,196005739,IMR90|chr3:196228677-196228785,chr3,196228677,196228785,1,222980
IMR90|chr3:197540131-197540183,chr3,197540131,197540183,IMR90|chr3:98618165-98618277,chr3,98618165,98618277,1,98921966
IMR90|chr3:197540137-197540183,chr3,197540137,197540183,IMR90|chr3:98618165-98618277,chr3,98618165,98618277,1,98921972
IMR90|chr3:197546541-197546600,chr3,197546541,197546600,IMR90|chr3:30649449-30649523,chr3,30649449,30649523,1,166897092
IMR90|chr3:197546541-197546599,chr3,197546541,197546599,IMR90|chr3:30649449-30649523,chr3,30649449,30649523,1,166897092
IMR90|chr4:2599823-2599891,chr4,2599823,2599891,IMR90|chr4:7069036-7069118,chr4,7069036,7069118,1,4469213
IMR90|chr4:4451562-4451611,chr4,4451562,4451611,IMR90|chr4:47840295-47840403,chr4,47840295,47840403,1,43388733
IMR90|chr4:7810954-7810974,chr4,7810954,7810974,IMR90|chr4:8441167-8441208,chr4,8441167,8441208,1,630213
IMR90|chr4:7848720-7848849,chr4,7848720,7848849,IMR90|chr4:83293689-83293775,chr4,83293689,83293775,1,75444969
IMR90|chr4:7848720-7848784,chr4,7848720,7848784,IMR90|chr4:83293689-83293775,chr4,83293689,83293775,1,75444969
IMR90|chr4:7848746-7848849,chr4,7848746,7848849,IMR90|chr4:83293689-83293775,chr4,83293689,83293775,1,75444943
IMR90|chr4:10095850-10095871,chr4,10095850,10095871,IMR90|chr4:55525119-55525223,chr4,55525119,55525223,1,45429269
IMR90|chr4:10095852-10095871,chr4,10095852,10095871,IMR90|chr4:55525119-55525223,chr4,55525119,55525223,1,45429267
IMR90|chr4:10099724-10099760,chr4,10099724,10099760,IMR90|chr4:81190227-81190282,chr4,81190227,81190282,1,71090503
IMR90|chr4:16616755-16616847,chr4,16616755,16616847,IMR90|chr4:177712770-177712818,chr4,177712770,177712818,1,161096015
IMR90|chr4:24530716-24530837,chr4,24530716,24530837,IMR90|chr4:41215355-41215401,chr4,41215355,41215401,1,16684639
IMR90|chr4:24530716-24530815,chr4,24530716,24530815,IMR90|chr4:41215355-41215401,chr4,41215355,41215401,1,16684639
IMR90|chr4:26413579-26413661,chr4,26413579,26413661,IMR90|chr4:26854343-26854484,chr4,26854343,26854484,1,440764
IMR90|chr4:26417927-26418062,chr4,26417927,26418062,IMR90|chr4:26856254-26856307,chr4,26856254,26856307,1,438327
IMR90|chr4:26417927-26418024,chr4,26417927,26418024,IMR90|chr4:26856254-26856307,chr4,26856254,26856307,1,438327
IMR90|chr4:38110623-38110643,chr4,38110623,38110643,IMR90|chr4:73935651-73935717,chr4,73935651,73935717,1,35825028
IMR90|chr4:38994771-38994814,chr4,38994771,38994814,IMR90|chr4:39458388-39458495,chr4,39458388,39458495,1,463617
IMR90|chr4:38994820-38994970,chr4,38994820,38994970,IMR90|chr4:39458388-39458495,chr4,39458388,39458495,1,463568
IMR90|chr4:38997936-38998042,chr4,38997936,38998042,IMR90|chr4:4252231-4252297,chr4,4252231,4252297,1,34745705
IMR90|chr4:38998045-38998143,chr4,38998045,38998143,IMR90|chr4:4252225-4252278,chr4,4252225,4252278,1,34745820
IMR90|chr4:47545849-47545917,chr4,47545849,47545917,IMR90|chr4:73936556-73936607,chr4,73936556,73936607,1,26390707
IMR90|chr4:47545849-47545900,chr4,47545849,47545900,IMR90|chr4:73936556-73936607,chr4,73936556,73936607,1,26390707
IMR90|chr4:53878522-53878613,chr4,53878522,53878613,IMR90|chr4:128797735-128797769,chr4,128797735,128797769,1,74919213
IMR90|chr4:53878522-53878573,chr4,53878522,53878573,IMR90|chr4:128797731-128797769,chr4,128797731,128797769,1,74919209
IMR90|chr4:53878526-53878613,chr4,53878526,53878613,IMR90|chr4:128797735-128797769,chr4,128797735,128797769,1,74919209
IMR90|chr4:53878526-53878612,chr4,53878526,53878612,IMR90|chr4:128797735-128797769,chr4,128797735,128797769,1,74919209
IMR90|chr4:54903330-54903449,chr4,54903330,54903449,IMR90|chr4:76866094-76866229,chr4,76866094,76866229,1,21962764
IMR90|chr4:54903330-54903448,chr4,54903330,54903448,IMR90|chr4:76866095-76866229,chr4,76866095,76866229,1,21962765
IMR90|chr4:54903403-54903449,chr4,54903403,54903449,IMR90|chr4:76866094-76866229,chr4,76866094,76866229,1,21962691
IMR90|chr4:57934300-57934356,chr4,57934300,57934356,IMR90|chr4:103748513-103748585,chr4,103748513,103748585,1,45814213
IMR90|chr4:57934304-57934356,chr4,57934304,57934356,IMR90|chr4:103748513-103748585,chr4,103748513,103748585,1,45814209
IMR90|chr4:57945537-57945594,chr4,57945537,57945594,IMR90|chr4:56265242-56265327,chr4,56265242,56265327,1,1680295
IMR90|chr4:57954772-57954846,chr4,57954772,57954846,IMR90|chr4:46391649-46391686,chr4,46391649,46391686,1,11563123
IMR90|chr4:57954816-57954847,chr4,57954816,57954847,IMR90|chr4:46391567-46391686,chr4,46391567,46391686,1,11563249
IMR90|chr4:57967380-57967464,chr4,57967380,57967464,IMR90|chr4:56263407-56263469,chr4,56263407,56263469,1,1703973
IMR90|chr4:68551551-68551616,chr4,68551551,68551616,IMR90|chr4:57330255-57330291,chr4,57330255,57330291,1,11221296
IMR90|chr4:68551551-68551596,chr4,68551551,68551596,IMR90|chr4:57330186-57330291,chr4,57330186,57330291,1,11221365
IMR90|chr4:71653110-71653204,chr4,71653110,71653204,IMR90|chr4:71767083-71767138,chr4,71767083,71767138,1,113973
IMR90|chr4:71792580-71792726,chr4,71792580,71792726,IMR90|chr4:56263925-56263995,chr4,56263925,56263995,1,15528655
IMR90|chr4:71792646-71792726,chr4,71792646,71792726,IMR90|chr4:56263925-56263995,chr4,56263925,56263995,1,15528721
IMR90|chr4:74055946-74056077,chr4,74055946,74056077,IMR90|chr4:81192168-81192233,chr4,81192168,81192233,1,7136222
IMR90|chr4:74055982-74056077,chr4,74055982,74056077,IMR90|chr4:81192168-81192233,chr4,81192168,81192233,1,7136186
IMR90|chr4:77692348-77692414,chr4,77692348,77692414,IMR90|chr4:57842027-57842115,chr4,57842027,57842115,1,19850321
IMR90|chr4:77692348-77692412,chr4,77692348,77692412,IMR90|chr4:57842027-57842115,chr4,57842027,57842115,1,19850321
IMR90|chr4:77692358-77692414,chr4,77692358,77692414,IMR90|chr4:57842027-57842115,chr4,57842027,57842115,1,19850331
IMR90|chr4:77877731-77877784,chr4,77877731,77877784,IMR90|chr4:122744487-122744537,chr4,122744487,122744537,1,44866756
IMR90|chr4:77877737-77877788,chr4,77877737,77877788,IMR90|chr4:122744481-122744537,chr4,122744481,122744537,1,44866744
IMR90|chr4:77929695-77929757,chr4,77929695,77929757,IMR90|chr4:47840222-47840299,chr4,47840222,47840299,1,30089473
IMR90|chr4:77929698-77929757,chr4,77929698,77929757,IMR90|chr4:47840222-47840299,chr4,47840222,47840299,1,30089476
IMR90|chr4:79748301-79748348,chr4,79748301,79748348,IMR90|chr4:177710356-177710433,chr4,177710356,177710433,1,97962055
IMR90|chr4:80929520-80929622,chr4,80929520,80929622,IMR90|chr4:81122811-81122836,chr4,81122811,81122836,1,193291
IMR90|chr4:80929520-80929621,chr4,80929520,80929621,IMR90|chr4:81122811-81122836,chr4,81122811,81122836,1,193291
IMR90|chr4:81205573-81205596,chr4,81205573,81205596,IMR90|chr4:57975509-57975598,chr4,57975509,57975598,1,23230064
IMR90|chr4:81218862-81218948,chr4,81218862,81218948,IMR90|chr4:83349875-83349896,chr4,83349875,83349896,1,2131013
IMR90|chr4:83661565-83661603,chr4,83661565,83661603,IMR90|chr4:74088300-74088414,chr4,74088300,74088414,1,9573265
IMR90|chr4:83661576-83661603,chr4,83661576,83661603,IMR90|chr4:74088300-74088414,chr4,74088300,74088414,1,9573276
IMR90|chr4:83755846-83755957,chr4,83755846,83755957,IMR90|chr4:38666474-38666555,chr4,38666474,38666555,1,45089372
IMR90|chr4:85876068-85876153,chr4,85876068,85876153,IMR90|chr4:186391819-186391884,chr4,186391819,186391884,1,100515751
IMR90|chr4:85876188-85876260,chr4,85876188,85876260,IMR90|chr4:186391819-186391884,chr4,186391819,186391884,1,100515631
IMR90|chr4:86783524-86783608,chr4,86783524,86783608,IMR90|chr4:77908368-77908518,chr4,77908368,77908518,1,8875156
IMR90|chr4:87922308-87922345,chr4,87922308,87922345,IMR90|chr4:77869041-77869087,chr4,77869041,77869087,1,10053267
IMR90|chr4:87944323-87944375,chr4,87944323,87944375,IMR90|chr4:77872069-77872139,chr4,77872069,77872139,1,10072254
IMR90|chr4:95472953-95473049,chr4,95472953,95473049,IMR90|chr4:122617566-122617668,chr4,122617566,122617668,1,27144613
IMR90|chr4:95473005-95473053,chr4,95473005,95473053,IMR90|chr4:122617566-122617668,chr4,122617566,122617668,1,27144561
IMR90|chr4:95490196-95490220,chr4,95490196,95490220,IMR90|chr4:122617220-122617324,chr4,122617220,122617324,1,27127024
IMR90|chr4:95490196-95490219,chr4,95490196,95490219,IMR90|chr4:122617220-122617324,chr4,122617220,122617324,1,27127024
IMR90|chr4:99543446-99543517,chr4,99543446,99543517,IMR90|chr4:77906872-77906931,chr4,77906872,77906931,1,21636574
IMR90|chr4:99543447-99543517,chr4,99543447,99543517,IMR90|chr4:77906872-77906931,chr4,77906872,77906931,1,21636575
IMR90|chr4:99554271-99554295,chr4,99554271,99554295,IMR90|chr4:77906407-77906457,chr4,77906407,77906457,1,21647864
IMR90|chr4:99568993-99569030,chr4,99568993,99569030,IMR90|chr4:2244120-2244235,chr4,2244120,2244235,1,97324873
IMR90|chr4:104028270-104028326,chr4,104028270,104028326,IMR90|chr4:104025672-104025759,chr4,104025672,104025759,1,2598
IMR90|chr4:104028279-104028328,chr4,104028279,104028328,IMR90|chr4:104025672-104025759,chr4,104025672,104025759,1,2607
IMR90|chr4:104029864-104029921,chr4,104029864,104029921,IMR90|chr4:104021370-104021394,chr4,104021370,104021394,1,8494
IMR90|chr4:114521000-114521065,chr4,114521000,114521065,IMR90|chr4:99849365-99849448,chr4,99849365,99849448,1,14671635
IMR90|chr4:114521000-114521063,chr4,114521000,114521063,IMR90|chr4:99849365-99849448,chr4,99849365,99849448,1,14671635
IMR90|chr4:114599375-114599451,chr4,114599375,114599451,IMR90|chr4:77129876-77129946,chr4,77129876,77129946,1,37469499
IMR90|chr4:114599378-114599448,chr4,114599378,114599448,IMR90|chr4:77129875-77129949,chr4,77129875,77129949,1,37469503
IMR90|chr4:119207438-119207483,chr4,119207438,119207483,IMR90|chr4:187646349-187646430,chr4,187646349,187646430,1,68438911
IMR90|chr4:119207438-119207481,chr4,119207438,119207481,IMR90|chr4:187646349-187646430,chr4,187646349,187646430,1,68438911
IMR90|chr4:119716891-119716939,chr4,119716891,119716939,IMR90|chr4:129208056-129208137,chr4,129208056,129208137,1,9491165
IMR90|chr4:119721173-119721246,chr4,119721173,119721246,IMR90|chr4:129213461-129213501,chr4,129213461,129213501,1,9492288
IMR90|chr4:119724903-119725042,chr4,119724903,119725042,IMR90|chr4:122616446-122616484,chr4,122616446,122616484,1,2891543
IMR90|chr4:119724914-119725026,chr4,119724914,119725026,IMR90|chr4:122616446-122616484,chr4,122616446,122616484,1,2891532
IMR90|chr4:119734106-119734186,chr4,119734106,119734186,IMR90|chr4:160025598-160025663,chr4,160025598,160025663,1,40291492
IMR90|chr4:119734107-119734184,chr4,119734107,119734184,IMR90|chr4:160025598-160025663,chr4,160025598,160025663,1,40291491
IMR90|chr4:119739093-119739179,chr4,119739093,119739179,IMR90|chr4:122614799-122614896,chr4,122614799,122614896,1,2875706
IMR90|chr4:123819643-123819672,chr4,123819643,123819672,IMR90|chr4:123748541-123748669,chr4,123748541,123748669,1,71102
IMR90|chr4:123819650-123819672,chr4,123819650,123819672,IMR90|chr4:123748541-123748669,chr4,123748541,123748669,1,71109
IMR90|chr4:129251770-129251837,chr4,129251770,129251837,IMR90|chr4:129213288-129213330,chr4,129213288,129213330,1,38482
IMR90|chr4:129290217-129290367,chr4,129290217,129290367,IMR90|chr4:129211726-129211745,chr4,129211726,129211745,1,78491
IMR90|chr4:129290253-129290381,chr4,129290253,129290381,IMR90|chr4:129211726-129211745,chr4,129211726,129211745,1,78527
IMR90|chr4:139108224-139108298,chr4,139108224,139108298,IMR90|chr4:83810947-83810985,chr4,83810947,83810985,1,55297277
IMR90|chr4:139967129-139967200,chr4,139967129,139967200,IMR90|chr4:139937939-139937996,chr4,139937939,139937996,1,29190
IMR90|chr4:139967134-139967199,chr4,139967134,139967199,IMR90|chr4:139937939-139937996,chr4,139937939,139937996,1,29195
IMR90|chr4:139973057-139973102,chr4,139973057,139973102,IMR90|chr4:139938418-139938523,chr4,139938418,139938523,1,34639
IMR90|chr4:140066618-140066661,chr4,140066618,140066661,IMR90|chr4:99578267-99578311,chr4,99578267,99578311,1,40488351
IMR90|chr4:140794604-140794708,chr4,140794604,140794708,IMR90|chr4:114897724-114897770,chr4,114897724,114897770,1,25896880
IMR90|chr4:140794605-140794755,chr4,140794605,140794755,IMR90|chr4:114897724-114897770,chr4,114897724,114897770,1,25896881
IMR90|chr4:140975774-140975802,chr4,140975774,140975802,IMR90|chr4:139938008-139938124,chr4,139938008,139938124,1,1037766
IMR90|chr4:141037892-141037945,chr4,141037892,141037945,IMR90|chr4:139938151-139938246,chr4,139938151,139938246,1,1099741
IMR90|chr4:141037895-141037944,chr4,141037895,141037944,IMR90|chr4:139938151-139938246,chr4,139938151,139938246,1,1099744
IMR90|chr4:148690934-148691060,chr4,148690934,148691060,IMR90|chr4:120548001-120548052,chr4,120548001,120548052,1,28142933
IMR90|chr4:148690962-148691061,chr4,148690962,148691061,IMR90|chr4:120548001-120548052,chr4,120548001,120548052,1,28142961
IMR90|chr4:148708023-148708099,chr4,148708023,148708099,IMR90|chr4:120547970-120548044,chr4,120547970,120548044,1,28160053
IMR90|chr4:148895857-148895950,chr4,148895857,148895950,IMR90|chr4:107238052-107238073,chr4,107238052,107238073,1,41657805
IMR90|chr4:151246905-151246981,chr4,151246905,151246981,IMR90|chr4:148655174-148655231,chr4,148655174,148655231,1,2591731
IMR90|chr4:154397175-154397276,chr4,154397175,154397276,IMR90|chr4:57845312-57845358,chr4,57845312,57845358,1,96551863
IMR90|chr4:154397176-154397276,chr4,154397176,154397276,IMR90|chr4:57845312-57845358,chr4,57845312,57845358,1,96551864
IMR90|chr4:157802590-157802685,chr4,157802590,157802685,IMR90|chr4:177712293-177712352,chr4,177712293,177712352,1,19909703
IMR90|chr4:157802595-157802686,chr4,157802595,157802686,IMR90|chr4:177712293-177712352,chr4,177712293,177712352,1,19909698
IMR90|chr4:157821511-157821584,chr4,157821511,157821584,IMR90|chr4:177710332-177710381,chr4,177710332,177710381,1,19888821
IMR90|chr4:157821514-157821584,chr4,157821514,157821584,IMR90|chr4:177710332-177710381,chr4,177710332,177710381,1,19888818
IMR90|chr4:157878878-157878906,chr4,157878878,157878906,IMR90|chr4:775117-775239,chr4,775117,775239,1,157103761
IMR90|chr4:157878881-157878958,chr4,157878881,157878958,IMR90|chr4:775117-775239,chr4,775117,775239,1,157103764
IMR90|chr4:157878881-157878957,chr4,157878881,157878957,IMR90|chr4:775117-775239,chr4,775117,775239,1,157103764
IMR90|chr4:169728194-169728228,chr4,169728194,169728228,IMR90|chr4:7940297-7940446,chr4,7940297,7940446,1,161787897
IMR90|chr4:169739286-169739321,chr4,169739286,169739321,IMR90|chr4:177712733-177712848,chr4,177712733,177712848,1,7973447
IMR90|chr4:169739288-169739345,chr4,169739288,169739345,IMR90|chr4:177712733-177712848,chr4,177712733,177712848,1,7973445
IMR90|chr4:169777955-169778040,chr4,169777955,169778040,IMR90|chr4:177710308-177710390,chr4,177710308,177710390,1,7932353
IMR90|chr4:169777973-169778041,chr4,169777973,169778041,IMR90|chr4:177710308-177710390,chr4,177710308,177710390,1,7932335
IMR90|chr4:170162665-170162801,chr4,170162665,170162801,IMR90|chr4:157891115-157891172,chr4,157891115,157891172,1,12271550
IMR90|chr4:170162708-170162801,chr4,170162708,170162801,IMR90|chr4:157891115-157891172,chr4,157891115,157891172,1,12271593
IMR90|chr4:170168542-170168601,chr4,170168542,170168601,IMR90|chr4:157891166-157891261,chr4,157891166,157891261,1,12277376
IMR90|chr4:170168547-170168602,chr4,170168547,170168602,IMR90|chr4:157891166-157891261,chr4,157891166,157891261,1,12277381
IMR90|chr4:174113134-174113193,chr4,174113134,174113193,IMR90|chr4:177242738-177242797,chr4,177242738,177242797,1,3129604
IMR90|chr4:177683291-177683343,chr4,177683291,177683343,IMR90|chr4:56264144-56264222,chr4,56264144,56264222,1,121419147
IMR90|chr4:177698500-177698550,chr4,177698500,177698550,IMR90|chr4:56265241-56265298,chr4,56265241,56265298,1,121433259
IMR90|chr4:177698500-177698547,chr4,177698500,177698547,IMR90|chr4:56265241-56265298,chr4,56265241,56265298,1,121433259
IMR90|chr4:178373251-178373367,chr4,178373251,178373367,IMR90|chr4:178365522-178365650,chr4,178365522,178365650,1,7729
IMR90|chr4:178378090-178378160,chr4,178378090,178378160,IMR90|chr4:178365542-178365579,chr4,178365542,178365579,1,12548
IMR90|chr4:178378094-178378160,chr4,178378094,178378160,IMR90|chr4:178365542-178365579,chr4,178365542,178365579,1,12552
IMR90|chr4:184081579-184081631,chr4,184081579,184081631,IMR90|chr4:157891677-157891752,chr4,157891677,157891752,1,26189902
IMR90|chr4:187607572-187607676,chr4,187607572,187607676,IMR90|chr4:177712575-177712613,chr4,177712575,177712613,1,9894997
IMR90|chr4:187619860-187619961,chr4,187619860,187619961,IMR90|chr4:177713229-177713257,chr4,177713229,177713257,1,9906631
IMR90|chr4:187619860-187619960,chr4,187619860,187619960,IMR90|chr4:177713229-177713257,chr4,177713229,177713257,1,9906631
IMR90|chr5:369205-369238,chr5,369205,369238,IMR90|chr5:443993-444057,chr5,443993,444057,1,74788
IMR90|chr5:371247-371340,chr5,371247,371340,IMR90|chr5:14146626-14146670,chr5,14146626,14146670,1,13775379
IMR90|chr5:387676-387791,chr5,387676,387791,IMR90|chr5:179718831-179718849,chr5,179718831,179718849,1,179331155
IMR90|chr5:387678-387791,chr5,387678,387791,IMR90|chr5:179718831-179718849,chr5,179718831,179718849,1,179331153
IMR90|chr5:9188293-9188352,chr5,9188293,9188352,IMR90|chr5:34930873-34930936,chr5,34930873,34930936,1,25742580
IMR90|chr5:9188293-9188351,chr5,9188293,9188351,IMR90|chr5:34930873-34930936,chr5,34930873,34930936,1,25742580
IMR90|chr5:10699105-10699136,chr5,10699105,10699136,IMR90|chr5:10567806-10567837,chr5,10567806,10567837,1,131299
IMR90|chr5:10700283-10700309,chr5,10700283,10700309,IMR90|chr5:10567808-10567924,chr5,10567808,10567924,1,132475
IMR90|chr5:10724798-10724858,chr5,10724798,10724858,IMR90|chr5:14147318-14147348,chr5,14147318,14147348,1,3422520
IMR90|chr5:10724798-10724840,chr5,10724798,10724840,IMR90|chr5:14147318-14147423,chr5,14147318,14147423,1,3422520
IMR90|chr5:14166901-14166951,chr5,14166901,14166951,IMR90|chr5:17219951-17220030,chr5,17219951,17220030,1,3053050
IMR90|chr5:14166901-14166925,chr5,14166901,14166925,IMR90|chr5:17219951-17220030,chr5,17219951,17220030,1,3053050
IMR90|chr5:14168619-14168648,chr5,14168619,14168648,IMR90|chr5:55290332-55290423,chr5,55290332,55290423,1,41121713
IMR90|chr5:14169336-14169379,chr5,14169336,14169379,IMR90|chr5:17219558-17219586,chr5,17219558,17219586,1,3050222
IMR90|chr5:14190889-14191020,chr5,14190889,14191020,IMR90|chr5:17219989-17220008,chr5,17219989,17220008,1,3029100
IMR90|chr5:14196439-14196534,chr5,14196439,14196534,IMR90|chr5:16935426-16935445,chr5,16935426,16935445,1,2738987
IMR90|chr5:14196439-14196529,chr5,14196439,14196529,IMR90|chr5:16935426-16935445,chr5,16935426,16935445,1,2738987
IMR90|chr5:14197139-14197176,chr5,14197139,14197176,IMR90|chr5:443700-443754,chr5,443700,443754,1,13753439
IMR90|chr5:14197156-14197242,chr5,14197156,14197242,IMR90|chr5:443700-443754,chr5,443700,443754,1,13753456
IMR90|chr5:14197189-14197242,chr5,14197189,14197242,IMR90|chr5:443700-443754,chr5,443700,443754,1,13753489
IMR90|chr5:14197876-14197958,chr5,14197876,14197958,IMR90|chr5:65221658-65221772,chr5,65221658,65221772,1,51023782
IMR90|chr5:14197876-14197912,chr5,14197876,14197912,IMR90|chr5:65221658-65221772,chr5,65221658,65221772,1,51023782
IMR90|chr5:14209402-14209462,chr5,14209402,14209462,IMR90|chr5:17219216-17219247,chr5,17219216,17219247,1,3009814
IMR90|chr5:14214334-14214461,chr5,14214334,14214461,IMR90|chr5:444945-444968,chr5,444945,444968,1,13769389
IMR90|chr5:14214334-14214459,chr5,14214334,14214459,IMR90|chr5:444943-444968,chr5,444943,444968,1,13769391
IMR90|chr5:14214834-14214866,chr5,14214834,14214866,IMR90|chr5:34657448-34657506,chr5,34657448,34657506,1,20442614
IMR90|chr5:14221943-14222024,chr5,14221943,14222024,IMR90|chr5:34661069-34661126,chr5,34661069,34661126,1,20439126
IMR90|chr5:14227557-14227672,chr5,14227557,14227672,IMR90|chr5:17219324-17219359,chr5,17219324,17219359,1,2991767
IMR90|chr5:14228518-14228592,chr5,14228518,14228592,IMR90|chr5:6711976-6712052,chr5,6711976,6712052,1,7516542
IMR90|chr5:14228519-14228592,chr5,14228519,14228592,IMR90|chr5:6711975-6712052,chr5,6711975,6712052,1,7516544
IMR90|chr5:14234087-14234145,chr5,14234087,14234145,IMR90|chr5:32172553-32172626,chr5,32172553,32172626,1,17938466
IMR90|chr5:14234565-14234604,chr5,14234565,14234604,IMR90|chr5:16935405-16935485,chr5,16935405,16935485,1,2700840
IMR90|chr5:14239770-14239804,chr5,14239770,14239804,IMR90|chr5:6709688-6709788,chr5,6709688,6709788,1,7530082
IMR90|chr5:14259700-14259724,chr5,14259700,14259724,IMR90|chr5:32173518-32173634,chr5,32173518,32173634,1,17913818
IMR90|chr5:14259700-14259723,chr5,14259700,14259723,IMR90|chr5:32173518-32173634,chr5,32173518,32173634,1,17913818
IMR90|chr5:14279874-14279954,chr5,14279874,14279954,IMR90|chr5:72922573-72922623,chr5,72922573,72922623,1,58642699
IMR90|chr5:14339901-14339933,chr5,14339901,14339933,IMR90|chr5:34657712-34657796,chr5,34657712,34657796,1,20317811
IMR90|chr5:14390505-14390560,chr5,14390505,14390560,IMR90|chr5:72797306-72797348,chr5,72797306,72797348,1,58406801
IMR90|chr5:14430388-14430432,chr5,14430388,14430432,IMR90|chr5:150534503-150534544,chr5,150534503,150534544,1,136104115
IMR90|chr5:14430391-14430445,chr5,14430391,14430445,IMR90|chr5:150534500-150534533,chr5,150534500,150534533,1,136104109
IMR90|chr5:14437924-14437956,chr5,14437924,14437956,IMR90|chr5:138941541-138941645,chr5,138941541,138941645,1,124503617
IMR90|chr5:14437924-14437955,chr5,14437924,14437955,IMR90|chr5:138941541-138941645,chr5,138941541,138941645,1,124503617
IMR90|chr5:14441054-14441126,chr5,14441054,14441126,IMR90|chr5:34657512-34657572,chr5,34657512,34657572,1,20216458
IMR90|chr5:14446066-14446216,chr5,14446066,14446216,IMR90|chr5:131593793-131593835,chr5,131593793,131593835,1,117147727
IMR90|chr5:14446128-14446236,chr5,14446128,14446236,IMR90|chr5:131593793-131593835,chr5,131593793,131593835,1,117147665
IMR90|chr5:14450676-14450704,chr5,14450676,14450704,IMR90|chr5:55289447-55289515,chr5,55289447,55289515,1,40838771
IMR90|chr5:14450676-14450703,chr5,14450676,14450703,IMR90|chr5:55289447-55289515,chr5,55289447,55289515,1,40838771
IMR90|chr5:14452648-14452765,chr5,14452648,14452765,IMR90|chr5:72796920-72796953,chr5,72796920,72796953,1,58344272
IMR90|chr5:14456800-14456880,chr5,14456800,14456880,IMR90|chr5:14870255-14870311,chr5,14870255,14870311,1,413455
IMR90|chr5:14469632-14469657,chr5,14469632,14469657,IMR90|chr5:138942228-138942326,chr5,138942228,138942326,1,124472596
IMR90|chr5:14469632-14469656,chr5,14469632,14469656,IMR90|chr5:138942228-138942326,chr5,138942228,138942326,1,124472596
IMR90|chr5:14474987-14475029,chr5,14474987,14475029,IMR90|chr5:34660259-34660376,chr5,34660259,34660376,1,20185272
IMR90|chr5:14673083-14673166,chr5,14673083,14673166,IMR90|chr5:56112899-56112917,chr5,56112899,56112917,1,41439816
IMR90|chr5:14673083-14673165,chr5,14673083,14673165,IMR90|chr5:56112899-56112917,chr5,56112899,56112917,1,41439816
IMR90|chr5:14673084-14673165,chr5,14673084,14673165,IMR90|chr5:56112899-56112917,chr5,56112899,56112917,1,41439815
IMR90|chr5:14725969-14726075,chr5,14725969,14726075,IMR90|chr5:14657702-14657766,chr5,14657702,14657766,1,68267
IMR90|chr5:14725993-14726077,chr5,14725993,14726077,IMR90|chr5:14657702-14657766,chr5,14657702,14657766,1,68291
IMR90|chr5:15519013-15519088,chr5,15519013,15519088,IMR90|chr5:17219093-17219104,chr5,17219093,17219104,1,1700080
IMR90|chr5:15519016-15519110,chr5,15519016,15519110,IMR90|chr5:17219105-17219155,chr5,17219105,17219155,1,1700089
IMR90|chr5:15530982-15531035,chr5,15530982,15531035,IMR90|chr5:17219951-17220032,chr5,17219951,17220032,1,1688969
IMR90|chr5:15530982-15531034,chr5,15530982,15531034,IMR90|chr5:17219951-17220032,chr5,17219951,17220032,1,1688969
IMR90|chr5:15685079-15685171,chr5,15685079,15685171,IMR90|chr5:14147898-14147953,chr5,14147898,14147953,1,1537181
IMR90|chr5:15686594-15686644,chr5,15686594,15686644,IMR90|chr5:14147153-14147215,chr5,14147153,14147215,1,1539441
IMR90|chr5:15686598-15686644,chr5,15686598,15686644,IMR90|chr5:14147153-14147215,chr5,14147153,14147215,1,1539445
IMR90|chr5:17223565-17223640,chr5,17223565,17223640,IMR90|chr5:60631021-60631096,chr5,60631021,60631096,1,43407456
IMR90|chr5:17229124-17229220,chr5,17229124,17229220,IMR90|chr5:43064870-43064921,chr5,43064870,43064921,1,25835746
IMR90|chr5:17229143-17229293,chr5,17229143,17229293,IMR90|chr5:43064870-43064921,chr5,43064870,43064921,1,25835727
IMR90|chr5:17233968-17234096,chr5,17233968,17234096,IMR90|chr5:14870702-14870801,chr5,14870702,14870801,1,2363266
IMR90|chr5:17234080-17234185,chr5,17234080,17234185,IMR90|chr5:16469463-16469488,chr5,16469463,16469488,1,764617
IMR90|chr5:17234080-17234184,chr5,17234080,17234184,IMR90|chr5:16469463-16469488,chr5,16469463,16469488,1,764617
IMR90|chr5:17234219-17234270,chr5,17234219,17234270,IMR90|chr5:14870702-14870801,chr5,14870702,14870801,1,2363517
IMR90|chr5:17247305-17247344,chr5,17247305,17247344,IMR90|chr5:43064615-43064696,chr5,43064615,43064696,1,25817310
IMR90|chr5:17257761-17257829,chr5,17257761,17257829,IMR90|chr5:60630750-60630864,chr5,60630750,60630864,1,43372989
IMR90|chr5:33802348-33802400,chr5,33802348,33802400,IMR90|chr5:34660749-34660798,chr5,34660749,34660798,1,858401
IMR90|chr5:33802350-33802400,chr5,33802350,33802400,IMR90|chr5:34660749-34660798,chr5,34660749,34660798,1,858399
IMR90|chr5:33819628-33819719,chr5,33819628,33819719,IMR90|chr5:34657370-34657407,chr5,34657370,34657407,1,837742
IMR90|chr5:33819628-33819700,chr5,33819628,33819700,IMR90|chr5:34657370-34657407,chr5,34657370,34657407,1,837742
IMR90|chr5:34663533-34663625,chr5,34663533,34663625,IMR90|chr5:90676436-90676490,chr5,90676436,90676490,1,56012903
IMR90|chr5:34669780-34669854,chr5,34669780,34669854,IMR90|chr5:98107844-98107879,chr5,98107844,98107879,1,63438064
IMR90|chr5:34696673-34696766,chr5,34696673,34696766,IMR90|chr5:114520159-114520216,chr5,114520159,114520216,1,79823486
IMR90|chr5:34696674-34696728,chr5,34696674,34696728,IMR90|chr5:114520158-114520254,chr5,114520158,114520254,1,79823484
IMR90|chr5:34706083-34706122,chr5,34706083,34706122,IMR90|chr5:33891081-33891146,chr5,33891081,33891146,1,815002
IMR90|chr5:34713556-34713600,chr5,34713556,34713600,IMR90|chr5:33891016-33891081,chr5,33891016,33891081,1,822540
IMR90|chr5:34718091-34718178,chr5,34718091,34718178,IMR90|chr5:43190601-43190645,chr5,43190601,43190645,1,8472510
IMR90|chr5:34718091-34718134,chr5,34718091,34718134,IMR90|chr5:43190601-43190645,chr5,43190601,43190645,1,8472510
IMR90|chr5:34718152-34718258,chr5,34718152,34718258,IMR90|chr5:43190601-43190645,chr5,43190601,43190645,1,8472449
IMR90|chr5:34718598-34718714,chr5,34718598,34718714,IMR90|chr5:98107499-98107538,chr5,98107499,98107538,1,63388901
IMR90|chr5:34718598-34718709,chr5,34718598,34718709,IMR90|chr5:98107499-98107538,chr5,98107499,98107538,1,63388901
IMR90|chr5:34801520-34801580,chr5,34801520,34801580,IMR90|chr5:132167788-132167878,chr5,132167788,132167878,1,97366268
IMR90|chr5:34801598-34801732,chr5,34801598,34801732,IMR90|chr5:132167824-132167877,chr5,132167824,132167877,1,97366226
IMR90|chr5:34801607-34801754,chr5,34801607,34801754,IMR90|chr5:132167824-132167877,chr5,132167824,132167877,1,97366217
IMR90|chr5:34801633-34801727,chr5,34801633,34801727,IMR90|chr5:132167824-132167877,chr5,132167824,132167877,1,97366191
IMR90|chr5:39016487-39016608,chr5,39016487,39016608,IMR90|chr5:39424446-39424518,chr5,39424446,39424518,1,407959
IMR90|chr5:39016574-39016608,chr5,39016574,39016608,IMR90|chr5:39424425-39424519,chr5,39424425,39424519,1,407851
IMR90|chr5:40788670-40788728,chr5,40788670,40788728,IMR90|chr5:40835716-40835765,chr5,40835716,40835765,1,47046
IMR90|chr5:40791139-40791236,chr5,40791139,40791236,IMR90|chr5:40833614-40833662,chr5,40833614,40833662,1,42475
IMR90|chr5:43007509-43007535,chr5,43007509,43007535,IMR90|chr5:43041431-43041519,chr5,43041431,43041519,1,33922
IMR90|chr5:43009243-43009297,chr5,43009243,43009297,IMR90|chr5:43041973-43042019,chr5,43041973,43042019,1,32730
IMR90|chr5:52290313-52290357,chr5,52290313,52290357,IMR90|chr5:76326874-76326913,chr5,76326874,76326913,1,24036561
IMR90|chr5:52290313-52290356,chr5,52290313,52290356,IMR90|chr5:76326873-76326939,chr5,76326873,76326939,1,24036560
IMR90|chr5:52294348-52294389,chr5,52294348,52294389,IMR90|chr5:98110837-98110933,chr5,98110837,98110933,1,45816489
IMR90|chr5:52294351-52294389,chr5,52294351,52294389,IMR90|chr5:98110837-98110933,chr5,98110837,98110933,1,45816486
IMR90|chr5:52319685-52319771,chr5,52319685,52319771,IMR90|chr5:60630259-60630322,chr5,60630259,60630322,1,8310574
IMR90|chr5:52319687-52319769,chr5,52319687,52319769,IMR90|chr5:60630259-60630322,chr5,60630259,60630322,1,8310572
IMR90|chr5:52323590-52323704,chr5,52323590,52323704,IMR90|chr5:85914781-85914853,chr5,85914781,85914853,1,33591191
IMR90|chr5:53387316-53387420,chr5,53387316,53387420,IMR90|chr5:83679849-83679955,chr5,83679849,83679955,1,30292533
IMR90|chr5:53387317-53387361,chr5,53387317,53387361,IMR90|chr5:83679849-83679955,chr5,83679849,83679955,1,30292532
IMR90|chr5:53821056-53821146,chr5,53821056,53821146,IMR90|chr5:133560094-133560164,chr5,133560094,133560164,1,79739038
IMR90|chr5:54736319-54736384,chr5,54736319,54736384,IMR90|chr5:92923360-92923412,chr5,92923360,92923412,1,38187041
IMR90|chr5:60614721-60614744,chr5,60614721,60614744,IMR90|chr5:60624376-60624451,chr5,60624376,60624451,1,9655
IMR90|chr5:60615031-60615121,chr5,60615031,60615121,IMR90|chr5:60630633-60630668,chr5,60630633,60630668,1,15602
IMR90|chr5:60618241-60618290,chr5,60618241,60618290,IMR90|chr5:60625303-60625453,chr5,60625303,60625453,1,7062
IMR90|chr5:60618836-60618868,chr5,60618836,60618868,IMR90|chr5:60624376-60624451,chr5,60624376,60624451,1,5540
IMR90|chr5:60618836-60618867,chr5,60618836,60618867,IMR90|chr5:60624376-60624451,chr5,60624376,60624451,1,5540
IMR90|chr5:60690358-60690401,chr5,60690358,60690401,IMR90|chr5:151137545-151137620,chr5,151137545,151137620,1,90447187
IMR90|chr5:64805990-64806035,chr5,64805990,64806035,IMR90|chr5:64787717-64787788,chr5,64787717,64787788,1,18273
IMR90|chr5:64808306-64808400,chr5,64808306,64808400,IMR90|chr5:64786020-64786052,chr5,64786020,64786052,1,22286
IMR90|chr5:64808306-64808399,chr5,64808306,64808399,IMR90|chr5:64786020-64786052,chr5,64786020,64786052,1,22286
IMR90|chr5:65101531-65101625,chr5,65101531,65101625,IMR90|chr5:14146591-14146657,chr5,14146591,14146657,1,50954940
IMR90|chr5:65101541-65101625,chr5,65101541,65101625,IMR90|chr5:14146591-14146657,chr5,14146591,14146657,1,50954950
IMR90|chr5:67568011-67568095,chr5,67568011,67568095,IMR90|chr5:9546896-9546956,chr5,9546896,9546956,1,58021115
IMR90|chr5:67568012-67568095,chr5,67568012,67568095,IMR90|chr5:9546896-9546956,chr5,9546896,9546956,1,58021116
IMR90|chr5:68505207-68505349,chr5,68505207,68505349,IMR90|chr5:68510018-68510083,chr5,68510018,68510083,1,4811
IMR90|chr5:68505210-68505295,chr5,68505210,68505295,IMR90|chr5:68510018-68510083,chr5,68510018,68510083,1,4808
IMR90|chr5:71435005-71435062,chr5,71435005,71435062,IMR90|chr5:14144143-14144236,chr5,14144143,14144236,1,57290862
IMR90|chr5:71466930-71466975,chr5,71466930,71466975,IMR90|chr5:14147657-14147708,chr5,14147657,14147708,1,57319273
IMR90|chr5:71466930-71466972,chr5,71466930,71466972,IMR90|chr5:14147657-14147708,chr5,14147657,14147708,1,57319273
IMR90|chr5:73118875-73118922,chr5,73118875,73118922,IMR90|chr5:71614316-71614443,chr5,71614316,71614443,1,1504559
IMR90|chr5:74897489-74897639,chr5,74897489,74897639,IMR90|chr5:74906142-74906221,chr5,74906142,74906221,1,8653
IMR90|chr5:74897581-74897664,chr5,74897581,74897664,IMR90|chr5:74902618-74902662,chr5,74902618,74902662,1,5037
IMR90|chr5:74897593-74897664,chr5,74897593,74897664,IMR90|chr5:74906142-74906221,chr5,74906142,74906221,1,8549
IMR90|chr5:74898086-74898143,chr5,74898086,74898143,IMR90|chr5:74900065-74900114,chr5,74900065,74900114,1,1979
IMR90|chr5:79496129-79496170,chr5,79496129,79496170,IMR90|chr5:79649850-79649956,chr5,79649850,79649956,1,153721
IMR90|chr5:80316910-80316983,chr5,80316910,80316983,IMR90|chr5:138632699-138632754,chr5,138632699,138632754,1,58315789
IMR90|chr5:80317620-80317666,chr5,80317620,80317666,IMR90|chr5:138634164-138634267,chr5,138634164,138634267,1,58316544
IMR90|chr5:80317620-80317659,chr5,80317620,80317659,IMR90|chr5:138634164-138634267,chr5,138634164,138634267,1,58316544
IMR90|chr5:95240324-95240361,chr5,95240324,95240361,IMR90|chr5:14141164-14141229,chr5,14141164,14141229,1,81099160
IMR90|chr5:95250337-95250410,chr5,95250337,95250410,IMR90|chr5:14148737-14148827,chr5,14148737,14148827,1,81101600
IMR90|chr5:95250350-95250410,chr5,95250350,95250410,IMR90|chr5:14148737-14148827,chr5,14148737,14148827,1,81101613
IMR90|chr5:95255818-95255881,chr5,95255818,95255881,IMR90|chr5:98111967-98112014,chr5,98111967,98112014,1,2856149
IMR90|chr5:95258821-95258847,chr5,95258821,95258847,IMR90|chr5:151061209-151061284,chr5,151061209,151061284,1,55802388
IMR90|chr5:95270990-95271016,chr5,95270990,95271016,IMR90|chr5:32713891-32714040,chr5,32713891,32714040,1,62557099
IMR90|chr5:95271980-95272031,chr5,95271980,95272031,IMR90|chr5:98111615-98111646,chr5,98111615,98111646,1,2839635
IMR90|chr5:95277525-95277583,chr5,95277525,95277583,IMR90|chr5:98108054-98108143,chr5,98108054,98108143,1,2830529
IMR90|chr5:95277525-95277580,chr5,95277525,95277580,IMR90|chr5:98108054-98108143,chr5,98108054,98108143,1,2830529
IMR90|chr5:95292107-95292167,chr5,95292107,95292167,IMR90|chr5:98112163-98112211,chr5,98112163,98112211,1,2820056
IMR90|chr5:95292108-95292167,chr5,95292108,95292167,IMR90|chr5:98112163-98112211,chr5,98112163,98112211,1,2820055
IMR90|chr5:96056398-96056435,chr5,96056398,96056435,IMR90|chr5:95296687-95296823,chr5,95296687,95296823,1,759711
IMR90|chr5:96056863-96056911,chr5,96056863,96056911,IMR90|chr5:52285628-52285657,chr5,52285628,52285657,1,43771235
IMR90|chr5:106800740-106800829,chr5,106800740,106800829,IMR90|chr5:149532346-149532407,chr5,149532346,149532407,1,42731606
IMR90|chr5:106800740-106800764,chr5,106800740,106800764,IMR90|chr5:149532348-149532491,chr5,149532348,149532491,1,42731608
IMR90|chr5:108226259-108226303,chr5,108226259,108226303,IMR90|chr5:14147741-14147797,chr5,14147741,14147797,1,94078518
IMR90|chr5:108226263-108226303,chr5,108226263,108226303,IMR90|chr5:14147741-14147797,chr5,14147741,14147797,1,94078522
IMR90|chr5:108226953-108226970,chr5,108226953,108226970,IMR90|chr5:14139992-14140139,chr5,14139992,14140139,1,94086961
IMR90|chr5:112113413-112113501,chr5,112113413,112113501,IMR90|chr5:140070250-140070312,chr5,140070250,140070312,1,27956837
IMR90|chr5:112113414-112113516,chr5,112113414,112113516,IMR90|chr5:140070249-140070312,chr5,140070249,140070312,1,27956835
IMR90|chr5:112600242-112600346,chr5,112600242,112600346,IMR90|chr5:172196938-172196984,chr5,172196938,172196984,1,59596696
IMR90|chr5:113577750-113577768,chr5,113577750,113577768,IMR90|chr5:113696796-113696915,chr5,113696796,113696915,1,119046
IMR90|chr5:113582289-113582336,chr5,113582289,113582336,IMR90|chr5:113692802-113692888,chr5,113692802,113692888,1,110513
IMR90|chr5:113590751-113590786,chr5,113590751,113590786,IMR90|chr5:151064551-151064601,chr5,151064551,151064601,1,37473800
IMR90|chr5:113590753-113590803,chr5,113590753,113590803,IMR90|chr5:151064549-151064601,chr5,151064549,151064601,1,37473796
IMR90|chr5:119860614-119860655,chr5,119860614,119860655,IMR90|chr5:148925544-148925623,chr5,148925544,148925623,1,29064930
IMR90|chr5:119860614-119860650,chr5,119860614,119860650,IMR90|chr5:148925544-148925623,chr5,148925544,148925623,1,29064930
IMR90|chr5:119884435-119884483,chr5,119884435,119884483,IMR90|chr5:148925819-148925958,chr5,148925819,148925958,1,29041384
IMR90|chr5:119935951-119936003,chr5,119935951,119936003,IMR90|chr5:43064669-43064758,chr5,43064669,43064758,1,76871282
IMR90|chr5:119935952-119936003,chr5,119935952,119936003,IMR90|chr5:43064669-43064758,chr5,43064669,43064758,1,76871283
IMR90|chr5:121428853-121428960,chr5,121428853,121428960,IMR90|chr5:121415034-121415066,chr5,121415034,121415066,1,13819
IMR90|chr5:121428856-121428960,chr5,121428856,121428960,IMR90|chr5:121415034-121415066,chr5,121415034,121415066,1,13822
IMR90|chr5:121428857-121428960,chr5,121428857,121428960,IMR90|chr5:121415034-121415066,chr5,121415034,121415066,1,13823
IMR90|chr5:121429121-121429180,chr5,121429121,121429180,IMR90|chr5:121414045-121414109,chr5,121414045,121414109,1,15076
IMR90|chr5:121429121-121429177,chr5,121429121,121429177,IMR90|chr5:121414045-121414109,chr5,121414045,121414109,1,15076
IMR90|chr5:121430176-121430291,chr5,121430176,121430291,IMR90|chr5:121411044-121411141,chr5,121411044,121411141,1,19132
IMR90|chr5:121430176-121430224,chr5,121430176,121430224,IMR90|chr5:121411044-121411141,chr5,121411044,121411141,1,19132
IMR90|chr5:121430405-121430463,chr5,121430405,121430463,IMR90|chr5:121412463-121412515,chr5,121412463,121412515,1,17942
IMR90|chr5:121440628-121440731,chr5,121440628,121440731,IMR90|chr5:121417830-121417906,chr5,121417830,121417906,1,22798
IMR90|chr5:121440628-121440702,chr5,121440628,121440702,IMR90|chr5:121417830-121417906,chr5,121417830,121417906,1,22798
IMR90|chr5:130663689-130663752,chr5,130663689,130663752,IMR90|chr5:134074873-134074924,chr5,134074873,134074924,1,3411184
IMR90|chr5:131109557-131109636,chr5,131109557,131109636,IMR90|chr5:119801601-119801635,chr5,119801601,119801635,1,11307956
IMR90|chr5:131109559-131109636,chr5,131109559,131109636,IMR90|chr5:119801601-119801635,chr5,119801601,119801635,1,11307958
IMR90|chr5:131539568-131539686,chr5,131539568,131539686,IMR90|chr5:150534776-150534845,chr5,150534776,150534845,1,18995208
IMR90|chr5:131539613-131539688,chr5,131539613,131539688,IMR90|chr5:150534776-150534845,chr5,150534776,150534845,1,18995163
IMR90|chr5:131540006-131540088,chr5,131540006,131540088,IMR90|chr5:150535234-150535280,chr5,150535234,150535280,1,18995228
IMR90|chr5:131540040-131540129,chr5,131540040,131540129,IMR90|chr5:150535234-150535280,chr5,150535234,150535280,1,18995194
IMR90|chr5:131784944-131785039,chr5,131784944,131785039,IMR90|chr5:138613227-138613262,chr5,138613227,138613262,1,6828283
IMR90|chr5:131784976-131785039,chr5,131784976,131785039,IMR90|chr5:138613227-138613262,chr5,138613227,138613262,1,6828251
IMR90|chr5:133313317-133313418,chr5,133313317,133313418,IMR90|chr5:132298692-132298803,chr5,132298692,132298803,1,1014625
IMR90|chr5:133313380-133313419,chr5,133313380,133313419,IMR90|chr5:132298692-132298803,chr5,132298692,132298803,1,1014688
IMR90|chr5:133783213-133783265,chr5,133783213,133783265,IMR90|chr5:133703552-133703605,chr5,133703552,133703605,1,79661
IMR90|chr5:133789543-133789610,chr5,133789543,133789610,IMR90|chr5:133703316-133703362,chr5,133703316,133703362,1,86227
IMR90|chr5:133896851-133896907,chr5,133896851,133896907,IMR90|chr5:133703439-133703482,chr5,133703439,133703482,1,193412
IMR90|chr5:134168855-134168955,chr5,134168855,134168955,IMR90|chr5:133560297-133560345,chr5,133560297,133560345,1,608558
IMR90|chr5:134168857-134168958,chr5,134168857,134168958,IMR90|chr5:133560297-133560345,chr5,133560297,133560345,1,608560
IMR90|chr5:134694204-134694226,chr5,134694204,134694226,IMR90|chr5:176924019-176924088,chr5,176924019,176924088,1,42229815
IMR90|chr5:134694800-134694854,chr5,134694800,134694854,IMR90|chr5:148522695-148522777,chr5,148522695,148522777,1,13827895
IMR90|chr5:134703923-134703983,chr5,134703923,134703983,IMR90|chr5:140792526-140792556,chr5,140792526,140792556,1,6088603
IMR90|chr5:134703924-134703983,chr5,134703924,134703983,IMR90|chr5:140792526-140792556,chr5,140792526,140792556,1,6088602
IMR90|chr5:137335543-137335598,chr5,137335543,137335598,IMR90|chr5:148522444-148522486,chr5,148522444,148522486,1,11186901
IMR90|chr5:137335544-137335579,chr5,137335544,137335579,IMR90|chr5:148522443-148522502,chr5,148522443,148522502,1,11186899
IMR90|chr5:137853529-137853553,chr5,137853529,137853553,IMR90|chr5:137885482-137885546,chr5,137885482,137885546,1,31953
IMR90|chr5:137854899-137855002,chr5,137854899,137855002,IMR90|chr5:137879988-137880034,chr5,137879988,137880034,1,25089
IMR90|chr5:137854903-137854999,chr5,137854903,137854999,IMR90|chr5:137879988-137880034,chr5,137879988,137880034,1,25085
IMR90|chr5:138227408-138227447,chr5,138227408,138227447,IMR90|chr5:141701950-141702038,chr5,141701950,141702038,1,3474542
IMR90|chr5:138236522-138236591,chr5,138236522,138236591,IMR90|chr5:141706346-141706387,chr5,141706346,141706387,1,3469824
IMR90|chr5:139639847-139639997,chr5,139639847,139639997,IMR90|chr5:172197026-172197044,chr5,172197026,172197044,1,32557179
IMR90|chr5:139639911-139640043,chr5,139639911,139640043,IMR90|chr5:172197026-172197044,chr5,172197026,172197044,1,32557115
IMR90|chr5:139639928-139640043,chr5,139639928,139640043,IMR90|chr5:172197026-172197044,chr5,172197026,172197044,1,32557098
IMR90|chr5:141675575-141675611,chr5,141675575,141675611,IMR90|chr5:141703123-141703198,chr5,141703123,141703198,1,27548
IMR90|chr5:141676103-141676122,chr5,141676103,141676122,IMR90|chr5:141702595-141702645,chr5,141702595,141702645,1,26492
IMR90|chr5:141677428-141677464,chr5,141677428,141677464,IMR90|chr5:141702420-141702545,chr5,141702420,141702545,1,24992
IMR90|chr5:141680536-141680558,chr5,141680536,141680558,IMR90|chr5:141703753-141703842,chr5,141703753,141703842,1,23217
IMR90|chr5:141681048-141681124,chr5,141681048,141681124,IMR90|chr5:141704241-141704303,chr5,141704241,141704303,1,23193
IMR90|chr5:141681050-141681124,chr5,141681050,141681124,IMR90|chr5:141704241-141704303,chr5,141704241,141704303,1,23191
IMR90|chr5:141681142-141681215,chr5,141681142,141681215,IMR90|chr5:141703331-141703368,chr5,141703331,141703368,1,22189
IMR90|chr5:141682348-141682395,chr5,141682348,141682395,IMR90|chr5:141702121-141702182,chr5,141702121,141702182,1,19773
IMR90|chr5:141683338-141683428,chr5,141683338,141683428,IMR90|chr5:141702553-141702606,chr5,141702553,141702606,1,19215
IMR90|chr5:141683338-141683409,chr5,141683338,141683409,IMR90|chr5:141702553-141702606,chr5,141702553,141702606,1,19215
IMR90|chr5:141683669-141683711,chr5,141683669,141683711,IMR90|chr5:141702309-141702364,chr5,141702309,141702364,1,18640
IMR90|chr5:141684420-141684482,chr5,141684420,141684482,IMR90|chr5:141700839-141700900,chr5,141700839,141700900,1,16419
IMR90|chr5:141684974-141685051,chr5,141684974,141685051,IMR90|chr5:141701926-141701968,chr5,141701926,141701968,1,16952
IMR90|chr5:141686364-141686460,chr5,141686364,141686460,IMR90|chr5:141702442-141702592,chr5,141702442,141702592,1,16078
IMR90|chr5:141687077-141687131,chr5,141687077,141687131,IMR90|chr5:141700538-141700621,chr5,141700538,141700621,1,13461
IMR90|chr5:141687244-141687310,chr5,141687244,141687310,IMR90|chr5:141700648-141700712,chr5,141700648,141700712,1,13404
IMR90|chr5:141687553-141687645,chr5,141687553,141687645,IMR90|chr5:141702504-141702604,chr5,141702504,141702604,1,14951
IMR90|chr5:141687553-141687602,chr5,141687553,141687602,IMR90|chr5:141702504-141702604,chr5,141702504,141702604,1,14951
IMR90|chr5:141687949-141687987,chr5,141687949,141687987,IMR90|chr5:141703677-141703821,chr5,141703677,141703821,1,15728
IMR90|chr5:141688109-141688195,chr5,141688109,141688195,IMR90|chr5:141703150-141703190,chr5,141703150,141703190,1,15041
IMR90|chr5:141688110-141688195,chr5,141688110,141688195,IMR90|chr5:141703150-141703190,chr5,141703150,141703190,1,15040
IMR90|chr5:141688942-141689018,chr5,141688942,141689018,IMR90|chr5:141702566-141702605,chr5,141702566,141702605,1,13624
IMR90|chr5:141688943-141689018,chr5,141688943,141689018,IMR90|chr5:141702566-141702605,chr5,141702566,141702605,1,13623
IMR90|chr5:141688969-141689027,chr5,141688969,141689027,IMR90|chr5:141700392-141700422,chr5,141700392,141700422,1,11423
IMR90|chr5:141689382-141689452,chr5,141689382,141689452,IMR90|chr5:141701325-141701351,chr5,141701325,141701351,1,11943
IMR90|chr5:141689629-141689692,chr5,141689629,141689692,IMR90|chr5:141702237-141702259,chr5,141702237,141702259,1,12608
IMR90|chr5:141689841-141689938,chr5,141689841,141689938,IMR90|chr5:141702914-141702941,chr5,141702914,141702941,1,13073
IMR90|chr5:141696830-141696914,chr5,141696830,141696914,IMR90|chr5:68628423-68628489,chr5,68628423,68628489,1,73068407
IMR90|chr5:141696830-141696906,chr5,141696830,141696906,IMR90|chr5:68628415-68628489,chr5,68628415,68628489,1,73068415
IMR90|chr5:141737900-141737978,chr5,141737900,141737978,IMR90|chr5:141700467-141700523,chr5,141700467,141700523,1,37433
IMR90|chr5:141742432-141742494,chr5,141742432,141742494,IMR90|chr5:141703175-141703262,chr5,141703175,141703262,1,39257
IMR90|chr5:141767066-141767122,chr5,141767066,141767122,IMR90|chr5:148522443-148522502,chr5,148522443,148522502,1,6755377
IMR90|chr5:142724884-142725031,chr5,142724884,142725031,IMR90|chr5:139738762-139738871,chr5,139738762,139738871,1,2986122
IMR90|chr5:142725039-142725080,chr5,142725039,142725080,IMR90|chr5:139738762-139738871,chr5,139738762,139738871,1,2986277
IMR90|chr5:142725039-142725079,chr5,142725039,142725079,IMR90|chr5:139738761-139738867,chr5,139738761,139738867,1,2986278
IMR90|chr5:145132073-145132192,chr5,145132073,145132192,IMR90|chr5:141028452-141028504,chr5,141028452,141028504,1,4103621
IMR90|chr5:145132073-145132171,chr5,145132073,145132171,IMR90|chr5:141028452-141028504,chr5,141028452,141028504,1,4103621
IMR90|chr5:145132076-145132192,chr5,145132076,145132192,IMR90|chr5:141028452-141028504,chr5,141028452,141028504,1,4103624
IMR90|chr5:145132082-145132192,chr5,145132082,145132192,IMR90|chr5:141028452-141028504,chr5,141028452,141028504,1,4103630
IMR90|chr5:148240144-148240188,chr5,148240144,148240188,IMR90|chr5:68483745-68483805,chr5,68483745,68483805,1,79756399
IMR90|chr5:148240145-148240188,chr5,148240145,148240188,IMR90|chr5:68483745-68483805,chr5,68483745,68483805,1,79756400
IMR90|chr5:148533709-148533786,chr5,148533709,148533786,IMR90|chr5:151063964-151064003,chr5,151063964,151064003,1,2530255
IMR90|chr5:148533724-148533786,chr5,148533724,148533786,IMR90|chr5:151063964-151064003,chr5,151063964,151064003,1,2530240
IMR90|chr5:148534419-148534517,chr5,148534419,148534517,IMR90|chr5:140780019-140780111,chr5,140780019,140780111,1,7754400
IMR90|chr5:148534460-148534518,chr5,148534460,148534518,IMR90|chr5:140780019-140780111,chr5,140780019,140780111,1,7754441
IMR90|chr5:148537798-148537835,chr5,148537798,148537835,IMR90|chr5:140791376-140791424,chr5,140791376,140791424,1,7746422
IMR90|chr5:148566867-148566917,chr5,148566867,148566917,IMR90|chr5:151061648-151061738,chr5,151061648,151061738,1,2494781
IMR90|chr5:148584373-148584424,chr5,148584373,148584424,IMR90|chr5:150533449-150533543,chr5,150533449,150533543,1,1949076
IMR90|chr5:148591747-148591805,chr5,148591747,148591805,IMR90|chr5:150534477-150534530,chr5,150534477,150534530,1,1942730
IMR90|chr5:148591748-148591805,chr5,148591748,148591805,IMR90|chr5:150534477-150534530,chr5,150534477,150534530,1,1942729
IMR90|chr5:148603944-148604032,chr5,148603944,148604032,IMR90|chr5:140734109-140734168,chr5,140734109,140734168,1,7869835
IMR90|chr5:148608988-148609049,chr5,148608988,148609049,IMR90|chr5:147763846-147763882,chr5,147763846,147763882,1,845142
IMR90|chr5:148608988-148609046,chr5,148608988,148609046,IMR90|chr5:147763846-147763882,chr5,147763846,147763882,1,845142
IMR90|chr5:148608991-148609049,chr5,148608991,148609049,IMR90|chr5:147763852-147763885,chr5,147763852,147763885,1,845139
IMR90|chr5:148870292-148870323,chr5,148870292,148870323,IMR90|chr5:148925447-148925597,chr5,148925447,148925597,1,55155
IMR90|chr5:148871439-148871512,chr5,148871439,148871512,IMR90|chr5:148926087-148926200,chr5,148926087,148926200,1,54648
IMR90|chr5:148879589-148879642,chr5,148879589,148879642,IMR90|chr5:34658853-34658933,chr5,34658853,34658933,1,114220736
IMR90|chr5:149417999-149418074,chr5,149417999,149418074,IMR90|chr5:149828322-149828393,chr5,149828322,149828393,1,410323
IMR90|chr5:149941853-149941913,chr5,149941853,149941913,IMR90|chr5:149867532-149867565,chr5,149867532,149867565,1,74321
IMR90|chr5:149941853-149941912,chr5,149941853,149941912,IMR90|chr5:149867532-149867565,chr5,149867532,149867565,1,74321
IMR90|chr5:150164102-150164186,chr5,150164102,150164186,IMR90|chr5:151060265-151060287,chr5,151060265,151060287,1,896163
IMR90|chr5:150164105-150164186,chr5,150164105,150164186,IMR90|chr5:151060265-151060287,chr5,151060265,151060287,1,896160
IMR90|chr5:150164489-150164556,chr5,150164489,150164556,IMR90|chr5:151061540-151061564,chr5,151061540,151061564,1,897051
IMR90|chr5:150166289-150166364,chr5,150166289,150166364,IMR90|chr5:151061540-151061564,chr5,151061540,151061564,1,895251
IMR90|chr5:150177141-150177202,chr5,150177141,150177202,IMR90|chr5:150159211-150159319,chr5,150159211,150159319,1,17930
IMR90|chr5:150177161-150177203,chr5,150177161,150177203,IMR90|chr5:150159211-150159319,chr5,150159211,150159319,1,17950
IMR90|chr5:150177507-150177624,chr5,150177507,150177624,IMR90|chr5:150160261-150160307,chr5,150160261,150160307,1,17246
IMR90|chr5:150177520-150177624,chr5,150177520,150177624,IMR90|chr5:150160261-150160307,chr5,150160261,150160307,1,17259
IMR90|chr5:150180002-150180052,chr5,150180002,150180052,IMR90|chr5:150159470-150159602,chr5,150159470,150159602,1,20532
IMR90|chr5:150844310-150844378,chr5,150844310,150844378,IMR90|chr5:151060421-151060498,chr5,151060421,151060498,1,216111
IMR90|chr5:150844312-150844378,chr5,150844312,150844378,IMR90|chr5:151060421-151060498,chr5,151060421,151060498,1,216109
IMR90|chr5:150847522-150847569,chr5,150847522,150847569,IMR90|chr5:151061335-151061438,chr5,151061335,151061438,1,213813
IMR90|chr5:150847524-150847583,chr5,150847524,150847583,IMR90|chr5:151061335-151061438,chr5,151061335,151061438,1,213811
IMR90|chr5:150860442-150860514,chr5,150860442,150860514,IMR90|chr5:151065121-151065192,chr5,151065121,151065192,1,204679
IMR90|chr5:150860443-150860514,chr5,150860443,150860514,IMR90|chr5:151065120-151065193,chr5,151065120,151065193,1,204677
IMR90|chr5:151043579-151043608,chr5,151043579,151043608,IMR90|chr5:151136772-151136875,chr5,151136772,151136875,1,93193
IMR90|chr5:151046284-151046329,chr5,151046284,151046329,IMR90|chr5:151137246-151137303,chr5,151137246,151137303,1,90962
IMR90|chr5:151050461-151050526,chr5,151050461,151050526,IMR90|chr5:149866380-149866430,chr5,149866380,149866430,1,1184081
IMR90|chr5:151054873-151054961,chr5,151054873,151054961,IMR90|chr5:151148639-151148657,chr5,151148639,151148657,1,93766
IMR90|chr5:151054874-151054961,chr5,151054874,151054961,IMR90|chr5:151148639-151148657,chr5,151148639,151148657,1,93765
IMR90|chr5:151058822-151058914,chr5,151058822,151058914,IMR90|chr5:162934274-162934327,chr5,162934274,162934327,1,11875452
IMR90|chr5:151058822-151058911,chr5,151058822,151058911,IMR90|chr5:162934274-162934327,chr5,162934274,162934327,1,11875452
IMR90|chr5:153583999-153584073,chr5,153583999,153584073,IMR90|chr5:162867394-162867470,chr5,162867394,162867470,1,9283395
IMR90|chr5:153584000-153584085,chr5,153584000,153584085,IMR90|chr5:162867394-162867470,chr5,162867394,162867470,1,9283394
IMR90|chr5:153601809-153601866,chr5,153601809,153601866,IMR90|chr5:162864918-162864994,chr5,162864918,162864994,1,9263109
IMR90|chr5:153623524-153623586,chr5,153623524,153623586,IMR90|chr5:14148763-14148851,chr5,14148763,14148851,1,139474761
IMR90|chr5:153623526-153623614,chr5,153623526,153623614,IMR90|chr5:14148763-14148851,chr5,14148763,14148851,1,139474763
IMR90|chr5:154163047-154163098,chr5,154163047,154163098,IMR90|chr5:141734780-141734879,chr5,141734780,141734879,1,12428267
IMR90|chr5:156980839-156980886,chr5,156980839,156980886,IMR90|chr5:179049059-179049168,chr5,179049059,179049168,1,22068220
IMR90|chr5:156980839-156980880,chr5,156980839,156980880,IMR90|chr5:179049059-179049168,chr5,179049059,179049168,1,22068220
IMR90|chr5:158623615-158623678,chr5,158623615,158623678,IMR90|chr5:170815817-170815964,chr5,170815817,170815964,1,12192202
IMR90|chr5:159600029-159600094,chr5,159600029,159600094,IMR90|chr5:159612478-159612540,chr5,159612478,159612540,1,12449
IMR90|chr5:169368316-169368401,chr5,169368316,169368401,IMR90|chr5:141701869-141701958,chr5,141701869,141701958,1,27666447
IMR90|chr5:169374989-169375106,chr5,169374989,169375106,IMR90|chr5:141701159-141701216,chr5,141701159,141701216,1,27673830
IMR90|chr5:169375014-169375107,chr5,169375014,169375107,IMR90|chr5:141701159-141701216,chr5,141701159,141701216,1,27673855
IMR90|chr5:169375674-169375750,chr5,169375674,169375750,IMR90|chr5:130604198-130604271,chr5,130604198,130604271,1,38771476
IMR90|chr5:169375675-169375750,chr5,169375675,169375750,IMR90|chr5:130604196-130604271,chr5,130604196,130604271,1,38771479
IMR90|chr5:169375740-169375819,chr5,169375740,169375819,IMR90|chr5:141703952-141704004,chr5,141703952,141704004,1,27671788
IMR90|chr5:169380758-169380861,chr5,169380758,169380861,IMR90|chr5:130604713-130604744,chr5,130604713,130604744,1,38776045
IMR90|chr5:169401508-169401606,chr5,169401508,169401606,IMR90|chr5:176946455-176946488,chr5,176946455,176946488,1,7544947
IMR90|chr5:169401509-169401606,chr5,169401509,169401606,IMR90|chr5:176946455-176946488,chr5,176946455,176946488,1,7544946
IMR90|chr5:170835594-170835661,chr5,170835594,170835661,IMR90|chr5:170844552-170844586,chr5,170844552,170844586,1,8958
IMR90|chr5:170836858-170836907,chr5,170836858,170836907,IMR90|chr5:170842185-170842283,chr5,170842185,170842283,1,5327
IMR90|chr5:170836896-170837043,chr5,170836896,170837043,IMR90|chr5:170842185-170842283,chr5,170842185,170842283,1,5289
IMR90|chr5:171529191-171529213,chr5,171529191,171529213,IMR90|chr5:171432284-171432400,chr5,171432284,171432400,1,96907
IMR90|chr5:171530470-171530541,chr5,171530470,171530541,IMR90|chr5:151065180-151065219,chr5,151065180,151065219,1,20465290
IMR90|chr5:171530838-171530877,chr5,171530838,171530877,IMR90|chr5:38844965-38845106,chr5,38844965,38845106,1,132685873
IMR90|chr5:171533562-171533635,chr5,171533562,171533635,IMR90|chr5:175967629-175967681,chr5,175967629,175967681,1,4434067
IMR90|chr5:171533562-171533631,chr5,171533562,171533631,IMR90|chr5:175967629-175967681,chr5,175967629,175967681,1,4434067
IMR90|chr5:171534662-171534692,chr5,171534662,171534692,IMR90|chr5:171432572-171432695,chr5,171432572,171432695,1,102090
IMR90|chr5:171534662-171534689,chr5,171534662,171534689,IMR90|chr5:171432572-171432695,chr5,171432572,171432695,1,102090
IMR90|chr5:171537219-171537326,chr5,171537219,171537326,IMR90|chr5:151060964-151060987,chr5,151060964,151060987,1,20476255
IMR90|chr5:171562303-171562357,chr5,171562303,171562357,IMR90|chr5:140791014-140791151,chr5,140791014,140791151,1,30771289
IMR90|chr5:171562594-171562614,chr5,171562594,171562614,IMR90|chr5:140781117-140781247,chr5,140781117,140781247,1,30781477
IMR90|chr5:172278467-172278533,chr5,172278467,172278533,IMR90|chr5:148928032-148928135,chr5,148928032,148928135,1,23350435
IMR90|chr5:172278489-172278536,chr5,172278489,172278536,IMR90|chr5:148928032-148928135,chr5,148928032,148928135,1,23350457
IMR90|chr5:172285262-172285293,chr5,172285262,172285293,IMR90|chr5:172754284-172754377,chr5,172754284,172754377,1,469022
IMR90|chr5:172292657-172292690,chr5,172292657,172292690,IMR90|chr5:172194144-172194213,chr5,172194144,172194213,1,98513
IMR90|chr5:172296673-172296704,chr5,172296673,172296704,IMR90|chr5:172196938-172196984,chr5,172196938,172196984,1,99735
IMR90|chr5:172299746-172299815,chr5,172299746,172299815,IMR90|chr5:151060835-151060925,chr5,151060835,151060925,1,21238911
IMR90|chr5:172299755-172299815,chr5,172299755,172299815,IMR90|chr5:151060835-151060925,chr5,151060835,151060925,1,21238920
IMR90|chr5:172308806-172308852,chr5,172308806,172308852,IMR90|chr5:172194848-172194890,chr5,172194848,172194890,1,113958
IMR90|chr5:172314976-172315024,chr5,172314976,172315024,IMR90|chr5:151060537-151060603,chr5,151060537,151060603,1,21254439
IMR90|chr5:172324359-172324409,chr5,172324359,172324409,IMR90|chr5:148928254-148928379,chr5,148928254,148928379,1,23396105
IMR90|chr5:172324575-172324654,chr5,172324575,172324654,IMR90|chr5:172197093-172197158,chr5,172197093,172197158,1,127482
IMR90|chr5:172324575-172324652,chr5,172324575,172324652,IMR90|chr5:172197093-172197158,chr5,172197093,172197158,1,127482
IMR90|chr5:172348362-172348402,chr5,172348362,172348402,IMR90|chr5:172751953-172752012,chr5,172751953,172752012,1,403591
IMR90|chr5:172354507-172354582,chr5,172354507,172354582,IMR90|chr5:172754290-172754351,chr5,172754290,172754351,1,399783
IMR90|chr5:172354557-172354704,chr5,172354557,172354704,IMR90|chr5:172754290-172754351,chr5,172754290,172754351,1,399733
IMR90|chr5:172359162-172359233,chr5,172359162,172359233,IMR90|chr5:172196766-172196845,chr5,172196766,172196845,1,162396
IMR90|chr5:172360165-172360230,chr5,172360165,172360230,IMR90|chr5:172752234-172752282,chr5,172752234,172752282,1,392069
IMR90|chr5:172360166-172360267,chr5,172360166,172360267,IMR90|chr5:172752234-172752282,chr5,172752234,172752282,1,392068
IMR90|chr5:172372991-172373035,chr5,172372991,172373035,IMR90|chr5:172196323-172196370,chr5,172196323,172196370,1,176668
IMR90|chr5:172372992-172373035,chr5,172372992,172373035,IMR90|chr5:172196322-172196370,chr5,172196322,172196370,1,176670
IMR90|chr5:172376388-172376461,chr5,172376388,172376461,IMR90|chr5:172196181-172196225,chr5,172196181,172196225,1,180207
IMR90|chr5:172439743-172439826,chr5,172439743,172439826,IMR90|chr5:172752436-172752493,chr5,172752436,172752493,1,312693
IMR90|chr5:172439784-172439826,chr5,172439784,172439826,IMR90|chr5:172752436-172752493,chr5,172752436,172752493,1,312652
IMR90|chr5:172451429-172451526,chr5,172451429,172451526,IMR90|chr5:172752527-172752564,chr5,172752527,172752564,1,301098
IMR90|chr5:172456724-172456750,chr5,172456724,172456750,IMR90|chr5:98112498-98112622,chr5,98112498,98112622,1,74344226
IMR90|chr5:172456725-172456750,chr5,172456725,172456750,IMR90|chr5:98112498-98112524,chr5,98112498,98112524,1,74344227
IMR90|chr5:172456726-172456750,chr5,172456726,172456750,IMR90|chr5:98112498-98112621,chr5,98112498,98112621,1,74344228
IMR90|chr5:172745976-172746092,chr5,172745976,172746092,IMR90|chr5:138634919-138635025,chr5,138634919,138635025,1,34111057
IMR90|chr5:176617384-176617482,chr5,176617384,176617482,IMR90|chr5:175878237-175878280,chr5,175878237,175878280,1,739147
IMR90|chr5:176617385-176617482,chr5,176617385,176617482,IMR90|chr5:175878237-175878280,chr5,175878237,175878280,1,739148
IMR90|chr5:176906813-176906888,chr5,176906813,176906888,IMR90|chr5:176904294-176904342,chr5,176904294,176904342,1,2519
IMR90|chr5:176906915-176906961,chr5,176906915,176906961,IMR90|chr5:176906037-176906069,chr5,176906037,176906069,1,878
IMR90|chr5:176906949-176907002,chr5,176906949,176907002,IMR90|chr5:176906265-176906309,chr5,176906265,176906309,1,684
IMR90|chr5:176906952-176907013,chr5,176906952,176907013,IMR90|chr5:176905560-176905710,chr5,176905560,176905710,1,1392
IMR90|chr5:176906956-176907002,chr5,176906956,176907002,IMR90|chr5:176906196-176906346,chr5,176906196,176906346,1,760
IMR90|chr5:176907056-176907115,chr5,176907056,176907115,IMR90|chr5:176904131-176904201,chr5,176904131,176904201,1,2925
IMR90|chr5:176907057-176907114,chr5,176907057,176907114,IMR90|chr5:176904131-176904201,chr5,176904131,176904201,1,2926
IMR90|chr5:176907133-176907190,chr5,176907133,176907190,IMR90|chr5:176905248-176905303,chr5,176905248,176905303,1,1885
IMR90|chr5:176907144-176907236,chr5,176907144,176907236,IMR90|chr5:176905907-176905956,chr5,176905907,176905956,1,1237
IMR90|chr5:176907144-176907232,chr5,176907144,176907232,IMR90|chr5:176905907-176905956,chr5,176905907,176905956,1,1237
IMR90|chr5:176907198-176907238,chr5,176907198,176907238,IMR90|chr5:176905831-176905917,chr5,176905831,176905917,1,1367
IMR90|chr5:176907199-176907249,chr5,176907199,176907249,IMR90|chr5:176905766-176905806,chr5,176905766,176905806,1,1433
IMR90|chr5:176907217-176907333,chr5,176907217,176907333,IMR90|chr5:176904036-176904113,chr5,176904036,176904113,1,3181
IMR90|chr5:176907218-176907333,chr5,176907218,176907333,IMR90|chr5:176904036-176904113,chr5,176904036,176904113,1,3182
IMR90|chr5:176907218-176907291,chr5,176907218,176907291,IMR90|chr5:176904036-176904113,chr5,176904036,176904113,1,3182
IMR90|chr5:176907249-176907321,chr5,176907249,176907321,IMR90|chr5:176901873-176901918,chr5,176901873,176901918,1,5376
IMR90|chr5:176907249-176907292,chr5,176907249,176907292,IMR90|chr5:176901811-176901918,chr5,176901811,176901918,1,5438
IMR90|chr5:176907323-176907409,chr5,176907323,176907409,IMR90|chr5:176906212-176906249,chr5,176906212,176906249,1,1111
IMR90|chr5:176907343-176907444,chr5,176907343,176907444,IMR90|chr5:176906236-176906331,chr5,176906236,176906331,1,1107
IMR90|chr5:176907369-176907443,chr5,176907369,176907443,IMR90|chr5:176906236-176906331,chr5,176906236,176906331,1,1133
IMR90|chr5:176907498-176907564,chr5,176907498,176907564,IMR90|chr5:176904189-176904254,chr5,176904189,176904254,1,3309
IMR90|chr5:176907637-176907667,chr5,176907637,176907667,IMR90|chr5:176904684-176904726,chr5,176904684,176904726,1,2953
IMR90|chr5:176907655-176907726,chr5,176907655,176907726,IMR90|chr5:176904684-176904726,chr5,176904684,176904726,1,2971
IMR90|chr5:176907843-176907912,chr5,176907843,176907912,IMR90|chr5:176905888-176905917,chr5,176905888,176905917,1,1955
IMR90|chr5:176908385-176908520,chr5,176908385,176908520,IMR90|chr5:176903869-176903941,chr5,176903869,176903941,1,4516
IMR90|chr5:176908442-176908520,chr5,176908442,176908520,IMR90|chr5:176903869-176903941,chr5,176903869,176903941,1,4573
IMR90|chr5:176908506-176908611,chr5,176908506,176908611,IMR90|chr5:176905513-176905577,chr5,176905513,176905577,1,2993
IMR90|chr5:176908507-176908599,chr5,176908507,176908599,IMR90|chr5:176906063-176906086,chr5,176906063,176906086,1,2444
IMR90|chr5:176908518-176908571,chr5,176908518,176908571,IMR90|chr5:176904559-176904609,chr5,176904559,176904609,1,3959
IMR90|chr5:176908525-176908611,chr5,176908525,176908611,IMR90|chr5:176905513-176905577,chr5,176905513,176905577,1,3012
IMR90|chr5:176908541-176908611,chr5,176908541,176908611,IMR90|chr5:176905513-176905576,chr5,176905513,176905576,1,3028
IMR90|chr5:176908772-176908862,chr5,176908772,176908862,IMR90|chr5:176905766-176905806,chr5,176905766,176905806,1,3006
IMR90|chr5:176909344-176909388,chr5,176909344,176909388,IMR90|chr5:176905964-176906013,chr5,176905964,176906013,1,3380
IMR90|chr5:176909344-176909367,chr5,176909344,176909367,IMR90|chr5:176904579-176904663,chr5,176904579,176904663,1,4765
IMR90|chr5:176909485-176909551,chr5,176909485,176909551,IMR90|chr5:176905748-176905827,chr5,176905748,176905827,1,3737
IMR90|chr5:176909493-176909546,chr5,176909493,176909546,IMR90|chr5:176906020-176906072,chr5,176906020,176906072,1,3473
IMR90|chr5:176909834-176909871,chr5,176909834,176909871,IMR90|chr5:176904343-176904416,chr5,176904343,176904416,1,5491
IMR90|chr5:176909922-176910072,chr5,176909922,176910072,IMR90|chr5:176904175-176904230,chr5,176904175,176904230,1,5747
IMR90|chr5:176910032-176910079,chr5,176910032,176910079,IMR90|chr5:176904279-176904421,chr5,176904279,176904421,1,5753
IMR90|chr5:176910092-176910133,chr5,176910092,176910133,IMR90|chr5:176905888-176905917,chr5,176905888,176905917,1,4204
IMR90|chr5:176910154-176910298,chr5,176910154,176910298,IMR90|chr5:176904892-176904915,chr5,176904892,176904915,1,5262
IMR90|chr5:176910180-176910304,chr5,176910180,176910304,IMR90|chr5:176904892-176904915,chr5,176904892,176904915,1,5288
IMR90|chr5:176910190-176910304,chr5,176910190,176910304,IMR90|chr5:176904892-176904915,chr5,176904892,176904915,1,5298
IMR90|chr5:176910255-176910310,chr5,176910255,176910310,IMR90|chr5:176905967-176906037,chr5,176905967,176906037,1,4288
IMR90|chr5:176910356-176910420,chr5,176910356,176910420,IMR90|chr5:176905232-176905298,chr5,176905232,176905298,1,5124
IMR90|chr5:179036278-179036349,chr5,179036278,179036349,IMR90|chr5:178053416-178053495,chr5,178053416,178053495,1,982862
IMR90|chr5:179036278-179036314,chr5,179036278,179036314,IMR90|chr5:178053406-178053495,chr5,178053406,178053495,1,982872
IMR90|chr5:179038080-179038102,chr5,179038080,179038102,IMR90|chr5:178053406-178053495,chr5,178053406,178053495,1,984674
IMR90|chr5:179185449-179185487,chr5,179185449,179185487,IMR90|chr5:179049540-179049630,chr5,179049540,179049630,1,135909
IMR90|chr5:179191339-179191414,chr5,179191339,179191414,IMR90|chr5:179049487-179049556,chr5,179049487,179049556,1,141852
IMR90|chr5:179191340-179191414,chr5,179191340,179191414,IMR90|chr5:179049487-179049556,chr5,179049487,179049556,1,141853
IMR90|chr6:708525-708592,chr6,708525,708592,IMR90|chr6:696633-696730,chr6,696633,696730,1,11892
IMR90|chr6:708525-708575,chr6,708525,708575,IMR90|chr6:696633-696730,chr6,696633,696730,1,11892
IMR90|chr6:711527-711590,chr6,711527,711590,IMR90|chr6:693214-693231,chr6,693214,693231,1,18313
IMR90|chr6:713713-713833,chr6,713713,713833,IMR90|chr6:692736-692766,chr6,692736,692766,1,20977
IMR90|chr6:713713-713782,chr6,713713,713782,IMR90|chr6:692682-692766,chr6,692682,692766,1,21031
IMR90|chr6:713713-713779,chr6,713713,713779,IMR90|chr6:692682-692766,chr6,692682,692766,1,21031
IMR90|chr6:713733-713883,chr6,713733,713883,IMR90|chr6:692736-692766,chr6,692736,692766,1,20997
IMR90|chr6:715476-715560,chr6,715476,715560,IMR90|chr6:698018-698168,chr6,698018,698168,1,17458
IMR90|chr6:1324041-1324081,chr6,1324041,1324081,IMR90|chr6:1389591-1389633,chr6,1389591,1389633,1,65550
IMR90|chr6:1324106-1324211,chr6,1324106,1324211,IMR90|chr6:1389591-1389633,chr6,1389591,1389633,1,65485
IMR90|chr6:1324992-1325033,chr6,1324992,1325033,IMR90|chr6:1389415-1389476,chr6,1389415,1389476,1,64423
IMR90|chr6:1325056-1325162,chr6,1325056,1325162,IMR90|chr6:1389253-1389293,chr6,1389253,1389293,1,64197
IMR90|chr6:1325063-1325162,chr6,1325063,1325162,IMR90|chr6:1389253-1389348,chr6,1389253,1389348,1,64190
IMR90|chr6:1325096-1325164,chr6,1325096,1325164,IMR90|chr6:1389258-1389304,chr6,1389258,1389304,1,64162
IMR90|chr6:1325098-1325162,chr6,1325098,1325162,IMR90|chr6:1389253-1389287,chr6,1389253,1389287,1,64155
IMR90|chr6:1325107-1325162,chr6,1325107,1325162,IMR90|chr6:1389253-1389348,chr6,1389253,1389348,1,64146
IMR90|chr6:1325122-1325162,chr6,1325122,1325162,IMR90|chr6:1389253-1389351,chr6,1389253,1389351,1,64131
IMR90|chr6:1325132-1325162,chr6,1325132,1325162,IMR90|chr6:1389253-1389374,chr6,1389253,1389374,1,64121
IMR90|chr6:1325133-1325162,chr6,1325133,1325162,IMR90|chr6:1389253-1389374,chr6,1389253,1389374,1,64120
IMR90|chr6:1325134-1325162,chr6,1325134,1325162,IMR90|chr6:1393869-1394019,chr6,1393869,1394019,1,68735
IMR90|chr6:1325404-1325430,chr6,1325404,1325430,IMR90|chr6:1389347-1389451,chr6,1389347,1389451,1,63943
IMR90|chr6:1326064-1326123,chr6,1326064,1326123,IMR90|chr6:1388988-1389038,chr6,1388988,1389038,1,62924
IMR90|chr6:1397859-1397932,chr6,1397859,1397932,IMR90|chr6:1393630-1393699,chr6,1393630,1393699,1,4229
IMR90|chr6:1397859-1397907,chr6,1397859,1397907,IMR90|chr6:1393630-1393699,chr6,1393630,1393699,1,4229
IMR90|chr6:1407553-1407625,chr6,1407553,1407625,IMR90|chr6:1392487-1392513,chr6,1392487,1392513,1,15066
IMR90|chr6:2850952-2850988,chr6,2850952,2850988,IMR90|chr6:2845923-2846012,chr6,2845923,2846012,1,5029
IMR90|chr6:2851403-2851468,chr6,2851403,2851468,IMR90|chr6:2845965-2846054,chr6,2845965,2846054,1,5438
IMR90|chr6:2851407-2851468,chr6,2851407,2851468,IMR90|chr6:2845965-2846054,chr6,2845965,2846054,1,5442
IMR90|chr6:2856683-2856791,chr6,2856683,2856791,IMR90|chr6:2841501-2841574,chr6,2841501,2841574,1,15182
IMR90|chr6:2856683-2856786,chr6,2856683,2856786,IMR90|chr6:2841548-2841574,chr6,2841548,2841574,1,15135
IMR90|chr6:2856683-2856775,chr6,2856683,2856775,IMR90|chr6:2841514-2841574,chr6,2841514,2841574,1,15169
IMR90|chr6:2856683-2856773,chr6,2856683,2856773,IMR90|chr6:2841514-2841574,chr6,2841514,2841574,1,15169
IMR90|chr6:2856683-2856764,chr6,2856683,2856764,IMR90|chr6:2841524-2841574,chr6,2841524,2841574,1,15159
IMR90|chr6:2856683-2856760,chr6,2856683,2856760,IMR90|chr6:2841501-2841574,chr6,2841501,2841574,1,15182
IMR90|chr6:2858526-2858561,chr6,2858526,2858561,IMR90|chr6:2843215-2843259,chr6,2843215,2843259,1,15311
IMR90|chr6:2858564-2858602,chr6,2858564,2858602,IMR90|chr6:2843215-2843259,chr6,2843215,2843259,1,15349
IMR90|chr6:3162791-3162903,chr6,3162791,3162903,IMR90|chr6:3161373-3161412,chr6,3161373,3161412,1,1418
IMR90|chr6:3162792-3162903,chr6,3162792,3162903,IMR90|chr6:3161373-3161412,chr6,3161373,3161412,1,1419
IMR90|chr6:3163097-3163220,chr6,3163097,3163220,IMR90|chr6:3159143-3159241,chr6,3159143,3159241,1,3954
IMR90|chr6:3163097-3163148,chr6,3163097,3163148,IMR90|chr6:3159143-3159241,chr6,3159143,3159241,1,3954
IMR90|chr6:4367818-4367881,chr6,4367818,4367881,IMR90|chr6:151714942-151715016,chr6,151714942,151715016,1,147347124
IMR90|chr6:4811305-4811366,chr6,4811305,4811366,IMR90|chr6:86162713-86162836,chr6,86162713,86162836,1,81351408
IMR90|chr6:4811339-4811366,chr6,4811339,4811366,IMR90|chr6:86162713-86162836,chr6,86162713,86162836,1,81351374
IMR90|chr6:13444561-13444626,chr6,13444561,13444626,IMR90|chr6:71997715-71997752,chr6,71997715,71997752,1,58553154
IMR90|chr6:15322132-15322260,chr6,15322132,15322260,IMR90|chr6:42847887-42847946,chr6,42847887,42847946,1,27525755
IMR90|chr6:15322132-15322223,chr6,15322132,15322223,IMR90|chr6:42847887-42847946,chr6,42847887,42847946,1,27525755
IMR90|chr6:15425716-15425809,chr6,15425716,15425809,IMR90|chr6:15246307-15246353,chr6,15246307,15246353,1,179409
IMR90|chr6:15436959-15437055,chr6,15436959,15437055,IMR90|chr6:16130736-16130758,chr6,16130736,16130758,1,693777
IMR90|chr6:15436959-15437043,chr6,15436959,15437043,IMR90|chr6:16130736-16130758,chr6,16130736,16130758,1,693777
IMR90|chr6:16582261-16582373,chr6,16582261,16582373,IMR90|chr6:17394672-17394724,chr6,17394672,17394724,1,812411
IMR90|chr6:16582261-16582359,chr6,16582261,16582359,IMR90|chr6:17394672-17394724,chr6,17394672,17394724,1,812411
IMR90|chr6:16723093-16723115,chr6,16723093,16723115,IMR90|chr6:36647915-36647995,chr6,36647915,36647995,1,19924822
IMR90|chr6:16743614-16743677,chr6,16743614,16743677,IMR90|chr6:36647195-36647248,chr6,36647195,36647248,1,19903581
IMR90|chr6:16750124-16750240,chr6,16750124,16750240,IMR90|chr6:4022741-4022823,chr6,4022741,4022823,1,12727383
IMR90|chr6:16750172-16750240,chr6,16750172,16750240,IMR90|chr6:4022741-4022823,chr6,4022741,4022823,1,12727431
IMR90|chr6:16750206-16750239,chr6,16750206,16750239,IMR90|chr6:4022743-4022824,chr6,4022743,4022824,1,12727463
IMR90|chr6:17993328-17993379,chr6,17993328,17993379,IMR90|chr6:17988626-17988667,chr6,17988626,17988667,1,4702
IMR90|chr6:17993329-17993379,chr6,17993329,17993379,IMR90|chr6:17988626-17988667,chr6,17988626,17988667,1,4703
IMR90|chr6:26420623-26420690,chr6,26420623,26420690,IMR90|chr6:26457131-26457174,chr6,26457131,26457174,1,36508
IMR90|chr6:26422300-26422396,chr6,26422300,26422396,IMR90|chr6:26458905-26458988,chr6,26458905,26458988,1,36605
IMR90|chr6:26422320-26422399,chr6,26422320,26422399,IMR90|chr6:26458905-26458989,chr6,26458905,26458989,1,36585
IMR90|chr6:26422332-26422399,chr6,26422332,26422399,IMR90|chr6:26458905-26458988,chr6,26458905,26458988,1,36573
IMR90|chr6:26422335-26422399,chr6,26422335,26422399,IMR90|chr6:26458905-26458989,chr6,26458905,26458989,1,36570
IMR90|chr6:26422345-26422399,chr6,26422345,26422399,IMR90|chr6:26458905-26459001,chr6,26458905,26459001,1,36560
IMR90|chr6:30647800-30647887,chr6,30647800,30647887,IMR90|chr6:30644096-30644129,chr6,30644096,30644129,1,3704
IMR90|chr6:30647838-30647887,chr6,30647838,30647887,IMR90|chr6:30644096-30644129,chr6,30644096,30644129,1,3742
IMR90|chr6:31790035-31790078,chr6,31790035,31790078,IMR90|chr6:31794979-31795076,chr6,31794979,31795076,1,4944
IMR90|chr6:31790038-31790078,chr6,31790038,31790078,IMR90|chr6:31794979-31795069,chr6,31794979,31795069,1,4941
IMR90|chr6:33224552-33224616,chr6,33224552,33224616,IMR90|chr6:31589809-31589879,chr6,31589809,31589879,1,1634743
IMR90|chr6:33224552-33224615,chr6,33224552,33224615,IMR90|chr6:31589809-31589879,chr6,31589809,31589879,1,1634743
IMR90|chr6:34184438-34184483,chr6,34184438,34184483,IMR90|chr6:34205706-34205799,chr6,34205706,34205799,1,21268
IMR90|chr6:35341538-35341621,chr6,35341538,35341621,IMR90|chr6:107782303-107782334,chr6,107782303,107782334,1,72440765
IMR90|chr6:35355888-35355925,chr6,35355888,35355925,IMR90|chr6:107779767-107779838,chr6,107779767,107779838,1,72423879
IMR90|chr6:36880005-36880092,chr6,36880005,36880092,IMR90|chr6:36952678-36952730,chr6,36952678,36952730,1,72673
IMR90|chr6:36880005-36880075,chr6,36880005,36880075,IMR90|chr6:36952678-36952730,chr6,36952678,36952730,1,72673
IMR90|chr6:36880014-36880092,chr6,36880014,36880092,IMR90|chr6:36952678-36952730,chr6,36952678,36952730,1,72664
IMR90|chr6:37829494-37829539,chr6,37829494,37829539,IMR90|chr6:52438801-52438829,chr6,52438801,52438829,1,14609307
IMR90|chr6:37838265-37838318,chr6,37838265,37838318,IMR90|chr6:52439511-52439598,chr6,52439511,52439598,1,14601246
IMR90|chr6:37838265-37838317,chr6,37838265,37838317,IMR90|chr6:52439511-52439598,chr6,52439511,52439598,1,14601246
IMR90|chr6:37840838-37840868,chr6,37840838,37840868,IMR90|chr6:86301503-86301570,chr6,86301503,86301570,1,48460665
IMR90|chr6:37858992-37859046,chr6,37858992,37859046,IMR90|chr6:86303099-86303180,chr6,86303099,86303180,1,48444107
IMR90|chr6:37858994-37859046,chr6,37858994,37859046,IMR90|chr6:86303099-86303180,chr6,86303099,86303180,1,48444105
IMR90|chr6:37904193-37904222,chr6,37904193,37904222,IMR90|chr6:30293463-30293600,chr6,30293463,30293600,1,7610730
IMR90|chr6:37956583-37956604,chr6,37956583,37956604,IMR90|chr6:35438179-35438260,chr6,35438179,35438260,1,2518404
IMR90|chr6:37956583-37956602,chr6,37956583,37956602,IMR90|chr6:35438178-35438260,chr6,35438178,35438260,1,2518405
IMR90|chr6:37956584-37956604,chr6,37956584,37956604,IMR90|chr6:35438179-35438260,chr6,35438179,35438260,1,2518405
IMR90|chr6:37956584-37956602,chr6,37956584,37956602,IMR90|chr6:35438178-35438260,chr6,35438178,35438260,1,2518406
IMR90|chr6:41930711-41930777,chr6,41930711,41930777,IMR90|chr6:41749968-41750030,chr6,41749968,41750030,1,180743
IMR90|chr6:41933381-41933466,chr6,41933381,41933466,IMR90|chr6:41751965-41752030,chr6,41751965,41752030,1,181416
IMR90|chr6:41939237-41939289,chr6,41939237,41939289,IMR90|chr6:133136311-133136383,chr6,133136311,133136383,1,91197074
IMR90|chr6:41939237-41939288,chr6,41939237,41939288,IMR90|chr6:133136311-133136383,chr6,133136311,133136383,1,91197074
IMR90|chr6:42191961-42191992,chr6,42191961,42191992,IMR90|chr6:42190068-42190187,chr6,42190068,42190187,1,1893
IMR90|chr6:42191962-42191992,chr6,42191962,42191992,IMR90|chr6:42190068-42190187,chr6,42190068,42190187,1,1894
IMR90|chr6:42264958-42265000,chr6,42264958,42265000,IMR90|chr6:52441459-52441546,chr6,52441459,52441546,1,10176501
IMR90|chr6:42264963-42265000,chr6,42264963,42265000,IMR90|chr6:52441433-52441546,chr6,52441433,52441546,1,10176470
IMR90|chr6:42272948-42272988,chr6,42272948,42272988,IMR90|chr6:42185340-42185490,chr6,42185340,42185490,1,87608
IMR90|chr6:42324137-42324242,chr6,42324137,42324242,IMR90|chr6:42533204-42533243,chr6,42533204,42533243,1,209067
IMR90|chr6:42324163-42324242,chr6,42324163,42324242,IMR90|chr6:42533204-42533243,chr6,42533204,42533243,1,209041
IMR90|chr6:42344327-42344449,chr6,42344327,42344449,IMR90|chr6:42533397-42533473,chr6,42533397,42533473,1,189070
IMR90|chr6:42344375-42344449,chr6,42344375,42344449,IMR90|chr6:42533397-42533473,chr6,42533397,42533473,1,189022
IMR90|chr6:42380438-42380509,chr6,42380438,42380509,IMR90|chr6:43398574-43398625,chr6,43398574,43398625,1,1018136
IMR90|chr6:42380438-42380508,chr6,42380438,42380508,IMR90|chr6:43398574-43398625,chr6,43398574,43398625,1,1018136
IMR90|chr6:42381365-42381468,chr6,42381365,42381468,IMR90|chr6:43397787-43397830,chr6,43397787,43397830,1,1016422
IMR90|chr6:42411244-42411314,chr6,42411244,42411314,IMR90|chr6:43021259-43021334,chr6,43021259,43021334,1,610015
IMR90|chr6:42411245-42411314,chr6,42411245,42411314,IMR90|chr6:43021262-43021274,chr6,43021262,43021274,1,610017
IMR90|chr6:42663318-42663375,chr6,42663318,42663375,IMR90|chr6:135817422-135817466,chr6,135817422,135817466,1,93154104
IMR90|chr6:42667397-42667458,chr6,42667397,42667458,IMR90|chr6:42895444-42895482,chr6,42895444,42895482,1,228047
IMR90|chr6:43084643-43084708,chr6,43084643,43084708,IMR90|chr6:42927776-42927828,chr6,42927776,42927828,1,156867
IMR90|chr6:44008671-44008764,chr6,44008671,44008764,IMR90|chr6:30651929-30651990,chr6,30651929,30651990,1,13356742
IMR90|chr6:44008671-44008760,chr6,44008671,44008760,IMR90|chr6:30651929-30651990,chr6,30651929,30651990,1,13356742
IMR90|chr6:48078780-48078822,chr6,48078780,48078822,IMR90|chr6:48037521-48037664,chr6,48037521,48037664,1,41259
IMR90|chr6:48078784-48078900,chr6,48078784,48078900,IMR90|chr6:48037574-48037662,chr6,48037574,48037662,1,41210
IMR90|chr6:48078784-48078892,chr6,48078784,48078892,IMR90|chr6:48037598-48037662,chr6,48037598,48037662,1,41186
IMR90|chr6:48078784-48078870,chr6,48078784,48078870,IMR90|chr6:48037598-48037662,chr6,48037598,48037662,1,41186
IMR90|chr6:48078784-48078842,chr6,48078784,48078842,IMR90|chr6:48037606-48037662,chr6,48037606,48037662,1,41178
IMR90|chr6:48078784-48078832,chr6,48078784,48078832,IMR90|chr6:48037608-48037662,chr6,48037608,48037662,1,41176
IMR90|chr6:48078784-48078825,chr6,48078784,48078825,IMR90|chr6:48037536-48037662,chr6,48037536,48037662,1,41248
IMR90|chr6:48078784-48078822,chr6,48078784,48078822,IMR90|chr6:48037521-48037664,chr6,48037521,48037664,1,41263
IMR90|chr6:48078784-48078820,chr6,48078784,48078820,IMR90|chr6:48037548-48037662,chr6,48037548,48037662,1,41236
IMR90|chr6:48078784-48078818,chr6,48078784,48078818,IMR90|chr6:48037548-48037662,chr6,48037548,48037662,1,41236
IMR90|chr6:48078784-48078808,chr6,48078784,48078808,IMR90|chr6:48037541-48037662,chr6,48037541,48037662,1,41243
IMR90|chr6:48078784-48078806,chr6,48078784,48078806,IMR90|chr6:48037541-48037662,chr6,48037541,48037662,1,41243
IMR90|chr6:48078784-48078804,chr6,48078784,48078804,IMR90|chr6:48037546-48037662,chr6,48037546,48037662,1,41238
IMR90|chr6:48078784-48078802,chr6,48078784,48078802,IMR90|chr6:48037541-48037662,chr6,48037541,48037662,1,41243
IMR90|chr6:48078802-48078888,chr6,48078802,48078888,IMR90|chr6:48037212-48037238,chr6,48037212,48037238,1,41590
IMR90|chr6:52376305-52376340,chr6,52376305,52376340,IMR90|chr6:71999616-71999691,chr6,71999616,71999691,1,19623311
IMR90|chr6:52416487-52416507,chr6,52416487,52416507,IMR90|chr6:42417514-42417609,chr6,42417514,42417609,1,9998973
IMR90|chr6:52416487-52416505,chr6,52416487,52416505,IMR90|chr6:42417514-42417609,chr6,42417514,42417609,1,9998973
IMR90|chr6:56604838-56604877,chr6,56604838,56604877,IMR90|chr6:84139850-84139960,chr6,84139850,84139960,1,27535012
IMR90|chr6:56604840-56604894,chr6,56604840,56604894,IMR90|chr6:84139850-84139960,chr6,84139850,84139960,1,27535010
IMR90|chr6:56622472-56622559,chr6,56622472,56622559,IMR90|chr6:52441405-52441468,chr6,52441405,52441468,1,4181067
IMR90|chr6:56627267-56627304,chr6,56627267,56627304,IMR90|chr6:52439733-52439796,chr6,52439733,52439796,1,4187534
IMR90|chr6:56627267-56627301,chr6,56627267,56627301,IMR90|chr6:52439733-52439796,chr6,52439733,52439796,1,4187534
IMR90|chr6:56672675-56672755,chr6,56672675,56672755,IMR90|chr6:34234602-34234650,chr6,34234602,34234650,1,22438073
IMR90|chr6:56672675-56672753,chr6,56672675,56672753,IMR90|chr6:34234602-34234648,chr6,34234602,34234648,1,22438073
IMR90|chr6:56672678-56672755,chr6,56672678,56672755,IMR90|chr6:34234602-34234648,chr6,34234602,34234648,1,22438076
IMR90|chr6:56691370-56691467,chr6,56691370,56691467,IMR90|chr6:48041176-48041196,chr6,48041176,48041196,1,8650194
IMR90|chr6:56691371-56691467,chr6,56691371,56691467,IMR90|chr6:48041176-48041196,chr6,48041176,48041196,1,8650195
IMR90|chr6:56692645-56692681,chr6,56692645,56692681,IMR90|chr6:48041001-48041063,chr6,48041001,48041063,1,8651644
IMR90|chr6:56692646-56692681,chr6,56692646,56692681,IMR90|chr6:48041001-48041063,chr6,48041001,48041063,1,8651645
IMR90|chr6:56728330-56728398,chr6,56728330,56728398,IMR90|chr6:116893815-116893867,chr6,116893815,116893867,1,60165485
IMR90|chr6:57022256-57022277,chr6,57022256,57022277,IMR90|chr6:42983365-42983509,chr6,42983365,42983509,1,14038891
IMR90|chr6:57329056-57329124,chr6,57329056,57329124,IMR90|chr6:158588483-158588559,chr6,158588483,158588559,1,101259427
IMR90|chr6:72054487-72054515,chr6,72054487,72054515,IMR90|chr6:26273766-26273897,chr6,26273766,26273897,1,45780721
IMR90|chr6:72054490-72054515,chr6,72054490,72054515,IMR90|chr6:26273766-26273897,chr6,26273766,26273897,1,45780724
IMR90|chr6:73495249-73495292,chr6,73495249,73495292,IMR90|chr6:109774215-109774286,chr6,109774215,109774286,1,36278966
IMR90|chr6:73495250-73495292,chr6,73495250,73495292,IMR90|chr6:109774215-109774286,chr6,109774215,109774286,1,36278965
IMR90|chr6:75988397-75988433,chr6,75988397,75988433,IMR90|chr6:87865736-87865885,chr6,87865736,87865885,1,11877339
IMR90|chr6:86166813-86166891,chr6,86166813,86166891,IMR90|chr6:86158135-86158179,chr6,86158135,86158179,1,8678
IMR90|chr6:86167012-86167112,chr6,86167012,86167112,IMR90|chr6:86155797-86155869,chr6,86155797,86155869,1,11215
IMR90|chr6:86167090-86167112,chr6,86167090,86167112,IMR90|chr6:86155797-86155869,chr6,86155797,86155869,1,11293
IMR90|chr6:86173437-86173487,chr6,86173437,86173487,IMR90|chr6:133136853-133136944,chr6,133136853,133136944,1,46963416
IMR90|chr6:86173437-86173486,chr6,86173437,86173486,IMR90|chr6:133136853-133136944,chr6,133136853,133136944,1,46963416
IMR90|chr6:86186523-86186567,chr6,86186523,86186567,IMR90|chr6:86155715-86155821,chr6,86155715,86155821,1,30808
IMR90|chr6:86186524-86186624,chr6,86186524,86186624,IMR90|chr6:86155715-86155821,chr6,86155715,86155821,1,30809
IMR90|chr6:86187639-86187747,chr6,86187639,86187747,IMR90|chr6:133136957-133136999,chr6,133136957,133136999,1,46949318
IMR90|chr6:86286837-86286872,chr6,86286837,86286872,IMR90|chr6:86162366-86162404,chr6,86162366,86162404,1,124471
IMR90|chr6:86287496-86287530,chr6,86287496,86287530,IMR90|chr6:86156191-86156281,chr6,86156191,86156281,1,131305
IMR90|chr6:87876181-87876270,chr6,87876181,87876270,IMR90|chr6:83779472-83779544,chr6,83779472,83779544,1,4096709
IMR90|chr6:87876192-87876270,chr6,87876192,87876270,IMR90|chr6:83779472-83779544,chr6,83779472,83779544,1,4096720
IMR90|chr6:88287189-88287256,chr6,88287189,88287256,IMR90|chr6:136575625-136575696,chr6,136575625,136575696,1,48288436
IMR90|chr6:88287190-88287256,chr6,88287190,88287256,IMR90|chr6:136575632-136575697,chr6,136575632,136575697,1,48288442
IMR90|chr6:89561718-89561770,chr6,89561718,89561770,IMR90|chr6:125286210-125286306,chr6,125286210,125286306,1,35724492
IMR90|chr6:89561721-89561770,chr6,89561721,89561770,IMR90|chr6:125286210-125286306,chr6,125286210,125286306,1,35724489
IMR90|chr6:108921624-108921749,chr6,108921624,108921749,IMR90|chr6:122792632-122792687,chr6,122792632,122792687,1,13871008
IMR90|chr6:108921624-108921666,chr6,108921624,108921666,IMR90|chr6:122792632-122792687,chr6,122792632,122792687,1,13871008
IMR90|chr6:108921666-108921749,chr6,108921666,108921749,IMR90|chr6:122792632-122792687,chr6,122792632,122792687,1,13870966
IMR90|chr6:108943852-108943981,chr6,108943852,108943981,IMR90|chr6:122792608-122792627,chr6,122792608,122792627,1,13848756
IMR90|chr6:108943852-108943979,chr6,108943852,108943979,IMR90|chr6:122792608-122792627,chr6,122792608,122792627,1,13848756
IMR90|chr6:108946221-108946255,chr6,108946221,108946255,IMR90|chr6:99844600-99844630,chr6,99844600,99844630,1,9101621
IMR90|chr6:110851781-110851865,chr6,110851781,110851865,IMR90|chr6:111302682-111302763,chr6,111302682,111302763,1,450901
IMR90|chr6:110851781-110851829,chr6,110851781,110851829,IMR90|chr6:111302682-111302763,chr6,111302682,111302763,1,450901
IMR90|chr6:114273071-114273147,chr6,114273071,114273147,IMR90|chr6:149867637-149867684,chr6,149867637,149867684,1,35594566
IMR90|chr6:128666197-128666269,chr6,128666197,128666269,IMR90|chr6:116892810-116892950,chr6,116892810,116892950,1,11773387
IMR90|chr6:131316298-131316401,chr6,131316298,131316401,IMR90|chr6:26102544-26102588,chr6,26102544,26102588,1,105213754
IMR90|chr6:131316299-131316401,chr6,131316299,131316401,IMR90|chr6:26102544-26102588,chr6,26102544,26102588,1,105213755
IMR90|chr6:136897994-136898093,chr6,136897994,136898093,IMR90|chr6:151716600-151716651,chr6,151716600,151716651,1,14818606
IMR90|chr6:136897995-136898106,chr6,136897995,136898106,IMR90|chr6:151716600-151716651,chr6,151716600,151716651,1,14818605
IMR90|chr6:136898055-136898106,chr6,136898055,136898106,IMR90|chr6:151716600-151716651,chr6,151716600,151716651,1,14818545
IMR90|chr6:136925772-136925841,chr6,136925772,136925841,IMR90|chr6:151715165-151715205,chr6,151715165,151715205,1,14789393
IMR90|chr6:136925775-136925841,chr6,136925775,136925841,IMR90|chr6:151715165-151715205,chr6,151715165,151715205,1,14789390
IMR90|chr6:137088768-137088786,chr6,137088768,137088786,IMR90|chr6:111284162-111284280,chr6,111284162,111284280,1,25804606
IMR90|chr6:138812045-138812164,chr6,138812045,138812164,IMR90|chr6:34854784-34854852,chr6,34854784,34854852,1,103957261
IMR90|chr6:138812045-138812123,chr6,138812045,138812123,IMR90|chr6:34854784-34854852,chr6,34854784,34854852,1,103957261
IMR90|chr6:138812056-138812164,chr6,138812056,138812164,IMR90|chr6:34854784-34854852,chr6,34854784,34854852,1,103957272
IMR90|chr6:142701802-142701840,chr6,142701802,142701840,IMR90|chr6:43485728-43485875,chr6,43485728,43485875,1,99216074
IMR90|chr6:143171970-143172014,chr6,143171970,143172014,IMR90|chr6:133137162-133137224,chr6,133137162,133137224,1,10034808
IMR90|chr6:143185087-143185113,chr6,143185087,143185113,IMR90|chr6:147525419-147525513,chr6,147525419,147525513,1,4340332
IMR90|chr6:143221700-143221722,chr6,143221700,143221722,IMR90|chr6:143267096-143267246,chr6,143267096,143267246,1,45396
IMR90|chr6:143222800-143222874,chr6,143222800,143222874,IMR90|chr6:143267080-143267108,chr6,143267080,143267108,1,44280
IMR90|chr6:143222816-143222874,chr6,143222816,143222874,IMR90|chr6:143267080-143267196,chr6,143267080,143267196,1,44264
IMR90|chr6:143222817-143222874,chr6,143222817,143222874,IMR90|chr6:143266635-143266706,chr6,143266635,143266706,1,43818
IMR90|chr6:143222825-143222874,chr6,143222825,143222874,IMR90|chr6:143267080-143267148,chr6,143267080,143267148,1,44255
IMR90|chr6:143222842-143222874,chr6,143222842,143222874,IMR90|chr6:143267080-143267196,chr6,143267080,143267196,1,44238
IMR90|chr6:143222847-143222874,chr6,143222847,143222874,IMR90|chr6:143266627-143266698,chr6,143266627,143266698,1,43780
IMR90|chr6:143807211-143807301,chr6,143807211,143807301,IMR90|chr6:2971009-2971034,chr6,2971009,2971034,1,140836202
IMR90|chr6:143807211-143807287,chr6,143807211,143807287,IMR90|chr6:2971009-2971034,chr6,2971009,2971034,1,140836202
IMR90|chr6:143807211-143807273,chr6,143807211,143807273,IMR90|chr6:2971009-2971034,chr6,2971009,2971034,1,140836202
IMR90|chr6:144618972-144619017,chr6,144618972,144619017,IMR90|chr6:144606663-144606765,chr6,144606663,144606765,1,12309
IMR90|chr6:144618972-144619015,chr6,144618972,144619015,IMR90|chr6:144606663-144606765,chr6,144606663,144606765,1,12309
IMR90|chr6:144627642-144627707,chr6,144627642,144627707,IMR90|chr6:144606642-144606761,chr6,144606642,144606761,1,21000
IMR90|chr6:144627642-144627673,chr6,144627642,144627673,IMR90|chr6:144606642-144606761,chr6,144606642,144606761,1,21000
IMR90|chr6:144629119-144629186,chr6,144629119,144629186,IMR90|chr6:144606742-144606779,chr6,144606742,144606779,1,22377
IMR90|chr6:144629187-144629214,chr6,144629187,144629214,IMR90|chr6:144606742-144606779,chr6,144606742,144606779,1,22445
IMR90|chr6:146163339-146163379,chr6,146163339,146163379,IMR90|chr6:30180909-30181007,chr6,30180909,30181007,1,115982430
IMR90|chr6:146163341-146163379,chr6,146163341,146163379,IMR90|chr6:30180909-30181007,chr6,30180909,30181007,1,115982432
IMR90|chr6:148737626-148737738,chr6,148737626,148737738,IMR90|chr6:138190215-138190274,chr6,138190215,138190274,1,10547411
IMR90|chr6:148737626-148737675,chr6,148737626,148737675,IMR90|chr6:138190215-138190274,chr6,138190215,138190274,1,10547411
IMR90|chr6:149082221-149082327,chr6,149082221,149082327,IMR90|chr6:32142754-32142785,chr6,32142754,32142785,1,116939467
IMR90|chr6:149082221-149082326,chr6,149082221,149082326,IMR90|chr6:32142754-32142785,chr6,32142754,32142785,1,116939467
IMR90|chr6:149082222-149082284,chr6,149082222,149082284,IMR90|chr6:32142754-32142785,chr6,32142754,32142785,1,116939468
IMR90|chr6:149377948-149378004,chr6,149377948,149378004,IMR90|chr6:149866212-149866235,chr6,149866212,149866235,1,488264
IMR90|chr6:151176673-151176721,chr6,151176673,151176721,IMR90|chr6:153324115-153324190,chr6,153324115,153324190,1,2147442
IMR90|chr6:151176673-151176720,chr6,151176673,151176720,IMR90|chr6:153324115-153324190,chr6,153324115,153324190,1,2147442
IMR90|chr6:151302022-151302081,chr6,151302022,151302081,IMR90|chr6:127841638-127841713,chr6,127841638,127841713,1,23460384
IMR90|chr6:151319843-151319907,chr6,151319843,151319907,IMR90|chr6:151773079-151773142,chr6,151773079,151773142,1,453236
IMR90|chr6:151321232-151321302,chr6,151321232,151321302,IMR90|chr6:163843019-163843061,chr6,163843019,163843061,1,12521787
IMR90|chr6:151322834-151322901,chr6,151322834,151322901,IMR90|chr6:36649319-36649360,chr6,36649319,36649360,1,114673515
IMR90|chr6:151323592-151323680,chr6,151323592,151323680,IMR90|chr6:36646814-36646833,chr6,36646814,36646833,1,114676778
IMR90|chr6:151323593-151323680,chr6,151323593,151323680,IMR90|chr6:36646814-36646833,chr6,36646814,36646833,1,114676779
IMR90|chr6:151329784-151329811,chr6,151329784,151329811,IMR90|chr6:30614721-30614844,chr6,30614721,30614844,1,120715063
IMR90|chr6:151329786-151329817,chr6,151329786,151329817,IMR90|chr6:30614721-30614844,chr6,30614721,30614844,1,120715065
IMR90|chr6:154810077-154810129,chr6,154810077,154810129,IMR90|chr6:150182431-150182501,chr6,150182431,150182501,1,4627646
IMR90|chr6:154810077-154810128,chr6,154810077,154810128,IMR90|chr6:150182431-150182498,chr6,150182431,150182498,1,4627646
IMR90|chr6:155082170-155082210,chr6,155082170,155082210,IMR90|chr6:86305289-86305423,chr6,86305289,86305423,1,68776881
IMR90|chr6:155082171-155082210,chr6,155082171,155082210,IMR90|chr6:86305289-86305423,chr6,86305289,86305423,1,68776882
IMR90|chr6:167013251-167013346,chr6,167013251,167013346,IMR90|chr6:4016392-4016437,chr6,4016392,4016437,1,162996859
IMR90|chr7:91937-91964,chr7,91937,91964,IMR90|chr7:195078-195149,chr7,195078,195149,1,103141
IMR90|chr7:93843-93880,chr7,93843,93880,IMR90|chr7:195985-196063,chr7,195985,196063,1,102142
IMR90|chr7:93843-93879,chr7,93843,93879,IMR90|chr7:195985-196063,chr7,195985,196063,1,102142
IMR90|chr7:215159-215229,chr7,215159,215229,IMR90|chr7:23339309-23339333,chr7,23339309,23339333,1,23124150
IMR90|chr7:215160-215229,chr7,215160,215229,IMR90|chr7:23339309-23339333,chr7,23339309,23339333,1,23124149
IMR90|chr7:216901-216939,chr7,216901,216939,IMR90|chr7:192786-192858,chr7,192786,192858,1,24115
IMR90|chr7:217032-217076,chr7,217032,217076,IMR90|chr7:192586-192627,chr7,192586,192627,1,24446
IMR90|chr7:217820-217869,chr7,217820,217869,IMR90|chr7:192590-192659,chr7,192590,192659,1,25230
IMR90|chr7:217820-217866,chr7,217820,217866,IMR90|chr7:192590-192659,chr7,192590,192659,1,25230
IMR90|chr7:218470-218534,chr7,218470,218534,IMR90|chr7:192741-192763,chr7,192741,192763,1,25729
IMR90|chr7:218470-218533,chr7,218470,218533,IMR90|chr7:192741-192763,chr7,192741,192763,1,25729
IMR90|chr7:219233-219293,chr7,219233,219293,IMR90|chr7:192582-192675,chr7,192582,192675,1,26651
IMR90|chr7:219233-219290,chr7,219233,219290,IMR90|chr7:192582-192675,chr7,192582,192675,1,26651
IMR90|chr7:219263-219284,chr7,219263,219284,IMR90|chr7:192821-192888,chr7,192821,192888,1,26442
IMR90|chr7:222520-222582,chr7,222520,222582,IMR90|chr7:192709-192805,chr7,192709,192805,1,29811
IMR90|chr7:222534-222583,chr7,222534,222583,IMR90|chr7:192709-192805,chr7,192709,192805,1,29825
IMR90|chr7:223994-224053,chr7,223994,224053,IMR90|chr7:26244816-26244893,chr7,26244816,26244893,1,26020822
IMR90|chr7:223994-224046,chr7,223994,224046,IMR90|chr7:26244816-26244893,chr7,26244816,26244893,1,26020822
IMR90|chr7:2792992-2793030,chr7,2792992,2793030,IMR90|chr7:2668690-2668766,chr7,2668690,2668766,1,124302
IMR90|chr7:2793049-2793123,chr7,2793049,2793123,IMR90|chr7:2668690-2668766,chr7,2668690,2668766,1,124359
IMR90|chr7:2793049-2793103,chr7,2793049,2793103,IMR90|chr7:2668690-2668766,chr7,2668690,2668766,1,124359
IMR90|chr7:3479199-3479271,chr7,3479199,3479271,IMR90|chr7:41735751-41735785,chr7,41735751,41735785,1,38256552
IMR90|chr7:3480369-3480414,chr7,3480369,3480414,IMR90|chr7:41740807-41740908,chr7,41740807,41740908,1,38260438
IMR90|chr7:4753566-4753630,chr7,4753566,4753630,IMR90|chr7:5185581-5185609,chr7,5185581,5185609,1,432015
IMR90|chr7:4753567-4753630,chr7,4753567,4753630,IMR90|chr7:5185581-5185609,chr7,5185581,5185609,1,432014
IMR90|chr7:5666629-5666685,chr7,5666629,5666685,IMR90|chr7:5636144-5636227,chr7,5636144,5636227,1,30485
IMR90|chr7:5676275-5676318,chr7,5676275,5676318,IMR90|chr7:5633798-5633875,chr7,5633798,5633875,1,42477
IMR90|chr7:5676275-5676314,chr7,5676275,5676314,IMR90|chr7:5633798-5633875,chr7,5633798,5633875,1,42477
IMR90|chr7:5681180-5681228,chr7,5681180,5681228,IMR90|chr7:104652848-104652884,chr7,104652848,104652884,1,98971668
IMR90|chr7:6273828-6273912,chr7,6273828,6273912,IMR90|chr7:1573947-1573969,chr7,1573947,1573969,1,4699881
IMR90|chr7:6472765-6472855,chr7,6472765,6472855,IMR90|chr7:148937439-148937499,chr7,148937439,148937499,1,142464674
IMR90|chr7:6472768-6472857,chr7,6472768,6472857,IMR90|chr7:148937439-148937499,chr7,148937439,148937499,1,142464671
IMR90|chr7:22895390-22895462,chr7,22895390,22895462,IMR90|chr7:100772590-100772636,chr7,100772590,100772636,1,77877200
IMR90|chr7:22900273-22900317,chr7,22900273,22900317,IMR90|chr7:97914670-97914771,chr7,97914670,97914771,1,75014397
IMR90|chr7:22900274-22900338,chr7,22900274,22900338,IMR90|chr7:97914670-97914771,chr7,97914670,97914771,1,75014396
IMR90|chr7:22901461-22901522,chr7,22901461,22901522,IMR90|chr7:100772875-100772943,chr7,100772875,100772943,1,77871414
IMR90|chr7:22902131-22902276,chr7,22902131,22902276,IMR90|chr7:56121549-56121594,chr7,56121549,56121594,1,33219418
IMR90|chr7:22902133-22902276,chr7,22902133,22902276,IMR90|chr7:56121549-56121594,chr7,56121549,56121594,1,33219416
IMR90|chr7:22902182-22902284,chr7,22902182,22902284,IMR90|chr7:56121549-56121594,chr7,56121549,56121594,1,33219367
IMR90|chr7:23374758-23374883,chr7,23374758,23374883,IMR90|chr7:35841705-35841722,chr7,35841705,35841722,1,12466947
IMR90|chr7:23377161-23377210,chr7,23377161,23377210,IMR90|chr7:35841810-35841839,chr7,35841810,35841839,1,12464649
IMR90|chr7:23377161-23377185,chr7,23377161,23377185,IMR90|chr7:35841126-35841251,chr7,35841126,35841251,1,12463965
IMR90|chr7:23381970-23382026,chr7,23381970,23382026,IMR90|chr7:23532641-23532730,chr7,23532641,23532730,1,150671
IMR90|chr7:23396909-23396958,chr7,23396909,23396958,IMR90|chr7:23531640-23531683,chr7,23531640,23531683,1,134731
IMR90|chr7:23422438-23422506,chr7,23422438,23422506,IMR90|chr7:45040985-45041055,chr7,45040985,45041055,1,21618547
IMR90|chr7:23422439-23422506,chr7,23422439,23422506,IMR90|chr7:45040984-45041055,chr7,45040984,45041055,1,21618545
IMR90|chr7:23422840-23422906,chr7,23422840,23422906,IMR90|chr7:6774136-6774214,chr7,6774136,6774214,1,16648704
IMR90|chr7:24786339-24786393,chr7,24786339,24786393,IMR90|chr7:149536187-149536220,chr7,149536187,149536220,1,124749848
IMR90|chr7:32076912-32077029,chr7,32076912,32077029,IMR90|chr7:30808541-30808574,chr7,30808541,30808574,1,1268371
IMR90|chr7:32076920-32077070,chr7,32076920,32077070,IMR90|chr7:30808541-30808574,chr7,30808541,30808574,1,1268379
IMR90|chr7:40578132-40578212,chr7,40578132,40578212,IMR90|chr7:137533649-137533726,chr7,137533649,137533726,1,96955517
IMR90|chr7:40578132-40578190,chr7,40578132,40578190,IMR90|chr7:137533649-137533726,chr7,137533649,137533726,1,96955517
IMR90|chr7:40578139-40578212,chr7,40578139,40578212,IMR90|chr7:137533649-137533726,chr7,137533649,137533726,1,96955510
IMR90|chr7:40581848-40581902,chr7,40581848,40581902,IMR90|chr7:137532953-137533040,chr7,137532953,137533040,1,96951105
IMR90|chr7:40581848-40581901,chr7,40581848,40581901,IMR90|chr7:137532953-137533040,chr7,137532953,137533040,1,96951105
IMR90|chr7:41507476-41507621,chr7,41507476,41507621,IMR90|chr7:75510126-75510149,chr7,75510126,75510149,1,34002650
IMR90|chr7:41507476-41507603,chr7,41507476,41507603,IMR90|chr7:75510126-75510149,chr7,75510126,75510149,1,34002650
IMR90|chr7:42178987-42179054,chr7,42178987,42179054,IMR90|chr7:41737447-41737487,chr7,41737447,41737487,1,441540
IMR90|chr7:43706603-43706637,chr7,43706603,43706637,IMR90|chr7:94026377-94026408,chr7,94026377,94026408,1,50319774
IMR90|chr7:44498045-44498137,chr7,44498045,44498137,IMR90|chr7:100770921-100770962,chr7,100770921,100770962,1,56272876
IMR90|chr7:47361459-47361609,chr7,47361459,47361609,IMR90|chr7:26237870-26237887,chr7,26237870,26237887,1,21123589
IMR90|chr7:47361519-47361652,chr7,47361519,47361652,IMR90|chr7:26237870-26237887,chr7,26237870,26237887,1,21123649
IMR90|chr7:47366463-47366563,chr7,47366463,47366563,IMR90|chr7:137535416-137535441,chr7,137535416,137535441,1,90168953
IMR90|chr7:55092900-55092981,chr7,55092900,55092981,IMR90|chr7:42274896-42274935,chr7,42274896,42274935,1,12818004
IMR90|chr7:55092901-55092981,chr7,55092901,55092981,IMR90|chr7:42274896-42274935,chr7,42274896,42274935,1,12818005
IMR90|chr7:55099977-55100119,chr7,55099977,55100119,IMR90|chr7:26238697-26238723,chr7,26238697,26238723,1,28861280
IMR90|chr7:55100005-55100125,chr7,55100005,55100125,IMR90|chr7:26238697-26238723,chr7,26238697,26238723,1,28861308
IMR90|chr7:55105122-55105202,chr7,55105122,55105202,IMR90|chr7:77426781-77426842,chr7,77426781,77426842,1,22321659
IMR90|chr7:55105205-55105267,chr7,55105205,55105267,IMR90|chr7:26239955-26240040,chr7,26239955,26240040,1,28865250
IMR90|chr7:55105206-55105267,chr7,55105206,55105267,IMR90|chr7:26239955-26240040,chr7,26239955,26240040,1,28865251
IMR90|chr7:55105583-55105666,chr7,55105583,55105666,IMR90|chr7:26243607-26243630,chr7,26243607,26243630,1,28861976
IMR90|chr7:55143699-55143757,chr7,55143699,55143757,IMR90|chr7:56132295-56132368,chr7,56132295,56132368,1,988596
IMR90|chr7:55155946-55155988,chr7,55155946,55155988,IMR90|chr7:56120233-56120350,chr7,56120233,56120350,1,964287
IMR90|chr7:55157912-55158018,chr7,55157912,55158018,IMR90|chr7:66385499-66385534,chr7,66385499,66385534,1,11227587
IMR90|chr7:55157912-55158015,chr7,55157912,55158015,IMR90|chr7:66385499-66385534,chr7,66385499,66385534,1,11227587
IMR90|chr7:55160523-55160575,chr7,55160523,55160575,IMR90|chr7:24796174-24796251,chr7,24796174,24796251,1,30364349
IMR90|chr7:55165487-55165528,chr7,55165487,55165528,IMR90|chr7:99645846-99645880,chr7,99645846,99645880,1,44480359
IMR90|chr7:55200182-55200249,chr7,55200182,55200249,IMR90|chr7:55432042-55432103,chr7,55432042,55432103,1,231860
IMR90|chr7:55613345-55613452,chr7,55613345,55613452,IMR90|chr7:41738875-41738930,chr7,41738875,41738930,1,13874470
IMR90|chr7:55613345-55613440,chr7,55613345,55613440,IMR90|chr7:41738875-41738930,chr7,41738875,41738930,1,13874470
IMR90|chr7:66003928-66003952,chr7,66003928,66003952,IMR90|chr7:44837600-44837682,chr7,44837600,44837682,1,21166328
IMR90|chr7:66056485-66056613,chr7,66056485,66056613,IMR90|chr7:66206388-66206446,chr7,66206388,66206446,1,149903
IMR90|chr7:66056521-66056613,chr7,66056521,66056613,IMR90|chr7:66206388-66206446,chr7,66206388,66206446,1,149867
IMR90|chr7:66057013-66057098,chr7,66057013,66057098,IMR90|chr7:66205876-66205924,chr7,66205876,66205924,1,148863
IMR90|chr7:66057014-66057044,chr7,66057014,66057044,IMR90|chr7:66205963-66206024,chr7,66205963,66206024,1,148949
IMR90|chr7:66139421-66139509,chr7,66139421,66139509,IMR90|chr7:65580875-65580946,chr7,65580875,65580946,1,558546
IMR90|chr7:66139433-66139512,chr7,66139433,66139512,IMR90|chr7:65580875-65580946,chr7,65580875,65580946,1,558558
IMR90|chr7:66139494-66139559,chr7,66139494,66139559,IMR90|chr7:65580897-65580944,chr7,65580897,65580944,1,558597
IMR90|chr7:66139495-66139558,chr7,66139495,66139558,IMR90|chr7:65580897-65580944,chr7,65580897,65580944,1,558598
IMR90|chr7:66311582-66311651,chr7,66311582,66311651,IMR90|chr7:65956468-65956504,chr7,65956468,65956504,1,355114
IMR90|chr7:66311861-66311933,chr7,66311861,66311933,IMR90|chr7:65956840-65956949,chr7,65956840,65956949,1,355021
IMR90|chr7:66311886-66311935,chr7,66311886,66311935,IMR90|chr7:65956840-65956972,chr7,65956840,65956972,1,355046
IMR90|chr7:66312001-66312028,chr7,66312001,66312028,IMR90|chr7:65956454-65956529,chr7,65956454,65956529,1,355547
IMR90|chr7:66312027-66312085,chr7,66312027,66312085,IMR90|chr7:65956497-65956617,chr7,65956497,65956617,1,355530
IMR90|chr7:73293249-73293280,chr7,73293249,73293280,IMR90|chr7:73866010-73866079,chr7,73866010,73866079,1,572761
IMR90|chr7:73714264-73714328,chr7,73714264,73714328,IMR90|chr7:23571266-23571367,chr7,23571266,23571367,1,50142998
IMR90|chr7:73714285-73714328,chr7,73714285,73714328,IMR90|chr7:23571266-23571367,chr7,23571266,23571367,1,50143019
IMR90|chr7:73752680-73752741,chr7,73752680,73752741,IMR90|chr7:72819514-72819564,chr7,72819514,72819564,1,933166
IMR90|chr7:73752681-73752741,chr7,73752681,73752741,IMR90|chr7:72819514-72819565,chr7,72819514,72819565,1,933167
IMR90|chr7:73895290-73895421,chr7,73895290,73895421,IMR90|chr7:44837868-44837896,chr7,44837868,44837896,1,29057422
IMR90|chr7:73895301-73895422,chr7,73895301,73895422,IMR90|chr7:44837868-44837896,chr7,44837868,44837896,1,29057433
IMR90|chr7:73895379-73895422,chr7,73895379,73895422,IMR90|chr7:44837868-44837896,chr7,44837868,44837896,1,29057511
IMR90|chr7:73900207-73900252,chr7,73900207,73900252,IMR90|chr7:74067704-74067773,chr7,74067704,74067773,1,167497
IMR90|chr7:74284642-74284792,chr7,74284642,74284792,IMR90|chr7:74491241-74491390,chr7,74491241,74491390,1,206599
IMR90|chr7:74284658-74284808,chr7,74284658,74284808,IMR90|chr7:74491336-74491486,chr7,74491336,74491486,1,206678
IMR90|chr7:74284710-74284808,chr7,74284710,74284808,IMR90|chr7:74491392-74491542,chr7,74491392,74491542,1,206682
IMR90|chr7:74284945-74285095,chr7,74284945,74285095,IMR90|chr7:74491079-74491226,chr7,74491079,74491226,1,206134
IMR90|chr7:74284966-74285110,chr7,74284966,74285110,IMR90|chr7:74491069-74491219,chr7,74491069,74491219,1,206103
IMR90|chr7:74285572-74285629,chr7,74285572,74285629,IMR90|chr7:74490080-74490173,chr7,74490080,74490173,1,204508
IMR90|chr7:74286064-74286112,chr7,74286064,74286112,IMR90|chr7:74491305-74491407,chr7,74491305,74491407,1,205241
IMR90|chr7:74286102-74286178,chr7,74286102,74286178,IMR90|chr7:74491275-74491341,chr7,74491275,74491341,1,205173
IMR90|chr7:74286540-74286578,chr7,74286540,74286578,IMR90|chr7:72820423-72820552,chr7,72820423,72820552,1,1466117
IMR90|chr7:74287129-74287158,chr7,74287129,74287158,IMR90|chr7:72821054-72821200,chr7,72821054,72821200,1,1466075
IMR90|chr7:74288153-74288201,chr7,74288153,74288201,IMR90|chr7:74491125-74491234,chr7,74491125,74491234,1,202972
IMR90|chr7:74289003-74289054,chr7,74289003,74289054,IMR90|chr7:72820800-72820874,chr7,72820800,72820874,1,1468203
IMR90|chr7:74290003-74290044,chr7,74290003,74290044,IMR90|chr7:6774534-6774594,chr7,6774534,6774594,1,67515469
IMR90|chr7:74290410-74290474,chr7,74290410,74290474,IMR90|chr7:74491151-74491233,chr7,74491151,74491233,1,200741
IMR90|chr7:75359749-75359844,chr7,75359749,75359844,IMR90|chr7:75155456-75155521,chr7,75155456,75155521,1,204293
IMR90|chr7:75359770-75359846,chr7,75359770,75359846,IMR90|chr7:75155456-75155521,chr7,75155456,75155521,1,204314
IMR90|chr7:75362042-75362119,chr7,75362042,75362119,IMR90|chr7:75156805-75156867,chr7,75156805,75156867,1,205237
IMR90|chr7:75920136-75920270,chr7,75920136,75920270,IMR90|chr7:75931178-75931277,chr7,75931178,75931277,1,11042
IMR90|chr7:75978004-75978154,chr7,75978004,75978154,IMR90|chr7:100770799-100770855,chr7,100770799,100770855,1,24792795
IMR90|chr7:75978079-75978169,chr7,75978079,75978169,IMR90|chr7:100770799-100770855,chr7,100770799,100770855,1,24792720
IMR90|chr7:75979873-75979999,chr7,75979873,75979999,IMR90|chr7:100772615-100772714,chr7,100772615,100772714,1,24792742
IMR90|chr7:76209216-76209274,chr7,76209216,76209274,IMR90|chr7:75550362-75550435,chr7,75550362,75550435,1,658854
IMR90|chr7:76209216-76209273,chr7,76209216,76209273,IMR90|chr7:75550362-75550435,chr7,75550362,75550435,1,658854
IMR90|chr7:76209582-76209647,chr7,76209582,76209647,IMR90|chr7:156687411-156687494,chr7,156687411,156687494,1,80477829
IMR90|chr7:76209582-76209603,chr7,76209582,76209603,IMR90|chr7:156687411-156687494,chr7,156687411,156687494,1,80477829
IMR90|chr7:77180603-77180668,chr7,77180603,77180668,IMR90|chr7:23507187-23507337,chr7,23507187,23507337,1,53673416
IMR90|chr7:77184060-77184125,chr7,77184060,77184125,IMR90|chr7:79081996-79082074,chr7,79081996,79082074,1,1897936
IMR90|chr7:77184060-77184124,chr7,77184060,77184124,IMR90|chr7:79081996-79082074,chr7,79081996,79082074,1,1897936
IMR90|chr7:77187093-77187138,chr7,77187093,77187138,IMR90|chr7:128504146-128504199,chr7,128504146,128504199,1,51317053
IMR90|chr7:77187093-77187137,chr7,77187093,77187137,IMR90|chr7:128504146-128504199,chr7,128504146,128504199,1,51317053
IMR90|chr7:77189769-77189826,chr7,77189769,77189826,IMR90|chr7:77166521-77166584,chr7,77166521,77166584,1,23248
IMR90|chr7:77206667-77206690,chr7,77206667,77206690,IMR90|chr7:23508398-23508487,chr7,23508398,23508487,1,53698269
IMR90|chr7:77208693-77208742,chr7,77208693,77208742,IMR90|chr7:100773130-100773194,chr7,100773130,100773194,1,23564437
IMR90|chr7:77214451-77214472,chr7,77214451,77214472,IMR90|chr7:100772819-100772879,chr7,100772819,100772879,1,23558368
IMR90|chr7:77214451-77214470,chr7,77214451,77214470,IMR90|chr7:100772819-100772879,chr7,100772819,100772879,1,23558368
IMR90|chr7:77278773-77278811,chr7,77278773,77278811,IMR90|chr7:143081662-143081722,chr7,143081662,143081722,1,65802889
IMR90|chr7:77300885-77300924,chr7,77300885,77300924,IMR90|chr7:100772400-100772501,chr7,100772400,100772501,1,23471515
IMR90|chr7:77305728-77305799,chr7,77305728,77305799,IMR90|chr7:100771565-100771628,chr7,100771565,100771628,1,23465837
IMR90|chr7:77442458-77442483,chr7,77442458,77442483,IMR90|chr7:77167112-77167262,chr7,77167112,77167262,1,275346
IMR90|chr7:79774824-79774927,chr7,79774824,79774927,IMR90|chr7:75114379-75114439,chr7,75114379,75114439,1,4660445
IMR90|chr7:79774824-79774914,chr7,79774824,79774914,IMR90|chr7:75114379-75114439,chr7,75114379,75114439,1,4660445
IMR90|chr7:80492513-80492568,chr7,80492513,80492568,IMR90|chr7:100771086-100771181,chr7,100771086,100771181,1,20278573
IMR90|chr7:80511906-80511968,chr7,80511906,80511968,IMR90|chr7:100770782-100770828,chr7,100770782,100770828,1,20258876
IMR90|chr7:90858181-90858245,chr7,90858181,90858245,IMR90|chr7:90891171-90891301,chr7,90891171,90891301,1,32990
IMR90|chr7:90858225-90858245,chr7,90858225,90858245,IMR90|chr7:90891171-90891301,chr7,90891171,90891301,1,32946
IMR90|chr7:92248471-92248517,chr7,92248471,92248517,IMR90|chr7:92218880-92218917,chr7,92218880,92218917,1,29591
IMR90|chr7:92268956-92269005,chr7,92268956,92269005,IMR90|chr7:92219056-92219153,chr7,92219056,92219153,1,49900
IMR90|chr7:92269005-92269031,chr7,92269005,92269031,IMR90|chr7:92219052-92219151,chr7,92219052,92219151,1,49953
IMR90|chr7:92299977-92300124,chr7,92299977,92300124,IMR90|chr7:98740406-98740492,chr7,98740406,98740492,1,6440429
IMR90|chr7:92299977-92300038,chr7,92299977,92300038,IMR90|chr7:98740406-98740492,chr7,98740406,98740492,1,6440429
IMR90|chr7:92300074-92300124,chr7,92300074,92300124,IMR90|chr7:98740406-98740492,chr7,98740406,98740492,1,6440332
IMR90|chr7:92300495-92300566,chr7,92300495,92300566,IMR90|chr7:66093208-66093256,chr7,66093208,66093256,1,26207287
IMR90|chr7:92307773-92307801,chr7,92307773,92307801,IMR90|chr7:104655685-104655761,chr7,104655685,104655761,1,12347912
IMR90|chr7:92307774-92307801,chr7,92307774,92307801,IMR90|chr7:104655685-104655761,chr7,104655685,104655761,1,12347911
IMR90|chr7:92312892-92312924,chr7,92312892,92312924,IMR90|chr7:104649817-104649967,chr7,104649817,104649967,1,12336925
IMR90|chr7:92318376-92318417,chr7,92318376,92318417,IMR90|chr7:140399531-140399587,chr7,140399531,140399587,1,48081155
IMR90|chr7:92318376-92318416,chr7,92318376,92318416,IMR90|chr7:140399531-140399587,chr7,140399531,140399587,1,48081155
IMR90|chr7:92340903-92340946,chr7,92340903,92340946,IMR90|chr7:99931286-99931351,chr7,99931286,99931351,1,7590383
IMR90|chr7:92343574-92343592,chr7,92343574,92343592,IMR90|chr7:97911317-97911356,chr7,97911317,97911356,1,5567743
IMR90|chr7:92350630-92350663,chr7,92350630,92350663,IMR90|chr7:73153921-73154035,chr7,73153921,73154035,1,19196709
IMR90|chr7:92396618-92396685,chr7,92396618,92396685,IMR90|chr7:94027362-94027423,chr7,94027362,94027423,1,1630744
IMR90|chr7:92415284-92415421,chr7,92415284,92415421,IMR90|chr7:94025050-94025121,chr7,94025050,94025121,1,1609766
IMR90|chr7:92415342-92415421,chr7,92415342,92415421,IMR90|chr7:94025050-94025121,chr7,94025050,94025121,1,1609708
IMR90|chr7:92433072-92433134,chr7,92433072,92433134,IMR90|chr7:35841363-35841431,chr7,35841363,35841431,1,56591709
IMR90|chr7:92433072-92433133,chr7,92433072,92433133,IMR90|chr7:35841363-35841431,chr7,35841363,35841431,1,56591709
IMR90|chr7:92433210-92433280,chr7,92433210,92433280,IMR90|chr7:111844817-111844855,chr7,111844817,111844855,1,19411607
IMR90|chr7:92435792-92435843,chr7,92435792,92435843,IMR90|chr7:94024776-94024875,chr7,94024776,94024875,1,1588984
IMR90|chr7:92435796-92435868,chr7,92435796,92435868,IMR90|chr7:94024772-94024848,chr7,94024772,94024848,1,1588976
IMR90|chr7:94032204-94032250,chr7,94032204,94032250,IMR90|chr7:97906359-97906459,chr7,97906359,97906459,1,3874155
IMR90|chr7:94032208-94032249,chr7,94032208,94032249,IMR90|chr7:97906359-97906459,chr7,97906359,97906459,1,3874151
IMR90|chr7:94033184-94033206,chr7,94033184,94033206,IMR90|chr7:26245486-26245551,chr7,26245486,26245551,1,67787698
IMR90|chr7:94042001-94042026,chr7,94042001,94042026,IMR90|chr7:100772405-100772498,chr7,100772405,100772498,1,6730404
IMR90|chr7:94042056-94042088,chr7,94042056,94042088,IMR90|chr7:100772405-100772498,chr7,100772405,100772498,1,6730349
IMR90|chr7:94048166-94048226,chr7,94048166,94048226,IMR90|chr7:149194039-149194121,chr7,149194039,149194121,1,55145873
IMR90|chr7:94048167-94048226,chr7,94048167,94048226,IMR90|chr7:149194039-149194121,chr7,149194039,149194121,1,55145872
IMR90|chr7:94048171-94048225,chr7,94048171,94048225,IMR90|chr7:100772488-100772571,chr7,100772488,100772571,1,6724317
IMR90|chr7:94048172-94048225,chr7,94048172,94048225,IMR90|chr7:100772529-100772572,chr7,100772529,100772572,1,6724357
IMR90|chr7:94050650-94050697,chr7,94050650,94050697,IMR90|chr7:100771388-100771446,chr7,100771388,100771446,1,6720738
IMR90|chr7:94050652-94050752,chr7,94050652,94050752,IMR90|chr7:97911863-97911912,chr7,97911863,97911912,1,3861211
IMR90|chr7:94050657-94050749,chr7,94050657,94050749,IMR90|chr7:97911863-97911912,chr7,97911863,97911912,1,3861206
IMR90|chr7:94052911-94053003,chr7,94052911,94053003,IMR90|chr7:26238516-26238554,chr7,26238516,26238554,1,67814395
IMR90|chr7:94053129-94053178,chr7,94053129,94053178,IMR90|chr7:100773024-100773125,chr7,100773024,100773125,1,6719895
IMR90|chr7:94053133-94053178,chr7,94053133,94053178,IMR90|chr7:100773024-100773129,chr7,100773024,100773129,1,6719891
IMR90|chr7:94055871-94055897,chr7,94055871,94055897,IMR90|chr7:100771557-100771655,chr7,100771557,100771655,1,6715686
IMR90|chr7:94055871-94055894,chr7,94055871,94055894,IMR90|chr7:100771557-100771655,chr7,100771557,100771655,1,6715686
IMR90|chr7:94058776-94058825,chr7,94058776,94058825,IMR90|chr7:100181367-100181462,chr7,100181367,100181462,1,6122591
IMR90|chr7:94058776-94058815,chr7,94058776,94058815,IMR90|chr7:100181367-100181462,chr7,100181367,100181462,1,6122591
IMR90|chr7:94058777-94058860,chr7,94058777,94058860,IMR90|chr7:100181367-100181462,chr7,100181367,100181462,1,6122590
IMR90|chr7:94060984-94061012,chr7,94060984,94061012,IMR90|chr7:100770931-100771027,chr7,100770931,100771027,1,6709947
IMR90|chr7:94060985-94061012,chr7,94060985,94061012,IMR90|chr7:100770931-100771027,chr7,100770931,100771027,1,6709946
IMR90|chr7:98440506-98440560,chr7,98440506,98440560,IMR90|chr7:99062953-99062982,chr7,99062953,99062982,1,622447
IMR90|chr7:98638717-98638757,chr7,98638717,98638757,IMR90|chr7:100772201-100772281,chr7,100772201,100772281,1,2133484
IMR90|chr7:98638720-98638757,chr7,98638720,98638757,IMR90|chr7:100772201-100772281,chr7,100772201,100772281,1,2133481
IMR90|chr7:98638720-98638756,chr7,98638720,98638756,IMR90|chr7:100772201-100772281,chr7,100772201,100772281,1,2133481
IMR90|chr7:98731589-98731631,chr7,98731589,98731631,IMR90|chr7:104653476-104653549,chr7,104653476,104653549,1,5921887
IMR90|chr7:100737384-100737439,chr7,100737384,100737439,IMR90|chr7:100728969-100729054,chr7,100728969,100729054,1,8415
IMR90|chr7:100737384-100737436,chr7,100737384,100737436,IMR90|chr7:100728969-100729054,chr7,100728969,100729054,1,8415
IMR90|chr7:100742395-100742510,chr7,100742395,100742510,IMR90|chr7:100729417-100729510,chr7,100729417,100729510,1,12978
IMR90|chr7:100776148-100776184,chr7,100776148,100776184,IMR90|chr7:100466797-100466931,chr7,100466797,100466931,1,309351
IMR90|chr7:100776668-100776750,chr7,100776668,100776750,IMR90|chr7:100728213-100728229,chr7,100728213,100728229,1,48455
IMR90|chr7:100777673-100777727,chr7,100777673,100777727,IMR90|chr7:100798361-100798414,chr7,100798361,100798414,1,20688
IMR90|chr7:100778359-100778447,chr7,100778359,100778447,IMR90|chr7:100799676-100799705,chr7,100799676,100799705,1,21317
IMR90|chr7:100778638-100778666,chr7,100778638,100778666,IMR90|chr7:100466603-100466678,chr7,100466603,100466678,1,312035
IMR90|chr7:101506639-101506737,chr7,101506639,101506737,IMR90|chr7:100772493-100772537,chr7,100772493,100772537,1,734146
IMR90|chr7:101507860-101507976,chr7,101507860,101507976,IMR90|chr7:100771055-100771123,chr7,100771055,100771123,1,736805
IMR90|chr7:101507860-101507942,chr7,101507860,101507942,IMR90|chr7:100771055-100771123,chr7,100771055,100771123,1,736805
IMR90|chr7:101511563-101511593,chr7,101511563,101511593,IMR90|chr7:100771554-100771648,chr7,100771554,100771648,1,740009
IMR90|chr7:101511563-101511590,chr7,101511563,101511590,IMR90|chr7:100771554-100771648,chr7,100771554,100771648,1,740009
IMR90|chr7:101515605-101515722,chr7,101515605,101515722,IMR90|chr7:100770981-100771062,chr7,100770981,100771062,1,744624
IMR90|chr7:101515656-101515725,chr7,101515656,101515725,IMR90|chr7:100770981-100771062,chr7,100770981,100771062,1,744675
IMR90|chr7:101524958-101525020,chr7,101524958,101525020,IMR90|chr7:138719685-138719759,chr7,138719685,138719759,1,37194727
IMR90|chr7:101556091-101556118,chr7,101556091,101556118,IMR90|chr7:100772082-100772197,chr7,100772082,100772197,1,784009
IMR90|chr7:101556091-101556117,chr7,101556091,101556117,IMR90|chr7:100772082-100772197,chr7,100772082,100772197,1,784009
IMR90|chr7:101557819-101557901,chr7,101557819,101557901,IMR90|chr7:100770883-100770971,chr7,100770883,100770971,1,786936
IMR90|chr7:101559655-101559673,chr7,101559655,101559673,IMR90|chr7:128380407-128380511,chr7,128380407,128380511,1,26820752
IMR90|chr7:101559656-101559673,chr7,101559656,101559673,IMR90|chr7:128380407-128380511,chr7,128380407,128380511,1,26820751
IMR90|chr7:101561378-101561495,chr7,101561378,101561495,IMR90|chr7:128375059-128375086,chr7,128375059,128375086,1,26813681
IMR90|chr7:101561392-101561542,chr7,101561392,101561542,IMR90|chr7:128375059-128375086,chr7,128375059,128375086,1,26813667
IMR90|chr7:101578665-101578768,chr7,101578665,101578768,IMR90|chr7:100773127-100773157,chr7,100773127,100773157,1,805538
IMR90|chr7:101578666-101578768,chr7,101578666,101578768,IMR90|chr7:100773127-100773157,chr7,100773127,100773157,1,805539
IMR90|chr7:102153065-102153128,chr7,102153065,102153128,IMR90|chr7:102252134-102252260,chr7,102252134,102252260,1,99069
IMR90|chr7:102153065-102153127,chr7,102153065,102153127,IMR90|chr7:102252111-102252195,chr7,102252111,102252195,1,99046
IMR90|chr7:102153067-102153123,chr7,102153067,102153123,IMR90|chr7:102252108-102252256,chr7,102252108,102252256,1,99041
IMR90|chr7:102153073-102153121,chr7,102153073,102153121,IMR90|chr7:102252174-102252260,chr7,102252174,102252260,1,99101
IMR90|chr7:102153075-102153128,chr7,102153075,102153128,IMR90|chr7:102252147-102252260,chr7,102252147,102252260,1,99072
IMR90|chr7:102153075-102153124,chr7,102153075,102153124,IMR90|chr7:102252136-102252260,chr7,102252136,102252260,1,99061
IMR90|chr7:102153077-102153126,chr7,102153077,102153126,IMR90|chr7:102252120-102252260,chr7,102252120,102252260,1,99043
IMR90|chr7:102153084-102153128,chr7,102153084,102153128,IMR90|chr7:102252160-102252260,chr7,102252160,102252260,1,99076
IMR90|chr7:102153086-102153128,chr7,102153086,102153128,IMR90|chr7:102252144-102252260,chr7,102252144,102252260,1,99058
IMR90|chr7:102153089-102153123,chr7,102153089,102153123,IMR90|chr7:102252159-102252259,chr7,102252159,102252259,1,99070
IMR90|chr7:102153097-102153155,chr7,102153097,102153155,IMR90|chr7:102252179-102252260,chr7,102252179,102252260,1,99082
IMR90|chr7:102153097-102153147,chr7,102153097,102153147,IMR90|chr7:102252202-102252259,chr7,102252202,102252259,1,99105
IMR90|chr7:102153119-102153139,chr7,102153119,102153139,IMR90|chr7:102252169-102252260,chr7,102252169,102252260,1,99050
IMR90|chr7:102153122-102153169,chr7,102153122,102153169,IMR90|chr7:102252280-102252314,chr7,102252280,102252314,1,99158
IMR90|chr7:102153131-102153180,chr7,102153131,102153180,IMR90|chr7:102252189-102252282,chr7,102252189,102252282,1,99058
IMR90|chr7:105408974-105409060,chr7,105408974,105409060,IMR90|chr7:104650826-104650870,chr7,104650826,104650870,1,758148
IMR90|chr7:105418074-105418106,chr7,105418074,105418106,IMR90|chr7:104653483-104653601,chr7,104653483,104653601,1,764591
IMR90|chr7:105425481-105425514,chr7,105425481,105425514,IMR90|chr7:104649786-104649871,chr7,104649786,104649871,1,775695
IMR90|chr7:105425482-105425514,chr7,105425482,105425514,IMR90|chr7:104649786-104649871,chr7,104649786,104649871,1,775696
IMR90|chr7:105442790-105442823,chr7,105442790,105442823,IMR90|chr7:128472194-128472272,chr7,128472194,128472272,1,23029404
IMR90|chr7:105446165-105446232,chr7,105446165,105446232,IMR90|chr7:105518785-105518844,chr7,105518785,105518844,1,72620
IMR90|chr7:105446166-105446232,chr7,105446166,105446232,IMR90|chr7:105518785-105518844,chr7,105518785,105518844,1,72619
IMR90|chr7:105489347-105489399,chr7,105489347,105489399,IMR90|chr7:105517778-105517837,chr7,105517778,105517837,1,28431
IMR90|chr7:110752219-110752276,chr7,110752219,110752276,IMR90|chr7:93630132-93630282,chr7,93630132,93630282,1,17122087
IMR90|chr7:110999073-110999162,chr7,110999073,110999162,IMR90|chr7:150077581-150077630,chr7,150077581,150077630,1,39078508
IMR90|chr7:110999116-110999161,chr7,110999116,110999161,IMR90|chr7:150077581-150077630,chr7,150077581,150077630,1,39078465
IMR90|chr7:111714673-111714733,chr7,111714673,111714733,IMR90|chr7:6681749-6681828,chr7,6681749,6681828,1,105032924
IMR90|chr7:111714673-111714731,chr7,111714673,111714731,IMR90|chr7:6681749-6681828,chr7,6681749,6681828,1,105032924
IMR90|chr7:111716490-111716542,chr7,111716490,111716542,IMR90|chr7:107642780-107642927,chr7,107642780,107642927,1,4073710
IMR90|chr7:115901700-115901738,chr7,115901700,115901738,IMR90|chr7:116165353-116165434,chr7,116165353,116165434,1,263653
IMR90|chr7:115902869-115902926,chr7,115902869,115902926,IMR90|chr7:116165879-116165912,chr7,116165879,116165912,1,263010
IMR90|chr7:115910603-115910640,chr7,115910603,115910640,IMR90|chr7:116169357-116169430,chr7,116169357,116169430,1,258754
IMR90|chr7:115947414-115947439,chr7,115947414,115947439,IMR90|chr7:116168858-116168955,chr7,116168858,116168955,1,221444
IMR90|chr7:115947414-115947438,chr7,115947414,115947438,IMR90|chr7:116168858-116168955,chr7,116168858,116168955,1,221444
IMR90|chr7:115967086-115967187,chr7,115967086,115967187,IMR90|chr7:104652034-104652086,chr7,104652034,104652086,1,11315052
IMR90|chr7:115967086-115967184,chr7,115967086,115967184,IMR90|chr7:104652034-104652086,chr7,104652034,104652086,1,11315052
IMR90|chr7:115967868-115967893,chr7,115967868,115967893,IMR90|chr7:116166854-116166937,chr7,116166854,116166937,1,198986
IMR90|chr7:115967869-115967893,chr7,115967869,115967893,IMR90|chr7:116166854-116166937,chr7,116166854,116166937,1,198985
IMR90|chr7:116615129-116615206,chr7,116615129,116615206,IMR90|chr7:120968644-120968717,chr7,120968644,120968717,1,4353515
IMR90|chr7:116615132-116615221,chr7,116615132,116615221,IMR90|chr7:120968641-120968702,chr7,120968641,120968702,1,4353509
IMR90|chr7:116615153-116615221,chr7,116615153,116615221,IMR90|chr7:120968643-120968717,chr7,120968643,120968717,1,4353490
IMR90|chr7:116680941-116680973,chr7,116680941,116680973,IMR90|chr7:127230233-127230296,chr7,127230233,127230296,1,10549292
IMR90|chr7:116680942-116680973,chr7,116680942,116680973,IMR90|chr7:127230233-127230296,chr7,127230233,127230296,1,10549291
IMR90|chr7:120922927-120923055,chr7,120922927,120923055,IMR90|chr7:120965322-120965355,chr7,120965322,120965355,1,42395
IMR90|chr7:120922971-120923055,chr7,120922971,120923055,IMR90|chr7:120965322-120965355,chr7,120965322,120965355,1,42351
IMR90|chr7:120926094-120926140,chr7,120926094,120926140,IMR90|chr7:111845698-111845802,chr7,111845698,111845802,1,9080396
IMR90|chr7:120926096-120926171,chr7,120926096,120926171,IMR90|chr7:111845698-111845802,chr7,111845698,111845802,1,9080398
IMR90|chr7:120929064-120929109,chr7,120929064,120929109,IMR90|chr7:120960735-120960814,chr7,120960735,120960814,1,31671
IMR90|chr7:120938037-120938093,chr7,120938037,120938093,IMR90|chr7:120965198-120965240,chr7,120965198,120965240,1,27161
IMR90|chr7:120938054-120938109,chr7,120938054,120938109,IMR90|chr7:120966482-120966532,chr7,120966482,120966532,1,28428
IMR90|chr7:120945275-120945368,chr7,120945275,120945368,IMR90|chr7:120962856-120962922,chr7,120962856,120962922,1,17581
IMR90|chr7:120945284-120945368,chr7,120945284,120945368,IMR90|chr7:120962856-120962922,chr7,120962856,120962922,1,17572
IMR90|chr7:120945812-120945905,chr7,120945812,120945905,IMR90|chr7:120966028-120966075,chr7,120966028,120966075,1,20216
IMR90|chr7:120945972-120946008,chr7,120945972,120946008,IMR90|chr7:120965815-120965958,chr7,120965815,120965958,1,19843
IMR90|chr7:127570940-127570998,chr7,127570940,127570998,IMR90|chr7:100773128-100773169,chr7,100773128,100773169,1,26797812
IMR90|chr7:127570940-127570997,chr7,127570940,127570997,IMR90|chr7:100773128-100773169,chr7,100773128,100773169,1,26797812
IMR90|chr7:127577671-127577727,chr7,127577671,127577727,IMR90|chr7:100771132-100771219,chr7,100771132,100771219,1,26806539
IMR90|chr7:127577672-127577726,chr7,127577672,127577726,IMR90|chr7:100771132-100771219,chr7,100771132,100771219,1,26806540
IMR90|chr7:127585297-127585396,chr7,127585297,127585396,IMR90|chr7:100772584-100772608,chr7,100772584,100772608,1,26812713
IMR90|chr7:128391528-128391678,chr7,128391528,128391678,IMR90|chr7:64364487-64364622,chr7,64364487,64364622,1,64027041
IMR90|chr7:128391546-128391678,chr7,128391546,128391678,IMR90|chr7:64364487-64364560,chr7,64364487,64364560,1,64027059
IMR90|chr7:129482839-129482924,chr7,129482839,129482924,IMR90|chr7:100771285-100771326,chr7,100771285,100771326,1,28711554
IMR90|chr7:129484144-129484212,chr7,129484144,129484212,IMR90|chr7:128379977-128380019,chr7,128379977,128380019,1,1104167
IMR90|chr7:129495613-129495684,chr7,129495613,129495684,IMR90|chr7:100771007-100771085,chr7,100771007,100771085,1,28724606
IMR90|chr7:129495616-129495684,chr7,129495616,129495684,IMR90|chr7:100771007-100771085,chr7,100771007,100771085,1,28724609
IMR90|chr7:129512753-129512876,chr7,129512753,129512876,IMR90|chr7:129707728-129707774,chr7,129707728,129707774,1,194975
IMR90|chr7:129512766-129512869,chr7,129512766,129512869,IMR90|chr7:129707728-129707774,chr7,129707728,129707774,1,194962
IMR90|chr7:129514820-129514893,chr7,129514820,129514893,IMR90|chr7:100771046-100771084,chr7,100771046,100771084,1,28743774
IMR90|chr7:129521415-129521509,chr7,129521415,129521509,IMR90|chr7:129708683-129708763,chr7,129708683,129708763,1,187268
IMR90|chr7:129521439-129521509,chr7,129521439,129521509,IMR90|chr7:129708683-129708763,chr7,129708683,129708763,1,187244
IMR90|chr7:130550061-130550090,chr7,130550061,130550090,IMR90|chr7:5634920-5634952,chr7,5634920,5634952,1,124915141
IMR90|chr7:130550483-130550563,chr7,130550483,130550563,IMR90|chr7:130794996-130795049,chr7,130794996,130795049,1,244513
IMR90|chr7:130554258-130554307,chr7,130554258,130554307,IMR90|chr7:134467325-134467379,chr7,134467325,134467379,1,3913067
IMR90|chr7:130554261-130554307,chr7,130554261,130554307,IMR90|chr7:134467325-134467379,chr7,134467325,134467379,1,3913064
IMR90|chr7:130554537-130554558,chr7,130554537,130554558,IMR90|chr7:55088128-55088216,chr7,55088128,55088216,1,75466409
IMR90|chr7:130561567-130561609,chr7,130561567,130561609,IMR90|chr7:120966485-120966575,chr7,120966485,120966575,1,9595082
IMR90|chr7:130561570-130561609,chr7,130561570,130561609,IMR90|chr7:120966485-120966575,chr7,120966485,120966575,1,9595085
IMR90|chr7:130564003-130564110,chr7,130564003,130564110,IMR90|chr7:100771995-100772069,chr7,100771995,100772069,1,29792008
IMR90|chr7:130564177-130564258,chr7,130564177,130564258,IMR90|chr7:100773094-100773133,chr7,100773094,100773133,1,29791083
IMR90|chr7:130565232-130565272,chr7,130565232,130565272,IMR90|chr7:100771448-100771478,chr7,100771448,100771478,1,29793784
IMR90|chr7:130565893-130566012,chr7,130565893,130566012,IMR90|chr7:129590532-129590555,chr7,129590532,129590555,1,975361
IMR90|chr7:130565930-130565962,chr7,130565930,130565962,IMR90|chr7:100771423-100771536,chr7,100771423,100771536,1,29794507
IMR90|chr7:130565931-130565962,chr7,130565931,130565962,IMR90|chr7:100771423-100771536,chr7,100771423,100771536,1,29794508
IMR90|chr7:130569337-130569359,chr7,130569337,130569359,IMR90|chr7:97885518-97885622,chr7,97885518,97885622,1,32683819
IMR90|chr7:130569338-130569359,chr7,130569338,130569359,IMR90|chr7:97885518-97885622,chr7,97885518,97885622,1,32683820
IMR90|chr7:130570167-130570197,chr7,130570167,130570197,IMR90|chr7:129592069-129592153,chr7,129592069,129592153,1,978098
IMR90|chr7:130570168-130570197,chr7,130570168,130570197,IMR90|chr7:129592069-129592153,chr7,129592069,129592153,1,978099
IMR90|chr7:130571520-130571558,chr7,130571520,130571558,IMR90|chr7:130794454-130794527,chr7,130794454,130794527,1,222934
IMR90|chr7:130572000-130572086,chr7,130572000,130572086,IMR90|chr7:142986450-142986511,chr7,142986450,142986511,1,12414450
IMR90|chr7:130572000-130572085,chr7,130572000,130572085,IMR90|chr7:142986450-142986511,chr7,142986450,142986511,1,12414450
IMR90|chr7:130572048-130572101,chr7,130572048,130572101,IMR90|chr7:100771926-100772064,chr7,100771926,100772064,1,29800122
IMR90|chr7:130572639-130572703,chr7,130572639,130572703,IMR90|chr7:130794326-130794377,chr7,130794326,130794377,1,221687
IMR90|chr7:130574055-130574165,chr7,130574055,130574165,IMR90|chr7:97598352-97598376,chr7,97598352,97598376,1,32975703
IMR90|chr7:130575567-130575677,chr7,130575567,130575677,IMR90|chr7:100857709-100857730,chr7,100857709,100857730,1,29717858
IMR90|chr7:130576421-130576444,chr7,130576421,130576444,IMR90|chr7:130791009-130791133,chr7,130791009,130791133,1,214588
IMR90|chr7:130577888-130577954,chr7,130577888,130577954,IMR90|chr7:100771015-100771073,chr7,100771015,100771073,1,29806873
IMR90|chr7:130577942-130577987,chr7,130577942,130577987,IMR90|chr7:120963791-120963820,chr7,120963791,120963820,1,9614151
IMR90|chr7:130581480-130581582,chr7,130581480,130581582,IMR90|chr7:134467016-134467051,chr7,134467016,134467051,1,3885536
IMR90|chr7:130581939-130582025,chr7,130581939,130582025,IMR90|chr7:130127278-130127300,chr7,130127278,130127300,1,454661
IMR90|chr7:130581939-130582022,chr7,130581939,130582022,IMR90|chr7:130127278-130127300,chr7,130127278,130127300,1,454661
IMR90|chr7:130582126-130582276,chr7,130582126,130582276,IMR90|chr7:129590865-129590900,chr7,129590865,129590900,1,991261
IMR90|chr7:130582432-130582475,chr7,130582432,130582475,IMR90|chr7:115849670-115849778,chr7,115849670,115849778,1,14732762
IMR90|chr7:130582436-130582478,chr7,130582436,130582478,IMR90|chr7:115849670-115849778,chr7,115849670,115849778,1,14732766
IMR90|chr7:130582834-130582923,chr7,130582834,130582923,IMR90|chr7:2673292-2673350,chr7,2673292,2673350,1,127909542
IMR90|chr7:130582834-130582922,chr7,130582834,130582922,IMR90|chr7:2673292-2673350,chr7,2673292,2673350,1,127909542
IMR90|chr7:130582834-130582921,chr7,130582834,130582921,IMR90|chr7:2673292-2673350,chr7,2673292,2673350,1,127909542
IMR90|chr7:130583275-130583374,chr7,130583275,130583374,IMR90|chr7:130134298-130134349,chr7,130134298,130134349,1,448977
IMR90|chr7:130583323-130583473,chr7,130583323,130583473,IMR90|chr7:130134298-130134349,chr7,130134298,130134349,1,449025
IMR90|chr7:130583376-130583473,chr7,130583376,130583473,IMR90|chr7:130134298-130134349,chr7,130134298,130134349,1,449078
IMR90|chr7:130584295-130584329,chr7,130584295,130584329,IMR90|chr7:100857413-100857510,chr7,100857413,100857510,1,29726882
IMR90|chr7:130585377-130585413,chr7,130585377,130585413,IMR90|chr7:131014107-131014201,chr7,131014107,131014201,1,428730
IMR90|chr7:130586090-130586151,chr7,130586090,130586151,IMR90|chr7:97596955-97597030,chr7,97596955,97597030,1,32989135
IMR90|chr7:130586090-130586150,chr7,130586090,130586150,IMR90|chr7:97596955-97597030,chr7,97596955,97597030,1,32989135
IMR90|chr7:130586927-130586981,chr7,130586927,130586981,IMR90|chr7:135195067-135195163,chr7,135195067,135195163,1,4608140
IMR90|chr7:130586930-130586981,chr7,130586930,130586981,IMR90|chr7:135195067-135195163,chr7,135195067,135195163,1,4608137
IMR90|chr7:130587947-130587979,chr7,130587947,130587979,IMR90|chr7:100773025-100773129,chr7,100773025,100773129,1,29814922
IMR90|chr7:130589205-130589244,chr7,130589205,130589244,IMR90|chr7:98740386-98740524,chr7,98740386,98740524,1,31848819
IMR90|chr7:130591959-130592065,chr7,130591959,130592065,IMR90|chr7:100074444-100074467,chr7,100074444,100074467,1,30517515
IMR90|chr7:130591959-130592064,chr7,130591959,130592064,IMR90|chr7:100074444-100074467,chr7,100074444,100074467,1,30517515
IMR90|chr7:130593087-130593165,chr7,130593087,130593165,IMR90|chr7:97880951-97881023,chr7,97880951,97881023,1,32712136
IMR90|chr7:130593134-130593172,chr7,130593134,130593172,IMR90|chr7:97880951-97881023,chr7,97880951,97881023,1,32712183
IMR90|chr7:130594113-130594155,chr7,130594113,130594155,IMR90|chr7:100074678-100074785,chr7,100074678,100074785,1,30519435
IMR90|chr7:130594114-130594154,chr7,130594114,130594154,IMR90|chr7:100074678-100074785,chr7,100074678,100074785,1,30519436
IMR90|chr7:130594170-130594300,chr7,130594170,130594300,IMR90|chr7:98739825-98739878,chr7,98739825,98739878,1,31854345
IMR90|chr7:130594229-130594300,chr7,130594229,130594300,IMR90|chr7:98739825-98739878,chr7,98739825,98739878,1,31854404
IMR90|chr7:130596033-130596121,chr7,130596033,130596121,IMR90|chr7:55088271-55088299,chr7,55088271,55088299,1,75507762
IMR90|chr7:130596034-130596121,chr7,130596034,130596121,IMR90|chr7:55088271-55088299,chr7,55088271,55088299,1,75507763
IMR90|chr7:130597832-130597860,chr7,130597832,130597860,IMR90|chr7:137684889-137685010,chr7,137684889,137685010,1,7087057
IMR90|chr7:130597837-130597862,chr7,130597837,130597862,IMR90|chr7:137684889-137685010,chr7,137684889,137685010,1,7087052
IMR90|chr7:130602740-130602761,chr7,130602740,130602761,IMR90|chr7:135193550-135193680,chr7,135193550,135193680,1,4590810
IMR90|chr7:130602740-130602760,chr7,130602740,130602760,IMR90|chr7:135193550-135193680,chr7,135193550,135193680,1,4590810
IMR90|chr7:130602802-130602835,chr7,130602802,130602835,IMR90|chr7:100427061-100427125,chr7,100427061,100427125,1,30175741
IMR90|chr7:130606934-130606994,chr7,130606934,130606994,IMR90|chr7:152130919-152131004,chr7,152130919,152131004,1,21523985
IMR90|chr7:130606939-130606994,chr7,130606939,130606994,IMR90|chr7:152130919-152131004,chr7,152130919,152131004,1,21523980
IMR90|chr7:130607835-130607862,chr7,130607835,130607862,IMR90|chr7:149413630-149413686,chr7,149413630,149413686,1,18805795
IMR90|chr7:130616453-130616489,chr7,130616453,130616489,IMR90|chr7:100771558-100771610,chr7,100771558,100771610,1,29844895
IMR90|chr7:130616454-130616489,chr7,130616454,130616489,IMR90|chr7:100771558-100771610,chr7,100771558,100771610,1,29844896
IMR90|chr7:130619514-130619563,chr7,130619514,130619563,IMR90|chr7:149413587-149413632,chr7,149413587,149413632,1,18794073
IMR90|chr7:130632713-130632802,chr7,130632713,130632802,IMR90|chr7:137684173-137684260,chr7,137684173,137684260,1,7051460
IMR90|chr7:130632740-130632803,chr7,130632740,130632803,IMR90|chr7:137684173-137684260,chr7,137684173,137684260,1,7051433
IMR90|chr7:130640943-130640985,chr7,130640943,130640985,IMR90|chr7:100771385-100771476,chr7,100771385,100771476,1,29869558
IMR90|chr7:130640944-130640985,chr7,130640944,130640985,IMR90|chr7:100771385-100771476,chr7,100771385,100771476,1,29869559
IMR90|chr7:130647269-130647332,chr7,130647269,130647332,IMR90|chr7:131012237-131012326,chr7,131012237,131012326,1,364968
IMR90|chr7:130647274-130647332,chr7,130647274,130647332,IMR90|chr7:131012237-131012326,chr7,131012237,131012326,1,364963
IMR90|chr7:130647307-130647332,chr7,130647307,130647332,IMR90|chr7:131012237-131012326,chr7,131012237,131012326,1,364930
IMR90|chr7:130692317-130692419,chr7,130692317,130692419,IMR90|chr7:75986804-75986823,chr7,75986804,75986823,1,54705513
IMR90|chr7:130692317-130692350,chr7,130692317,130692350,IMR90|chr7:75986805-75986823,chr7,75986805,75986823,1,54705512
IMR90|chr7:130692329-130692419,chr7,130692329,130692419,IMR90|chr7:75986805-75986823,chr7,75986805,75986823,1,54705524
IMR90|chr7:130705617-130705688,chr7,130705617,130705688,IMR90|chr7:99519436-99519490,chr7,99519436,99519490,1,31186181
IMR90|chr7:130705618-130705688,chr7,130705618,130705688,IMR90|chr7:99519436-99519490,chr7,99519436,99519490,1,31186182
IMR90|chr7:130718911-130719061,chr7,130718911,130719061,IMR90|chr7:129588762-129588808,chr7,129588762,129588808,1,1130149
IMR90|chr7:130718992-130719096,chr7,130718992,130719096,IMR90|chr7:129588762-129588808,chr7,129588762,129588808,1,1130230
IMR90|chr7:131064779-131064815,chr7,131064779,131064815,IMR90|chr7:139523991-139524053,chr7,139523991,139524053,1,8459212
IMR90|chr7:133355541-133355643,chr7,133355541,133355643,IMR90|chr7:130795596-130795644,chr7,130795596,130795644,1,2559945
IMR90|chr7:133355542-133355639,chr7,133355542,133355639,IMR90|chr7:130795596-130795644,chr7,130795596,130795644,1,2559946
IMR90|chr7:133355554-133355643,chr7,133355554,133355643,IMR90|chr7:130795596-130795644,chr7,130795596,130795644,1,2559958
IMR90|chr7:134593192-134593274,chr7,134593192,134593274,IMR90|chr7:104655533-104655612,chr7,104655533,104655612,1,29937659
IMR90|chr7:134623871-134623962,chr7,134623871,134623962,IMR90|chr7:104651179-104651227,chr7,104651179,104651227,1,29972692
IMR90|chr7:136623921-136623976,chr7,136623921,136623976,IMR90|chr7:111844011-111844101,chr7,111844011,111844101,1,24779910
IMR90|chr7:136623921-136623975,chr7,136623921,136623975,IMR90|chr7:111844011-111844101,chr7,111844011,111844101,1,24779910
IMR90|chr7:136642026-136642102,chr7,136642026,136642102,IMR90|chr7:111845720-111845767,chr7,111845720,111845767,1,24796306
IMR90|chr7:136642084-136642187,chr7,136642084,136642187,IMR90|chr7:111845720-111845767,chr7,111845720,111845767,1,24796364
IMR90|chr7:137503486-137503578,chr7,137503486,137503578,IMR90|chr7:137536556-137536604,chr7,137536556,137536604,1,33070
IMR90|chr7:137503533-137503587,chr7,137503533,137503587,IMR90|chr7:137535909-137536005,chr7,137535909,137536005,1,32376
IMR90|chr7:137503534-137503587,chr7,137503534,137503587,IMR90|chr7:137535909-137536005,chr7,137535909,137536005,1,32375
IMR90|chr7:137505340-137505375,chr7,137505340,137505375,IMR90|chr7:137534569-137534658,chr7,137534569,137534658,1,29229
IMR90|chr7:137566785-137566860,chr7,137566785,137566860,IMR90|chr7:135341415-135341435,chr7,135341415,135341435,1,2225370
IMR90|chr7:137566786-137566860,chr7,137566786,137566860,IMR90|chr7:135341415-135341435,chr7,135341415,135341435,1,2225371
IMR90|chr7:137566805-137566862,chr7,137566805,137566862,IMR90|chr7:135341415-135341435,chr7,135341415,135341435,1,2225390
IMR90|chr7:137659780-137659833,chr7,137659780,137659833,IMR90|chr7:44084863-44084991,chr7,44084863,44084991,1,93574917
IMR90|chr7:137664557-137664584,chr7,137664557,137664584,IMR90|chr7:87847549-87847648,chr7,87847549,87847648,1,49817008
IMR90|chr7:137664557-137664580,chr7,137664557,137664580,IMR90|chr7:87847549-87847648,chr7,87847549,87847648,1,49817008
IMR90|chr7:137664558-137664580,chr7,137664558,137664580,IMR90|chr7:87847549-87847648,chr7,87847549,87847648,1,49817009
IMR90|chr7:137672792-137672846,chr7,137672792,137672846,IMR90|chr7:100074675-100074750,chr7,100074675,100074750,1,37598117
IMR90|chr7:137672810-137672844,chr7,137672810,137672844,IMR90|chr7:100074675-100074750,chr7,100074675,100074750,1,37598135
IMR90|chr7:137672819-137672862,chr7,137672819,137672862,IMR90|chr7:44086828-44086885,chr7,44086828,44086885,1,93585991
IMR90|chr7:139337631-139337760,chr7,139337631,139337760,IMR90|chr7:143081665-143081686,chr7,143081665,143081686,1,3744034
IMR90|chr7:139337633-139337762,chr7,139337633,139337762,IMR90|chr7:143081665-143081686,chr7,143081665,143081686,1,3744032
IMR90|chr7:139349228-139349283,chr7,139349228,139349283,IMR90|chr7:143080627-143080719,chr7,143080627,143080719,1,3731399
IMR90|chr7:139349228-139349281,chr7,139349228,139349281,IMR90|chr7:143080627-143080719,chr7,143080627,143080719,1,3731399
IMR90|chr7:139349463-139349495,chr7,139349463,139349495,IMR90|chr7:90224759-90224870,chr7,90224759,90224870,1,49124704
IMR90|chr7:139349464-139349495,chr7,139349464,139349495,IMR90|chr7:90224759-90224870,chr7,90224759,90224870,1,49124705
IMR90|chr7:139357211-139357322,chr7,139357211,139357322,IMR90|chr7:143082006-143082023,chr7,143082006,143082023,1,3724795
IMR90|chr7:139357228-139357322,chr7,139357228,139357322,IMR90|chr7:143082006-143082023,chr7,143082006,143082023,1,3724778
IMR90|chr7:139363176-139363236,chr7,139363176,139363236,IMR90|chr7:65541435-65541483,chr7,65541435,65541483,1,73821741
IMR90|chr7:139434288-139434376,chr7,139434288,139434376,IMR90|chr7:98972915-98972996,chr7,98972915,98972996,1,40461373
IMR90|chr7:139434307-139434377,chr7,139434307,139434377,IMR90|chr7:98972916-98972995,chr7,98972916,98972995,1,40461391
IMR90|chr7:139434361-139434376,chr7,139434361,139434376,IMR90|chr7:98972915-98972996,chr7,98972915,98972996,1,40461446
IMR90|chr7:139547359-139547450,chr7,139547359,139547450,IMR90|chr7:137683702-137683768,chr7,137683702,137683768,1,1863657
IMR90|chr7:139547366-139547450,chr7,139547366,139547450,IMR90|chr7:137683702-137683768,chr7,137683702,137683768,1,1863664
IMR90|chr7:139547367-139547450,chr7,139547367,139547450,IMR90|chr7:137683702-137683768,chr7,137683702,137683768,1,1863665
IMR90|chr7:139637674-139637770,chr7,139637674,139637770,IMR90|chr7:137686093-137686158,chr7,137686093,137686158,1,1951581
IMR90|chr7:139637698-139637770,chr7,139637698,139637770,IMR90|chr7:137686093-137686158,chr7,137686093,137686158,1,1951605
IMR90|chr7:139637714-139637770,chr7,139637714,139637770,IMR90|chr7:137686093-137686158,chr7,137686093,137686158,1,1951621
IMR90|chr7:151189552-151189656,chr7,151189552,151189656,IMR90|chr7:140339371-140339411,chr7,140339371,140339411,1,10850181
IMR90|chr7:151189698-151189737,chr7,151189698,151189737,IMR90|chr7:140339371-140339411,chr7,140339371,140339411,1,10850327
IMR90|chr7:151192509-151192620,chr7,151192509,151192620,IMR90|chr7:140339438-140339477,chr7,140339438,140339477,1,10853071
IMR90|chr7:151192510-151192637,chr7,151192510,151192637,IMR90|chr7:140339438-140339477,chr7,140339438,140339477,1,10853072
IMR90|chr7:151197713-151197787,chr7,151197713,151197787,IMR90|chr7:158496424-158496487,chr7,158496424,158496487,1,7298711
IMR90|chr7:151198969-151199027,chr7,151198969,151199027,IMR90|chr7:79086859-79086951,chr7,79086859,79086951,1,72112110
IMR90|chr7:151198979-151199027,chr7,151198979,151199027,IMR90|chr7:79086849-79086951,chr7,79086849,79086951,1,72112130
IMR90|chr7:151338513-151338625,chr7,151338513,151338625,IMR90|chr7:94025358-94025382,chr7,94025358,94025382,1,57313155
IMR90|chr7:151338556-151338625,chr7,151338556,151338625,IMR90|chr7:94025358-94025382,chr7,94025358,94025382,1,57313198
IMR90|chr7:152063642-152063694,chr7,152063642,152063694,IMR90|chr7:97915386-97915511,chr7,97915386,97915511,1,54148256
IMR90|chr7:152063643-152063694,chr7,152063643,152063694,IMR90|chr7:97915386-97915511,chr7,97915386,97915511,1,54148257
IMR90|chr7:152063672-152063694,chr7,152063672,152063694,IMR90|chr7:97915386-97915511,chr7,97915386,97915511,1,54148286
IMR90|chr7:155452266-155452325,chr7,155452266,155452325,IMR90|chr7:105331746-105331826,chr7,105331746,105331826,1,50120520
IMR90|chr7:155452267-155452325,chr7,155452267,155452325,IMR90|chr7:105331746-105331826,chr7,105331746,105331826,1,50120521
IMR90|chr7:156993452-156993491,chr7,156993452,156993491,IMR90|chr7:157130897-157130973,chr7,157130897,157130973,1,137445
IMR90|chr7:157101979-157102050,chr7,157101979,157102050,IMR90|chr7:157131126-157131197,chr7,157131126,157131197,1,29147
IMR90|chr7:157101979-157102047,chr7,157101979,157102047,IMR90|chr7:157131126-157131197,chr7,157131126,157131197,1,29147
IMR90|chr7:157191700-157191779,chr7,157191700,157191779,IMR90|chr7:94025853-94025886,chr7,94025853,94025886,1,63165847
IMR90|chr7:157195119-157195227,chr7,157195119,157195227,IMR90|chr7:44615859-44615885,chr7,44615859,44615885,1,112579260
IMR90|chr8:1848991-1849034,chr8,1848991,1849034,IMR90|chr8:1918808-1918849,chr8,1918808,1918849,1,69817
IMR90|chr8:1848992-1849023,chr8,1848992,1849023,IMR90|chr8:1918808-1918849,chr8,1918808,1918849,1,69816
IMR90|chr8:9466805-9466867,chr8,9466805,9466867,IMR90|chr8:119118645-119118708,chr8,119118645,119118708,1,109651840
IMR90|chr8:9997012-9997046,chr8,9997012,9997046,IMR90|chr8:37656597-37656684,chr8,37656597,37656684,1,27659585
IMR90|chr8:9997012-9997042,chr8,9997012,9997042,IMR90|chr8:37656597-37656684,chr8,37656597,37656684,1,27659585
IMR90|chr8:12946549-12946644,chr8,12946549,12946644,IMR90|chr8:23710197-23710216,chr8,23710197,23710216,1,10763648
IMR90|chr8:12961904-12962000,chr8,12961904,12962000,IMR90|chr8:100907519-100907562,chr8,100907519,100907562,1,87945615
IMR90|chr8:12963485-12963558,chr8,12963485,12963558,IMR90|chr8:23711327-23711383,chr8,23711327,23711383,1,10747842
IMR90|chr8:12963498-12963558,chr8,12963498,12963558,IMR90|chr8:23711327-23711383,chr8,23711327,23711383,1,10747829
IMR90|chr8:13009609-13009688,chr8,13009609,13009688,IMR90|chr8:18871935-18872040,chr8,18871935,18872040,1,5862326
IMR90|chr8:13009643-13009688,chr8,13009643,13009688,IMR90|chr8:18871935-18872040,chr8,18871935,18872040,1,5862292
IMR90|chr8:13063937-13063971,chr8,13063937,13063971,IMR90|chr8:11722815-11722890,chr8,11722815,11722890,1,1341122
IMR90|chr8:13063938-13063971,chr8,13063938,13063971,IMR90|chr8:11722815-11722890,chr8,11722815,11722890,1,1341123
IMR90|chr8:13071293-13071421,chr8,13071293,13071421,IMR90|chr8:11724120-11724144,chr8,11724120,11724144,1,1347173
IMR90|chr8:13071309-13071421,chr8,13071309,13071421,IMR90|chr8:11724120-11724144,chr8,11724120,11724144,1,1347189
IMR90|chr8:13077699-13077754,chr8,13077699,13077754,IMR90|chr8:11722629-11722724,chr8,11722629,11722724,1,1355070
IMR90|chr8:13080402-13080535,chr8,13080402,13080535,IMR90|chr8:48922044-48922096,chr8,48922044,48922096,1,35841642
IMR90|chr8:13080442-13080535,chr8,13080442,13080535,IMR90|chr8:48922044-48922096,chr8,48922044,48922096,1,35841602
IMR90|chr8:13080820-13080913,chr8,13080820,13080913,IMR90|chr8:1773287-1773344,chr8,1773287,1773344,1,11307533
IMR90|chr8:13097534-13097576,chr8,13097534,13097576,IMR90|chr8:25315102-25315144,chr8,25315102,25315144,1,12217568
IMR90|chr8:13097538-13097576,chr8,13097538,13097576,IMR90|chr8:25315102-25315139,chr8,25315102,25315139,1,12217564
IMR90|chr8:13364060-13364091,chr8,13364060,13364091,IMR90|chr8:142010133-142010211,chr8,142010133,142010211,1,128646073
IMR90|chr8:16912141-16912161,chr8,16912141,16912161,IMR90|chr8:38857331-38857369,chr8,38857331,38857369,1,21945190
IMR90|chr8:16913814-16913858,chr8,16913814,16913858,IMR90|chr8:17017991-17018072,chr8,17017991,17018072,1,104177
IMR90|chr8:16915411-16915519,chr8,16915411,16915519,IMR90|chr8:38857331-38857369,chr8,38857331,38857369,1,21941920
IMR90|chr8:16915436-16915519,chr8,16915436,16915519,IMR90|chr8:38857331-38857369,chr8,38857331,38857369,1,21941895
IMR90|chr8:16967927-16967988,chr8,16967927,16967988,IMR90|chr8:17016705-17016747,chr8,17016705,17016747,1,48778
IMR90|chr8:21782677-21782821,chr8,21782677,21782821,IMR90|chr8:20082508-20082556,chr8,20082508,20082556,1,1700169
IMR90|chr8:21782677-21782781,chr8,21782677,21782781,IMR90|chr8:20082508-20082554,chr8,20082508,20082554,1,1700169
IMR90|chr8:23154064-23154084,chr8,23154064,23154084,IMR90|chr8:23146795-23146875,chr8,23146795,23146875,1,7269
IMR90|chr8:23154608-23154658,chr8,23154608,23154658,IMR90|chr8:23146692-23146842,chr8,23146692,23146842,1,7916
IMR90|chr8:23173904-23173963,chr8,23173904,23173963,IMR90|chr8:23147057-23147144,chr8,23147057,23147144,1,26847
IMR90|chr8:23173904-23173960,chr8,23173904,23173960,IMR90|chr8:23147057-23147144,chr8,23147057,23147144,1,26847
IMR90|chr8:25129905-25129920,chr8,25129905,25129920,IMR90|chr8:25315326-25315430,chr8,25315326,25315430,1,185421
IMR90|chr8:25130143-25130254,chr8,25130143,25130254,IMR90|chr8:37656476-37656515,chr8,37656476,37656515,1,12526333
IMR90|chr8:25130143-25130184,chr8,25130143,25130184,IMR90|chr8:37656476-37656515,chr8,37656476,37656515,1,12526333
IMR90|chr8:25130193-25130340,chr8,25130193,25130340,IMR90|chr8:37656476-37656515,chr8,37656476,37656515,1,12526283
IMR90|chr8:29085672-29085765,chr8,29085672,29085765,IMR90|chr8:128752406-128752429,chr8,128752406,128752429,1,99666734
IMR90|chr8:29085673-29085765,chr8,29085673,29085765,IMR90|chr8:128752406-128752429,chr8,128752406,128752429,1,99666733
IMR90|chr8:30253458-30253478,chr8,30253458,30253478,IMR90|chr8:38035864-38035987,chr8,38035864,38035987,1,7782406
IMR90|chr8:30253458-30253477,chr8,30253458,30253477,IMR90|chr8:38035864-38035987,chr8,38035864,38035987,1,7782406
IMR90|chr8:30351052-30351103,chr8,30351052,30351103,IMR90|chr8:90770714-90770797,chr8,90770714,90770797,1,60419662
IMR90|chr8:32636616-32636712,chr8,32636616,32636712,IMR90|chr8:57123445-57123490,chr8,57123445,57123490,1,24486829
IMR90|chr8:32636616-32636710,chr8,32636616,32636710,IMR90|chr8:57123445-57123490,chr8,57123445,57123490,1,24486829
IMR90|chr8:37670643-37670736,chr8,37670643,37670736,IMR90|chr8:42395335-42395394,chr8,42395335,42395394,1,4724692
IMR90|chr8:37670643-37670733,chr8,37670643,37670733,IMR90|chr8:42395335-42395394,chr8,42395335,42395394,1,4724692
IMR90|chr8:38780526-38780568,chr8,38780526,38780568,IMR90|chr8:42051767-42051860,chr8,42051767,42051860,1,3271241
IMR90|chr8:38894366-38894419,chr8,38894366,38894419,IMR90|chr8:55012775-55012828,chr8,55012775,55012828,1,16118409
IMR90|chr8:38894366-38894400,chr8,38894366,38894400,IMR90|chr8:55012769-55012828,chr8,55012769,55012828,1,16118403
IMR90|chr8:41867127-41867199,chr8,41867127,41867199,IMR90|chr8:11327949-11328009,chr8,11327949,11328009,1,30539178
IMR90|chr8:41867127-41867165,chr8,41867127,41867165,IMR90|chr8:11327949-11328009,chr8,11327949,11328009,1,30539178
IMR90|chr8:42154019-42154169,chr8,42154019,42154169,IMR90|chr8:38645536-38645572,chr8,38645536,38645572,1,3508483
IMR90|chr8:42154019-42154156,chr8,42154019,42154156,IMR90|chr8:38645536-38645572,chr8,38645536,38645572,1,3508483
IMR90|chr8:42154066-42154180,chr8,42154066,42154180,IMR90|chr8:38645536-38645572,chr8,38645536,38645572,1,3508530
IMR90|chr8:42987534-42987580,chr8,42987534,42987580,IMR90|chr8:120844350-120844427,chr8,120844350,120844427,1,77856816
IMR90|chr8:42987534-42987574,chr8,42987534,42987574,IMR90|chr8:120844350-120844427,chr8,120844350,120844427,1,77856816
IMR90|chr8:48395084-48395138,chr8,48395084,48395138,IMR90|chr8:116679859-116679953,chr8,116679859,116679953,1,68284775
IMR90|chr8:48395084-48395134,chr8,48395084,48395134,IMR90|chr8:116679918-116679953,chr8,116679918,116679953,1,68284834
IMR90|chr8:48589806-48589853,chr8,48589806,48589853,IMR90|chr8:17433646-17433697,chr8,17433646,17433697,1,31156160
IMR90|chr8:49321552-49321702,chr8,49321552,49321702,IMR90|chr8:49296845-49296874,chr8,49296845,49296874,1,24707
IMR90|chr8:49321588-49321706,chr8,49321588,49321706,IMR90|chr8:49296845-49296874,chr8,49296845,49296874,1,24743
IMR90|chr8:49324269-49324309,chr8,49324269,49324309,IMR90|chr8:62625842-62625866,chr8,62625842,62625866,1,13301573
IMR90|chr8:49330995-49331119,chr8,49330995,49331119,IMR90|chr8:49296745-49296793,chr8,49296745,49296793,1,34250
IMR90|chr8:49330995-49331097,chr8,49330995,49331097,IMR90|chr8:49296745-49296793,chr8,49296745,49296793,1,34250
IMR90|chr8:49336912-49336971,chr8,49336912,49336971,IMR90|chr8:49294713-49294746,chr8,49294713,49294746,1,42199
IMR90|chr8:49336912-49336962,chr8,49336912,49336962,IMR90|chr8:49294643-49294771,chr8,49294643,49294771,1,42269
IMR90|chr8:49336912-49336934,chr8,49336912,49336934,IMR90|chr8:49294643-49294771,chr8,49294643,49294771,1,42269
IMR90|chr8:61445591-61445660,chr8,61445591,61445660,IMR90|chr8:62624548-62624616,chr8,62624548,62624616,1,1178957
IMR90|chr8:61445593-61445660,chr8,61445593,61445660,IMR90|chr8:62624546-62624616,chr8,62624546,62624616,1,1178953
IMR90|chr8:61450992-61451044,chr8,61450992,61451044,IMR90|chr8:62623249-62623311,chr8,62623249,62623311,1,1172257
IMR90|chr8:62568366-62568387,chr8,62568366,62568387,IMR90|chr8:74904163-74904199,chr8,74904163,74904199,1,12335797
IMR90|chr8:62574703-62574769,chr8,62574703,62574769,IMR90|chr8:61430830-61430899,chr8,61430830,61430899,1,1143873
IMR90|chr8:62574705-62574769,chr8,62574705,62574769,IMR90|chr8:61430830-61430899,chr8,61430830,61430899,1,1143875
IMR90|chr8:62589383-62589502,chr8,62589383,62589502,IMR90|chr8:57123507-57123574,chr8,57123507,57123574,1,5465876
IMR90|chr8:62609286-62609374,chr8,62609286,62609374,IMR90|chr8:61430593-61430651,chr8,61430593,61430651,1,1178693
IMR90|chr8:62609287-62609373,chr8,62609287,62609373,IMR90|chr8:61430593-61430651,chr8,61430593,61430651,1,1178694
IMR90|chr8:62617437-62617521,chr8,62617437,62617521,IMR90|chr8:57122314-57122365,chr8,57122314,57122365,1,5495123
IMR90|chr8:62617440-62617521,chr8,62617440,62617521,IMR90|chr8:57122314-57122365,chr8,57122314,57122365,1,5495126
IMR90|chr8:62621568-62621633,chr8,62621568,62621633,IMR90|chr8:74884138-74884216,chr8,74884138,74884216,1,12262570
IMR90|chr8:62621569-62621633,chr8,62621569,62621633,IMR90|chr8:74884138-74884216,chr8,74884138,74884216,1,12262569
IMR90|chr8:74920085-74920131,chr8,74920085,74920131,IMR90|chr8:48876657-48876752,chr8,48876657,48876752,1,26043428
IMR90|chr8:90901687-90901722,chr8,90901687,90901722,IMR90|chr8:90913067-90913217,chr8,90913067,90913217,1,11380
IMR90|chr8:97947210-97947315,chr8,97947210,97947315,IMR90|chr8:117781305-117781350,chr8,117781305,117781350,1,19834095
IMR90|chr8:97947210-97947310,chr8,97947210,97947310,IMR90|chr8:117781305-117781345,chr8,117781305,117781345,1,19834095
IMR90|chr8:98194097-98194119,chr8,98194097,98194119,IMR90|chr8:104384332-104384432,chr8,104384332,104384432,1,6190235
IMR90|chr8:98194098-98194119,chr8,98194098,98194119,IMR90|chr8:104384332-104384432,chr8,104384332,104384432,1,6190234
IMR90|chr8:103403305-103403368,chr8,103403305,103403368,IMR90|chr8:145687091-145687160,chr8,145687091,145687160,1,42283786
IMR90|chr8:103403309-103403368,chr8,103403309,103403368,IMR90|chr8:145687091-145687158,chr8,145687091,145687158,1,42283782
IMR90|chr8:103403332-103403368,chr8,103403332,103403368,IMR90|chr8:145687091-145687160,chr8,145687091,145687160,1,42283759
IMR90|chr8:103403490-103403551,chr8,103403490,103403551,IMR90|chr8:101732566-101732609,chr8,101732566,101732609,1,1670924
IMR90|chr8:103403491-103403551,chr8,103403491,103403551,IMR90|chr8:101732566-101732609,chr8,101732566,101732609,1,1670925
IMR90|chr8:104323183-104323261,chr8,104323183,104323261,IMR90|chr8:104379164-104379213,chr8,104379164,104379213,1,55981
IMR90|chr8:104325587-104325640,chr8,104325587,104325640,IMR90|chr8:104387833-104387888,chr8,104387833,104387888,1,62246
IMR90|chr8:106419854-106419898,chr8,106419854,106419898,IMR90|chr8:66752834-66752923,chr8,66752834,66752923,1,39667020
IMR90|chr8:107072390-107072431,chr8,107072390,107072431,IMR90|chr8:134581140-134581223,chr8,134581140,134581223,1,27508750
IMR90|chr8:107072390-107072429,chr8,107072390,107072429,IMR90|chr8:134581140-134581223,chr8,134581140,134581223,1,27508750
IMR90|chr8:107558184-107558236,chr8,107558184,107558236,IMR90|chr8:107077706-107077777,chr8,107077706,107077777,1,480478
IMR90|chr8:107558184-107558221,chr8,107558184,107558221,IMR90|chr8:107077706-107077792,chr8,107077706,107077792,1,480478
IMR90|chr8:107558196-107558236,chr8,107558196,107558236,IMR90|chr8:107077706-107077792,chr8,107077706,107077792,1,480490
IMR90|chr8:107558221-107558259,chr8,107558221,107558259,IMR90|chr8:107077706-107077792,chr8,107077706,107077792,1,480515
IMR90|chr8:107558236-107558259,chr8,107558236,107558259,IMR90|chr8:107077706-107077792,chr8,107077706,107077792,1,480530
IMR90|chr8:116583217-116583249,chr8,116583217,116583249,IMR90|chr8:125552252-125552336,chr8,125552252,125552336,1,8969035
IMR90|chr8:116583232-116583250,chr8,116583232,116583250,IMR90|chr8:125552253-125552335,chr8,125552253,125552335,1,8969021
IMR90|chr8:117696062-117696139,chr8,117696062,117696139,IMR90|chr8:131455068-131455115,chr8,131455068,131455115,1,13759006
IMR90|chr8:117720080-117720128,chr8,117720080,117720128,IMR90|chr8:119122183-119122231,chr8,119122183,119122231,1,1402103
IMR90|chr8:117741057-117741114,chr8,117741057,117741114,IMR90|chr8:119121842-119121922,chr8,119121842,119121922,1,1380785
IMR90|chr8:118900268-118900332,chr8,118900268,118900332,IMR90|chr8:116677372-116677416,chr8,116677372,116677416,1,2222896
IMR90|chr8:118903159-118903211,chr8,118903159,118903211,IMR90|chr8:134582012-134582091,chr8,134582012,134582091,1,15678853
IMR90|chr8:118903161-118903211,chr8,118903161,118903211,IMR90|chr8:134582012-134582091,chr8,134582012,134582091,1,15678851
IMR90|chr8:118908893-118908916,chr8,118908893,118908916,IMR90|chr8:145013738-145013832,chr8,145013738,145013832,1,26104845
IMR90|chr8:118937366-118937466,chr8,118937366,118937466,IMR90|chr8:99056493-99056550,chr8,99056493,99056550,1,19880873
IMR90|chr8:118937373-118937466,chr8,118937373,118937466,IMR90|chr8:99056493-99056550,chr8,99056493,99056550,1,19880880
IMR90|chr8:118945431-118945470,chr8,118945431,118945470,IMR90|chr8:106332348-106332404,chr8,106332348,106332404,1,12613083
IMR90|chr8:119010974-119011112,chr8,119010974,119011112,IMR90|chr8:145012797-145012928,chr8,145012797,145012928,1,26001823
IMR90|chr8:119021826-119021905,chr8,119021826,119021905,IMR90|chr8:106334385-106334435,chr8,106334385,106334435,1,12687441
IMR90|chr8:119025778-119025806,chr8,119025778,119025806,IMR90|chr8:11724505-11724548,chr8,11724505,11724548,1,107301273
IMR90|chr8:119025779-119025806,chr8,119025779,119025806,IMR90|chr8:11724505-11724548,chr8,11724505,11724548,1,107301274
IMR90|chr8:119032773-119032836,chr8,119032773,119032836,IMR90|chr8:72757311-72757362,chr8,72757311,72757362,1,46275462
IMR90|chr8:119032774-119032836,chr8,119032774,119032836,IMR90|chr8:72757311-72757362,chr8,72757311,72757362,1,46275463
IMR90|chr8:119042724-119042814,chr8,119042724,119042814,IMR90|chr8:66753173-66753231,chr8,66753173,66753231,1,52289551
IMR90|chr8:119042752-119042842,chr8,119042752,119042842,IMR90|chr8:66753173-66753231,chr8,66753173,66753231,1,52289579
IMR90|chr8:119048981-119049023,chr8,119048981,119049023,IMR90|chr8:104384912-104384989,chr8,104384912,104384989,1,14664069
IMR90|chr8:119052193-119052284,chr8,119052193,119052284,IMR90|chr8:104385851-104385872,chr8,104385851,104385872,1,14666342
IMR90|chr8:119052193-119052281,chr8,119052193,119052281,IMR90|chr8:104385851-104385872,chr8,104385851,104385872,1,14666342
IMR90|chr8:119057844-119057926,chr8,119057844,119057926,IMR90|chr8:11720117-11720161,chr8,11720117,11720161,1,107337727
IMR90|chr8:119057844-119057924,chr8,119057844,119057924,IMR90|chr8:11720117-11720161,chr8,11720117,11720161,1,107337727
IMR90|chr8:119057879-119057926,chr8,119057879,119057926,IMR90|chr8:11720117-11720161,chr8,11720117,11720161,1,107337762
IMR90|chr8:119061299-119061336,chr8,119061299,119061336,IMR90|chr8:66752023-66752058,chr8,66752023,66752058,1,52309276
IMR90|chr8:119065191-119065225,chr8,119065191,119065225,IMR90|chr8:145046285-145046418,chr8,145046285,145046418,1,25981094
IMR90|chr8:119074422-119074504,chr8,119074422,119074504,IMR90|chr8:134581069-134581219,chr8,134581069,134581219,1,15506647
IMR90|chr8:119084052-119084116,chr8,119084052,119084116,IMR90|chr8:11323190-11323255,chr8,11323190,11323255,1,107760862
IMR90|chr8:119084053-119084116,chr8,119084053,119084116,IMR90|chr8:11323190-11323255,chr8,11323190,11323255,1,107760863
IMR90|chr8:119084053-119084114,chr8,119084053,119084114,IMR90|chr8:11323190-11323256,chr8,11323190,11323256,1,107760863
IMR90|chr8:119085767-119085849,chr8,119085767,119085849,IMR90|chr8:145021384-145021424,chr8,145021384,145021424,1,25935617
IMR90|chr8:119085819-119085851,chr8,119085819,119085851,IMR90|chr8:145021384-145021424,chr8,145021384,145021424,1,25935565
IMR90|chr8:119095721-119095810,chr8,119095721,119095810,IMR90|chr8:11722756-11722814,chr8,11722756,11722814,1,107372965
IMR90|chr8:119095727-119095877,chr8,119095727,119095877,IMR90|chr8:11722756-11722814,chr8,11722756,11722814,1,107372971
IMR90|chr8:119097500-119097562,chr8,119097500,119097562,IMR90|chr8:145015745-145015819,chr8,145015745,145015819,1,25918245
IMR90|chr8:119097501-119097562,chr8,119097501,119097562,IMR90|chr8:145015745-145015819,chr8,145015745,145015819,1,25918244
IMR90|chr8:119105721-119105818,chr8,119105721,119105818,IMR90|chr8:145032639-145032683,chr8,145032639,145032683,1,25926918
IMR90|chr8:119105721-119105817,chr8,119105721,119105817,IMR90|chr8:145032639-145032683,chr8,145032639,145032683,1,25926918
IMR90|chr8:119110852-119110937,chr8,119110852,119110937,IMR90|chr8:116680064-116680122,chr8,116680064,116680122,1,2430788
IMR90|chr8:119110852-119110935,chr8,119110852,119110935,IMR90|chr8:116680064-116680122,chr8,116680064,116680122,1,2430788
IMR90|chr8:119112405-119112503,chr8,119112405,119112503,IMR90|chr8:99055789-99055830,chr8,99055789,99055830,1,20056616
IMR90|chr8:119112405-119112494,chr8,119112405,119112494,IMR90|chr8:99055769-99055830,chr8,99055769,99055830,1,20056636
IMR90|chr8:123116155-123116258,chr8,123116155,123116258,IMR90|chr8:122652485-122652572,chr8,122652485,122652572,1,463670
IMR90|chr8:123116155-123116210,chr8,123116155,123116210,IMR90|chr8:122652485-122652572,chr8,122652485,122652572,1,463670
IMR90|chr8:124531739-124531790,chr8,124531739,124531790,IMR90|chr8:124290586-124290631,chr8,124290586,124290631,1,241153
IMR90|chr8:126083216-126083305,chr8,126083216,126083305,IMR90|chr8:12988548-12988585,chr8,12988548,12988585,1,113094668
IMR90|chr8:126083216-126083303,chr8,126083216,126083303,IMR90|chr8:12988548-12988585,chr8,12988548,12988585,1,113094668
IMR90|chr8:126197579-126197686,chr8,126197579,126197686,IMR90|chr8:94750990-94751018,chr8,94750990,94751018,1,31446589
IMR90|chr8:126197579-126197685,chr8,126197579,126197685,IMR90|chr8:94750990-94751018,chr8,94750990,94751018,1,31446589
IMR90|chr8:126197580-126197685,chr8,126197580,126197685,IMR90|chr8:94750991-94751018,chr8,94750991,94751018,1,31446589
IMR90|chr8:126232964-126233001,chr8,126232964,126233001,IMR90|chr8:119120476-119120575,chr8,119120476,119120575,1,7112488
IMR90|chr8:126234031-126234175,chr8,126234031,126234175,IMR90|chr8:119119067-119119104,chr8,119119067,119119104,1,7114964
IMR90|chr8:126234031-126234144,chr8,126234031,126234144,IMR90|chr8:119119067-119119104,chr8,119119067,119119104,1,7114964
IMR90|chr8:126306662-126306694,chr8,126306662,126306694,IMR90|chr8:126444064-126444140,chr8,126444064,126444140,1,137402
IMR90|chr8:128232630-128232679,chr8,128232630,128232679,IMR90|chr8:128749155-128749256,chr8,128749155,128749256,1,516525
IMR90|chr8:128232630-128232678,chr8,128232630,128232678,IMR90|chr8:128750375-128750511,chr8,128750375,128750511,1,517745
IMR90|chr8:128812864-128812921,chr8,128812864,128812921,IMR90|chr8:128749047-128749117,chr8,128749047,128749117,1,63817
IMR90|chr8:128816764-128816804,chr8,128816764,128816804,IMR90|chr8:128750209-128750291,chr8,128750209,128750291,1,66555
IMR90|chr8:128816764-128816781,chr8,128816764,128816781,IMR90|chr8:128750209-128750291,chr8,128750209,128750291,1,66555
IMR90|chr8:128823870-128823964,chr8,128823870,128823964,IMR90|chr8:128752276-128752359,chr8,128752276,128752359,1,71594
IMR90|chr8:128823870-128823937,chr8,128823870,128823937,IMR90|chr8:128752276-128752359,chr8,128752276,128752359,1,71594
IMR90|chr8:128824540-128824620,chr8,128824540,128824620,IMR90|chr8:131454436-131454491,chr8,131454436,131454491,1,2629896
IMR90|chr8:128827042-128827099,chr8,128827042,128827099,IMR90|chr8:62622780-62622828,chr8,62622780,62622828,1,66204262
IMR90|chr8:128844815-128844899,chr8,128844815,128844899,IMR90|chr8:62623145-62623179,chr8,62623145,62623179,1,66221670
IMR90|chr8:128862335-128862417,chr8,128862335,128862417,IMR90|chr8:131454443-131454546,chr8,131454443,131454546,1,2592108
IMR90|chr8:128862373-128862420,chr8,128862373,128862420,IMR90|chr8:131454443-131454546,chr8,131454443,131454546,1,2592070
IMR90|chr8:128888574-128888619,chr8,128888574,128888619,IMR90|chr8:128749485-128749534,chr8,128749485,128749534,1,139089
IMR90|chr8:128888574-128888606,chr8,128888574,128888606,IMR90|chr8:128749485-128749534,chr8,128749485,128749534,1,139089
IMR90|chr8:128905276-128905335,chr8,128905276,128905335,IMR90|chr8:124086055-124086205,chr8,124086055,124086205,1,4819221
IMR90|chr8:128914081-128914109,chr8,128914081,128914109,IMR90|chr8:128749052-128749084,chr8,128749052,128749084,1,165029
IMR90|chr8:128915737-128915794,chr8,128915737,128915794,IMR90|chr8:62626023-62626064,chr8,62626023,62626064,1,66289714
IMR90|chr8:128918321-128918344,chr8,128918321,128918344,IMR90|chr8:128751419-128751477,chr8,128751419,128751477,1,166902
IMR90|chr8:128920420-128920444,chr8,128920420,128920444,IMR90|chr8:124086297-124086336,chr8,124086297,124086336,1,4834123
IMR90|chr8:128928218-128928247,chr8,128928218,128928247,IMR90|chr8:145134262-145134359,chr8,145134262,145134359,1,16206044
IMR90|chr8:128938469-128938572,chr8,128938469,128938572,IMR90|chr8:128748976-128748998,chr8,128748976,128748998,1,189493
IMR90|chr8:129051457-129051505,chr8,129051457,129051505,IMR90|chr8:145154317-145154452,chr8,145154317,145154452,1,16102860
IMR90|chr8:129054209-129054288,chr8,129054209,129054288,IMR90|chr8:128749536-128749588,chr8,128749536,128749588,1,304673
IMR90|chr8:129068316-129068399,chr8,129068316,129068399,IMR90|chr8:66751025-66751080,chr8,66751025,66751080,1,62317291
IMR90|chr8:129068316-129068397,chr8,129068316,129068397,IMR90|chr8:66751025-66751080,chr8,66751025,66751080,1,62317291
IMR90|chr8:129073166-129073250,chr8,129073166,129073250,IMR90|chr8:144677083-144677170,chr8,144677083,144677170,1,15603917
IMR90|chr8:129078414-129078472,chr8,129078414,129078472,IMR90|chr8:128752070-128752131,chr8,128752070,128752131,1,326344
IMR90|chr8:129082712-129082734,chr8,129082712,129082734,IMR90|chr8:145155392-145155433,chr8,145155392,145155433,1,16072680
IMR90|chr8:129083796-129083850,chr8,129083796,129083850,IMR90|chr8:128749201-128749273,chr8,128749201,128749273,1,334595
IMR90|chr8:129104572-129104664,chr8,129104572,129104664,IMR90|chr8:144677146-144677229,chr8,144677146,144677229,1,15572574
IMR90|chr8:129104572-129104639,chr8,129104572,129104639,IMR90|chr8:144677146-144677229,chr8,144677146,144677229,1,15572574
IMR90|chr8:131222936-131223012,chr8,131222936,131223012,IMR90|chr8:90770863-90770931,chr8,90770863,90770931,1,40452073
IMR90|chr8:131222965-131223012,chr8,131222965,131223012,IMR90|chr8:90770863-90770931,chr8,90770863,90770931,1,40452102
IMR90|chr8:131226342-131226388,chr8,131226342,131226388,IMR90|chr8:25311907-25311967,chr8,25311907,25311967,1,105914435
IMR90|chr8:131267916-131267988,chr8,131267916,131267988,IMR90|chr8:62625926-62626015,chr8,62625926,62626015,1,68641990
IMR90|chr8:131267928-131267989,chr8,131267928,131267989,IMR90|chr8:62625926-62626015,chr8,62625926,62626015,1,68642002
IMR90|chr8:131292951-131292980,chr8,131292951,131292980,IMR90|chr8:25313800-25313896,chr8,25313800,25313896,1,105979151
IMR90|chr8:131305823-131305931,chr8,131305823,131305931,IMR90|chr8:144674754-144674796,chr8,144674754,144674796,1,13368931
IMR90|chr8:131306597-131306651,chr8,131306597,131306651,IMR90|chr8:62625800-62625862,chr8,62625800,62625862,1,68680797
IMR90|chr8:131306598-131306651,chr8,131306598,131306651,IMR90|chr8:62625800-62625862,chr8,62625800,62625862,1,68680798
IMR90|chr8:131308671-131308704,chr8,131308671,131308704,IMR90|chr8:90770608-90770754,chr8,90770608,90770754,1,40538063
IMR90|chr8:131342539-131342630,chr8,131342539,131342630,IMR90|chr8:25313763-25313786,chr8,25313763,25313786,1,106028776
IMR90|chr8:131345754-131345839,chr8,131345754,131345839,IMR90|chr8:144677257-144677303,chr8,144677257,144677303,1,13331503
IMR90|chr8:134543275-134543336,chr8,134543275,134543336,IMR90|chr8:145135839-145135910,chr8,145135839,145135910,1,10592564
IMR90|chr8:141186588-141186646,chr8,141186588,141186646,IMR90|chr8:119120054-119120089,chr8,119120054,119120089,1,22066534
IMR90|chr8:141632185-141632259,chr8,141632185,141632259,IMR90|chr8:141646071-141646142,chr8,141646071,141646142,1,13886
IMR90|chr8:141632187-141632259,chr8,141632187,141632259,IMR90|chr8:141646071-141646142,chr8,141646071,141646142,1,13884
IMR90|chr8:141634544-141634587,chr8,141634544,141634587,IMR90|chr8:141645800-141645881,chr8,141645800,141645881,1,11256
IMR90|chr8:141634544-141634586,chr8,141634544,141634586,IMR90|chr8:141645800-141645881,chr8,141645800,141645881,1,11256
IMR90|chr8:141855000-141855073,chr8,141855000,141855073,IMR90|chr8:107283278-107283347,chr8,107283278,107283347,1,34571722
IMR90|chr8:141855000-141855072,chr8,141855000,141855072,IMR90|chr8:107283278-107283346,chr8,107283278,107283346,1,34571722
IMR90|chr8:141883840-141883901,chr8,141883840,141883901,IMR90|chr8:142140923-142141012,chr8,142140923,142141012,1,257083
IMR90|chr8:141883841-141883899,chr8,141883841,141883899,IMR90|chr8:142140923-142141012,chr8,142140923,142141012,1,257082
IMR90|chr8:141887311-141887356,chr8,141887311,141887356,IMR90|chr8:103432963-103433020,chr8,103432963,103433020,1,38454348
IMR90|chr8:141887312-141887356,chr8,141887312,141887356,IMR90|chr8:103432963-103433020,chr8,103432963,103433020,1,38454349
IMR90|chr8:141887364-141887482,chr8,141887364,141887482,IMR90|chr8:142140408-142140496,chr8,142140408,142140496,1,253044
IMR90|chr8:141887364-141887426,chr8,141887364,141887426,IMR90|chr8:142140408-142140496,chr8,142140408,142140496,1,253044
IMR90|chr8:144577932-144578000,chr8,144577932,144578000,IMR90|chr8:11720751-11720821,chr8,11720751,11720821,1,132857181
IMR90|chr8:144577932-144577988,chr8,144577932,144577988,IMR90|chr8:11720751-11720832,chr8,11720751,11720832,1,132857181
IMR90|chr8:144577948-144578000,chr8,144577948,144578000,IMR90|chr8:11720751-11720832,chr8,11720751,11720832,1,132857197
IMR90|chr9:2812488-2812557,chr9,2812488,2812557,IMR90|chr9:33472794-33472845,chr9,33472794,33472845,1,30660306
IMR90|chr9:4232306-4232382,chr9,4232306,4232382,IMR90|chr9:16726467-16726498,chr9,16726467,16726498,1,12494161
IMR90|chr9:4232306-4232340,chr9,4232306,4232340,IMR90|chr9:16726467-16726498,chr9,16726467,16726498,1,12494161
IMR90|chr9:5621132-5621222,chr9,5621132,5621222,IMR90|chr9:5625286-5625350,chr9,5625286,5625350,1,4154
IMR90|chr9:5621136-5621222,chr9,5621136,5621222,IMR90|chr9:5625286-5625350,chr9,5625286,5625350,1,4150
IMR90|chr9:5622276-5622320,chr9,5622276,5622320,IMR90|chr9:5627773-5627879,chr9,5627773,5627879,1,5497
IMR90|chr9:5622279-5622369,chr9,5622279,5622369,IMR90|chr9:5627773-5627879,chr9,5627773,5627879,1,5494
IMR90|chr9:5622285-5622336,chr9,5622285,5622336,IMR90|chr9:5627780-5627879,chr9,5627780,5627879,1,5495
IMR90|chr9:15401591-15401638,chr9,15401591,15401638,IMR90|chr9:15422139-15422200,chr9,15422139,15422200,1,20548
IMR90|chr9:15401703-15401817,chr9,15401703,15401817,IMR90|chr9:15423590-15423626,chr9,15423590,15423626,1,21887
IMR90|chr9:15401748-15401817,chr9,15401748,15401817,IMR90|chr9:15423590-15423636,chr9,15423590,15423636,1,21842
IMR90|chr9:16517818-16517849,chr9,16517818,16517849,IMR90|chr9:19101781-19101913,chr9,19101781,19101913,1,2583963
IMR90|chr9:16517818-16517835,chr9,16517818,16517835,IMR90|chr9:19101781-19101913,chr9,19101781,19101913,1,2583963
IMR90|chr9:16518644-16518697,chr9,16518644,16518697,IMR90|chr9:127022740-127022839,chr9,127022740,127022839,1,110504096
IMR90|chr9:16518647-16518698,chr9,16518647,16518698,IMR90|chr9:127022740-127022839,chr9,127022740,127022839,1,110504093
IMR90|chr9:16535122-16535186,chr9,16535122,16535186,IMR90|chr9:80646786-80646875,chr9,80646786,80646875,1,64111664
IMR90|chr9:16535122-16535181,chr9,16535122,16535181,IMR90|chr9:80646786-80646875,chr9,80646786,80646875,1,64111664
IMR90|chr9:16535122-16535155,chr9,16535122,16535155,IMR90|chr9:80646786-80646875,chr9,80646786,80646875,1,64111664
IMR90|chr9:16570235-16570262,chr9,16570235,16570262,IMR90|chr9:127021908-127021981,chr9,127021908,127021981,1,110451673
IMR90|chr9:20566153-20566232,chr9,20566153,20566232,IMR90|chr9:35731829-35731864,chr9,35731829,35731864,1,15165676
IMR90|chr9:20566154-20566232,chr9,20566154,20566232,IMR90|chr9:35731829-35731864,chr9,35731829,35731864,1,15165675
IMR90|chr9:20567403-20567446,chr9,20567403,20567446,IMR90|chr9:35730327-35730390,chr9,35730327,35730390,1,15162924
IMR90|chr9:20567406-20567446,chr9,20567406,20567446,IMR90|chr9:35730327-35730390,chr9,35730327,35730390,1,15162921
IMR90|chr9:20684602-20684677,chr9,20684602,20684677,IMR90|chr9:5437369-5437450,chr9,5437369,5437450,1,15247233
IMR90|chr9:20690351-20690419,chr9,20690351,20690419,IMR90|chr9:5437369-5437450,chr9,5437369,5437450,1,15252982
IMR90|chr9:33122889-33122967,chr9,33122889,33122967,IMR90|chr9:131643377-131643448,chr9,131643377,131643448,1,98520488
IMR90|chr9:33122889-33122965,chr9,33122889,33122965,IMR90|chr9:131643377-131643448,chr9,131643377,131643448,1,98520488
IMR90|chr9:33491474-33491542,chr9,33491474,33491542,IMR90|chr9:33474422-33474487,chr9,33474422,33474487,1,17052
IMR90|chr9:33498985-33499060,chr9,33498985,33499060,IMR90|chr9:33474814-33474862,chr9,33474814,33474862,1,24171
IMR90|chr9:33498985-33499058,chr9,33498985,33499058,IMR90|chr9:33474814-33474862,chr9,33474814,33474862,1,24171
IMR90|chr9:33500511-33500615,chr9,33500511,33500615,IMR90|chr9:33474622-33474769,chr9,33474622,33474769,1,25889
IMR90|chr9:33506683-33506777,chr9,33506683,33506777,IMR90|chr9:33478139-33478195,chr9,33478139,33478195,1,28544
IMR90|chr9:33506733-33506778,chr9,33506733,33506778,IMR90|chr9:33478139-33478184,chr9,33478139,33478184,1,28594
IMR90|chr9:33507222-33507295,chr9,33507222,33507295,IMR90|chr9:75768744-75768772,chr9,75768744,75768772,1,42261522
IMR90|chr9:33507222-33507293,chr9,33507222,33507293,IMR90|chr9:75768744-75768772,chr9,75768744,75768772,1,42261522
IMR90|chr9:35515916-35515978,chr9,35515916,35515978,IMR90|chr9:35688097-35688176,chr9,35688097,35688176,1,172181
IMR90|chr9:35515916-35515976,chr9,35515916,35515976,IMR90|chr9:35688097-35688176,chr9,35688097,35688176,1,172181
IMR90|chr9:35947776-35947880,chr9,35947776,35947880,IMR90|chr9:35962460-35962533,chr9,35962460,35962533,1,14684
IMR90|chr9:35951547-35951658,chr9,35951547,35951658,IMR90|chr9:35961713-35961858,chr9,35961713,35961858,1,10166
IMR90|chr9:36028763-36028832,chr9,36028763,36028832,IMR90|chr9:35728149-35728174,chr9,35728149,35728174,1,300614
IMR90|chr9:36073660-36073714,chr9,36073660,36073714,IMR90|chr9:35729200-35729267,chr9,35729200,35729267,1,344460
IMR90|chr9:36073664-36073761,chr9,36073664,36073761,IMR90|chr9:35729200-35729267,chr9,35729200,35729267,1,344464
IMR90|chr9:37957235-37957320,chr9,37957235,37957320,IMR90|chr9:2843437-2843502,chr9,2843437,2843502,1,35113798
IMR90|chr9:37957238-37957320,chr9,37957238,37957320,IMR90|chr9:2843437-2843502,chr9,2843437,2843502,1,35113801
IMR90|chr9:37969972-37970081,chr9,37969972,37970081,IMR90|chr9:19375413-19375454,chr9,19375413,19375454,1,18594559
IMR90|chr9:37982369-37982413,chr9,37982369,37982413,IMR90|chr9:131445173-131445237,chr9,131445173,131445237,1,93462804
IMR90|chr9:37982370-37982413,chr9,37982370,37982413,IMR90|chr9:131445173-131445238,chr9,131445173,131445238,1,93462803
IMR90|chr9:38048385-38048465,chr9,38048385,38048465,IMR90|chr9:2843347-2843391,chr9,2843347,2843391,1,35205038
IMR90|chr9:38049849-38049999,chr9,38049849,38049999,IMR90|chr9:131440739-131440790,chr9,131440739,131440790,1,93390890
IMR90|chr9:42250986-42251101,chr9,42250986,42251101,IMR90|chr9:45442431-45442580,chr9,45442431,45442580,1,3191445
IMR90|chr9:42251158-42251275,chr9,42251158,42251275,IMR90|chr9:45442274-45442394,chr9,45442274,45442394,1,3191116
IMR90|chr9:42251158-42251268,chr9,42251158,42251268,IMR90|chr9:45442431-45442555,chr9,45442431,45442555,1,3191273
IMR90|chr9:42251158-42251260,chr9,42251158,42251260,IMR90|chr9:45442310-45442394,chr9,45442310,45442394,1,3191152
IMR90|chr9:66457902-66458049,chr9,66457902,66458049,IMR90|chr9:68409252-68409315,chr9,68409252,68409315,1,1951350
IMR90|chr9:66458026-66458108,chr9,66458026,66458108,IMR90|chr9:68409076-68409109,chr9,68409076,68409109,1,1951050
IMR90|chr9:67300464-67300556,chr9,67300464,67300556,IMR90|chr9:67336770-67336920,chr9,67336770,67336920,1,36306
IMR90|chr9:67301375-67301440,chr9,67301375,67301440,IMR90|chr9:67336493-67336600,chr9,67336493,67336600,1,35118
IMR90|chr9:68409477-68409592,chr9,68409477,68409592,IMR90|chr9:66454843-66454878,chr9,66454843,66454878,1,1954634
IMR90|chr9:68411065-68411150,chr9,68411065,68411150,IMR90|chr9:66455766-66455806,chr9,66455766,66455806,1,1955299
IMR90|chr9:68411362-68411388,chr9,68411362,68411388,IMR90|chr9:66455698-66455802,chr9,66455698,66455802,1,1955664
IMR90|chr9:68411584-68411610,chr9,68411584,68411610,IMR90|chr9:66455441-66455578,chr9,66455441,66455578,1,1956143
IMR90|chr9:68412380-68412530,chr9,68412380,68412530,IMR90|chr9:66454746-66454896,chr9,66454746,66454896,1,1957634
IMR90|chr9:68412381-68412531,chr9,68412381,68412531,IMR90|chr9:66454705-66454851,chr9,66454705,66454851,1,1957676
IMR90|chr9:68412384-68412534,chr9,68412384,68412534,IMR90|chr9:66454685-66454832,chr9,66454685,66454832,1,1957699
IMR90|chr9:68412392-68412542,chr9,68412392,68412542,IMR90|chr9:66454706-66454855,chr9,66454706,66454855,1,1957686
IMR90|chr9:68412408-68412558,chr9,68412408,68412558,IMR90|chr9:66454720-66454870,chr9,66454720,66454870,1,1957688
IMR90|chr9:68412410-68412560,chr9,68412410,68412560,IMR90|chr9:66454693-66454843,chr9,66454693,66454843,1,1957717
IMR90|chr9:68412410-68412559,chr9,68412410,68412559,IMR90|chr9:66454729-66454793,chr9,66454729,66454793,1,1957681
IMR90|chr9:68412413-68412563,chr9,68412413,68412563,IMR90|chr9:66454737-66454887,chr9,66454737,66454887,1,1957676
IMR90|chr9:68412413-68412562,chr9,68412413,68412562,IMR90|chr9:66454708-66454858,chr9,66454708,66454858,1,1957705
IMR90|chr9:68412413-68412561,chr9,68412413,68412561,IMR90|chr9:66454703-66454853,chr9,66454703,66454853,1,1957710
IMR90|chr9:68412414-68412561,chr9,68412414,68412561,IMR90|chr9:66454714-66454864,chr9,66454714,66454864,1,1957700
IMR90|chr9:68412415-68412565,chr9,68412415,68412565,IMR90|chr9:66454677-66454827,chr9,66454677,66454827,1,1957738
IMR90|chr9:68412421-68412570,chr9,68412421,68412570,IMR90|chr9:66454670-66454820,chr9,66454670,66454820,1,1957751
IMR90|chr9:68412423-68412561,chr9,68412423,68412561,IMR90|chr9:66454723-66454853,chr9,66454723,66454853,1,1957700
IMR90|chr9:68412424-68412574,chr9,68412424,68412574,IMR90|chr9:66454670-66454820,chr9,66454670,66454820,1,1957754
IMR90|chr9:68412424-68412573,chr9,68412424,68412573,IMR90|chr9:66454687-66454836,chr9,66454687,66454836,1,1957737
IMR90|chr9:68412428-68412578,chr9,68412428,68412578,IMR90|chr9:66454698-66454848,chr9,66454698,66454848,1,1957730
IMR90|chr9:68412429-68412579,chr9,68412429,68412579,IMR90|chr9:66454714-66454864,chr9,66454714,66454864,1,1957715
IMR90|chr9:68412430-68412580,chr9,68412430,68412580,IMR90|chr9:66454705-66454848,chr9,66454705,66454848,1,1957725
IMR90|chr9:68412435-68412541,chr9,68412435,68412541,IMR90|chr9:66454704-66454788,chr9,66454704,66454788,1,1957731
IMR90|chr9:68412441-68412591,chr9,68412441,68412591,IMR90|chr9:66454752-66454902,chr9,66454752,66454902,1,1957689
IMR90|chr9:68412449-68412598,chr9,68412449,68412598,IMR90|chr9:66454687-66454837,chr9,66454687,66454837,1,1957762
IMR90|chr9:68412463-68412613,chr9,68412463,68412613,IMR90|chr9:66454677-66454827,chr9,66454677,66454827,1,1957786
IMR90|chr9:68412470-68412620,chr9,68412470,68412620,IMR90|chr9:66454663-66454813,chr9,66454663,66454813,1,1957807
IMR90|chr9:68412471-68412590,chr9,68412471,68412590,IMR90|chr9:66454782-66454813,chr9,66454782,66454813,1,1957689
IMR90|chr9:68412478-68412619,chr9,68412478,68412619,IMR90|chr9:66454677-66454827,chr9,66454677,66454827,1,1957801
IMR90|chr9:68412502-68412652,chr9,68412502,68412652,IMR90|chr9:66454677-66454827,chr9,66454677,66454827,1,1957825
IMR90|chr9:68412502-68412644,chr9,68412502,68412644,IMR90|chr9:66454782-66454813,chr9,66454782,66454813,1,1957720
IMR90|chr9:68412504-68412652,chr9,68412504,68412652,IMR90|chr9:66454725-66454792,chr9,66454725,66454792,1,1957779
IMR90|chr9:68412506-68412656,chr9,68412506,68412656,IMR90|chr9:66454682-66454832,chr9,66454682,66454832,1,1957824
IMR90|chr9:68412509-68412659,chr9,68412509,68412659,IMR90|chr9:66454705-66454851,chr9,66454705,66454851,1,1957804
IMR90|chr9:68412512-68412662,chr9,68412512,68412662,IMR90|chr9:66454663-66454813,chr9,66454663,66454813,1,1957849
IMR90|chr9:68412516-68412662,chr9,68412516,68412662,IMR90|chr9:66454705-66454791,chr9,66454705,66454791,1,1957811
IMR90|chr9:68412555-68412652,chr9,68412555,68412652,IMR90|chr9:66454670-66454700,chr9,66454670,66454700,1,1957885
IMR90|chr9:68412557-68412706,chr9,68412557,68412706,IMR90|chr9:66454668-66454809,chr9,66454668,66454809,1,1957889
IMR90|chr9:68412576-68412725,chr9,68412576,68412725,IMR90|chr9:66454672-66454706,chr9,66454672,66454706,1,1957904
IMR90|chr9:68412627-68412671,chr9,68412627,68412671,IMR90|chr9:66454703-66454853,chr9,66454703,66454853,1,1957924
IMR90|chr9:68412712-68412752,chr9,68412712,68412752,IMR90|chr9:66454755-66454825,chr9,66454755,66454825,1,1957957
IMR90|chr9:68412757-68412807,chr9,68412757,68412807,IMR90|chr9:66454826-66454913,chr9,66454826,66454913,1,1957931
IMR90|chr9:68412759-68412835,chr9,68412759,68412835,IMR90|chr9:66455277-66455337,chr9,66455277,66455337,1,1957482
IMR90|chr9:68412760-68412835,chr9,68412760,68412835,IMR90|chr9:66455277-66455337,chr9,66455277,66455337,1,1957483
IMR90|chr9:68412785-68412807,chr9,68412785,68412807,IMR90|chr9:66454826-66454913,chr9,66454826,66454913,1,1957959
IMR90|chr9:68412790-68412848,chr9,68412790,68412848,IMR90|chr9:66455305-66455382,chr9,66455305,66455382,1,1957485
IMR90|chr9:68412790-68412847,chr9,68412790,68412847,IMR90|chr9:66455305-66455382,chr9,66455305,66455382,1,1957485
IMR90|chr9:68412826-68412877,chr9,68412826,68412877,IMR90|chr9:66455429-66455526,chr9,66455429,66455526,1,1957397
IMR90|chr9:68412829-68412877,chr9,68412829,68412877,IMR90|chr9:66455429-66455526,chr9,66455429,66455526,1,1957400
IMR90|chr9:68412896-68412975,chr9,68412896,68412975,IMR90|chr9:66454827-66454926,chr9,66454827,66454926,1,1958069
IMR90|chr9:68412925-68412976,chr9,68412925,68412976,IMR90|chr9:66454827-66454926,chr9,66454827,66454926,1,1958098
IMR90|chr9:68413231-68413259,chr9,68413231,68413259,IMR90|chr9:66455272-66455336,chr9,66455272,66455336,1,1957959
IMR90|chr9:68413832-68413877,chr9,68413832,68413877,IMR90|chr9:66454852-66454923,chr9,66454852,66454923,1,1958980
IMR90|chr9:68413833-68413877,chr9,68413833,68413877,IMR90|chr9:66454852-66454923,chr9,66454852,66454923,1,1958981
IMR90|chr9:68413849-68413939,chr9,68413849,68413939,IMR90|chr9:66454699-66454822,chr9,66454699,66454822,1,1959150
IMR90|chr9:68413912-68413939,chr9,68413912,68413939,IMR90|chr9:66454699-66454822,chr9,66454699,66454822,1,1959213
IMR90|chr9:68414067-68414151,chr9,68414067,68414151,IMR90|chr9:66454887-66454937,chr9,66454887,66454937,1,1959180
IMR90|chr9:68414797-68414907,chr9,68414797,68414907,IMR90|chr9:66454730-66454869,chr9,66454730,66454869,1,1960067
IMR90|chr9:68414879-68414931,chr9,68414879,68414931,IMR90|chr9:66454718-66454770,chr9,66454718,66454770,1,1960161
IMR90|chr9:71702155-71702273,chr9,71702155,71702273,IMR90|chr9:139688585-139688654,chr9,139688585,139688654,1,67986430
IMR90|chr9:71702155-71702236,chr9,71702155,71702236,IMR90|chr9:139688585-139688654,chr9,139688585,139688654,1,67986430
IMR90|chr9:72273712-72273739,chr9,72273712,72273739,IMR90|chr9:128511344-128511415,chr9,128511344,128511415,1,56237632
IMR90|chr9:72362879-72362929,chr9,72362879,72362929,IMR90|chr9:130212520-130212564,chr9,130212520,130212564,1,57849641
IMR90|chr9:72844059-72844134,chr9,72844059,72844134,IMR90|chr9:130855182-130855222,chr9,130855182,130855222,1,58011123
IMR90|chr9:72844059-72844133,chr9,72844059,72844133,IMR90|chr9:130855182-130855222,chr9,130855182,130855222,1,58011123
IMR90|chr9:74366547-74366581,chr9,74366547,74366581,IMR90|chr9:74979085-74979186,chr9,74979085,74979186,1,612538
IMR90|chr9:74366547-74366580,chr9,74366547,74366580,IMR90|chr9:74979085-74979186,chr9,74979085,74979186,1,612538
IMR90|chr9:82275833-82275870,chr9,82275833,82275870,IMR90|chr9:86594048-86594142,chr9,86594048,86594142,1,4318215
IMR90|chr9:84268262-84268337,chr9,84268262,84268337,IMR90|chr9:73025538-73025570,chr9,73025538,73025570,1,11242724
IMR90|chr9:84275696-84275796,chr9,84275696,84275796,IMR90|chr9:73029877-73029901,chr9,73029877,73029901,1,11245819
IMR90|chr9:84275697-84275796,chr9,84275697,84275796,IMR90|chr9:73029877-73029901,chr9,73029877,73029901,1,11245820
IMR90|chr9:86578852-86579002,chr9,86578852,86579002,IMR90|chr9:86576821-86576845,chr9,86576821,86576845,1,2031
IMR90|chr9:86578852-86578969,chr9,86578852,86578969,IMR90|chr9:86576003-86576035,chr9,86576003,86576035,1,2849
IMR90|chr9:86578852-86578967,chr9,86578852,86578967,IMR90|chr9:86576003-86576035,chr9,86576003,86576035,1,2849
IMR90|chr9:86578921-86579047,chr9,86578921,86579047,IMR90|chr9:86576821-86576845,chr9,86576821,86576845,1,2100
IMR90|chr9:90874621-90874751,chr9,90874621,90874751,IMR90|chr9:134613130-134613280,chr9,134613130,134613280,1,43738509
IMR90|chr9:90874621-90874749,chr9,90874621,90874749,IMR90|chr9:134613139-134613285,chr9,134613139,134613285,1,43738518
IMR90|chr9:91139528-91139660,chr9,91139528,91139660,IMR90|chr9:91145608-91145704,chr9,91145608,91145704,1,6080
IMR90|chr9:91139789-91139832,chr9,91139789,91139832,IMR90|chr9:91146084-91146157,chr9,91146084,91146157,1,6295
IMR90|chr9:91140088-91140131,chr9,91140088,91140131,IMR90|chr9:91148283-91148348,chr9,91148283,91148348,1,8195
IMR90|chr9:91140806-91140881,chr9,91140806,91140881,IMR90|chr9:91146100-91146175,chr9,91146100,91146175,1,5294
IMR90|chr9:91140864-91140980,chr9,91140864,91140980,IMR90|chr9:91149130-91149213,chr9,91149130,91149213,1,8266
IMR90|chr9:91141763-91141801,chr9,91141763,91141801,IMR90|chr9:91148626-91148701,chr9,91148626,91148701,1,6863
IMR90|chr9:91141922-91142021,chr9,91141922,91142021,IMR90|chr9:91146929-91146979,chr9,91146929,91146979,1,5007
IMR90|chr9:91142394-91142437,chr9,91142394,91142437,IMR90|chr9:91146231-91146318,chr9,91146231,91146318,1,3837
IMR90|chr9:91142401-91142468,chr9,91142401,91142468,IMR90|chr9:91146242-91146323,chr9,91146242,91146323,1,3841
IMR90|chr9:91142412-91142443,chr9,91142412,91142443,IMR90|chr9:91146199-91146318,chr9,91146199,91146318,1,3787
IMR90|chr9:91142414-91142480,chr9,91142414,91142480,IMR90|chr9:91146199-91146318,chr9,91146199,91146318,1,3785
IMR90|chr9:91142427-91142490,chr9,91142427,91142490,IMR90|chr9:91146223-91146298,chr9,91146223,91146298,1,3796
IMR90|chr9:91142427-91142489,chr9,91142427,91142489,IMR90|chr9:91146223-91146298,chr9,91146223,91146298,1,3796
IMR90|chr9:91142430-91142539,chr9,91142430,91142539,IMR90|chr9:91146192-91146271,chr9,91146192,91146271,1,3762
IMR90|chr9:91142436-91142450,chr9,91142436,91142450,IMR90|chr9:91146202-91146281,chr9,91146202,91146281,1,3766
IMR90|chr9:91142437-91142470,chr9,91142437,91142470,IMR90|chr9:91146268-91146293,chr9,91146268,91146293,1,3831
IMR90|chr9:91142437-91142465,chr9,91142437,91142465,IMR90|chr9:91146268-91146293,chr9,91146268,91146293,1,3831
IMR90|chr9:91142462-91142533,chr9,91142462,91142533,IMR90|chr9:91146202-91146281,chr9,91146202,91146281,1,3740
IMR90|chr9:91142468-91142539,chr9,91142468,91142539,IMR90|chr9:91146192-91146271,chr9,91146192,91146271,1,3724
IMR90|chr9:91142516-91142636,chr9,91142516,91142636,IMR90|chr9:91145785-91145864,chr9,91145785,91145864,1,3269
IMR90|chr9:91142540-91142649,chr9,91142540,91142649,IMR90|chr9:91145718-91145868,chr9,91145718,91145868,1,3178
IMR90|chr9:91142550-91142700,chr9,91142550,91142700,IMR90|chr9:91145703-91145772,chr9,91145703,91145772,1,3153
IMR90|chr9:91142550-91142695,chr9,91142550,91142695,IMR90|chr9:91145727-91145772,chr9,91145727,91145772,1,3177
IMR90|chr9:91142556-91142650,chr9,91142556,91142650,IMR90|chr9:91145674-91145766,chr9,91145674,91145766,1,3118
IMR90|chr9:91142556-91142633,chr9,91142556,91142633,IMR90|chr9:91145779-91145834,chr9,91145779,91145834,1,3223
IMR90|chr9:91142565-91142636,chr9,91142565,91142636,IMR90|chr9:91145785-91145864,chr9,91145785,91145864,1,3220
IMR90|chr9:91142644-91142725,chr9,91142644,91142725,IMR90|chr9:91145703-91145772,chr9,91145703,91145772,1,3059
IMR90|chr9:91142655-91142682,chr9,91142655,91142682,IMR90|chr9:91145744-91145848,chr9,91145744,91145848,1,3089
IMR90|chr9:91142664-91142734,chr9,91142664,91142734,IMR90|chr9:91145683-91145754,chr9,91145683,91145754,1,3019
IMR90|chr9:91142664-91142732,chr9,91142664,91142732,IMR90|chr9:91145677-91145754,chr9,91145677,91145754,1,3013
IMR90|chr9:91142729-91142787,chr9,91142729,91142787,IMR90|chr9:91145674-91145766,chr9,91145674,91145766,1,2945
IMR90|chr9:91142733-91142817,chr9,91142733,91142817,IMR90|chr9:91145608-91145700,chr9,91145608,91145700,1,2875
IMR90|chr9:91142733-91142791,chr9,91142733,91142791,IMR90|chr9:91145608-91145700,chr9,91145608,91145700,1,2875
IMR90|chr9:91142743-91142789,chr9,91142743,91142789,IMR90|chr9:91145592-91145700,chr9,91145592,91145700,1,2849
IMR90|chr9:91142743-91142785,chr9,91142743,91142785,IMR90|chr9:91145592-91145700,chr9,91145592,91145700,1,2849
IMR90|chr9:91142748-91142802,chr9,91142748,91142802,IMR90|chr9:91145539-91145685,chr9,91145539,91145685,1,2791
IMR90|chr9:91142775-91142895,chr9,91142775,91142895,IMR90|chr9:91145576-91145638,chr9,91145576,91145638,1,2801
IMR90|chr9:91142810-91142895,chr9,91142810,91142895,IMR90|chr9:91145576-91145638,chr9,91145576,91145638,1,2766
IMR90|chr9:91142900-91142939,chr9,91142900,91142939,IMR90|chr9:91145501-91145576,chr9,91145501,91145576,1,2601
IMR90|chr9:91142901-91142939,chr9,91142901,91142939,IMR90|chr9:91145501-91145576,chr9,91145501,91145576,1,2600
IMR90|chr9:91142985-91143053,chr9,91142985,91143053,IMR90|chr9:91149241-91149284,chr9,91149241,91149284,1,6256
IMR90|chr9:91143057-91143083,chr9,91143057,91143083,IMR90|chr9:91147157-91147241,chr9,91147157,91147241,1,4100
IMR90|chr9:91143058-91143083,chr9,91143058,91143083,IMR90|chr9:91147157-91147241,chr9,91147157,91147241,1,4099
IMR90|chr9:91143393-91143452,chr9,91143393,91143452,IMR90|chr9:91145342-91145438,chr9,91145342,91145438,1,1949
IMR90|chr9:91143398-91143452,chr9,91143398,91143452,IMR90|chr9:91145342-91145438,chr9,91145342,91145438,1,1944
IMR90|chr9:91144248-91144291,chr9,91144248,91144291,IMR90|chr9:91148998-91149091,chr9,91148998,91149091,1,4750
IMR90|chr9:91144498-91144577,chr9,91144498,91144577,IMR90|chr9:91148791-91148856,chr9,91148791,91148856,1,4293
IMR90|chr9:91717224-91717268,chr9,91717224,91717268,IMR90|chr9:91148863-91148923,chr9,91148863,91148923,1,568361
IMR90|chr9:91717224-91717264,chr9,91717224,91717264,IMR90|chr9:91148863-91148923,chr9,91148863,91148923,1,568361
IMR90|chr9:91725081-91725185,chr9,91725081,91725185,IMR90|chr9:91148582-91148668,chr9,91148582,91148668,1,576499
IMR90|chr9:91725121-91725185,chr9,91725121,91725185,IMR90|chr9:91148582-91148668,chr9,91148582,91148668,1,576539
IMR90|chr9:91761033-91761120,chr9,91761033,91761120,IMR90|chr9:140019898-140019961,chr9,140019898,140019961,1,48258865
IMR90|chr9:91761034-91761120,chr9,91761034,91761120,IMR90|chr9:140019898-140019970,chr9,140019898,140019970,1,48258864
IMR90|chr9:91761042-91761120,chr9,91761042,91761120,IMR90|chr9:140019898-140019970,chr9,140019898,140019970,1,48258856
IMR90|chr9:91761042-91761119,chr9,91761042,91761119,IMR90|chr9:140019897-140019970,chr9,140019897,140019970,1,48258855
IMR90|chr9:91768759-91768853,chr9,91768759,91768853,IMR90|chr9:91795652-91795708,chr9,91795652,91795708,1,26893
IMR90|chr9:91768759-91768850,chr9,91768759,91768850,IMR90|chr9:91795652-91795708,chr9,91795652,91795708,1,26893
IMR90|chr9:91768797-91768947,chr9,91768797,91768947,IMR90|chr9:91795652-91795708,chr9,91795652,91795708,1,26855
IMR90|chr9:94057934-94057987,chr9,94057934,94057987,IMR90|chr9:95054963-95055004,chr9,95054963,95055004,1,997029
IMR90|chr9:97776572-97776678,chr9,97776572,97776678,IMR90|chr9:124032754-124032797,chr9,124032754,124032797,1,26256182
IMR90|chr9:97776573-97776695,chr9,97776573,97776695,IMR90|chr9:124032754-124032797,chr9,124032754,124032797,1,26256181
IMR90|chr9:99246526-99246593,chr9,99246526,99246593,IMR90|chr9:131873294-131873356,chr9,131873294,131873356,1,32626768
IMR90|chr9:100980954-100981104,chr9,100980954,100981104,IMR90|chr9:100958650-100958676,chr9,100958650,100958676,1,22304
IMR90|chr9:100981009-100981133,chr9,100981009,100981133,IMR90|chr9:100958650-100958676,chr9,100958650,100958676,1,22359
IMR90|chr9:100982246-100982326,chr9,100982246,100982326,IMR90|chr9:100958516-100958582,chr9,100958516,100958582,1,23730
IMR90|chr9:100982246-100982323,chr9,100982246,100982323,IMR90|chr9:100958516-100958582,chr9,100958516,100958582,1,23730
IMR90|chr9:100985149-100985236,chr9,100985149,100985236,IMR90|chr9:114661033-114661091,chr9,114661033,114661091,1,13675884
IMR90|chr9:100988750-100988770,chr9,100988750,100988770,IMR90|chr9:114657733-114657883,chr9,114657733,114657883,1,13668983
IMR90|chr9:101005874-101005939,chr9,101005874,101005939,IMR90|chr9:100956454-100956516,chr9,100956454,100956516,1,49420
IMR90|chr9:101006441-101006517,chr9,101006441,101006517,IMR90|chr9:101471471-101471492,chr9,101471471,101471492,1,465030
IMR90|chr9:101099866-101099932,chr9,101099866,101099932,IMR90|chr9:101015787-101015833,chr9,101015787,101015833,1,84079
IMR90|chr9:101099866-101099931,chr9,101099866,101099931,IMR90|chr9:101015787-101015833,chr9,101015787,101015833,1,84079
IMR90|chr9:101120018-101120105,chr9,101120018,101120105,IMR90|chr9:101015793-101015828,chr9,101015793,101015828,1,104225
IMR90|chr9:102813777-102813842,chr9,102813777,102813842,IMR90|chr9:72658163-72658243,chr9,72658163,72658243,1,30155614
IMR90|chr9:107620669-107620715,chr9,107620669,107620715,IMR90|chr9:97769440-97769526,chr9,97769440,97769526,1,9851229
IMR90|chr9:107620669-107620714,chr9,107620669,107620714,IMR90|chr9:97769440-97769526,chr9,97769440,97769526,1,9851229
IMR90|chr9:111857294-111857335,chr9,111857294,111857335,IMR90|chr9:112888712-112888774,chr9,112888712,112888774,1,1031418
IMR90|chr9:111857294-111857334,chr9,111857294,111857334,IMR90|chr9:112888729-112888774,chr9,112888729,112888774,1,1031435
IMR90|chr9:111868029-111868071,chr9,111868029,111868071,IMR90|chr9:130660466-130660527,chr9,130660466,130660527,1,18792437
IMR90|chr9:112827204-112827318,chr9,112827204,112827318,IMR90|chr9:113796747-113796776,chr9,113796747,113796776,1,969543
IMR90|chr9:112828517-112828554,chr9,112828517,112828554,IMR90|chr9:113797821-113797917,chr9,113797821,113797917,1,969304
IMR90|chr9:112831448-112831544,chr9,112831448,112831544,IMR90|chr9:115094949-115095045,chr9,115094949,115095045,1,2263501
IMR90|chr9:112832893-112832946,chr9,112832893,112832946,IMR90|chr9:114662539-114662583,chr9,114662539,114662583,1,1829646
IMR90|chr9:112838454-112838530,chr9,112838454,112838530,IMR90|chr9:114663765-114663833,chr9,114663765,114663833,1,1825311
IMR90|chr9:112838455-112838530,chr9,112838455,112838530,IMR90|chr9:114663765-114663838,chr9,114663765,114663838,1,1825310
IMR90|chr9:112843111-112843154,chr9,112843111,112843154,IMR90|chr9:113798986-113799074,chr9,113798986,113799074,1,955875
IMR90|chr9:112843111-112843153,chr9,112843111,112843153,IMR90|chr9:113798986-113799074,chr9,113798986,113799074,1,955875
IMR90|chr9:112845500-112845528,chr9,112845500,112845528,IMR90|chr9:113017130-113017205,chr9,113017130,113017205,1,171630
IMR90|chr9:112860618-112860634,chr9,112860618,112860634,IMR90|chr9:113799743-113799797,chr9,113799743,113799797,1,939125
IMR90|chr9:112860626-112860666,chr9,112860626,112860666,IMR90|chr9:113799743-113799797,chr9,113799743,113799797,1,939117
IMR90|chr9:112860627-112860666,chr9,112860627,112860666,IMR90|chr9:113799743-113799797,chr9,113799743,113799797,1,939116
IMR90|chr9:112864796-112864883,chr9,112864796,112864883,IMR90|chr9:113796582-113796627,chr9,113796582,113796627,1,931786
IMR90|chr9:112864985-112865110,chr9,112864985,112865110,IMR90|chr9:114659877-114659902,chr9,114659877,114659902,1,1794892
IMR90|chr9:112865011-112865161,chr9,112865011,112865161,IMR90|chr9:114659877-114659902,chr9,114659877,114659902,1,1794866
IMR90|chr9:112865681-112865739,chr9,112865681,112865739,IMR90|chr9:113798230-113798289,chr9,113798230,113798289,1,932549
IMR90|chr9:112871407-112871500,chr9,112871407,112871500,IMR90|chr9:113016614-113016671,chr9,113016614,113016671,1,145207
IMR90|chr9:112871467-112871613,chr9,112871467,112871613,IMR90|chr9:113016614-113016671,chr9,113016614,113016671,1,145147
IMR90|chr9:112871535-112871613,chr9,112871535,112871613,IMR90|chr9:113016614-113016671,chr9,113016614,113016671,1,145079
IMR90|chr9:112872042-112872079,chr9,112872042,112872079,IMR90|chr9:113017098-113017153,chr9,113017098,113017153,1,145056
IMR90|chr9:112872042-112872076,chr9,112872042,112872076,IMR90|chr9:113017098-113017153,chr9,113017098,113017153,1,145056
IMR90|chr9:112935840-112935888,chr9,112935840,112935888,IMR90|chr9:100744638-100744704,chr9,100744638,100744704,1,12191202
IMR90|chr9:112938073-112938167,chr9,112938073,112938167,IMR90|chr9:79793971-79794027,chr9,79793971,79794027,1,33144102
IMR90|chr9:112938076-112938137,chr9,112938076,112938137,IMR90|chr9:79793964-79794030,chr9,79793964,79794030,1,33144112
IMR90|chr9:113670379-113670417,chr9,113670379,113670417,IMR90|chr9:114660155-114660230,chr9,114660155,114660230,1,989776
IMR90|chr9:113670382-113670439,chr9,113670382,113670439,IMR90|chr9:114660155-114660230,chr9,114660155,114660230,1,989773
IMR90|chr9:113690996-113691074,chr9,113690996,113691074,IMR90|chr9:137534391-137534463,chr9,137534391,137534463,1,23843395
IMR90|chr9:113690996-113691067,chr9,113690996,113691067,IMR90|chr9:137534388-137534460,chr9,137534388,137534460,1,23843392
IMR90|chr9:113711444-113711527,chr9,113711444,113711527,IMR90|chr9:114660351-114660383,chr9,114660351,114660383,1,948907
IMR90|chr9:113711444-113711525,chr9,113711444,113711525,IMR90|chr9:114660351-114660383,chr9,114660351,114660383,1,948907
IMR90|chr9:113773865-113773970,chr9,113773865,113773970,IMR90|chr9:113801149-113801178,chr9,113801149,113801178,1,27284
IMR90|chr9:113773900-113773970,chr9,113773900,113773970,IMR90|chr9:113800989-113801019,chr9,113800989,113801019,1,27089
IMR90|chr9:113773908-113773970,chr9,113773908,113773970,IMR90|chr9:113801149-113801192,chr9,113801149,113801192,1,27241
IMR90|chr9:113782962-113783042,chr9,113782962,113783042,IMR90|chr9:124034029-124034097,chr9,124034029,124034097,1,10251067
IMR90|chr9:113782964-113783042,chr9,113782964,113783042,IMR90|chr9:124034029-124034097,chr9,124034029,124034097,1,10251065
IMR90|chr9:114609704-114609777,chr9,114609704,114609777,IMR90|chr9:110046160-110046186,chr9,110046160,110046186,1,4563544
IMR90|chr9:114609704-114609775,chr9,114609704,114609775,IMR90|chr9:110046160-110046186,chr9,110046160,110046186,1,4563544
IMR90|chr9:114669072-114669169,chr9,114669072,114669169,IMR90|chr9:91792180-91792240,chr9,91792180,91792240,1,22876892
IMR90|chr9:114698226-114698316,chr9,114698226,114698316,IMR90|chr9:114663585-114663656,chr9,114663585,114663656,1,34641
IMR90|chr9:114698237-114698316,chr9,114698237,114698316,IMR90|chr9:114663585-114663656,chr9,114663585,114663656,1,34652
IMR90|chr9:114700145-114700218,chr9,114700145,114700218,IMR90|chr9:114660736-114660782,chr9,114660736,114660782,1,39409
IMR90|chr9:114702486-114702549,chr9,114702486,114702549,IMR90|chr9:114661284-114661312,chr9,114661284,114661312,1,41202
IMR90|chr9:114704545-114704625,chr9,114704545,114704625,IMR90|chr9:91791916-91792066,chr9,91791916,91792066,1,22912629
IMR90|chr9:114706721-114706759,chr9,114706721,114706759,IMR90|chr9:114659873-114659905,chr9,114659873,114659905,1,46848
IMR90|chr9:114710934-114710985,chr9,114710934,114710985,IMR90|chr9:114659873-114659905,chr9,114659873,114659905,1,51061
IMR90|chr9:115525678-115525706,chr9,115525678,115525706,IMR90|chr9:138986356-138986494,chr9,138986356,138986494,1,23460678
IMR90|chr9:116651206-116651284,chr9,116651206,116651284,IMR90|chr9:33020686-33020712,chr9,33020686,33020712,1,83630520
IMR90|chr9:118709060-118709079,chr9,118709060,118709079,IMR90|chr9:33022477-33022608,chr9,33022477,33022608,1,85686583
IMR90|chr9:118709062-118709154,chr9,118709062,118709154,IMR90|chr9:33022477-33022608,chr9,33022477,33022608,1,85686585
IMR90|chr9:118767009-118767049,chr9,118767009,118767049,IMR90|chr9:127021388-127021454,chr9,127021388,127021454,1,8254379
IMR90|chr9:118769429-118769456,chr9,118769429,118769456,IMR90|chr9:130342627-130342671,chr9,130342627,130342671,1,11573198
IMR90|chr9:118769646-118769744,chr9,118769646,118769744,IMR90|chr9:127024653-127024699,chr9,127024653,127024699,1,8255007
IMR90|chr9:118769655-118769801,chr9,118769655,118769801,IMR90|chr9:127024653-127024699,chr9,127024653,127024699,1,8254998
IMR90|chr9:118775132-118775166,chr9,118775132,118775166,IMR90|chr9:127021188-127021243,chr9,127021188,127021243,1,8246056
IMR90|chr9:118790051-118790134,chr9,118790051,118790134,IMR90|chr9:101017331-101017398,chr9,101017331,101017398,1,17772720
IMR90|chr9:118790051-118790129,chr9,118790051,118790129,IMR90|chr9:101017331-101017398,chr9,101017331,101017398,1,17772720
IMR90|chr9:118790063-118790208,chr9,118790063,118790208,IMR90|chr9:101017331-101017398,chr9,101017331,101017398,1,17772732
IMR90|chr9:118794427-118794496,chr9,118794427,118794496,IMR90|chr9:101016525-101016624,chr9,101016525,101016624,1,17777902
IMR90|chr9:118794449-118794497,chr9,118794449,118794497,IMR90|chr9:101016525-101016624,chr9,101016525,101016624,1,17777924
IMR90|chr9:119034984-119035021,chr9,119034984,119035021,IMR90|chr9:113016716-113016821,chr9,113016716,113016821,1,6018268
IMR90|chr9:119040270-119040354,chr9,119040270,119040354,IMR90|chr9:113017274-113017324,chr9,113017274,113017324,1,6022996
IMR90|chr9:119075839-119075886,chr9,119075839,119075886,IMR90|chr9:130342891-130342946,chr9,130342891,130342946,1,11267052
IMR90|chr9:119082474-119082531,chr9,119082474,119082531,IMR90|chr9:130328735-130328861,chr9,130328735,130328861,1,11246261
IMR90|chr9:119082474-119082498,chr9,119082474,119082498,IMR90|chr9:130328735-130328861,chr9,130328735,130328861,1,11246261
IMR90|chr9:124367326-124367399,chr9,124367326,124367399,IMR90|chr9:124032561-124032644,chr9,124032561,124032644,1,334765
IMR90|chr9:124367326-124367398,chr9,124367326,124367398,IMR90|chr9:124032560-124032638,chr9,124032560,124032638,1,334766
IMR90|chr9:124367332-124367399,chr9,124367332,124367399,IMR90|chr9:124032561-124032644,chr9,124032561,124032644,1,334771
IMR90|chr9:125122609-125122672,chr9,125122609,125122672,IMR90|chr9:125132357-125132414,chr9,125132357,125132414,1,9748
IMR90|chr9:125127562-125127712,chr9,125127562,125127712,IMR90|chr9:125129156-125129193,chr9,125129156,125129193,1,1594
IMR90|chr9:125127604-125127717,chr9,125127604,125127717,IMR90|chr9:125129156-125129193,chr9,125129156,125129193,1,1552
IMR90|chr9:125759693-125759712,chr9,125759693,125759712,IMR90|chr9:111881159-111881230,chr9,111881159,111881230,1,13878534
IMR90|chr9:127038046-127038078,chr9,127038046,127038078,IMR90|chr9:88357046-88357128,chr9,88357046,88357128,1,38681000
IMR90|chr9:127038047-127038078,chr9,127038047,127038078,IMR90|chr9:88357071-88357097,chr9,88357071,88357097,1,38680976
IMR90|chr9:127040741-127040848,chr9,127040741,127040848,IMR90|chr9:127178912-127178974,chr9,127178912,127178974,1,138171
IMR90|chr9:127040759-127040847,chr9,127040759,127040847,IMR90|chr9:127178912-127178974,chr9,127178912,127178974,1,138153
IMR90|chr9:127040761-127040847,chr9,127040761,127040847,IMR90|chr9:127178912-127178974,chr9,127178912,127178974,1,138151
IMR90|chr9:127116753-127116806,chr9,127116753,127116806,IMR90|chr9:127023840-127023910,chr9,127023840,127023910,1,92913
IMR90|chr9:127117865-127117917,chr9,127117865,127117917,IMR90|chr9:127020854-127020922,chr9,127020854,127020922,1,97011
IMR90|chr9:127117865-127117915,chr9,127117865,127117915,IMR90|chr9:127020854-127020922,chr9,127020854,127020922,1,97011
IMR90|chr9:127150052-127150076,chr9,127150052,127150076,IMR90|chr9:127021118-127021175,chr9,127021118,127021175,1,128934
IMR90|chr9:127156402-127156478,chr9,127156402,127156478,IMR90|chr9:127025079-127025118,chr9,127025079,127025118,1,131323
IMR90|chr9:127156404-127156478,chr9,127156404,127156478,IMR90|chr9:127025079-127025118,chr9,127025079,127025118,1,131325
IMR90|chr9:127159821-127159849,chr9,127159821,127159849,IMR90|chr9:33478333-33478417,chr9,33478333,33478417,1,93681488
IMR90|chr9:127927051-127927099,chr9,127927051,127927099,IMR90|chr9:127960671-127960714,chr9,127960671,127960714,1,33620
IMR90|chr9:127932506-127932524,chr9,127932506,127932524,IMR90|chr9:127960597-127960646,chr9,127960597,127960646,1,28091
IMR90|chr9:130258684-130258723,chr9,130258684,130258723,IMR90|chr9:130343323-130343426,chr9,130343323,130343426,1,84639
IMR90|chr9:130259898-130259966,chr9,130259898,130259966,IMR90|chr9:130696593-130696675,chr9,130696593,130696675,1,436695
IMR90|chr9:130259898-130259956,chr9,130259898,130259956,IMR90|chr9:130696675-130696764,chr9,130696675,130696764,1,436777
IMR90|chr9:130260327-130260402,chr9,130260327,130260402,IMR90|chr9:35070299-35070374,chr9,35070299,35070374,1,95190028
IMR90|chr9:130260342-130260379,chr9,130260342,130260379,IMR90|chr9:130341831-130341888,chr9,130341831,130341888,1,81489
IMR90|chr9:130262661-130262679,chr9,130262661,130262679,IMR90|chr9:130211324-130211442,chr9,130211324,130211442,1,51337
IMR90|chr9:130263942-130263994,chr9,130263942,130263994,IMR90|chr9:130858637-130858723,chr9,130858637,130858723,1,594695
IMR90|chr9:130264091-130264148,chr9,130264091,130264148,IMR90|chr9:130212187-130212337,chr9,130212187,130212337,1,51904
IMR90|chr9:130265925-130266022,chr9,130265925,130266022,IMR90|chr9:130213364-130213411,chr9,130213364,130213411,1,52561
IMR90|chr9:130265925-130265988,chr9,130265925,130265988,IMR90|chr9:130213364-130213411,chr9,130213364,130213411,1,52561
IMR90|chr9:130265927-130266077,chr9,130265927,130266077,IMR90|chr9:130213364-130213411,chr9,130213364,130213411,1,52563
IMR90|chr9:130266953-130267017,chr9,130266953,130267017,IMR90|chr9:130330288-130330374,chr9,130330288,130330374,1,63335
IMR90|chr9:130266954-130267077,chr9,130266954,130267077,IMR90|chr9:130330288-130330374,chr9,130330288,130330374,1,63334
IMR90|chr9:130293311-130293392,chr9,130293311,130293392,IMR90|chr9:130696745-130696764,chr9,130696745,130696764,1,403434
IMR90|chr9:130295375-130295433,chr9,130295375,130295433,IMR90|chr9:35083670-35083751,chr9,35083670,35083751,1,95211705
IMR90|chr9:130298541-130298649,chr9,130298541,130298649,IMR90|chr9:130375291-130375315,chr9,130375291,130375315,1,76750
IMR90|chr9:130298542-130298649,chr9,130298542,130298649,IMR90|chr9:130375291-130375315,chr9,130375291,130375315,1,76749
IMR90|chr9:130301484-130301533,chr9,130301484,130301533,IMR90|chr9:130699977-130700084,chr9,130699977,130700084,1,398493
IMR90|chr9:130301523-130301566,chr9,130301523,130301566,IMR90|chr9:130699977-130700084,chr9,130699977,130700084,1,398454
IMR90|chr9:130301758-130301838,chr9,130301758,130301838,IMR90|chr9:130343866-130343930,chr9,130343866,130343930,1,42108
IMR90|chr9:130302389-130302429,chr9,130302389,130302429,IMR90|chr9:130342513-130342605,chr9,130342513,130342605,1,40124
IMR90|chr9:130302390-130302429,chr9,130302390,130302429,IMR90|chr9:130342513-130342605,chr9,130342513,130342605,1,40123
IMR90|chr9:130305592-130305672,chr9,130305592,130305672,IMR90|chr9:130371914-130371972,chr9,130371914,130371972,1,66322
IMR90|chr9:130316859-130316964,chr9,130316859,130316964,IMR90|chr9:130345270-130345361,chr9,130345270,130345361,1,28411
IMR90|chr9:130316859-130316918,chr9,130316859,130316918,IMR90|chr9:130345270-130345361,chr9,130345270,130345361,1,28411
IMR90|chr9:130321068-130321131,chr9,130321068,130321131,IMR90|chr9:130859185-130859254,chr9,130859185,130859254,1,538117
IMR90|chr9:130324059-130324090,chr9,130324059,130324090,IMR90|chr9:130371670-130371816,chr9,130371670,130371816,1,47611
IMR90|chr9:130324974-130325070,chr9,130324974,130325070,IMR90|chr9:130344658-130344808,chr9,130344658,130344808,1,19684
IMR90|chr9:130346730-130346777,chr9,130346730,130346777,IMR90|chr9:130344837-130344907,chr9,130344837,130344907,1,1893
IMR90|chr9:130346775-130346894,chr9,130346775,130346894,IMR90|chr9:130345357-130345385,chr9,130345357,130345385,1,1418
IMR90|chr9:130346831-130346924,chr9,130346831,130346924,IMR90|chr9:130345559-130345709,chr9,130345559,130345709,1,1272
IMR90|chr9:130346874-130346933,chr9,130346874,130346933,IMR90|chr9:130345055-130345140,chr9,130345055,130345140,1,1819
IMR90|chr9:130346874-130346930,chr9,130346874,130346930,IMR90|chr9:130345055-130345140,chr9,130345055,130345140,1,1819
IMR90|chr9:130346883-130346938,chr9,130346883,130346938,IMR90|chr9:130345050-130345162,chr9,130345050,130345162,1,1833
IMR90|chr9:130346901-130346939,chr9,130346901,130346939,IMR90|chr9:130345050-130345162,chr9,130345050,130345162,1,1851
IMR90|chr9:130347664-130347753,chr9,130347664,130347753,IMR90|chr9:130346128-130346175,chr9,130346128,130346175,1,1536
IMR90|chr9:130347869-130347966,chr9,130347869,130347966,IMR90|chr9:130344733-130344817,chr9,130344733,130344817,1,3136
IMR90|chr9:130347898-130347996,chr9,130347898,130347996,IMR90|chr9:130344727-130344794,chr9,130344727,130344794,1,3171
IMR90|chr9:130347902-130348001,chr9,130347902,130348001,IMR90|chr9:130344727-130344787,chr9,130344727,130344787,1,3175
IMR90|chr9:130347902-130347991,chr9,130347902,130347991,IMR90|chr9:130344727-130344787,chr9,130344727,130344787,1,3175
IMR90|chr9:130347903-130348005,chr9,130347903,130348005,IMR90|chr9:130344661-130344791,chr9,130344661,130344791,1,3242
IMR90|chr9:130347905-130347988,chr9,130347905,130347988,IMR90|chr9:130344727-130344794,chr9,130344727,130344794,1,3178
IMR90|chr9:130347905-130347979,chr9,130347905,130347979,IMR90|chr9:130345701-130345747,chr9,130345701,130345747,1,2204
IMR90|chr9:130347909-130348012,chr9,130347909,130348012,IMR90|chr9:130344720-130344785,chr9,130344720,130344785,1,3189
IMR90|chr9:130347909-130347994,chr9,130347909,130347994,IMR90|chr9:130344720-130344785,chr9,130344720,130344785,1,3189
IMR90|chr9:130347909-130347971,chr9,130347909,130347971,IMR90|chr9:130344733-130344817,chr9,130344733,130344817,1,3176
IMR90|chr9:130348015-130348061,chr9,130348015,130348061,IMR90|chr9:130345584-130345689,chr9,130345584,130345689,1,2431
IMR90|chr9:130348016-130348061,chr9,130348016,130348061,IMR90|chr9:130345584-130345689,chr9,130345584,130345689,1,2432
IMR90|chr9:130348069-130348185,chr9,130348069,130348185,IMR90|chr9:130345277-130345421,chr9,130345277,130345421,1,2792
IMR90|chr9:130348071-130348192,chr9,130348071,130348192,IMR90|chr9:130344539-130344631,chr9,130344539,130344631,1,3532
IMR90|chr9:130348071-130348129,chr9,130348071,130348129,IMR90|chr9:130344539-130344631,chr9,130344539,130344631,1,3532
IMR90|chr9:130348085-130348174,chr9,130348085,130348174,IMR90|chr9:130344666-130344743,chr9,130344666,130344743,1,3419
IMR90|chr9:130348091-130348185,chr9,130348091,130348185,IMR90|chr9:130345277-130345371,chr9,130345277,130345371,1,2814
IMR90|chr9:130348101-130348174,chr9,130348101,130348174,IMR90|chr9:130344666-130344743,chr9,130344666,130344743,1,3435
IMR90|chr9:130348124-130348196,chr9,130348124,130348196,IMR90|chr9:130343653-130343740,chr9,130343653,130343740,1,4471
IMR90|chr9:130348133-130348196,chr9,130348133,130348196,IMR90|chr9:130343653-130343740,chr9,130343653,130343740,1,4480
IMR90|chr9:130348180-130348201,chr9,130348180,130348201,IMR90|chr9:130344667-130344817,chr9,130344667,130344817,1,3513
IMR90|chr9:130605319-130605409,chr9,130605319,130605409,IMR90|chr9:35730251-35730286,chr9,35730251,35730286,1,94875068
IMR90|chr9:130605322-130605409,chr9,130605322,130605409,IMR90|chr9:35730251-35730286,chr9,35730251,35730286,1,94875071
IMR90|chr9:132257615-132257637,chr9,132257615,132257637,IMR90|chr9:130635276-130635404,chr9,130635276,130635404,1,1622339
IMR90|chr9:132257616-132257653,chr9,132257616,132257653,IMR90|chr9:130635276-130635404,chr9,130635276,130635404,1,1622340
IMR90|chr9:132462531-132462581,chr9,132462531,132462581,IMR90|chr9:123881807-123881904,chr9,123881807,123881904,1,8580724
IMR90|chr9:132472948-132473002,chr9,132472948,132473002,IMR90|chr9:33022676-33022768,chr9,33022676,33022768,1,99450272
IMR90|chr9:132945406-132945426,chr9,132945406,132945426,IMR90|chr9:127022253-127022336,chr9,127022253,127022336,1,5923153
IMR90|chr9:132946957-132947013,chr9,132946957,132947013,IMR90|chr9:127022903-127023033,chr9,127022903,127023033,1,5924054
IMR90|chr9:133728702-133728753,chr9,133728702,133728753,IMR90|chr9:130694628-130694721,chr9,130694628,130694721,1,3034074
IMR90|chr9:134289056-134289158,chr9,134289056,134289158,IMR90|chr9:73034261-73034293,chr9,73034261,73034293,1,61254795
IMR90|chr9:134289056-134289148,chr9,134289056,134289148,IMR90|chr9:73034261-73034293,chr9,73034261,73034293,1,61254795
IMR90|chr9:136706184-136706208,chr9,136706184,136706208,IMR90|chr9:101015651-101015691,chr9,101015651,101015691,1,35690533
IMR90|chr10:363914-364016,chr10,363914,364016,IMR90|chr10:5727489-5727565,chr10,5727489,5727565,1,5363575
IMR90|chr10:363942-364016,chr10,363942,364016,IMR90|chr10:5727489-5727565,chr10,5727489,5727565,1,5363547
IMR90|chr10:363978-364016,chr10,363978,364016,IMR90|chr10:5727490-5727565,chr10,5727490,5727565,1,5363512
IMR90|chr10:586331-586400,chr10,586331,586400,IMR90|chr10:65276981-65277036,chr10,65276981,65277036,1,64690650
IMR90|chr10:3134219-3134318,chr10,3134219,3134318,IMR90|chr10:3825382-3825433,chr10,3825382,3825433,1,691163
IMR90|chr10:3134223-3134320,chr10,3134223,3134320,IMR90|chr10:3825382-3825433,chr10,3825382,3825433,1,691159
IMR90|chr10:3138618-3138684,chr10,3138618,3138684,IMR90|chr10:3824555-3824589,chr10,3824555,3824589,1,685937
IMR90|chr10:3138621-3138684,chr10,3138621,3138684,IMR90|chr10:3824555-3824589,chr10,3824555,3824589,1,685934
IMR90|chr10:3816859-3816885,chr10,3816859,3816885,IMR90|chr10:3825703-3825813,chr10,3825703,3825813,1,8844
IMR90|chr10:3817116-3817143,chr10,3817116,3817143,IMR90|chr10:3825407-3825477,chr10,3825407,3825477,1,8291
IMR90|chr10:3817146-3817291,chr10,3817146,3817291,IMR90|chr10:3825529-3825552,chr10,3825529,3825552,1,8383
IMR90|chr10:3817163-3817290,chr10,3817163,3817290,IMR90|chr10:3825529-3825552,chr10,3825529,3825552,1,8366
IMR90|chr10:6200682-6200757,chr10,6200682,6200757,IMR90|chr10:74117563-74117612,chr10,74117563,74117612,1,67916881
IMR90|chr10:6200682-6200756,chr10,6200682,6200756,IMR90|chr10:74117563-74117612,chr10,74117563,74117612,1,67916881
IMR90|chr10:7836851-7836979,chr10,7836851,7836979,IMR90|chr10:32343473-32343534,chr10,32343473,32343534,1,24506622
IMR90|chr10:7836851-7836940,chr10,7836851,7836940,IMR90|chr10:32343473-32343534,chr10,32343473,32343534,1,24506622
IMR90|chr10:7836851-7836939,chr10,7836851,7836939,IMR90|chr10:32343473-32343534,chr10,32343473,32343534,1,24506622
IMR90|chr10:13816418-13816527,chr10,13816418,13816527,IMR90|chr10:3826174-3826224,chr10,3826174,3826224,1,9990244
IMR90|chr10:13816433-13816527,chr10,13816433,13816527,IMR90|chr10:3826174-3826226,chr10,3826174,3826226,1,9990259
IMR90|chr10:13922145-13922233,chr10,13922145,13922233,IMR90|chr10:3826840-3826865,chr10,3826840,3826865,1,10095305
IMR90|chr10:13964976-13965077,chr10,13964976,13965077,IMR90|chr10:28823229-28823289,chr10,28823229,28823289,1,14858253
IMR90|chr10:13964976-13965076,chr10,13964976,13965076,IMR90|chr10:28823229-28823289,chr10,28823229,28823289,1,14858253
IMR90|chr10:13964976-13965066,chr10,13964976,13965066,IMR90|chr10:28823229-28823289,chr10,28823229,28823289,1,14858253
IMR90|chr10:13997065-13997105,chr10,13997065,13997105,IMR90|chr10:93169882-93169975,chr10,93169882,93169975,1,79172817
IMR90|chr10:29761320-29761385,chr10,29761320,29761385,IMR90|chr10:86088988-86089049,chr10,86088988,86089049,1,56327668
IMR90|chr10:31296071-31296137,chr10,31296071,31296137,IMR90|chr10:103872927-103872968,chr10,103872927,103872968,1,72576856
IMR90|chr10:33233752-33233835,chr10,33233752,33233835,IMR90|chr10:75169701-75169762,chr10,75169701,75169762,1,41935949
IMR90|chr10:33515617-33515673,chr10,33515617,33515673,IMR90|chr10:17273594-17273620,chr10,17273594,17273620,1,16242023
IMR90|chr10:33571916-33572066,chr10,33571916,33572066,IMR90|chr10:6187204-6187232,chr10,6187204,6187232,1,27384712
IMR90|chr10:33580134-33580171,chr10,33580134,33580171,IMR90|chr10:17271966-17272007,chr10,17271966,17272007,1,16308168
IMR90|chr10:33607388-33607486,chr10,33607388,33607486,IMR90|chr10:17272238-17272288,chr10,17272238,17272288,1,16335150
IMR90|chr10:33607388-33607479,chr10,33607388,33607479,IMR90|chr10:17272238-17272288,chr10,17272238,17272288,1,16335150
IMR90|chr10:33632935-33632990,chr10,33632935,33632990,IMR90|chr10:33628806-33628880,chr10,33628806,33628880,1,4129
IMR90|chr10:33633839-33633870,chr10,33633839,33633870,IMR90|chr10:33626831-33626927,chr10,33626831,33626927,1,7008
IMR90|chr10:33634089-33634166,chr10,33634089,33634166,IMR90|chr10:33626283-33626318,chr10,33626283,33626318,1,7806
IMR90|chr10:33636494-33636627,chr10,33636494,33636627,IMR90|chr10:33625498-33625515,chr10,33625498,33625515,1,10996
IMR90|chr10:35666042-35666058,chr10,35666042,35666058,IMR90|chr10:17275134-17275252,chr10,17275134,17275252,1,18390908
IMR90|chr10:47387624-47387701,chr10,47387624,47387701,IMR90|chr10:46915557-46915629,chr10,46915557,46915629,1,472067
IMR90|chr10:47395005-47395078,chr10,47395005,47395078,IMR90|chr10:46915562-46915639,chr10,46915562,46915639,1,479443
IMR90|chr10:49617346-49617378,chr10,49617346,49617378,IMR90|chr10:99257504-99257654,chr10,99257504,99257654,1,49640158
IMR90|chr10:49617347-49617378,chr10,49617347,49617378,IMR90|chr10:99257595-99257654,chr10,99257595,99257654,1,49640248
IMR90|chr10:49650987-49651059,chr10,49650987,49651059,IMR90|chr10:31609120-31609206,chr10,31609120,31609206,1,18041867
IMR90|chr10:49650995-49651059,chr10,49650995,49651059,IMR90|chr10:31609120-31609206,chr10,31609120,31609206,1,18041875
IMR90|chr10:52119031-52119095,chr10,52119031,52119095,IMR90|chr10:100206126-100206212,chr10,100206126,100206212,1,48087095
IMR90|chr10:60393977-60394127,chr10,60393977,60394127,IMR90|chr10:111766802-111766886,chr10,111766802,111766886,1,51372825
IMR90|chr10:60463120-60463211,chr10,60463120,60463211,IMR90|chr10:82216730-82216817,chr10,82216730,82216817,1,21753610
IMR90|chr10:60463121-60463167,chr10,60463121,60463167,IMR90|chr10:82216730-82216817,chr10,82216730,82216817,1,21753609
IMR90|chr10:63777388-63777427,chr10,63777388,63777427,IMR90|chr10:65276461-65276509,chr10,65276461,65276509,1,1499073
IMR90|chr10:63780932-63781008,chr10,63780932,63781008,IMR90|chr10:65276967-65277030,chr10,65276967,65277030,1,1496035
IMR90|chr10:63819756-63819830,chr10,63819756,63819830,IMR90|chr10:75675434-75675538,chr10,75675434,75675538,1,11855678
IMR90|chr10:63819757-63819830,chr10,63819757,63819830,IMR90|chr10:75675434-75675538,chr10,75675434,75675538,1,11855677
IMR90|chr10:63819787-63819833,chr10,63819787,63819833,IMR90|chr10:75675434-75675538,chr10,75675434,75675538,1,11855647
IMR90|chr10:63839324-63839367,chr10,63839324,63839367,IMR90|chr10:80830630-80830733,chr10,80830630,80830733,1,16991306
IMR90|chr10:63839441-63839495,chr10,63839441,63839495,IMR90|chr10:71896212-71896264,chr10,71896212,71896264,1,8056771
IMR90|chr10:63839441-63839494,chr10,63839441,63839494,IMR90|chr10:71896212-71896264,chr10,71896212,71896264,1,8056771
IMR90|chr10:65002036-65002056,chr10,65002036,65002056,IMR90|chr10:29699410-29699505,chr10,29699410,29699505,1,35302626
IMR90|chr10:65169691-65169748,chr10,65169691,65169748,IMR90|chr10:65281497-65281578,chr10,65281497,65281578,1,111806
IMR90|chr10:65169695-65169748,chr10,65169695,65169748,IMR90|chr10:65281497-65281566,chr10,65281497,65281566,1,111802
IMR90|chr10:65170680-65170769,chr10,65170680,65170769,IMR90|chr10:65276789-65276850,chr10,65276789,65276850,1,106109
IMR90|chr10:65174573-65174659,chr10,65174573,65174659,IMR90|chr10:65281497-65281603,chr10,65281497,65281603,1,106924
IMR90|chr10:65174577-65174659,chr10,65174577,65174659,IMR90|chr10:65281497-65281583,chr10,65281497,65281583,1,106920
IMR90|chr10:65174595-65174659,chr10,65174595,65174659,IMR90|chr10:65281497-65281583,chr10,65281497,65281583,1,106902
IMR90|chr10:65174615-65174659,chr10,65174615,65174659,IMR90|chr10:65281497-65281603,chr10,65281497,65281603,1,106882
IMR90|chr10:65195310-65195332,chr10,65195310,65195332,IMR90|chr10:65280776-65280878,chr10,65280776,65280878,1,85466
IMR90|chr10:65195417-65195510,chr10,65195417,65195510,IMR90|chr10:65277722-65277776,chr10,65277722,65277776,1,82305
IMR90|chr10:65195432-65195507,chr10,65195432,65195507,IMR90|chr10:65277728-65277782,chr10,65277728,65277782,1,82296
IMR90|chr10:65267166-65267208,chr10,65267166,65267208,IMR90|chr10:65277711-65277817,chr10,65277711,65277817,1,10545
IMR90|chr10:65267169-65267319,chr10,65267169,65267319,IMR90|chr10:65277711-65277817,chr10,65277711,65277817,1,10542
IMR90|chr10:65267296-65267395,chr10,65267296,65267395,IMR90|chr10:65276804-65276855,chr10,65276804,65276855,1,9508
IMR90|chr10:65267810-65267843,chr10,65267810,65267843,IMR90|chr10:65278270-65278384,chr10,65278270,65278384,1,10460
IMR90|chr10:65267811-65267843,chr10,65267811,65267843,IMR90|chr10:65278270-65278384,chr10,65278270,65278384,1,10459
IMR90|chr10:65268874-65268899,chr10,65268874,65268899,IMR90|chr10:65277233-65277278,chr10,65277233,65277278,1,8359
IMR90|chr10:65269296-65269372,chr10,65269296,65269372,IMR90|chr10:65276205-65276256,chr10,65276205,65276256,1,6909
IMR90|chr10:65270410-65270493,chr10,65270410,65270493,IMR90|chr10:65280290-65280339,chr10,65280290,65280339,1,9880
IMR90|chr10:65270858-65270903,chr10,65270858,65270903,IMR90|chr10:65279165-65279199,chr10,65279165,65279199,1,8307
IMR90|chr10:65270866-65270966,chr10,65270866,65270966,IMR90|chr10:65276458-65276483,chr10,65276458,65276483,1,5592
IMR90|chr10:65271296-65271441,chr10,65271296,65271441,IMR90|chr10:65277643-65277702,chr10,65277643,65277702,1,6347
IMR90|chr10:65271298-65271441,chr10,65271298,65271441,IMR90|chr10:65277638-65277704,chr10,65277638,65277704,1,6340
IMR90|chr10:65271300-65271446,chr10,65271300,65271446,IMR90|chr10:65276837-65276951,chr10,65276837,65276951,1,5537
IMR90|chr10:65271355-65271439,chr10,65271355,65271439,IMR90|chr10:65277638-65277704,chr10,65277638,65277704,1,6283
IMR90|chr10:65272452-65272530,chr10,65272452,65272530,IMR90|chr10:65277231-65277278,chr10,65277231,65277278,1,4779
IMR90|chr10:65272660-65272682,chr10,65272660,65272682,IMR90|chr10:65276789-65276850,chr10,65276789,65276850,1,4129
IMR90|chr10:65274451-65274527,chr10,65274451,65274527,IMR90|chr10:65279449-65279520,chr10,65279449,65279520,1,4998
IMR90|chr10:65275060-65275142,chr10,65275060,65275142,IMR90|chr10:65281341-65281409,chr10,65281341,65281409,1,6281
IMR90|chr10:65369131-65369257,chr10,65369131,65369257,IMR90|chr10:89100222-89100258,chr10,89100222,89100258,1,23731091
IMR90|chr10:65369131-65369221,chr10,65369131,65369221,IMR90|chr10:89100222-89100258,chr10,89100222,89100258,1,23731091
IMR90|chr10:65369145-65369228,chr10,65369145,65369228,IMR90|chr10:89100222-89100258,chr10,89100222,89100258,1,23731077
IMR90|chr10:65369228-65369257,chr10,65369228,65369257,IMR90|chr10:89100222-89100258,chr10,89100222,89100258,1,23730994
IMR90|chr10:74498516-74498600,chr10,74498516,74498600,IMR90|chr10:95240827-95240944,chr10,95240827,95240944,1,20742311
IMR90|chr10:74498516-74498598,chr10,74498516,74498598,IMR90|chr10:95240827-95240944,chr10,95240827,95240944,1,20742311
IMR90|chr10:75490425-75490572,chr10,75490425,75490572,IMR90|chr10:75503921-75503959,chr10,75503921,75503959,1,13496
IMR90|chr10:75490519-75490631,chr10,75490519,75490631,IMR90|chr10:75503921-75503959,chr10,75503921,75503959,1,13402
IMR90|chr10:75490532-75490631,chr10,75490532,75490631,IMR90|chr10:75503921-75503939,chr10,75503921,75503939,1,13389
IMR90|chr10:75774079-75774165,chr10,75774079,75774165,IMR90|chr10:75672459-75672589,chr10,75672459,75672589,1,101620
IMR90|chr10:75774079-75774156,chr10,75774079,75774156,IMR90|chr10:75672527-75672589,chr10,75672527,75672589,1,101552
IMR90|chr10:75775487-75775586,chr10,75775487,75775586,IMR90|chr10:82216961-82217104,chr10,82216961,82217104,1,6441474
IMR90|chr10:75783111-75783163,chr10,75783111,75783163,IMR90|chr10:105420480-105420569,chr10,105420480,105420569,1,29637369
IMR90|chr10:75787615-75787665,chr10,75787615,75787665,IMR90|chr10:75537840-75537926,chr10,75537840,75537926,1,249775
IMR90|chr10:75795546-75795598,chr10,75795546,75795598,IMR90|chr10:75539602-75539661,chr10,75539602,75539661,1,255944
IMR90|chr10:75806250-75806360,chr10,75806250,75806360,IMR90|chr10:82215037-82215065,chr10,82215037,82215065,1,6408787
IMR90|chr10:75806251-75806360,chr10,75806251,75806360,IMR90|chr10:82215037-82215065,chr10,82215037,82215065,1,6408786
IMR90|chr10:75808444-75808516,chr10,75808444,75808516,IMR90|chr10:75541118-75541181,chr10,75541118,75541181,1,267326
IMR90|chr10:75808444-75808515,chr10,75808444,75808515,IMR90|chr10:75541118-75541181,chr10,75541118,75541181,1,267326
IMR90|chr10:75816968-75816999,chr10,75816968,75816999,IMR90|chr10:75675850-75675928,chr10,75675850,75675928,1,141118
IMR90|chr10:75822146-75822192,chr10,75822146,75822192,IMR90|chr10:75672539-75672605,chr10,75672539,75672605,1,149607
IMR90|chr10:76646787-76646885,chr10,76646787,76646885,IMR90|chr10:69834107-69834140,chr10,69834107,69834140,1,6812680
IMR90|chr10:76646787-76646838,chr10,76646787,76646838,IMR90|chr10:69834103-69834140,chr10,69834103,69834140,1,6812684
IMR90|chr10:76646788-76646885,chr10,76646788,76646885,IMR90|chr10:69834107-69834140,chr10,69834107,69834140,1,6812681
IMR90|chr10:76960880-76960973,chr10,76960880,76960973,IMR90|chr10:76968473-76968525,chr10,76968473,76968525,1,7593
IMR90|chr10:76960952-76960973,chr10,76960952,76960973,IMR90|chr10:76968473-76968525,chr10,76968473,76968525,1,7521
IMR90|chr10:76961363-76961384,chr10,76961363,76961384,IMR90|chr10:76966477-76966616,chr10,76966477,76966616,1,5114
IMR90|chr10:76961401-76961499,chr10,76961401,76961499,IMR90|chr10:76967149-76967201,chr10,76967149,76967201,1,5748
IMR90|chr10:76961404-76961527,chr10,76961404,76961527,IMR90|chr10:76967149-76967201,chr10,76967149,76967201,1,5745
IMR90|chr10:76962443-76962538,chr10,76962443,76962538,IMR90|chr10:76966520-76966575,chr10,76966520,76966575,1,4077
IMR90|chr10:76963938-76964037,chr10,76963938,76964037,IMR90|chr10:76966758-76966826,chr10,76966758,76966826,1,2820
IMR90|chr10:79031102-79031198,chr10,79031102,79031198,IMR90|chr10:103876442-103876496,chr10,103876442,103876496,1,24845340
IMR90|chr10:79031123-79031198,chr10,79031123,79031198,IMR90|chr10:103876442-103876517,chr10,103876442,103876517,1,24845319
IMR90|chr10:79257201-79257249,chr10,79257201,79257249,IMR90|chr10:75760593-75760677,chr10,75760593,75760677,1,3496608
IMR90|chr10:79257215-79257249,chr10,79257215,79257249,IMR90|chr10:75760593-75760677,chr10,75760593,75760677,1,3496622
IMR90|chr10:79261693-79261779,chr10,79261693,79261779,IMR90|chr10:75764177-75764222,chr10,75764177,75764222,1,3497516
IMR90|chr10:80836288-80836340,chr10,80836288,80836340,IMR90|chr10:99183811-99183873,chr10,99183811,99183873,1,18347523
IMR90|chr10:80852750-80852772,chr10,80852750,80852772,IMR90|chr10:82215768-82215825,chr10,82215768,82215825,1,1363018
IMR90|chr10:80863417-80863564,chr10,80863417,80863564,IMR90|chr10:80828753-80828780,chr10,80828753,80828780,1,34664
IMR90|chr10:80863490-80863613,chr10,80863490,80863613,IMR90|chr10:80828753-80828780,chr10,80828753,80828780,1,34737
IMR90|chr10:80875367-80875445,chr10,80875367,80875445,IMR90|chr10:114712252-114712279,chr10,114712252,114712279,1,33836885
IMR90|chr10:80897676-80897721,chr10,80897676,80897721,IMR90|chr10:75255752-75255857,chr10,75255752,75255857,1,5641924
IMR90|chr10:80897677-80897761,chr10,80897677,80897761,IMR90|chr10:75255752-75255831,chr10,75255752,75255831,1,5641925
IMR90|chr10:80897678-80897761,chr10,80897678,80897761,IMR90|chr10:75255752-75255857,chr10,75255752,75255857,1,5641926
IMR90|chr10:80900526-80900638,chr10,80900526,80900638,IMR90|chr10:114713859-114713906,chr10,114713859,114713906,1,33813333
IMR90|chr10:80900536-80900638,chr10,80900536,80900638,IMR90|chr10:114713859-114713906,chr10,114713859,114713906,1,33813323
IMR90|chr10:80913540-80913605,chr10,80913540,80913605,IMR90|chr10:75006179-75006236,chr10,75006179,75006236,1,5907361
IMR90|chr10:80926671-80926717,chr10,80926671,80926717,IMR90|chr10:82215033-82215085,chr10,82215033,82215085,1,1288362
IMR90|chr10:80926673-80926717,chr10,80926673,80926717,IMR90|chr10:82215033-82215085,chr10,82215033,82215085,1,1288360
IMR90|chr10:81022896-81022994,chr10,81022896,81022994,IMR90|chr10:49733216-49733267,chr10,49733216,49733267,1,31289680
IMR90|chr10:81165110-81165182,chr10,81165110,81165182,IMR90|chr10:106094503-106094539,chr10,106094503,106094539,1,24929393
IMR90|chr10:81165110-81165181,chr10,81165110,81165181,IMR90|chr10:106094503-106094539,chr10,106094503,106094539,1,24929393
IMR90|chr10:81166083-81166142,chr10,81166083,81166142,IMR90|chr10:82215081-82215166,chr10,82215081,82215166,1,1048998
IMR90|chr10:81178387-81178452,chr10,81178387,81178452,IMR90|chr10:69834853-69834938,chr10,69834853,69834938,1,11343534
IMR90|chr10:81189040-81189097,chr10,81189040,81189097,IMR90|chr10:82216233-82216310,chr10,82216233,82216310,1,1027193
IMR90|chr10:81196498-81196527,chr10,81196498,81196527,IMR90|chr10:69834808-69834908,chr10,69834808,69834908,1,11361690
IMR90|chr10:81196499-81196527,chr10,81196499,81196527,IMR90|chr10:69834808-69834908,chr10,69834808,69834908,1,11361691
IMR90|chr10:86104491-86104552,chr10,86104491,86104552,IMR90|chr10:101416353-101416456,chr10,101416353,101416456,1,15311862
IMR90|chr10:86104491-86104538,chr10,86104491,86104538,IMR90|chr10:101416353-101416456,chr10,101416353,101416456,1,15311862
IMR90|chr10:86109221-86109282,chr10,86109221,86109282,IMR90|chr10:43277665-43277751,chr10,43277665,43277751,1,42831556
IMR90|chr10:86109253-86109378,chr10,86109253,86109378,IMR90|chr10:43277665-43277751,chr10,43277665,43277751,1,42831588
IMR90|chr10:86109268-86109378,chr10,86109268,86109378,IMR90|chr10:43277665-43277751,chr10,43277665,43277751,1,42831603
IMR90|chr10:88579456-88579555,chr10,88579456,88579555,IMR90|chr10:120839489-120839547,chr10,120839489,120839547,1,32260033
IMR90|chr10:88579463-88579555,chr10,88579463,88579555,IMR90|chr10:120839489-120839547,chr10,120839489,120839547,1,32260026
IMR90|chr10:89456126-89456158,chr10,89456126,89456158,IMR90|chr10:75763530-75763602,chr10,75763530,75763602,1,13692596
IMR90|chr10:89460274-89460373,chr10,89460274,89460373,IMR90|chr10:75760295-75760334,chr10,75760295,75760334,1,13699979
IMR90|chr10:92953623-92953708,chr10,92953623,92953708,IMR90|chr10:92975350-92975450,chr10,92975350,92975450,1,21727
IMR90|chr10:92953623-92953667,chr10,92953623,92953667,IMR90|chr10:92975350-92975450,chr10,92975350,92975450,1,21727
IMR90|chr10:92953748-92953789,chr10,92953748,92953789,IMR90|chr10:92978501-92978651,chr10,92978501,92978651,1,24753
IMR90|chr10:95138007-95138054,chr10,95138007,95138054,IMR90|chr10:70288107-70288174,chr10,70288107,70288174,1,24849900
IMR90|chr10:96999135-96999179,chr10,96999135,96999179,IMR90|chr10:51565404-51565463,chr10,51565404,51565463,1,45433731
IMR90|chr10:96999135-96999178,chr10,96999135,96999178,IMR90|chr10:51565404-51565511,chr10,51565404,51565511,1,45433731
IMR90|chr10:97007224-97007299,chr10,97007224,97007299,IMR90|chr10:95240498-95240560,chr10,95240498,95240560,1,1766726
IMR90|chr10:97007225-97007299,chr10,97007225,97007299,IMR90|chr10:95240498-95240560,chr10,95240498,95240560,1,1766727
IMR90|chr10:97028494-97028565,chr10,97028494,97028565,IMR90|chr10:75936711-75936790,chr10,75936711,75936790,1,21091783
IMR90|chr10:97037667-97037700,chr10,97037667,97037700,IMR90|chr10:95240685-95240766,chr10,95240685,95240766,1,1796982
IMR90|chr10:98604952-98604996,chr10,98604952,98604996,IMR90|chr10:116582551-116582602,chr10,116582551,116582602,1,17977599
IMR90|chr10:101697859-101697964,chr10,101697859,101697964,IMR90|chr10:133793768-133793808,chr10,133793768,133793808,1,32095909
IMR90|chr10:101697869-101698015,chr10,101697869,101698015,IMR90|chr10:133793768-133793808,chr10,133793768,133793808,1,32095899
IMR90|chr10:101697895-101698015,chr10,101697895,101698015,IMR90|chr10:133793768-133793808,chr10,133793768,133793808,1,32095873
IMR90|chr10:101702815-101702923,chr10,101702815,101702923,IMR90|chr10:95240201-95240297,chr10,95240201,95240297,1,6462614
IMR90|chr10:101724808-101724826,chr10,101724808,101724826,IMR90|chr10:43903223-43903314,chr10,43903223,43903314,1,57821585
IMR90|chr10:101724809-101724826,chr10,101724809,101724826,IMR90|chr10:43903223-43903314,chr10,43903223,43903314,1,57821586
IMR90|chr10:101755554-101755627,chr10,101755554,101755627,IMR90|chr10:102726079-102726152,chr10,102726079,102726152,1,970525
IMR90|chr10:101755563-101755628,chr10,101755563,101755628,IMR90|chr10:102726079-102726151,chr10,102726079,102726151,1,970516
IMR90|chr10:102700202-102700285,chr10,102700202,102700285,IMR90|chr10:103114510-103114566,chr10,103114510,103114566,1,414308
IMR90|chr10:102700203-102700300,chr10,102700203,102700300,IMR90|chr10:103114510-103114567,chr10,103114510,103114567,1,414307
IMR90|chr10:102700203-102700238,chr10,102700203,102700238,IMR90|chr10:103114510-103114567,chr10,103114510,103114567,1,414307
IMR90|chr10:103698297-103698358,chr10,103698297,103698358,IMR90|chr10:103600210-103600296,chr10,103600210,103600296,1,98087
IMR90|chr10:103698297-103698357,chr10,103698297,103698357,IMR90|chr10:103600210-103600296,chr10,103600210,103600296,1,98087
IMR90|chr10:104071602-104071666,chr10,104071602,104071666,IMR90|chr10:112680432-112680518,chr10,112680432,112680518,1,8608830
IMR90|chr10:104367535-104367622,chr10,104367535,104367622,IMR90|chr10:104206244-104206304,chr10,104206244,104206304,1,161291
IMR90|chr10:104388259-104388275,chr10,104388259,104388275,IMR90|chr10:104213330-104213348,chr10,104213330,104213348,1,174929
IMR90|chr10:104522930-104522998,chr10,104522930,104522998,IMR90|chr10:105430457-105430534,chr10,105430457,105430534,1,907527
IMR90|chr10:104522931-104522962,chr10,104522931,104522962,IMR90|chr10:105430457-105430534,chr10,105430457,105430534,1,907526
IMR90|chr10:104729420-104729567,chr10,104729420,104729567,IMR90|chr10:75672563-75672607,chr10,75672563,75672607,1,29056857
IMR90|chr10:104729420-104729473,chr10,104729420,104729473,IMR90|chr10:75672562-75672619,chr10,75672562,75672619,1,29056858
IMR90|chr10:105495936-105496015,chr10,105495936,105496015,IMR90|chr10:63812533-63812558,chr10,63812533,63812558,1,41683403
IMR90|chr10:105495937-105496015,chr10,105495937,105496015,IMR90|chr10:63812533-63812558,chr10,63812533,63812558,1,41683404
IMR90|chr10:111725021-111725094,chr10,111725021,111725094,IMR90|chr10:111763815-111763853,chr10,111763815,111763853,1,38794
IMR90|chr10:111725023-111725094,chr10,111725023,111725094,IMR90|chr10:111763815-111763853,chr10,111763815,111763853,1,38792
IMR90|chr10:111740223-111740274,chr10,111740223,111740274,IMR90|chr10:111760927-111760985,chr10,111760927,111760985,1,20704
IMR90|chr10:111750185-111750335,chr10,111750185,111750335,IMR90|chr10:111765169-111765231,chr10,111765169,111765231,1,14984
IMR90|chr10:111750295-111750383,chr10,111750295,111750383,IMR90|chr10:111765169-111765231,chr10,111765169,111765231,1,14874
IMR90|chr10:111753245-111753315,chr10,111753245,111753315,IMR90|chr10:111761693-111761723,chr10,111761693,111761723,1,8448
IMR90|chr10:111753245-111753283,chr10,111753245,111753283,IMR90|chr10:111761693-111761723,chr10,111761693,111761723,1,8448
IMR90|chr10:111753250-111753315,chr10,111753250,111753315,IMR90|chr10:111761693-111761723,chr10,111761693,111761723,1,8443
IMR90|chr10:111805470-111805540,chr10,111805470,111805540,IMR90|chr10:116521332-116521394,chr10,116521332,116521394,1,4715862
IMR90|chr10:112262781-112262909,chr10,112262781,112262909,IMR90|chr10:106095127-106095148,chr10,106095127,106095148,1,6167654
IMR90|chr10:112271966-112272080,chr10,112271966,112272080,IMR90|chr10:106097673-106097726,chr10,106097673,106097726,1,6174293
IMR90|chr10:112271966-112272063,chr10,112271966,112272063,IMR90|chr10:106097673-106097726,chr10,106097673,106097726,1,6174293
IMR90|chr10:112272285-112272383,chr10,112272285,112272383,IMR90|chr10:112260361-112260456,chr10,112260361,112260456,1,11924
IMR90|chr10:112272329-112272384,chr10,112272329,112272384,IMR90|chr10:112260361-112260456,chr10,112260361,112260456,1,11968
IMR90|chr10:112272884-112272945,chr10,112272884,112272945,IMR90|chr10:112259338-112259371,chr10,112259338,112259371,1,13546
IMR90|chr10:112273067-112273107,chr10,112273067,112273107,IMR90|chr10:112260177-112260230,chr10,112260177,112260230,1,12890
IMR90|chr10:112277823-112277872,chr10,112277823,112277872,IMR90|chr10:112260430-112260580,chr10,112260430,112260580,1,17393
IMR90|chr10:114471031-114471079,chr10,114471031,114471079,IMR90|chr10:104407518-104407563,chr10,104407518,104407563,1,10063513
IMR90|chr10:114471032-114471079,chr10,114471032,114471079,IMR90|chr10:104407518-104407563,chr10,104407518,104407563,1,10063514
IMR90|chr10:114782172-114782217,chr10,114782172,114782217,IMR90|chr10:112260076-112260149,chr10,112260076,112260149,1,2522096
IMR90|chr10:114782172-114782215,chr10,114782172,114782215,IMR90|chr10:112260076-112260149,chr10,112260076,112260149,1,2522096
IMR90|chr10:114844857-114844934,chr10,114844857,114844934,IMR90|chr10:116526288-116526343,chr10,116526288,116526343,1,1681431
IMR90|chr10:114844857-114844933,chr10,114844857,114844933,IMR90|chr10:116526288-116526343,chr10,116526288,116526343,1,1681431
IMR90|chr10:114844985-114845036,chr10,114844985,114845036,IMR90|chr10:94335595-94335660,chr10,94335595,94335660,1,20509390
IMR90|chr10:114844987-114845036,chr10,114844987,114845036,IMR90|chr10:94335595-94335660,chr10,94335595,94335660,1,20509392
IMR90|chr10:114844988-114845036,chr10,114844988,114845036,IMR90|chr10:94335595-94335660,chr10,94335595,94335660,1,20509393
IMR90|chr10:116388181-116388247,chr10,116388181,116388247,IMR90|chr10:116445941-116446080,chr10,116445941,116446080,1,57760
IMR90|chr10:116439026-116439095,chr10,116439026,116439095,IMR90|chr10:116523080-116523100,chr10,116523080,116523100,1,84054
IMR90|chr10:116453664-116453787,chr10,116453664,116453787,IMR90|chr10:116521039-116521143,chr10,116521039,116521143,1,67375
IMR90|chr10:116453741-116453787,chr10,116453741,116453787,IMR90|chr10:116521039-116521143,chr10,116521039,116521143,1,67298
IMR90|chr10:120975197-120975245,chr10,120975197,120975245,IMR90|chr10:103815779-103815877,chr10,103815779,103815877,1,17159418
IMR90|chr10:120975199-120975245,chr10,120975199,120975245,IMR90|chr10:103815779-103815877,chr10,103815779,103815877,1,17159420
IMR90|chr10:120979889-120979961,chr10,120979889,120979961,IMR90|chr10:121412203-121412259,chr10,121412203,121412259,1,432314
IMR90|chr10:120979892-120979961,chr10,120979892,120979961,IMR90|chr10:121412203-121412259,chr10,121412203,121412259,1,432311
IMR90|chr10:121012929-121012953,chr10,121012929,121012953,IMR90|chr10:80829992-80830104,chr10,80829992,80830104,1,40182937
IMR90|chr10:121082240-121082301,chr10,121082240,121082301,IMR90|chr10:121413336-121413407,chr10,121413336,121413407,1,331096
IMR90|chr10:121082241-121082300,chr10,121082241,121082300,IMR90|chr10:121413336-121413407,chr10,121413336,121413407,1,331095
IMR90|chr10:121091336-121091389,chr10,121091336,121091389,IMR90|chr10:15134765-15134797,chr10,15134765,15134797,1,105956571
IMR90|chr10:121100666-121100726,chr10,121100666,121100726,IMR90|chr10:121414915-121414978,chr10,121414915,121414978,1,314249
IMR90|chr10:121421507-121421566,chr10,121421507,121421566,IMR90|chr10:121358736-121358886,chr10,121358736,121358886,1,62771
IMR90|chr10:121431318-121431460,chr10,121431318,121431460,IMR90|chr10:121355813-121355834,chr10,121355813,121355834,1,75505
IMR90|chr10:121431327-121431456,chr10,121431327,121431456,IMR90|chr10:121355813-121355834,chr10,121355813,121355834,1,75514
IMR90|chr10:123904494-123904547,chr10,123904494,123904547,IMR90|chr10:33245401-33245551,chr10,33245401,33245551,1,90659093
IMR90|chr10:123904495-123904547,chr10,123904495,123904547,IMR90|chr10:33245401-33245551,chr10,33245401,33245551,1,90659094
IMR90|chr10:126653913-126653947,chr10,126653913,126653947,IMR90|chr10:98345769-98345885,chr10,98345769,98345885,1,28308144
IMR90|chr10:126653915-126653947,chr10,126653915,126653947,IMR90|chr10:98345769-98345885,chr10,98345769,98345885,1,28308146
IMR90|chr10:126773205-126773325,chr10,126773205,126773325,IMR90|chr10:127512503-127512533,chr10,127512503,127512533,1,739298
IMR90|chr10:126773208-126773325,chr10,126773208,126773325,IMR90|chr10:127512500-127512533,chr10,127512500,127512533,1,739292
IMR90|chr10:126774283-126774328,chr10,126774283,126774328,IMR90|chr10:104405254-104405324,chr10,104405254,104405324,1,22369029
IMR90|chr10:126782500-126782592,chr10,126782500,126782592,IMR90|chr10:104406586-104406639,chr10,104406586,104406639,1,22375914
IMR90|chr10:126782501-126782592,chr10,126782501,126782592,IMR90|chr10:104406586-104406639,chr10,104406586,104406639,1,22375915
IMR90|chr10:126790481-126790574,chr10,126790481,126790574,IMR90|chr10:104407227-104407251,chr10,104407227,104407251,1,22383254
IMR90|chr10:129207874-129208013,chr10,129207874,129208013,IMR90|chr10:124935125-124935165,chr10,124935125,124935165,1,4272749
IMR90|chr10:129207874-129207984,chr10,129207874,129207984,IMR90|chr10:124935125-124935165,chr10,124935125,124935165,1,4272749
IMR90|chr10:134325969-134326002,chr10,134325969,134326002,IMR90|chr10:134350281-134350420,chr10,134350281,134350420,1,24312
IMR90|chr10:134332252-134332304,chr10,134332252,134332304,IMR90|chr10:134347496-134347581,chr10,134347496,134347581,1,15244
IMR90|chr10:134332280-134332304,chr10,134332280,134332304,IMR90|chr10:134347496-134347582,chr10,134347496,134347582,1,15216
IMR90|chr10:134336392-134336439,chr10,134336392,134336439,IMR90|chr10:134348707-134348857,chr10,134348707,134348857,1,12315
IMR90|chr10:134336822-134336897,chr10,134336822,134336897,IMR90|chr10:134349283-134349304,chr10,134349283,134349304,1,12461
IMR90|chr10:134336822-134336883,chr10,134336822,134336883,IMR90|chr10:134349283-134349304,chr10,134349283,134349304,1,12461
IMR90|chr10:134342478-134342603,chr10,134342478,134342603,IMR90|chr10:134349635-134349784,chr10,134349635,134349784,1,7157
IMR90|chr11:3169009-3169113,chr11,3169009,3169113,IMR90|chr11:779257-779371,chr11,779257,779371,1,2389752
IMR90|chr11:3169086-3169113,chr11,3169086,3169113,IMR90|chr11:779257-779371,chr11,779257,779371,1,2389829
IMR90|chr11:3172138-3172214,chr11,3172138,3172214,IMR90|chr11:845127-845167,chr11,845127,845167,1,2327011
IMR90|chr11:3752217-3752274,chr11,3752217,3752274,IMR90|chr11:8705459-8705492,chr11,8705459,8705492,1,4953242
IMR90|chr11:3759557-3759662,chr11,3759557,3759662,IMR90|chr11:6626300-6626326,chr11,6626300,6626326,1,2866743
IMR90|chr11:9885280-9885315,chr11,9885280,9885315,IMR90|chr11:27720727-27720807,chr11,27720727,27720807,1,17835447
IMR90|chr11:9885282-9885313,chr11,9885282,9885313,IMR90|chr11:27720727-27720807,chr11,27720727,27720807,1,17835445
IMR90|chr11:9885282-9885312,chr11,9885282,9885312,IMR90|chr11:27720725-27720809,chr11,27720725,27720809,1,17835443
IMR90|chr11:10276051-10276086,chr11,10276051,10276086,IMR90|chr11:118479819-118479961,chr11,118479819,118479961,1,108203768
IMR90|chr11:11888776-11888808,chr11,11888776,11888808,IMR90|chr11:65684205-65684323,chr11,65684205,65684323,1,53795429
IMR90|chr11:11931576-11931622,chr11,11931576,11931622,IMR90|chr11:12133870-12133972,chr11,12133870,12133972,1,202294
IMR90|chr11:11931579-11931622,chr11,11931579,11931622,IMR90|chr11:12133870-12133972,chr11,12133870,12133972,1,202291
IMR90|chr11:11935769-11935804,chr11,11935769,11935804,IMR90|chr11:12136723-12136811,chr11,12136723,12136811,1,200954
IMR90|chr11:12005324-12005405,chr11,12005324,12005405,IMR90|chr11:3397448-3397508,chr11,3397448,3397508,1,8607876
IMR90|chr11:12149321-12149353,chr11,12149321,12149353,IMR90|chr11:35162256-35162369,chr11,35162256,35162369,1,23012935
IMR90|chr11:12149321-12149352,chr11,12149321,12149352,IMR90|chr11:35162255-35162369,chr11,35162255,35162369,1,23012934
IMR90|chr11:12149321-12149351,chr11,12149321,12149351,IMR90|chr11:35162256-35162369,chr11,35162256,35162369,1,23012935
IMR90|chr11:12165709-12165741,chr11,12165709,12165741,IMR90|chr11:12027864-12027978,chr11,12027864,12027978,1,137845
IMR90|chr11:12165710-12165770,chr11,12165710,12165770,IMR90|chr11:12027864-12027978,chr11,12027864,12027978,1,137846
IMR90|chr11:12167317-12167337,chr11,12167317,12167337,IMR90|chr11:12112181-12112288,chr11,12112181,12112288,1,55136
IMR90|chr11:12176307-12176342,chr11,12176307,12176342,IMR90|chr11:12699903-12699991,chr11,12699903,12699991,1,523596
IMR90|chr11:12177335-12177354,chr11,12177335,12177354,IMR90|chr11:12698840-12698931,chr11,12698840,12698931,1,521505
IMR90|chr11:12193916-12193936,chr11,12193916,12193936,IMR90|chr11:12028718-12028786,chr11,12028718,12028786,1,165198
IMR90|chr11:12195819-12195925,chr11,12195819,12195925,IMR90|chr11:12113017-12113063,chr11,12113017,12113063,1,82802
IMR90|chr11:12195819-12195910,chr11,12195819,12195910,IMR90|chr11:12113017-12113063,chr11,12113017,12113063,1,82802
IMR90|chr11:12197045-12197107,chr11,12197045,12197107,IMR90|chr11:65033840-65033882,chr11,65033840,65033882,1,52836795
IMR90|chr11:12239127-12239181,chr11,12239127,12239181,IMR90|chr11:12029101-12029184,chr11,12029101,12029184,1,210026
IMR90|chr11:12257600-12257639,chr11,12257600,12257639,IMR90|chr11:33278891-33278995,chr11,33278891,33278995,1,21021291
IMR90|chr11:12428247-12428374,chr11,12428247,12428374,IMR90|chr11:14378383-14378477,chr11,14378383,14378477,1,1950136
IMR90|chr11:12457475-12457562,chr11,12457475,12457562,IMR90|chr11:14376327-14376384,chr11,14376327,14376384,1,1918852
IMR90|chr11:12457479-12457559,chr11,12457479,12457559,IMR90|chr11:14376327-14376384,chr11,14376327,14376384,1,1918848
IMR90|chr11:12546010-12546089,chr11,12546010,12546089,IMR90|chr11:17230538-17230648,chr11,17230538,17230648,1,4684528
IMR90|chr11:12546010-12546050,chr11,12546010,12546050,IMR90|chr11:17230538-17230648,chr11,17230538,17230648,1,4684528
IMR90|chr11:12718331-12718385,chr11,12718331,12718385,IMR90|chr11:57547551-57547629,chr11,57547551,57547629,1,44829220
IMR90|chr11:12719226-12719257,chr11,12719226,12719257,IMR90|chr11:12134175-12134252,chr11,12134175,12134252,1,585051
IMR90|chr11:12721648-12721754,chr11,12721648,12721754,IMR90|chr11:71937960-71937997,chr11,71937960,71937997,1,59216312
IMR90|chr11:12721652-12721754,chr11,12721652,12721754,IMR90|chr11:71937960-71937999,chr11,71937960,71937999,1,59216308
IMR90|chr11:12723065-12723113,chr11,12723065,12723113,IMR90|chr11:12132502-12132572,chr11,12132502,12132572,1,590563
IMR90|chr11:12746572-12746634,chr11,12746572,12746634,IMR90|chr11:27719929-27719973,chr11,27719929,27719973,1,14973357
IMR90|chr11:12746784-12746882,chr11,12746784,12746882,IMR90|chr11:34074831-34074870,chr11,34074831,34074870,1,21328047
IMR90|chr11:12746784-12746881,chr11,12746784,12746881,IMR90|chr11:34074831-34074870,chr11,34074831,34074870,1,21328047
IMR90|chr11:12754462-12754526,chr11,12754462,12754526,IMR90|chr11:12135501-12135612,chr11,12135501,12135612,1,618961
IMR90|chr11:12754490-12754529,chr11,12754490,12754529,IMR90|chr11:12135501-12135612,chr11,12135501,12135612,1,618989
IMR90|chr11:12771996-12772055,chr11,12771996,12772055,IMR90|chr11:12137365-12137422,chr11,12137365,12137422,1,634631
IMR90|chr11:12772499-12772558,chr11,12772499,12772558,IMR90|chr11:10478587-10478643,chr11,10478587,10478643,1,2293912
IMR90|chr11:12788167-12788205,chr11,12788167,12788205,IMR90|chr11:57546947-57546977,chr11,57546947,57546977,1,44758780
IMR90|chr11:12792141-12792217,chr11,12792141,12792217,IMR90|chr11:71938800-71938865,chr11,71938800,71938865,1,59146659
IMR90|chr11:12794405-12794467,chr11,12794405,12794467,IMR90|chr11:27719801-27719842,chr11,27719801,27719842,1,14925396
IMR90|chr11:12794435-12794467,chr11,12794435,12794467,IMR90|chr11:27719801-27719842,chr11,27719801,27719842,1,14925366
IMR90|chr11:12802660-12802719,chr11,12802660,12802719,IMR90|chr11:12132680-12132750,chr11,12132680,12132750,1,669980
IMR90|chr11:12818813-12818870,chr11,12818813,12818870,IMR90|chr11:12136898-12136993,chr11,12136898,12136993,1,681915
IMR90|chr11:12820565-12820643,chr11,12820565,12820643,IMR90|chr11:85779100-85779172,chr11,85779100,85779172,1,72958535
IMR90|chr11:12820567-12820643,chr11,12820567,12820643,IMR90|chr11:85779100-85779172,chr11,85779100,85779172,1,72958533
IMR90|chr11:12846206-12846249,chr11,12846206,12846249,IMR90|chr11:12028946-12029016,chr11,12028946,12029016,1,817260
IMR90|chr11:12864165-12864217,chr11,12864165,12864217,IMR90|chr11:12133037-12133097,chr11,12133037,12133097,1,731128
IMR90|chr11:12888860-12888948,chr11,12888860,12888948,IMR90|chr11:12030325-12030352,chr11,12030325,12030352,1,858535
IMR90|chr11:12888863-12888948,chr11,12888863,12888948,IMR90|chr11:12030325-12030352,chr11,12030325,12030352,1,858538
IMR90|chr11:12890011-12890043,chr11,12890011,12890043,IMR90|chr11:12136524-12136604,chr11,12136524,12136604,1,753487
IMR90|chr11:12890446-12890509,chr11,12890446,12890509,IMR90|chr11:16761238-16761325,chr11,16761238,16761325,1,3870792
IMR90|chr11:12890450-12890509,chr11,12890450,12890509,IMR90|chr11:16761238-16761325,chr11,16761238,16761325,1,3870788
IMR90|chr11:12890450-12890508,chr11,12890450,12890508,IMR90|chr11:16761238-16761325,chr11,16761238,16761325,1,3870788
IMR90|chr11:12890450-12890507,chr11,12890450,12890507,IMR90|chr11:16761238-16761325,chr11,16761238,16761325,1,3870788
IMR90|chr11:12891522-12891579,chr11,12891522,12891579,IMR90|chr11:12134412-12134496,chr11,12134412,12134496,1,757110
IMR90|chr11:12893602-12893699,chr11,12893602,12893699,IMR90|chr11:85779038-85779091,chr11,85779038,85779091,1,72885436
IMR90|chr11:12911460-12911539,chr11,12911460,12911539,IMR90|chr11:65379576-65379664,chr11,65379576,65379664,1,52468116
IMR90|chr11:12911477-12911539,chr11,12911477,12911539,IMR90|chr11:65379576-65379664,chr11,65379576,65379664,1,52468099
IMR90|chr11:14312085-14312227,chr11,14312085,14312227,IMR90|chr11:35165826-35165869,chr11,35165826,35165869,1,20853741
IMR90|chr11:14312166-14312273,chr11,14312166,14312273,IMR90|chr11:35165826-35165869,chr11,35165826,35165869,1,20853660
IMR90|chr11:14327431-14327503,chr11,14327431,14327503,IMR90|chr11:35162436-35162474,chr11,35162436,35162474,1,20835005
IMR90|chr11:14353391-14353474,chr11,14353391,14353474,IMR90|chr11:18610090-18610117,chr11,18610090,18610117,1,4256699
IMR90|chr11:14353391-14353473,chr11,14353391,14353473,IMR90|chr11:18610090-18610117,chr11,18610090,18610117,1,4256699
IMR90|chr11:14353392-14353474,chr11,14353392,14353474,IMR90|chr11:18610090-18610117,chr11,18610090,18610117,1,4256698
IMR90|chr11:14397629-14397685,chr11,14397629,14397685,IMR90|chr11:14382792-14382852,chr11,14382792,14382852,1,14837
IMR90|chr11:14397647-14397793,chr11,14397647,14397793,IMR90|chr11:14382792-14382852,chr11,14382792,14382852,1,14855
IMR90|chr11:16196510-16196638,chr11,16196510,16196638,IMR90|chr11:47663577-47663623,chr11,47663577,47663623,1,31467067
IMR90|chr11:16196535-16196639,chr11,16196535,16196639,IMR90|chr11:47663577-47663623,chr11,47663577,47663623,1,31467042
IMR90|chr11:19620512-19620561,chr11,19620512,19620561,IMR90|chr11:124931611-124931712,chr11,124931611,124931712,1,105311099
IMR90|chr11:19620513-19620618,chr11,19620513,19620618,IMR90|chr11:124931611-124931712,chr11,124931611,124931712,1,105311098
IMR90|chr11:19827562-19827650,chr11,19827562,19827650,IMR90|chr11:34124818-34124880,chr11,34124818,34124880,1,14297256
IMR90|chr11:19827562-19827589,chr11,19827562,19827589,IMR90|chr11:34124818-34124880,chr11,34124818,34124880,1,14297256
IMR90|chr11:19827563-19827650,chr11,19827563,19827650,IMR90|chr11:34124818-34124880,chr11,34124818,34124880,1,14297255
IMR90|chr11:20005151-20005192,chr11,20005151,20005192,IMR90|chr11:27718789-27718876,chr11,27718789,27718876,1,7713638
IMR90|chr11:20010464-20010502,chr11,20010464,20010502,IMR90|chr11:27720859-27720896,chr11,27720859,27720896,1,7710395
IMR90|chr11:20010465-20010502,chr11,20010465,20010502,IMR90|chr11:27720859-27720896,chr11,27720859,27720896,1,7710394
IMR90|chr11:20012060-20012096,chr11,20012060,20012096,IMR90|chr11:27720581-27720655,chr11,27720581,27720655,1,7708521
IMR90|chr11:20078546-20078594,chr11,20078546,20078594,IMR90|chr11:65666583-65666710,chr11,65666583,65666710,1,45588037
IMR90|chr11:20078546-20078569,chr11,20078546,20078569,IMR90|chr11:65666583-65666710,chr11,65666583,65666710,1,45588037
IMR90|chr11:27711451-27711511,chr11,27711451,27711511,IMR90|chr11:13483943-13483996,chr11,13483943,13483996,1,14227508
IMR90|chr11:27711452-27711511,chr11,27711452,27711511,IMR90|chr11:13483943-13483996,chr11,13483943,13483996,1,14227509
IMR90|chr11:28587474-28587512,chr11,28587474,28587512,IMR90|chr11:70962007-70962117,chr11,70962007,70962117,1,42374533
IMR90|chr11:34089126-34089189,chr11,34089126,34089189,IMR90|chr11:34125170-34125257,chr11,34125170,34125257,1,36044
IMR90|chr11:34692934-34692983,chr11,34692934,34692983,IMR90|chr11:775131-775227,chr11,775131,775227,1,33917803
IMR90|chr11:34692948-34693098,chr11,34692948,34693098,IMR90|chr11:775131-775227,chr11,775131,775227,1,33917817
IMR90|chr11:34693068-34693098,chr11,34693068,34693098,IMR90|chr11:775175-775228,chr11,775175,775228,1,33917893
IMR90|chr11:35171967-35172011,chr11,35171967,35172011,IMR90|chr11:46303185-46303302,chr11,46303185,46303302,1,11131218
IMR90|chr11:35171982-35172011,chr11,35171982,35172011,IMR90|chr11:46303185-46303302,chr11,46303185,46303302,1,11131203
IMR90|chr11:35175802-35175842,chr11,35175802,35175842,IMR90|chr11:34127071-34127139,chr11,34127071,34127139,1,1048731
IMR90|chr11:35185856-35185891,chr11,35185856,35185891,IMR90|chr11:34125794-34125868,chr11,34125794,34125868,1,1060062
IMR90|chr11:35185858-35185891,chr11,35185858,35185891,IMR90|chr11:34125794-34125868,chr11,34125794,34125868,1,1060064
IMR90|chr11:35189342-35189368,chr11,35189342,35189368,IMR90|chr11:17095140-17095264,chr11,17095140,17095264,1,18094202
IMR90|chr11:35189345-35189368,chr11,35189345,35189368,IMR90|chr11:17095140-17095264,chr11,17095140,17095264,1,18094205
IMR90|chr11:35230136-35230220,chr11,35230136,35230220,IMR90|chr11:12111718-12111759,chr11,12111718,12111759,1,23118418
IMR90|chr11:35230136-35230218,chr11,35230136,35230218,IMR90|chr11:12111718-12111759,chr11,12111718,12111759,1,23118418
IMR90|chr11:35377806-35377828,chr11,35377806,35377828,IMR90|chr11:35161901-35161975,chr11,35161901,35161975,1,215905
IMR90|chr11:35396250-35396284,chr11,35396250,35396284,IMR90|chr11:35164845-35164932,chr11,35164845,35164932,1,231405
IMR90|chr11:35399218-35399304,chr11,35399218,35399304,IMR90|chr11:35164947-35165048,chr11,35164947,35165048,1,234271
IMR90|chr11:35399218-35399265,chr11,35399218,35399265,IMR90|chr11:35164947-35165048,chr11,35164947,35165048,1,234271
IMR90|chr11:35399218-35399254,chr11,35399218,35399254,IMR90|chr11:35164947-35165048,chr11,35164947,35165048,1,234271
IMR90|chr11:35559528-35559618,chr11,35559528,35559618,IMR90|chr11:35551001-35551079,chr11,35551001,35551079,1,8527
IMR90|chr11:35559547-35559619,chr11,35559547,35559619,IMR90|chr11:35551001-35551079,chr11,35551001,35551079,1,8546
IMR90|chr11:35561668-35561776,chr11,35561668,35561776,IMR90|chr11:35550076-35550126,chr11,35550076,35550126,1,11592
IMR90|chr11:35561726-35561776,chr11,35561726,35561776,IMR90|chr11:35550076-35550126,chr11,35550076,35550126,1,11650
IMR90|chr11:35575419-35575476,chr11,35575419,35575476,IMR90|chr11:35550445-35550527,chr11,35550445,35550527,1,24974
IMR90|chr11:43398129-43398171,chr11,43398129,43398171,IMR90|chr11:47194655-47194693,chr11,47194655,47194693,1,3796526
IMR90|chr11:43854883-43854977,chr11,43854883,43854977,IMR90|chr11:72462455-72462492,chr11,72462455,72462492,1,28607572
IMR90|chr11:43854884-43854977,chr11,43854884,43854977,IMR90|chr11:72462455-72462492,chr11,72462455,72462492,1,28607571
IMR90|chr11:46053923-46054037,chr11,46053923,46054037,IMR90|chr11:62311374-62311408,chr11,62311374,62311408,1,16257451
IMR90|chr11:46053927-46054030,chr11,46053927,46054030,IMR90|chr11:62311374-62311408,chr11,62311374,62311408,1,16257447
IMR90|chr11:46085811-46085838,chr11,46085811,46085838,IMR90|chr11:62312151-62312255,chr11,62312151,62312255,1,16226340
IMR90|chr11:46085812-46085838,chr11,46085812,46085838,IMR90|chr11:62312151-62312255,chr11,62312151,62312255,1,16226339
IMR90|chr11:46259218-46259324,chr11,46259218,46259324,IMR90|chr11:63607073-63607114,chr11,63607073,63607114,1,17347855
IMR90|chr11:46259218-46259321,chr11,46259218,46259321,IMR90|chr11:63607073-63607114,chr11,63607073,63607114,1,17347855
IMR90|chr11:46528540-46528640,chr11,46528540,46528640,IMR90|chr11:6627485-6627514,chr11,6627485,6627514,1,39901055
IMR90|chr11:46528546-46528640,chr11,46528546,46528640,IMR90|chr11:6627485-6627514,chr11,6627485,6627514,1,39901061
IMR90|chr11:46528548-46528640,chr11,46528548,46528640,IMR90|chr11:6627485-6627514,chr11,6627485,6627514,1,39901063
IMR90|chr11:47129500-47129555,chr11,47129500,47129555,IMR90|chr11:27721420-27721485,chr11,27721420,27721485,1,19408080
IMR90|chr11:47252586-47252657,chr11,47252586,47252657,IMR90|chr11:47195768-47195808,chr11,47195768,47195808,1,56818
IMR90|chr11:47252587-47252657,chr11,47252587,47252657,IMR90|chr11:47195768-47195808,chr11,47195768,47195808,1,56819
IMR90|chr11:47558473-47558535,chr11,47558473,47558535,IMR90|chr11:46613883-46613933,chr11,46613883,46613933,1,944590
IMR90|chr11:47558474-47558535,chr11,47558474,47558535,IMR90|chr11:46613883-46613933,chr11,46613883,46613933,1,944591
IMR90|chr11:47558474-47558534,chr11,47558474,47558534,IMR90|chr11:46613883-46613933,chr11,46613883,46613933,1,944591
IMR90|chr11:47629736-47629769,chr11,47629736,47629769,IMR90|chr11:47619591-47619626,chr11,47619591,47619626,1,10145
IMR90|chr11:47631706-47631776,chr11,47631706,47631776,IMR90|chr11:47619591-47619626,chr11,47619591,47619626,1,12115
IMR90|chr11:47632987-47633039,chr11,47632987,47633039,IMR90|chr11:47618216-47618332,chr11,47618216,47618332,1,14771
IMR90|chr11:58396328-58396417,chr11,58396328,58396417,IMR90|chr11:18547863-18547934,chr11,18547863,18547934,1,39848465
IMR90|chr11:58396338-58396417,chr11,58396338,58396417,IMR90|chr11:18547863-18547934,chr11,18547863,18547934,1,39848475
IMR90|chr11:61203064-61203160,chr11,61203064,61203160,IMR90|chr11:62311246-62311332,chr11,62311246,62311332,1,1108182
IMR90|chr11:61203103-61203161,chr11,61203103,61203161,IMR90|chr11:62311246-62311332,chr11,62311246,62311332,1,1108143
IMR90|chr11:61207819-61207903,chr11,61207819,61207903,IMR90|chr11:62325322-62325388,chr11,62325322,62325388,1,1117503
IMR90|chr11:61207820-61207970,chr11,61207820,61207970,IMR90|chr11:62325322-62325388,chr11,62325322,62325388,1,1117502
IMR90|chr11:61209428-61209482,chr11,61209428,61209482,IMR90|chr11:61351759-61351836,chr11,61351759,61351836,1,142331
IMR90|chr11:64092735-64092803,chr11,64092735,64092803,IMR90|chr11:64105810-64105846,chr11,64105810,64105846,1,13075
IMR90|chr11:64094955-64095008,chr11,64094955,64095008,IMR90|chr11:64105810-64105839,chr11,64105810,64105839,1,10855
IMR90|chr11:64094974-64095006,chr11,64094974,64095006,IMR90|chr11:64106440-64106524,chr11,64106440,64106524,1,11466
IMR90|chr11:65072534-65072567,chr11,65072534,65072567,IMR90|chr11:65079463-65079580,chr11,65079463,65079580,1,6929
IMR90|chr11:65073021-65073171,chr11,65073021,65073171,IMR90|chr11:65080649-65080715,chr11,65080649,65080715,1,7628
IMR90|chr11:65190268-65190348,chr11,65190268,65190348,IMR90|chr11:62494832-62494873,chr11,62494832,62494873,1,2695436
IMR90|chr11:65190270-65190348,chr11,65190270,65190348,IMR90|chr11:62494832-62494873,chr11,62494832,62494873,1,2695438
IMR90|chr11:65190288-65190355,chr11,65190288,65190355,IMR90|chr11:36531846-36531864,chr11,36531846,36531864,1,28658442
IMR90|chr11:65190319-65190431,chr11,65190319,65190431,IMR90|chr11:65664574-65664628,chr11,65664574,65664628,1,474255
IMR90|chr11:65190319-65190377,chr11,65190319,65190377,IMR90|chr11:65664574-65664628,chr11,65664574,65664628,1,474255
IMR90|chr11:65190325-65190431,chr11,65190325,65190431,IMR90|chr11:65664572-65664600,chr11,65664572,65664600,1,474247
IMR90|chr11:65190327-65190431,chr11,65190327,65190431,IMR90|chr11:65664572-65664600,chr11,65664572,65664600,1,474245
IMR90|chr11:65190383-65190423,chr11,65190383,65190423,IMR90|chr11:65345677-65345789,chr11,65345677,65345789,1,155294
IMR90|chr11:65190385-65190423,chr11,65190385,65190423,IMR90|chr11:65345677-65345789,chr11,65345677,65345789,1,155292
IMR90|chr11:65190423-65190457,chr11,65190423,65190457,IMR90|chr11:120207293-120207386,chr11,120207293,120207386,1,55016870
IMR90|chr11:65190528-65190651,chr11,65190528,65190651,IMR90|chr11:708444-708471,chr11,708444,708471,1,64482084
IMR90|chr11:65190620-65190709,chr11,65190620,65190709,IMR90|chr11:65664002-65664036,chr11,65664002,65664036,1,473382
IMR90|chr11:65190651-65190712,chr11,65190651,65190712,IMR90|chr11:64847567-64847644,chr11,64847567,64847644,1,343084
IMR90|chr11:65190652-65190712,chr11,65190652,65190712,IMR90|chr11:64847567-64847644,chr11,64847567,64847644,1,343085
IMR90|chr11:65190677-65190729,chr11,65190677,65190729,IMR90|chr11:834829-834887,chr11,834829,834887,1,64355848
IMR90|chr11:65190678-65190729,chr11,65190678,65190729,IMR90|chr11:834829-834887,chr11,834829,834887,1,64355849
IMR90|chr11:65190685-65190724,chr11,65190685,65190724,IMR90|chr11:57547806-57547849,chr11,57547806,57547849,1,7642879
IMR90|chr11:65190718-65190814,chr11,65190718,65190814,IMR90|chr11:65102565-65102605,chr11,65102565,65102605,1,88153
IMR90|chr11:65191024-65191084,chr11,65191024,65191084,IMR90|chr11:67008331-67008400,chr11,67008331,67008400,1,1817307
IMR90|chr11:65191076-65191138,chr11,65191076,65191138,IMR90|chr11:64945341-64945408,chr11,64945341,64945408,1,245735
IMR90|chr11:65191088-65191176,chr11,65191088,65191176,IMR90|chr11:846431-846482,chr11,846431,846482,1,64344657
IMR90|chr11:65191089-65191176,chr11,65191089,65191176,IMR90|chr11:846431-846482,chr11,846431,846482,1,64344658
IMR90|chr11:65191109-65191137,chr11,65191109,65191137,IMR90|chr11:65217693-65217778,chr11,65217693,65217778,1,26584
IMR90|chr11:65191261-65191323,chr11,65191261,65191323,IMR90|chr11:65664759-65664778,chr11,65664759,65664778,1,473498
IMR90|chr11:65191269-65191322,chr11,65191269,65191322,IMR90|chr11:844036-844057,chr11,844036,844057,1,64347233
IMR90|chr11:65191269-65191321,chr11,65191269,65191321,IMR90|chr11:843952-844005,chr11,843952,844005,1,64347317
IMR90|chr11:65191270-65191384,chr11,65191270,65191384,IMR90|chr11:65839232-65839252,chr11,65839232,65839252,1,647962
IMR90|chr11:65191286-65191398,chr11,65191286,65191398,IMR90|chr11:67138101-67138178,chr11,67138101,67138178,1,1946815
IMR90|chr11:65191327-65191400,chr11,65191327,65191400,IMR90|chr11:67138101-67138178,chr11,67138101,67138178,1,1946774
IMR90|chr11:65191463-65191523,chr11,65191463,65191523,IMR90|chr11:85779163-85779223,chr11,85779163,85779223,1,20587700
IMR90|chr11:65191493-65191607,chr11,65191493,65191607,IMR90|chr11:64692810-64692843,chr11,64692810,64692843,1,498683
IMR90|chr11:65191496-65191607,chr11,65191496,65191607,IMR90|chr11:64692810-64692843,chr11,64692810,64692843,1,498686
IMR90|chr11:65191577-65191625,chr11,65191577,65191625,IMR90|chr11:67139054-67139132,chr11,67139054,67139132,1,1947477
IMR90|chr11:65191577-65191624,chr11,65191577,65191624,IMR90|chr11:67139054-67139132,chr11,67139054,67139132,1,1947477
IMR90|chr11:65191650-65191682,chr11,65191650,65191682,IMR90|chr11:845452-845559,chr11,845452,845559,1,64346198
IMR90|chr11:65191669-65191751,chr11,65191669,65191751,IMR90|chr11:64849496-64849553,chr11,64849496,64849553,1,342173
IMR90|chr11:65191683-65191752,chr11,65191683,65191752,IMR90|chr11:62496597-62496623,chr11,62496597,62496623,1,2695086
IMR90|chr11:65191683-65191750,chr11,65191683,65191750,IMR90|chr11:62496597-62496623,chr11,62496597,62496623,1,2695086
IMR90|chr11:65191828-65191874,chr11,65191828,65191874,IMR90|chr11:211867-211976,chr11,211867,211976,1,64979961
IMR90|chr11:65191828-65191869,chr11,65191828,65191869,IMR90|chr11:211867-211976,chr11,211867,211976,1,64979961
IMR90|chr11:65191922-65192017,chr11,65191922,65192017,IMR90|chr11:709151-709199,chr11,709151,709199,1,64482771
IMR90|chr11:65191931-65191991,chr11,65191931,65191991,IMR90|chr11:72524217-72524277,chr11,72524217,72524277,1,7332286
IMR90|chr11:65191944-65191989,chr11,65191944,65191989,IMR90|chr11:65220459-65220551,chr11,65220459,65220551,1,28515
IMR90|chr11:65191953-65191989,chr11,65191953,65191989,IMR90|chr11:65220459-65220551,chr11,65220459,65220551,1,28506
IMR90|chr11:65192207-65192302,chr11,65192207,65192302,IMR90|chr11:57548937-57548983,chr11,57548937,57548983,1,7643270
IMR90|chr11:65192208-65192302,chr11,65192208,65192302,IMR90|chr11:57548937-57548983,chr11,57548937,57548983,1,7643271
IMR90|chr11:65192448-65192471,chr11,65192448,65192471,IMR90|chr11:65665038-65665162,chr11,65665038,65665162,1,472590
IMR90|chr11:65192705-65192813,chr11,65192705,65192813,IMR90|chr11:65033144-65033197,chr11,65033144,65033197,1,159561
IMR90|chr11:65192705-65192801,chr11,65192705,65192801,IMR90|chr11:65033144-65033197,chr11,65033144,65033197,1,159561
IMR90|chr11:65192732-65192782,chr11,65192732,65192782,IMR90|chr11:62479459-62479573,chr11,62479459,62479573,1,2713273
IMR90|chr11:65192733-65192809,chr11,65192733,65192809,IMR90|chr11:65082439-65082528,chr11,65082439,65082528,1,110294
IMR90|chr11:65192733-65192794,chr11,65192733,65192794,IMR90|chr11:65082439-65082528,chr11,65082439,65082528,1,110294
IMR90|chr11:65192733-65192768,chr11,65192733,65192768,IMR90|chr11:65082439-65082528,chr11,65082439,65082528,1,110294
IMR90|chr11:65192735-65192794,chr11,65192735,65192794,IMR90|chr11:17098430-17098454,chr11,17098430,17098454,1,48094305
IMR90|chr11:65192776-65192809,chr11,65192776,65192809,IMR90|chr11:65082439-65082528,chr11,65082439,65082528,1,110337
IMR90|chr11:65192891-65192925,chr11,65192891,65192925,IMR90|chr11:62479459-62479573,chr11,62479459,62479573,1,2713432
IMR90|chr11:65193452-65193500,chr11,65193452,65193500,IMR90|chr11:64850735-64850792,chr11,64850735,64850792,1,342717
IMR90|chr11:65193453-65193500,chr11,65193453,65193500,IMR90|chr11:64850735-64850792,chr11,64850735,64850792,1,342718
IMR90|chr11:65193818-65193851,chr11,65193818,65193851,IMR90|chr11:64886362-64886429,chr11,64886362,64886429,1,307456
IMR90|chr11:65193818-65193849,chr11,65193818,65193849,IMR90|chr11:64886362-64886429,chr11,64886362,64886429,1,307456
IMR90|chr11:65193947-65194030,chr11,65193947,65194030,IMR90|chr11:832473-832514,chr11,832473,832514,1,64361474
IMR90|chr11:65194259-65194286,chr11,65194259,65194286,IMR90|chr11:125461864-125461934,chr11,125461864,125461934,1,60267605
IMR90|chr11:65194481-65194528,chr11,65194481,65194528,IMR90|chr11:120207137-120207239,chr11,120207137,120207239,1,55012656
IMR90|chr11:65194484-65194560,chr11,65194484,65194560,IMR90|chr11:120207137-120207239,chr11,120207137,120207239,1,55012653
IMR90|chr11:65194686-65194771,chr11,65194686,65194771,IMR90|chr11:60611631-60611745,chr11,60611631,60611745,1,4583055
IMR90|chr11:65194686-65194722,chr11,65194686,65194722,IMR90|chr11:60611631-60611745,chr11,60611631,60611745,1,4583055
IMR90|chr11:65194723-65194779,chr11,65194723,65194779,IMR90|chr11:62494042-62494129,chr11,62494042,62494129,1,2700681
IMR90|chr11:65194813-65194872,chr11,65194813,65194872,IMR90|chr11:65033579-65033616,chr11,65033579,65033616,1,161234
IMR90|chr11:65194813-65194871,chr11,65194813,65194871,IMR90|chr11:65033579-65033616,chr11,65033579,65033616,1,161234
IMR90|chr11:65194828-65194850,chr11,65194828,65194850,IMR90|chr11:95656535-95656619,chr11,95656535,95656619,1,30461707
IMR90|chr11:65194830-65194850,chr11,65194830,65194850,IMR90|chr11:95656535-95656619,chr11,95656535,95656619,1,30461705
IMR90|chr11:65194867-65194952,chr11,65194867,65194952,IMR90|chr11:65158152-65158203,chr11,65158152,65158203,1,36715
IMR90|chr11:65194885-65194929,chr11,65194885,65194929,IMR90|chr11:57530091-57530144,chr11,57530091,57530144,1,7664794
IMR90|chr11:65194886-65194929,chr11,65194886,65194929,IMR90|chr11:57530091-57530144,chr11,57530091,57530144,1,7664795
IMR90|chr11:65194890-65194945,chr11,65194890,65194945,IMR90|chr11:57546153-57546250,chr11,57546153,57546250,1,7648737
IMR90|chr11:65194892-65194945,chr11,65194892,65194945,IMR90|chr11:57546153-57546250,chr11,57546153,57546250,1,7648739
IMR90|chr11:65195046-65195111,chr11,65195046,65195111,IMR90|chr11:65664632-65664699,chr11,65664632,65664699,1,469586
IMR90|chr11:65195047-65195111,chr11,65195047,65195111,IMR90|chr11:65664631-65664692,chr11,65664631,65664692,1,469584
IMR90|chr11:65195049-65195135,chr11,65195049,65195135,IMR90|chr11:125461995-125462040,chr11,125461995,125462040,1,60266946
IMR90|chr11:65195063-65195135,chr11,65195063,65195135,IMR90|chr11:65406450-65406488,chr11,65406450,65406488,1,211387
IMR90|chr11:65195388-65195414,chr11,65195388,65195414,IMR90|chr11:65217978-65218095,chr11,65217978,65218095,1,22590
IMR90|chr11:65195388-65195411,chr11,65195388,65195411,IMR90|chr11:65217978-65218095,chr11,65217978,65218095,1,22590
IMR90|chr11:65195473-65195529,chr11,65195473,65195529,IMR90|chr11:212049-212116,chr11,212049,212116,1,64983424
IMR90|chr11:65195473-65195527,chr11,65195473,65195527,IMR90|chr11:212049-212116,chr11,212049,212116,1,64983424
IMR90|chr11:65195522-65195577,chr11,65195522,65195577,IMR90|chr11:64691814-64691909,chr11,64691814,64691909,1,503708
IMR90|chr11:65195552-65195702,chr11,65195552,65195702,IMR90|chr11:64691814-64691909,chr11,64691814,64691909,1,503738
IMR90|chr11:65195765-65195827,chr11,65195765,65195827,IMR90|chr11:64944530-64944603,chr11,64944530,64944603,1,251235
IMR90|chr11:65195929-65196010,chr11,65195929,65196010,IMR90|chr11:67138513-67138547,chr11,67138513,67138547,1,1942584
IMR90|chr11:65195953-65196039,chr11,65195953,65196039,IMR90|chr11:57530854-57530907,chr11,57530854,57530907,1,7665099
IMR90|chr11:65195953-65196037,chr11,65195953,65196037,IMR90|chr11:57530854-57530907,chr11,57530854,57530907,1,7665099
IMR90|chr11:65195955-65196037,chr11,65195955,65196037,IMR90|chr11:57530854-57530907,chr11,57530854,57530907,1,7665101
IMR90|chr11:65195982-65196062,chr11,65195982,65196062,IMR90|chr11:65083473-65083496,chr11,65083473,65083496,1,112509
IMR90|chr11:65196138-65196240,chr11,65196138,65196240,IMR90|chr11:85779367-85779390,chr11,85779367,85779390,1,20583229
IMR90|chr11:65196146-65196239,chr11,65196146,65196239,IMR90|chr11:36531129-36531178,chr11,36531129,36531178,1,28665017
IMR90|chr11:65196163-65196240,chr11,65196163,65196240,IMR90|chr11:85779367-85779390,chr11,85779367,85779390,1,20583204
IMR90|chr11:65196168-65196225,chr11,65196168,65196225,IMR90|chr11:65157943-65158012,chr11,65157943,65158012,1,38225
IMR90|chr11:65196169-65196222,chr11,65196169,65196222,IMR90|chr11:844145-844259,chr11,844145,844259,1,64352024
IMR90|chr11:65196367-65196416,chr11,65196367,65196416,IMR90|chr11:57547894-57547973,chr11,57547894,57547973,1,7648473
IMR90|chr11:65196369-65196416,chr11,65196369,65196416,IMR90|chr11:57547894-57547973,chr11,57547894,57547973,1,7648475
IMR90|chr11:65196535-65196561,chr11,65196535,65196561,IMR90|chr11:823252-823351,chr11,823252,823351,1,64373283
IMR90|chr11:65196535-65196560,chr11,65196535,65196560,IMR90|chr11:823252-823351,chr11,823252,823351,1,64373283
IMR90|chr11:65196815-65196850,chr11,65196815,65196850,IMR90|chr11:64879886-64879960,chr11,64879886,64879960,1,316929
IMR90|chr11:65197320-65197366,chr11,65197320,65197366,IMR90|chr11:65666160-65666264,chr11,65666160,65666264,1,468840
IMR90|chr11:65197664-65197691,chr11,65197664,65197691,IMR90|chr11:57532254-57532328,chr11,57532254,57532328,1,7665410
IMR90|chr11:65197754-65197797,chr11,65197754,65197797,IMR90|chr11:707541-707642,chr11,707541,707642,1,64490213
IMR90|chr11:65197971-65198031,chr11,65197971,65198031,IMR90|chr11:3117116-3117134,chr11,3117116,3117134,1,62080855
IMR90|chr11:65198004-65198096,chr11,65198004,65198096,IMR90|chr11:57531236-57531297,chr11,57531236,57531297,1,7666768
IMR90|chr11:65198004-65198084,chr11,65198004,65198084,IMR90|chr11:57531236-57531306,chr11,57531236,57531306,1,7666768
IMR90|chr11:65198008-65198096,chr11,65198008,65198096,IMR90|chr11:57531254-57531310,chr11,57531254,57531310,1,7666754
IMR90|chr11:65198173-65198216,chr11,65198173,65198216,IMR90|chr11:772571-772647,chr11,772571,772647,1,64425602
IMR90|chr11:65198629-65198661,chr11,65198629,65198661,IMR90|chr11:65342898-65342964,chr11,65342898,65342964,1,144269
IMR90|chr11:65198693-65198798,chr11,65198693,65198798,IMR90|chr11:57546803-57546844,chr11,57546803,57546844,1,7651890
IMR90|chr11:65198959-65199026,chr11,65198959,65199026,IMR90|chr11:3117054-3117135,chr11,3117054,3117135,1,62081905
IMR90|chr11:65199437-65199475,chr11,65199437,65199475,IMR90|chr11:810468-810562,chr11,810468,810562,1,64388969
IMR90|chr11:65199437-65199474,chr11,65199437,65199474,IMR90|chr11:810468-810562,chr11,810468,810562,1,64388969
IMR90|chr11:65199464-65199563,chr11,65199464,65199563,IMR90|chr11:65223068-65223089,chr11,65223068,65223089,1,23604
IMR90|chr11:65199692-65199753,chr11,65199692,65199753,IMR90|chr11:72524500-72524527,chr11,72524500,72524527,1,7324808
IMR90|chr11:65200193-65200219,chr11,65200193,65200219,IMR90|chr11:65155227-65155313,chr11,65155227,65155313,1,44966
IMR90|chr11:65200219-65200301,chr11,65200219,65200301,IMR90|chr11:64904641-64904709,chr11,64904641,64904709,1,295578
IMR90|chr11:65200221-65200284,chr11,65200221,65200284,IMR90|chr11:65663635-65663705,chr11,65663635,65663705,1,463414
IMR90|chr11:65200629-65200708,chr11,65200629,65200708,IMR90|chr11:65663807-65663844,chr11,65663807,65663844,1,463178
IMR90|chr11:65200629-65200707,chr11,65200629,65200707,IMR90|chr11:65663807-65663844,chr11,65663807,65663844,1,463178
IMR90|chr11:65200666-65200739,chr11,65200666,65200739,IMR90|chr11:810857-810884,chr11,810857,810884,1,64389809
IMR90|chr11:65200944-65201011,chr11,65200944,65201011,IMR90|chr11:117050785-117050897,chr11,117050785,117050897,1,51849841
IMR90|chr11:65200944-65200982,chr11,65200944,65200982,IMR90|chr11:117050785-117050897,chr11,117050785,117050897,1,51849841
IMR90|chr11:65201179-65201274,chr11,65201179,65201274,IMR90|chr11:64853573-64853607,chr11,64853573,64853607,1,347606
IMR90|chr11:65201179-65201272,chr11,65201179,65201272,IMR90|chr11:64853573-64853607,chr11,64853573,64853607,1,347606
IMR90|chr11:65201518-65201563,chr11,65201518,65201563,IMR90|chr11:62538244-62538327,chr11,62538244,62538327,1,2663274
IMR90|chr11:65201632-65201698,chr11,65201632,65201698,IMR90|chr11:67156202-67156265,chr11,67156202,67156265,1,1954570
IMR90|chr11:65201734-65201769,chr11,65201734,65201769,IMR90|chr11:65838386-65838500,chr11,65838386,65838500,1,636652
IMR90|chr11:65201734-65201768,chr11,65201734,65201768,IMR90|chr11:65838386-65838500,chr11,65838386,65838500,1,636652
IMR90|chr11:65201800-65201861,chr11,65201800,65201861,IMR90|chr11:57546592-57546648,chr11,57546592,57546648,1,7655208
IMR90|chr11:65201800-65201860,chr11,65201800,65201860,IMR90|chr11:57546591-57546648,chr11,57546591,57546648,1,7655209
IMR90|chr11:65201923-65201975,chr11,65201923,65201975,IMR90|chr11:65667459-65667520,chr11,65667459,65667520,1,465536
IMR90|chr11:65201923-65201973,chr11,65201923,65201973,IMR90|chr11:65667459-65667520,chr11,65667459,65667520,1,465536
IMR90|chr11:65202148-65202196,chr11,65202148,65202196,IMR90|chr11:17097490-17097531,chr11,17097490,17097531,1,48104658
IMR90|chr11:65202160-65202284,chr11,65202160,65202284,IMR90|chr11:1891017-1891038,chr11,1891017,1891038,1,63311143
IMR90|chr11:65202172-65202246,chr11,65202172,65202246,IMR90|chr11:850516-850551,chr11,850516,850551,1,64351656
IMR90|chr11:65202465-65202519,chr11,65202465,65202519,IMR90|chr11:65032977-65033096,chr11,65032977,65033096,1,169488
IMR90|chr11:65202465-65202496,chr11,65202465,65202496,IMR90|chr11:65032977-65033096,chr11,65032977,65033096,1,169488
IMR90|chr11:65202527-65202577,chr11,65202527,65202577,IMR90|chr11:17098436-17098493,chr11,17098436,17098493,1,48104091
IMR90|chr11:65202816-65202859,chr11,65202816,65202859,IMR90|chr11:64944649-64944718,chr11,64944649,64944718,1,258167
IMR90|chr11:65203147-65203206,chr11,65203147,65203206,IMR90|chr11:65343909-65343955,chr11,65343909,65343955,1,140762
IMR90|chr11:65203434-65203478,chr11,65203434,65203478,IMR90|chr11:64905606-64905665,chr11,64905606,64905665,1,297828
IMR90|chr11:65203578-65203633,chr11,65203578,65203633,IMR90|chr11:71936772-71936826,chr11,71936772,71936826,1,6733194
IMR90|chr11:65203612-65203655,chr11,65203612,65203655,IMR90|chr11:65665416-65665470,chr11,65665416,65665470,1,461804
IMR90|chr11:65203612-65203654,chr11,65203612,65203654,IMR90|chr11:65665416-65665470,chr11,65665416,65665470,1,461804
IMR90|chr11:65203693-65203757,chr11,65203693,65203757,IMR90|chr11:65666797-65666829,chr11,65666797,65666829,1,463104
IMR90|chr11:65203717-65203786,chr11,65203717,65203786,IMR90|chr11:66610194-66610273,chr11,66610194,66610273,1,1406477
IMR90|chr11:65203718-65203786,chr11,65203718,65203786,IMR90|chr11:66610194-66610273,chr11,66610194,66610273,1,1406476
IMR90|chr11:65203725-65203845,chr11,65203725,65203845,IMR90|chr11:64886908-64886938,chr11,64886908,64886938,1,316817
IMR90|chr11:65203765-65203869,chr11,65203765,65203869,IMR90|chr11:211639-211685,chr11,211639,211685,1,64992126
IMR90|chr11:65203766-65203870,chr11,65203766,65203870,IMR90|chr11:211639-211685,chr11,211639,211685,1,64992127
IMR90|chr11:65203773-65203843,chr11,65203773,65203843,IMR90|chr11:707944-707973,chr11,707944,707973,1,64495829
IMR90|chr11:65203774-65203843,chr11,65203774,65203843,IMR90|chr11:707944-707973,chr11,707944,707973,1,64495830
IMR90|chr11:65203789-65203881,chr11,65203789,65203881,IMR90|chr11:85779223-85779267,chr11,85779223,85779267,1,20575434
IMR90|chr11:65203797-65203851,chr11,65203797,65203851,IMR90|chr11:71938026-71938093,chr11,71938026,71938093,1,6734229
IMR90|chr11:65203826-65203914,chr11,65203826,65203914,IMR90|chr11:65667438-65667491,chr11,65667438,65667491,1,463612
IMR90|chr11:65204077-65204118,chr11,65204077,65204118,IMR90|chr11:65078043-65078133,chr11,65078043,65078133,1,126034
IMR90|chr11:65204084-65204142,chr11,65204084,65204142,IMR90|chr11:67007042-67007134,chr11,67007042,67007134,1,1802958
IMR90|chr11:65204085-65204142,chr11,65204085,65204142,IMR90|chr11:67007042-67007134,chr11,67007042,67007134,1,1802957
IMR90|chr11:65204271-65204343,chr11,65204271,65204343,IMR90|chr11:65665975-65666047,chr11,65665975,65666047,1,461704
IMR90|chr11:65204281-65204343,chr11,65204281,65204343,IMR90|chr11:65665959-65666047,chr11,65665959,65666047,1,461678
IMR90|chr11:65204744-65204791,chr11,65204744,65204791,IMR90|chr11:65666717-65666867,chr11,65666717,65666867,1,461973
IMR90|chr11:65205150-65205214,chr11,65205150,65205214,IMR90|chr11:696501-696581,chr11,696501,696581,1,64508649
IMR90|chr11:65205150-65205211,chr11,65205150,65205211,IMR90|chr11:696501-696581,chr11,696501,696581,1,64508649
IMR90|chr11:65205162-65205215,chr11,65205162,65205215,IMR90|chr11:821421-821475,chr11,821421,821475,1,64383741
IMR90|chr11:65205164-65205215,chr11,65205164,65205215,IMR90|chr11:821421-821475,chr11,821421,821475,1,64383743
IMR90|chr11:65205167-65205239,chr11,65205167,65205239,IMR90|chr11:67137367-67137477,chr11,67137367,67137477,1,1932200
IMR90|chr11:65205167-65205206,chr11,65205167,65205206,IMR90|chr11:67137367-67137477,chr11,67137367,67137477,1,1932200
IMR90|chr11:65205185-65205240,chr11,65205185,65205240,IMR90|chr11:67159728-67159810,chr11,67159728,67159810,1,1954543
IMR90|chr11:65205196-65205251,chr11,65205196,65205251,IMR90|chr11:66610006-66610041,chr11,66610006,66610041,1,1404810
IMR90|chr11:65205197-65205251,chr11,65205197,65205251,IMR90|chr11:66609771-66609829,chr11,66609771,66609829,1,1404574
IMR90|chr11:65205198-65205247,chr11,65205198,65205247,IMR90|chr11:71935067-71935170,chr11,71935067,71935170,1,6729869
IMR90|chr11:65205203-65205247,chr11,65205203,65205247,IMR90|chr11:71935067-71935170,chr11,71935067,71935170,1,6729864
IMR90|chr11:65205248-65205348,chr11,65205248,65205348,IMR90|chr11:85779446-85779487,chr11,85779446,85779487,1,20574198
IMR90|chr11:65205448-65205503,chr11,65205448,65205503,IMR90|chr11:75276421-75276479,chr11,75276421,75276479,1,10070973
IMR90|chr11:65205589-65205674,chr11,65205589,65205674,IMR90|chr11:75276611-75276664,chr11,75276611,75276664,1,10071022
IMR90|chr11:65205590-65205674,chr11,65205590,65205674,IMR90|chr11:75276611-75276664,chr11,75276611,75276664,1,10071021
IMR90|chr11:65205981-65206012,chr11,65205981,65206012,IMR90|chr11:57548538-57548670,chr11,57548538,57548670,1,7657443
IMR90|chr11:65205986-65206012,chr11,65205986,65206012,IMR90|chr11:65099292-65099376,chr11,65099292,65099376,1,106694
IMR90|chr11:65205996-65206038,chr11,65205996,65206038,IMR90|chr11:71937200-71937350,chr11,71937200,71937350,1,6731204
IMR90|chr11:65206315-65206337,chr11,65206315,65206337,IMR90|chr11:57533204-57533241,chr11,57533204,57533241,1,7673111
IMR90|chr11:65206420-65206465,chr11,65206420,65206465,IMR90|chr11:67136781-67136845,chr11,67136781,67136845,1,1930361
IMR90|chr11:65206937-65206954,chr11,65206937,65206954,IMR90|chr11:57548441-57548562,chr11,57548441,57548562,1,7658496
IMR90|chr11:65206950-65206999,chr11,65206950,65206999,IMR90|chr11:65288818-65288919,chr11,65288818,65288919,1,81868
IMR90|chr11:65206996-65207055,chr11,65206996,65207055,IMR90|chr11:65665691-65665779,chr11,65665691,65665779,1,458695
IMR90|chr11:65206999-65207065,chr11,65206999,65207065,IMR90|chr11:65665691-65665779,chr11,65665691,65665779,1,458692
IMR90|chr11:65207015-65207113,chr11,65207015,65207113,IMR90|chr11:65152412-65152444,chr11,65152412,65152444,1,54603
IMR90|chr11:65207034-65207110,chr11,65207034,65207110,IMR90|chr11:64944513-64944587,chr11,64944513,64944587,1,262521
IMR90|chr11:65207072-65207150,chr11,65207072,65207150,IMR90|chr11:65288481-65288510,chr11,65288481,65288510,1,81409
IMR90|chr11:65207092-65207155,chr11,65207092,65207155,IMR90|chr11:64945745-64945772,chr11,64945745,64945772,1,261347
IMR90|chr11:65207092-65207144,chr11,65207092,65207144,IMR90|chr11:64945745-64945772,chr11,64945745,64945772,1,261347
IMR90|chr11:65207092-65207139,chr11,65207092,65207139,IMR90|chr11:64945745-64945772,chr11,64945745,64945772,1,261347
IMR90|chr11:65207184-65207236,chr11,65207184,65207236,IMR90|chr11:65407764-65407853,chr11,65407764,65407853,1,200580
IMR90|chr11:65207433-65207469,chr11,65207433,65207469,IMR90|chr11:65033219-65033332,chr11,65033219,65033332,1,174214
IMR90|chr11:65207444-65207542,chr11,65207444,65207542,IMR90|chr11:65100693-65100745,chr11,65100693,65100745,1,106751
IMR90|chr11:65207446-65207546,chr11,65207446,65207546,IMR90|chr11:65100693-65100745,chr11,65100693,65100745,1,106753
IMR90|chr11:65207472-65207535,chr11,65207472,65207535,IMR90|chr11:64886695-64886765,chr11,64886695,64886765,1,320777
IMR90|chr11:65207472-65207510,chr11,65207472,65207510,IMR90|chr11:64886695-64886765,chr11,64886695,64886765,1,320777
IMR90|chr11:65207744-65207762,chr11,65207744,65207762,IMR90|chr11:65665007-65665115,chr11,65665007,65665115,1,457263
IMR90|chr11:65207791-65207860,chr11,65207791,65207860,IMR90|chr11:67158984-67159064,chr11,67158984,67159064,1,1951193
IMR90|chr11:65207793-65207825,chr11,65207793,65207825,IMR90|chr11:65665269-65665349,chr11,65665269,65665349,1,457476
IMR90|chr11:65207794-65207825,chr11,65207794,65207825,IMR90|chr11:65665269-65665349,chr11,65665269,65665349,1,457475
IMR90|chr11:65207864-65207933,chr11,65207864,65207933,IMR90|chr11:64886572-64886651,chr11,64886572,64886651,1,321292
IMR90|chr11:65207951-65208083,chr11,65207951,65208083,IMR90|chr11:62474293-62474311,chr11,62474293,62474311,1,2733658
IMR90|chr11:65207974-65208119,chr11,65207974,65208119,IMR90|chr11:62474293-62474311,chr11,62474293,62474311,1,2733681
IMR90|chr11:65208068-65208092,chr11,65208068,65208092,IMR90|chr11:808403-808520,chr11,808403,808520,1,64399665
IMR90|chr11:65208070-65208139,chr11,65208070,65208139,IMR90|chr11:65155227-65155271,chr11,65155227,65155271,1,52843
IMR90|chr11:65208107-65208227,chr11,65208107,65208227,IMR90|chr11:65157512-65157536,chr11,65157512,65157536,1,50595
IMR90|chr11:65208107-65208226,chr11,65208107,65208226,IMR90|chr11:65157512-65157536,chr11,65157512,65157536,1,50595
IMR90|chr11:65208187-65208300,chr11,65208187,65208300,IMR90|chr11:65405179-65405216,chr11,65405179,65405216,1,196992
IMR90|chr11:65208222-65208266,chr11,65208222,65208266,IMR90|chr11:808581-808648,chr11,808581,808648,1,64399641
IMR90|chr11:65208222-65208264,chr11,65208222,65208264,IMR90|chr11:808581-808648,chr11,808581,808648,1,64399641
IMR90|chr11:65208342-65208393,chr11,65208342,65208393,IMR90|chr11:65665499-65665622,chr11,65665499,65665622,1,457157
IMR90|chr11:65208411-65208498,chr11,65208411,65208498,IMR90|chr11:65343946-65343962,chr11,65343946,65343962,1,135535
IMR90|chr11:65208420-65208479,chr11,65208420,65208479,IMR90|chr11:117048265-117048410,chr11,117048265,117048410,1,51839845
IMR90|chr11:65208425-65208491,chr11,65208425,65208491,IMR90|chr11:65666488-65666572,chr11,65666488,65666572,1,458063
IMR90|chr11:65208426-65208506,chr11,65208426,65208506,IMR90|chr11:65666488-65666572,chr11,65666488,65666572,1,458062
IMR90|chr11:65208594-65208614,chr11,65208594,65208614,IMR90|chr11:72523914-72524001,chr11,72523914,72524001,1,7315320
IMR90|chr11:65208594-65208613,chr11,65208594,65208613,IMR90|chr11:72523914-72524001,chr11,72523914,72524001,1,7315320
IMR90|chr11:65208693-65208734,chr11,65208693,65208734,IMR90|chr11:57529886-57529934,chr11,57529886,57529934,1,7678807
IMR90|chr11:65208695-65208734,chr11,65208695,65208734,IMR90|chr11:57529886-57529934,chr11,57529886,57529934,1,7678809
IMR90|chr11:65208789-65208866,chr11,65208789,65208866,IMR90|chr11:65221436-65221509,chr11,65221436,65221509,1,12647
IMR90|chr11:65208791-65208885,chr11,65208791,65208885,IMR90|chr11:65221436-65221509,chr11,65221436,65221509,1,12645
IMR90|chr11:65208793-65208892,chr11,65208793,65208892,IMR90|chr11:65030807-65030855,chr11,65030807,65030855,1,177986
IMR90|chr11:65208806-65208864,chr11,65208806,65208864,IMR90|chr11:65666944-65667076,chr11,65666944,65667076,1,458138
IMR90|chr11:65208844-65208909,chr11,65208844,65208909,IMR90|chr11:85778792-85778822,chr11,85778792,85778822,1,20569948
IMR90|chr11:65208845-65208907,chr11,65208845,65208907,IMR90|chr11:85778792-85778822,chr11,85778792,85778822,1,20569947
IMR90|chr11:65208919-65208986,chr11,65208919,65208986,IMR90|chr11:65158146-65158169,chr11,65158146,65158169,1,50773
IMR90|chr11:65208919-65208983,chr11,65208919,65208983,IMR90|chr11:65158146-65158169,chr11,65158146,65158169,1,50773
IMR90|chr11:65208939-65209024,chr11,65208939,65209024,IMR90|chr11:62493807-62493884,chr11,62493807,62493884,1,2715132
IMR90|chr11:65208939-65208970,chr11,65208939,65208970,IMR90|chr11:62493807-62493884,chr11,62493807,62493884,1,2715132
IMR90|chr11:65209199-65209255,chr11,65209199,65209255,IMR90|chr11:65839252-65839298,chr11,65839252,65839298,1,630053
IMR90|chr11:65209441-65209585,chr11,65209441,65209585,IMR90|chr11:796659-796694,chr11,796659,796694,1,64412782
IMR90|chr11:65209441-65209556,chr11,65209441,65209556,IMR90|chr11:796659-796694,chr11,796659,796694,1,64412782
IMR90|chr11:65209476-65209612,chr11,65209476,65209612,IMR90|chr11:120208534-120208616,chr11,120208534,120208616,1,54999058
IMR90|chr11:65209476-65209544,chr11,65209476,65209544,IMR90|chr11:120208534-120208616,chr11,120208534,120208616,1,54999058
IMR90|chr11:65209476-65209539,chr11,65209476,65209539,IMR90|chr11:120208534-120208616,chr11,120208534,120208616,1,54999058
IMR90|chr11:65209506-65209523,chr11,65209506,65209523,IMR90|chr11:65217911-65218022,chr11,65217911,65218022,1,8405
IMR90|chr11:65209511-65209636,chr11,65209511,65209636,IMR90|chr11:75276567-75276590,chr11,75276567,75276590,1,10067056
IMR90|chr11:65209511-65209633,chr11,65209511,65209633,IMR90|chr11:75276567-75276590,chr11,75276567,75276590,1,10067056
IMR90|chr11:65209585-65209633,chr11,65209585,65209633,IMR90|chr11:776001-776115,chr11,776001,776115,1,64433584
IMR90|chr11:65209796-65209945,chr11,65209796,65209945,IMR90|chr11:65030176-65030196,chr11,65030176,65030196,1,179620
IMR90|chr11:65209819-65209949,chr11,65209819,65209949,IMR90|chr11:65030176-65030196,chr11,65030176,65030196,1,179643
IMR90|chr11:65209836-65209915,chr11,65209836,65209915,IMR90|chr11:65347176-65347208,chr11,65347176,65347208,1,137340
IMR90|chr11:65209838-65209907,chr11,65209838,65209907,IMR90|chr11:75276568-75276634,chr11,75276568,75276634,1,10066730
IMR90|chr11:65209851-65209904,chr11,65209851,65209904,IMR90|chr11:65102625-65102670,chr11,65102625,65102670,1,107226
IMR90|chr11:65210052-65210071,chr11,65210052,65210071,IMR90|chr11:71937398-71937486,chr11,71937398,71937486,1,6727346
IMR90|chr11:65210063-65210180,chr11,65210063,65210180,IMR90|chr11:64946320-64946353,chr11,64946320,64946353,1,263743
IMR90|chr11:65210147-65210188,chr11,65210147,65210188,IMR90|chr11:65221411-65221520,chr11,65221411,65221520,1,11264
IMR90|chr11:65210148-65210236,chr11,65210148,65210236,IMR90|chr11:65221411-65221520,chr11,65221411,65221520,1,11263
IMR90|chr11:65210550-65210581,chr11,65210550,65210581,IMR90|chr11:65219633-65219752,chr11,65219633,65219752,1,9083
IMR90|chr11:65210804-65210839,chr11,65210804,65210839,IMR90|chr11:57531875-57531979,chr11,57531875,57531979,1,7678929
IMR90|chr11:65210961-65210982,chr11,65210961,65210982,IMR90|chr11:75276771-75276878,chr11,75276771,75276878,1,10065810
IMR90|chr11:65211006-65211087,chr11,65211006,65211087,IMR90|chr11:85779185-85779240,chr11,85779185,85779240,1,20568179
IMR90|chr11:65211012-65211074,chr11,65211012,65211074,IMR90|chr11:65664544-65664595,chr11,65664544,65664595,1,453532
IMR90|chr11:65211012-65211073,chr11,65211012,65211073,IMR90|chr11:65664544-65664595,chr11,65664544,65664595,1,453532
IMR90|chr11:65211334-65211400,chr11,65211334,65211400,IMR90|chr11:60614871-60614897,chr11,60614871,60614897,1,4596463
IMR90|chr11:65211413-65211505,chr11,65211413,65211505,IMR90|chr11:65156496-65156523,chr11,65156496,65156523,1,54917
IMR90|chr11:65211472-65211552,chr11,65211472,65211552,IMR90|chr11:72520557-72520621,chr11,72520557,72520621,1,7309085
IMR90|chr11:65211473-65211549,chr11,65211473,65211549,IMR90|chr11:72520557-72520621,chr11,72520557,72520621,1,7309084
IMR90|chr11:65211528-65211678,chr11,65211528,65211678,IMR90|chr11:17098430-17098469,chr11,17098430,17098469,1,48113098
IMR90|chr11:65211554-65211595,chr11,65211554,65211595,IMR90|chr11:62477556-62477665,chr11,62477556,62477665,1,2733998
IMR90|chr11:65211556-65211588,chr11,65211556,65211588,IMR90|chr11:62477556-62477665,chr11,62477556,62477665,1,2734000
IMR90|chr11:65211557-65211595,chr11,65211557,65211595,IMR90|chr11:65097078-65097159,chr11,65097078,65097159,1,114479
IMR90|chr11:65211571-65211682,chr11,65211571,65211682,IMR90|chr11:17098430-17098469,chr11,17098430,17098469,1,48113141
IMR90|chr11:65211572-65211682,chr11,65211572,65211682,IMR90|chr11:17098430-17098469,chr11,17098430,17098469,1,48113142
IMR90|chr11:65211616-65211662,chr11,65211616,65211662,IMR90|chr11:821989-822085,chr11,821989,822085,1,64389627
IMR90|chr11:65211621-65211662,chr11,65211621,65211662,IMR90|chr11:821989-822085,chr11,821989,822085,1,64389632
IMR90|chr11:65211663-65211744,chr11,65211663,65211744,IMR90|chr11:120209333-120209373,chr11,120209333,120209373,1,54997670
IMR90|chr11:65211665-65211700,chr11,65211665,65211700,IMR90|chr11:57546591-57546631,chr11,57546591,57546631,1,7665074
IMR90|chr11:65211702-65211766,chr11,65211702,65211766,IMR90|chr11:65406484-65406517,chr11,65406484,65406517,1,194782
IMR90|chr11:65211721-65211766,chr11,65211721,65211766,IMR90|chr11:67008387-67008439,chr11,67008387,67008439,1,1796666
IMR90|chr11:65211721-65211765,chr11,65211721,65211765,IMR90|chr11:67008387-67008439,chr11,67008387,67008439,1,1796666
IMR90|chr11:65211782-65211850,chr11,65211782,65211850,IMR90|chr11:65217947-65218029,chr11,65217947,65218029,1,6165
IMR90|chr11:65211783-65211873,chr11,65211783,65211873,IMR90|chr11:65217947-65218029,chr11,65217947,65218029,1,6164
IMR90|chr11:65212124-65212179,chr11,65212124,65212179,IMR90|chr11:73882957-73882979,chr11,73882957,73882979,1,8670833
IMR90|chr11:65212354-65212374,chr11,65212354,65212374,IMR90|chr11:847700-847850,chr11,847700,847850,1,64364654
IMR90|chr11:65212587-65212667,chr11,65212587,65212667,IMR90|chr11:71937872-71937963,chr11,71937872,71937963,1,6725285
IMR90|chr11:65212612-65212671,chr11,65212612,65212671,IMR90|chr11:71937872-71937963,chr11,71937872,71937963,1,6725260
IMR90|chr11:65212728-65212744,chr11,65212728,65212744,IMR90|chr11:67135728-67135828,chr11,67135728,67135828,1,1923000
IMR90|chr11:65214505-65214539,chr11,65214505,65214539,IMR90|chr11:65218252-65218402,chr11,65218252,65218402,1,3747
IMR90|chr11:65214959-65215036,chr11,65214959,65215036,IMR90|chr11:65157052-65157089,chr11,65157052,65157089,1,57907
IMR90|chr11:65240077-65240167,chr11,65240077,65240167,IMR90|chr11:65096332-65096392,chr11,65096332,65096392,1,143745
IMR90|chr11:65266541-65266665,chr11,65266541,65266665,IMR90|chr11:65321510-65321532,chr11,65321510,65321532,1,54969
IMR90|chr11:65266543-65266586,chr11,65266543,65266586,IMR90|chr11:633992-634062,chr11,633992,634062,1,64632551
IMR90|chr11:65266544-65266586,chr11,65266544,65266586,IMR90|chr11:633992-634062,chr11,633992,634062,1,64632552
IMR90|chr11:65266585-65266665,chr11,65266585,65266665,IMR90|chr11:65321510-65321532,chr11,65321510,65321532,1,54925
IMR90|chr11:65266659-65266700,chr11,65266659,65266700,IMR90|chr11:64110401-64110457,chr11,64110401,64110457,1,1156258
IMR90|chr11:65266659-65266699,chr11,65266659,65266699,IMR90|chr11:64110416-64110458,chr11,64110416,64110458,1,1156243
IMR90|chr11:65266698-65266772,chr11,65266698,65266772,IMR90|chr11:65098892-65098918,chr11,65098892,65098918,1,167806
IMR90|chr11:65266775-65266809,chr11,65266775,65266809,IMR90|chr11:65288851-65288931,chr11,65288851,65288931,1,22076
IMR90|chr11:65267003-65267078,chr11,65267003,65267078,IMR90|chr11:93465431-93465578,chr11,93465431,93465578,1,28198428
IMR90|chr11:65267104-65267204,chr11,65267104,65267204,IMR90|chr11:6496454-6496530,chr11,6496454,6496530,1,58770650
IMR90|chr11:65267130-65267204,chr11,65267130,65267204,IMR90|chr11:6496454-6496530,chr11,6496454,6496530,1,58770676
IMR90|chr11:65267229-65267289,chr11,65267229,65267289,IMR90|chr11:72433658-72433692,chr11,72433658,72433692,1,7166429
IMR90|chr11:65267230-65267289,chr11,65267230,65267289,IMR90|chr11:72433658-72433692,chr11,72433658,72433692,1,7166428
IMR90|chr11:65267451-65267477,chr11,65267451,65267477,IMR90|chr11:57091292-57091438,chr11,57091292,57091438,1,8176159
IMR90|chr11:65267457-65267496,chr11,65267457,65267496,IMR90|chr11:8699020-8699128,chr11,8699020,8699128,1,56568437
IMR90|chr11:65267459-65267496,chr11,65267459,65267496,IMR90|chr11:8699020-8699128,chr11,8699020,8699128,1,56568439
IMR90|chr11:65267528-65267628,chr11,65267528,65267628,IMR90|chr11:101785444-101785490,chr11,101785444,101785490,1,36517916
IMR90|chr11:65267561-65267662,chr11,65267561,65267662,IMR90|chr11:101785444-101785490,chr11,101785444,101785490,1,36517883
IMR90|chr11:65267609-65267675,chr11,65267609,65267675,IMR90|chr11:79151889-79151956,chr11,79151889,79151956,1,13884280
IMR90|chr11:65267609-65267669,chr11,65267609,65267669,IMR90|chr11:79151889-79151956,chr11,79151889,79151956,1,13884280
IMR90|chr11:65267613-65267663,chr11,65267613,65267663,IMR90|chr11:6501900-6501953,chr11,6501900,6501953,1,58765713
IMR90|chr11:65267613-65267662,chr11,65267613,65267662,IMR90|chr11:6501900-6501953,chr11,6501900,6501953,1,58765713
IMR90|chr11:65267629-65267667,chr11,65267629,65267667,IMR90|chr11:8700323-8700391,chr11,8700323,8700391,1,56567306
IMR90|chr11:65267631-65267667,chr11,65267631,65267667,IMR90|chr11:8700323-8700391,chr11,8700323,8700391,1,56567308
IMR90|chr11:65267636-65267672,chr11,65267636,65267672,IMR90|chr11:8711788-8711854,chr11,8711788,8711854,1,56555848
IMR90|chr11:65267767-65267911,chr11,65267767,65267911,IMR90|chr11:93474276-93474390,chr11,93474276,93474390,1,28206509
IMR90|chr11:65267801-65267834,chr11,65267801,65267834,IMR90|chr11:93467188-93467257,chr11,93467188,93467257,1,28199387
IMR90|chr11:65267846-65267936,chr11,65267846,65267936,IMR90|chr11:67799211-67799260,chr11,67799211,67799260,1,2531365
IMR90|chr11:65267846-65267935,chr11,65267846,65267935,IMR90|chr11:67799211-67799260,chr11,67799211,67799260,1,2531365
IMR90|chr11:65267847-65267920,chr11,65267847,65267920,IMR90|chr11:117016722-117016774,chr11,117016722,117016774,1,51748875
IMR90|chr11:65267852-65267901,chr11,65267852,65267901,IMR90|chr11:65033547-65033608,chr11,65033547,65033608,1,234305
IMR90|chr11:65267873-65267957,chr11,65267873,65267957,IMR90|chr11:8704873-8704939,chr11,8704873,8704939,1,56563000
IMR90|chr11:65267874-65267984,chr11,65267874,65267984,IMR90|chr11:8704873-8704939,chr11,8704873,8704939,1,56563001
IMR90|chr11:65268137-65268221,chr11,65268137,65268221,IMR90|chr11:57091369-57091433,chr11,57091369,57091433,1,8176768
IMR90|chr11:65268142-65268216,chr11,65268142,65268216,IMR90|chr11:27912553-27912609,chr11,27912553,27912609,1,37355589
IMR90|chr11:65268164-65268222,chr11,65268164,65268222,IMR90|chr11:57091339-57091431,chr11,57091339,57091431,1,8176825
IMR90|chr11:65268178-65268275,chr11,65268178,65268275,IMR90|chr11:10878468-10878529,chr11,10878468,10878529,1,54389710
IMR90|chr11:65268178-65268236,chr11,65268178,65268236,IMR90|chr11:10878473-10878529,chr11,10878473,10878529,1,54389705
IMR90|chr11:65268187-65268276,chr11,65268187,65268276,IMR90|chr11:10878473-10878529,chr11,10878473,10878529,1,54389714
IMR90|chr11:65268251-65268272,chr11,65268251,65268272,IMR90|chr11:635688-635803,chr11,635688,635803,1,64632563
IMR90|chr11:65268310-65268344,chr11,65268310,65268344,IMR90|chr11:66054023-66054173,chr11,66054023,66054173,1,785713
IMR90|chr11:65268422-65268463,chr11,65268422,65268463,IMR90|chr11:125036592-125036703,chr11,125036592,125036703,1,59768170
IMR90|chr11:65268422-65268461,chr11,65268422,65268461,IMR90|chr11:125036603-125036703,chr11,125036603,125036703,1,59768181
IMR90|chr11:65268422-65268460,chr11,65268422,65268460,IMR90|chr11:125036592-125036703,chr11,125036592,125036703,1,59768170
IMR90|chr11:65268454-65268495,chr11,65268454,65268495,IMR90|chr11:62649710-62649815,chr11,62649710,62649815,1,2618744
IMR90|chr11:65268454-65268493,chr11,65268454,65268493,IMR90|chr11:62649706-62649815,chr11,62649706,62649815,1,2618748
IMR90|chr11:65268464-65268520,chr11,65268464,65268520,IMR90|chr11:2403887-2403950,chr11,2403887,2403950,1,62864577
IMR90|chr11:65268589-65268634,chr11,65268589,65268634,IMR90|chr11:8700302-8700437,chr11,8700302,8700437,1,56568287
IMR90|chr11:65268595-65268632,chr11,65268595,65268632,IMR90|chr11:8700302-8700437,chr11,8700302,8700437,1,56568293
IMR90|chr11:65268621-65268678,chr11,65268621,65268678,IMR90|chr11:35548048-35548130,chr11,35548048,35548130,1,29720573
IMR90|chr11:65268623-65268674,chr11,65268623,65268674,IMR90|chr11:57089947-57090005,chr11,57089947,57090005,1,8178676
IMR90|chr11:65268631-65268717,chr11,65268631,65268717,IMR90|chr11:65308303-65308323,chr11,65308303,65308323,1,39672
IMR90|chr11:65268749-65268771,chr11,65268749,65268771,IMR90|chr11:57089947-57090005,chr11,57089947,57090005,1,8178802
IMR90|chr11:65268839-65268926,chr11,65268839,65268926,IMR90|chr11:65099308-65099372,chr11,65099308,65099372,1,169531
IMR90|chr11:65268839-65268925,chr11,65268839,65268925,IMR90|chr11:65099308-65099372,chr11,65099308,65099372,1,169531
IMR90|chr11:65268841-65268918,chr11,65268841,65268918,IMR90|chr11:93470866-93470886,chr11,93470866,93470886,1,28202025
IMR90|chr11:65268843-65268918,chr11,65268843,65268918,IMR90|chr11:93470866-93470886,chr11,93470866,93470886,1,28202023
IMR90|chr11:65268914-65268964,chr11,65268914,65268964,IMR90|chr11:79148089-79148181,chr11,79148089,79148181,1,13879175
IMR90|chr11:65269032-65269150,chr11,65269032,65269150,IMR90|chr11:70054648-70054744,chr11,70054648,70054744,1,4785616
IMR90|chr11:65269077-65269124,chr11,65269077,65269124,IMR90|chr11:93478272-93478417,chr11,93478272,93478417,1,28209195
IMR90|chr11:65269098-65269151,chr11,65269098,65269151,IMR90|chr11:70054648-70054744,chr11,70054648,70054744,1,4785550
IMR90|chr11:65269098-65269131,chr11,65269098,65269131,IMR90|chr11:67810345-67810419,chr11,67810345,67810419,1,2541247
IMR90|chr11:65269216-65269312,chr11,65269216,65269312,IMR90|chr11:93473514-93473594,chr11,93473514,93473594,1,28204298
IMR90|chr11:65269230-65269260,chr11,65269230,65269260,IMR90|chr11:65345793-65345878,chr11,65345793,65345878,1,76563
IMR90|chr11:65269384-65269420,chr11,65269384,65269420,IMR90|chr11:62652533-62652629,chr11,62652533,62652629,1,2616851
IMR90|chr11:65269431-65269454,chr11,65269431,65269454,IMR90|chr11:35546833-35546916,chr11,35546833,35546916,1,29722598
IMR90|chr11:65269463-65269505,chr11,65269463,65269505,IMR90|chr11:79150927-79151068,chr11,79150927,79151068,1,13881464
IMR90|chr11:65269516-65269571,chr11,65269516,65269571,IMR90|chr11:93467543-93467595,chr11,93467543,93467595,1,28198027
IMR90|chr11:65269517-65269564,chr11,65269517,65269564,IMR90|chr11:117016803-117016826,chr11,117016803,117016826,1,51747286
IMR90|chr11:65269608-65269658,chr11,65269608,65269658,IMR90|chr11:406539-406640,chr11,406539,406640,1,64863069
IMR90|chr11:65269608-65269657,chr11,65269608,65269657,IMR90|chr11:406539-406640,chr11,406539,406640,1,64863069
IMR90|chr11:65269646-65269686,chr11,65269646,65269686,IMR90|chr11:2402710-2402787,chr11,2402710,2402787,1,62866936
IMR90|chr11:65269646-65269683,chr11,65269646,65269683,IMR90|chr11:2402710-2402787,chr11,2402710,2402787,1,62866936
IMR90|chr11:65269648-65269700,chr11,65269648,65269700,IMR90|chr11:35548148-35548237,chr11,35548148,35548237,1,29721500
IMR90|chr11:65269946-65270066,chr11,65269946,65270066,IMR90|chr11:72432650-72432692,chr11,72432650,72432692,1,7162704
IMR90|chr11:65269958-65270066,chr11,65269958,65270066,IMR90|chr11:72432650-72432692,chr11,72432650,72432692,1,7162692
IMR90|chr11:65270015-65270077,chr11,65270015,65270077,IMR90|chr11:65338802-65338843,chr11,65338802,65338843,1,68787
IMR90|chr11:65270018-65270077,chr11,65270018,65270077,IMR90|chr11:65338802-65338843,chr11,65338802,65338843,1,68784
IMR90|chr11:65270101-65270177,chr11,65270101,65270177,IMR90|chr11:67809881-67809964,chr11,67809881,67809964,1,2539780
IMR90|chr11:65270125-65270216,chr11,65270125,65270216,IMR90|chr11:65032840-65032874,chr11,65032840,65032874,1,237285
IMR90|chr11:65270129-65270204,chr11,65270129,65270204,IMR90|chr11:67809400-67809443,chr11,67809400,67809443,1,2539271
IMR90|chr11:65270142-65270215,chr11,65270142,65270215,IMR90|chr11:291632-291713,chr11,291632,291713,1,64978510
IMR90|chr11:65270143-65270250,chr11,65270143,65270250,IMR90|chr11:67809400-67809443,chr11,67809400,67809443,1,2539257
IMR90|chr11:65270156-65270215,chr11,65270156,65270215,IMR90|chr11:291632-291713,chr11,291632,291713,1,64978524
IMR90|chr11:65270161-65270204,chr11,65270161,65270204,IMR90|chr11:35551026-35551113,chr11,35551026,35551113,1,29719135
IMR90|chr11:65270203-65270350,chr11,65270203,65270350,IMR90|chr11:101786286-101786343,chr11,101786286,101786343,1,36516083
IMR90|chr11:65270218-65270268,chr11,65270218,65270268,IMR90|chr11:65407087-65407185,chr11,65407087,65407185,1,136869
IMR90|chr11:65270218-65270263,chr11,65270218,65270263,IMR90|chr11:65407087-65407185,chr11,65407087,65407185,1,136869
IMR90|chr11:65270218-65270256,chr11,65270218,65270256,IMR90|chr11:93474028-93474128,chr11,93474028,93474128,1,28203810
IMR90|chr11:65270227-65270250,chr11,65270227,65270250,IMR90|chr11:3398569-3398658,chr11,3398569,3398658,1,61871658
IMR90|chr11:65270301-65270394,chr11,65270301,65270394,IMR90|chr11:101786286-101786343,chr11,101786286,101786343,1,36515985
IMR90|chr11:65270487-65270510,chr11,65270487,65270510,IMR90|chr11:93466776-93466856,chr11,93466776,93466856,1,28196289
IMR90|chr11:65270525-65270670,chr11,65270525,65270670,IMR90|chr11:70054802-70054901,chr11,70054802,70054901,1,4784277
IMR90|chr11:65270526-65270670,chr11,65270526,65270670,IMR90|chr11:70054802-70054901,chr11,70054802,70054901,1,4784276
IMR90|chr11:65270529-65270575,chr11,65270529,65270575,IMR90|chr11:67809602-67809684,chr11,67809602,67809684,1,2539073
IMR90|chr11:65270552-65270678,chr11,65270552,65270678,IMR90|chr11:65344422-65344442,chr11,65344422,65344442,1,73870
IMR90|chr11:65270554-65270684,chr11,65270554,65270684,IMR90|chr11:65344422-65344442,chr11,65344422,65344442,1,73868
IMR90|chr11:65270620-65270670,chr11,65270620,65270670,IMR90|chr11:70054802-70054901,chr11,70054802,70054901,1,4784182
IMR90|chr11:65270750-65270855,chr11,65270750,65270855,IMR90|chr11:57090377-57090435,chr11,57090377,57090435,1,8180373
IMR90|chr11:65270764-65270856,chr11,65270764,65270856,IMR90|chr11:57090377-57090435,chr11,57090377,57090435,1,8180387
IMR90|chr11:65270910-65270942,chr11,65270910,65270942,IMR90|chr11:117016306-117016400,chr11,117016306,117016400,1,51745396
IMR90|chr11:65270910-65270941,chr11,65270910,65270941,IMR90|chr11:117016306-117016400,chr11,117016306,117016400,1,51745396
IMR90|chr11:65270910-65270930,chr11,65270910,65270930,IMR90|chr11:72432329-72432426,chr11,72432329,72432426,1,7161419
IMR90|chr11:65270910-65270928,chr11,65270910,65270928,IMR90|chr11:72432329-72432426,chr11,72432329,72432426,1,7161419
IMR90|chr11:65270979-65271046,chr11,65270979,65271046,IMR90|chr11:93477507-93477552,chr11,93477507,93477552,1,28206528
IMR90|chr11:65271068-65271091,chr11,65271068,65271091,IMR90|chr11:2401534-2401622,chr11,2401534,2401622,1,62869534
IMR90|chr11:65271178-65271206,chr11,65271178,65271206,IMR90|chr11:65347302-65347367,chr11,65347302,65347367,1,76124
IMR90|chr11:65271190-65271252,chr11,65271190,65271252,IMR90|chr11:2399643-2399763,chr11,2399643,2399763,1,62871547
IMR90|chr11:65271190-65271220,chr11,65271190,65271220,IMR90|chr11:2399643-2399763,chr11,2399643,2399763,1,62871547
IMR90|chr11:65271214-65271263,chr11,65271214,65271263,IMR90|chr11:3399654-3399755,chr11,3399654,3399755,1,61871560
IMR90|chr11:65271215-65271274,chr11,65271215,65271274,IMR90|chr11:3399654-3399755,chr11,3399654,3399755,1,61871561
IMR90|chr11:65271415-65271433,chr11,65271415,65271433,IMR90|chr11:66054390-66054474,chr11,66054390,66054474,1,782975
IMR90|chr11:65271530-65271596,chr11,65271530,65271596,IMR90|chr11:291445-291522,chr11,291445,291522,1,64980085
IMR90|chr11:65271531-65271608,chr11,65271531,65271608,IMR90|chr11:57508696-57508737,chr11,57508696,57508737,1,7762835
IMR90|chr11:65271531-65271607,chr11,65271531,65271607,IMR90|chr11:57508696-57508737,chr11,57508696,57508737,1,7762835
IMR90|chr11:65271531-65271596,chr11,65271531,65271596,IMR90|chr11:291445-291522,chr11,291445,291522,1,64980086
IMR90|chr11:65271531-65271582,chr11,65271531,65271582,IMR90|chr11:291445-291522,chr11,291445,291522,1,64980086
IMR90|chr11:65271602-65271647,chr11,65271602,65271647,IMR90|chr11:65478354-65478410,chr11,65478354,65478410,1,206752
IMR90|chr11:65271615-65271712,chr11,65271615,65271712,IMR90|chr11:93470637-93470692,chr11,93470637,93470692,1,28199022
IMR90|chr11:65271623-65271715,chr11,65271623,65271715,IMR90|chr11:93470637-93470692,chr11,93470637,93470692,1,28199014
IMR90|chr11:65271644-65271739,chr11,65271644,65271739,IMR90|chr11:65345146-65345165,chr11,65345146,65345165,1,73502
IMR90|chr11:65271647-65271705,chr11,65271647,65271705,IMR90|chr11:65287867-65287926,chr11,65287867,65287926,1,16220
IMR90|chr11:65271648-65271741,chr11,65271648,65271741,IMR90|chr11:79149829-79149861,chr11,79149829,79149861,1,13878181
IMR90|chr11:65271649-65271741,chr11,65271649,65271741,IMR90|chr11:79149829-79149861,chr11,79149829,79149861,1,13878180
IMR90|chr11:65271731-65271794,chr11,65271731,65271794,IMR90|chr11:67798762-67798797,chr11,67798762,67798797,1,2527031
IMR90|chr11:65271731-65271779,chr11,65271731,65271779,IMR90|chr11:67798762-67798797,chr11,67798762,67798797,1,2527031
IMR90|chr11:65271762-65271882,chr11,65271762,65271882,IMR90|chr11:46142097-46142143,chr11,46142097,46142143,1,19129665
IMR90|chr11:65271762-65271830,chr11,65271762,65271830,IMR90|chr11:46142097-46142143,chr11,46142097,46142143,1,19129665
IMR90|chr11:65271792-65271882,chr11,65271792,65271882,IMR90|chr11:46142097-46142143,chr11,46142097,46142143,1,19129695
IMR90|chr11:65271803-65271875,chr11,65271803,65271875,IMR90|chr11:3396142-3396197,chr11,3396142,3396197,1,61875661
IMR90|chr11:65271978-65272043,chr11,65271978,65272043,IMR90|chr11:66055004-66055078,chr11,66055004,66055078,1,783026
IMR90|chr11:65272030-65272062,chr11,65272030,65272062,IMR90|chr11:3396077-3396148,chr11,3396077,3396148,1,61875953
IMR90|chr11:65272030-65272059,chr11,65272030,65272059,IMR90|chr11:3396077-3396148,chr11,3396077,3396148,1,61875953
IMR90|chr11:65272033-65272062,chr11,65272033,65272062,IMR90|chr11:3396076-3396148,chr11,3396076,3396148,1,61875957
IMR90|chr11:65272070-65272154,chr11,65272070,65272154,IMR90|chr11:3399207-3399233,chr11,3399207,3399233,1,61872863
IMR90|chr11:65272078-65272140,chr11,65272078,65272140,IMR90|chr11:2403627-2403715,chr11,2403627,2403715,1,62868451
IMR90|chr11:65272080-65272177,chr11,65272080,65272177,IMR90|chr11:2403627-2403715,chr11,2403627,2403715,1,62868453
IMR90|chr11:65272136-65272183,chr11,65272136,65272183,IMR90|chr11:93466588-93466646,chr11,93466588,93466646,1,28194452
IMR90|chr11:65272152-65272189,chr11,65272152,65272189,IMR90|chr11:65478420-65478500,chr11,65478420,65478500,1,206268
IMR90|chr11:65272267-65272325,chr11,65272267,65272325,IMR90|chr11:93467034-93467110,chr11,93467034,93467110,1,28194767
IMR90|chr11:65272278-65272334,chr11,65272278,65272334,IMR90|chr11:79149075-79149164,chr11,79149075,79149164,1,13876797
IMR90|chr11:65272281-65272351,chr11,65272281,65272351,IMR90|chr11:93474278-93474385,chr11,93474278,93474385,1,28201997
IMR90|chr11:65272281-65272324,chr11,65272281,65272324,IMR90|chr11:93474278-93474385,chr11,93474278,93474385,1,28201997
IMR90|chr11:65272282-65272329,chr11,65272282,65272329,IMR90|chr11:10878692-10878728,chr11,10878692,10878728,1,54393590
IMR90|chr11:65272304-65272344,chr11,65272304,65272344,IMR90|chr11:67799439-67799515,chr11,67799439,67799515,1,2527135
IMR90|chr11:65272391-65272436,chr11,65272391,65272436,IMR90|chr11:66054238-66054351,chr11,66054238,66054351,1,781847
IMR90|chr11:65272391-65272428,chr11,65272391,65272428,IMR90|chr11:66054238-66054351,chr11,66054238,66054351,1,781847
IMR90|chr11:65272433-65272518,chr11,65272433,65272518,IMR90|chr11:35548097-35548124,chr11,35548097,35548124,1,29724336
IMR90|chr11:65272433-65272516,chr11,65272433,65272516,IMR90|chr11:35548097-35548124,chr11,35548097,35548124,1,29724336
IMR90|chr11:65272550-65272631,chr11,65272550,65272631,IMR90|chr11:65406716-65406748,chr11,65406716,65406748,1,134166
IMR90|chr11:65272578-65272695,chr11,65272578,65272695,IMR90|chr11:70050244-70050284,chr11,70050244,70050284,1,4777666
IMR90|chr11:65272578-65272688,chr11,65272578,65272688,IMR90|chr11:70050244-70050284,chr11,70050244,70050284,1,4777666
IMR90|chr11:65272581-65272638,chr11,65272581,65272638,IMR90|chr11:35548158-35548245,chr11,35548158,35548245,1,29724423
IMR90|chr11:65272583-65272722,chr11,65272583,65272722,IMR90|chr11:35548158-35548245,chr11,35548158,35548245,1,29724425
IMR90|chr11:65272585-65272693,chr11,65272585,65272693,IMR90|chr11:79149402-79149444,chr11,79149402,79149444,1,13876817
IMR90|chr11:65272586-65272696,chr11,65272586,65272696,IMR90|chr11:79149402-79149444,chr11,79149402,79149444,1,13876816
IMR90|chr11:65272665-65272703,chr11,65272665,65272703,IMR90|chr11:65030861-65030969,chr11,65030861,65030969,1,241804
IMR90|chr11:65272716-65272781,chr11,65272716,65272781,IMR90|chr11:65404910-65404961,chr11,65404910,65404961,1,132194
IMR90|chr11:65272749-65272882,chr11,65272749,65272882,IMR90|chr11:67809534-67809592,chr11,67809534,67809592,1,2536785
IMR90|chr11:65272768-65272867,chr11,65272768,65272867,IMR90|chr11:66053727-66053776,chr11,66053727,66053776,1,780959
IMR90|chr11:65272773-65272863,chr11,65272773,65272863,IMR90|chr11:65478713-65478747,chr11,65478713,65478747,1,205940
IMR90|chr11:65272782-65272877,chr11,65272782,65272877,IMR90|chr11:62651800-62651838,chr11,62651800,62651838,1,2620982
IMR90|chr11:65272790-65272882,chr11,65272790,65272882,IMR90|chr11:67809534-67809592,chr11,67809534,67809592,1,2536744
IMR90|chr11:65272795-65272870,chr11,65272795,65272870,IMR90|chr11:65288555-65288630,chr11,65288555,65288630,1,15760
IMR90|chr11:65272839-65272857,chr11,65272839,65272857,IMR90|chr11:93469807-93469869,chr11,93469807,93469869,1,28196968
IMR90|chr11:65272885-65272974,chr11,65272885,65272974,IMR90|chr11:93471936-93471997,chr11,93471936,93471997,1,28199051
IMR90|chr11:65272910-65272971,chr11,65272910,65272971,IMR90|chr11:72437273-72437309,chr11,72437273,72437309,1,7164363
IMR90|chr11:65272911-65273061,chr11,65272911,65273061,IMR90|chr11:93471936-93471997,chr11,93471936,93471997,1,28199025
IMR90|chr11:65272918-65273030,chr11,65272918,65273030,IMR90|chr11:8699484-8699522,chr11,8699484,8699522,1,56573434
IMR90|chr11:65272931-65273065,chr11,65272931,65273065,IMR90|chr11:8699052-8699076,chr11,8699052,8699076,1,56573879
IMR90|chr11:65272937-65273084,chr11,65272937,65273084,IMR90|chr11:8699484-8699522,chr11,8699484,8699522,1,56573453
IMR90|chr11:65272949-65273064,chr11,65272949,65273064,IMR90|chr11:8699052-8699076,chr11,8699052,8699076,1,56573897
IMR90|chr11:65272953-65273088,chr11,65272953,65273088,IMR90|chr11:291357-291392,chr11,291357,291392,1,64981596
IMR90|chr11:65272955-65273049,chr11,65272955,65273049,IMR90|chr11:65330650-65330722,chr11,65330650,65330722,1,57695
IMR90|chr11:65272961-65273070,chr11,65272961,65273070,IMR90|chr11:93474300-93474341,chr11,93474300,93474341,1,28201339
IMR90|chr11:65272961-65273056,chr11,65272961,65273056,IMR90|chr11:93474300-93474341,chr11,93474300,93474341,1,28201339
IMR90|chr11:65272970-65273022,chr11,65272970,65273022,IMR90|chr11:72437455-72437485,chr11,72437455,72437485,1,7164485
IMR90|chr11:65272971-65273049,chr11,65272971,65273049,IMR90|chr11:65330650-65330722,chr11,65330650,65330722,1,57679
IMR90|chr11:65272973-65273088,chr11,65272973,65273088,IMR90|chr11:291357-291392,chr11,291357,291392,1,64981616
IMR90|chr11:65272977-65273053,chr11,65272977,65273053,IMR90|chr11:66053727-66053776,chr11,66053727,66053776,1,780750
IMR90|chr11:65272993-65273037,chr11,65272993,65273037,IMR90|chr11:67809675-67809795,chr11,67809675,67809795,1,2536682
IMR90|chr11:65272993-65273023,chr11,65272993,65273023,IMR90|chr11:66054766-66054852,chr11,66054766,66054852,1,781773
IMR90|chr11:65272998-65273062,chr11,65272998,65273062,IMR90|chr11:65310984-65311064,chr11,65310984,65311064,1,37986
IMR90|chr11:65272999-65273081,chr11,65272999,65273081,IMR90|chr11:65310984-65311064,chr11,65310984,65311064,1,37985
IMR90|chr11:65272999-65273041,chr11,65272999,65273041,IMR90|chr11:6501676-6501721,chr11,6501676,6501721,1,58771323
IMR90|chr11:65273049-65273102,chr11,65273049,65273102,IMR90|chr11:65097558-65097639,chr11,65097558,65097639,1,175491
IMR90|chr11:65273050-65273102,chr11,65273050,65273102,IMR90|chr11:65097558-65097639,chr11,65097558,65097639,1,175492
IMR90|chr11:65273087-65273112,chr11,65273087,65273112,IMR90|chr11:65031589-65031665,chr11,65031589,65031665,1,241498
IMR90|chr11:65273096-65273193,chr11,65273096,65273193,IMR90|chr11:6501857-6501878,chr11,6501857,6501878,1,58771239
IMR90|chr11:65273097-65273193,chr11,65273097,65273193,IMR90|chr11:6501857-6501878,chr11,6501857,6501878,1,58771240
IMR90|chr11:65273432-65273527,chr11,65273432,65273527,IMR90|chr11:3398768-3398808,chr11,3398768,3398808,1,61874664
IMR90|chr11:65274268-65274362,chr11,65274268,65274362,IMR90|chr11:64103598-64103626,chr11,64103598,64103626,1,1170670
IMR90|chr11:65274268-65274350,chr11,65274268,65274350,IMR90|chr11:64103598-64103626,chr11,64103598,64103626,1,1170670
IMR90|chr11:65679078-65679107,chr11,65679078,65679107,IMR90|chr11:65656917-65657013,chr11,65656917,65657013,1,22161
IMR90|chr11:65679078-65679106,chr11,65679078,65679106,IMR90|chr11:65656917-65657013,chr11,65656917,65657013,1,22161
IMR90|chr11:65679079-65679106,chr11,65679079,65679106,IMR90|chr11:65656917-65657012,chr11,65656917,65657012,1,22162
IMR90|chr11:65885813-65885920,chr11,65885813,65885920,IMR90|chr11:65657082-65657114,chr11,65657082,65657114,1,228731
IMR90|chr11:65908865-65908895,chr11,65908865,65908895,IMR90|chr11:65656909-65657007,chr11,65656909,65657007,1,251956
IMR90|chr11:65957980-65958028,chr11,65957980,65958028,IMR90|chr11:46302529-46302650,chr11,46302529,46302650,1,19655451
IMR90|chr11:65957981-65958028,chr11,65957981,65958028,IMR90|chr11:46302529-46302650,chr11,46302529,46302650,1,19655452
IMR90|chr11:65957999-65958028,chr11,65957999,65958028,IMR90|chr11:46302529-46302650,chr11,46302529,46302650,1,19655470
IMR90|chr11:66940561-66940704,chr11,66940561,66940704,IMR90|chr11:66513908-66513972,chr11,66513908,66513972,1,426653
IMR90|chr11:66940566-66940647,chr11,66940566,66940647,IMR90|chr11:66513908-66513972,chr11,66513908,66513972,1,426658
IMR90|chr11:66940566-66940646,chr11,66940566,66940646,IMR90|chr11:66513908-66513972,chr11,66513908,66513972,1,426658
IMR90|chr11:67041017-67041068,chr11,67041017,67041068,IMR90|chr11:65407508-65407608,chr11,65407508,65407608,1,1633509
IMR90|chr11:67041018-67041068,chr11,67041018,67041068,IMR90|chr11:65407508-65407608,chr11,65407508,65407608,1,1633510
IMR90|chr11:67045201-67045290,chr11,67045201,67045290,IMR90|chr11:67206067-67206141,chr11,67206067,67206141,1,160866
IMR90|chr11:67045214-67045290,chr11,67045214,67045290,IMR90|chr11:67206067-67206141,chr11,67206067,67206141,1,160853
IMR90|chr11:69073064-69073163,chr11,69073064,69073163,IMR90|chr11:69458854-69458890,chr11,69458854,69458890,1,385790
IMR90|chr11:69075263-69075358,chr11,69075263,69075358,IMR90|chr11:96073281-96073306,chr11,96073281,96073306,1,26998018
IMR90|chr11:69077610-69077736,chr11,69077610,69077736,IMR90|chr11:69456904-69456928,chr11,69456904,69456928,1,379294
IMR90|chr11:69077627-69077777,chr11,69077627,69077777,IMR90|chr11:69456904-69456928,chr11,69456904,69456928,1,379277
IMR90|chr11:69174909-69174949,chr11,69174909,69174949,IMR90|chr11:62308729-62308838,chr11,62308729,62308838,1,6866180
IMR90|chr11:69174909-69174948,chr11,69174909,69174948,IMR90|chr11:62308729-62308838,chr11,62308729,62308838,1,6866180
IMR90|chr11:73041740-73041795,chr11,73041740,73041795,IMR90|chr11:63608074-63608104,chr11,63608074,63608104,1,9433666
IMR90|chr11:73041764-73041827,chr11,73041764,73041827,IMR90|chr11:63608075-63608105,chr11,63608075,63608105,1,9433689
IMR90|chr11:73065525-73065603,chr11,73065525,73065603,IMR90|chr11:66026929-66026974,chr11,66026929,66026974,1,7038596
IMR90|chr11:73065525-73065602,chr11,73065525,73065602,IMR90|chr11:66026929-66026974,chr11,66026929,66026974,1,7038596
IMR90|chr11:73065525-73065589,chr11,73065525,73065589,IMR90|chr11:66026929-66026974,chr11,66026929,66026974,1,7038596
IMR90|chr11:73065954-73065987,chr11,73065954,73065987,IMR90|chr11:65336951-65337039,chr11,65336951,65337039,1,7729003
IMR90|chr11:73065954-73065982,chr11,73065954,73065982,IMR90|chr11:65336951-65337039,chr11,65336951,65337039,1,7729003
IMR90|chr11:73065955-73065987,chr11,73065955,73065987,IMR90|chr11:65336951-65337039,chr11,65336951,65337039,1,7729004
IMR90|chr11:75218794-75218856,chr11,75218794,75218856,IMR90|chr11:75110715-75110846,chr11,75110715,75110846,1,108079
IMR90|chr11:78501493-78501551,chr11,78501493,78501551,IMR90|chr11:10318153-10318229,chr11,10318153,10318229,1,68183340
IMR90|chr11:78506052-78506102,chr11,78506052,78506102,IMR90|chr11:16760706-16760759,chr11,16760706,16760759,1,61745346
IMR90|chr11:78764652-78764696,chr11,78764652,78764696,IMR90|chr11:46614048-46614139,chr11,46614048,46614139,1,32150604
IMR90|chr11:78764653-78764696,chr11,78764653,78764696,IMR90|chr11:46614048-46614139,chr11,46614048,46614139,1,32150605
IMR90|chr11:78765057-78765126,chr11,78765057,78765126,IMR90|chr11:108094197-108094236,chr11,108094197,108094236,1,29329140
IMR90|chr11:78802188-78802206,chr11,78802188,78802206,IMR90|chr11:35165662-35165785,chr11,35165662,35165785,1,43636526
IMR90|chr11:78949418-78949476,chr11,78949418,78949476,IMR90|chr11:46613110-46613220,chr11,46613110,46613220,1,32336308
IMR90|chr11:78949437-78949477,chr11,78949437,78949477,IMR90|chr11:46613110-46613220,chr11,46613110,46613220,1,32336327
IMR90|chr11:78949446-78949477,chr11,78949446,78949477,IMR90|chr11:46613110-46613220,chr11,46613110,46613220,1,32336336
IMR90|chr11:79132739-79132818,chr11,79132739,79132818,IMR90|chr11:65156526-65156580,chr11,65156526,65156580,1,13976213
IMR90|chr11:79132743-79132818,chr11,79132743,79132818,IMR90|chr11:65156526-65156580,chr11,65156526,65156580,1,13976217
IMR90|chr11:88034390-88034447,chr11,88034390,88034447,IMR90|chr11:126858717-126858792,chr11,126858717,126858792,1,38824327
IMR90|chr11:88034392-88034447,chr11,88034392,88034447,IMR90|chr11:126858717-126858792,chr11,126858717,126858792,1,38824325
IMR90|chr11:88034413-88034447,chr11,88034413,88034447,IMR90|chr11:126858717-126858792,chr11,126858717,126858792,1,38824304
IMR90|chr11:88039829-88039859,chr11,88039829,88039859,IMR90|chr11:82869730-82869801,chr11,82869730,82869801,1,5170099
IMR90|chr11:88039829-88039856,chr11,88039829,88039856,IMR90|chr11:82869730-82869804,chr11,82869730,82869804,1,5170099
IMR90|chr11:95579070-95579137,chr11,95579070,95579137,IMR90|chr11:63582528-63582590,chr11,63582528,63582590,1,31996542
IMR90|chr11:95779018-95779067,chr11,95779018,95779067,IMR90|chr11:60611910-60612011,chr11,60611910,60612011,1,35167108
IMR90|chr11:95779019-95779066,chr11,95779019,95779066,IMR90|chr11:60611909-60611976,chr11,60611909,60611976,1,35167110
IMR90|chr11:95871430-95871503,chr11,95871430,95871503,IMR90|chr11:74694553-74694596,chr11,74694553,74694596,1,21176877
IMR90|chr11:95872618-95872641,chr11,95872618,95872641,IMR90|chr11:63934801-63934857,chr11,63934801,63934857,1,31937817
IMR90|chr11:95872620-95872641,chr11,95872620,95872641,IMR90|chr11:63934792-63934855,chr11,63934792,63934855,1,31937828
IMR90|chr11:95872654-95872674,chr11,95872654,95872674,IMR90|chr11:63934792-63934855,chr11,63934792,63934855,1,31937862
IMR90|chr11:95921134-95921168,chr11,95921134,95921168,IMR90|chr11:118981051-118981126,chr11,118981051,118981126,1,23059917
IMR90|chr11:95940282-95940356,chr11,95940282,95940356,IMR90|chr11:118952716-118952760,chr11,118952716,118952760,1,23012434
IMR90|chr11:95940284-95940356,chr11,95940284,95940356,IMR90|chr11:118952716-118952760,chr11,118952716,118952760,1,23012432
IMR90|chr11:95950151-95950266,chr11,95950151,95950266,IMR90|chr11:93472893-93472928,chr11,93472893,93472928,1,2477258
IMR90|chr11:95950151-95950261,chr11,95950151,95950261,IMR90|chr11:93472893-93472928,chr11,93472893,93472928,1,2477258
IMR90|chr11:95976490-95976567,chr11,95976490,95976567,IMR90|chr11:102961875-102961918,chr11,102961875,102961918,1,6985385
IMR90|chr11:95976490-95976565,chr11,95976490,95976565,IMR90|chr11:102961875-102961918,chr11,102961875,102961918,1,6985385
IMR90|chr11:95977785-95977873,chr11,95977785,95977873,IMR90|chr11:96122495-96122535,chr11,96122495,96122535,1,144710
IMR90|chr11:95977810-95977832,chr11,95977810,95977832,IMR90|chr11:96122495-96122544,chr11,96122495,96122544,1,144685
IMR90|chr11:95977815-95977873,chr11,95977815,95977873,IMR90|chr11:96122495-96122544,chr11,96122495,96122544,1,144680
IMR90|chr11:95977990-95978040,chr11,95977990,95978040,IMR90|chr11:102962159-102962210,chr11,102962159,102962210,1,6984169
IMR90|chr11:95993376-95993465,chr11,95993376,95993465,IMR90|chr11:62304202-62304277,chr11,62304202,62304277,1,33689174
IMR90|chr11:95993402-95993465,chr11,95993402,95993465,IMR90|chr11:62304202-62304277,chr11,62304202,62304277,1,33689200
IMR90|chr11:96002941-96002980,chr11,96002941,96002980,IMR90|chr11:62304603-62304695,chr11,62304603,62304695,1,33698338
IMR90|chr11:96004597-96004671,chr11,96004597,96004671,IMR90|chr11:93478870-93478935,chr11,93478870,93478935,1,2525727
IMR90|chr11:96006225-96006340,chr11,96006225,96006340,IMR90|chr11:118661277-118661316,chr11,118661277,118661316,1,22655052
IMR90|chr11:96010293-96010326,chr11,96010293,96010326,IMR90|chr11:62309250-62309355,chr11,62309250,62309355,1,33701043
IMR90|chr11:96031503-96031559,chr11,96031503,96031559,IMR90|chr11:93475655-93475738,chr11,93475655,93475738,1,2555848
IMR90|chr11:96031503-96031557,chr11,96031503,96031557,IMR90|chr11:93475655-93475738,chr11,93475655,93475738,1,2555848
IMR90|chr11:96032797-96032884,chr11,96032797,96032884,IMR90|chr11:118793191-118793237,chr11,118793191,118793237,1,22760394
IMR90|chr11:96049933-96050053,chr11,96049933,96050053,IMR90|chr11:93473399-93473424,chr11,93473399,93473424,1,2576534
IMR90|chr11:96049933-96050052,chr11,96049933,96050052,IMR90|chr11:93473399-93473424,chr11,93473399,93473424,1,2576534
IMR90|chr11:96052132-96052177,chr11,96052132,96052177,IMR90|chr11:118781654-118781716,chr11,118781654,118781716,1,22729522
IMR90|chr11:96052142-96052177,chr11,96052142,96052177,IMR90|chr11:118781605-118781639,chr11,118781605,118781639,1,22729463
IMR90|chr11:96066953-96066986,chr11,96066953,96066986,IMR90|chr11:64020065-64020149,chr11,64020065,64020149,1,32046888
IMR90|chr11:96066955-96066986,chr11,96066955,96066986,IMR90|chr11:64020090-64020149,chr11,64020090,64020149,1,32046865
IMR90|chr11:100572673-100572823,chr11,100572673,100572823,IMR90|chr11:93473206-93473327,chr11,93473206,93473327,1,7099467
IMR90|chr11:101992717-101992781,chr11,101992717,101992781,IMR90|chr11:102218645-102218708,chr11,102218645,102218708,1,225928
IMR90|chr11:101992784-101992812,chr11,101992784,101992812,IMR90|chr11:102218645-102218708,chr11,102218645,102218708,1,225861
IMR90|chr11:102022169-102022220,chr11,102022169,102022220,IMR90|chr11:102218099-102218194,chr11,102218099,102218194,1,195930
IMR90|chr11:102048934-102048965,chr11,102048934,102048965,IMR90|chr11:102218789-102218807,chr11,102218789,102218807,1,169855
IMR90|chr11:117085051-117085116,chr11,117085051,117085116,IMR90|chr11:65663763-65663790,chr11,65663763,65663790,1,51421288
IMR90|chr11:117085518-117085599,chr11,117085518,117085599,IMR90|chr11:65663549-65663602,chr11,65663549,65663602,1,51421969
IMR90|chr11:118488800-118488869,chr11,118488800,118488869,IMR90|chr11:118779668-118779698,chr11,118779668,118779698,1,290868
IMR90|chr11:118488802-118488869,chr11,118488802,118488869,IMR90|chr11:118779668-118779698,chr11,118779668,118779698,1,290866
IMR90|chr11:118490835-118490879,chr11,118490835,118490879,IMR90|chr11:118790499-118790543,chr11,118790499,118790543,1,299664
IMR90|chr11:118809453-118809526,chr11,118809453,118809526,IMR90|chr11:118309594-118309643,chr11,118309594,118309643,1,499859
IMR90|chr11:119100146-119100273,chr11,119100146,119100273,IMR90|chr11:117199879-117199902,chr11,117199879,117199902,1,1900267
IMR90|chr11:119100147-119100273,chr11,119100147,119100273,IMR90|chr11:117199879-117199902,chr11,117199879,117199902,1,1900268
IMR90|chr11:120236559-120236624,chr11,120236559,120236624,IMR90|chr11:126081857-126081934,chr11,126081857,126081934,1,5845298
IMR90|chr11:120237894-120237991,chr11,120237894,120237991,IMR90|chr11:13488009-13488062,chr11,13488009,13488062,1,106749885
IMR90|chr11:120282421-120282473,chr11,120282421,120282473,IMR90|chr11:123064938-123065016,chr11,123064938,123065016,1,2782517
IMR90|chr11:120282421-120282472,chr11,120282421,120282472,IMR90|chr11:123064938-123065016,chr11,123064938,123065016,1,2782517
IMR90|chr11:120290518-120290575,chr11,120290518,120290575,IMR90|chr11:10320406-10320484,chr11,10320406,10320484,1,109970112
IMR90|chr11:120290518-120290574,chr11,120290518,120290574,IMR90|chr11:10320406-10320484,chr11,10320406,10320484,1,109970112
IMR90|chr11:121919670-121919808,chr11,121919670,121919808,IMR90|chr11:120210021-120210060,chr11,120210021,120210060,1,1709649
IMR90|chr11:121919670-121919781,chr11,121919670,121919781,IMR90|chr11:120210021-120210060,chr11,120210021,120210060,1,1709649
IMR90|chr11:121949495-121949526,chr11,121949495,121949526,IMR90|chr11:118480086-118480236,chr11,118480086,118480236,1,3469409
IMR90|chr11:121949507-121949577,chr11,121949507,121949577,IMR90|chr11:3183275-3183318,chr11,3183275,3183318,1,118766232
IMR90|chr11:121959622-121959709,chr11,121959622,121959709,IMR90|chr11:120208142-120208165,chr11,120208142,120208165,1,1751480
IMR90|chr11:121959622-121959698,chr11,121959622,121959698,IMR90|chr11:120208142-120208165,chr11,120208142,120208165,1,1751480
IMR90|chr11:121968181-121968259,chr11,121968181,121968259,IMR90|chr11:3181528-3181578,chr11,3181528,3181578,1,118786653
IMR90|chr11:121968181-121968258,chr11,121968181,121968258,IMR90|chr11:3181528-3181578,chr11,3181528,3181578,1,118786653
IMR90|chr11:121976253-121976330,chr11,121976253,121976330,IMR90|chr11:120209795-120209836,chr11,120209795,120209836,1,1766458
IMR90|chr11:121977748-121977822,chr11,121977748,121977822,IMR90|chr11:120208360-120208393,chr11,120208360,120208393,1,1769388
IMR90|chr11:121977748-121977821,chr11,121977748,121977821,IMR90|chr11:120208360-120208393,chr11,120208360,120208393,1,1769388
IMR90|chr11:121993368-121993432,chr11,121993368,121993432,IMR90|chr11:123063210-123063297,chr11,123063210,123063297,1,1069842
IMR90|chr11:121993368-121993431,chr11,121993368,121993431,IMR90|chr11:123063210-123063297,chr11,123063210,123063297,1,1069842
IMR90|chr11:122000874-122000942,chr11,122000874,122000942,IMR90|chr11:79150527-79150572,chr11,79150527,79150572,1,42850347
IMR90|chr11:122000874-122000941,chr11,122000874,122000941,IMR90|chr11:79150527-79150572,chr11,79150527,79150572,1,42850347
IMR90|chr11:122005925-122006007,chr11,122005925,122006007,IMR90|chr11:130764333-130764366,chr11,130764333,130764366,1,8758408
IMR90|chr11:122005926-122006007,chr11,122005926,122006007,IMR90|chr11:130764333-130764366,chr11,130764333,130764366,1,8758407
IMR90|chr11:122007253-122007343,chr11,122007253,122007343,IMR90|chr11:8705155-8705185,chr11,8705155,8705185,1,113302098
IMR90|chr11:122007253-122007342,chr11,122007253,122007342,IMR90|chr11:8705155-8705184,chr11,8705155,8705184,1,113302098
IMR90|chr11:122034049-122034082,chr11,122034049,122034082,IMR90|chr11:74695933-74696050,chr11,74695933,74696050,1,47338116
IMR90|chr11:122034052-122034126,chr11,122034052,122034126,IMR90|chr11:74695930-74696006,chr11,74695930,74696006,1,47338122
IMR90|chr11:122038822-122038880,chr11,122038822,122038880,IMR90|chr11:123061014-123061078,chr11,123061014,123061078,1,1022192
IMR90|chr11:122045201-122045266,chr11,122045201,122045266,IMR90|chr11:123063287-123063330,chr11,123063287,123063330,1,1018086
IMR90|chr11:122045201-122045265,chr11,122045201,122045265,IMR90|chr11:123063287-123063330,chr11,123063287,123063330,1,1018086
IMR90|chr11:122049655-122049716,chr11,122049655,122049716,IMR90|chr11:120082245-120082320,chr11,120082245,120082320,1,1967410
IMR90|chr11:122068357-122068418,chr11,122068357,122068418,IMR90|chr11:74695323-74695356,chr11,74695323,74695356,1,47373034
IMR90|chr11:122068358-122068417,chr11,122068358,122068417,IMR90|chr11:74695323-74695356,chr11,74695323,74695356,1,47373035
IMR90|chr11:122073527-122073594,chr11,122073527,122073594,IMR90|chr11:120208647-120208691,chr11,120208647,120208691,1,1864880
IMR90|chr11:122534610-122534652,chr11,122534610,122534652,IMR90|chr11:118888196-118888318,chr11,118888196,118888318,1,3646414
IMR90|chr11:122534610-122534638,chr11,122534610,122534638,IMR90|chr11:118888196-118888318,chr11,118888196,118888318,1,3646414
IMR90|chr11:122534610-122534637,chr11,122534610,122534637,IMR90|chr11:118888196-118888318,chr11,118888196,118888318,1,3646414
IMR90|chr11:122541406-122541433,chr11,122541406,122541433,IMR90|chr11:77899267-77899343,chr11,77899267,77899343,1,44642139
IMR90|chr11:122563152-122563200,chr11,122563152,122563200,IMR90|chr11:14376220-14376324,chr11,14376220,14376324,1,108186932
IMR90|chr11:122563576-122563662,chr11,122563576,122563662,IMR90|chr11:96073885-96073915,chr11,96073885,96073915,1,26489691
IMR90|chr11:122569406-122569470,chr11,122569406,122569470,IMR90|chr11:14378403-14378450,chr11,14378403,14378450,1,108191003
IMR90|chr11:122579895-122579962,chr11,122579895,122579962,IMR90|chr11:122937216-122937319,chr11,122937216,122937319,1,357321
IMR90|chr11:122579918-122579962,chr11,122579918,122579962,IMR90|chr11:122937216-122937319,chr11,122937216,122937319,1,357298
IMR90|chr11:122595813-122595885,chr11,122595813,122595885,IMR90|chr11:93472013-93472119,chr11,93472013,93472119,1,29123800
IMR90|chr11:122595813-122595853,chr11,122595813,122595853,IMR90|chr11:93472013-93472119,chr11,93472013,93472119,1,29123800
IMR90|chr11:122606673-122606718,chr11,122606673,122606718,IMR90|chr11:93467033-93467086,chr11,93467033,93467086,1,29139640
IMR90|chr11:122606673-122606706,chr11,122606673,122606706,IMR90|chr11:93467033-93467086,chr11,93467033,93467086,1,29139640
IMR90|chr11:122608052-122608086,chr11,122608052,122608086,IMR90|chr11:65683775-65683819,chr11,65683775,65683819,1,56924277
IMR90|chr11:122608108-122608255,chr11,122608108,122608255,IMR90|chr11:122931749-122931791,chr11,122931749,122931791,1,323641
IMR90|chr11:122615785-122615838,chr11,122615785,122615838,IMR90|chr11:128388071-128388119,chr11,128388071,128388119,1,5772286
IMR90|chr11:122618469-122618487,chr11,122618469,122618487,IMR90|chr11:128390602-128390713,chr11,128390602,128390713,1,5772133
IMR90|chr11:122644950-122645068,chr11,122644950,122645068,IMR90|chr11:123064667-123064697,chr11,123064667,123064697,1,419717
IMR90|chr11:122644953-122645067,chr11,122644953,122645067,IMR90|chr11:123064667-123064697,chr11,123064667,123064697,1,419714
IMR90|chr11:122648919-122648976,chr11,122648919,122648976,IMR90|chr11:123062437-123062472,chr11,123062437,123062472,1,413518
IMR90|chr11:122981380-122981454,chr11,122981380,122981454,IMR90|chr11:122527589-122527628,chr11,122527589,122527628,1,453791
IMR90|chr11:122981381-122981454,chr11,122981381,122981454,IMR90|chr11:122527589-122527628,chr11,122527589,122527628,1,453792
IMR90|chr11:122981860-122981914,chr11,122981860,122981914,IMR90|chr11:122937268-122937306,chr11,122937268,122937306,1,44592
IMR90|chr11:122988202-122988271,chr11,122988202,122988271,IMR90|chr11:122937141-122937190,chr11,122937141,122937190,1,51061
IMR90|chr11:123009550-123009664,chr11,123009550,123009664,IMR90|chr11:122938735-122938815,chr11,122938735,122938815,1,70815
IMR90|chr11:123009596-123009664,chr11,123009596,123009664,IMR90|chr11:122938735-122938815,chr11,122938735,122938815,1,70861
IMR90|chr11:123033973-123034015,chr11,123033973,123034015,IMR90|chr11:122938779-122938862,chr11,122938779,122938862,1,95194
IMR90|chr11:123038177-123038278,chr11,123038177,123038278,IMR90|chr11:122928925-122928958,chr11,122928925,122928958,1,109252
IMR90|chr11:126207043-126207092,chr11,126207043,126207092,IMR90|chr11:74695683-74695740,chr11,74695683,74695740,1,51511360
IMR90|chr11:126207044-126207092,chr11,126207044,126207092,IMR90|chr11:74695683-74695740,chr11,74695683,74695740,1,51511361
IMR90|chr11:126209844-126209969,chr11,126209844,126209969,IMR90|chr11:126224095-126224130,chr11,126224095,126224130,1,14251
IMR90|chr11:126209854-126209969,chr11,126209854,126209969,IMR90|chr11:126224095-126224130,chr11,126224095,126224130,1,14241
IMR90|chr11:126212051-126212088,chr11,126212051,126212088,IMR90|chr11:126225363-126225397,chr11,126225363,126225397,1,13312
IMR90|chr11:126215182-126215269,chr11,126215182,126215269,IMR90|chr11:126224854-126224978,chr11,126224854,126224978,1,9672
IMR90|chr11:126216744-126216770,chr11,126216744,126216770,IMR90|chr11:126222313-126222437,chr11,126222313,126222437,1,5569
IMR90|chr11:126216812-126216961,chr11,126216812,126216961,IMR90|chr11:126222313-126222437,chr11,126222313,126222437,1,5501
IMR90|chr11:126217686-126217762,chr11,126217686,126217762,IMR90|chr11:126223442-126223516,chr11,126223442,126223516,1,5756
IMR90|chr11:126218050-126218099,chr11,126218050,126218099,IMR90|chr11:126222296-126222394,chr11,126222296,126222394,1,4246
IMR90|chr11:126218052-126218129,chr11,126218052,126218129,IMR90|chr11:126222296-126222394,chr11,126222296,126222394,1,4244
IMR90|chr11:126218206-126218230,chr11,126218206,126218230,IMR90|chr11:126224854-126225004,chr11,126224854,126225004,1,6648
IMR90|chr11:126219133-126219154,chr11,126219133,126219154,IMR90|chr11:126220891-126220952,chr11,126220891,126220952,1,1758
IMR90|chr11:126606261-126606295,chr11,126606261,126606295,IMR90|chr11:93464267-93464348,chr11,93464267,93464348,1,33141994
IMR90|chr11:126606262-126606295,chr11,126606262,126606295,IMR90|chr11:93464267-93464348,chr11,93464267,93464348,1,33141995
IMR90|chr11:126703814-126703863,chr11,126703814,126703863,IMR90|chr11:1782392-1782494,chr11,1782392,1782494,1,124921422
IMR90|chr11:126703816-126703864,chr11,126703816,126703864,IMR90|chr11:1782392-1782494,chr11,1782392,1782494,1,124921424
IMR90|chr11:126706115-126706166,chr11,126706115,126706166,IMR90|chr11:46300707-46300753,chr11,46300707,46300753,1,80405408
IMR90|chr11:126749783-126749832,chr11,126749783,126749832,IMR90|chr11:65637881-65637999,chr11,65637881,65637999,1,61111902
IMR90|chr11:126749804-126749832,chr11,126749804,126749832,IMR90|chr11:65637881-65637999,chr11,65637881,65637999,1,61111923
IMR90|chr11:126761809-126761841,chr11,126761809,126761841,IMR90|chr11:128389509-128389598,chr11,128389509,128389598,1,1627700
IMR90|chr11:126792344-126792409,chr11,126792344,126792409,IMR90|chr11:27720367-27720414,chr11,27720367,27720414,1,99071977
IMR90|chr11:126793903-126794021,chr11,126793903,126794021,IMR90|chr11:118794198-118794232,chr11,118794198,118794232,1,7999705
IMR90|chr11:126793910-126794022,chr11,126793910,126794022,IMR90|chr11:118794198-118794232,chr11,118794198,118794232,1,7999712
IMR90|chr11:126799148-126799193,chr11,126799148,126799193,IMR90|chr11:118790980-118791083,chr11,118790980,118791083,1,8008168
IMR90|chr11:126799149-126799193,chr11,126799149,126799193,IMR90|chr11:118790980-118791083,chr11,118790980,118791083,1,8008169
IMR90|chr11:130290231-130290250,chr11,130290231,130290250,IMR90|chr11:67157335-67157447,chr11,67157335,67157447,1,63132896
IMR90|chr11:130290231-130290249,chr11,130290231,130290249,IMR90|chr11:67157335-67157447,chr11,67157335,67157447,1,63132896
IMR90|chr11:131769322-131769366,chr11,131769322,131769366,IMR90|chr11:291266-291405,chr11,291266,291405,1,131478056
IMR90|chr12:1458763-1458825,chr12,1458763,1458825,IMR90|chr12:1685938-1685977,chr12,1685938,1685977,1,227175
IMR90|chr12:1458764-1458825,chr12,1458764,1458825,IMR90|chr12:1685938-1685977,chr12,1685938,1685977,1,227174
IMR90|chr12:1539606-1539695,chr12,1539606,1539695,IMR90|chr12:72665169-72665207,chr12,72665169,72665207,1,71125563
IMR90|chr12:1539607-1539695,chr12,1539607,1539695,IMR90|chr12:72665169-72665207,chr12,72665169,72665207,1,71125562
IMR90|chr12:1668197-1668297,chr12,1668197,1668297,IMR90|chr12:6447814-6447863,chr12,6447814,6447863,1,4779617
IMR90|chr12:1690103-1690130,chr12,1690103,1690130,IMR90|chr12:1771621-1771738,chr12,1771621,1771738,1,81518
IMR90|chr12:1690111-1690131,chr12,1690111,1690131,IMR90|chr12:1771621-1771738,chr12,1771621,1771738,1,81510
IMR90|chr12:1691885-1691997,chr12,1691885,1691997,IMR90|chr12:1773033-1773072,chr12,1773033,1773072,1,81148
IMR90|chr12:1691885-1691996,chr12,1691885,1691996,IMR90|chr12:1773033-1773072,chr12,1773033,1773072,1,81148
IMR90|chr12:1698107-1698170,chr12,1698107,1698170,IMR90|chr12:46764030-46764117,chr12,46764030,46764117,1,45065923
IMR90|chr12:1698110-1698176,chr12,1698110,1698176,IMR90|chr12:46764030-46764117,chr12,46764030,46764117,1,45065920
IMR90|chr12:1733240-1733260,chr12,1733240,1733260,IMR90|chr12:123009053-123009152,chr12,123009053,123009152,1,121275813
IMR90|chr12:3226503-3226570,chr12,3226503,3226570,IMR90|chr12:49451427-49451464,chr12,49451427,49451464,1,46224924
IMR90|chr12:3226521-3226570,chr12,3226521,3226570,IMR90|chr12:49451427-49451464,chr12,49451427,49451464,1,46224906
IMR90|chr12:3236101-3236125,chr12,3236101,3236125,IMR90|chr12:57029284-57029332,chr12,57029284,57029332,1,53793183
IMR90|chr12:3236124-3236181,chr12,3236124,3236181,IMR90|chr12:57029309-57029386,chr12,57029309,57029386,1,53793185
IMR90|chr12:3330829-3330883,chr12,3330829,3330883,IMR90|chr12:30904867-30904963,chr12,30904867,30904963,1,27574038
IMR90|chr12:3330831-3330910,chr12,3330831,3330910,IMR90|chr12:30904867-30904963,chr12,30904867,30904963,1,27574036
IMR90|chr12:5555240-5555273,chr12,5555240,5555273,IMR90|chr12:13351388-13351471,chr12,13351388,13351471,1,7796148
IMR90|chr12:5597646-5597735,chr12,5597646,5597735,IMR90|chr12:13350952-13351014,chr12,13350952,13351014,1,7753306
IMR90|chr12:5597648-5597736,chr12,5597648,5597736,IMR90|chr12:13350952-13351014,chr12,13350952,13351014,1,7753304
IMR90|chr12:6292488-6292533,chr12,6292488,6292533,IMR90|chr12:6304160-6304235,chr12,6304160,6304235,1,11672
IMR90|chr12:6434459-6434501,chr12,6434459,6434501,IMR90|chr12:6447724-6447834,chr12,6447724,6447834,1,13265
IMR90|chr12:6434474-6434501,chr12,6434474,6434501,IMR90|chr12:6447724-6447834,chr12,6447724,6447834,1,13250
IMR90|chr12:6435869-6435984,chr12,6435869,6435984,IMR90|chr12:6450208-6450226,chr12,6450208,6450226,1,14339
IMR90|chr12:6435869-6435976,chr12,6435869,6435976,IMR90|chr12:6450208-6450226,chr12,6450208,6450226,1,14339
IMR90|chr12:6437793-6437821,chr12,6437793,6437821,IMR90|chr12:6449703-6449800,chr12,6449703,6449800,1,11910
IMR90|chr12:7044362-7044430,chr12,7044362,7044430,IMR90|chr12:1642913-1642951,chr12,1642913,1642951,1,5401449
IMR90|chr12:7044366-7044430,chr12,7044366,7044430,IMR90|chr12:1642913-1642955,chr12,1642913,1642955,1,5401453
IMR90|chr12:8141012-8141098,chr12,8141012,8141098,IMR90|chr12:8091484-8091546,chr12,8091484,8091546,1,49528
IMR90|chr12:8141012-8141096,chr12,8141012,8141096,IMR90|chr12:8089555-8089617,chr12,8089555,8089617,1,51457
IMR90|chr12:12900135-12900187,chr12,12900135,12900187,IMR90|chr12:50417701-50417823,chr12,50417701,50417823,1,37517566
IMR90|chr12:12900159-12900187,chr12,12900159,12900187,IMR90|chr12:50417701-50417823,chr12,50417701,50417823,1,37517542
IMR90|chr12:13026766-13026846,chr12,13026766,13026846,IMR90|chr12:13041449-13041524,chr12,13041449,13041524,1,14683
IMR90|chr12:13026766-13026841,chr12,13026766,13026841,IMR90|chr12:13041449-13041524,chr12,13041449,13041524,1,14683
IMR90|chr12:13029111-13029257,chr12,13029111,13029257,IMR90|chr12:13039809-13039908,chr12,13039809,13039908,1,10698
IMR90|chr12:13029201-13029252,chr12,13029201,13029252,IMR90|chr12:13039809-13039908,chr12,13039809,13039908,1,10608
IMR90|chr12:13031390-13031512,chr12,13031390,13031512,IMR90|chr12:13042826-13042854,chr12,13042826,13042854,1,11436
IMR90|chr12:13031453-13031600,chr12,13031453,13031600,IMR90|chr12:13042826-13042854,chr12,13042826,13042854,1,11373
IMR90|chr12:13037301-13037319,chr12,13037301,13037319,IMR90|chr12:13042389-13042430,chr12,13042389,13042430,1,5088
IMR90|chr12:13037574-13037654,chr12,13037574,13037654,IMR90|chr12:13039289-13039359,chr12,13039289,13039359,1,1715
IMR90|chr12:13037575-13037678,chr12,13037575,13037678,IMR90|chr12:13039289-13039359,chr12,13039289,13039359,1,1714
IMR90|chr12:13037622-13037700,chr12,13037622,13037700,IMR90|chr12:13039230-13039302,chr12,13039230,13039302,1,1608
IMR90|chr12:13314038-13314120,chr12,13314038,13314120,IMR90|chr12:13345332-13345452,chr12,13345332,13345452,1,31294
IMR90|chr12:13314090-13314120,chr12,13314090,13314120,IMR90|chr12:13345332-13345452,chr12,13345332,13345452,1,31242
IMR90|chr12:13394780-13394871,chr12,13394780,13394871,IMR90|chr12:7245541-7245582,chr12,7245541,7245582,1,6149239
IMR90|chr12:19348152-19348225,chr12,19348152,19348225,IMR90|chr12:10874917-10874992,chr12,10874917,10874992,1,8473235
IMR90|chr12:19348153-19348223,chr12,19348153,19348223,IMR90|chr12:10874917-10874992,chr12,10874917,10874992,1,8473236
IMR90|chr12:24715515-24715601,chr12,24715515,24715601,IMR90|chr12:53835926-53836019,chr12,53835926,53836019,1,29120411
IMR90|chr12:25070055-25070115,chr12,25070055,25070115,IMR90|chr12:46759694-46759767,chr12,46759694,46759767,1,21689639
IMR90|chr12:25070055-25070113,chr12,25070055,25070113,IMR90|chr12:46759694-46759767,chr12,46759694,46759767,1,21689639
IMR90|chr12:25076566-25076683,chr12,25076566,25076683,IMR90|chr12:46763086-46763143,chr12,46763086,46763143,1,21686520
IMR90|chr12:25076590-25076683,chr12,25076590,25076683,IMR90|chr12:46763086-46763143,chr12,46763086,46763143,1,21686496
IMR90|chr12:25392779-25392893,chr12,25392779,25392893,IMR90|chr12:25101280-25101306,chr12,25101280,25101306,1,291499
IMR90|chr12:26940023-26940103,chr12,26940023,26940103,IMR90|chr12:49663176-49663231,chr12,49663176,49663231,1,22723153
IMR90|chr12:27740268-27740339,chr12,27740268,27740339,IMR90|chr12:27237498-27237530,chr12,27237498,27237530,1,502770
IMR90|chr12:27740268-27740302,chr12,27740268,27740302,IMR90|chr12:27237498-27237530,chr12,27237498,27237530,1,502770
IMR90|chr12:27744198-27744242,chr12,27744198,27744242,IMR90|chr12:27240139-27240266,chr12,27240139,27240266,1,504059
IMR90|chr12:29742715-29742739,chr12,29742715,29742739,IMR90|chr12:4758380-4758517,chr12,4758380,4758517,1,24984335
IMR90|chr12:29742716-29742739,chr12,29742716,29742739,IMR90|chr12:4758380-4758517,chr12,4758380,4758517,1,24984336
IMR90|chr12:31729955-31729992,chr12,31729955,31729992,IMR90|chr12:6714515-6714561,chr12,6714515,6714561,1,25015440
IMR90|chr12:32701733-32701783,chr12,32701733,32701783,IMR90|chr12:21655942-21656041,chr12,21655942,21656041,1,11045791
IMR90|chr12:32701733-32701774,chr12,32701733,32701774,IMR90|chr12:21655942-21656041,chr12,21655942,21656041,1,11045791
IMR90|chr12:32701734-32701797,chr12,32701734,32701797,IMR90|chr12:21655942-21656041,chr12,21655942,21656041,1,11045792
IMR90|chr12:32713703-32713768,chr12,32713703,32713768,IMR90|chr12:6659234-6659302,chr12,6659234,6659302,1,26054469
IMR90|chr12:43730321-43730387,chr12,43730321,43730387,IMR90|chr12:122059708-122059773,chr12,122059708,122059773,1,78329387
IMR90|chr12:43730323-43730387,chr12,43730323,43730387,IMR90|chr12:122059708-122059775,chr12,122059708,122059775,1,78329385
IMR90|chr12:45622635-45622694,chr12,45622635,45622694,IMR90|chr12:21809856-21809903,chr12,21809856,21809903,1,23812779
IMR90|chr12:45651013-45651077,chr12,45651013,45651077,IMR90|chr12:49452042-49452144,chr12,49452042,49452144,1,3801029
IMR90|chr12:45651057-45651077,chr12,45651057,45651077,IMR90|chr12:49452042-49452144,chr12,49452042,49452144,1,3800985
IMR90|chr12:45654601-45654669,chr12,45654601,45654669,IMR90|chr12:13351331-13351472,chr12,13351331,13351472,1,32303270
IMR90|chr12:45726093-45726210,chr12,45726093,45726210,IMR90|chr12:13345770-13345796,chr12,13345770,13345796,1,32380323
IMR90|chr12:45726167-45726210,chr12,45726167,45726210,IMR90|chr12:13345770-13345796,chr12,13345770,13345796,1,32380397
IMR90|chr12:46363122-46363182,chr12,46363122,46363182,IMR90|chr12:46659771-46659842,chr12,46659771,46659842,1,296649
IMR90|chr12:46363123-46363182,chr12,46363123,46363182,IMR90|chr12:46659771-46659842,chr12,46659771,46659842,1,296648
IMR90|chr12:46833796-46833873,chr12,46833796,46833873,IMR90|chr12:51610576-51610637,chr12,51610576,51610637,1,4776780
IMR90|chr12:46889315-46889341,chr12,46889315,46889341,IMR90|chr12:51612939-51612966,chr12,51612939,51612966,1,4723624
IMR90|chr12:46889316-46889341,chr12,46889316,46889341,IMR90|chr12:51612939-51612966,chr12,51612939,51612966,1,4723623
IMR90|chr12:49904805-49904895,chr12,49904805,49904895,IMR90|chr12:49659142-49659201,chr12,49659142,49659201,1,245663
IMR90|chr12:49904805-49904894,chr12,49904805,49904894,IMR90|chr12:49659142-49659201,chr12,49659142,49659201,1,245663
IMR90|chr12:50092403-50092459,chr12,50092403,50092459,IMR90|chr12:49659629-49659683,chr12,49659629,49659683,1,432774
IMR90|chr12:50092404-50092459,chr12,50092404,50092459,IMR90|chr12:49659629-49659683,chr12,49659629,49659683,1,432775
IMR90|chr12:50701514-50701647,chr12,50701514,50701647,IMR90|chr12:50679207-50679307,chr12,50679207,50679307,1,22307
IMR90|chr12:50706596-50706702,chr12,50706596,50706702,IMR90|chr12:50681972-50682118,chr12,50681972,50682118,1,24624
IMR90|chr12:51071317-51071398,chr12,51071317,51071398,IMR90|chr12:53397783-53397821,chr12,53397783,53397821,1,2326466
IMR90|chr12:51071365-51071398,chr12,51071365,51071398,IMR90|chr12:53397783-53397821,chr12,53397783,53397821,1,2326418
IMR90|chr12:51515459-51515551,chr12,51515459,51515551,IMR90|chr12:51480363-51480427,chr12,51480363,51480427,1,35096
IMR90|chr12:51515465-51515551,chr12,51515465,51515551,IMR90|chr12:51480363-51480427,chr12,51480363,51480427,1,35102
IMR90|chr12:56600826-56600871,chr12,56600826,56600871,IMR90|chr12:6877901-6877931,chr12,6877901,6877931,1,49722925
IMR90|chr12:56926176-56926259,chr12,56926176,56926259,IMR90|chr12:56620643-56620671,chr12,56620643,56620671,1,305533
IMR90|chr12:56929189-56929269,chr12,56929189,56929269,IMR90|chr12:56884721-56884768,chr12,56884721,56884768,1,44468
IMR90|chr12:56930499-56930595,chr12,56930499,56930595,IMR90|chr12:49214902-49214982,chr12,49214902,49214982,1,7715597
IMR90|chr12:59273996-59274076,chr12,59273996,59274076,IMR90|chr12:46759466-46759607,chr12,46759466,46759607,1,12514530
IMR90|chr12:59280903-59281030,chr12,59280903,59281030,IMR90|chr12:65005255-65005281,chr12,65005255,65005281,1,5724352
IMR90|chr12:59280907-59281031,chr12,59280907,59281031,IMR90|chr12:65005255-65005281,chr12,65005255,65005281,1,5724348
IMR90|chr12:64284298-64284353,chr12,64284298,64284353,IMR90|chr12:66220212-66220285,chr12,66220212,66220285,1,1935914
IMR90|chr12:64284302-64284353,chr12,64284302,64284353,IMR90|chr12:66220212-66220285,chr12,66220212,66220285,1,1935910
IMR90|chr12:64287689-64287758,chr12,64287689,64287758,IMR90|chr12:77458923-77459037,chr12,77458923,77459037,1,13171234
IMR90|chr12:64315789-64315853,chr12,64315789,64315853,IMR90|chr12:66220970-66221021,chr12,66220970,66221021,1,1905181
IMR90|chr12:64325639-64325693,chr12,64325639,64325693,IMR90|chr12:16501528-16501624,chr12,16501528,16501624,1,47824111
IMR90|chr12:64427992-64428072,chr12,64427992,64428072,IMR90|chr12:16502334-16502387,chr12,16502334,16502387,1,47925658
IMR90|chr12:64427993-64428072,chr12,64427993,64428072,IMR90|chr12:16502334-16502387,chr12,16502334,16502387,1,47925659
IMR90|chr12:65727757-65727798,chr12,65727757,65727798,IMR90|chr12:110317479-110317585,chr12,110317479,110317585,1,44589722
IMR90|chr12:65727758-65727798,chr12,65727758,65727798,IMR90|chr12:110317479-110317585,chr12,110317479,110317585,1,44589721
IMR90|chr12:65805607-65805677,chr12,65805607,65805677,IMR90|chr12:66220313-66220393,chr12,66220313,66220393,1,414706
IMR90|chr12:65805993-65806080,chr12,65805993,65806080,IMR90|chr12:66216760-66216805,chr12,66216760,66216805,1,410767
IMR90|chr12:65805993-65806079,chr12,65805993,65806079,IMR90|chr12:66216760-66216805,chr12,66216760,66216805,1,410767
IMR90|chr12:65822472-65822540,chr12,65822472,65822540,IMR90|chr12:66220438-66220511,chr12,66220438,66220511,1,397966
IMR90|chr12:65822473-65822540,chr12,65822473,65822540,IMR90|chr12:66220438-66220511,chr12,66220438,66220511,1,397965
IMR90|chr12:65826128-65826188,chr12,65826128,65826188,IMR90|chr12:66220913-66221011,chr12,66220913,66221011,1,394785
IMR90|chr12:65826192-65826213,chr12,65826192,65826213,IMR90|chr12:66220913-66221011,chr12,66220913,66221011,1,394721
IMR90|chr12:65953964-65954031,chr12,65953964,65954031,IMR90|chr12:51313870-51313953,chr12,51313870,51313953,1,14640094
IMR90|chr12:65953965-65954054,chr12,65953965,65954054,IMR90|chr12:51313870-51313953,chr12,51313870,51313953,1,14640095
IMR90|chr12:66226106-66226157,chr12,66226106,66226157,IMR90|chr12:54671874-54671931,chr12,54671874,54671931,1,11554232
IMR90|chr12:66226675-66226712,chr12,66226675,66226712,IMR90|chr12:42623982-42624092,chr12,42623982,42624092,1,23602693
IMR90|chr12:66227595-66227672,chr12,66227595,66227672,IMR90|chr12:76477333-76477357,chr12,76477333,76477357,1,10249738
IMR90|chr12:66228206-66228327,chr12,66228206,66228327,IMR90|chr12:72233991-72234012,chr12,72233991,72234012,1,6005785
IMR90|chr12:66229720-66229756,chr12,66229720,66229756,IMR90|chr12:98989156-98989227,chr12,98989156,98989227,1,32759436
IMR90|chr12:66231399-66231460,chr12,66231399,66231460,IMR90|chr12:79261789-79261877,chr12,79261789,79261877,1,13030390
IMR90|chr12:66233925-66234026,chr12,66233925,66234026,IMR90|chr12:98990098-98990144,chr12,98990098,98990144,1,32756173
IMR90|chr12:66234037-66234083,chr12,66234037,66234083,IMR90|chr12:1700929-1701020,chr12,1700929,1701020,1,64533108
IMR90|chr12:66234150-66234223,chr12,66234150,66234223,IMR90|chr12:64799223-64799247,chr12,64799223,64799247,1,1434927
IMR90|chr12:66234151-66234223,chr12,66234151,66234223,IMR90|chr12:64799223-64799247,chr12,64799223,64799247,1,1434928
IMR90|chr12:66234224-66234327,chr12,66234224,66234327,IMR90|chr12:57116126-57116145,chr12,57116126,57116145,1,9118098
IMR90|chr12:66234224-66234326,chr12,66234224,66234326,IMR90|chr12:57116126-57116145,chr12,57116126,57116145,1,9118098
IMR90|chr12:66234260-66234298,chr12,66234260,66234298,IMR90|chr12:42724049-42724111,chr12,42724049,42724111,1,23510211
IMR90|chr12:66234260-66234297,chr12,66234260,66234297,IMR90|chr12:42724049-42724111,chr12,42724049,42724111,1,23510211
IMR90|chr12:66234347-66234410,chr12,66234347,66234410,IMR90|chr12:64238707-64238763,chr12,64238707,64238763,1,1995640
IMR90|chr12:66234406-66234439,chr12,66234406,66234439,IMR90|chr12:57115418-57115442,chr12,57115418,57115442,1,9118988
IMR90|chr12:66234667-66234699,chr12,66234667,66234699,IMR90|chr12:1701522-1701640,chr12,1701522,1701640,1,64533145
IMR90|chr12:66234668-66234729,chr12,66234668,66234729,IMR90|chr12:1701522-1701640,chr12,1701522,1701640,1,64533146
IMR90|chr12:66235167-66235236,chr12,66235167,66235236,IMR90|chr12:68044696-68044777,chr12,68044696,68044777,1,1809529
IMR90|chr12:66236290-66236384,chr12,66236290,66236384,IMR90|chr12:133404526-133404576,chr12,133404526,133404576,1,67168236
IMR90|chr12:66237662-66237761,chr12,66237662,66237761,IMR90|chr12:120885014-120885041,chr12,120885014,120885041,1,54647352
IMR90|chr12:66239740-66239774,chr12,66239740,66239774,IMR90|chr12:69005399-69005470,chr12,69005399,69005470,1,2765659
IMR90|chr12:66239741-66239774,chr12,66239741,66239774,IMR90|chr12:69005399-69005470,chr12,69005399,69005470,1,2765658
IMR90|chr12:66239765-66239784,chr12,66239765,66239784,IMR90|chr12:133399711-133399733,chr12,133399711,133399733,1,67159946
IMR90|chr12:66239786-66239907,chr12,66239786,66239907,IMR90|chr12:57118118-57118147,chr12,57118118,57118147,1,9121668
IMR90|chr12:66239787-66239906,chr12,66239787,66239906,IMR90|chr12:57118118-57118147,chr12,57118118,57118147,1,9121669
IMR90|chr12:66239878-66239936,chr12,66239878,66239936,IMR90|chr12:76423846-76423900,chr12,76423846,76423900,1,10183968
IMR90|chr12:66241474-66241508,chr12,66241474,66241508,IMR90|chr12:88536639-88536737,chr12,88536639,88536737,1,22295165
IMR90|chr12:66244666-66244733,chr12,66244666,66244733,IMR90|chr12:57523931-57523976,chr12,57523931,57523976,1,8720735
IMR90|chr12:66245006-66245114,chr12,66245006,66245114,IMR90|chr12:42722886-42722919,chr12,42722886,42722919,1,23522120
IMR90|chr12:66245037-66245119,chr12,66245037,66245119,IMR90|chr12:64799533-64799563,chr12,64799533,64799563,1,1445504
IMR90|chr12:66245860-66245974,chr12,66245860,66245974,IMR90|chr12:121129820-121129964,chr12,121129820,121129964,1,54883960
IMR90|chr12:66247148-66247193,chr12,66247148,66247193,IMR90|chr12:76424085-76424167,chr12,76424085,76424167,1,10176937
IMR90|chr12:66247149-66247193,chr12,66247149,66247193,IMR90|chr12:76424085-76424167,chr12,76424085,76424167,1,10176936
IMR90|chr12:66247171-66247253,chr12,66247171,66247253,IMR90|chr12:57524331-57524368,chr12,57524331,57524368,1,8722840
IMR90|chr12:66248523-66248561,chr12,66248523,66248561,IMR90|chr12:121128000-121128105,chr12,121128000,121128105,1,54879477
IMR90|chr12:66248743-66248821,chr12,66248743,66248821,IMR90|chr12:46761484-46761527,chr12,46761484,46761527,1,19487259
IMR90|chr12:66249207-66249316,chr12,66249207,66249316,IMR90|chr12:28127023-28127089,chr12,28127023,28127089,1,38122184
IMR90|chr12:66254691-66254712,chr12,66254691,66254712,IMR90|chr12:98988417-98988443,chr12,98988417,98988443,1,32733726
IMR90|chr12:66254692-66254723,chr12,66254692,66254723,IMR90|chr12:98988421-98988443,chr12,98988421,98988443,1,32733729
IMR90|chr12:66254964-66255028,chr12,66254964,66255028,IMR90|chr12:64800263-64800375,chr12,64800263,64800375,1,1454701
IMR90|chr12:66254990-66255028,chr12,66254990,66255028,IMR90|chr12:64800263-64800375,chr12,64800263,64800375,1,1454727
IMR90|chr12:66255034-66255170,chr12,66255034,66255170,IMR90|chr12:111803726-111803746,chr12,111803726,111803746,1,45548692
IMR90|chr12:66255034-66255152,chr12,66255034,66255152,IMR90|chr12:111803726-111803746,chr12,111803726,111803746,1,45548692
IMR90|chr12:66255590-66255641,chr12,66255590,66255641,IMR90|chr12:46761261-46761289,chr12,46761261,46761289,1,19494329
IMR90|chr12:66255641-66255781,chr12,66255641,66255781,IMR90|chr12:46761261-46761289,chr12,46761261,46761289,1,19494380
IMR90|chr12:66255649-66255770,chr12,66255649,66255770,IMR90|chr12:28124246-28124264,chr12,28124246,28124264,1,38131403
IMR90|chr12:66255748-66255824,chr12,66255748,66255824,IMR90|chr12:49109428-49109480,chr12,49109428,49109480,1,17146320
IMR90|chr12:66255749-66255824,chr12,66255749,66255824,IMR90|chr12:49109428-49109480,chr12,49109428,49109480,1,17146321
IMR90|chr12:66256611-66256658,chr12,66256611,66256658,IMR90|chr12:56368582-56368669,chr12,56368582,56368669,1,9888029
IMR90|chr12:66256612-66256658,chr12,66256612,66256658,IMR90|chr12:56368582-56368669,chr12,56368582,56368669,1,9888030
IMR90|chr12:66259378-66259407,chr12,66259378,66259407,IMR90|chr12:133400611-133400715,chr12,133400611,133400715,1,67141233
IMR90|chr12:66259491-66259552,chr12,66259491,66259552,IMR90|chr12:46761685-46761734,chr12,46761685,46761734,1,19497806
IMR90|chr12:66259748-66259798,chr12,66259748,66259798,IMR90|chr12:1699954-1700043,chr12,1699954,1700043,1,64559794
IMR90|chr12:66260519-66260557,chr12,66260519,66260557,IMR90|chr12:109247357-109247400,chr12,109247357,109247400,1,42986838
IMR90|chr12:66261447-66261530,chr12,66261447,66261530,IMR90|chr12:64240414-64240513,chr12,64240414,64240513,1,2021033
IMR90|chr12:66261480-66261531,chr12,66261480,66261531,IMR90|chr12:64240414-64240513,chr12,64240414,64240513,1,2021066
IMR90|chr12:66262229-66262317,chr12,66262229,66262317,IMR90|chr12:111805014-111805051,chr12,111805014,111805051,1,45542785
IMR90|chr12:66263689-66263809,chr12,66263689,66263809,IMR90|chr12:125402610-125402636,chr12,125402610,125402636,1,59138921
IMR90|chr12:66264794-66264819,chr12,66264794,66264819,IMR90|chr12:1699905-1699932,chr12,1699905,1699932,1,64564889
IMR90|chr12:66265108-66265146,chr12,66265108,66265146,IMR90|chr12:57039331-57039400,chr12,57039331,57039400,1,9225777
IMR90|chr12:66265108-66265145,chr12,66265108,66265145,IMR90|chr12:57039331-57039400,chr12,57039331,57039400,1,9225777
IMR90|chr12:66265108-66265143,chr12,66265108,66265143,IMR90|chr12:57039331-57039400,chr12,57039331,57039400,1,9225777
IMR90|chr12:66265163-66265216,chr12,66265163,66265216,IMR90|chr12:125395982-125396035,chr12,125395982,125396035,1,59130819
IMR90|chr12:66265163-66265215,chr12,66265163,66265215,IMR90|chr12:125395982-125396036,chr12,125395982,125396036,1,59130819
IMR90|chr12:66265681-66265766,chr12,66265681,66265766,IMR90|chr12:1700848-1700913,chr12,1700848,1700913,1,64564833
IMR90|chr12:66265683-66265768,chr12,66265683,66265768,IMR90|chr12:1700848-1700913,chr12,1700848,1700913,1,64564835
IMR90|chr12:66266471-66266525,chr12,66266471,66266525,IMR90|chr12:64800194-64800244,chr12,64800194,64800244,1,1466277
IMR90|chr12:66266489-66266525,chr12,66266489,66266525,IMR90|chr12:77458918-77458996,chr12,77458918,77458996,1,11192429
IMR90|chr12:66269234-66269305,chr12,66269234,66269305,IMR90|chr12:54671646-54671698,chr12,54671646,54671698,1,11597588
IMR90|chr12:66269236-66269305,chr12,66269236,66269305,IMR90|chr12:54671646-54671698,chr12,54671646,54671698,1,11597590
IMR90|chr12:66269520-66269544,chr12,66269520,66269544,IMR90|chr12:79261793-79261877,chr12,79261793,79261877,1,12992273
IMR90|chr12:66270209-66270243,chr12,66270209,66270243,IMR90|chr12:64238013-64238117,chr12,64238013,64238117,1,2032196
IMR90|chr12:66270209-66270242,chr12,66270209,66270242,IMR90|chr12:64238013-64238117,chr12,64238013,64238117,1,2032196
IMR90|chr12:66270296-66270387,chr12,66270296,66270387,IMR90|chr12:64801572-64801626,chr12,64801572,64801626,1,1468724
IMR90|chr12:66270299-66270387,chr12,66270299,66270387,IMR90|chr12:64801572-64801626,chr12,64801572,64801626,1,1468727
IMR90|chr12:66270307-66270361,chr12,66270307,66270361,IMR90|chr12:69005993-69006083,chr12,69005993,69006083,1,2735686
IMR90|chr12:66281158-66281253,chr12,66281158,66281253,IMR90|chr12:58002052-58002081,chr12,58002052,58002081,1,8279106
IMR90|chr12:66281352-66281413,chr12,66281352,66281413,IMR90|chr12:52346515-52346558,chr12,52346515,52346558,1,13934837
IMR90|chr12:66281353-66281413,chr12,66281353,66281413,IMR90|chr12:52346515-52346558,chr12,52346515,52346558,1,13934838
IMR90|chr12:66281860-66281921,chr12,66281860,66281921,IMR90|chr12:57037461-57037522,chr12,57037461,57037522,1,9244399
IMR90|chr12:66282036-66282186,chr12,66282036,66282186,IMR90|chr12:72229783-72229830,chr12,72229783,72229830,1,5947747
IMR90|chr12:66284539-66284569,chr12,66284539,66284569,IMR90|chr12:68043954-68044041,chr12,68043954,68044041,1,1759415
IMR90|chr12:66284995-66285105,chr12,66284995,66285105,IMR90|chr12:42721930-42722009,chr12,42721930,42722009,1,23563065
IMR90|chr12:66284995-66285066,chr12,66284995,66285066,IMR90|chr12:42721930-42722009,chr12,42721930,42722009,1,23563065
IMR90|chr12:66285419-66285481,chr12,66285419,66285481,IMR90|chr12:46764109-46764176,chr12,46764109,46764176,1,19521310
IMR90|chr12:66285419-66285479,chr12,66285419,66285479,IMR90|chr12:46764109-46764176,chr12,46764109,46764176,1,19521310
IMR90|chr12:66286028-66286057,chr12,66286028,66286057,IMR90|chr12:120885300-120885418,chr12,120885300,120885418,1,54599272
IMR90|chr12:66286114-66286186,chr12,66286114,66286186,IMR90|chr12:64800648-64800691,chr12,64800648,64800691,1,1485466
IMR90|chr12:66286115-66286186,chr12,66286115,66286186,IMR90|chr12:64800648-64800691,chr12,64800648,64800691,1,1485467
IMR90|chr12:66286115-66286185,chr12,66286115,66286185,IMR90|chr12:64800648-64800691,chr12,64800648,64800691,1,1485467
IMR90|chr12:66286360-66286451,chr12,66286360,66286451,IMR90|chr12:57526099-57526148,chr12,57526099,57526148,1,8760261
IMR90|chr12:66286471-66286579,chr12,66286471,66286579,IMR90|chr12:133403741-133403769,chr12,133403741,133403769,1,67117270
IMR90|chr12:66286784-66286860,chr12,66286784,66286860,IMR90|chr12:76476747-76476813,chr12,76476747,76476813,1,10189963
IMR90|chr12:66287465-66287503,chr12,66287465,66287503,IMR90|chr12:69005703-69005806,chr12,69005703,69005806,1,2718238
IMR90|chr12:66288651-66288733,chr12,66288651,66288733,IMR90|chr12:104682395-104682414,chr12,104682395,104682414,1,38393744
IMR90|chr12:66291143-66291172,chr12,66291143,66291172,IMR90|chr12:46761702-46761769,chr12,46761702,46761769,1,19529441
IMR90|chr12:66292926-66292948,chr12,66292926,66292948,IMR90|chr12:109250723-109250780,chr12,109250723,109250780,1,42957797
IMR90|chr12:66293644-66293714,chr12,66293644,66293714,IMR90|chr12:46761471-46761522,chr12,46761471,46761522,1,19532173
IMR90|chr12:66296636-66296688,chr12,66296636,66296688,IMR90|chr12:64800490-64800588,chr12,64800490,64800588,1,1496146
IMR90|chr12:66296637-66296733,chr12,66296637,66296733,IMR90|chr12:64800490-64800588,chr12,64800490,64800588,1,1496147
IMR90|chr12:66299237-66299258,chr12,66299237,66299258,IMR90|chr12:54677002-54677067,chr12,54677002,54677067,1,11622235
IMR90|chr12:66301137-66301192,chr12,66301137,66301192,IMR90|chr12:133402948-133403004,chr12,133402948,133403004,1,67101811
IMR90|chr12:66302115-66302236,chr12,66302115,66302236,IMR90|chr12:69006281-69006374,chr12,69006281,69006374,1,2704166
IMR90|chr12:66302115-66302160,chr12,66302115,66302160,IMR90|chr12:69006281-69006374,chr12,69006281,69006374,1,2704166
IMR90|chr12:66302293-66302394,chr12,66302293,66302394,IMR90|chr12:56366661-56366687,chr12,56366661,56366687,1,9935632
IMR90|chr12:66302293-66302380,chr12,66302293,66302380,IMR90|chr12:56366661-56366687,chr12,56366661,56366687,1,9935632
IMR90|chr12:66302318-66302379,chr12,66302318,66302379,IMR90|chr12:79260141-79260209,chr12,79260141,79260209,1,12957823
IMR90|chr12:66303725-66303831,chr12,66303725,66303831,IMR90|chr12:121127712-121127741,chr12,121127712,121127741,1,54823987
IMR90|chr12:66303726-66303831,chr12,66303726,66303831,IMR90|chr12:121127712-121127741,chr12,121127712,121127741,1,54823986
IMR90|chr12:66303751-66303794,chr12,66303751,66303794,IMR90|chr12:109248562-109248611,chr12,109248562,109248611,1,42944811
IMR90|chr12:66303753-66303794,chr12,66303753,66303794,IMR90|chr12:109248562-109248611,chr12,109248562,109248611,1,42944809
IMR90|chr12:66306534-66306611,chr12,66306534,66306611,IMR90|chr12:88536644-88536687,chr12,88536644,88536687,1,22230110
IMR90|chr12:66306534-66306610,chr12,66306534,66306610,IMR90|chr12:88536644-88536687,chr12,88536644,88536687,1,22230110
IMR90|chr12:66307017-66307075,chr12,66307017,66307075,IMR90|chr12:863601-863699,chr12,863601,863699,1,65443416
IMR90|chr12:66307023-66307075,chr12,66307023,66307075,IMR90|chr12:863601-863699,chr12,863601,863699,1,65443422
IMR90|chr12:66307070-66307145,chr12,66307070,66307145,IMR90|chr12:69005405-69005476,chr12,69005405,69005476,1,2698335
IMR90|chr12:66307073-66307138,chr12,66307073,66307138,IMR90|chr12:69005405-69005479,chr12,69005405,69005479,1,2698332
IMR90|chr12:66307233-66307260,chr12,66307233,66307260,IMR90|chr12:111806441-111806557,chr12,111806441,111806557,1,45499208
IMR90|chr12:66307234-66307294,chr12,66307234,66307294,IMR90|chr12:111806441-111806557,chr12,111806441,111806557,1,45499207
IMR90|chr12:66307552-66307621,chr12,66307552,66307621,IMR90|chr12:46765734-46765776,chr12,46765734,46765776,1,19541818
IMR90|chr12:66311181-66311226,chr12,66311181,66311226,IMR90|chr12:69675603-69675651,chr12,69675603,69675651,1,3364422
IMR90|chr12:66311567-66311638,chr12,66311567,66311638,IMR90|chr12:27092541-27092569,chr12,27092541,27092569,1,39219026
IMR90|chr12:66311567-66311634,chr12,66311567,66311634,IMR90|chr12:27092541-27092569,chr12,27092541,27092569,1,39219026
IMR90|chr12:66312657-66312766,chr12,66312657,66312766,IMR90|chr12:76428698-76428797,chr12,76428698,76428797,1,10116041
IMR90|chr12:66324813-66324944,chr12,66324813,66324944,IMR90|chr12:104683975-104684041,chr12,104683975,104684041,1,38359162
IMR90|chr12:66324860-66324944,chr12,66324860,66324944,IMR90|chr12:104683975-104684041,chr12,104683975,104684041,1,38359115
IMR90|chr12:66326690-66326762,chr12,66326690,66326762,IMR90|chr12:46765971-46766049,chr12,46765971,46766049,1,19560719
IMR90|chr12:66326690-66326761,chr12,66326690,66326761,IMR90|chr12:46765971-46766049,chr12,46765971,46766049,1,19560719
IMR90|chr12:66327368-66327395,chr12,66327368,66327395,IMR90|chr12:57116948-57117018,chr12,57116948,57117018,1,9210420
IMR90|chr12:66327368-66327392,chr12,66327368,66327392,IMR90|chr12:57116948-57117018,chr12,57116948,57117018,1,9210420
IMR90|chr12:66328678-66328757,chr12,66328678,66328757,IMR90|chr12:88972333-88972429,chr12,88972333,88972429,1,22643655
IMR90|chr12:66328678-66328731,chr12,66328678,66328731,IMR90|chr12:88972333-88972430,chr12,88972333,88972430,1,22643655
IMR90|chr12:66343968-66344044,chr12,66343968,66344044,IMR90|chr12:98992721-98992776,chr12,98992721,98992776,1,32648753
IMR90|chr12:66343968-66344043,chr12,66343968,66344043,IMR90|chr12:98992721-98992776,chr12,98992721,98992776,1,32648753
IMR90|chr12:66352737-66352781,chr12,66352737,66352781,IMR90|chr12:42631171-42631253,chr12,42631171,42631253,1,23721566
IMR90|chr12:68059864-68059911,chr12,68059864,68059911,IMR90|chr12:109899167-109899229,chr12,109899167,109899229,1,41839303
IMR90|chr12:68059866-68059911,chr12,68059866,68059911,IMR90|chr12:109899167-109899229,chr12,109899167,109899229,1,41839301
IMR90|chr12:72738630-72738655,chr12,72738630,72738655,IMR90|chr12:56918089-56918161,chr12,56918089,56918161,1,15820541
IMR90|chr12:76731895-76731939,chr12,76731895,76731939,IMR90|chr12:76745317-76745419,chr12,76745317,76745419,1,13422
IMR90|chr12:76731896-76731939,chr12,76731896,76731939,IMR90|chr12:76745317-76745419,chr12,76745317,76745419,1,13421
IMR90|chr12:78335928-78336078,chr12,78335928,78336078,IMR90|chr12:112455740-112455852,chr12,112455740,112455852,1,34119812
IMR90|chr12:78338631-78338657,chr12,78338631,78338657,IMR90|chr12:66220032-66220152,chr12,66220032,66220152,1,12118599
IMR90|chr12:78338632-78338668,chr12,78338632,78338668,IMR90|chr12:66220032-66220152,chr12,66220032,66220152,1,12118600
IMR90|chr12:89758077-89758227,chr12,89758077,89758227,IMR90|chr12:89750300-89750319,chr12,89750300,89750319,1,7777
IMR90|chr12:89758100-89758231,chr12,89758100,89758231,IMR90|chr12:89750300-89750319,chr12,89750300,89750319,1,7800
IMR90|chr12:89761009-89761038,chr12,89761009,89761038,IMR90|chr12:89748113-89748156,chr12,89748113,89748156,1,12896
IMR90|chr12:89766700-89766763,chr12,89766700,89766763,IMR90|chr12:89749138-89749243,chr12,89749138,89749243,1,17562
IMR90|chr12:89766700-89766745,chr12,89766700,89766745,IMR90|chr12:89749138-89749243,chr12,89749138,89749243,1,17562
IMR90|chr12:89774601-89774665,chr12,89774601,89774665,IMR90|chr12:89749593-89749655,chr12,89749593,89749655,1,25008
IMR90|chr12:89774601-89774663,chr12,89774601,89774663,IMR90|chr12:89749593-89749655,chr12,89749593,89749655,1,25008
IMR90|chr12:93817315-93817374,chr12,93817315,93817374,IMR90|chr12:93771099-93771130,chr12,93771099,93771130,1,46216
IMR90|chr12:93817352-93817374,chr12,93817352,93817374,IMR90|chr12:93771099-93771131,chr12,93771099,93771131,1,46253
IMR90|chr12:96128632-96128729,chr12,96128632,96128729,IMR90|chr12:95949751-95949794,chr12,95949751,95949794,1,178881
IMR90|chr12:96128632-96128723,chr12,96128632,96128723,IMR90|chr12:95949735-95949794,chr12,95949735,95949794,1,178897
IMR90|chr12:96128632-96128714,chr12,96128632,96128714,IMR90|chr12:95949726-95949794,chr12,95949726,95949794,1,178906
IMR90|chr12:96128632-96128670,chr12,96128632,96128670,IMR90|chr12:95949716-95949794,chr12,95949716,95949794,1,178916
IMR90|chr12:96608336-96608398,chr12,96608336,96608398,IMR90|chr12:123378769-123378821,chr12,123378769,123378821,1,26770433
IMR90|chr12:96812510-96812646,chr12,96812510,96812646,IMR90|chr12:96798383-96798440,chr12,96798383,96798440,1,14127
IMR90|chr12:96812553-96812646,chr12,96812553,96812646,IMR90|chr12:96798383-96798440,chr12,96798383,96798440,1,14170
IMR90|chr12:96818881-96818942,chr12,96818881,96818942,IMR90|chr12:96795291-96795335,chr12,96795291,96795335,1,23590
IMR90|chr12:96818881-96818941,chr12,96818881,96818941,IMR90|chr12:96795291-96795335,chr12,96795291,96795335,1,23590
IMR90|chr12:104206480-104206565,chr12,104206480,104206565,IMR90|chr12:133531800-133531852,chr12,133531800,133531852,1,29325320
IMR90|chr12:104664295-104664403,chr12,104664295,104664403,IMR90|chr12:105627747-105627779,chr12,105627747,105627779,1,963452
IMR90|chr12:104664295-104664401,chr12,104664295,104664401,IMR90|chr12:105627747-105627779,chr12,105627747,105627779,1,963452
IMR90|chr12:104664296-104664401,chr12,104664296,104664401,IMR90|chr12:105627747-105627779,chr12,105627747,105627779,1,963451
IMR90|chr12:104664629-104664680,chr12,104664629,104664680,IMR90|chr12:69204608-69204642,chr12,69204608,69204642,1,35460021
IMR90|chr12:104664629-104664678,chr12,104664629,104664678,IMR90|chr12:69204606-69204663,chr12,69204606,69204663,1,35460023
IMR90|chr12:104664631-104664680,chr12,104664631,104664680,IMR90|chr12:69204608-69204709,chr12,69204608,69204709,1,35460023
IMR90|chr12:105103863-105103896,chr12,105103863,105103896,IMR90|chr12:58236820-58236885,chr12,58236820,58236885,1,46867043
IMR90|chr12:105103863-105103894,chr12,105103863,105103894,IMR90|chr12:58236820-58236885,chr12,58236820,58236885,1,46867043
IMR90|chr12:105600573-105600662,chr12,105600573,105600662,IMR90|chr12:97302660-97302725,chr12,97302660,97302725,1,8297913
IMR90|chr12:105600573-105600658,chr12,105600573,105600658,IMR90|chr12:97302660-97302725,chr12,97302660,97302725,1,8297913
IMR90|chr12:109080010-109080066,chr12,109080010,109080066,IMR90|chr12:109247420-109247514,chr12,109247420,109247514,1,167410
IMR90|chr12:109080017-109080095,chr12,109080017,109080095,IMR90|chr12:109247420-109247514,chr12,109247420,109247514,1,167403
IMR90|chr12:109083102-109083144,chr12,109083102,109083144,IMR90|chr12:109251799-109251939,chr12,109251799,109251939,1,168697
IMR90|chr12:109106932-109107012,chr12,109106932,109107012,IMR90|chr12:133402960-133402995,chr12,133402960,133402995,1,24296028
IMR90|chr12:109107894-109107962,chr12,109107894,109107962,IMR90|chr12:110439274-110439356,chr12,110439274,110439356,1,1331380
IMR90|chr12:109107896-109107973,chr12,109107896,109107973,IMR90|chr12:110439274-110439356,chr12,110439274,110439356,1,1331378
IMR90|chr12:109203638-109203694,chr12,109203638,109203694,IMR90|chr12:132339867-132339896,chr12,132339867,132339896,1,23136229
IMR90|chr12:109203641-109203694,chr12,109203641,109203694,IMR90|chr12:132339867-132339896,chr12,132339867,132339896,1,23136226
IMR90|chr12:110450765-110450820,chr12,110450765,110450820,IMR90|chr12:57115548-57115596,chr12,57115548,57115596,1,53335217
IMR90|chr12:110748501-110748539,chr12,110748501,110748539,IMR90|chr12:49932217-49932296,chr12,49932217,49932296,1,60816284
IMR90|chr12:110748502-110748539,chr12,110748502,110748539,IMR90|chr12:49932217-49932296,chr12,49932217,49932296,1,60816285
IMR90|chr12:110996445-110996532,chr12,110996445,110996532,IMR90|chr12:110887022-110887172,chr12,110887022,110887172,1,109423
IMR90|chr12:111010948-111011010,chr12,111010948,111011010,IMR90|chr12:110438753-110438836,chr12,110438753,110438836,1,572195
IMR90|chr12:111995377-111995454,chr12,111995377,111995454,IMR90|chr12:97304310-97304337,chr12,97304310,97304337,1,14691067
IMR90|chr12:112003420-112003493,chr12,112003420,112003493,IMR90|chr12:111845198-111845275,chr12,111845198,111845275,1,158222
IMR90|chr12:112003421-112003498,chr12,112003421,112003498,IMR90|chr12:111845198-111845275,chr12,111845198,111845275,1,158223
IMR90|chr12:112004528-112004594,chr12,112004528,112004594,IMR90|chr12:111841543-111841580,chr12,111841543,111841580,1,162985
IMR90|chr12:112533110-112533232,chr12,112533110,112533232,IMR90|chr12:112549450-112549478,chr12,112549450,112549478,1,16340
IMR90|chr12:112533110-112533225,chr12,112533110,112533225,IMR90|chr12:112549450-112549478,chr12,112549450,112549478,1,16340
IMR90|chr12:112535131-112535241,chr12,112535131,112535241,IMR90|chr12:49659163-49659203,chr12,49659163,49659203,1,62875968
IMR90|chr12:112535132-112535245,chr12,112535132,112535245,IMR90|chr12:49659163-49659199,chr12,49659163,49659199,1,62875969
IMR90|chr12:116491876-116491922,chr12,116491876,116491922,IMR90|chr12:57117832-57117893,chr12,57117832,57117893,1,59374044
IMR90|chr12:116491878-116491922,chr12,116491878,116491922,IMR90|chr12:57117832-57117893,chr12,57117832,57117893,1,59374046
IMR90|chr12:116496476-116496548,chr12,116496476,116496548,IMR90|chr12:105626187-105626223,chr12,105626187,105626223,1,10870289
IMR90|chr12:116496477-116496548,chr12,116496477,116496548,IMR90|chr12:105626187-105626223,chr12,105626187,105626223,1,10870290
IMR90|chr12:116500259-116500289,chr12,116500259,116500289,IMR90|chr12:1641430-1641457,chr12,1641430,1641457,1,114858829
IMR90|chr12:116500260-116500289,chr12,116500260,116500289,IMR90|chr12:1641430-1641457,chr12,1641430,1641457,1,114858830
IMR90|chr12:116500273-116500311,chr12,116500273,116500311,IMR90|chr12:105634534-105634568,chr12,105634534,105634568,1,10865739
IMR90|chr12:116514397-116514429,chr12,116514397,116514429,IMR90|chr12:114847023-114847148,chr12,114847023,114847148,1,1667374
IMR90|chr12:116514404-116514429,chr12,116514404,116514429,IMR90|chr12:114847023-114847148,chr12,114847023,114847148,1,1667381
IMR90|chr12:116582254-116582287,chr12,116582254,116582287,IMR90|chr12:53892649-53892752,chr12,53892649,53892752,1,62689605
IMR90|chr12:116695062-116695107,chr12,116695062,116695107,IMR90|chr12:66220947-66221053,chr12,66220947,66221053,1,50474115
IMR90|chr12:116695063-116695107,chr12,116695063,116695107,IMR90|chr12:66220947-66221053,chr12,66220947,66221053,1,50474116
IMR90|chr12:116695064-116695107,chr12,116695064,116695107,IMR90|chr12:66220947-66221053,chr12,66220947,66221053,1,50474117
IMR90|chr12:117404928-117404979,chr12,117404928,117404979,IMR90|chr12:114839183-114839256,chr12,114839183,114839256,1,2565745
IMR90|chr12:117428663-117428805,chr12,117428663,117428805,IMR90|chr12:114844239-114844280,chr12,114844239,114844280,1,2584424
IMR90|chr12:117428696-117428805,chr12,117428696,117428805,IMR90|chr12:114844239-114844280,chr12,114844239,114844280,1,2584457
IMR90|chr12:118728990-118729081,chr12,118728990,118729081,IMR90|chr12:49661657-49661705,chr12,49661657,49661705,1,69067333
IMR90|chr12:118728995-118729081,chr12,118728995,118729081,IMR90|chr12:49661657-49661705,chr12,49661657,49661705,1,69067338
IMR90|chr12:118752930-118753016,chr12,118752930,118753016,IMR90|chr12:104681961-104682047,chr12,104681961,104682047,1,14070969
IMR90|chr12:118752930-118752994,chr12,118752930,118752994,IMR90|chr12:104681961-104682047,chr12,104681961,104682047,1,14070969
IMR90|chr12:118765927-118766032,chr12,118765927,118766032,IMR90|chr12:104683147-104683178,chr12,104683147,104683178,1,14082780
IMR90|chr12:118777368-118777452,chr12,118777368,118777452,IMR90|chr12:120665165-120665310,chr12,120665165,120665310,1,1887797
IMR90|chr12:118777369-118777452,chr12,118777369,118777452,IMR90|chr12:120665165-120665310,chr12,120665165,120665310,1,1887796
IMR90|chr12:118777387-118777451,chr12,118777387,118777451,IMR90|chr12:120665166-120665310,chr12,120665166,120665310,1,1887779
IMR90|chr12:120620103-120620253,chr12,120620103,120620253,IMR90|chr12:120557640-120557777,chr12,120557640,120557777,1,62463
IMR90|chr12:120620195-120620253,chr12,120620195,120620253,IMR90|chr12:120557670-120557777,chr12,120557670,120557777,1,62525
IMR90|chr12:120671322-120671419,chr12,120671322,120671419,IMR90|chr12:133403973-133404021,chr12,133403973,133404021,1,12732651
IMR90|chr12:120671323-120671419,chr12,120671323,120671419,IMR90|chr12:133403973-133404021,chr12,133403973,133404021,1,12732650
IMR90|chr12:120671483-120671530,chr12,120671483,120671530,IMR90|chr12:133400720-133400776,chr12,133400720,133400776,1,12729237
IMR90|chr12:120681869-120681970,chr12,120681869,120681970,IMR90|chr12:133401302-133401341,chr12,133401302,133401341,1,12719433
IMR90|chr12:120681871-120681970,chr12,120681871,120681970,IMR90|chr12:133401302-133401341,chr12,133401302,133401341,1,12719431
IMR90|chr12:120682143-120682193,chr12,120682143,120682193,IMR90|chr12:133403124-133403199,chr12,133403124,133403199,1,12720981
IMR90|chr12:120696204-120696298,chr12,120696204,120696298,IMR90|chr12:121784115-121784168,chr12,121784115,121784168,1,1087911
IMR90|chr12:120696265-120696298,chr12,120696265,120696298,IMR90|chr12:121784115-121784208,chr12,121784115,121784208,1,1087850
IMR90|chr12:122501349-122501437,chr12,122501349,122501437,IMR90|chr12:122515565-122515630,chr12,122515565,122515630,1,14216
IMR90|chr12:122501355-122501437,chr12,122501355,122501437,IMR90|chr12:122515565-122515630,chr12,122515565,122515630,1,14210
IMR90|chr12:122502294-122502339,chr12,122502294,122502339,IMR90|chr12:122515565-122515666,chr12,122515565,122515666,1,13271
IMR90|chr12:122502531-122502585,chr12,122502531,122502585,IMR90|chr12:122515562-122515704,chr12,122515562,122515704,1,13031
IMR90|chr12:122502544-122502585,chr12,122502544,122502585,IMR90|chr12:122515562-122515626,chr12,122515562,122515626,1,13018
IMR90|chr12:122502545-122502585,chr12,122502545,122502585,IMR90|chr12:122515562-122515626,chr12,122515562,122515626,1,13017
IMR90|chr12:122503143-122503229,chr12,122503143,122503229,IMR90|chr12:122516200-122516247,chr12,122516200,122516247,1,13057
IMR90|chr12:122503215-122503295,chr12,122503215,122503295,IMR90|chr12:122512963-122513032,chr12,122512963,122513032,1,9748
IMR90|chr12:122504285-122504317,chr12,122504285,122504317,IMR90|chr12:122512349-122512419,chr12,122512349,122512419,1,8064
IMR90|chr12:122504759-122504848,chr12,122504759,122504848,IMR90|chr12:122513149-122513165,chr12,122513149,122513165,1,8390
IMR90|chr12:122504903-122504984,chr12,122504903,122504984,IMR90|chr12:122512838-122512907,chr12,122512838,122512907,1,7935
IMR90|chr12:122504904-122504999,chr12,122504904,122504999,IMR90|chr12:122512838-122512907,chr12,122512838,122512907,1,7934
IMR90|chr12:122505173-122505244,chr12,122505173,122505244,IMR90|chr12:122513069-122513117,chr12,122513069,122513117,1,7896
IMR90|chr12:122506278-122506329,chr12,122506278,122506329,IMR90|chr12:122515558-122515700,chr12,122515558,122515700,1,9280
IMR90|chr12:122506373-122506495,chr12,122506373,122506495,IMR90|chr12:122513678-122513812,chr12,122513678,122513812,1,7305
IMR90|chr12:122506870-122506920,chr12,122506870,122506920,IMR90|chr12:122519391-122519413,chr12,122519391,122519413,1,12521
IMR90|chr12:122506887-122506999,chr12,122506887,122506999,IMR90|chr12:122519391-122519413,chr12,122519391,122519413,1,12504
IMR90|chr12:122506895-122506934,chr12,122506895,122506934,IMR90|chr12:122515603-122515704,chr12,122515603,122515704,1,8708
IMR90|chr12:122507809-122507871,chr12,122507809,122507871,IMR90|chr12:122514281-122514360,chr12,122514281,122514360,1,6472
IMR90|chr12:122507816-122507966,chr12,122507816,122507966,IMR90|chr12:122514281-122514360,chr12,122514281,122514360,1,6465
IMR90|chr12:122507901-122507970,chr12,122507901,122507970,IMR90|chr12:122511643-122511716,chr12,122511643,122511716,1,3742
IMR90|chr12:122508105-122508132,chr12,122508105,122508132,IMR90|chr12:122512264-122512365,chr12,122512264,122512365,1,4159
IMR90|chr12:122508197-122508347,chr12,122508197,122508347,IMR90|chr12:122512264-122512365,chr12,122512264,122512365,1,4067
IMR90|chr12:122508324-122508385,chr12,122508324,122508385,IMR90|chr12:122518225-122518260,chr12,122518225,122518260,1,9901
IMR90|chr12:122508326-122508385,chr12,122508326,122508385,IMR90|chr12:122518225-122518260,chr12,122518225,122518260,1,9899
IMR90|chr12:122508685-122508750,chr12,122508685,122508750,IMR90|chr12:122512868-122512950,chr12,122512868,122512950,1,4183
IMR90|chr12:122508686-122508750,chr12,122508686,122508750,IMR90|chr12:122512868-122512950,chr12,122512868,122512950,1,4182
IMR90|chr12:122508689-122508750,chr12,122508689,122508750,IMR90|chr12:122512868-122512950,chr12,122512868,122512950,1,4179
IMR90|chr12:122508947-122509067,chr12,122508947,122509067,IMR90|chr12:122514602-122514637,chr12,122514602,122514637,1,5655
IMR90|chr12:122508947-122509057,chr12,122508947,122509057,IMR90|chr12:122514602-122514637,chr12,122514602,122514637,1,5655
IMR90|chr12:122509103-122509184,chr12,122509103,122509184,IMR90|chr12:122514415-122514479,chr12,122514415,122514479,1,5312
IMR90|chr12:122509117-122509186,chr12,122509117,122509186,IMR90|chr12:122512393-122512446,chr12,122512393,122512446,1,3276
IMR90|chr12:122509353-122509397,chr12,122509353,122509397,IMR90|chr12:122511898-122511954,chr12,122511898,122511954,1,2545
IMR90|chr12:122509524-122509586,chr12,122509524,122509586,IMR90|chr12:122511884-122511945,chr12,122511884,122511945,1,2360
IMR90|chr12:122509529-122509586,chr12,122509529,122509586,IMR90|chr12:122511888-122511950,chr12,122511888,122511950,1,2359
IMR90|chr12:122509910-122510050,chr12,122509910,122510050,IMR90|chr12:122512354-122512383,chr12,122512354,122512383,1,2444
IMR90|chr12:122509964-122510033,chr12,122509964,122510033,IMR90|chr12:122515887-122515928,chr12,122515887,122515928,1,5923
IMR90|chr12:122509968-122510037,chr12,122509968,122510037,IMR90|chr12:122513068-122513160,chr12,122513068,122513160,1,3100
IMR90|chr12:122510038-122510073,chr12,122510038,122510073,IMR90|chr12:122512354-122512383,chr12,122512354,122512383,1,2316
IMR90|chr12:122510189-122510256,chr12,122510189,122510256,IMR90|chr12:122512326-122512370,chr12,122512326,122512370,1,2137
IMR90|chr12:122510441-122510470,chr12,122510441,122510470,IMR90|chr12:122512881-122512942,chr12,122512881,122512942,1,2440
IMR90|chr12:122769394-122769466,chr12,122769394,122769466,IMR90|chr12:76429583-76429630,chr12,76429583,76429630,1,46339811
IMR90|chr12:122769394-122769430,chr12,122769394,122769430,IMR90|chr12:76429583-76429621,chr12,76429583,76429621,1,46339811
IMR90|chr12:123336622-123336710,chr12,123336622,123336710,IMR90|chr12:97305253-97305290,chr12,97305253,97305290,1,26031369
IMR90|chr12:123336622-123336708,chr12,123336622,123336708,IMR90|chr12:97305253-97305290,chr12,97305253,97305290,1,26031369
IMR90|chr12:123534170-123534243,chr12,123534170,123534243,IMR90|chr12:13351887-13351934,chr12,13351887,13351934,1,110182283
IMR90|chr12:123534171-123534243,chr12,123534171,123534243,IMR90|chr12:13351887-13351934,chr12,13351887,13351934,1,110182284
IMR90|chr12:124859218-124859255,chr12,124859218,124859255,IMR90|chr12:50100631-50100700,chr12,50100631,50100700,1,74758587
IMR90|chr12:124859220-124859255,chr12,124859220,124859255,IMR90|chr12:50100631-50100700,chr12,50100631,50100700,1,74758589
IMR90|chr12:124913062-124913114,chr12,124913062,124913114,IMR90|chr12:120703025-120703123,chr12,120703025,120703123,1,4210037
IMR90|chr12:124913086-124913236,chr12,124913086,124913236,IMR90|chr12:120703025-120703123,chr12,120703025,120703123,1,4210061
IMR90|chr12:124913092-124913236,chr12,124913092,124913236,IMR90|chr12:120703025-120703123,chr12,120703025,120703123,1,4210067
IMR90|chr12:125029505-125029562,chr12,125029505,125029562,IMR90|chr12:125053061-125053106,chr12,125053061,125053106,1,23556
IMR90|chr12:125032576-125032657,chr12,125032576,125032657,IMR90|chr12:125052709-125052773,chr12,125052709,125052773,1,20133
IMR90|chr12:125315478-125315540,chr12,125315478,125315540,IMR90|chr12:118572463-118572573,chr12,118572463,118572573,1,6743015
IMR90|chr12:125315540-125315669,chr12,125315540,125315669,IMR90|chr12:118572465-118572575,chr12,118572465,118572575,1,6743075
IMR90|chr12:125315540-125315668,chr12,125315540,125315668,IMR90|chr12:118572471-118572575,chr12,118572471,118572575,1,6743069
IMR90|chr12:125388667-125388791,chr12,125388667,125388791,IMR90|chr12:133404895-133404921,chr12,133404895,133404921,1,8016228
IMR90|chr12:128072427-128072481,chr12,128072427,128072481,IMR90|chr12:106640027-106640091,chr12,106640027,106640091,1,21432400
IMR90|chr12:128072427-128072480,chr12,128072427,128072480,IMR90|chr12:106640027-106640091,chr12,106640027,106640091,1,21432400
IMR90|chr12:128072428-128072480,chr12,128072428,128072480,IMR90|chr12:106640027-106640091,chr12,106640027,106640091,1,21432401
IMR90|chr13:21450907-21450984,chr13,21450907,21450984,IMR90|chr13:20362001-20362061,chr13,20362001,20362061,1,1088906
IMR90|chr13:21450911-21450985,chr13,21450911,21450985,IMR90|chr13:20362002-20362061,chr13,20362002,20362061,1,1088909
IMR90|chr13:21574230-21574275,chr13,21574230,21574275,IMR90|chr13:23942907-23943006,chr13,23942907,23943006,1,2368677
IMR90|chr13:21574231-21574291,chr13,21574231,21574291,IMR90|chr13:23942907-23943006,chr13,23942907,23943006,1,2368676
IMR90|chr13:21597857-21597886,chr13,21597857,21597886,IMR90|chr13:23943882-23943952,chr13,23943882,23943952,1,2346025
IMR90|chr13:21597858-21597886,chr13,21597858,21597886,IMR90|chr13:23943882-23943952,chr13,23943882,23943952,1,2346024
IMR90|chr13:24185004-24185074,chr13,24185004,24185074,IMR90|chr13:23944002-23944070,chr13,23944002,23944070,1,241002
IMR90|chr13:24185005-24185074,chr13,24185005,24185074,IMR90|chr13:23944001-23944070,chr13,23944001,23944070,1,241004
IMR90|chr13:24199640-24199696,chr13,24199640,24199696,IMR90|chr13:23944849-23944943,chr13,23944849,23944943,1,254791
IMR90|chr13:24219226-24219247,chr13,24219226,24219247,IMR90|chr13:114144609-114144698,chr13,114144609,114144698,1,89925383
IMR90|chr13:24232636-24232668,chr13,24232636,24232668,IMR90|chr13:23944354-23944437,chr13,23944354,23944437,1,288282
IMR90|chr13:24232636-24232667,chr13,24232636,24232667,IMR90|chr13:23944354-23944437,chr13,23944354,23944437,1,288282
IMR90|chr13:24258877-24258953,chr13,24258877,24258953,IMR90|chr13:67808508-67808582,chr13,67808508,67808582,1,43549631
IMR90|chr13:24258933-24258953,chr13,24258933,24258953,IMR90|chr13:67808452-67808582,chr13,67808452,67808582,1,43549519
IMR90|chr13:33831633-33831699,chr13,33831633,33831699,IMR90|chr13:41344713-41344741,chr13,41344713,41344741,1,7513080
IMR90|chr13:33831657-33831699,chr13,33831657,33831699,IMR90|chr13:41344713-41344741,chr13,41344713,41344741,1,7513056
IMR90|chr13:41712559-41712651,chr13,41712559,41712651,IMR90|chr13:41710898-41710960,chr13,41710898,41710960,1,1661
IMR90|chr13:41712563-41712651,chr13,41712563,41712651,IMR90|chr13:41710898-41710960,chr13,41710898,41710960,1,1665
IMR90|chr13:47143030-47143116,chr13,47143030,47143116,IMR90|chr13:45913819-45913863,chr13,45913819,45913863,1,1229211
IMR90|chr13:47143031-47143116,chr13,47143031,47143116,IMR90|chr13:45913819-45913863,chr13,45913819,45913863,1,1229212
IMR90|chr13:47222742-47222783,chr13,47222742,47222783,IMR90|chr13:45913530-45913604,chr13,45913530,45913604,1,1309212
IMR90|chr13:47222744-47222783,chr13,47222744,47222783,IMR90|chr13:45913530-45913604,chr13,45913530,45913604,1,1309214
IMR90|chr13:50647554-50647647,chr13,50647554,50647647,IMR90|chr13:50270249-50270335,chr13,50270249,50270335,1,377305
IMR90|chr13:50647554-50647615,chr13,50647554,50647615,IMR90|chr13:50270249-50270335,chr13,50270249,50270335,1,377305
IMR90|chr13:52219977-52220034,chr13,52219977,52220034,IMR90|chr13:52980990-52981114,chr13,52980990,52981114,1,761013
IMR90|chr13:52985988-52986098,chr13,52985988,52986098,IMR90|chr13:52982846-52982921,chr13,52982846,52982921,1,3142
IMR90|chr13:52985988-52986025,chr13,52985988,52986025,IMR90|chr13:52983212-52983250,chr13,52983212,52983250,1,2776
IMR90|chr13:52985988-52986024,chr13,52985988,52986024,IMR90|chr13:52983212-52983250,chr13,52983212,52983250,1,2776
IMR90|chr13:52986384-52986427,chr13,52986384,52986427,IMR90|chr13:52982313-52982459,chr13,52982313,52982459,1,4071
IMR90|chr13:52986392-52986427,chr13,52986392,52986427,IMR90|chr13:52982229-52982379,chr13,52982229,52982379,1,4163
IMR90|chr13:52994560-52994635,chr13,52994560,52994635,IMR90|chr13:52983788-52983838,chr13,52983788,52983838,1,10772
IMR90|chr13:53175134-53175214,chr13,53175134,53175214,IMR90|chr13:53187240-53187319,chr13,53187240,53187319,1,12106
IMR90|chr13:53175143-53175214,chr13,53175143,53175214,IMR90|chr13:53187240-53187319,chr13,53187240,53187319,1,12097
IMR90|chr13:53178064-53178200,chr13,53178064,53178200,IMR90|chr13:53188169-53188202,chr13,53188169,53188202,1,10105
IMR90|chr13:74687204-74687230,chr13,74687204,74687230,IMR90|chr13:33856530-33856599,chr13,33856530,33856599,1,40830674
IMR90|chr13:76435238-76435316,chr13,76435238,76435316,IMR90|chr13:76441464-76441566,chr13,76441464,76441566,1,6226
IMR90|chr13:76436390-76436453,chr13,76436390,76436453,IMR90|chr13:76444868-76445007,chr13,76444868,76445007,1,8478
IMR90|chr13:97791934-97792062,chr13,97791934,97792062,IMR90|chr13:108517607-108517660,chr13,108517607,108517660,1,10725673
IMR90|chr13:97791934-97792031,chr13,97791934,97792031,IMR90|chr13:108517607-108517660,chr13,108517607,108517660,1,10725673
IMR90|chr13:97791949-97792062,chr13,97791949,97792062,IMR90|chr13:108517607-108517660,chr13,108517607,108517660,1,10725658
IMR90|chr13:98861805-98861896,chr13,98861805,98861896,IMR90|chr13:98791304-98791363,chr13,98791304,98791363,1,70501
IMR90|chr13:98875949-98875987,chr13,98875949,98875987,IMR90|chr13:24155272-24155374,chr13,24155272,24155374,1,74720677
IMR90|chr13:98875949-98875983,chr13,98875949,98875983,IMR90|chr13:24155245-24155373,chr13,24155245,24155373,1,74720704
IMR90|chr13:98875964-98875983,chr13,98875964,98875983,IMR90|chr13:24155245-24155373,chr13,24155245,24155373,1,74720719
IMR90|chr13:99162869-99162952,chr13,99162869,99162952,IMR90|chr13:97876354-97876455,chr13,97876354,97876455,1,1286515
IMR90|chr13:99162869-99162911,chr13,99162869,99162911,IMR90|chr13:97876354-97876455,chr13,97876354,97876455,1,1286515
IMR90|chr13:99162883-99162952,chr13,99162883,99162952,IMR90|chr13:97876354-97876455,chr13,97876354,97876455,1,1286529
IMR90|chr13:100814700-100814826,chr13,100814700,100814826,IMR90|chr13:42614625-42614648,chr13,42614625,42614648,1,58200075
IMR90|chr13:101038339-101038407,chr13,101038339,101038407,IMR90|chr13:98828455-98828496,chr13,98828455,98828496,1,2209884
IMR90|chr13:101038343-101038407,chr13,101038343,101038407,IMR90|chr13:98828455-98828496,chr13,98828455,98828496,1,2209888
IMR90|chr13:107852145-107852244,chr13,107852145,107852244,IMR90|chr13:108522655-108522698,chr13,108522655,108522698,1,670510
IMR90|chr13:107861615-107861718,chr13,107861615,107861718,IMR90|chr13:108519722-108519768,chr13,108519722,108519768,1,658107
IMR90|chr13:107861688-107861792,chr13,107861688,107861792,IMR90|chr13:108519722-108519768,chr13,108519722,108519768,1,658034
IMR90|chr13:108235280-108235375,chr13,108235280,108235375,IMR90|chr13:76212870-76212901,chr13,76212870,76212901,1,32022410
IMR90|chr13:108235280-108235374,chr13,108235280,108235374,IMR90|chr13:76212870-76212901,chr13,76212870,76212901,1,32022410
IMR90|chr13:108243550-108243615,chr13,108243550,108243615,IMR90|chr13:76212102-76212186,chr13,76212102,76212186,1,32031448
IMR90|chr13:108243551-108243624,chr13,108243551,108243624,IMR90|chr13:76212102-76212186,chr13,76212102,76212186,1,32031449
IMR90|chr13:108245433-108245510,chr13,108245433,108245510,IMR90|chr13:31192838-31192886,chr13,31192838,31192886,1,77052595
IMR90|chr13:108245433-108245506,chr13,108245433,108245506,IMR90|chr13:31192838-31192886,chr13,31192838,31192886,1,77052595
IMR90|chr13:108280455-108280532,chr13,108280455,108280532,IMR90|chr13:111212427-111212460,chr13,111212427,111212460,1,2931972
IMR90|chr13:108280456-108280532,chr13,108280456,108280532,IMR90|chr13:111212427-111212460,chr13,111212427,111212460,1,2931971
IMR90|chr13:108295800-108295822,chr13,108295800,108295822,IMR90|chr13:52982105-52982225,chr13,52982105,52982225,1,55313695
IMR90|chr13:108386204-108386273,chr13,108386204,108386273,IMR90|chr13:114563525-114563575,chr13,114563525,114563575,1,6177321
IMR90|chr13:108388664-108388716,chr13,108388664,108388716,IMR90|chr13:76212303-76212358,chr13,76212303,76212358,1,32176361
IMR90|chr13:108394020-108394077,chr13,108394020,108394077,IMR90|chr13:114897694-114897738,chr13,114897694,114897738,1,6503674
IMR90|chr13:108400486-108400538,chr13,108400486,108400538,IMR90|chr13:114565317-114565384,chr13,114565317,114565384,1,6164831
IMR90|chr13:108400487-108400538,chr13,108400487,108400538,IMR90|chr13:114565317-114565384,chr13,114565317,114565384,1,6164830
IMR90|chr13:108400871-108400925,chr13,108400871,108400925,IMR90|chr13:114563268-114563333,chr13,114563268,114563333,1,6162397
IMR90|chr13:108419527-108419572,chr13,108419527,108419572,IMR90|chr13:33857458-33857476,chr13,33857458,33857476,1,74562069
IMR90|chr13:108424487-108424517,chr13,108424487,108424517,IMR90|chr13:33858681-33858795,chr13,33858681,33858795,1,74565806
IMR90|chr13:108459263-108459362,chr13,108459263,108459362,IMR90|chr13:108521969-108522019,chr13,108521969,108522019,1,62706
IMR90|chr13:108459265-108459362,chr13,108459265,108459362,IMR90|chr13:108521969-108522019,chr13,108521969,108522019,1,62704
IMR90|chr13:108460372-108460427,chr13,108460372,108460427,IMR90|chr13:108519242-108519318,chr13,108519242,108519318,1,58870
IMR90|chr13:108466005-108466035,chr13,108466005,108466035,IMR90|chr13:108519203-108519347,chr13,108519203,108519347,1,53198
IMR90|chr13:108468346-108468384,chr13,108468346,108468384,IMR90|chr13:108519243-108519336,chr13,108519243,108519336,1,50897
IMR90|chr13:108470755-108470836,chr13,108470755,108470836,IMR90|chr13:20533955-20534005,chr13,20533955,20534005,1,87936800
IMR90|chr13:108472380-108472472,chr13,108472380,108472472,IMR90|chr13:114898778-114898848,chr13,114898778,114898848,1,6426398
IMR90|chr13:108472380-108472457,chr13,108472380,108472457,IMR90|chr13:114898778-114898848,chr13,114898778,114898848,1,6426398
IMR90|chr13:108473911-108474053,chr13,108473911,108474053,IMR90|chr13:114141152-114141186,chr13,114141152,114141186,1,5667241
IMR90|chr13:108473915-108474031,chr13,108473915,108474031,IMR90|chr13:114141152-114141186,chr13,114141152,114141186,1,5667237
IMR90|chr13:108475709-108475796,chr13,108475709,108475796,IMR90|chr13:108519598-108519627,chr13,108519598,108519627,1,43889
IMR90|chr13:108479046-108479107,chr13,108479046,108479107,IMR90|chr13:108519451-108519494,chr13,108519451,108519494,1,40405
IMR90|chr13:108480323-108480421,chr13,108480323,108480421,IMR90|chr13:114895267-114895318,chr13,114895267,114895318,1,6414944
IMR90|chr13:108484073-108484102,chr13,108484073,108484102,IMR90|chr13:114141087-114141165,chr13,114141087,114141165,1,5657014
IMR90|chr13:108484283-108484352,chr13,108484283,108484352,IMR90|chr13:103249975-103250005,chr13,103249975,103250005,1,5234308
IMR90|chr13:108484283-108484351,chr13,108484283,108484351,IMR90|chr13:103249975-103250005,chr13,103249975,103250005,1,5234308
IMR90|chr13:108489696-108489723,chr13,108489696,108489723,IMR90|chr13:108519249-108519301,chr13,108519249,108519301,1,29553
IMR90|chr13:108501771-108501866,chr13,108501771,108501866,IMR90|chr13:20534170-20534194,chr13,20534170,20534194,1,87967601
IMR90|chr13:108534324-108534386,chr13,108534324,108534386,IMR90|chr13:108520894-108520941,chr13,108520894,108520941,1,13430
IMR90|chr13:108534324-108534385,chr13,108534324,108534385,IMR90|chr13:108520894-108520941,chr13,108520894,108520941,1,13430
IMR90|chr13:108535625-108535686,chr13,108535625,108535686,IMR90|chr13:108522584-108522637,chr13,108522584,108522637,1,13041
IMR90|chr13:110893281-110893392,chr13,110893281,110893392,IMR90|chr13:21347814-21347841,chr13,21347814,21347841,1,89545467
IMR90|chr13:111037444-111037525,chr13,111037444,111037525,IMR90|chr13:93875662-93875784,chr13,93875662,93875784,1,17161782
IMR90|chr13:111042134-111042221,chr13,111042134,111042221,IMR90|chr13:33857031-33857080,chr13,33857031,33857080,1,77185103
IMR90|chr13:111069275-111069327,chr13,111069275,111069327,IMR90|chr13:33857281-33857345,chr13,33857281,33857345,1,77211994
IMR90|chr13:111538036-111538067,chr13,111538036,111538067,IMR90|chr13:111363509-111363544,chr13,111363509,111363544,1,174527
IMR90|chr13:111538036-111538066,chr13,111538036,111538066,IMR90|chr13:111363509-111363544,chr13,111363509,111363544,1,174527
IMR90|chr13:114557140-114557168,chr13,114557140,114557168,IMR90|chr13:114896869-114896956,chr13,114896869,114896956,1,339729
IMR90|chr13:114560883-114560975,chr13,114560883,114560975,IMR90|chr13:20533952-20533985,chr13,20533952,20533985,1,94026931
IMR90|chr13:114560887-114560975,chr13,114560887,114560975,IMR90|chr13:20533952-20533985,chr13,20533952,20533985,1,94026935
IMR90|chr13:114561455-114561479,chr13,114561455,114561479,IMR90|chr13:114897065-114897172,chr13,114897065,114897172,1,335610
IMR90|chr13:114619120-114619156,chr13,114619120,114619156,IMR90|chr13:114540078-114540187,chr13,114540078,114540187,1,79042
IMR90|chr13:114791024-114791051,chr13,114791024,114791051,IMR90|chr13:114536842-114536940,chr13,114536842,114536940,1,254182
IMR90|chr13:114791437-114791492,chr13,114791437,114791492,IMR90|chr13:114540663-114540721,chr13,114540663,114540721,1,250774
IMR90|chr13:114797218-114797292,chr13,114797218,114797292,IMR90|chr13:115001480-115001556,chr13,115001480,115001556,1,204262
IMR90|chr13:114797219-114797291,chr13,114797219,114797291,IMR90|chr13:115001479-115001556,chr13,115001479,115001556,1,204260
IMR90|chr13:114797221-114797310,chr13,114797221,114797310,IMR90|chr13:115001479-115001556,chr13,115001479,115001556,1,204258
IMR90|chr13:114818725-114818814,chr13,114818725,114818814,IMR90|chr13:114567666-114567765,chr13,114567666,114567765,1,251059
IMR90|chr13:114818768-114818814,chr13,114818768,114818814,IMR90|chr13:114567666-114567765,chr13,114567666,114567765,1,251102
IMR90|chr13:114823590-114823622,chr13,114823590,114823622,IMR90|chr13:114566045-114566118,chr13,114566045,114566118,1,257545
IMR90|chr13:114829173-114829209,chr13,114829173,114829209,IMR90|chr13:114563011-114563063,chr13,114563011,114563063,1,266162
IMR90|chr13:114829983-114830085,chr13,114829983,114830085,IMR90|chr13:114563011-114563059,chr13,114563011,114563059,1,266972
IMR90|chr13:114829983-114830049,chr13,114829983,114830049,IMR90|chr13:114563011-114563059,chr13,114563011,114563059,1,266972
IMR90|chr13:114861476-114861620,chr13,114861476,114861620,IMR90|chr13:111359321-111359378,chr13,111359321,111359378,1,3502155
IMR90|chr13:114861545-114861634,chr13,114861545,114861634,IMR90|chr13:111359321-111359378,chr13,111359321,111359378,1,3502224
IMR90|chr13:114874142-114874248,chr13,114874142,114874248,IMR90|chr13:80055786-80055846,chr13,80055786,80055846,1,34818356
IMR90|chr13:114874142-114874232,chr13,114874142,114874232,IMR90|chr13:80055786-80055846,chr13,80055786,80055846,1,34818356
IMR90|chr13:114878111-114878167,chr13,114878111,114878167,IMR90|chr13:114901147-114901211,chr13,114901147,114901211,1,23036
IMR90|chr13:114883102-114883220,chr13,114883102,114883220,IMR90|chr13:111359392-111359417,chr13,111359392,111359417,1,3523710
IMR90|chr13:114883165-114883285,chr13,114883165,114883285,IMR90|chr13:111359392-111359417,chr13,111359392,111359417,1,3523773
IMR90|chr13:114891150-114891185,chr13,114891150,114891185,IMR90|chr13:41362562-41362648,chr13,41362562,41362648,1,73528588
IMR90|chr13:114891153-114891185,chr13,114891153,114891185,IMR90|chr13:41362562-41362625,chr13,41362562,41362625,1,73528591
IMR90|chr13:114892341-114892448,chr13,114892341,114892448,IMR90|chr13:114902628-114902658,chr13,114902628,114902658,1,10287
IMR90|chr14:31460881-31460936,chr14,31460881,31460936,IMR90|chr14:61114814-61114964,chr14,61114814,61114964,1,29653933
IMR90|chr14:31525605-31525707,chr14,31525605,31525707,IMR90|chr14:31680823-31680871,chr14,31680823,31680871,1,155218
IMR90|chr14:35118885-35118910,chr14,35118885,35118910,IMR90|chr14:35102115-35102173,chr14,35102115,35102173,1,16770
IMR90|chr14:35119192-35119256,chr14,35119192,35119256,IMR90|chr14:35103791-35103825,chr14,35103791,35103825,1,15401
IMR90|chr14:35119461-35119521,chr14,35119461,35119521,IMR90|chr14:35098943-35099061,chr14,35098943,35099061,1,20518
IMR90|chr14:35119489-35119521,chr14,35119489,35119521,IMR90|chr14:35098943-35099061,chr14,35098943,35099061,1,20546
IMR90|chr14:35119891-35119944,chr14,35119891,35119944,IMR90|chr14:35102115-35102173,chr14,35102115,35102173,1,17776
IMR90|chr14:50108047-50108077,chr14,50108047,50108077,IMR90|chr14:50102409-50102559,chr14,50102409,50102559,1,5638
IMR90|chr14:50108442-50108501,chr14,50108442,50108501,IMR90|chr14:50106334-50106383,chr14,50106334,50106383,1,2108
IMR90|chr14:52491815-52491879,chr14,52491815,52491879,IMR90|chr14:52459501-52459547,chr14,52459501,52459547,1,32314
IMR90|chr14:52514483-52514523,chr14,52514483,52514523,IMR90|chr14:52458585-52458624,chr14,52458585,52458624,1,55898
IMR90|chr14:53271318-53271468,chr14,53271318,53271468,IMR90|chr14:55519278-55519343,chr14,55519278,55519343,1,2247960
IMR90|chr14:53271434-53271519,chr14,53271434,53271519,IMR90|chr14:55519278-55519343,chr14,55519278,55519343,1,2247844
IMR90|chr14:53271722-53271818,chr14,53271722,53271818,IMR90|chr14:53258968-53259010,chr14,53258968,53259010,1,12754
IMR90|chr14:53271722-53271806,chr14,53271722,53271806,IMR90|chr14:53259005-53259044,chr14,53259005,53259044,1,12717
IMR90|chr14:53271722-53271792,chr14,53271722,53271792,IMR90|chr14:53258964-53259044,chr14,53258964,53259044,1,12758
IMR90|chr14:53925417-53925473,chr14,53925417,53925473,IMR90|chr14:59934411-59934445,chr14,59934411,59934445,1,6008994
IMR90|chr14:55054305-55054359,chr14,55054305,55054359,IMR90|chr14:55033145-55033255,chr14,55033145,55033255,1,21160
IMR90|chr14:55102173-55102196,chr14,55102173,55102196,IMR90|chr14:100705132-100705151,chr14,100705132,100705151,1,45602959
IMR90|chr14:55102173-55102194,chr14,55102173,55102194,IMR90|chr14:100705106-100705151,chr14,100705106,100705151,1,45602933
IMR90|chr14:55102173-55102191,chr14,55102173,55102191,IMR90|chr14:100705106-100705151,chr14,100705106,100705151,1,45602933
IMR90|chr14:55103962-55104071,chr14,55103962,55104071,IMR90|chr14:55032841-55032884,chr14,55032841,55032884,1,71121
IMR90|chr14:55103962-55104069,chr14,55103962,55104069,IMR90|chr14:55032841-55032884,chr14,55032841,55032884,1,71121
IMR90|chr14:55103962-55104053,chr14,55103962,55104053,IMR90|chr14:55032841-55032884,chr14,55032841,55032884,1,71121
IMR90|chr14:55154071-55154170,chr14,55154071,55154170,IMR90|chr14:59935037-59935090,chr14,59935037,59935090,1,4780966
IMR90|chr14:55154074-55154171,chr14,55154074,55154171,IMR90|chr14:59935037-59935090,chr14,59935037,59935090,1,4780963
IMR90|chr14:55162992-55163077,chr14,55162992,55163077,IMR90|chr14:59934393-59934443,chr14,59934393,59934443,1,4771401
IMR90|chr14:55162992-55163047,chr14,55162992,55163047,IMR90|chr14:59934393-59934443,chr14,59934393,59934443,1,4771401
IMR90|chr14:59901381-59901454,chr14,59901381,59901454,IMR90|chr14:59936099-59936150,chr14,59936099,59936150,1,34718
IMR90|chr14:59901382-59901454,chr14,59901382,59901454,IMR90|chr14:59936099-59936150,chr14,59936099,59936150,1,34717
IMR90|chr14:59907089-59907138,chr14,59907089,59907138,IMR90|chr14:59935383-59935439,chr14,59935383,59935439,1,28294
IMR90|chr14:59921707-59921796,chr14,59921707,59921796,IMR90|chr14:59932343-59932374,chr14,59932343,59932374,1,10636
IMR90|chr14:59922292-59922357,chr14,59922292,59922357,IMR90|chr14:59933761-59933808,chr14,59933761,59933808,1,11469
IMR90|chr14:60568546-60568601,chr14,60568546,60568601,IMR90|chr14:58865172-58865232,chr14,58865172,58865232,1,1703374
IMR90|chr14:61092886-61092956,chr14,61092886,61092956,IMR90|chr14:61126998-61127028,chr14,61126998,61127028,1,34112
IMR90|chr14:61092886-61092934,chr14,61092886,61092934,IMR90|chr14:61126998-61127028,chr14,61126998,61127028,1,34112
IMR90|chr14:61099950-61099997,chr14,61099950,61099997,IMR90|chr14:61106027-61106102,chr14,61106027,61106102,1,6077
IMR90|chr14:61099950-61099972,chr14,61099950,61099972,IMR90|chr14:61106027-61106102,chr14,61106027,61106102,1,6077
IMR90|chr14:62219201-62219275,chr14,62219201,62219275,IMR90|chr14:62163216-62163284,chr14,62163216,62163284,1,55985
IMR90|chr14:67723908-67723952,chr14,67723908,67723952,IMR90|chr14:92589451-92589521,chr14,92589451,92589521,1,24865543
IMR90|chr14:67723909-67723952,chr14,67723909,67723952,IMR90|chr14:92589451-92589521,chr14,92589451,92589521,1,24865542
IMR90|chr14:69307788-69307841,chr14,69307788,69307841,IMR90|chr14:69323563-69323693,chr14,69323563,69323693,1,15775
IMR90|chr14:69307796-69307841,chr14,69307796,69307841,IMR90|chr14:69323563-69323687,chr14,69323563,69323687,1,15767
IMR90|chr14:69307823-69307841,chr14,69307823,69307841,IMR90|chr14:69323563-69323687,chr14,69323563,69323687,1,15740
IMR90|chr14:69307825-69307841,chr14,69307825,69307841,IMR90|chr14:69323563-69323693,chr14,69323563,69323693,1,15738
IMR90|chr14:69375031-69375181,chr14,69375031,69375181,IMR90|chr14:53174664-53174705,chr14,53174664,53174705,1,16200367
IMR90|chr14:69375031-69375137,chr14,69375031,69375137,IMR90|chr14:53174664-53174705,chr14,53174664,53174705,1,16200367
IMR90|chr14:69428433-69428521,chr14,69428433,69428521,IMR90|chr14:53174739-53174767,chr14,53174739,53174767,1,16253694
IMR90|chr14:69428433-69428518,chr14,69428433,69428518,IMR90|chr14:53174739-53174767,chr14,53174739,53174767,1,16253694
IMR90|chr14:69428434-69428521,chr14,69428434,69428521,IMR90|chr14:53174739-53174767,chr14,53174739,53174767,1,16253695
IMR90|chr14:72183448-72183561,chr14,72183448,72183561,IMR90|chr14:73923480-73923524,chr14,73923480,73923524,1,1740032
IMR90|chr14:72183459-72183562,chr14,72183459,72183562,IMR90|chr14:73923480-73923524,chr14,73923480,73923524,1,1740021
IMR90|chr14:73892722-73892823,chr14,73892722,73892823,IMR90|chr14:74357472-74357521,chr14,74357472,74357521,1,464750
IMR90|chr14:75301365-75301396,chr14,75301365,75301396,IMR90|chr14:78173772-78173850,chr14,78173772,78173850,1,2872407
IMR90|chr14:75301365-75301395,chr14,75301365,75301395,IMR90|chr14:78173772-78173850,chr14,78173772,78173850,1,2872407
IMR90|chr14:78055318-78055398,chr14,78055318,78055398,IMR90|chr14:77968461-77968564,chr14,77968461,77968564,1,86857
IMR90|chr14:78055376-78055401,chr14,78055376,78055401,IMR90|chr14:77968461-77968564,chr14,77968461,77968564,1,86915
IMR90|chr14:89791430-89791457,chr14,89791430,89791457,IMR90|chr14:105261279-105261366,chr14,105261279,105261366,1,15469849
IMR90|chr14:89791431-89791457,chr14,89791431,89791457,IMR90|chr14:105261279-105261366,chr14,105261279,105261366,1,15469848
IMR90|chr14:89974778-89974808,chr14,89974778,89974808,IMR90|chr14:89017383-89017494,chr14,89017383,89017494,1,957395
IMR90|chr14:92441848-92441984,chr14,92441848,92441984,IMR90|chr14:20800826-20800911,chr14,20800826,20800911,1,71641022
IMR90|chr14:92441919-92441984,chr14,92441919,92441984,IMR90|chr14:20800826-20800911,chr14,20800826,20800911,1,71641093
IMR90|chr14:92441924-92441984,chr14,92441924,92441984,IMR90|chr14:20800826-20800911,chr14,20800826,20800911,1,71641098
IMR90|chr14:92449534-92449572,chr14,92449534,92449572,IMR90|chr14:69442371-69442483,chr14,69442371,69442483,1,23007163
IMR90|chr14:92449536-92449588,chr14,92449536,92449588,IMR90|chr14:69442371-69442483,chr14,69442371,69442483,1,23007165
IMR90|chr14:93008446-93008558,chr14,93008446,93008558,IMR90|chr14:50051897-50051974,chr14,50051897,50051974,1,42956549
IMR90|chr14:93008446-93008552,chr14,93008446,93008552,IMR90|chr14:50051897-50051974,chr14,50051897,50051974,1,42956549
IMR90|chr14:93008446-93008519,chr14,93008446,93008519,IMR90|chr14:50051897-50051974,chr14,50051897,50051974,1,42956549
IMR90|chr14:93054740-93054806,chr14,93054740,93054806,IMR90|chr14:93798446-93798502,chr14,93798446,93798502,1,743706
IMR90|chr14:93110536-93110577,chr14,93110536,93110577,IMR90|chr14:59933573-59933665,chr14,59933573,59933665,1,33176963
IMR90|chr14:93110536-93110572,chr14,93110536,93110572,IMR90|chr14:59933573-59933665,chr14,59933573,59933665,1,33176963
IMR90|chr14:95948051-95948136,chr14,95948051,95948136,IMR90|chr14:95981013-95981153,chr14,95981013,95981153,1,32962
IMR90|chr14:95954180-95954272,chr14,95954180,95954272,IMR90|chr14:95980746-95980819,chr14,95980746,95980819,1,26566
IMR90|chr14:95954180-95954257,chr14,95954180,95954257,IMR90|chr14:95980746-95980819,chr14,95980746,95980819,1,26566
IMR90|chr14:95954868-95954951,chr14,95954868,95954951,IMR90|chr14:95980598-95980642,chr14,95980598,95980642,1,25730
IMR90|chr14:95954869-95954951,chr14,95954869,95954951,IMR90|chr14:95980598-95980642,chr14,95980598,95980642,1,25729
IMR90|chr14:95955620-95955684,chr14,95955620,95955684,IMR90|chr14:95981450-95981491,chr14,95981450,95981491,1,25830
IMR90|chr14:95955622-95955684,chr14,95955622,95955684,IMR90|chr14:95981450-95981491,chr14,95981450,95981491,1,25828
IMR90|chr14:95964531-95964590,chr14,95964531,95964590,IMR90|chr14:95981725-95981814,chr14,95981725,95981814,1,17194
IMR90|chr14:95964532-95964590,chr14,95964532,95964590,IMR90|chr14:95981725-95981814,chr14,95981725,95981814,1,17193
IMR90|chr14:95966203-95966269,chr14,95966203,95966269,IMR90|chr14:95979146-95979202,chr14,95979146,95979202,1,12943
IMR90|chr14:95966637-95966695,chr14,95966637,95966695,IMR90|chr14:95981500-95981648,chr14,95981500,95981648,1,14863
IMR90|chr14:95969451-95969522,chr14,95969451,95969522,IMR90|chr14:95982235-95982296,chr14,95982235,95982296,1,12784
IMR90|chr14:95969453-95969522,chr14,95969453,95969522,IMR90|chr14:95982235-95982296,chr14,95982235,95982296,1,12782
IMR90|chr14:95969750-95969790,chr14,95969750,95969790,IMR90|chr14:95980658-95980801,chr14,95980658,95980801,1,10908
IMR90|chr14:95969953-95970041,chr14,95969953,95970041,IMR90|chr14:95979103-95979194,chr14,95979103,95979194,1,9150
IMR90|chr14:95971830-95971910,chr14,95971830,95971910,IMR90|chr14:95977506-95977536,chr14,95977506,95977536,1,5676
IMR90|chr14:95971831-95971910,chr14,95971831,95971910,IMR90|chr14:95977506-95977536,chr14,95977506,95977536,1,5675
IMR90|chr14:95972784-95972835,chr14,95972784,95972835,IMR90|chr14:95980240-95980318,chr14,95980240,95980318,1,7456
IMR90|chr14:95972785-95972835,chr14,95972785,95972835,IMR90|chr14:95980240-95980318,chr14,95980240,95980318,1,7455
IMR90|chr14:95973539-95973610,chr14,95973539,95973610,IMR90|chr14:95980053-95980114,chr14,95980053,95980114,1,6514
IMR90|chr14:95974783-95974882,chr14,95974783,95974882,IMR90|chr14:95979824-95979849,chr14,95979824,95979849,1,5041
IMR90|chr14:96686813-96686875,chr14,96686813,96686875,IMR90|chr14:105441746-105441832,chr14,105441746,105441832,1,8754933
IMR90|chr14:96686813-96686859,chr14,96686813,96686859,IMR90|chr14:105441746-105441800,chr14,105441746,105441800,1,8754933
IMR90|chr14:96686858-96686907,chr14,96686858,96686907,IMR90|chr14:105441746-105441832,chr14,105441746,105441832,1,8754888
IMR90|chr14:96727909-96728027,chr14,96727909,96728027,IMR90|chr14:95979672-95979739,chr14,95979672,95979739,1,748237
IMR90|chr14:96727944-96728027,chr14,96727944,96728027,IMR90|chr14:95979672-95979739,chr14,95979672,95979739,1,748272
IMR90|chr14:102521887-102521952,chr14,102521887,102521952,IMR90|chr14:105189815-105189874,chr14,105189815,105189874,1,2667928
IMR90|chr14:102521887-102521945,chr14,102521887,102521945,IMR90|chr14:105189815-105189874,chr14,105189815,105189874,1,2667928
IMR90|chr14:104065503-104065580,chr14,104065503,104065580,IMR90|chr14:104181161-104181263,chr14,104181161,104181263,1,115658
IMR90|chr14:104065533-104065580,chr14,104065533,104065580,IMR90|chr14:104181161-104181263,chr14,104181161,104181263,1,115628
IMR90|chr14:104102005-104102087,chr14,104102005,104102087,IMR90|chr14:103245425-103245490,chr14,103245425,103245490,1,856580
IMR90|chr14:105147360-105147430,chr14,105147360,105147430,IMR90|chr14:105153929-105153986,chr14,105153929,105153986,1,6569
IMR90|chr14:105148244-105148275,chr14,105148244,105148275,IMR90|chr14:105153760-105153836,chr14,105153760,105153836,1,5516
IMR90|chr15:22992179-22992275,chr15,22992179,22992275,IMR90|chr15:23032971-23033034,chr15,23032971,23033034,1,40792
IMR90|chr15:22992179-22992266,chr15,22992179,22992266,IMR90|chr15:23032971-23033034,chr15,23032971,23033034,1,40792
IMR90|chr15:26024723-26024833,chr15,26024723,26024833,IMR90|chr15:64752809-64752958,chr15,64752809,64752958,1,38728086
IMR90|chr15:26024727-26024833,chr15,26024727,26024833,IMR90|chr15:64752809-64752959,chr15,64752809,64752959,1,38728082
IMR90|chr15:28834997-28835147,chr15,28834997,28835147,IMR90|chr15:28566878-28567028,chr15,28566878,28567028,1,268119
IMR90|chr15:28835055-28835205,chr15,28835055,28835205,IMR90|chr15:28566669-28566816,chr15,28566669,28566816,1,268386
IMR90|chr15:30105317-30105380,chr15,30105317,30105380,IMR90|chr15:60684815-60684866,chr15,60684815,60684866,1,30579498
IMR90|chr15:30105317-30105378,chr15,30105317,30105378,IMR90|chr15:60684815-60684866,chr15,60684815,60684866,1,30579498
IMR90|chr15:33028686-33028749,chr15,33028686,33028749,IMR90|chr15:33013332-33013385,chr15,33013332,33013385,1,15354
IMR90|chr15:33028855-33028879,chr15,33028855,33028879,IMR90|chr15:33012566-33012641,chr15,33012566,33012641,1,16289
IMR90|chr15:33029096-33029171,chr15,33029096,33029171,IMR90|chr15:33011813-33011864,chr15,33011813,33011864,1,17283
IMR90|chr15:33029096-33029169,chr15,33029096,33029169,IMR90|chr15:33011813-33011864,chr15,33011813,33011864,1,17283
IMR90|chr15:33030007-33030065,chr15,33030007,33030065,IMR90|chr15:33011638-33011729,chr15,33011638,33011729,1,18369
IMR90|chr15:33071977-33072007,chr15,33071977,33072007,IMR90|chr15:71051829-71051906,chr15,71051829,71051906,1,37979852
IMR90|chr15:33071978-33072007,chr15,33071978,33072007,IMR90|chr15:71051829-71051907,chr15,71051829,71051907,1,37979851
IMR90|chr15:33072520-33072579,chr15,33072520,33072579,IMR90|chr15:33011746-33011811,chr15,33011746,33011811,1,60774
IMR90|chr15:33084343-33084373,chr15,33084343,33084373,IMR90|chr15:71054477-71054535,chr15,71054477,71054535,1,37970134
IMR90|chr15:33084346-33084373,chr15,33084346,33084373,IMR90|chr15:71054477-71054535,chr15,71054477,71054535,1,37970131
IMR90|chr15:33118721-33118764,chr15,33118721,33118764,IMR90|chr15:38545495-38545561,chr15,38545495,38545561,1,5426774
IMR90|chr15:33131661-33131783,chr15,33131661,33131783,IMR90|chr15:69222811-69222830,chr15,69222811,69222830,1,36091150
IMR90|chr15:33287924-33287951,chr15,33287924,33287951,IMR90|chr15:33012196-33012319,chr15,33012196,33012319,1,275728
IMR90|chr15:33287926-33287972,chr15,33287926,33287972,IMR90|chr15:33012196-33012319,chr15,33012196,33012319,1,275730
IMR90|chr15:33294897-33294939,chr15,33294897,33294939,IMR90|chr15:33012447-33012562,chr15,33012447,33012562,1,282450
IMR90|chr15:33294905-33294939,chr15,33294905,33294939,IMR90|chr15:33012447-33012562,chr15,33012447,33012562,1,282458
IMR90|chr15:33308845-33308889,chr15,33308845,33308889,IMR90|chr15:96902776-96902839,chr15,96902776,96902839,1,63593931
IMR90|chr15:33308846-33308889,chr15,33308846,33308889,IMR90|chr15:96902776-96902839,chr15,96902776,96902839,1,63593930
IMR90|chr15:37319456-37319490,chr15,37319456,37319490,IMR90|chr15:63342304-63342420,chr15,63342304,63342420,1,26022848
IMR90|chr15:37319459-37319551,chr15,37319459,37319551,IMR90|chr15:63342304-63342420,chr15,63342304,63342420,1,26022845
IMR90|chr15:37322725-37322844,chr15,37322725,37322844,IMR90|chr15:71051700-71051793,chr15,71051700,71051793,1,33728975
IMR90|chr15:37322785-37322844,chr15,37322785,37322844,IMR90|chr15:71051702-71051793,chr15,71051702,71051793,1,33728917
IMR90|chr15:37322785-37322842,chr15,37322785,37322842,IMR90|chr15:71051700-71051793,chr15,71051700,71051793,1,33728915
IMR90|chr15:37332755-37332819,chr15,37332755,37332819,IMR90|chr15:63336465-63336510,chr15,63336465,63336510,1,26003710
IMR90|chr15:38593079-38593106,chr15,38593079,38593106,IMR90|chr15:85291664-85291697,chr15,85291664,85291697,1,46698585
IMR90|chr15:39914667-39914722,chr15,39914667,39914722,IMR90|chr15:60687813-60687894,chr15,60687813,60687894,1,20773146
IMR90|chr15:39914669-39914722,chr15,39914669,39914722,IMR90|chr15:60687813-60687896,chr15,60687813,60687896,1,20773144
IMR90|chr15:40183782-40183877,chr15,40183782,40183877,IMR90|chr15:39875387-39875406,chr15,39875387,39875406,1,308395
IMR90|chr15:40188821-40188971,chr15,40188821,40188971,IMR90|chr15:69747137-69747272,chr15,69747137,69747272,1,29558316
IMR90|chr15:40188873-40188971,chr15,40188873,40188971,IMR90|chr15:69747137-69747272,chr15,69747137,69747272,1,29558264
IMR90|chr15:40198805-40198901,chr15,40198805,40198901,IMR90|chr15:39873646-39873698,chr15,39873646,39873698,1,325159
IMR90|chr15:40198808-40198901,chr15,40198808,40198901,IMR90|chr15:39873646-39873698,chr15,39873646,39873698,1,325162
IMR90|chr15:40623307-40623398,chr15,40623307,40623398,IMR90|chr15:40630342-40630404,chr15,40630342,40630404,1,7035
IMR90|chr15:40623307-40623395,chr15,40623307,40623395,IMR90|chr15:40630342-40630404,chr15,40630342,40630404,1,7035
IMR90|chr15:40623442-40623515,chr15,40623442,40623515,IMR90|chr15:40630590-40630623,chr15,40630590,40630623,1,7148
IMR90|chr15:48821353-48821404,chr15,48821353,48821404,IMR90|chr15:23032846-23032913,chr15,23032846,23032913,1,25788507
IMR90|chr15:48821353-48821403,chr15,48821353,48821403,IMR90|chr15:23032846-23032913,chr15,23032846,23032913,1,25788507
IMR90|chr15:48861082-48861150,chr15,48861082,48861150,IMR90|chr15:68872409-68872458,chr15,68872409,68872458,1,20011327
IMR90|chr15:52423205-52423268,chr15,52423205,52423268,IMR90|chr15:52314222-52314272,chr15,52314222,52314272,1,108983
IMR90|chr15:52423206-52423268,chr15,52423206,52423268,IMR90|chr15:52314222-52314272,chr15,52314222,52314272,1,108984
IMR90|chr15:52430305-52430441,chr15,52430305,52430441,IMR90|chr15:52314366-52314387,chr15,52314366,52314387,1,115939
IMR90|chr15:52430305-52430434,chr15,52430305,52430434,IMR90|chr15:52314366-52314387,chr15,52314366,52314387,1,115939
IMR90|chr15:56199806-56199892,chr15,56199806,56199892,IMR90|chr15:60685103-60685160,chr15,60685103,60685160,1,4485297
IMR90|chr15:56200954-56201063,chr15,56200954,56201063,IMR90|chr15:60686520-60686586,chr15,60686520,60686586,1,4485566
IMR90|chr15:56200954-56201035,chr15,56200954,56201035,IMR90|chr15:60686520-60686586,chr15,60686520,60686586,1,4485566
IMR90|chr15:57232260-57232334,chr15,57232260,57232334,IMR90|chr15:90548022-90548061,chr15,90548022,90548061,1,33315762
IMR90|chr15:57232260-57232331,chr15,57232260,57232331,IMR90|chr15:90548022-90548061,chr15,90548022,90548061,1,33315762
IMR90|chr15:57239514-57239544,chr15,57239514,57239544,IMR90|chr15:90549227-90549287,chr15,90549227,90549287,1,33309713
IMR90|chr15:57296715-57296841,chr15,57296715,57296841,IMR90|chr15:59965821-59965879,chr15,59965821,59965879,1,2669106
IMR90|chr15:57296749-57296841,chr15,57296749,57296841,IMR90|chr15:59965821-59965879,chr15,59965821,59965879,1,2669072
IMR90|chr15:57528065-57528167,chr15,57528065,57528167,IMR90|chr15:69109839-69109865,chr15,69109839,69109865,1,11581774
IMR90|chr15:57551691-57551731,chr15,57551691,57551731,IMR90|chr15:91473332-91473381,chr15,91473332,91473381,1,33921641
IMR90|chr15:59030487-59030582,chr15,59030487,59030582,IMR90|chr15:59966034-59966140,chr15,59966034,59966140,1,935547
IMR90|chr15:59030542-59030583,chr15,59030542,59030583,IMR90|chr15:59966034-59966140,chr15,59966034,59966140,1,935492
IMR90|chr15:59035123-59035171,chr15,59035123,59035171,IMR90|chr15:59967700-59967789,chr15,59967700,59967789,1,932577
IMR90|chr15:59035123-59035170,chr15,59035123,59035170,IMR90|chr15:59967700-59967789,chr15,59967700,59967789,1,932577
IMR90|chr15:59653267-59653340,chr15,59653267,59653340,IMR90|chr15:39877252-39877332,chr15,39877252,39877332,1,19776015
IMR90|chr15:59653359-59653429,chr15,59653359,59653429,IMR90|chr15:39877252-39877332,chr15,39877252,39877332,1,19776107
IMR90|chr15:60645525-60645566,chr15,60645525,60645566,IMR90|chr15:63335188-63335254,chr15,63335188,63335254,1,2689663
IMR90|chr15:60647113-60647157,chr15,60647113,60647157,IMR90|chr15:63336954-63337043,chr15,63336954,63337043,1,2689841
IMR90|chr15:60652744-60652866,chr15,60652744,60652866,IMR90|chr15:65423438-65423475,chr15,65423438,65423475,1,4770694
IMR90|chr15:60652753-60652866,chr15,60652753,60652866,IMR90|chr15:65423438-65423475,chr15,65423438,65423475,1,4770685
IMR90|chr15:60673098-60673137,chr15,60673098,60673137,IMR90|chr15:63335480-63335545,chr15,63335480,63335545,1,2662382
IMR90|chr15:60673098-60673133,chr15,60673098,60673133,IMR90|chr15:63335480-63335545,chr15,63335480,63335545,1,2662382
IMR90|chr15:62758181-62758243,chr15,62758181,62758243,IMR90|chr15:63344587-63344615,chr15,63344587,63344615,1,586406
IMR90|chr15:62758208-62758243,chr15,62758208,62758243,IMR90|chr15:63344587-63344615,chr15,63344587,63344615,1,586379
IMR90|chr15:62765031-62765072,chr15,62765031,62765072,IMR90|chr15:63342856-63342902,chr15,63342856,63342902,1,577825
IMR90|chr15:62765033-62765072,chr15,62765033,62765072,IMR90|chr15:63342856-63342902,chr15,63342856,63342902,1,577823
IMR90|chr15:62785277-62785354,chr15,62785277,62785354,IMR90|chr15:63346301-63346329,chr15,63346301,63346329,1,561024
IMR90|chr15:63364936-63365036,chr15,63364936,63365036,IMR90|chr15:63345449-63345488,chr15,63345449,63345488,1,19487
IMR90|chr15:63365444-63365510,chr15,63365444,63365510,IMR90|chr15:63336584-63336623,chr15,63336584,63336623,1,28860
IMR90|chr15:63505312-63505356,chr15,63505312,63505356,IMR90|chr15:63673497-63673609,chr15,63673497,63673609,1,168185
IMR90|chr15:63505322-63505357,chr15,63505322,63505357,IMR90|chr15:63673497-63673609,chr15,63673497,63673609,1,168175
IMR90|chr15:63518392-63518433,chr15,63518392,63518433,IMR90|chr15:63344411-63344489,chr15,63344411,63344489,1,173981
IMR90|chr15:63518397-63518433,chr15,63518397,63518433,IMR90|chr15:63344411-63344489,chr15,63344411,63344489,1,173986
IMR90|chr15:63537806-63537883,chr15,63537806,63537883,IMR90|chr15:63342723-63342792,chr15,63342723,63342792,1,195083
IMR90|chr15:64801821-64801883,chr15,64801821,64801883,IMR90|chr15:59965500-59965557,chr15,59965500,59965557,1,4836321
IMR90|chr15:64821109-64821198,chr15,64821109,64821198,IMR90|chr15:33011657-33011714,chr15,33011657,33011714,1,31809452
IMR90|chr15:64821109-64821170,chr15,64821109,64821170,IMR90|chr15:33011657-33011714,chr15,33011657,33011714,1,31809452
IMR90|chr15:64908869-64908975,chr15,64908869,64908975,IMR90|chr15:72523119-72523160,chr15,72523119,72523160,1,7614250
IMR90|chr15:67018708-67018769,chr15,67018708,67018769,IMR90|chr15:67360760-67360889,chr15,67360760,67360889,1,342052
IMR90|chr15:67018748-67018769,chr15,67018748,67018769,IMR90|chr15:67360760-67360889,chr15,67360760,67360889,1,342012
IMR90|chr15:67064511-67064661,chr15,67064511,67064661,IMR90|chr15:67362109-67362153,chr15,67362109,67362153,1,297598
IMR90|chr15:67064638-67064741,chr15,67064638,67064741,IMR90|chr15:67362109-67362153,chr15,67362109,67362153,1,297471
IMR90|chr15:67364350-67364467,chr15,67364350,67364467,IMR90|chr15:60683919-60683952,chr15,60683919,60683952,1,6680431
IMR90|chr15:67364356-67364467,chr15,67364356,67364467,IMR90|chr15:60683919-60683952,chr15,60683919,60683952,1,6680437
IMR90|chr15:67364667-67364725,chr15,67364667,67364725,IMR90|chr15:67000356-67000448,chr15,67000356,67000448,1,364311
IMR90|chr15:67364667-67364723,chr15,67364667,67364723,IMR90|chr15:67000356-67000448,chr15,67000356,67000448,1,364311
IMR90|chr15:67368698-67368771,chr15,67368698,67368771,IMR90|chr15:60686617-60686677,chr15,60686617,60686677,1,6682081
IMR90|chr15:67372142-67372170,chr15,67372142,67372170,IMR90|chr15:71054851-71054948,chr15,71054851,71054948,1,3682709
IMR90|chr15:67373705-67373727,chr15,67373705,67373727,IMR90|chr15:60689961-60690086,chr15,60689961,60690086,1,6683744
IMR90|chr15:67373706-67373727,chr15,67373706,67373727,IMR90|chr15:60689961-60690086,chr15,60689961,60690086,1,6683745
IMR90|chr15:67383554-67383667,chr15,67383554,67383667,IMR90|chr15:71053456-71053493,chr15,71053456,71053493,1,3669902
IMR90|chr15:67383555-67383678,chr15,67383555,67383678,IMR90|chr15:71053456-71053493,chr15,71053456,71053493,1,3669901
IMR90|chr15:67396532-67396608,chr15,67396532,67396608,IMR90|chr15:71055101-71055175,chr15,71055101,71055175,1,3658569
IMR90|chr15:67396534-67396622,chr15,67396534,67396622,IMR90|chr15:71055099-71055161,chr15,71055099,71055161,1,3658565
IMR90|chr15:67399874-67399944,chr15,67399874,67399944,IMR90|chr15:67000005-67000056,chr15,67000005,67000056,1,399869
IMR90|chr15:67400842-67400925,chr15,67400842,67400925,IMR90|chr15:66998205-66998259,chr15,66998205,66998259,1,402637
IMR90|chr15:67402596-67402637,chr15,67402596,67402637,IMR90|chr15:60684957-60685001,chr15,60684957,60685001,1,6717639
IMR90|chr15:67466720-67466802,chr15,67466720,67466802,IMR90|chr15:90357158-90357187,chr15,90357158,90357187,1,22890438
IMR90|chr15:67466720-67466801,chr15,67466720,67466801,IMR90|chr15:90357158-90357187,chr15,90357158,90357187,1,22890438
IMR90|chr15:67466725-67466801,chr15,67466725,67466801,IMR90|chr15:90357158-90357187,chr15,90357158,90357187,1,22890433
IMR90|chr15:67513993-67514039,chr15,67513993,67514039,IMR90|chr15:67430513-67430606,chr15,67430513,67430606,1,83480
IMR90|chr15:67521457-67521526,chr15,67521457,67521526,IMR90|chr15:67419385-67419423,chr15,67419385,67419423,1,102072
IMR90|chr15:67521459-67521526,chr15,67521459,67521526,IMR90|chr15:67419385-67419423,chr15,67419385,67419423,1,102074
IMR90|chr15:68878589-68878620,chr15,68878589,68878620,IMR90|chr15:96871597-96871720,chr15,96871597,96871720,1,27993008
IMR90|chr15:68878593-68878620,chr15,68878593,68878620,IMR90|chr15:96871597-96871720,chr15,96871597,96871720,1,27993004
IMR90|chr15:68899660-68899741,chr15,68899660,68899741,IMR90|chr15:96869628-96869663,chr15,96869628,96869663,1,27969968
IMR90|chr15:69105876-69105929,chr15,69105876,69105929,IMR90|chr15:93452081-93452144,chr15,93452081,93452144,1,24346205
IMR90|chr15:70875636-70875672,chr15,70875636,70875672,IMR90|chr15:70994678-70994769,chr15,70994678,70994769,1,119042
IMR90|chr15:70878334-70878385,chr15,70878334,70878385,IMR90|chr15:71051868-71051951,chr15,71051868,71051951,1,173534
IMR90|chr15:70878356-70878385,chr15,70878356,70878385,IMR90|chr15:71051868-71051951,chr15,71051868,71051951,1,173512
IMR90|chr15:70878357-70878385,chr15,70878357,70878385,IMR90|chr15:71051868-71051951,chr15,71051868,71051951,1,173511
IMR90|chr15:70885695-70885754,chr15,70885695,70885754,IMR90|chr15:70994688-70994746,chr15,70994688,70994746,1,108993
IMR90|chr15:70887772-70887873,chr15,70887772,70887873,IMR90|chr15:71054834-71054926,chr15,71054834,71054926,1,167062
IMR90|chr15:70900350-70900434,chr15,70900350,70900434,IMR90|chr15:70995075-70995141,chr15,70995075,70995141,1,94725
IMR90|chr15:70900410-70900434,chr15,70900410,70900434,IMR90|chr15:70995075-70995183,chr15,70995075,70995183,1,94665
IMR90|chr15:70901878-70901970,chr15,70901878,70901970,IMR90|chr15:71051240-71051284,chr15,71051240,71051284,1,149362
IMR90|chr15:70906992-70907033,chr15,70906992,70907033,IMR90|chr15:71053613-71053647,chr15,71053613,71053647,1,146621
IMR90|chr15:70907207-70907292,chr15,70907207,70907292,IMR90|chr15:71051677-71051715,chr15,71051677,71051715,1,144470
IMR90|chr15:70908072-70908143,chr15,70908072,70908143,IMR90|chr15:71051771-71051816,chr15,71051771,71051816,1,143699
IMR90|chr15:70908072-70908142,chr15,70908072,70908142,IMR90|chr15:71051771-71051816,chr15,71051771,71051816,1,143699
IMR90|chr15:70909401-70909427,chr15,70909401,70909427,IMR90|chr15:65119779-65119909,chr15,65119779,65119909,1,5789622
IMR90|chr15:70909664-70909695,chr15,70909664,70909695,IMR90|chr15:71051236-71051320,chr15,71051236,71051320,1,141572
IMR90|chr15:70909889-70909982,chr15,70909889,70909982,IMR90|chr15:71052230-71052282,chr15,71052230,71052282,1,142341
IMR90|chr15:71005639-71005696,chr15,71005639,71005696,IMR90|chr15:72521763-72521852,chr15,72521763,72521852,1,1516124
IMR90|chr15:71005640-71005696,chr15,71005640,71005696,IMR90|chr15:72521763-72521852,chr15,72521763,72521852,1,1516123
IMR90|chr15:71008503-71008600,chr15,71008503,71008600,IMR90|chr15:71145184-71145227,chr15,71145184,71145227,1,136681
IMR90|chr15:71009472-71009570,chr15,71009472,71009570,IMR90|chr15:102189644-102189693,chr15,102189644,102189693,1,31180172
IMR90|chr15:71009497-71009588,chr15,71009497,71009588,IMR90|chr15:102189644-102189693,chr15,102189644,102189693,1,31180147
IMR90|chr15:71010077-71010105,chr15,71010077,71010105,IMR90|chr15:50650641-50650733,chr15,50650641,50650733,1,20359436
IMR90|chr15:71017346-71017456,chr15,71017346,71017456,IMR90|chr15:60685063-60685102,chr15,60685063,60685102,1,10332283
IMR90|chr15:71017702-71017741,chr15,71017702,71017741,IMR90|chr15:78591638-78591749,chr15,78591638,78591749,1,7573936
IMR90|chr15:71017704-71017767,chr15,71017704,71017767,IMR90|chr15:78591638-78591749,chr15,78591638,78591749,1,7573934
IMR90|chr15:71019248-71019320,chr15,71019248,71019320,IMR90|chr15:71143119-71143194,chr15,71143119,71143194,1,123871
IMR90|chr15:71019326-71019366,chr15,71019326,71019366,IMR90|chr15:71149610-71149684,chr15,71149610,71149684,1,130284
IMR90|chr15:71020767-71020852,chr15,71020767,71020852,IMR90|chr15:72515435-72515469,chr15,72515435,72515469,1,1494668
IMR90|chr15:71020767-71020851,chr15,71020767,71020851,IMR90|chr15:72515435-72515469,chr15,72515435,72515469,1,1494668
IMR90|chr15:71021083-71021137,chr15,71021083,71021137,IMR90|chr15:33013970-33014045,chr15,33013970,33014045,1,38007113
IMR90|chr15:71027583-71027650,chr15,71027583,71027650,IMR90|chr15:74831574-74831644,chr15,74831574,74831644,1,3803991
IMR90|chr15:71027585-71027650,chr15,71027585,71027650,IMR90|chr15:74831574-74831644,chr15,74831574,74831644,1,3803989
IMR90|chr15:71028941-71029086,chr15,71028941,71029086,IMR90|chr15:60687671-60687688,chr15,60687671,60687688,1,10341270
IMR90|chr15:71028966-71029094,chr15,71028966,71029094,IMR90|chr15:60687671-60687688,chr15,60687671,60687688,1,10341295
IMR90|chr15:71029359-71029408,chr15,71029359,71029408,IMR90|chr15:50642292-50642361,chr15,50642292,50642361,1,20387067
IMR90|chr15:71030147-71030240,chr15,71030147,71030240,IMR90|chr15:33012502-33012548,chr15,33012502,33012548,1,38017645
IMR90|chr15:71030147-71030199,chr15,71030147,71030199,IMR90|chr15:57512713-57512759,chr15,57512713,57512759,1,13517434
IMR90|chr15:71030148-71030199,chr15,71030148,71030199,IMR90|chr15:57512713-57512758,chr15,57512713,57512758,1,13517435
IMR90|chr15:71030149-71030240,chr15,71030149,71030240,IMR90|chr15:33012502-33012548,chr15,33012502,33012548,1,38017647
IMR90|chr15:71030864-71030888,chr15,71030864,71030888,IMR90|chr15:33011782-33011839,chr15,33011782,33011839,1,38019082
IMR90|chr15:71031096-71031147,chr15,71031096,71031147,IMR90|chr15:60686616-60686693,chr15,60686616,60686693,1,10344480
IMR90|chr15:71031100-71031147,chr15,71031100,71031147,IMR90|chr15:60686616-60686693,chr15,60686616,60686693,1,10344484
IMR90|chr15:71031729-71031797,chr15,71031729,71031797,IMR90|chr15:71142592-71142637,chr15,71142592,71142637,1,110863
IMR90|chr15:71032662-71032707,chr15,71032662,71032707,IMR90|chr15:71408348-71408497,chr15,71408348,71408497,1,375686
IMR90|chr15:71035062-71035085,chr15,71035062,71035085,IMR90|chr15:33013231-33013378,chr15,33013231,33013378,1,38021831
IMR90|chr15:71037509-71037652,chr15,71037509,71037652,IMR90|chr15:60687551-60687613,chr15,60687551,60687613,1,10349958
IMR90|chr15:71037670-71037764,chr15,71037670,71037764,IMR90|chr15:75203700-75203847,chr15,75203700,75203847,1,4166030
IMR90|chr15:71037699-71037764,chr15,71037699,71037764,IMR90|chr15:75203700-75203799,chr15,75203700,75203799,1,4166001
IMR90|chr15:71039349-71039381,chr15,71039349,71039381,IMR90|chr15:72519212-72519359,chr15,72519212,72519359,1,1479863
IMR90|chr15:71039542-71039571,chr15,71039542,71039571,IMR90|chr15:74835447-74835522,chr15,74835447,74835522,1,3795905
IMR90|chr15:71039602-71039701,chr15,71039602,71039701,IMR90|chr15:74835447-74835522,chr15,74835447,74835522,1,3795845
IMR90|chr15:71041554-71041631,chr15,71041554,71041631,IMR90|chr15:102190950-102191023,chr15,102190950,102191023,1,31149396
IMR90|chr15:71042785-71042843,chr15,71042785,71042843,IMR90|chr15:60685952-60685974,chr15,60685952,60685974,1,10356833
IMR90|chr15:71043394-71043486,chr15,71043394,71043486,IMR90|chr15:72521788-72521877,chr15,72521788,72521877,1,1478394
IMR90|chr15:71043394-71043455,chr15,71043394,71043455,IMR90|chr15:72521788-72521877,chr15,72521788,72521877,1,1478394
IMR90|chr15:71044455-71044550,chr15,71044455,71044550,IMR90|chr15:60686723-60686778,chr15,60686723,60686778,1,10357732
IMR90|chr15:71046666-71046802,chr15,71046666,71046802,IMR90|chr15:72515729-72515782,chr15,72515729,72515782,1,1469063
IMR90|chr15:71046710-71046802,chr15,71046710,71046802,IMR90|chr15:72515724-72515782,chr15,72515724,72515782,1,1469014
IMR90|chr15:71048486-71048527,chr15,71048486,71048527,IMR90|chr15:50645841-50645918,chr15,50645841,50645918,1,20402645
IMR90|chr15:71048923-71049037,chr15,71048923,71049037,IMR90|chr15:72520498-72520515,chr15,72520498,72520515,1,1471575
IMR90|chr15:71048926-71049037,chr15,71048926,71049037,IMR90|chr15:72520498-72520515,chr15,72520498,72520515,1,1471572
IMR90|chr15:71082640-71082761,chr15,71082640,71082761,IMR90|chr15:71055502-71055525,chr15,71055502,71055525,1,27138
IMR90|chr15:71082694-71082844,chr15,71082694,71082844,IMR90|chr15:71055502-71055525,chr15,71055502,71055525,1,27192
IMR90|chr15:71094057-71094174,chr15,71094057,71094174,IMR90|chr15:71053085-71053104,chr15,71053085,71053104,1,40972
IMR90|chr15:71094060-71094172,chr15,71094060,71094172,IMR90|chr15:71053074-71053108,chr15,71053074,71053108,1,40986
IMR90|chr15:71094086-71094164,chr15,71094086,71094164,IMR90|chr15:71053188-71053225,chr15,71053188,71053225,1,40898
IMR90|chr15:71094570-71094623,chr15,71094570,71094623,IMR90|chr15:71051892-71051996,chr15,71051892,71051996,1,42678
IMR90|chr15:71094570-71094616,chr15,71094570,71094616,IMR90|chr15:71051892-71051996,chr15,71051892,71051996,1,42678
IMR90|chr15:71575628-71575677,chr15,71575628,71575677,IMR90|chr15:71051758-71051827,chr15,71051758,71051827,1,523870
IMR90|chr15:71592421-71592544,chr15,71592421,71592544,IMR90|chr15:72518941-72519030,chr15,72518941,72519030,1,926520
IMR90|chr15:71592421-71592482,chr15,71592421,71592482,IMR90|chr15:72518941-72519030,chr15,72518941,72519030,1,926520
IMR90|chr15:71604127-71604199,chr15,71604127,71604199,IMR90|chr15:71052060-71052086,chr15,71052060,71052086,1,552067
IMR90|chr15:71611156-71611211,chr15,71611156,71611211,IMR90|chr15:72519443-72519499,chr15,72519443,72519499,1,908287
IMR90|chr15:71611716-71611767,chr15,71611716,71611767,IMR90|chr15:71054996-71055110,chr15,71054996,71055110,1,556720
IMR90|chr15:71614727-71614757,chr15,71614727,71614757,IMR90|chr15:72520133-72520213,chr15,72520133,72520213,1,905406
IMR90|chr15:71646559-71646676,chr15,71646559,71646676,IMR90|chr15:71052609-71052646,chr15,71052609,71052646,1,593950
IMR90|chr15:71646564-71646677,chr15,71646564,71646677,IMR90|chr15:71052609-71052646,chr15,71052609,71052646,1,593955
IMR90|chr15:71654175-71654240,chr15,71654175,71654240,IMR90|chr15:71053838-71053917,chr15,71053838,71053917,1,600337
IMR90|chr15:71745093-71745135,chr15,71745093,71745135,IMR90|chr15:71051797-71051908,chr15,71051797,71051908,1,693296
IMR90|chr15:71745093-71745128,chr15,71745093,71745128,IMR90|chr15:71051797-71051908,chr15,71051797,71051908,1,693296
IMR90|chr15:71745660-71745804,chr15,71745660,71745804,IMR90|chr15:71051543-71051580,chr15,71051543,71051580,1,694117
IMR90|chr15:71745660-71745773,chr15,71745660,71745773,IMR90|chr15:71051543-71051580,chr15,71051543,71051580,1,694117
IMR90|chr15:71747249-71747318,chr15,71747249,71747318,IMR90|chr15:71054022-71054046,chr15,71054022,71054046,1,693227
IMR90|chr15:71747249-71747317,chr15,71747249,71747317,IMR90|chr15:71054022-71054046,chr15,71054022,71054046,1,693227
IMR90|chr15:71800729-71800877,chr15,71800729,71800877,IMR90|chr15:72410926-72410962,chr15,72410926,72410962,1,610197
IMR90|chr15:71800730-71800877,chr15,71800730,71800877,IMR90|chr15:72410926-72410962,chr15,72410926,72410962,1,610196
IMR90|chr15:71800730-71800809,chr15,71800730,71800809,IMR90|chr15:72410926-72410962,chr15,72410926,72410962,1,610196
IMR90|chr15:71800850-71800961,chr15,71800850,71800961,IMR90|chr15:72410926-72410962,chr15,72410926,72410962,1,610076
IMR90|chr15:74692435-74692484,chr15,74692435,74692484,IMR90|chr15:60688705-60688768,chr15,60688705,60688768,1,14003730
IMR90|chr15:74692435-74692483,chr15,74692435,74692483,IMR90|chr15:60688705-60688768,chr15,60688705,60688768,1,14003730
IMR90|chr15:74693613-74693636,chr15,74693613,74693636,IMR90|chr15:60686407-60686441,chr15,60686407,60686441,1,14007206
IMR90|chr15:74693670-74693738,chr15,74693670,74693738,IMR90|chr15:60686407-60686441,chr15,60686407,60686441,1,14007263
IMR90|chr15:74706621-74706671,chr15,74706621,74706671,IMR90|chr15:39877067-39877120,chr15,39877067,39877120,1,34829554
IMR90|chr15:74706621-74706670,chr15,74706621,74706670,IMR90|chr15:39877437-39877473,chr15,39877437,39877473,1,34829184
IMR90|chr15:74711846-74711887,chr15,74711846,74711887,IMR90|chr15:39877474-39877579,chr15,39877474,39877579,1,34834372
IMR90|chr15:78284050-78284095,chr15,78284050,78284095,IMR90|chr15:85046504-85046596,chr15,85046504,85046596,1,6762454
IMR90|chr15:80463820-80463913,chr15,80463820,80463913,IMR90|chr15:34518769-34518879,chr15,34518769,34518879,1,45945051
IMR90|chr15:85952800-85952854,chr15,85952800,85952854,IMR90|chr15:85295766-85295798,chr15,85295766,85295798,1,657034
IMR90|chr15:85952875-85953009,chr15,85952875,85953009,IMR90|chr15:85295766-85295798,chr15,85295766,85295798,1,657109
IMR90|chr15:89639648-89639675,chr15,89639648,89639675,IMR90|chr15:89877264-89877375,chr15,89877264,89877375,1,237616
IMR90|chr15:89653391-89653455,chr15,89653391,89653455,IMR90|chr15:89877499-89877567,chr15,89877499,89877567,1,224108
IMR90|chr15:89675115-89675157,chr15,89675115,89675157,IMR90|chr15:89166516-89166602,chr15,89166516,89166602,1,508599
IMR90|chr15:89703890-89703947,chr15,89703890,89703947,IMR90|chr15:89165051-89165125,chr15,89165051,89165125,1,538839
IMR90|chr15:90569077-90569150,chr15,90569077,90569150,IMR90|chr15:63342096-63342131,chr15,63342096,63342131,1,27226981
IMR90|chr15:90945340-90945375,chr15,90945340,90945375,IMR90|chr15:90644820-90644902,chr15,90644820,90644902,1,300520
IMR90|chr15:91095381-91095480,chr15,91095381,91095480,IMR90|chr15:63345318-63345345,chr15,63345318,63345345,1,27750063
IMR90|chr15:96808435-96808494,chr15,96808435,96808494,IMR90|chr15:89176864-89176923,chr15,89176864,89176923,1,7631571
IMR90|chr15:96815251-96815286,chr15,96815251,96815286,IMR90|chr15:89180291-89180335,chr15,89180291,89180335,1,7634960
IMR90|chr15:96883624-96883755,chr15,96883624,96883755,IMR90|chr15:96878061-96878183,chr15,96878061,96878183,1,5563
IMR90|chr15:96883624-96883652,chr15,96883624,96883652,IMR90|chr15:96878061-96878183,chr15,96878061,96878183,1,5563
IMR90|chr15:96883907-96883987,chr15,96883907,96883987,IMR90|chr15:96875871-96875924,chr15,96875871,96875924,1,8036
IMR90|chr15:96885176-96885203,chr15,96885176,96885203,IMR90|chr15:96876146-96876216,chr15,96876146,96876216,1,9030
IMR90|chr15:96885188-96885259,chr15,96885188,96885259,IMR90|chr15:96879928-96879995,chr15,96879928,96879995,1,5260
IMR90|chr15:96886144-96886182,chr15,96886144,96886182,IMR90|chr15:96879283-96879379,chr15,96879283,96879379,1,6861
IMR90|chr15:96887588-96887613,chr15,96887588,96887613,IMR90|chr15:96879181-96879242,chr15,96879181,96879242,1,8407
IMR90|chr15:96887589-96887690,chr15,96887589,96887690,IMR90|chr15:96879181-96879242,chr15,96879181,96879242,1,8408
IMR90|chr15:96891746-96891831,chr15,96891746,96891831,IMR90|chr15:96871259-96871313,chr15,96871259,96871313,1,20487
IMR90|chr15:96891822-96891953,chr15,96891822,96891953,IMR90|chr15:96870695-96870714,chr15,96870695,96870714,1,21127
IMR90|chr15:96891824-96891974,chr15,96891824,96891974,IMR90|chr15:96870695-96870714,chr15,96870695,96870714,1,21129
IMR90|chr15:99208212-99208343,chr15,99208212,99208343,IMR90|chr15:85293141-85293215,chr15,85293141,85293215,1,13915071
IMR90|chr15:99208212-99208287,chr15,99208212,99208287,IMR90|chr15:85293141-85293216,chr15,85293141,85293216,1,13915071
IMR90|chr15:99333738-99333772,chr15,99333738,99333772,IMR90|chr15:72522586-72522736,chr15,72522586,72522736,1,26811152
IMR90|chr15:99333739-99333772,chr15,99333739,99333772,IMR90|chr15:72522586-72522736,chr15,72522586,72522736,1,26811153
IMR90|chr15:99348044-99348143,chr15,99348044,99348143,IMR90|chr15:90549168-90549215,chr15,90549168,90549215,1,8798876
IMR90|chr15:99348047-99348142,chr15,99348047,99348142,IMR90|chr15:90549168-90549215,chr15,90549168,90549215,1,8798879
IMR90|chr15:99348047-99348099,chr15,99348047,99348099,IMR90|chr15:90549168-90549215,chr15,90549168,90549215,1,8798879
IMR90|chr15:99493070-99493148,chr15,99493070,99493148,IMR90|chr15:89441348-89441382,chr15,89441348,89441382,1,10051722
IMR90|chr15:99493070-99493135,chr15,99493070,99493135,IMR90|chr15:89441348-89441380,chr15,89441348,89441380,1,10051722
IMR90|chr15:101713448-101713512,chr15,101713448,101713512,IMR90|chr15:71051885-71052008,chr15,71051885,71052008,1,30661563
IMR90|chr15:101713448-101713475,chr15,101713448,101713475,IMR90|chr15:71051885-71052008,chr15,71051885,71052008,1,30661563
IMR90|chr15:101731854-101731885,chr15,101731854,101731885,IMR90|chr15:66997607-66997715,chr15,66997607,66997715,1,34734247
IMR90|chr15:101731854-101731882,chr15,101731854,101731882,IMR90|chr15:66997607-66997716,chr15,66997607,66997716,1,34734247
IMR90|chr15:101757753-101757900,chr15,101757753,101757900,IMR90|chr15:72519240-72519290,chr15,72519240,72519290,1,29238513
IMR90|chr15:101757803-101757903,chr15,101757803,101757903,IMR90|chr15:72519240-72519290,chr15,72519240,72519290,1,29238563
IMR90|chr15:101758712-101758799,chr15,101758712,101758799,IMR90|chr15:71054853-71054892,chr15,71054853,71054892,1,30703859
IMR90|chr15:101761087-101761156,chr15,101761087,101761156,IMR90|chr15:96876120-96876152,chr15,96876120,96876152,1,4884967
IMR90|chr16:392308-392389,chr16,392308,392389,IMR90|chr16:452022-452076,chr16,452022,452076,1,59714
IMR90|chr16:392308-392386,chr16,392308,392386,IMR90|chr16:452022-452076,chr16,452022,452076,1,59714
IMR90|chr16:395564-395649,chr16,395564,395649,IMR90|chr16:435301-435341,chr16,435301,435341,1,39737
IMR90|chr16:395564-395648,chr16,395564,395648,IMR90|chr16:435301-435341,chr16,435301,435341,1,39737
IMR90|chr16:2046520-2046595,chr16,2046520,2046595,IMR90|chr16:2045315-2045376,chr16,2045315,2045376,1,1205
IMR90|chr16:2046521-2046597,chr16,2046521,2046597,IMR90|chr16:2045317-2045391,chr16,2045317,2045391,1,1204
IMR90|chr16:2046917-2046951,chr16,2046917,2046951,IMR90|chr16:2045882-2045932,chr16,2045882,2045932,1,1035
IMR90|chr16:2046968-2047046,chr16,2046968,2047046,IMR90|chr16:2045882-2045932,chr16,2045882,2045932,1,1086
IMR90|chr16:2653188-2653269,chr16,2653188,2653269,IMR90|chr16:2732235-2732273,chr16,2732235,2732273,1,79047
IMR90|chr16:2653189-2653269,chr16,2653189,2653269,IMR90|chr16:2732235-2732273,chr16,2732235,2732273,1,79046
IMR90|chr16:2655483-2655632,chr16,2655483,2655632,IMR90|chr16:2733243-2733322,chr16,2733243,2733322,1,77760
IMR90|chr16:2655640-2655708,chr16,2655640,2655708,IMR90|chr16:2733243-2733322,chr16,2733243,2733322,1,77603
IMR90|chr16:3848033-3848093,chr16,3848033,3848093,IMR90|chr16:3448299-3448337,chr16,3448299,3448337,1,399734
IMR90|chr16:3878304-3878366,chr16,3878304,3878366,IMR90|chr16:3662643-3662681,chr16,3662643,3662681,1,215661
IMR90|chr16:3898165-3898199,chr16,3898165,3898199,IMR90|chr16:3661779-3661892,chr16,3661779,3661892,1,236386
IMR90|chr16:3898169-3898196,chr16,3898169,3898196,IMR90|chr16:3661779-3661892,chr16,3661779,3661892,1,236390
IMR90|chr16:3914987-3915051,chr16,3914987,3915051,IMR90|chr16:3031215-3031268,chr16,3031215,3031268,1,883772
IMR90|chr16:4060634-4060654,chr16,4060634,4060654,IMR90|chr16:86540428-86540518,chr16,86540428,86540518,1,82479794
IMR90|chr16:4339701-4339781,chr16,4339701,4339781,IMR90|chr16:4326249-4326399,chr16,4326249,4326399,1,13452
IMR90|chr16:4340515-4340609,chr16,4340515,4340609,IMR90|chr16:88217190-88217237,chr16,88217190,88217237,1,83876675
IMR90|chr16:4349821-4349892,chr16,4349821,4349892,IMR90|chr16:4327295-4327329,chr16,4327295,4327329,1,22526
IMR90|chr16:4349821-4349891,chr16,4349821,4349891,IMR90|chr16:4327295-4327329,chr16,4327295,4327329,1,22526
IMR90|chr16:4355654-4355702,chr16,4355654,4355702,IMR90|chr16:4327280-4327342,chr16,4327280,4327342,1,28374
IMR90|chr16:4376917-4377028,chr16,4376917,4377028,IMR90|chr16:67279905-67279943,chr16,67279905,67279943,1,62902988
IMR90|chr16:4376917-4377026,chr16,4376917,4377026,IMR90|chr16:67279905-67279943,chr16,67279905,67279943,1,62902988
IMR90|chr16:8945557-8945635,chr16,8945557,8945635,IMR90|chr16:9188656-9188728,chr16,9188656,9188728,1,243099
IMR90|chr16:8945557-8945634,chr16,8945557,8945634,IMR90|chr16:9188656-9188728,chr16,9188656,9188728,1,243099
IMR90|chr16:8945558-8945643,chr16,8945558,8945643,IMR90|chr16:9188656-9188728,chr16,9188656,9188728,1,243098
IMR90|chr16:8945558-8945641,chr16,8945558,8945641,IMR90|chr16:9188656-9188728,chr16,9188656,9188728,1,243098
IMR90|chr16:9194270-9194294,chr16,9194270,9194294,IMR90|chr16:11830584-11830631,chr16,11830584,11830631,1,2636314
IMR90|chr16:9199632-9199782,chr16,9199632,9199782,IMR90|chr16:11835510-11835571,chr16,11835510,11835571,1,2635878
IMR90|chr16:9199632-9199663,chr16,9199632,9199663,IMR90|chr16:11835510-11835571,chr16,11835510,11835571,1,2635878
IMR90|chr16:9219304-9219361,chr16,9219304,9219361,IMR90|chr16:71495505-71495558,chr16,71495505,71495558,1,62276201
IMR90|chr16:9219304-9219360,chr16,9219304,9219360,IMR90|chr16:71495505-71495558,chr16,71495505,71495558,1,62276201
IMR90|chr16:11143413-11143435,chr16,11143413,11143435,IMR90|chr16:11835574-11835675,chr16,11835574,11835675,1,692161
IMR90|chr16:11143414-11143435,chr16,11143414,11143435,IMR90|chr16:11835574-11835675,chr16,11835574,11835675,1,692160
IMR90|chr16:11143414-11143434,chr16,11143414,11143434,IMR90|chr16:11835574-11835674,chr16,11835574,11835674,1,692160
IMR90|chr16:15109421-15109511,chr16,15109421,15109511,IMR90|chr16:31103060-31103091,chr16,31103060,31103091,1,15993639
IMR90|chr16:15109423-15109511,chr16,15109423,15109511,IMR90|chr16:31103058-31103091,chr16,31103058,31103091,1,15993635
IMR90|chr16:15241086-15241122,chr16,15241086,15241122,IMR90|chr16:2181627-2181741,chr16,2181627,2181741,1,13059459
IMR90|chr16:15241086-15241121,chr16,15241086,15241121,IMR90|chr16:2181627-2181741,chr16,2181627,2181741,1,13059459
IMR90|chr16:15245230-15245327,chr16,15245230,15245327,IMR90|chr16:2182607-2182757,chr16,2182607,2182757,1,13062623
IMR90|chr16:15245788-15245841,chr16,15245788,15245841,IMR90|chr16:2183011-2183106,chr16,2183011,2183106,1,13062777
IMR90|chr16:15245790-15245831,chr16,15245790,15245831,IMR90|chr16:2182994-2183103,chr16,2182994,2183103,1,13062796
IMR90|chr16:15245859-15245911,chr16,15245859,15245911,IMR90|chr16:2183073-2183119,chr16,2183073,2183119,1,13062786
IMR90|chr16:16062288-16062326,chr16,16062288,16062326,IMR90|chr16:89160926-89161074,chr16,89160926,89161074,1,73098638
IMR90|chr16:16088620-16088656,chr16,16088620,16088656,IMR90|chr16:89161166-89161280,chr16,89161166,89161280,1,73072546
IMR90|chr16:16088621-16088666,chr16,16088621,16088666,IMR90|chr16:89161166-89161280,chr16,89161166,89161280,1,73072545
IMR90|chr16:16111903-16111932,chr16,16111903,16111932,IMR90|chr16:28885742-28885830,chr16,28885742,28885830,1,12773839
IMR90|chr16:16111904-16111930,chr16,16111904,16111930,IMR90|chr16:28885742-28885830,chr16,28885742,28885830,1,12773838
IMR90|chr16:16168383-16168469,chr16,16168383,16168469,IMR90|chr16:15982353-15982410,chr16,15982353,15982410,1,186030
IMR90|chr16:16168398-16168474,chr16,16168398,16168474,IMR90|chr16:15982334-15982405,chr16,15982334,15982405,1,186064
IMR90|chr16:19710181-19710254,chr16,19710181,19710254,IMR90|chr16:19724858-19724880,chr16,19724858,19724880,1,14677
IMR90|chr16:19710181-19710219,chr16,19710181,19710219,IMR90|chr16:19724858-19724880,chr16,19724858,19724880,1,14677
IMR90|chr16:19711327-19711399,chr16,19711327,19711399,IMR90|chr16:19724427-19724525,chr16,19724427,19724525,1,13100
IMR90|chr16:19711347-19711399,chr16,19711347,19711399,IMR90|chr16:19724427-19724525,chr16,19724427,19724525,1,13080
IMR90|chr16:20874861-20874889,chr16,20874861,20874889,IMR90|chr16:67966888-67967010,chr16,67966888,67967010,1,47092027
IMR90|chr16:20874861-20874888,chr16,20874861,20874888,IMR90|chr16:67966888-67967009,chr16,67966888,67967009,1,47092027
IMR90|chr16:20874863-20874891,chr16,20874863,20874891,IMR90|chr16:67966888-67967010,chr16,67966888,67967010,1,47092025
IMR90|chr16:20893867-20893916,chr16,20893867,20893916,IMR90|chr16:23461339-23461406,chr16,23461339,23461406,1,2567472
IMR90|chr16:21513424-21513574,chr16,21513424,21513574,IMR90|chr16:18937941-18938028,chr16,18937941,18938028,1,2575483
IMR90|chr16:21513514-21513662,chr16,21513514,21513662,IMR90|chr16:18937922-18937988,chr16,18937922,18937988,1,2575592
IMR90|chr16:21513540-21513690,chr16,21513540,21513690,IMR90|chr16:18937912-18938061,chr16,18937912,18938061,1,2575628
IMR90|chr16:21513613-21513760,chr16,21513613,21513760,IMR90|chr16:18937922-18937975,chr16,18937922,18937975,1,2575691
IMR90|chr16:21513613-21513714,chr16,21513613,21513714,IMR90|chr16:18937922-18937976,chr16,18937922,18937976,1,2575691
IMR90|chr16:21513614-21513760,chr16,21513614,21513760,IMR90|chr16:18937861-18937988,chr16,18937861,18937988,1,2575753
IMR90|chr16:21513626-21513766,chr16,21513626,21513766,IMR90|chr16:18937922-18937975,chr16,18937922,18937975,1,2575704
IMR90|chr16:21513635-21513732,chr16,21513635,21513732,IMR90|chr16:18937922-18937976,chr16,18937922,18937976,1,2575713
IMR90|chr16:21513636-21513732,chr16,21513636,21513732,IMR90|chr16:18937922-18937976,chr16,18937922,18937976,1,2575714
IMR90|chr16:21513639-21513732,chr16,21513639,21513732,IMR90|chr16:18937922-18937975,chr16,18937922,18937975,1,2575717
IMR90|chr16:21513640-21513732,chr16,21513640,21513732,IMR90|chr16:18937922-18937975,chr16,18937922,18937975,1,2575718
IMR90|chr16:21513642-21513732,chr16,21513642,21513732,IMR90|chr16:18937922-18937982,chr16,18937922,18937982,1,2575720
IMR90|chr16:21513644-21513763,chr16,21513644,21513763,IMR90|chr16:18937922-18937976,chr16,18937922,18937976,1,2575722
IMR90|chr16:21513644-21513732,chr16,21513644,21513732,IMR90|chr16:18937922-18937976,chr16,18937922,18937976,1,2575722
IMR90|chr16:21513645-21513732,chr16,21513645,21513732,IMR90|chr16:18937922-18937973,chr16,18937922,18937973,1,2575723
IMR90|chr16:21513650-21513732,chr16,21513650,21513732,IMR90|chr16:18937922-18937976,chr16,18937922,18937976,1,2575728
IMR90|chr16:21513651-21513732,chr16,21513651,21513732,IMR90|chr16:18937922-18937988,chr16,18937922,18937988,1,2575729
IMR90|chr16:21513653-21513763,chr16,21513653,21513763,IMR90|chr16:18937861-18937986,chr16,18937861,18937986,1,2575792
IMR90|chr16:21513653-21513732,chr16,21513653,21513732,IMR90|chr16:18937922-18937993,chr16,18937922,18937993,1,2575731
IMR90|chr16:21513663-21513763,chr16,21513663,21513763,IMR90|chr16:18937861-18937988,chr16,18937861,18937988,1,2575802
IMR90|chr16:21514869-21514982,chr16,21514869,21514982,IMR90|chr16:67279684-67279706,chr16,67279684,67279706,1,45764815
IMR90|chr16:21514869-21514980,chr16,21514869,21514980,IMR90|chr16:67279684-67279706,chr16,67279684,67279706,1,45764815
IMR90|chr16:21514913-21514980,chr16,21514913,21514980,IMR90|chr16:67279684-67279706,chr16,67279684,67279706,1,45764771
IMR90|chr16:21514918-21514980,chr16,21514918,21514980,IMR90|chr16:67279684-67279706,chr16,67279684,67279706,1,45764766
IMR90|chr16:21527643-21527792,chr16,21527643,21527792,IMR90|chr16:87899056-87899206,chr16,87899056,87899206,1,66371413
IMR90|chr16:21527763-21527859,chr16,21527763,21527859,IMR90|chr16:87899041-87899115,chr16,87899041,87899115,1,66371278
IMR90|chr16:21527908-21527945,chr16,21527908,21527945,IMR90|chr16:87899018-87899168,chr16,87899018,87899168,1,66371110
IMR90|chr16:21528355-21528480,chr16,21528355,21528480,IMR90|chr16:87899717-87899843,chr16,87899717,87899843,1,66371362
IMR90|chr16:21528685-21528757,chr16,21528685,21528757,IMR90|chr16:87900167-87900223,chr16,87900167,87900223,1,66371482
IMR90|chr16:21528935-21529027,chr16,21528935,21529027,IMR90|chr16:87899413-87899513,chr16,87899413,87899513,1,66370478
IMR90|chr16:21530080-21530199,chr16,21530080,21530199,IMR90|chr16:87901411-87901530,chr16,87901411,87901530,1,66371331
IMR90|chr16:22301096-22301220,chr16,22301096,22301220,IMR90|chr16:22304402-22304453,chr16,22304402,22304453,1,3306
IMR90|chr16:22301121-22301220,chr16,22301121,22301220,IMR90|chr16:22304402-22304453,chr16,22304402,22304453,1,3281
IMR90|chr16:22301461-22301565,chr16,22301461,22301565,IMR90|chr16:22304505-22304533,chr16,22304505,22304533,1,3044
IMR90|chr16:22302355-22302410,chr16,22302355,22302410,IMR90|chr16:22305868-22305961,chr16,22305868,22305961,1,3513
IMR90|chr16:25007531-25007593,chr16,25007531,25007593,IMR90|chr16:3106362-3106412,chr16,3106362,3106412,1,21901169
IMR90|chr16:25007531-25007563,chr16,25007531,25007563,IMR90|chr16:3106362-3106412,chr16,3106362,3106412,1,21901169
IMR90|chr16:25007531-25007558,chr16,25007531,25007558,IMR90|chr16:3106362-3106412,chr16,3106362,3106412,1,21901169
IMR90|chr16:25014229-25014359,chr16,25014229,25014359,IMR90|chr16:48281148-48281198,chr16,48281148,48281198,1,23266919
IMR90|chr16:25014282-25014382,chr16,25014282,25014382,IMR90|chr16:48281148-48281198,chr16,48281148,48281198,1,23266866
IMR90|chr16:25014284-25014359,chr16,25014284,25014359,IMR90|chr16:48281126-48281198,chr16,48281126,48281198,1,23266842
IMR90|chr16:29222465-29222615,chr16,29222465,29222615,IMR90|chr16:88210621-88210771,chr16,88210621,88210771,1,58988156
IMR90|chr16:29226018-29226165,chr16,29226018,29226165,IMR90|chr16:88214203-88214353,chr16,88214203,88214353,1,58988185
IMR90|chr16:29226023-29226167,chr16,29226023,29226167,IMR90|chr16:88214262-88214365,chr16,88214262,88214365,1,58988239
IMR90|chr16:29226023-29226161,chr16,29226023,29226161,IMR90|chr16:88214235-88214368,chr16,88214235,88214368,1,58988212
IMR90|chr16:29226025-29226173,chr16,29226025,29226173,IMR90|chr16:88214252-88214383,chr16,88214252,88214383,1,58988227
IMR90|chr16:29226026-29226173,chr16,29226026,29226173,IMR90|chr16:88214370-88214448,chr16,88214370,88214448,1,58988344
IMR90|chr16:29226027-29226165,chr16,29226027,29226165,IMR90|chr16:88214239-88214355,chr16,88214239,88214355,1,58988212
IMR90|chr16:29226040-29226190,chr16,29226040,29226190,IMR90|chr16:88214252-88214368,chr16,88214252,88214368,1,58988212
IMR90|chr16:29226042-29226192,chr16,29226042,29226192,IMR90|chr16:88214328-88214365,chr16,88214328,88214365,1,58988286
IMR90|chr16:29226042-29226191,chr16,29226042,29226191,IMR90|chr16:88214696-88214765,chr16,88214696,88214765,1,58988654
IMR90|chr16:29226042-29226163,chr16,29226042,29226163,IMR90|chr16:88214254-88214383,chr16,88214254,88214383,1,58988212
IMR90|chr16:29226046-29226187,chr16,29226046,29226187,IMR90|chr16:88214258-88214383,chr16,88214258,88214383,1,58988212
IMR90|chr16:29226046-29226185,chr16,29226046,29226185,IMR90|chr16:88214182-88214332,chr16,88214182,88214332,1,58988136
IMR90|chr16:29226074-29226165,chr16,29226074,29226165,IMR90|chr16:88214286-88214368,chr16,88214286,88214368,1,58988212
IMR90|chr16:29226107-29226183,chr16,29226107,29226183,IMR90|chr16:88214679-88214726,chr16,88214679,88214726,1,58988572
IMR90|chr16:29226404-29226486,chr16,29226404,29226486,IMR90|chr16:88214681-88214809,chr16,88214681,88214809,1,58988277
IMR90|chr16:29227343-29227375,chr16,29227343,29227375,IMR90|chr16:88215509-88215591,chr16,88215509,88215591,1,58988166
IMR90|chr16:29229225-29229375,chr16,29229225,29229375,IMR90|chr16:88217370-88217520,chr16,88217370,88217520,1,58988145
IMR90|chr16:29229231-29229311,chr16,29229231,29229311,IMR90|chr16:88217513-88217560,chr16,88217513,88217560,1,58988282
IMR90|chr16:29229566-29229628,chr16,29229566,29229628,IMR90|chr16:88217709-88217829,chr16,88217709,88217829,1,58988143
IMR90|chr16:29230420-29230464,chr16,29230420,29230464,IMR90|chr16:88218613-88218710,chr16,88218613,88218710,1,58988193
IMR90|chr16:29230421-29230464,chr16,29230421,29230464,IMR90|chr16:88218613-88218710,chr16,88218613,88218710,1,58988192
IMR90|chr16:29620859-29620949,chr16,29620859,29620949,IMR90|chr16:4476331-4476388,chr16,4476331,4476388,1,25144528
IMR90|chr16:29620883-29620957,chr16,29620883,29620957,IMR90|chr16:4476331-4476388,chr16,4476331,4476388,1,25144552
IMR90|chr16:29620938-29621082,chr16,29620938,29621082,IMR90|chr16:87899105-87899255,chr16,87899105,87899255,1,58278167
IMR90|chr16:29620939-29621089,chr16,29620939,29621089,IMR90|chr16:87899048-87899198,chr16,87899048,87899198,1,58278109
IMR90|chr16:29620948-29621098,chr16,29620948,29621098,IMR90|chr16:87899090-87899234,chr16,87899090,87899234,1,58278142
IMR90|chr16:29620954-29621103,chr16,29620954,29621103,IMR90|chr16:87899056-87899206,chr16,87899056,87899206,1,58278102
IMR90|chr16:29621066-29621216,chr16,29621066,29621216,IMR90|chr16:87899046-87899196,chr16,87899046,87899196,1,58277980
IMR90|chr16:29621079-29621216,chr16,29621079,29621216,IMR90|chr16:87899046-87899196,chr16,87899046,87899196,1,58277967
IMR90|chr16:29621090-29621211,chr16,29621090,29621211,IMR90|chr16:87899041-87899191,chr16,87899041,87899191,1,58277951
IMR90|chr16:29621125-29621216,chr16,29621125,29621216,IMR90|chr16:87899046-87899196,chr16,87899046,87899196,1,58277921
IMR90|chr16:29621140-29621201,chr16,29621140,29621201,IMR90|chr16:87899042-87899192,chr16,87899042,87899192,1,58277902
IMR90|chr16:30345884-30346034,chr16,30345884,30346034,IMR90|chr16:29605760-29605907,chr16,29605760,29605907,1,740124
IMR90|chr16:30345884-30346030,chr16,30345884,30346030,IMR90|chr16:29605760-29605905,chr16,29605760,29605905,1,740124
IMR90|chr16:30345917-30346017,chr16,30345917,30346017,IMR90|chr16:29605840-29605990,chr16,29605840,29605990,1,740077
IMR90|chr16:30346156-30346306,chr16,30346156,30346306,IMR90|chr16:29606045-29606189,chr16,29606045,29606189,1,740111
IMR90|chr16:30346163-30346313,chr16,30346163,30346313,IMR90|chr16:29606047-29606197,chr16,29606047,29606197,1,740116
IMR90|chr16:31462976-31463045,chr16,31462976,31463045,IMR90|chr16:31458967-31459094,chr16,31458967,31459094,1,4009
IMR90|chr16:31463022-31463059,chr16,31463022,31463059,IMR90|chr16:31466895-31466971,chr16,31466895,31466971,1,3873
IMR90|chr16:31463022-31463045,chr16,31463022,31463045,IMR90|chr16:31458967-31459094,chr16,31458967,31459094,1,4055
IMR90|chr16:31463432-31463511,chr16,31463432,31463511,IMR90|chr16:31466292-31466316,chr16,31466292,31466316,1,2860
IMR90|chr16:31463432-31463506,chr16,31463432,31463506,IMR90|chr16:31466084-31466128,chr16,31466084,31466128,1,2652
IMR90|chr16:31463506-31463536,chr16,31463506,31463536,IMR90|chr16:31467574-31467649,chr16,31467574,31467649,1,4068
IMR90|chr16:31463562-31463669,chr16,31463562,31463669,IMR90|chr16:31467504-31467630,chr16,31467504,31467630,1,3942
IMR90|chr16:31463565-31463648,chr16,31463565,31463648,IMR90|chr16:31467649-31467739,chr16,31467649,31467739,1,4084
IMR90|chr16:31463566-31463636,chr16,31463566,31463636,IMR90|chr16:31467533-31467613,chr16,31467533,31467613,1,3967
IMR90|chr16:31463568-31463666,chr16,31463568,31463666,IMR90|chr16:31467533-31467613,chr16,31467533,31467613,1,3965
IMR90|chr16:31463569-31463665,chr16,31463569,31463665,IMR90|chr16:31467502-31467648,chr16,31467502,31467648,1,3933
IMR90|chr16:31463575-31463614,chr16,31463575,31463614,IMR90|chr16:31467519-31467601,chr16,31467519,31467601,1,3944
IMR90|chr16:31463588-31463648,chr16,31463588,31463648,IMR90|chr16:31467649-31467739,chr16,31467649,31467739,1,4061
IMR90|chr16:31463592-31463636,chr16,31463592,31463636,IMR90|chr16:31467511-31467578,chr16,31467511,31467578,1,3919
IMR90|chr16:31463629-31463667,chr16,31463629,31463667,IMR90|chr16:31467478-31467590,chr16,31467478,31467590,1,3849
IMR90|chr16:31463952-31464063,chr16,31463952,31464063,IMR90|chr16:31465456-31465563,chr16,31465456,31465563,1,1504
IMR90|chr16:31463979-31463999,chr16,31463979,31463999,IMR90|chr16:31467516-31467648,chr16,31467516,31467648,1,3537
IMR90|chr16:31463979-31463997,chr16,31463979,31463997,IMR90|chr16:31467516-31467648,chr16,31467516,31467648,1,3537
IMR90|chr16:31464195-31464221,chr16,31464195,31464221,IMR90|chr16:31466930-31466996,chr16,31466930,31466996,1,2735
IMR90|chr16:48408726-48408794,chr16,48408726,48408794,IMR90|chr16:19723916-19723944,chr16,19723916,19723944,1,28684810
IMR90|chr16:48408728-48408794,chr16,48408728,48408794,IMR90|chr16:19723916-19723944,chr16,19723916,19723944,1,28684812
IMR90|chr16:48408728-48408792,chr16,48408728,48408792,IMR90|chr16:19723916-19723944,chr16,19723916,19723944,1,28684812
IMR90|chr16:51191055-51191128,chr16,51191055,51191128,IMR90|chr16:51189860-51189940,chr16,51189860,51189940,1,1195
IMR90|chr16:51191061-51191128,chr16,51191061,51191128,IMR90|chr16:51189860-51189940,chr16,51189860,51189940,1,1201
IMR90|chr16:51198238-51198257,chr16,51198238,51198257,IMR90|chr16:51188768-51188860,chr16,51188768,51188860,1,9470
IMR90|chr16:68324276-68324317,chr16,68324276,68324317,IMR90|chr16:4425220-4425278,chr16,4425220,4425278,1,63899056
IMR90|chr16:68324276-68324315,chr16,68324276,68324315,IMR90|chr16:4425220-4425278,chr16,4425220,4425278,1,63899056
IMR90|chr16:69314655-69314693,chr16,69314655,69314693,IMR90|chr16:70283369-70283457,chr16,70283369,70283457,1,968714
IMR90|chr16:69314655-69314692,chr16,69314655,69314692,IMR90|chr16:70283369-70283458,chr16,70283369,70283458,1,968714
IMR90|chr16:69506024-69506062,chr16,69506024,69506062,IMR90|chr16:69366412-69366479,chr16,69366412,69366479,1,139612
IMR90|chr16:70742010-70742061,chr16,70742010,70742061,IMR90|chr16:71841030-71841054,chr16,71841030,71841054,1,1099020
IMR90|chr16:70742010-70742060,chr16,70742010,70742060,IMR90|chr16:71841030-71841054,chr16,71841030,71841054,1,1099020
IMR90|chr16:70752159-70752219,chr16,70752159,70752219,IMR90|chr16:71491562-71491636,chr16,71491562,71491636,1,739403
IMR90|chr16:70763406-70763520,chr16,70763406,70763520,IMR90|chr16:70716881-70716959,chr16,70716881,70716959,1,46525
IMR90|chr16:70763449-70763521,chr16,70763449,70763521,IMR90|chr16:70716881-70716959,chr16,70716881,70716959,1,46568
IMR90|chr16:70765376-70765397,chr16,70765376,70765397,IMR90|chr16:70718296-70718396,chr16,70718296,70718396,1,47080
IMR90|chr16:70765377-70765397,chr16,70765377,70765397,IMR90|chr16:70718296-70718396,chr16,70718296,70718396,1,47081
IMR90|chr16:71849473-71849518,chr16,71849473,71849518,IMR90|chr16:71845976-71846050,chr16,71845976,71846050,1,3497
IMR90|chr16:71849773-71849799,chr16,71849773,71849799,IMR90|chr16:71844126-71844195,chr16,71844126,71844195,1,5647
IMR90|chr16:71849773-71849798,chr16,71849773,71849798,IMR90|chr16:71844126-71844195,chr16,71844126,71844195,1,5647
IMR90|chr16:71850254-71850360,chr16,71850254,71850360,IMR90|chr16:71847109-71847150,chr16,71847109,71847150,1,3145
IMR90|chr16:71850356-71850404,chr16,71850356,71850404,IMR90|chr16:71844371-71844461,chr16,71844371,71844461,1,5985
IMR90|chr16:71850423-71850510,chr16,71850423,71850510,IMR90|chr16:71848067-71848093,chr16,71848067,71848093,1,2356
IMR90|chr16:71851183-71851277,chr16,71851183,71851277,IMR90|chr16:71846697-71846742,chr16,71846697,71846742,1,4486
IMR90|chr16:71851183-71851276,chr16,71851183,71851276,IMR90|chr16:71846697-71846742,chr16,71846697,71846742,1,4486
IMR90|chr16:75099711-75099744,chr16,75099711,75099744,IMR90|chr16:74732909-74732974,chr16,74732909,74732974,1,366802
IMR90|chr16:75100507-75100657,chr16,75100507,75100657,IMR90|chr16:2587161-2587285,chr16,2587161,2587285,1,72513346
IMR90|chr16:75100507-75100566,chr16,75100507,75100566,IMR90|chr16:2587161-2587285,chr16,2587161,2587285,1,72513346
IMR90|chr16:75100698-75100718,chr16,75100698,75100718,IMR90|chr16:2587161-2587285,chr16,2587161,2587285,1,72513537
IMR90|chr16:75356233-75356328,chr16,75356233,75356328,IMR90|chr16:74640159-74640205,chr16,74640159,74640205,1,716074
IMR90|chr16:75409971-75410042,chr16,75409971,75410042,IMR90|chr16:56641686-56641765,chr16,56641686,56641765,1,18768285
IMR90|chr16:77930653-77930757,chr16,77930653,77930757,IMR90|chr16:81347618-81347681,chr16,81347618,81347681,1,3416965
IMR90|chr16:77930670-77930757,chr16,77930670,77930757,IMR90|chr16:81347618-81347681,chr16,81347618,81347681,1,3416948
IMR90|chr16:81518865-81518934,chr16,81518865,81518934,IMR90|chr16:81072355-81072505,chr16,81072355,81072505,1,446510
IMR90|chr16:81518865-81518925,chr16,81518865,81518925,IMR90|chr16:81072355-81072504,chr16,81072355,81072504,1,446510
IMR90|chr16:81520450-81520574,chr16,81520450,81520574,IMR90|chr16:4588477-4588500,chr16,4588477,4588500,1,76931973
IMR90|chr16:81520450-81520543,chr16,81520450,81520543,IMR90|chr16:4588477-4588500,chr16,4588477,4588500,1,76931973
IMR90|chr16:81520455-81520550,chr16,81520455,81520550,IMR90|chr16:4588477-4588500,chr16,4588477,4588500,1,76931978
IMR90|chr16:81520455-81520546,chr16,81520455,81520546,IMR90|chr16:4588478-4588498,chr16,4588478,4588498,1,76931977
IMR90|chr16:82675265-82675292,chr16,82675265,82675292,IMR90|chr16:30087128-30087194,chr16,30087128,30087194,1,52588137
IMR90|chr16:82689854-82689899,chr16,82689854,82689899,IMR90|chr16:30084801-30084863,chr16,30084801,30084863,1,52605053
IMR90|chr16:82689856-82689889,chr16,82689856,82689889,IMR90|chr16:30084801-30084863,chr16,30084801,30084863,1,52605055
IMR90|chr16:84616483-84616509,chr16,84616483,84616509,IMR90|chr16:3353454-3353578,chr16,3353454,3353578,1,81263029
IMR90|chr16:84616484-84616515,chr16,84616484,84616515,IMR90|chr16:3353454-3353565,chr16,3353454,3353565,1,81263030
IMR90|chr16:84761812-84761847,chr16,84761812,84761847,IMR90|chr16:85204059-85204110,chr16,85204059,85204110,1,442247
IMR90|chr16:84869209-84869258,chr16,84869209,84869258,IMR90|chr16:85208443-85208519,chr16,85208443,85208519,1,339234
IMR90|chr16:85193543-85193598,chr16,85193543,85193598,IMR90|chr16:85200183-85200278,chr16,85200183,85200278,1,6640
IMR90|chr16:85194594-85194633,chr16,85194594,85194633,IMR90|chr16:85204327-85204472,chr16,85204327,85204472,1,9733
IMR90|chr16:85197546-85197579,chr16,85197546,85197579,IMR90|chr16:85199993-85200110,chr16,85199993,85200110,1,2447
IMR90|chr16:85197665-85197798,chr16,85197665,85197798,IMR90|chr16:85201575-85201638,chr16,85201575,85201638,1,3910
IMR90|chr16:85197711-85197798,chr16,85197711,85197798,IMR90|chr16:85201575-85201638,chr16,85201575,85201638,1,3864
IMR90|chr16:85197748-85197800,chr16,85197748,85197800,IMR90|chr16:85204666-85204782,chr16,85204666,85204782,1,6918
IMR90|chr16:85221543-85221601,chr16,85221543,85221601,IMR90|chr16:85203821-85203913,chr16,85203821,85203913,1,17722
IMR90|chr16:85221566-85221624,chr16,85221566,85221624,IMR90|chr16:85203821-85203913,chr16,85203821,85203913,1,17745
IMR90|chr16:85221684-85221782,chr16,85221684,85221782,IMR90|chr16:85208101-85208134,chr16,85208101,85208134,1,13583
IMR90|chr16:85221997-85222034,chr16,85221997,85222034,IMR90|chr16:85207741-85207779,chr16,85207741,85207779,1,14256
IMR90|chr16:85222015-85222049,chr16,85222015,85222049,IMR90|chr16:85207914-85208064,chr16,85207914,85208064,1,14101
IMR90|chr16:85222423-85222472,chr16,85222423,85222472,IMR90|chr16:85206934-85206989,chr16,85206934,85206989,1,15489
IMR90|chr16:85222474-85222529,chr16,85222474,85222529,IMR90|chr16:85204827-85204919,chr16,85204827,85204919,1,17647
IMR90|chr16:85222632-85222695,chr16,85222632,85222695,IMR90|chr16:85205509-85205659,chr16,85205509,85205659,1,17123
IMR90|chr16:85222642-85222678,chr16,85222642,85222678,IMR90|chr16:85205923-85206073,chr16,85205923,85206073,1,16719
IMR90|chr16:85222667-85222720,chr16,85222667,85222720,IMR90|chr16:85207358-85207478,chr16,85207358,85207478,1,15309
IMR90|chr16:85222667-85222689,chr16,85222667,85222689,IMR90|chr16:85207358-85207478,chr16,85207358,85207478,1,15309
IMR90|chr16:85222725-85222828,chr16,85222725,85222828,IMR90|chr16:85207373-85207419,chr16,85207373,85207419,1,15352
IMR90|chr16:85222729-85222830,chr16,85222729,85222830,IMR90|chr16:85207373-85207419,chr16,85207373,85207419,1,15356
IMR90|chr16:85223051-85223135,chr16,85223051,85223135,IMR90|chr16:85208052-85208114,chr16,85208052,85208114,1,14999
IMR90|chr16:85224239-85224318,chr16,85224239,85224318,IMR90|chr16:85205559-85205633,chr16,85205559,85205633,1,18680
IMR90|chr16:85224242-85224318,chr16,85224242,85224318,IMR90|chr16:85205559-85205633,chr16,85205559,85205633,1,18683
IMR90|chr16:85224355-85224375,chr16,85224355,85224375,IMR90|chr16:86609144-86609294,chr16,86609144,86609294,1,1384789
IMR90|chr16:85226330-85226405,chr16,85226330,85226405,IMR90|chr16:85208107-85208145,chr16,85208107,85208145,1,18223
IMR90|chr16:85228197-85228233,chr16,85228197,85228233,IMR90|chr16:85204584-85204628,chr16,85204584,85204628,1,23613
IMR90|chr16:85228237-85228267,chr16,85228237,85228267,IMR90|chr16:85204584-85204628,chr16,85204584,85204628,1,23653
IMR90|chr16:85229553-85229572,chr16,85229553,85229572,IMR90|chr16:85208359-85208502,chr16,85208359,85208502,1,21194
IMR90|chr16:85229961-85230048,chr16,85229961,85230048,IMR90|chr16:85207044-85207076,chr16,85207044,85207076,1,22917
IMR90|chr16:85230146-85230205,chr16,85230146,85230205,IMR90|chr16:85204651-85204691,chr16,85204651,85204691,1,25495
IMR90|chr16:85231311-85231408,chr16,85231311,85231408,IMR90|chr16:85205931-85205983,chr16,85205931,85205983,1,25380
IMR90|chr16:85231311-85231407,chr16,85231311,85231407,IMR90|chr16:85205931-85205983,chr16,85205931,85205983,1,25380
IMR90|chr16:85232063-85232098,chr16,85232063,85232098,IMR90|chr16:85206629-85206727,chr16,85206629,85206727,1,25434
IMR90|chr16:85232540-85232586,chr16,85232540,85232586,IMR90|chr16:85208344-85208447,chr16,85208344,85208447,1,24196
IMR90|chr16:85232613-85232658,chr16,85232613,85232658,IMR90|chr16:85208344-85208447,chr16,85208344,85208447,1,24269
IMR90|chr16:85233622-85233660,chr16,85233622,85233660,IMR90|chr16:85204848-85204897,chr16,85204848,85204897,1,28774
IMR90|chr16:85233662-85233680,chr16,85233662,85233680,IMR90|chr16:85206143-85206166,chr16,85206143,85206166,1,27519
IMR90|chr16:85233676-85233780,chr16,85233676,85233780,IMR90|chr16:85206142-85206166,chr16,85206142,85206166,1,27534
IMR90|chr16:85233677-85233780,chr16,85233677,85233780,IMR90|chr16:85206142-85206166,chr16,85206142,85206166,1,27535
IMR90|chr16:85234549-85234635,chr16,85234549,85234635,IMR90|chr16:85204848-85204897,chr16,85204848,85204897,1,29701
IMR90|chr16:85235273-85235359,chr16,85235273,85235359,IMR90|chr16:85207402-85207441,chr16,85207402,85207441,1,27871
IMR90|chr16:85236702-85236809,chr16,85236702,85236809,IMR90|chr16:85208097-85208133,chr16,85208097,85208133,1,28605
IMR90|chr16:85236702-85236808,chr16,85236702,85236808,IMR90|chr16:85208097-85208133,chr16,85208097,85208133,1,28605
IMR90|chr16:85237057-85237086,chr16,85237057,85237086,IMR90|chr16:85205478-85205574,chr16,85205478,85205574,1,31579
IMR90|chr16:85237927-85237996,chr16,85237927,85237996,IMR90|chr16:85205836-85205896,chr16,85205836,85205896,1,32091
IMR90|chr16:85237932-85237996,chr16,85237932,85237996,IMR90|chr16:85205836-85205896,chr16,85205836,85205896,1,32096
IMR90|chr16:85238631-85238675,chr16,85238631,85238675,IMR90|chr16:85204145-85204224,chr16,85204145,85204224,1,34486
IMR90|chr16:85240625-85240736,chr16,85240625,85240736,IMR90|chr16:85203974-85204032,chr16,85203974,85204032,1,36651
IMR90|chr16:85240625-85240717,chr16,85240625,85240717,IMR90|chr16:85203974-85204032,chr16,85203974,85204032,1,36651
IMR90|chr16:85241156-85241221,chr16,85241156,85241221,IMR90|chr16:85205585-85205670,chr16,85205585,85205670,1,35571
IMR90|chr16:85242657-85242707,chr16,85242657,85242707,IMR90|chr16:85204286-85204307,chr16,85204286,85204307,1,38371
IMR90|chr16:85242992-85243119,chr16,85242992,85243119,IMR90|chr16:85207396-85207436,chr16,85207396,85207436,1,35596
IMR90|chr16:85242992-85243102,chr16,85242992,85243102,IMR90|chr16:85207396-85207436,chr16,85207396,85207436,1,35596
IMR90|chr16:85243102-85243223,chr16,85243102,85243223,IMR90|chr16:85207079-85207100,chr16,85207079,85207100,1,36023
IMR90|chr16:85244298-85244334,chr16,85244298,85244334,IMR90|chr16:85208446-85208495,chr16,85208446,85208495,1,35852
IMR90|chr16:85244579-85244644,chr16,85244579,85244644,IMR90|chr16:85203021-85203106,chr16,85203021,85203106,1,41558
IMR90|chr16:85246762-85246850,chr16,85246762,85246850,IMR90|chr16:85205433-85205454,chr16,85205433,85205454,1,41329
IMR90|chr16:85247153-85247233,chr16,85247153,85247233,IMR90|chr16:85207089-85207124,chr16,85207089,85207124,1,40064
IMR90|chr16:85247771-85247834,chr16,85247771,85247834,IMR90|chr16:85203648-85203676,chr16,85203648,85203676,1,44123
IMR90|chr16:85247771-85247832,chr16,85247771,85247832,IMR90|chr16:85203646-85203709,chr16,85203646,85203709,1,44125
IMR90|chr16:85247826-85247939,chr16,85247826,85247939,IMR90|chr16:85203313-85203350,chr16,85203313,85203350,1,44513
IMR90|chr16:85248818-85248877,chr16,85248818,85248877,IMR90|chr16:85203566-85203585,chr16,85203566,85203585,1,45252
IMR90|chr16:85249029-85249087,chr16,85249029,85249087,IMR90|chr16:85207497-85207611,chr16,85207497,85207611,1,41532
IMR90|chr16:85249051-85249087,chr16,85249051,85249087,IMR90|chr16:85207497-85207611,chr16,85207497,85207611,1,41554
IMR90|chr16:85249677-85249808,chr16,85249677,85249808,IMR90|chr16:85204118-85204160,chr16,85204118,85204160,1,45559
IMR90|chr16:85249695-85249788,chr16,85249695,85249788,IMR90|chr16:85205940-85205977,chr16,85205940,85205977,1,43755
IMR90|chr16:85249695-85249786,chr16,85249695,85249786,IMR90|chr16:85205940-85205977,chr16,85205940,85205977,1,43755
IMR90|chr16:85249700-85249808,chr16,85249700,85249808,IMR90|chr16:85204118-85204160,chr16,85204118,85204160,1,45582
IMR90|chr16:85250432-85250582,chr16,85250432,85250582,IMR90|chr16:85207364-85207419,chr16,85207364,85207419,1,43068
IMR90|chr16:85250432-85250551,chr16,85250432,85250551,IMR90|chr16:85207364-85207419,chr16,85207364,85207419,1,43068
IMR90|chr16:85250490-85250582,chr16,85250490,85250582,IMR90|chr16:85207364-85207419,chr16,85207364,85207419,1,43126
IMR90|chr16:85251278-85251368,chr16,85251278,85251368,IMR90|chr16:85205625-85205689,chr16,85205625,85205689,1,45653
IMR90|chr16:85251285-85251368,chr16,85251285,85251368,IMR90|chr16:85205625-85205689,chr16,85205625,85205689,1,45660
IMR90|chr16:85254177-85254309,chr16,85254177,85254309,IMR90|chr16:85207089-85207107,chr16,85207089,85207107,1,47088
IMR90|chr16:85254177-85254308,chr16,85254177,85254308,IMR90|chr16:85207089-85207107,chr16,85207089,85207107,1,47088
IMR90|chr16:85254211-85254361,chr16,85254211,85254361,IMR90|chr16:85203034-85203078,chr16,85203034,85203078,1,51177
IMR90|chr16:85254273-85254379,chr16,85254273,85254379,IMR90|chr16:85203034-85203078,chr16,85203034,85203078,1,51239
IMR90|chr16:85254434-85254479,chr16,85254434,85254479,IMR90|chr16:85208393-85208503,chr16,85208393,85208503,1,46041
IMR90|chr16:85254439-85254479,chr16,85254439,85254479,IMR90|chr16:85208393-85208503,chr16,85208393,85208503,1,46046
IMR90|chr16:85257940-85257974,chr16,85257940,85257974,IMR90|chr16:85207102-85207210,chr16,85207102,85207210,1,50838
IMR90|chr16:85260172-85260211,chr16,85260172,85260211,IMR90|chr16:85208476-85208613,chr16,85208476,85208613,1,51696
IMR90|chr16:85260461-85260492,chr16,85260461,85260492,IMR90|chr16:85203153-85203270,chr16,85203153,85203270,1,57308
IMR90|chr16:85260461-85260486,chr16,85260461,85260486,IMR90|chr16:85203153-85203270,chr16,85203153,85203270,1,57308
IMR90|chr16:85262547-85262657,chr16,85262547,85262657,IMR90|chr16:85206532-85206571,chr16,85206532,85206571,1,56015
IMR90|chr16:85262547-85262654,chr16,85262547,85262654,IMR90|chr16:85206532-85206571,chr16,85206532,85206571,1,56015
IMR90|chr16:85265979-85266062,chr16,85265979,85266062,IMR90|chr16:85207094-85207235,chr16,85207094,85207235,1,58885
IMR90|chr16:85266639-85266764,chr16,85266639,85266764,IMR90|chr16:85205659-85205722,chr16,85205659,85205722,1,60980
IMR90|chr16:85266639-85266726,chr16,85266639,85266726,IMR90|chr16:85205659-85205722,chr16,85205659,85205722,1,60980
IMR90|chr16:85269655-85269749,chr16,85269655,85269749,IMR90|chr16:85202386-85202447,chr16,85202386,85202447,1,67269
IMR90|chr16:85269655-85269744,chr16,85269655,85269744,IMR90|chr16:85202386-85202447,chr16,85202386,85202447,1,67269
IMR90|chr16:85269658-85269745,chr16,85269658,85269745,IMR90|chr16:85202387-85202447,chr16,85202387,85202447,1,67271
IMR90|chr16:85269660-85269749,chr16,85269660,85269749,IMR90|chr16:85202387-85202447,chr16,85202387,85202447,1,67273
IMR90|chr16:85270646-85270704,chr16,85270646,85270704,IMR90|chr16:85205852-85205886,chr16,85205852,85205886,1,64794
IMR90|chr16:85336962-85337052,chr16,85336962,85337052,IMR90|chr16:85206400-85206531,chr16,85206400,85206531,1,130562
IMR90|chr16:85337058-85337158,chr16,85337058,85337158,IMR90|chr16:85207133-85207214,chr16,85207133,85207214,1,129925
IMR90|chr16:85337090-85337159,chr16,85337090,85337159,IMR90|chr16:85207133-85207214,chr16,85207133,85207214,1,129957
IMR90|chr16:85337340-85337364,chr16,85337340,85337364,IMR90|chr16:85205825-85205890,chr16,85205825,85205890,1,131515
IMR90|chr16:85338808-85338882,chr16,85338808,85338882,IMR90|chr16:85206181-85206228,chr16,85206181,85206228,1,132627
IMR90|chr16:85338810-85338883,chr16,85338810,85338883,IMR90|chr16:85206181-85206228,chr16,85206181,85206228,1,132629
IMR90|chr16:85340607-85340648,chr16,85340607,85340648,IMR90|chr16:85206400-85206458,chr16,85206400,85206458,1,134207
IMR90|chr16:85340607-85340647,chr16,85340607,85340647,IMR90|chr16:85206400-85206458,chr16,85206400,85206458,1,134207
IMR90|chr16:85342300-85342329,chr16,85342300,85342329,IMR90|chr16:85204125-85204223,chr16,85204125,85204223,1,138175
IMR90|chr16:85342300-85342328,chr16,85342300,85342328,IMR90|chr16:85204125-85204223,chr16,85204125,85204223,1,138175
IMR90|chr16:85344101-85344128,chr16,85344101,85344128,IMR90|chr16:85205546-85205622,chr16,85205546,85205622,1,138555
IMR90|chr16:85353526-85353608,chr16,85353526,85353608,IMR90|chr16:85205546-85205580,chr16,85205546,85205580,1,147980
IMR90|chr16:85412466-85412488,chr16,85412466,85412488,IMR90|chr16:85204398-85204548,chr16,85204398,85204548,1,208068
IMR90|chr16:85418436-85418514,chr16,85418436,85418514,IMR90|chr16:85204061-85204095,chr16,85204061,85204095,1,214375
IMR90|chr16:85423923-85423964,chr16,85423923,85423964,IMR90|chr16:85204241-85204318,chr16,85204241,85204318,1,219682
IMR90|chr16:85425062-85425182,chr16,85425062,85425182,IMR90|chr16:89770566-89770620,chr16,89770566,89770620,1,4345504
IMR90|chr16:85425062-85425172,chr16,85425062,85425172,IMR90|chr16:89770566-89770620,chr16,89770566,89770620,1,4345504
IMR90|chr16:85425076-85425172,chr16,85425076,85425172,IMR90|chr16:89770566-89770620,chr16,89770566,89770620,1,4345490
IMR90|chr16:85427941-85427986,chr16,85427941,85427986,IMR90|chr16:85204822-85204913,chr16,85204822,85204913,1,223119
IMR90|chr16:85617076-85617177,chr16,85617076,85617177,IMR90|chr16:85644473-85644494,chr16,85644473,85644494,1,27397
IMR90|chr16:85617098-85617136,chr16,85617098,85617136,IMR90|chr16:85646148-85646240,chr16,85646148,85646240,1,29050
IMR90|chr16:85622469-85622562,chr16,85622469,85622562,IMR90|chr16:85640567-85640614,chr16,85640567,85640614,1,18098
IMR90|chr16:85624651-85624710,chr16,85624651,85624710,IMR90|chr16:85643007-85643046,chr16,85643007,85643046,1,18356
IMR90|chr16:85624715-85624806,chr16,85624715,85624806,IMR90|chr16:85643359-85643423,chr16,85643359,85643423,1,18644
IMR90|chr16:85624715-85624801,chr16,85624715,85624801,IMR90|chr16:85643359-85643423,chr16,85643359,85643423,1,18644
IMR90|chr16:85627076-85627128,chr16,85627076,85627128,IMR90|chr16:85644030-85644061,chr16,85644030,85644061,1,16954
IMR90|chr16:85627079-85627168,chr16,85627079,85627168,IMR90|chr16:85643979-85644040,chr16,85643979,85644040,1,16900
IMR90|chr16:85627079-85627150,chr16,85627079,85627150,IMR90|chr16:85643969-85644040,chr16,85643969,85644040,1,16890
IMR90|chr16:85628221-85628241,chr16,85628221,85628241,IMR90|chr16:85641479-85641571,chr16,85641479,85641571,1,13258
IMR90|chr16:85628441-85628503,chr16,85628441,85628503,IMR90|chr16:85643719-85643765,chr16,85643719,85643765,1,15278
IMR90|chr16:85630442-85630555,chr16,85630442,85630555,IMR90|chr16:85642987-85643033,chr16,85642987,85643033,1,12545
IMR90|chr16:85630451-85630555,chr16,85630451,85630555,IMR90|chr16:85642987-85643033,chr16,85642987,85643033,1,12536
IMR90|chr16:85632114-85632176,chr16,85632114,85632176,IMR90|chr16:85642342-85642403,chr16,85642342,85642403,1,10228
IMR90|chr16:85632114-85632162,chr16,85632114,85632162,IMR90|chr16:85642301-85642403,chr16,85642301,85642403,1,10187
IMR90|chr16:85632643-85632692,chr16,85632643,85632692,IMR90|chr16:85644174-85644275,chr16,85644174,85644275,1,11531
IMR90|chr16:85632951-85633042,chr16,85632951,85633042,IMR90|chr16:85640766-85640811,chr16,85640766,85640811,1,7815
IMR90|chr16:85633184-85633218,chr16,85633184,85633218,IMR90|chr16:85642876-85642959,chr16,85642876,85642959,1,9692
IMR90|chr16:85633186-85633218,chr16,85633186,85633218,IMR90|chr16:85642876-85642959,chr16,85642876,85642959,1,9690
IMR90|chr16:85633251-85633285,chr16,85633251,85633285,IMR90|chr16:85641856-85641932,chr16,85641856,85641932,1,8605
IMR90|chr16:86507660-86507781,chr16,86507660,86507781,IMR90|chr16:84855994-84856066,chr16,84855994,84856066,1,1651666
IMR90|chr16:86507703-86507781,chr16,86507703,86507781,IMR90|chr16:84855994-84856066,chr16,84855994,84856066,1,1651709
IMR90|chr16:86629537-86629564,chr16,86629537,86629564,IMR90|chr16:86609899-86610001,chr16,86609899,86610001,1,19638
IMR90|chr16:88452526-88452546,chr16,88452526,88452546,IMR90|chr16:88730237-88730269,chr16,88730237,88730269,1,277711
IMR90|chr16:89372142-89372206,chr16,89372142,89372206,IMR90|chr16:89571965-89572076,chr16,89571965,89572076,1,199823
IMR90|chr16:89406768-89406801,chr16,89406768,89406801,IMR90|chr16:89996197-89996272,chr16,89996197,89996272,1,589429
IMR90|chr16:89406930-89406999,chr16,89406930,89406999,IMR90|chr16:90039654-90039679,chr16,90039654,90039679,1,632724
IMR90|chr16:89410423-89410508,chr16,89410423,89410508,IMR90|chr16:89572011-89572057,chr16,89572011,89572057,1,161588
IMR90|chr16:89424078-89424185,chr16,89424078,89424185,IMR90|chr16:90035870-90035894,chr16,90035870,90035894,1,611792
IMR90|chr16:89424158-89424185,chr16,89424158,89424185,IMR90|chr16:90035870-90035894,chr16,90035870,90035894,1,611712
IMR90|chr16:89441461-89441487,chr16,89441461,89441487,IMR90|chr16:89573770-89573898,chr16,89573770,89573898,1,132309
IMR90|chr16:89448517-89448540,chr16,89448517,89448540,IMR90|chr16:75289174-75289272,chr16,75289174,75289272,1,14159343
IMR90|chr16:89448517-89448539,chr16,89448517,89448539,IMR90|chr16:75289174-75289272,chr16,75289174,75289272,1,14159343
IMR90|chr16:89453722-89453844,chr16,89453722,89453844,IMR90|chr16:89982191-89982253,chr16,89982191,89982253,1,528469
IMR90|chr16:89453722-89453810,chr16,89453722,89453810,IMR90|chr16:89982191-89982253,chr16,89982191,89982253,1,528469
IMR90|chr16:89453722-89453809,chr16,89453722,89453809,IMR90|chr16:89982191-89982253,chr16,89982191,89982253,1,528469
IMR90|chr16:89454336-89454421,chr16,89454336,89454421,IMR90|chr16:89989661-89989676,chr16,89989661,89989676,1,535325
IMR90|chr16:89460098-89460226,chr16,89460098,89460226,IMR90|chr16:75284481-75284500,chr16,75284481,75284500,1,14175617
IMR90|chr16:89460098-89460142,chr16,89460098,89460142,IMR90|chr16:75284461-75284500,chr16,75284461,75284500,1,14175637
IMR90|chr16:89481541-89481568,chr16,89481541,89481568,IMR90|chr16:67972357-67972484,chr16,67972357,67972484,1,21509184
IMR90|chr16:89481541-89481564,chr16,89481541,89481564,IMR90|chr16:67972357-67972484,chr16,67972357,67972484,1,21509184
IMR90|chr16:89489672-89489711,chr16,89489672,89489711,IMR90|chr16:89570856-89570961,chr16,89570856,89570961,1,81184
IMR90|chr16:89503364-89503443,chr16,89503364,89503443,IMR90|chr16:89990325-89990370,chr16,89990325,89990370,1,486961
IMR90|chr16:89503366-89503443,chr16,89503366,89503443,IMR90|chr16:89990325-89990370,chr16,89990325,89990370,1,486959
IMR90|chr16:89515638-89515757,chr16,89515638,89515757,IMR90|chr16:89573507-89573529,chr16,89573507,89573529,1,57869
IMR90|chr16:89515827-89515852,chr16,89515827,89515852,IMR90|chr16:89573507-89573529,chr16,89573507,89573529,1,57680
IMR90|chr16:89515960-89516031,chr16,89515960,89516031,IMR90|chr16:89996381-89996492,chr16,89996381,89996492,1,480421
IMR90|chr16:89520703-89520751,chr16,89520703,89520751,IMR90|chr16:89993862-89993929,chr16,89993862,89993929,1,473159
IMR90|chr16:89524622-89524696,chr16,89524622,89524696,IMR90|chr16:89993277-89993300,chr16,89993277,89993300,1,468655
IMR90|chr16:89547804-89547865,chr16,89547804,89547865,IMR90|chr16:87900081-87900204,chr16,87900081,87900204,1,1647723
IMR90|chr17:574427-574526,chr17,574427,574526,IMR90|chr17:4844953-4844999,chr17,4844953,4844999,1,4270526
IMR90|chr17:593403-593501,chr17,593403,593501,IMR90|chr17:62657140-62657176,chr17,62657140,62657176,1,62063737
IMR90|chr17:593404-593501,chr17,593404,593501,IMR90|chr17:62657140-62657176,chr17,62657140,62657176,1,62063736
IMR90|chr17:593467-593503,chr17,593467,593503,IMR90|chr17:4844280-4844339,chr17,4844280,4844339,1,4250813
IMR90|chr17:603642-603716,chr17,603642,603716,IMR90|chr17:38600440-38600481,chr17,38600440,38600481,1,37996798
IMR90|chr17:603642-603671,chr17,603642,603671,IMR90|chr17:38600440-38600481,chr17,38600440,38600481,1,37996798
IMR90|chr17:603643-603716,chr17,603643,603716,IMR90|chr17:38600440-38600481,chr17,38600440,38600481,1,37996797
IMR90|chr17:785540-785614,chr17,785540,785614,IMR90|chr17:80188978-80189084,chr17,80188978,80189084,1,79403438
IMR90|chr17:785587-785614,chr17,785587,785614,IMR90|chr17:80188978-80189085,chr17,80188978,80189085,1,79403391
IMR90|chr17:854414-854468,chr17,854414,854468,IMR90|chr17:62657442-62657482,chr17,62657442,62657482,1,61803028
IMR90|chr17:854414-854467,chr17,854414,854467,IMR90|chr17:62657442-62657482,chr17,62657442,62657482,1,61803028
IMR90|chr17:854414-854464,chr17,854414,854464,IMR90|chr17:62657442-62657482,chr17,62657442,62657482,1,61803028
IMR90|chr17:1276183-1276212,chr17,1276183,1276212,IMR90|chr17:1360611-1360696,chr17,1360611,1360696,1,84428
IMR90|chr17:1276583-1276610,chr17,1276583,1276610,IMR90|chr17:1362781-1362816,chr17,1362781,1362816,1,86198
IMR90|chr17:1277527-1277567,chr17,1277527,1277567,IMR90|chr17:1360610-1360718,chr17,1360610,1360718,1,83083
IMR90|chr17:1278259-1278320,chr17,1278259,1278320,IMR90|chr17:7310796-7310878,chr17,7310796,7310878,1,6032537
IMR90|chr17:1278259-1278319,chr17,1278259,1278319,IMR90|chr17:7310796-7310878,chr17,7310796,7310878,1,6032537
IMR90|chr17:1991834-1991886,chr17,1991834,1991886,IMR90|chr17:16942814-16942918,chr17,16942814,16942918,1,14950980
IMR90|chr17:1991834-1991877,chr17,1991834,1991877,IMR90|chr17:16942814-16942918,chr17,16942814,16942918,1,14950980
IMR90|chr17:2000350-2000386,chr17,2000350,2000386,IMR90|chr17:79980462-79980539,chr17,79980462,79980539,1,77980112
IMR90|chr17:2029196-2029262,chr17,2029196,2029262,IMR90|chr17:61048364-61048396,chr17,61048364,61048396,1,59019168
IMR90|chr17:2035232-2035294,chr17,2035232,2035294,IMR90|chr17:75374155-75374224,chr17,75374155,75374224,1,73338923
IMR90|chr17:2046748-2046788,chr17,2046748,2046788,IMR90|chr17:61048205-61048231,chr17,61048205,61048231,1,59001457
IMR90|chr17:2095613-2095666,chr17,2095613,2095666,IMR90|chr17:41151602-41151654,chr17,41151602,41151654,1,39055989
IMR90|chr17:2095613-2095665,chr17,2095613,2095665,IMR90|chr17:41151602-41151654,chr17,41151602,41151654,1,39055989
IMR90|chr17:2310594-2310667,chr17,2310594,2310667,IMR90|chr17:2308195-2308267,chr17,2308195,2308267,1,2399
IMR90|chr17:2310594-2310656,chr17,2310594,2310656,IMR90|chr17:2308195-2308267,chr17,2308195,2308267,1,2399
IMR90|chr17:2312670-2312756,chr17,2312670,2312756,IMR90|chr17:2308123-2308188,chr17,2308123,2308188,1,4547
IMR90|chr17:2312670-2312755,chr17,2312670,2312755,IMR90|chr17:2308123-2308188,chr17,2308123,2308188,1,4547
IMR90|chr17:4004570-4004646,chr17,4004570,4004646,IMR90|chr17:75448526-75448579,chr17,75448526,75448579,1,71443956
IMR90|chr17:4004570-4004643,chr17,4004570,4004643,IMR90|chr17:75448526-75448579,chr17,75448526,75448579,1,71443956
IMR90|chr17:8100351-8100387,chr17,8100351,8100387,IMR90|chr17:8096316-8096427,chr17,8096316,8096427,1,4035
IMR90|chr17:8101782-8101914,chr17,8101782,8101914,IMR90|chr17:8097210-8097274,chr17,8097210,8097274,1,4572
IMR90|chr17:8101782-8101860,chr17,8101782,8101860,IMR90|chr17:8097210-8097274,chr17,8097210,8097274,1,4572
IMR90|chr17:9275449-9275544,chr17,9275449,9275544,IMR90|chr17:79534358-79534442,chr17,79534358,79534442,1,70258909
IMR90|chr17:9275479-9275545,chr17,9275479,9275545,IMR90|chr17:79534358-79534439,chr17,79534358,79534439,1,70258879
IMR90|chr17:9275481-9275545,chr17,9275481,9275545,IMR90|chr17:79534358-79534442,chr17,79534358,79534442,1,70258877
IMR90|chr17:13464686-13464802,chr17,13464686,13464802,IMR90|chr17:62653744-62653772,chr17,62653744,62653772,1,49189058
IMR90|chr17:13478923-13478967,chr17,13478923,13478967,IMR90|chr17:62654052-62654127,chr17,62654052,62654127,1,49175129
IMR90|chr17:13478923-13478965,chr17,13478923,13478965,IMR90|chr17:62654052-62654127,chr17,62654052,62654127,1,49175129
IMR90|chr17:15364533-15364631,chr17,15364533,15364631,IMR90|chr17:17589719-17589856,chr17,17589719,17589856,1,2225186
IMR90|chr17:16208972-16209027,chr17,16208972,16209027,IMR90|chr17:40166289-40166384,chr17,40166289,40166384,1,23957317
IMR90|chr17:16208974-16209027,chr17,16208974,16209027,IMR90|chr17:40166287-40166384,chr17,40166287,40166384,1,23957313
IMR90|chr17:16208976-16209039,chr17,16208976,16209039,IMR90|chr17:40166289-40166384,chr17,40166289,40166384,1,23957313
IMR90|chr17:16348081-16348149,chr17,16348081,16348149,IMR90|chr17:21190956-21191012,chr17,21190956,21191012,1,4842875
IMR90|chr17:16348081-16348132,chr17,16348081,16348132,IMR90|chr17:21190949-21191012,chr17,21190949,21191012,1,4842868
IMR90|chr17:16354740-16354803,chr17,16354740,16354803,IMR90|chr17:16283642-16283695,chr17,16283642,16283695,1,71098
IMR90|chr17:16379536-16379597,chr17,16379536,16379597,IMR90|chr17:16294232-16294270,chr17,16294232,16294270,1,85304
IMR90|chr17:17000152-17000185,chr17,17000152,17000185,IMR90|chr17:78195044-78195103,chr17,78195044,78195103,1,61194892
IMR90|chr17:17005537-17005571,chr17,17005537,17005571,IMR90|chr17:47841646-47841694,chr17,47841646,47841694,1,30836109
IMR90|chr17:17005677-17005715,chr17,17005677,17005715,IMR90|chr17:47841646-47841694,chr17,47841646,47841694,1,30835969
IMR90|chr17:17017243-17017304,chr17,17017243,17017304,IMR90|chr17:7479422-7479480,chr17,7479422,7479480,1,9537821
IMR90|chr17:17600326-17600362,chr17,17600326,17600362,IMR90|chr17:17874839-17874867,chr17,17874839,17874867,1,274513
IMR90|chr17:17618600-17618689,chr17,17618600,17618689,IMR90|chr17:8113194-8113231,chr17,8113194,8113231,1,9505406
IMR90|chr17:17618602-17618689,chr17,17618602,17618689,IMR90|chr17:8113194-8113231,chr17,8113194,8113231,1,9505408
IMR90|chr17:17618613-17618697,chr17,17618613,17618697,IMR90|chr17:8113194-8113233,chr17,8113194,8113233,1,9505419
IMR90|chr17:17618613-17618689,chr17,17618613,17618689,IMR90|chr17:8113194-8113233,chr17,8113194,8113233,1,9505419
IMR90|chr17:17627906-17628004,chr17,17627906,17628004,IMR90|chr17:26667128-26667163,chr17,26667128,26667163,1,9039222
IMR90|chr17:17627906-17628003,chr17,17627906,17628003,IMR90|chr17:26667128-26667163,chr17,26667128,26667163,1,9039222
IMR90|chr17:17639044-17639082,chr17,17639044,17639082,IMR90|chr17:26666141-26666249,chr17,26666141,26666249,1,9027097
IMR90|chr17:17639068-17639095,chr17,17639068,17639095,IMR90|chr17:8103941-8104091,chr17,8103941,8104091,1,9535127
IMR90|chr17:17643175-17643240,chr17,17643175,17643240,IMR90|chr17:1464325-1464390,chr17,1464325,1464390,1,16178850
IMR90|chr17:17835940-17835989,chr17,17835940,17835989,IMR90|chr17:62657025-62657122,chr17,62657025,62657122,1,44821085
IMR90|chr17:17835952-17835991,chr17,17835952,17835991,IMR90|chr17:62657025-62657122,chr17,62657025,62657122,1,44821073
IMR90|chr17:17845183-17845238,chr17,17845183,17845238,IMR90|chr17:18087497-18087571,chr17,18087497,18087571,1,242314
IMR90|chr17:17862211-17862265,chr17,17862211,17862265,IMR90|chr17:62655172-62655239,chr17,62655172,62655239,1,44792961
IMR90|chr17:17862212-17862265,chr17,17862212,17862265,IMR90|chr17:62655208-62655240,chr17,62655208,62655240,1,44792996
IMR90|chr17:19167842-19167911,chr17,19167842,19167911,IMR90|chr17:59484416-59484488,chr17,59484416,59484488,1,40316574
IMR90|chr17:19174571-19174624,chr17,19174571,19174624,IMR90|chr17:19289328-19289471,chr17,19289328,19289471,1,114757
IMR90|chr17:20172181-20172236,chr17,20172181,20172236,IMR90|chr17:62655228-62655301,chr17,62655228,62655301,1,42483047
IMR90|chr17:20172181-20172235,chr17,20172181,20172235,IMR90|chr17:62655228-62655301,chr17,62655228,62655301,1,42483047
IMR90|chr17:26531924-26532074,chr17,26531924,26532074,IMR90|chr17:26548915-26549013,chr17,26548915,26549013,1,16991
IMR90|chr17:26531932-26532082,chr17,26531932,26532082,IMR90|chr17:26548914-26549053,chr17,26548914,26549053,1,16982
IMR90|chr17:26532027-26532150,chr17,26532027,26532150,IMR90|chr17:26548915-26548938,chr17,26548915,26548938,1,16888
IMR90|chr17:26532090-26532150,chr17,26532090,26532150,IMR90|chr17:26548915-26549022,chr17,26548915,26549022,1,16825
IMR90|chr17:26532091-26532150,chr17,26532091,26532150,IMR90|chr17:26548915-26549028,chr17,26548915,26549028,1,16824
IMR90|chr17:26532098-26532150,chr17,26532098,26532150,IMR90|chr17:26548915-26549013,chr17,26548915,26549013,1,16817
IMR90|chr17:26532111-26532150,chr17,26532111,26532150,IMR90|chr17:26548915-26549026,chr17,26548915,26549026,1,16804
IMR90|chr17:26532112-26532150,chr17,26532112,26532150,IMR90|chr17:26548915-26549022,chr17,26548915,26549022,1,16803
IMR90|chr17:26532113-26532150,chr17,26532113,26532150,IMR90|chr17:26548915-26549028,chr17,26548915,26549028,1,16802
IMR90|chr17:26532114-26532150,chr17,26532114,26532150,IMR90|chr17:26548915-26549017,chr17,26548915,26549017,1,16801
IMR90|chr17:26532123-26532150,chr17,26532123,26532150,IMR90|chr17:26548915-26549014,chr17,26548915,26549014,1,16792
IMR90|chr17:28171526-28171597,chr17,28171526,28171597,IMR90|chr17:47075292-47075322,chr17,47075292,47075322,1,18903766
IMR90|chr17:28171527-28171597,chr17,28171527,28171597,IMR90|chr17:47075292-47075322,chr17,47075292,47075322,1,18903765
IMR90|chr17:28928091-28928143,chr17,28928091,28928143,IMR90|chr17:62656493-62656585,chr17,62656493,62656585,1,33728402
IMR90|chr17:28928955-28928992,chr17,28928955,28928992,IMR90|chr17:62656789-62656896,chr17,62656789,62656896,1,33727834
IMR90|chr17:29338034-29338116,chr17,29338034,29338116,IMR90|chr17:62655650-62655728,chr17,62655650,62655728,1,33317616
IMR90|chr17:29338054-29338106,chr17,29338054,29338106,IMR90|chr17:62655761-62655824,chr17,62655761,62655824,1,33317707
IMR90|chr17:29338069-29338127,chr17,29338069,29338127,IMR90|chr17:28931130-28931179,chr17,28931130,28931179,1,406939
IMR90|chr17:29338356-29338392,chr17,29338356,29338392,IMR90|chr17:28930848-28930879,chr17,28930848,28930879,1,407508
IMR90|chr17:35886148-35886219,chr17,35886148,35886219,IMR90|chr17:62657194-62657234,chr17,62657194,62657234,1,26771046
IMR90|chr17:37036595-37036696,chr17,37036595,37036696,IMR90|chr17:34959291-34959339,chr17,34959291,34959339,1,2077304
IMR90|chr17:37036595-37036667,chr17,37036595,37036667,IMR90|chr17:34959293-34959339,chr17,34959293,34959339,1,2077302
IMR90|chr17:37036600-37036700,chr17,37036600,37036700,IMR90|chr17:34959293-34959339,chr17,34959293,34959339,1,2077307
IMR90|chr17:37049867-37049944,chr17,37049867,37049944,IMR90|chr17:41323364-41323411,chr17,41323364,41323411,1,4273497
IMR90|chr17:37055163-37055197,chr17,37055163,37055197,IMR90|chr17:62657844-62657965,chr17,62657844,62657965,1,25602681
IMR90|chr17:37055163-37055192,chr17,37055163,37055192,IMR90|chr17:62657844-62657965,chr17,62657844,62657965,1,25602681
IMR90|chr17:37056095-37056136,chr17,37056095,37056136,IMR90|chr17:62656383-62656454,chr17,62656383,62656454,1,25600288
IMR90|chr17:37056096-37056136,chr17,37056096,37056136,IMR90|chr17:62656383-62656454,chr17,62656383,62656454,1,25600287
IMR90|chr17:37061451-37061470,chr17,37061451,37061470,IMR90|chr17:80186961-80187049,chr17,80186961,80187049,1,43125510
IMR90|chr17:37061451-37061468,chr17,37061451,37061468,IMR90|chr17:80186961-80187049,chr17,80186961,80187049,1,43125510
IMR90|chr17:38483654-38483722,chr17,38483654,38483722,IMR90|chr17:38601144-38601237,chr17,38601144,38601237,1,117490
IMR90|chr17:38607716-38607755,chr17,38607716,38607755,IMR90|chr17:38522877-38522915,chr17,38522877,38522915,1,84839
IMR90|chr17:38608152-38608219,chr17,38608152,38608219,IMR90|chr17:40165032-40165098,chr17,40165032,40165098,1,1556880
IMR90|chr17:38608152-38608218,chr17,38608152,38608218,IMR90|chr17:40165032-40165099,chr17,40165032,40165099,1,1556880
IMR90|chr17:38608315-38608354,chr17,38608315,38608354,IMR90|chr17:72771528-72771601,chr17,72771528,72771601,1,34163213
IMR90|chr17:38608315-38608352,chr17,38608315,38608352,IMR90|chr17:72771528-72771601,chr17,72771528,72771601,1,34163213
IMR90|chr17:38609094-38609206,chr17,38609094,38609206,IMR90|chr17:38525820-38525888,chr17,38525820,38525888,1,83274
IMR90|chr17:38609094-38609129,chr17,38609094,38609129,IMR90|chr17:38525820-38525888,chr17,38525820,38525888,1,83274
IMR90|chr17:38609669-38609706,chr17,38609669,38609706,IMR90|chr17:38442813-38442863,chr17,38442813,38442863,1,166856
IMR90|chr17:38609707-38609730,chr17,38609707,38609730,IMR90|chr17:38442813-38442863,chr17,38442813,38442863,1,166894
IMR90|chr17:38610865-38610914,chr17,38610865,38610914,IMR90|chr17:37031266-37031309,chr17,37031266,37031309,1,1579599
IMR90|chr17:38610866-38610914,chr17,38610866,38610914,IMR90|chr17:37031266-37031309,chr17,37031266,37031309,1,1579600
IMR90|chr17:38614269-38614401,chr17,38614269,38614401,IMR90|chr17:38600425-38600460,chr17,38600425,38600460,1,13844
IMR90|chr17:38614286-38614401,chr17,38614286,38614401,IMR90|chr17:38600425-38600460,chr17,38600425,38600460,1,13861
IMR90|chr17:38614598-38614654,chr17,38614598,38614654,IMR90|chr17:38601381-38601429,chr17,38601381,38601429,1,13217
IMR90|chr17:38614686-38614716,chr17,38614686,38614716,IMR90|chr17:38602896-38602970,chr17,38602896,38602970,1,11790
IMR90|chr17:38614686-38614715,chr17,38614686,38614715,IMR90|chr17:38602896-38602970,chr17,38602896,38602970,1,11790
IMR90|chr17:38614856-38614901,chr17,38614856,38614901,IMR90|chr17:38601749-38601820,chr17,38601749,38601820,1,13107
IMR90|chr17:38614965-38615016,chr17,38614965,38615016,IMR90|chr17:38604077-38604120,chr17,38604077,38604120,1,10888
IMR90|chr17:38615147-38615190,chr17,38615147,38615190,IMR90|chr17:38604220-38604367,chr17,38604220,38604367,1,10927
IMR90|chr17:38615652-38615675,chr17,38615652,38615675,IMR90|chr17:38601988-38602008,chr17,38601988,38602008,1,13664
IMR90|chr17:38615674-38615734,chr17,38615674,38615734,IMR90|chr17:38604537-38604687,chr17,38604537,38604687,1,11137
IMR90|chr17:38615914-38616007,chr17,38615914,38616007,IMR90|chr17:80232476-80232503,chr17,80232476,80232503,1,41616562
IMR90|chr17:38616331-38616366,chr17,38616331,38616366,IMR90|chr17:38603242-38603386,chr17,38603242,38603386,1,13089
IMR90|chr17:38616481-38616539,chr17,38616481,38616539,IMR90|chr17:38600901-38600986,chr17,38600901,38600986,1,15580
IMR90|chr17:38616563-38616645,chr17,38616563,38616645,IMR90|chr17:38601799-38601903,chr17,38601799,38601903,1,14764
IMR90|chr17:38616563-38616609,chr17,38616563,38616609,IMR90|chr17:38601799-38601903,chr17,38601799,38601903,1,14764
IMR90|chr17:38616914-38616957,chr17,38616914,38616957,IMR90|chr17:38600438-38600514,chr17,38600438,38600514,1,16476
IMR90|chr17:38617283-38617302,chr17,38617283,38617302,IMR90|chr17:38604406-38604435,chr17,38604406,38604435,1,12877
IMR90|chr17:38617417-38617497,chr17,38617417,38617497,IMR90|chr17:38604436-38604474,chr17,38604436,38604474,1,12981
IMR90|chr17:38617598-38617638,chr17,38617598,38617638,IMR90|chr17:38604494-38604634,chr17,38604494,38604634,1,13104
IMR90|chr17:38617603-38617633,chr17,38617603,38617633,IMR90|chr17:38604517-38604634,chr17,38604517,38604634,1,13086
IMR90|chr17:38617884-38617981,chr17,38617884,38617981,IMR90|chr17:38601616-38601665,chr17,38601616,38601665,1,16268
IMR90|chr17:38617941-38617983,chr17,38617941,38617983,IMR90|chr17:38440587-38440658,chr17,38440587,38440658,1,177354
IMR90|chr17:38618225-38618251,chr17,38618225,38618251,IMR90|chr17:38603528-38603568,chr17,38603528,38603568,1,14697
IMR90|chr17:38618379-38618456,chr17,38618379,38618456,IMR90|chr17:38603403-38603473,chr17,38603403,38603473,1,14976
IMR90|chr17:38618379-38618455,chr17,38618379,38618455,IMR90|chr17:38603403-38603473,chr17,38603403,38603473,1,14976
IMR90|chr17:38618523-38618623,chr17,38618523,38618623,IMR90|chr17:38601736-38601793,chr17,38601736,38601793,1,16787
IMR90|chr17:38618531-38618624,chr17,38618531,38618624,IMR90|chr17:38601736-38601793,chr17,38601736,38601793,1,16795
IMR90|chr17:38618598-38618653,chr17,38618598,38618653,IMR90|chr17:38601604-38601682,chr17,38601604,38601682,1,16994
IMR90|chr17:38618633-38618653,chr17,38618633,38618653,IMR90|chr17:38603053-38603094,chr17,38603053,38603094,1,15580
IMR90|chr17:38618702-38618767,chr17,38618702,38618767,IMR90|chr17:38601882-38601958,chr17,38601882,38601958,1,16820
IMR90|chr17:38619742-38619843,chr17,38619742,38619843,IMR90|chr17:38603528-38603568,chr17,38603528,38603568,1,16214
IMR90|chr17:38620296-38620346,chr17,38620296,38620346,IMR90|chr17:38603886-38603971,chr17,38603886,38603971,1,16410
IMR90|chr17:38620296-38620336,chr17,38620296,38620336,IMR90|chr17:38603886-38603971,chr17,38603886,38603971,1,16410
IMR90|chr17:38621264-38621353,chr17,38621264,38621353,IMR90|chr17:59484214-59484235,chr17,59484214,59484235,1,20862950
IMR90|chr17:38622006-38622156,chr17,38622006,38622156,IMR90|chr17:38603923-38603948,chr17,38603923,38603948,1,18083
IMR90|chr17:38622006-38622026,chr17,38622006,38622026,IMR90|chr17:38603923-38603948,chr17,38603923,38603948,1,18083
IMR90|chr17:38622091-38622216,chr17,38622091,38622216,IMR90|chr17:38603923-38603948,chr17,38603923,38603948,1,18168
IMR90|chr17:38622646-38622667,chr17,38622646,38622667,IMR90|chr17:40166666-40166722,chr17,40166666,40166722,1,1544020
IMR90|chr17:38623880-38623908,chr17,38623880,38623908,IMR90|chr17:38523742-38523860,chr17,38523742,38523860,1,100138
IMR90|chr17:38623882-38623908,chr17,38623882,38623908,IMR90|chr17:38523742-38523860,chr17,38523742,38523860,1,100140
IMR90|chr17:38625075-38625135,chr17,38625075,38625135,IMR90|chr17:38602049-38602119,chr17,38602049,38602119,1,23026
IMR90|chr17:38625591-38625673,chr17,38625591,38625673,IMR90|chr17:40166666-40166722,chr17,40166666,40166722,1,1541075
IMR90|chr17:38625600-38625674,chr17,38625600,38625674,IMR90|chr17:40166666-40166721,chr17,40166666,40166721,1,1541066
IMR90|chr17:38701359-38701400,chr17,38701359,38701400,IMR90|chr17:38598353-38598440,chr17,38598353,38598440,1,103006
IMR90|chr17:38709403-38709486,chr17,38709403,38709486,IMR90|chr17:34137377-34137425,chr17,34137377,34137425,1,4572026
IMR90|chr17:38709403-38709478,chr17,38709403,38709478,IMR90|chr17:34137377-34137425,chr17,34137377,34137425,1,4572026
IMR90|chr17:40054066-40054122,chr17,40054066,40054122,IMR90|chr17:39971186-39971280,chr17,39971186,39971280,1,82880
IMR90|chr17:40054067-40054120,chr17,40054067,40054120,IMR90|chr17:39971186-39971280,chr17,39971186,39971280,1,82881
IMR90|chr17:40057314-40057383,chr17,40057314,40057383,IMR90|chr17:27072998-27073021,chr17,27072998,27073021,1,12984316
IMR90|chr17:40057316-40057389,chr17,40057316,40057389,IMR90|chr17:27072998-27073021,chr17,27072998,27073021,1,12984318
IMR90|chr17:40057382-40057430,chr17,40057382,40057430,IMR90|chr17:27072999-27073021,chr17,27072999,27073021,1,12984383
IMR90|chr17:40066346-40066393,chr17,40066346,40066393,IMR90|chr17:39973064-39973110,chr17,39973064,39973110,1,93282
IMR90|chr17:40066346-40066392,chr17,40066346,40066392,IMR90|chr17:39973064-39973110,chr17,39973064,39973110,1,93282
IMR90|chr17:40067718-40067777,chr17,40067718,40067777,IMR90|chr17:37557018-37557072,chr17,37557018,37557072,1,2510700
IMR90|chr17:40403794-40403853,chr17,40403794,40403853,IMR90|chr17:40610429-40610502,chr17,40610429,40610502,1,206635
IMR90|chr17:40411635-40411668,chr17,40411635,40411668,IMR90|chr17:40608104-40608162,chr17,40608104,40608162,1,196469
IMR90|chr17:40486153-40486173,chr17,40486153,40486173,IMR90|chr17:40428923-40428939,chr17,40428923,40428939,1,57230
IMR90|chr17:40494354-40494394,chr17,40494354,40494394,IMR90|chr17:39974978-39975050,chr17,39974978,39975050,1,519376
IMR90|chr17:40494354-40494391,chr17,40494354,40494391,IMR90|chr17:39974978-39975050,chr17,39974978,39975050,1,519376
IMR90|chr17:40513266-40513323,chr17,40513266,40513323,IMR90|chr17:40426519-40426572,chr17,40426519,40426572,1,86747
IMR90|chr17:40513266-40513322,chr17,40513266,40513322,IMR90|chr17:40426519-40426572,chr17,40426519,40426572,1,86747
IMR90|chr17:40553469-40553513,chr17,40553469,40553513,IMR90|chr17:40543005-40543155,chr17,40543005,40543155,1,10464
IMR90|chr17:40553469-40553512,chr17,40553469,40553512,IMR90|chr17:40543005-40543138,chr17,40543005,40543138,1,10464
IMR90|chr17:40558055-40558108,chr17,40558055,40558108,IMR90|chr17:40539738-40539795,chr17,40539738,40539795,1,18317
IMR90|chr17:40558582-40558691,chr17,40558582,40558691,IMR90|chr17:40545402-40545443,chr17,40545402,40545443,1,13180
IMR90|chr17:40558621-40558691,chr17,40558621,40558691,IMR90|chr17:40545402-40545482,chr17,40545402,40545482,1,13219
IMR90|chr17:40561182-40561240,chr17,40561182,40561240,IMR90|chr17:40541286-40541315,chr17,40541286,40541315,1,19896
IMR90|chr17:40565908-40566016,chr17,40565908,40566016,IMR90|chr17:39973084-39973151,chr17,39973084,39973151,1,592824
IMR90|chr17:40565933-40566016,chr17,40565933,40566016,IMR90|chr17:39973084-39973151,chr17,39973084,39973151,1,592849
IMR90|chr17:40567135-40567198,chr17,40567135,40567198,IMR90|chr17:39966720-39966810,chr17,39966720,39966810,1,600415
IMR90|chr17:40567135-40567195,chr17,40567135,40567195,IMR90|chr17:39966720-39966810,chr17,39966720,39966810,1,600415
IMR90|chr17:40581057-40581128,chr17,40581057,40581128,IMR90|chr17:40574180-40574233,chr17,40574180,40574233,1,6877
IMR90|chr17:40583252-40583386,chr17,40583252,40583386,IMR90|chr17:40575653-40575690,chr17,40575653,40575690,1,7599
IMR90|chr17:40583252-40583363,chr17,40583252,40583363,IMR90|chr17:40575653-40575690,chr17,40575653,40575690,1,7599
IMR90|chr17:40583259-40583400,chr17,40583259,40583400,IMR90|chr17:40579632-40579719,chr17,40579632,40579719,1,3627
IMR90|chr17:40587156-40587222,chr17,40587156,40587222,IMR90|chr17:40579313-40579463,chr17,40579313,40579463,1,7843
IMR90|chr17:40626272-40626321,chr17,40626272,40626321,IMR90|chr17:15553524-15553591,chr17,15553524,15553591,1,25072748
IMR90|chr17:41885185-41885238,chr17,41885185,41885238,IMR90|chr17:41855216-41855323,chr17,41855216,41855323,1,29969
IMR90|chr17:41885195-41885238,chr17,41885195,41885238,IMR90|chr17:41855216-41855323,chr17,41855216,41855323,1,29979
IMR90|chr17:41899177-41899213,chr17,41899177,41899213,IMR90|chr17:48543452-48543529,chr17,48543452,48543529,1,6644275
IMR90|chr17:41899177-41899206,chr17,41899177,41899206,IMR90|chr17:48543444-48543529,chr17,48543444,48543529,1,6644267
IMR90|chr17:43153234-43153298,chr17,43153234,43153298,IMR90|chr17:41853202-41853326,chr17,41853202,41853326,1,1300032
IMR90|chr17:43153236-43153277,chr17,43153236,43153277,IMR90|chr17:41853202-41853326,chr17,41853202,41853326,1,1300034
IMR90|chr17:43662360-43662510,chr17,43662360,43662510,IMR90|chr17:62915464-62915583,chr17,62915464,62915583,1,19253104
IMR90|chr17:43662428-43662524,chr17,43662428,43662524,IMR90|chr17:62915314-62915422,chr17,62915314,62915422,1,19252886
IMR90|chr17:43662452-43662510,chr17,43662452,43662510,IMR90|chr17:62915464-62915600,chr17,62915464,62915600,1,19253012
IMR90|chr17:43662470-43662514,chr17,43662470,43662514,IMR90|chr17:62915371-62915486,chr17,62915371,62915486,1,19252901
IMR90|chr17:43662487-43662517,chr17,43662487,43662517,IMR90|chr17:62915433-62915506,chr17,62915433,62915506,1,19252946
IMR90|chr17:43662492-43662524,chr17,43662492,43662524,IMR90|chr17:62915431-62915572,chr17,62915431,62915572,1,19252939
IMR90|chr17:44188747-44188887,chr17,44188747,44188887,IMR90|chr17:62655203-62655239,chr17,62655203,62655239,1,18466456
IMR90|chr17:44188836-44188914,chr17,44188836,44188914,IMR90|chr17:62655203-62655239,chr17,62655203,62655239,1,18466367
IMR90|chr17:44197177-44197225,chr17,44197177,44197225,IMR90|chr17:62653467-62653538,chr17,62653467,62653538,1,18456290
IMR90|chr17:44209382-44209476,chr17,44209382,44209476,IMR90|chr17:21187460-21187514,chr17,21187460,21187514,1,23021922
IMR90|chr17:44209384-44209473,chr17,44209384,44209473,IMR90|chr17:21187460-21187514,chr17,21187460,21187514,1,23021924
IMR90|chr17:44210868-44210894,chr17,44210868,44210894,IMR90|chr17:75447924-75448004,chr17,75447924,75448004,1,31237056
IMR90|chr17:44210868-44210893,chr17,44210868,44210893,IMR90|chr17:75447924-75448004,chr17,75447924,75448004,1,31237056
IMR90|chr17:44229283-44229318,chr17,44229283,44229318,IMR90|chr17:62656069-62656172,chr17,62656069,62656172,1,18426786
IMR90|chr17:44229283-44229317,chr17,44229283,44229317,IMR90|chr17:62656069-62656172,chr17,62656069,62656172,1,18426786
IMR90|chr17:45154518-45154654,chr17,45154518,45154654,IMR90|chr17:43024258-43024279,chr17,43024258,43024279,1,2130260
IMR90|chr17:45154518-45154647,chr17,45154518,45154647,IMR90|chr17:43024258-43024279,chr17,43024258,43024279,1,2130260
IMR90|chr17:45260237-45260271,chr17,45260237,45260271,IMR90|chr17:76163075-76163182,chr17,76163075,76163182,1,30902838
IMR90|chr17:45260237-45260267,chr17,45260237,45260267,IMR90|chr17:76163075-76163182,chr17,76163075,76163182,1,30902838
IMR90|chr17:45260238-45260271,chr17,45260238,45260271,IMR90|chr17:76163075-76163182,chr17,76163075,76163182,1,30902837
IMR90|chr17:47396155-47396179,chr17,47396155,47396179,IMR90|chr17:40074833-40074873,chr17,40074833,40074873,1,7321322
IMR90|chr17:47407638-47407681,chr17,47407638,47407681,IMR90|chr17:40074833-40074873,chr17,40074833,40074873,1,7332805
IMR90|chr17:47407638-47407680,chr17,47407638,47407680,IMR90|chr17:40074833-40074873,chr17,40074833,40074873,1,7332805
IMR90|chr17:48127504-48127565,chr17,48127504,48127565,IMR90|chr17:16259309-16259386,chr17,16259309,16259386,1,31868195
IMR90|chr17:48127505-48127565,chr17,48127505,48127565,IMR90|chr17:16259310-16259386,chr17,16259310,16259386,1,31868195
IMR90|chr17:48265664-48265735,chr17,48265664,48265735,IMR90|chr17:80187411-80187441,chr17,80187411,80187441,1,31921747
IMR90|chr17:48268016-48268073,chr17,48268016,48268073,IMR90|chr17:48473180-48473242,chr17,48473180,48473242,1,205164
IMR90|chr17:48268016-48268072,chr17,48268016,48268072,IMR90|chr17:48473180-48473242,chr17,48473180,48473242,1,205164
IMR90|chr17:48717949-48718065,chr17,48717949,48718065,IMR90|chr17:1618338-1618372,chr17,1618338,1618372,1,47099611
IMR90|chr17:48717949-48718064,chr17,48717949,48718064,IMR90|chr17:1618338-1618372,chr17,1618338,1618372,1,47099611
IMR90|chr17:48717978-48718128,chr17,48717978,48718128,IMR90|chr17:1618338-1618372,chr17,1618338,1618372,1,47099640
IMR90|chr17:55994323-55994385,chr17,55994323,55994385,IMR90|chr17:55929708-55929802,chr17,55929708,55929802,1,64615
IMR90|chr17:55994329-55994385,chr17,55994329,55994385,IMR90|chr17:55929708-55929802,chr17,55929708,55929802,1,64621
IMR90|chr17:56003231-56003299,chr17,56003231,56003299,IMR90|chr17:57784364-57784396,chr17,57784364,57784396,1,1781133
IMR90|chr17:56003231-56003298,chr17,56003231,56003298,IMR90|chr17:57784364-57784396,chr17,57784364,57784396,1,1781133
IMR90|chr17:56015710-56015785,chr17,56015710,56015785,IMR90|chr17:48135251-48135326,chr17,48135251,48135326,1,7880459
IMR90|chr17:56016041-56016157,chr17,56016041,56016157,IMR90|chr17:55930204-55930292,chr17,55930204,55930292,1,85837
IMR90|chr17:56016041-56016103,chr17,56016041,56016103,IMR90|chr17:55930204-55930292,chr17,55930204,55930292,1,85837
IMR90|chr17:57867234-57867351,chr17,57867234,57867351,IMR90|chr17:80008741-80008774,chr17,80008741,80008774,1,22141507
IMR90|chr17:57870062-57870206,chr17,57870062,57870206,IMR90|chr17:57781427-57781463,chr17,57781427,57781463,1,88635
IMR90|chr17:57870064-57870178,chr17,57870064,57870178,IMR90|chr17:57781427-57781463,chr17,57781427,57781463,1,88637
IMR90|chr17:57872438-57872493,chr17,57872438,57872493,IMR90|chr17:60143258-60143318,chr17,60143258,60143318,1,2270820
IMR90|chr17:57874589-57874654,chr17,57874589,57874654,IMR90|chr17:8054163-8054196,chr17,8054163,8054196,1,49820426
IMR90|chr17:57874594-57874654,chr17,57874594,57874654,IMR90|chr17:8054163-8054196,chr17,8054163,8054196,1,49820431
IMR90|chr17:57874611-57874654,chr17,57874611,57874654,IMR90|chr17:8054163-8054196,chr17,8054163,8054196,1,49820448
IMR90|chr17:57881728-57881830,chr17,57881728,57881830,IMR90|chr17:80234709-80234793,chr17,80234709,80234793,1,22352981
IMR90|chr17:57881728-57881828,chr17,57881728,57881828,IMR90|chr17:80234674-80234793,chr17,80234674,80234793,1,22352946
IMR90|chr17:57898383-57898459,chr17,57898383,57898459,IMR90|chr17:57696198-57696226,chr17,57696198,57696226,1,202185
IMR90|chr17:57915369-57915430,chr17,57915369,57915430,IMR90|chr17:73177947-73178025,chr17,73177947,73178025,1,15262578
IMR90|chr17:57915369-57915427,chr17,57915369,57915427,IMR90|chr17:73177947-73178025,chr17,73177947,73178025,1,15262578
IMR90|chr17:57915369-57915424,chr17,57915369,57915424,IMR90|chr17:73177947-73178025,chr17,73177947,73178025,1,15262578
IMR90|chr17:57916612-57916660,chr17,57916612,57916660,IMR90|chr17:57699790-57699849,chr17,57699790,57699849,1,216822
IMR90|chr17:57916612-57916659,chr17,57916612,57916659,IMR90|chr17:57699790-57699849,chr17,57699790,57699849,1,216822
IMR90|chr17:57916724-57916764,chr17,57916724,57916764,IMR90|chr17:57782183-57782248,chr17,57782183,57782248,1,134541
IMR90|chr17:59298986-59299057,chr17,59298986,59299057,IMR90|chr17:75452264-75452311,chr17,75452264,75452311,1,16153278
IMR90|chr17:59369395-59369430,chr17,59369395,59369430,IMR90|chr17:59474917-59475044,chr17,59474917,59475044,1,105522
IMR90|chr17:59374466-59374529,chr17,59374466,59374529,IMR90|chr17:59472895-59472977,chr17,59472895,59472977,1,98429
IMR90|chr17:59380904-59381054,chr17,59380904,59381054,IMR90|chr17:59479992-59480023,chr17,59479992,59480023,1,99088
IMR90|chr17:59380940-59381059,chr17,59380940,59381059,IMR90|chr17:59479992-59480023,chr17,59479992,59480023,1,99052
IMR90|chr17:59388353-59388413,chr17,59388353,59388413,IMR90|chr17:48942185-48942257,chr17,48942185,48942257,1,10446168
IMR90|chr17:59388353-59388412,chr17,59388353,59388412,IMR90|chr17:48942185-48942257,chr17,48942185,48942257,1,10446168
IMR90|chr17:59388357-59388414,chr17,59388357,59388414,IMR90|chr17:48942185-48942257,chr17,48942185,48942257,1,10446172
IMR90|chr17:59482361-59482454,chr17,59482361,59482454,IMR90|chr17:27042253-27042339,chr17,27042253,27042339,1,32440108
IMR90|chr17:59482361-59482425,chr17,59482361,59482425,IMR90|chr17:27042253-27042339,chr17,27042253,27042339,1,32440108
IMR90|chr17:59483461-59483495,chr17,59483461,59483495,IMR90|chr17:27052202-27052281,chr17,27052202,27052281,1,32431259
IMR90|chr17:59483461-59483493,chr17,59483461,59483493,IMR90|chr17:27052202-27052281,chr17,27052202,27052281,1,32431259
IMR90|chr17:60636918-60637035,chr17,60636918,60637035,IMR90|chr17:61050475-61050625,chr17,61050475,61050625,1,413557
IMR90|chr17:61073672-61073732,chr17,61073672,61073732,IMR90|chr17:61047275-61047324,chr17,61047275,61047324,1,26397
IMR90|chr17:61073672-61073722,chr17,61073672,61073722,IMR90|chr17:61047275-61047324,chr17,61047275,61047324,1,26397
IMR90|chr17:61074547-61074637,chr17,61074547,61074637,IMR90|chr17:61047821-61047861,chr17,61047821,61047861,1,26726
IMR90|chr17:61074547-61074636,chr17,61074547,61074636,IMR90|chr17:61047821-61047861,chr17,61047821,61047861,1,26726
IMR90|chr17:61174352-61174416,chr17,61174352,61174416,IMR90|chr17:61048213-61048261,chr17,61048213,61048261,1,126139
IMR90|chr17:61187745-61187832,chr17,61187745,61187832,IMR90|chr17:61048763-61048826,chr17,61048763,61048826,1,138982
IMR90|chr17:61187789-61187832,chr17,61187789,61187832,IMR90|chr17:61048763-61048828,chr17,61048763,61048828,1,139026
IMR90|chr17:61190674-61190750,chr17,61190674,61190750,IMR90|chr17:62653673-62653739,chr17,62653673,62653739,1,1462999
IMR90|chr17:61196044-61196110,chr17,61196044,61196110,IMR90|chr17:62653542-62653626,chr17,62653542,62653626,1,1457498
IMR90|chr17:61257894-61257940,chr17,61257894,61257940,IMR90|chr17:59484237-59484275,chr17,59484237,59484275,1,1773657
IMR90|chr17:61257896-61257940,chr17,61257896,61257940,IMR90|chr17:59484237-59484275,chr17,59484237,59484275,1,1773659
IMR90|chr17:61259541-61259577,chr17,61259541,61259577,IMR90|chr17:80189774-80189862,chr17,80189774,80189862,1,18930233
IMR90|chr17:61426688-61426744,chr17,61426688,61426744,IMR90|chr17:61675552-61675646,chr17,61675552,61675646,1,248864
IMR90|chr17:61426689-61426743,chr17,61426689,61426743,IMR90|chr17:61675552-61675646,chr17,61675552,61675646,1,248863
IMR90|chr17:61448201-61448262,chr17,61448201,61448262,IMR90|chr17:47437914-47438001,chr17,47437914,47438001,1,14010287
IMR90|chr17:62229720-62229760,chr17,62229720,62229760,IMR90|chr17:7310956-7311001,chr17,7310956,7311001,1,54918764
IMR90|chr17:62229720-62229759,chr17,62229720,62229759,IMR90|chr17:7310956-7311001,chr17,7310956,7311001,1,54918764
IMR90|chr17:62267200-62267296,chr17,62267200,62267296,IMR90|chr17:62654087-62654111,chr17,62654087,62654111,1,386887
IMR90|chr17:62267201-62267296,chr17,62267201,62267296,IMR90|chr17:62654087-62654111,chr17,62654087,62654111,1,386886
IMR90|chr17:62267202-62267296,chr17,62267202,62267296,IMR90|chr17:62654087-62654110,chr17,62654087,62654110,1,386885
IMR90|chr17:62552369-62552454,chr17,62552369,62552454,IMR90|chr17:48135176-48135219,chr17,48135176,48135219,1,14417193
IMR90|chr17:62552370-62552454,chr17,62552370,62552454,IMR90|chr17:48135176-48135219,chr17,48135176,48135219,1,14417194
IMR90|chr17:62607351-62607375,chr17,62607351,62607375,IMR90|chr17:75319463-75319578,chr17,75319463,75319578,1,12712112
IMR90|chr17:62607351-62607374,chr17,62607351,62607374,IMR90|chr17:75319942-75320012,chr17,75319942,75320012,1,12712591
IMR90|chr17:62607954-62608079,chr17,62607954,62608079,IMR90|chr17:6542870-6542921,chr17,6542870,6542921,1,56065084
IMR90|chr17:62607954-62608051,chr17,62607954,62608051,IMR90|chr17:6542870-6542921,chr17,6542870,6542921,1,56065084
IMR90|chr17:62609540-62609561,chr17,62609540,62609561,IMR90|chr17:62501103-62501174,chr17,62501103,62501174,1,108437
IMR90|chr17:62610162-62610202,chr17,62610162,62610202,IMR90|chr17:79819529-79819601,chr17,79819529,79819601,1,17209367
IMR90|chr17:62610484-62610555,chr17,62610484,62610555,IMR90|chr17:56062175-56062254,chr17,56062175,56062254,1,6548309
IMR90|chr17:62611207-62611254,chr17,62611207,62611254,IMR90|chr17:62495108-62495181,chr17,62495108,62495181,1,116099
IMR90|chr17:62611207-62611251,chr17,62611207,62611251,IMR90|chr17:62495108-62495181,chr17,62495108,62495181,1,116099
IMR90|chr17:62613817-62613869,chr17,62613817,62613869,IMR90|chr17:75373356-75373454,chr17,75373356,75373454,1,12759539
IMR90|chr17:62617390-62617460,chr17,62617390,62617460,IMR90|chr17:62504434-62504514,chr17,62504434,62504514,1,112956
IMR90|chr17:62617400-62617550,chr17,62617400,62617550,IMR90|chr17:62504434-62504514,chr17,62504434,62504514,1,112966
IMR90|chr17:62617407-62617484,chr17,62617407,62617484,IMR90|chr17:40572095-40572122,chr17,40572095,40572122,1,22045312
IMR90|chr17:62617407-62617437,chr17,62617407,62617437,IMR90|chr17:40572095-40572122,chr17,40572095,40572122,1,22045312
IMR90|chr17:62617609-62617667,chr17,62617609,62617667,IMR90|chr17:40579012-40579061,chr17,40579012,40579061,1,22038597
IMR90|chr17:62618583-62618611,chr17,62618583,62618611,IMR90|chr17:75373441-75373458,chr17,75373441,75373458,1,12754858
IMR90|chr17:62619666-62619712,chr17,62619666,62619712,IMR90|chr17:40572787-40572891,chr17,40572787,40572891,1,22046879
IMR90|chr17:62619720-62619766,chr17,62619720,62619766,IMR90|chr17:62658226-62658367,chr17,62658226,62658367,1,38506
IMR90|chr17:62620539-62620617,chr17,62620539,62620617,IMR90|chr17:62658288-62658318,chr17,62658288,62658318,1,37749
IMR90|chr17:62621594-62621639,chr17,62621594,62621639,IMR90|chr17:56061325-56061475,chr17,56061325,56061475,1,6560269
IMR90|chr17:62621971-62622013,chr17,62621971,62622013,IMR90|chr17:75374601-75374751,chr17,75374601,75374751,1,12752630
IMR90|chr17:62622300-62622360,chr17,62622300,62622360,IMR90|chr17:30772202-30772308,chr17,30772202,30772308,1,31850098
IMR90|chr17:62622734-62622877,chr17,62622734,62622877,IMR90|chr17:42277279-42277379,chr17,42277279,42277379,1,20345455
IMR90|chr17:62622734-62622876,chr17,62622734,62622876,IMR90|chr17:42277279-42277378,chr17,42277279,42277378,1,20345455
IMR90|chr17:62622750-62622896,chr17,62622750,62622896,IMR90|chr17:66287573-66287670,chr17,66287573,66287670,1,3664823
IMR90|chr17:62624248-62624293,chr17,62624248,62624293,IMR90|chr17:78390116-78390197,chr17,78390116,78390197,1,15765868
IMR90|chr17:62624252-62624293,chr17,62624252,62624293,IMR90|chr17:78390116-78390197,chr17,78390116,78390197,1,15765864
IMR90|chr17:62625214-62625236,chr17,62625214,62625236,IMR90|chr17:62658307-62658420,chr17,62658307,62658420,1,33093
IMR90|chr17:62625215-62625236,chr17,62625215,62625236,IMR90|chr17:62658307-62658420,chr17,62658307,62658420,1,33092
IMR90|chr17:62625246-62625317,chr17,62625246,62625317,IMR90|chr17:35852353-35852418,chr17,35852353,35852418,1,26772893
IMR90|chr17:62626118-62626198,chr17,62626118,62626198,IMR90|chr17:79819730-79819767,chr17,79819730,79819767,1,17193612
IMR90|chr17:62626182-62626294,chr17,62626182,62626294,IMR90|chr17:75316780-75316877,chr17,75316780,75316877,1,12690598
IMR90|chr17:62626700-62626724,chr17,62626700,62626724,IMR90|chr17:78193183-78193333,chr17,78193183,78193333,1,15566483
IMR90|chr17:62627022-62627098,chr17,62627022,62627098,IMR90|chr17:62497619-62497663,chr17,62497619,62497663,1,129403
IMR90|chr17:62627023-62627099,chr17,62627023,62627099,IMR90|chr17:62497619-62497663,chr17,62497619,62497663,1,129404
IMR90|chr17:62627162-62627231,chr17,62627162,62627231,IMR90|chr17:62489697-62489768,chr17,62489697,62489768,1,137465
IMR90|chr17:62627268-62627317,chr17,62627268,62627317,IMR90|chr17:62660094-62660189,chr17,62660094,62660189,1,32826
IMR90|chr17:62627271-62627331,chr17,62627271,62627331,IMR90|chr17:62660094-62660189,chr17,62660094,62660189,1,32823
IMR90|chr17:62627457-62627551,chr17,62627457,62627551,IMR90|chr17:62501071-62501105,chr17,62501071,62501105,1,126386
IMR90|chr17:62627457-62627550,chr17,62627457,62627550,IMR90|chr17:62501071-62501105,chr17,62501071,62501105,1,126386
IMR90|chr17:62629133-62629199,chr17,62629133,62629199,IMR90|chr17:80408177-80408261,chr17,80408177,80408261,1,17779044
IMR90|chr17:62629134-62629214,chr17,62629134,62629214,IMR90|chr17:80408177-80408261,chr17,80408177,80408261,1,17779043
IMR90|chr17:62629230-62629324,chr17,62629230,62629324,IMR90|chr17:28616663-28616698,chr17,28616663,28616698,1,34012567
IMR90|chr17:62630357-62630419,chr17,62630357,62630419,IMR90|chr17:62504217-62504301,chr17,62504217,62504301,1,126140
IMR90|chr17:62632665-62632709,chr17,62632665,62632709,IMR90|chr17:36586525-36586582,chr17,36586525,36586582,1,26046140
IMR90|chr17:62633745-62633857,chr17,62633745,62633857,IMR90|chr17:62658362-62658407,chr17,62658362,62658407,1,24617
IMR90|chr17:62634107-62634173,chr17,62634107,62634173,IMR90|chr17:6541491-6541545,chr17,6541491,6541545,1,56092616
IMR90|chr17:62639523-62639573,chr17,62639523,62639573,IMR90|chr17:79820558-79820700,chr17,79820558,79820700,1,17181035
IMR90|chr17:62640607-62640733,chr17,62640607,62640733,IMR90|chr17:62661726-62661750,chr17,62661726,62661750,1,21119
IMR90|chr17:62641908-62641944,chr17,62641908,62641944,IMR90|chr17:36585938-36585984,chr17,36585938,36585984,1,26055970
IMR90|chr17:62642041-62642167,chr17,62642041,62642167,IMR90|chr17:40572558-40572595,chr17,40572558,40572595,1,22069483
IMR90|chr17:62643645-62643696,chr17,62643645,62643696,IMR90|chr17:56062175-56062254,chr17,56062175,56062254,1,6581470
IMR90|chr17:62644339-62644374,chr17,62644339,62644374,IMR90|chr17:62505377-62505464,chr17,62505377,62505464,1,138962
IMR90|chr17:62644610-62644647,chr17,62644610,62644647,IMR90|chr17:40811740-40811837,chr17,40811740,40811837,1,21832870
IMR90|chr17:62645514-62645550,chr17,62645514,62645550,IMR90|chr17:28615855-28615943,chr17,28615855,28615943,1,34029659
IMR90|chr17:62645729-62645850,chr17,62645729,62645850,IMR90|chr17:62661729-62661790,chr17,62661729,62661790,1,16000
IMR90|chr17:62645762-62645851,chr17,62645762,62645851,IMR90|chr17:62661729-62661790,chr17,62661729,62661790,1,15967
IMR90|chr17:62645811-62645927,chr17,62645811,62645927,IMR90|chr17:78390151-78390185,chr17,78390151,78390185,1,15744340
IMR90|chr17:62646890-62646941,chr17,62646890,62646941,IMR90|chr17:78189274-78189424,chr17,78189274,78189424,1,15542384
IMR90|chr17:62647876-62647983,chr17,62647876,62647983,IMR90|chr17:62658383-62658416,chr17,62658383,62658416,1,10507
IMR90|chr17:62647964-62648040,chr17,62647964,62648040,IMR90|chr17:62659142-62659292,chr17,62659142,62659292,1,11178
IMR90|chr17:62649551-62649599,chr17,62649551,62649599,IMR90|chr17:80405650-80405728,chr17,80405650,80405728,1,17756099
IMR90|chr17:62668543-62668593,chr17,62668543,62668593,IMR90|chr17:62659189-62659275,chr17,62659189,62659275,1,9354
IMR90|chr17:62668544-62668592,chr17,62668544,62668592,IMR90|chr17:62659189-62659275,chr17,62659189,62659275,1,9355
IMR90|chr17:62673093-62673188,chr17,62673093,62673188,IMR90|chr17:62662214-62662277,chr17,62662214,62662277,1,10879
IMR90|chr17:62673103-62673190,chr17,62673103,62673190,IMR90|chr17:62662214-62662277,chr17,62662214,62662277,1,10889
IMR90|chr17:62682781-62682835,chr17,62682781,62682835,IMR90|chr17:62655180-62655238,chr17,62655180,62655238,1,27601
IMR90|chr17:62686182-62686279,chr17,62686182,62686279,IMR90|chr17:62655274-62655359,chr17,62655274,62655359,1,30908
IMR90|chr17:62686182-62686247,chr17,62686182,62686247,IMR90|chr17:62655274-62655359,chr17,62655274,62655359,1,30908
IMR90|chr17:62699816-62699907,chr17,62699816,62699907,IMR90|chr17:62654259-62654308,chr17,62654259,62654308,1,45557
IMR90|chr17:62717336-62717407,chr17,62717336,62717407,IMR90|chr17:62491987-62492028,chr17,62491987,62492028,1,225349
IMR90|chr17:62726685-62726810,chr17,62726685,62726810,IMR90|chr17:62658145-62658266,chr17,62658145,62658266,1,68540
IMR90|chr17:62727819-62727840,chr17,62727819,62727840,IMR90|chr17:62491211-62491311,chr17,62491211,62491311,1,236608
IMR90|chr17:62735305-62735424,chr17,62735305,62735424,IMR90|chr17:62661275-62661306,chr17,62661275,62661306,1,74030
IMR90|chr17:62736955-62737018,chr17,62736955,62737018,IMR90|chr17:62497563-62497645,chr17,62497563,62497645,1,239392
IMR90|chr17:62961078-62961120,chr17,62961078,62961120,IMR90|chr17:62915051-62915161,chr17,62915051,62915161,1,46027
IMR90|chr17:62961083-62961123,chr17,62961083,62961123,IMR90|chr17:62915051-62915161,chr17,62915051,62915161,1,46032
IMR90|chr17:63044436-63044508,chr17,63044436,63044508,IMR90|chr17:62656036-62656104,chr17,62656036,62656104,1,388400
IMR90|chr17:63045273-63045395,chr17,63045273,63045395,IMR90|chr17:62654324-62654426,chr17,62654324,62654426,1,390949
IMR90|chr17:63045347-63045395,chr17,63045347,63045395,IMR90|chr17:62654324-62654426,chr17,62654324,62654426,1,391023
IMR90|chr17:64311619-64311764,chr17,64311619,64311764,IMR90|chr17:42419761-42419893,chr17,42419761,42419893,1,21891858
IMR90|chr17:64311639-64311786,chr17,64311639,64311786,IMR90|chr17:42419777-42419896,chr17,42419777,42419896,1,21891862
IMR90|chr17:64439090-64439150,chr17,64439090,64439150,IMR90|chr17:46649871-46649919,chr17,46649871,46649919,1,17789219
IMR90|chr17:64452950-64453013,chr17,64452950,64453013,IMR90|chr17:46683281-46683322,chr17,46683281,46683322,1,17769669
IMR90|chr17:64497921-64497986,chr17,64497921,64497986,IMR90|chr17:62654086-62654106,chr17,62654086,62654106,1,1843835
IMR90|chr17:64499502-64499525,chr17,64499502,64499525,IMR90|chr17:46648931-46649026,chr17,46648931,46649026,1,17850571
IMR90|chr17:64499502-64499524,chr17,64499502,64499524,IMR90|chr17:46648931-46649026,chr17,46648931,46649026,1,17850571
IMR90|chr17:64503664-64503718,chr17,64503664,64503718,IMR90|chr17:62656377-62656443,chr17,62656377,62656443,1,1847287
IMR90|chr17:64504014-64504087,chr17,64504014,64504087,IMR90|chr17:46652375-46652407,chr17,46652375,46652407,1,17851639
IMR90|chr17:64507200-64507269,chr17,64507200,64507269,IMR90|chr17:53498279-53498340,chr17,53498279,53498340,1,11008921
IMR90|chr17:64511058-64511084,chr17,64511058,64511084,IMR90|chr17:62653528-62653635,chr17,62653528,62653635,1,1857530
IMR90|chr17:64561177-64561236,chr17,64561177,64561236,IMR90|chr17:71225404-71225470,chr17,71225404,71225470,1,6664227
IMR90|chr17:65253998-65254102,chr17,65253998,65254102,IMR90|chr17:56429261-56429307,chr17,56429261,56429307,1,8824737
IMR90|chr17:65253998-65254101,chr17,65253998,65254101,IMR90|chr17:56429261-56429307,chr17,56429261,56429307,1,8824737
IMR90|chr17:65253999-65254122,chr17,65253999,65254122,IMR90|chr17:56429261-56429307,chr17,56429261,56429307,1,8824738
IMR90|chr17:65416706-65416807,chr17,65416706,65416807,IMR90|chr17:65373436-65373469,chr17,65373436,65373469,1,43270
IMR90|chr17:65424978-65425060,chr17,65424978,65425060,IMR90|chr17:74499900-74500050,chr17,74499900,74500050,1,9074922
IMR90|chr17:65424982-65425104,chr17,65424982,65425104,IMR90|chr17:74499903-74500053,chr17,74499903,74500053,1,9074921
IMR90|chr17:65425002-65425104,chr17,65425002,65425104,IMR90|chr17:74499897-74500047,chr17,74499897,74500047,1,9074895
IMR90|chr17:65425017-65425104,chr17,65425017,65425104,IMR90|chr17:74499910-74500060,chr17,74499910,74500060,1,9074893
IMR90|chr17:65425111-65425255,chr17,65425111,65425255,IMR90|chr17:74499923-74500072,chr17,74499923,74500072,1,9074812
IMR90|chr17:65425123-65425273,chr17,65425123,65425273,IMR90|chr17:74499900-74500050,chr17,74499900,74500050,1,9074777
IMR90|chr17:65425127-65425277,chr17,65425127,65425277,IMR90|chr17:74499922-74500072,chr17,74499922,74500072,1,9074795
IMR90|chr17:65427405-65427496,chr17,65427405,65427496,IMR90|chr17:65368719-65368756,chr17,65368719,65368756,1,58686
IMR90|chr17:65427405-65427495,chr17,65427405,65427495,IMR90|chr17:65368719-65368756,chr17,65368719,65368756,1,58686
IMR90|chr17:66098147-66098180,chr17,66098147,66098180,IMR90|chr17:62657889-62657976,chr17,62657889,62657976,1,3440258
IMR90|chr17:66098489-66098541,chr17,66098489,66098541,IMR90|chr17:62657409-62657453,chr17,62657409,62657453,1,3441080
IMR90|chr17:66098556-66098583,chr17,66098556,66098583,IMR90|chr17:62657316-62657389,chr17,62657316,62657389,1,3441240
IMR90|chr17:66099011-66099046,chr17,66099011,66099046,IMR90|chr17:62656256-62656368,chr17,62656256,62656368,1,3442755
IMR90|chr17:66099664-66099720,chr17,66099664,66099720,IMR90|chr17:62656558-62656619,chr17,62656558,62656619,1,3443106
IMR90|chr17:66099958-66099995,chr17,66099958,66099995,IMR90|chr17:62656349-62656499,chr17,62656349,62656499,1,3443609
IMR90|chr17:66099960-66099981,chr17,66099960,66099981,IMR90|chr17:62656496-62656531,chr17,62656496,62656531,1,3443464
IMR90|chr17:71006514-71006545,chr17,71006514,71006545,IMR90|chr17:33468031-33468181,chr17,33468031,33468181,1,37538483
IMR90|chr17:71006516-71006545,chr17,71006516,71006545,IMR90|chr17:33468031-33468181,chr17,33468031,33468181,1,37538485
IMR90|chr17:71022117-71022168,chr17,71022117,71022168,IMR90|chr17:71092707-71092853,chr17,71092707,71092853,1,70590
IMR90|chr17:73075577-73075700,chr17,73075577,73075700,IMR90|chr17:73083107-73083252,chr17,73083107,73083252,1,7530
IMR90|chr17:73335220-73335305,chr17,73335220,73335305,IMR90|chr17:62655288-62655307,chr17,62655288,62655307,1,10679932
IMR90|chr17:73335250-73335400,chr17,73335250,73335400,IMR90|chr17:62655288-62655307,chr17,62655288,62655307,1,10679962
IMR90|chr17:73337967-73338013,chr17,73337967,73338013,IMR90|chr17:62657033-62657141,chr17,62657033,62657141,1,10680934
IMR90|chr17:73337972-73338014,chr17,73337972,73338014,IMR90|chr17:62657033-62657141,chr17,62657033,62657141,1,10680939
IMR90|chr17:74434606-74434641,chr17,74434606,74434641,IMR90|chr17:79824888-79824972,chr17,79824888,79824972,1,5390282
IMR90|chr17:74434606-74434639,chr17,74434606,74434639,IMR90|chr17:79824888-79824972,chr17,79824888,79824972,1,5390282
IMR90|chr17:74698458-74698567,chr17,74698458,74698567,IMR90|chr17:48543477-48543566,chr17,48543477,48543566,1,26154981
IMR90|chr17:75096251-75096350,chr17,75096251,75096350,IMR90|chr17:28444845-28444866,chr17,28444845,28444866,1,46651406
IMR90|chr17:75352441-75352539,chr17,75352441,75352539,IMR90|chr17:38603218-38603266,chr17,38603218,38603266,1,36749223
IMR90|chr17:75352442-75352542,chr17,75352442,75352542,IMR90|chr17:38603218-38603266,chr17,38603218,38603266,1,36749224
IMR90|chr17:75389052-75389071,chr17,75389052,75389071,IMR90|chr17:74099047-74099160,chr17,74099047,74099160,1,1290005
IMR90|chr17:75409862-75409911,chr17,75409862,75409911,IMR90|chr17:39975275-39975335,chr17,39975275,39975335,1,35434587
IMR90|chr17:75431023-75431047,chr17,75431023,75431047,IMR90|chr17:39969615-39969703,chr17,39969615,39969703,1,35461408
IMR90|chr17:76677439-76677485,chr17,76677439,76677485,IMR90|chr17:75449773-75449847,chr17,75449773,75449847,1,1227666
IMR90|chr17:76677440-76677485,chr17,76677440,76677485,IMR90|chr17:75449773-75449847,chr17,75449773,75449847,1,1227667
IMR90|chr17:76677461-76677485,chr17,76677461,76677485,IMR90|chr17:75449773-75449847,chr17,75449773,75449847,1,1227688
IMR90|chr17:76786274-76786344,chr17,76786274,76786344,IMR90|chr17:76783093-76783163,chr17,76783093,76783163,1,3181
IMR90|chr17:76787344-76787385,chr17,76787344,76787385,IMR90|chr17:76779085-76779136,chr17,76779085,76779136,1,8259
IMR90|chr17:76787344-76787382,chr17,76787344,76787382,IMR90|chr17:76779084-76779136,chr17,76779084,76779136,1,8260
IMR90|chr17:76787725-76787764,chr17,76787725,76787764,IMR90|chr17:76781929-76781960,chr17,76781929,76781960,1,5796
IMR90|chr17:76787882-76787935,chr17,76787882,76787935,IMR90|chr17:76783272-76783369,chr17,76783272,76783369,1,4610
IMR90|chr17:78229376-78229459,chr17,78229376,78229459,IMR90|chr17:78230190-78230251,chr17,78230190,78230251,1,814
IMR90|chr17:78229377-78229485,chr17,78229377,78229485,IMR90|chr17:78230190-78230251,chr17,78230190,78230251,1,813
IMR90|chr17:78229517-78229580,chr17,78229517,78229580,IMR90|chr17:78230110-78230140,chr17,78230110,78230140,1,593
IMR90|chr17:78653604-78653716,chr17,78653604,78653716,IMR90|chr17:45726166-45726201,chr17,45726166,45726201,1,32927438
IMR90|chr17:78653604-78653703,chr17,78653604,78653703,IMR90|chr17:45726166-45726201,chr17,45726166,45726201,1,32927438
IMR90|chr17:78653607-78653716,chr17,78653607,78653716,IMR90|chr17:45726166-45726201,chr17,45726166,45726201,1,32927441
IMR90|chr17:78653681-78653716,chr17,78653681,78653716,IMR90|chr17:45726166-45726201,chr17,45726166,45726201,1,32927515
IMR90|chr17:78728766-78728832,chr17,78728766,78728832,IMR90|chr17:80170001-80170066,chr17,80170001,80170066,1,1441235
IMR90|chr17:78728767-78728832,chr17,78728767,78728832,IMR90|chr17:80170000-80170065,chr17,80170000,80170065,1,1441233
IMR90|chr17:80246690-80246713,chr17,80246690,80246713,IMR90|chr17:80232253-80232341,chr17,80232253,80232341,1,14437
IMR90|chr18:3001267-3001410,chr18,3001267,3001410,IMR90|chr18:5236460-5236530,chr18,5236460,5236530,1,2235193
IMR90|chr18:3001272-3001350,chr18,3001272,3001350,IMR90|chr18:5236460-5236530,chr18,5236460,5236530,1,2235188
IMR90|chr18:8818573-8818631,chr18,8818573,8818631,IMR90|chr18:74816186-74816230,chr18,74816186,74816230,1,65997613
IMR90|chr18:8818573-8818626,chr18,8818573,8818626,IMR90|chr18:74816186-74816230,chr18,74816186,74816230,1,65997613
IMR90|chr18:12600995-12601052,chr18,12600995,12601052,IMR90|chr18:9476328-9476403,chr18,9476328,9476403,1,3124667
IMR90|chr18:12600995-12601051,chr18,12600995,12601051,IMR90|chr18:9476328-9476403,chr18,9476328,9476403,1,3124667
IMR90|chr18:43378936-43379052,chr18,43378936,43379052,IMR90|chr18:43677071-43677105,chr18,43677071,43677105,1,298135
IMR90|chr18:43379096-43379246,chr18,43379096,43379246,IMR90|chr18:43677071-43677105,chr18,43677071,43677105,1,297975
IMR90|chr18:43776972-43776992,chr18,43776972,43776992,IMR90|chr18:43654559-43654590,chr18,43654559,43654590,1,122413
IMR90|chr18:46136504-46136554,chr18,46136504,46136554,IMR90|chr18:12991659-12991713,chr18,12991659,12991713,1,33144845
IMR90|chr18:46198144-46198247,chr18,46198144,46198247,IMR90|chr18:47016001-47016044,chr18,47016001,47016044,1,817857
IMR90|chr18:46198144-46198170,chr18,46198144,46198170,IMR90|chr18:47016001-47016044,chr18,47016001,47016044,1,817857
IMR90|chr18:46198146-46198247,chr18,46198146,46198247,IMR90|chr18:47016001-47016044,chr18,47016001,47016044,1,817855
IMR90|chr18:46217871-46217901,chr18,46217871,46217901,IMR90|chr18:33711385-33711454,chr18,33711385,33711454,1,12506486
IMR90|chr18:46255044-46255154,chr18,46255044,46255154,IMR90|chr18:59245237-59245266,chr18,59245237,59245266,1,12990193
IMR90|chr18:46280907-46280972,chr18,46280907,46280972,IMR90|chr18:59249697-59249732,chr18,59249697,59249732,1,12968790
IMR90|chr18:46467514-46467621,chr18,46467514,46467621,IMR90|chr18:57363343-57363377,chr18,57363343,57363377,1,10895829
IMR90|chr18:55433895-55433960,chr18,55433895,55433960,IMR90|chr18:43651847-43651930,chr18,43651847,43651930,1,11782048
IMR90|chr18:55433896-55433963,chr18,55433896,55433963,IMR90|chr18:43651847-43651930,chr18,43651847,43651930,1,11782049
IMR90|chr18:55433897-55433963,chr18,55433897,55433963,IMR90|chr18:43651847-43651930,chr18,43651847,43651930,1,11782050
IMR90|chr18:56004143-56004186,chr18,56004143,56004186,IMR90|chr18:61638353-61638412,chr18,61638353,61638412,1,5634210
IMR90|chr18:56206615-56206651,chr18,56206615,56206651,IMR90|chr18:57363321-57363436,chr18,57363321,57363436,1,1156706
IMR90|chr18:56206616-56206651,chr18,56206616,56206651,IMR90|chr18:57363321-57363436,chr18,57363321,57363436,1,1156705
IMR90|chr18:57267735-57267873,chr18,57267735,57267873,IMR90|chr18:61088447-61088470,chr18,61088447,61088470,1,3820712
IMR90|chr18:57267735-57267862,chr18,57267735,57267862,IMR90|chr18:61088447-61088470,chr18,61088447,61088470,1,3820712
IMR90|chr18:57324573-57324662,chr18,57324573,57324662,IMR90|chr18:51884903-51884932,chr18,51884903,51884932,1,5439670
IMR90|chr18:57347118-57347151,chr18,57347118,57347151,IMR90|chr18:61088240-61088311,chr18,61088240,61088311,1,3741122
IMR90|chr18:57347566-57347616,chr18,57347566,57347616,IMR90|chr18:9915190-9915296,chr18,9915190,9915296,1,47432376
IMR90|chr18:57347572-57347616,chr18,57347572,57347616,IMR90|chr18:9915190-9915296,chr18,9915190,9915296,1,47432382
IMR90|chr18:57359274-57359333,chr18,57359274,57359333,IMR90|chr18:61089217-61089295,chr18,61089217,61089295,1,3729943
IMR90|chr18:57371497-57371567,chr18,57371497,57371567,IMR90|chr18:61087437-61087506,chr18,61087437,61087506,1,3715940
IMR90|chr18:59236352-59236500,chr18,59236352,59236500,IMR90|chr18:59245664-59245704,chr18,59245664,59245704,1,9312
IMR90|chr18:59236501-59236611,chr18,59236501,59236611,IMR90|chr18:59245664-59245704,chr18,59245664,59245704,1,9163
IMR90|chr18:59237846-59237992,chr18,59237846,59237992,IMR90|chr18:59247751-59247847,chr18,59247751,59247847,1,9905
IMR90|chr18:59269373-59269402,chr18,59269373,59269402,IMR90|chr18:59247827-59247938,chr18,59247827,59247938,1,21546
IMR90|chr18:59270995-59271065,chr18,59270995,59271065,IMR90|chr18:59245881-59245937,chr18,59245881,59245937,1,25114
IMR90|chr18:59270995-59271063,chr18,59270995,59271063,IMR90|chr18:59245881-59245937,chr18,59245881,59245937,1,25114
IMR90|chr18:60427820-60427883,chr18,60427820,60427883,IMR90|chr18:57026037-57026153,chr18,57026037,57026153,1,3401783
IMR90|chr18:60427849-60427883,chr18,60427849,60427883,IMR90|chr18:57026037-57026153,chr18,57026037,57026153,1,3401812
IMR90|chr18:74794731-74794805,chr18,74794731,74794805,IMR90|chr18:43546256-43546333,chr18,43546256,43546333,1,31248475
IMR90|chr18:74794767-74794805,chr18,74794767,74794805,IMR90|chr18:43546221-43546333,chr18,43546221,43546333,1,31248546
IMR90|chr18:74794768-74794805,chr18,74794768,74794805,IMR90|chr18:43546221-43546333,chr18,43546221,43546333,1,31248547
IMR90|chr19:946272-946372,chr19,946272,946372,IMR90|chr19:922572-922600,chr19,922572,922600,1,23700
IMR90|chr19:946273-946372,chr19,946273,946372,IMR90|chr19:922572-922600,chr19,922572,922600,1,23701
IMR90|chr19:947633-947740,chr19,947633,947740,IMR90|chr19:48825955-48825973,chr19,48825955,48825973,1,47878322
IMR90|chr19:947633-947738,chr19,947633,947738,IMR90|chr19:48825955-48825973,chr19,48825955,48825973,1,47878322
IMR90|chr19:947634-947740,chr19,947634,947740,IMR90|chr19:48825955-48825973,chr19,48825955,48825973,1,47878321
IMR90|chr19:953674-953718,chr19,953674,953718,IMR90|chr19:912913-912934,chr19,912913,912934,1,40761
IMR90|chr19:2950456-2950506,chr19,2950456,2950506,IMR90|chr19:2949718-2949865,chr19,2949718,2949865,1,738
IMR90|chr19:2950477-2950615,chr19,2950477,2950615,IMR90|chr19:2949793-2949839,chr19,2949793,2949839,1,684
IMR90|chr19:2950477-2950578,chr19,2950477,2950578,IMR90|chr19:2949793-2949839,chr19,2949793,2949839,1,684
IMR90|chr19:3376079-3376192,chr19,3376079,3376192,IMR90|chr19:36247478-36247562,chr19,36247478,36247562,1,32871399
IMR90|chr19:3388825-3388881,chr19,3388825,3388881,IMR90|chr19:2091743-2091821,chr19,2091743,2091821,1,1297082
IMR90|chr19:3388826-3388881,chr19,3388826,3388881,IMR90|chr19:2091743-2091821,chr19,2091743,2091821,1,1297083
IMR90|chr19:3399037-3399080,chr19,3399037,3399080,IMR90|chr19:2092429-2092527,chr19,2092429,2092527,1,1306608
IMR90|chr19:3399038-3399080,chr19,3399038,3399080,IMR90|chr19:2092429-2092527,chr19,2092429,2092527,1,1306609
IMR90|chr19:3400206-3400307,chr19,3400206,3400307,IMR90|chr19:3629601-3629650,chr19,3629601,3629650,1,229395
IMR90|chr19:3401741-3401798,chr19,3401741,3401798,IMR90|chr19:3626143-3626205,chr19,3626143,3626205,1,224402
IMR90|chr19:3401741-3401797,chr19,3401741,3401797,IMR90|chr19:3626143-3626205,chr19,3626143,3626205,1,224402
IMR90|chr19:3435269-3435387,chr19,3435269,3435387,IMR90|chr19:2093943-2093985,chr19,2093943,2093985,1,1341326
IMR90|chr19:3435269-3435377,chr19,3435269,3435377,IMR90|chr19:2093943-2093985,chr19,2093943,2093985,1,1341326
IMR90|chr19:3435269-3435345,chr19,3435269,3435345,IMR90|chr19:2093943-2093985,chr19,2093943,2093985,1,1341326
IMR90|chr19:3457337-3457431,chr19,3457337,3457431,IMR90|chr19:4063924-4063970,chr19,4063924,4063970,1,606587
IMR90|chr19:3457337-3457429,chr19,3457337,3457429,IMR90|chr19:4063924-4063972,chr19,4063924,4063972,1,606587
IMR90|chr19:4912486-4912509,chr19,4912486,4912509,IMR90|chr19:42365289-42365338,chr19,42365289,42365338,1,37452803
IMR90|chr19:4979070-4979089,chr19,4979070,4979089,IMR90|chr19:56150897-56151028,chr19,56150897,56151028,1,51171827
IMR90|chr19:5968082-5968165,chr19,5968082,5968165,IMR90|chr19:41773077-41773139,chr19,41773077,41773139,1,35804995
IMR90|chr19:5968082-5968123,chr19,5968082,5968123,IMR90|chr19:41773077-41773139,chr19,41773077,41773139,1,35804995
IMR90|chr19:5968132-5968165,chr19,5968132,5968165,IMR90|chr19:41773077-41773139,chr19,41773077,41773139,1,35804945
IMR90|chr19:8520594-8520648,chr19,8520594,8520648,IMR90|chr19:8375589-8375625,chr19,8375589,8375625,1,145005
IMR90|chr19:8520595-8520648,chr19,8520595,8520648,IMR90|chr19:8375589-8375625,chr19,8375589,8375625,1,145006
IMR90|chr19:8541047-8541107,chr19,8541047,8541107,IMR90|chr19:56148620-56148709,chr19,56148620,56148709,1,47607573
IMR90|chr19:8541049-8541143,chr19,8541049,8541143,IMR90|chr19:56148620-56148710,chr19,56148620,56148710,1,47607571
IMR90|chr19:11248115-11248265,chr19,11248115,11248265,IMR90|chr19:16191463-16191597,chr19,16191463,16191597,1,4943348
IMR90|chr19:11280001-11280098,chr19,11280001,11280098,IMR90|chr19:10358732-10358765,chr19,10358732,10358765,1,921269
IMR90|chr19:11280001-11280056,chr19,11280001,11280056,IMR90|chr19:10358683-10358729,chr19,10358683,10358729,1,921318
IMR90|chr19:11280002-11280098,chr19,11280002,11280098,IMR90|chr19:10358731-10358766,chr19,10358731,10358766,1,921271
IMR90|chr19:12101778-12101853,chr19,12101778,12101853,IMR90|chr19:12303003-12303043,chr19,12303003,12303043,1,201225
IMR90|chr19:13945453-13945576,chr19,13945453,13945576,IMR90|chr19:14227315-14227348,chr19,14227315,14227348,1,281862
IMR90|chr19:13945459-13945576,chr19,13945459,13945576,IMR90|chr19:14227315-14227348,chr19,14227315,14227348,1,281856
IMR90|chr19:13946743-13946853,chr19,13946743,13946853,IMR90|chr19:14226813-14226836,chr19,14226813,14226836,1,280070
IMR90|chr19:13946749-13946854,chr19,13946749,13946854,IMR90|chr19:14226813-14226836,chr19,14226813,14226836,1,280064
IMR90|chr19:13948081-13948141,chr19,13948081,13948141,IMR90|chr19:14224948-14225098,chr19,14224948,14225098,1,276867
IMR90|chr19:13952631-13952725,chr19,13952631,13952725,IMR90|chr19:45256992-45257054,chr19,45256992,45257054,1,31304361
IMR90|chr19:13952637-13952725,chr19,13952637,13952725,IMR90|chr19:45256992-45257054,chr19,45256992,45257054,1,31304355
IMR90|chr19:15333529-15333636,chr19,15333529,15333636,IMR90|chr19:15315934-15316059,chr19,15315934,15316059,1,17595
IMR90|chr19:15333529-15333578,chr19,15333529,15333578,IMR90|chr19:15315951-15316059,chr19,15315951,15316059,1,17578
IMR90|chr19:15333529-15333568,chr19,15333529,15333568,IMR90|chr19:15315951-15316059,chr19,15315951,15316059,1,17578
IMR90|chr19:15333529-15333553,chr19,15333529,15333553,IMR90|chr19:15315934-15316059,chr19,15315934,15316059,1,17595
IMR90|chr19:15333529-15333546,chr19,15333529,15333546,IMR90|chr19:15315941-15316059,chr19,15315941,15316059,1,17588
IMR90|chr19:15378334-15378440,chr19,15378334,15378440,IMR90|chr19:15542816-15542836,chr19,15542816,15542836,1,164482
IMR90|chr19:15382688-15382776,chr19,15382688,15382776,IMR90|chr19:16189360-16189412,chr19,16189360,16189412,1,806672
IMR90|chr19:15396628-15396713,chr19,15396628,15396713,IMR90|chr19:42911015-42911149,chr19,42911015,42911149,1,27514387
IMR90|chr19:15409152-15409195,chr19,15409152,15409195,IMR90|chr19:13042404-13042538,chr19,13042404,13042538,1,2366748
IMR90|chr19:15410275-15410371,chr19,15410275,15410371,IMR90|chr19:12205087-12205126,chr19,12205087,12205126,1,3205188
IMR90|chr19:15425244-15425358,chr19,15425244,15425358,IMR90|chr19:15543554-15543576,chr19,15543554,15543576,1,118310
IMR90|chr19:15433528-15433673,chr19,15433528,15433673,IMR90|chr19:13078184-13078268,chr19,13078184,13078268,1,2355344
IMR90|chr19:15436019-15436111,chr19,15436019,15436111,IMR90|chr19:16190243-16190289,chr19,16190243,16190289,1,754224
IMR90|chr19:15436236-15436271,chr19,15436236,15436271,IMR90|chr19:13057600-13057707,chr19,13057600,13057707,1,2378636
IMR90|chr19:16484441-16484542,chr19,16484441,16484542,IMR90|chr19:16181079-16181125,chr19,16181079,16181125,1,303362
IMR90|chr19:16484441-16484517,chr19,16484441,16484517,IMR90|chr19:16181079-16181153,chr19,16181079,16181153,1,303362
IMR90|chr19:17201420-17201468,chr19,17201420,17201468,IMR90|chr19:18632387-18632489,chr19,18632387,18632489,1,1430967
IMR90|chr19:17225170-17225187,chr19,17225170,17225187,IMR90|chr19:17379305-17379390,chr19,17379305,17379390,1,154135
IMR90|chr19:17227643-17227698,chr19,17227643,17227698,IMR90|chr19:18632262-18632352,chr19,18632262,18632352,1,1404619
IMR90|chr19:17227645-17227698,chr19,17227645,17227698,IMR90|chr19:18632262-18632352,chr19,18632262,18632352,1,1404617
IMR90|chr19:17230819-17230877,chr19,17230819,17230877,IMR90|chr19:17377287-17377330,chr19,17377287,17377330,1,146468
IMR90|chr19:17232062-17232116,chr19,17232062,17232116,IMR90|chr19:17378488-17378548,chr19,17378488,17378548,1,146426
IMR90|chr19:17240810-17240858,chr19,17240810,17240858,IMR90|chr19:17333579-17333698,chr19,17333579,17333698,1,92769
IMR90|chr19:17246095-17246145,chr19,17246095,17246145,IMR90|chr19:16736611-16736652,chr19,16736611,16736652,1,509484
IMR90|chr19:17246095-17246140,chr19,17246095,17246140,IMR90|chr19:16736611-16736657,chr19,16736611,16736657,1,509484
IMR90|chr19:18565828-18565919,chr19,18565828,18565919,IMR90|chr19:18433227-18433286,chr19,18433227,18433286,1,132601
IMR90|chr19:18567504-18567602,chr19,18567504,18567602,IMR90|chr19:18649875-18649927,chr19,18649875,18649927,1,82371
IMR90|chr19:18567504-18567578,chr19,18567504,18567578,IMR90|chr19:18649851-18649927,chr19,18649851,18649927,1,82347
IMR90|chr19:18599842-18599898,chr19,18599842,18599898,IMR90|chr19:19031323-19031371,chr19,19031323,19031371,1,431481
IMR90|chr19:18599842-18599894,chr19,18599842,18599894,IMR90|chr19:19031324-19031371,chr19,19031324,19031371,1,431482
IMR90|chr19:18769366-18769394,chr19,18769366,18769394,IMR90|chr19:49864412-49864435,chr19,49864412,49864435,1,31095046
IMR90|chr19:19557553-19557615,chr19,19557553,19557615,IMR90|chr19:56153343-56153416,chr19,56153343,56153416,1,36595790
IMR90|chr19:19561075-19561115,chr19,19561075,19561115,IMR90|chr19:56150554-56150661,chr19,56150554,56150661,1,36589479
IMR90|chr19:19561076-19561160,chr19,19561076,19561160,IMR90|chr19:56150554-56150661,chr19,56150554,56150661,1,36589478
IMR90|chr19:19581522-19581547,chr19,19581522,19581547,IMR90|chr19:17190026-17190112,chr19,17190026,17190112,1,2391496
IMR90|chr19:19581523-19581547,chr19,19581523,19581547,IMR90|chr19:17190026-17190112,chr19,17190026,17190112,1,2391497
IMR90|chr19:19581605-19581635,chr19,19581605,19581635,IMR90|chr19:16189659-16189705,chr19,16189659,16189705,1,3391946
IMR90|chr19:19581605-19581634,chr19,19581605,19581634,IMR90|chr19:16189659-16189706,chr19,16189659,16189706,1,3391946
IMR90|chr19:19581799-19581859,chr19,19581799,19581859,IMR90|chr19:16189854-16189894,chr19,16189854,16189894,1,3391945
IMR90|chr19:19581803-19581859,chr19,19581803,19581859,IMR90|chr19:16189854-16189894,chr19,16189854,16189894,1,3391949
IMR90|chr19:19589574-19589632,chr19,19589574,19589632,IMR90|chr19:19776396-19776543,chr19,19776396,19776543,1,186822
IMR90|chr19:19589575-19589632,chr19,19589575,19589632,IMR90|chr19:19776396-19776543,chr19,19776396,19776543,1,186821
IMR90|chr19:19705727-19705833,chr19,19705727,19705833,IMR90|chr19:19976821-19976967,chr19,19976821,19976967,1,271094
IMR90|chr19:19705727-19705832,chr19,19705727,19705832,IMR90|chr19:19976821-19976967,chr19,19976821,19976967,1,271094
IMR90|chr19:36673127-36673152,chr19,36673127,36673152,IMR90|chr19:36641766-36641824,chr19,36641766,36641824,1,31361
IMR90|chr19:38445129-38445177,chr19,38445129,38445177,IMR90|chr19:38886970-38887039,chr19,38886970,38887039,1,441841
IMR90|chr19:38445132-38445182,chr19,38445132,38445182,IMR90|chr19:38886970-38887039,chr19,38886970,38887039,1,441838
IMR90|chr19:38446074-38446122,chr19,38446074,38446122,IMR90|chr19:51303692-51303819,chr19,51303692,51303819,1,12857618
IMR90|chr19:38448267-38448356,chr19,38448267,38448356,IMR90|chr19:38145869-38145968,chr19,38145869,38145968,1,302398
IMR90|chr19:38448308-38448359,chr19,38448308,38448359,IMR90|chr19:38145869-38145968,chr19,38145869,38145968,1,302439
IMR90|chr19:38451782-38451836,chr19,38451782,38451836,IMR90|chr19:39141606-39141659,chr19,39141606,39141659,1,689824
IMR90|chr19:38451784-38451836,chr19,38451784,38451836,IMR90|chr19:39141606-39141661,chr19,39141606,39141661,1,689822
IMR90|chr19:38464304-38464410,chr19,38464304,38464410,IMR90|chr19:39141903-39141941,chr19,39141903,39141941,1,677599
IMR90|chr19:38478157-38478206,chr19,38478157,38478206,IMR90|chr19:44168300-44168359,chr19,44168300,44168359,1,5690143
IMR90|chr19:38478158-38478206,chr19,38478158,38478206,IMR90|chr19:44168300-44168359,chr19,44168300,44168359,1,5690142
IMR90|chr19:38483084-38483190,chr19,38483084,38483190,IMR90|chr19:38732171-38732215,chr19,38732171,38732215,1,249087
IMR90|chr19:38484955-38485019,chr19,38484955,38485019,IMR90|chr19:44168624-44168644,chr19,44168624,44168644,1,5683669
IMR90|chr19:38522431-38522520,chr19,38522431,38522520,IMR90|chr19:49458581-49458642,chr19,49458581,49458642,1,10936150
IMR90|chr19:38522483-38522633,chr19,38522483,38522633,IMR90|chr19:49458581-49458642,chr19,49458581,49458642,1,10936098
IMR90|chr19:38557725-38557796,chr19,38557725,38557796,IMR90|chr19:33866133-33866212,chr19,33866133,33866212,1,4691592
IMR90|chr19:38557725-38557779,chr19,38557725,38557779,IMR90|chr19:33866133-33866212,chr19,33866133,33866212,1,4691592
IMR90|chr19:38557728-38557852,chr19,38557728,38557852,IMR90|chr19:33866133-33866212,chr19,33866133,33866212,1,4691595
IMR90|chr19:39146911-39147058,chr19,39146911,39147058,IMR90|chr19:39337700-39337745,chr19,39337700,39337745,1,190789
IMR90|chr19:39147685-39147752,chr19,39147685,39147752,IMR90|chr19:39336119-39336161,chr19,39336119,39336161,1,188434
IMR90|chr19:39147686-39147752,chr19,39147686,39147752,IMR90|chr19:39336119-39336161,chr19,39336119,39336161,1,188433
IMR90|chr19:39155714-39155740,chr19,39155714,39155740,IMR90|chr19:37065051-37065171,chr19,37065051,37065171,1,2090663
IMR90|chr19:39155757-39155907,chr19,39155757,39155907,IMR90|chr19:37065051-37065171,chr19,37065051,37065171,1,2090706
IMR90|chr19:39160923-39160950,chr19,39160923,39160950,IMR90|chr19:58906808-58906892,chr19,58906808,58906892,1,19745885
IMR90|chr19:39160923-39160949,chr19,39160923,39160949,IMR90|chr19:58906808-58906892,chr19,58906808,58906892,1,19745885
IMR90|chr19:39166520-39166612,chr19,39166520,39166612,IMR90|chr19:37067138-37067187,chr19,37067138,37067187,1,2099382
IMR90|chr19:39169876-39169932,chr19,39169876,39169932,IMR90|chr19:39134904-39135015,chr19,39134904,39135015,1,34972
IMR90|chr19:39169876-39169915,chr19,39169876,39169915,IMR90|chr19:39134904-39135015,chr19,39134904,39135015,1,34972
IMR90|chr19:39172662-39172740,chr19,39172662,39172740,IMR90|chr19:6527689-6527773,chr19,6527689,6527773,1,32644973
IMR90|chr19:39172662-39172729,chr19,39172662,39172729,IMR90|chr19:6527689-6527773,chr19,6527689,6527773,1,32644973
IMR90|chr19:39172680-39172740,chr19,39172680,39172740,IMR90|chr19:6527689-6527773,chr19,6527689,6527773,1,32644991
IMR90|chr19:39176610-39176685,chr19,39176610,39176685,IMR90|chr19:39336728-39336803,chr19,39336728,39336803,1,160118
IMR90|chr19:39176610-39176652,chr19,39176610,39176652,IMR90|chr19:39336728-39336836,chr19,39336728,39336836,1,160118
IMR90|chr19:39179443-39179476,chr19,39179443,39179476,IMR90|chr19:38888608-38888628,chr19,38888608,38888628,1,290835
IMR90|chr19:39179450-39179476,chr19,39179450,39179476,IMR90|chr19:38888526-38888635,chr19,38888526,38888635,1,290924
IMR90|chr19:39187065-39187116,chr19,39187065,39187116,IMR90|chr19:47732723-47732821,chr19,47732723,47732821,1,8545658
IMR90|chr19:39187065-39187115,chr19,39187065,39187115,IMR90|chr19:47732723-47732821,chr19,47732723,47732821,1,8545658
IMR90|chr19:39187066-39187113,chr19,39187066,39187113,IMR90|chr19:47732723-47732821,chr19,47732723,47732821,1,8545657
IMR90|chr19:39205622-39205654,chr19,39205622,39205654,IMR90|chr19:39134061-39134123,chr19,39134061,39134123,1,71561
IMR90|chr19:39854587-39854715,chr19,39854587,39854715,IMR90|chr19:2839557-2839591,chr19,2839557,2839591,1,37015030
IMR90|chr19:39854587-39854714,chr19,39854587,39854714,IMR90|chr19:2839557-2839591,chr19,2839557,2839591,1,37015030
IMR90|chr19:39854602-39854715,chr19,39854602,39854715,IMR90|chr19:2839557-2839591,chr19,2839557,2839591,1,37015045
IMR90|chr19:39892050-39892072,chr19,39892050,39892072,IMR90|chr19:39882552-39882616,chr19,39882552,39882616,1,9498
IMR90|chr19:41153620-41153695,chr19,41153620,41153695,IMR90|chr19:41308244-41308294,chr19,41308244,41308294,1,154624
IMR90|chr19:41160888-41160937,chr19,41160888,41160937,IMR90|chr19:41311233-41311331,chr19,41311233,41311331,1,150345
IMR90|chr19:41804779-41804841,chr19,41804779,41804841,IMR90|chr19:41767831-41767917,chr19,41767831,41767917,1,36948
IMR90|chr19:41804784-41804843,chr19,41804784,41804843,IMR90|chr19:41767831-41767917,chr19,41767831,41767917,1,36953
IMR90|chr19:41804785-41804843,chr19,41804785,41804843,IMR90|chr19:41767831-41767917,chr19,41767831,41767917,1,36954
IMR90|chr19:45245660-45245757,chr19,45245660,45245757,IMR90|chr19:45248176-45248216,chr19,45248176,45248216,1,2516
IMR90|chr19:45246155-45246259,chr19,45246155,45246259,IMR90|chr19:45248301-45248392,chr19,45248301,45248392,1,2146
IMR90|chr19:45246161-45246259,chr19,45246161,45246259,IMR90|chr19:45248371-45248395,chr19,45248371,45248395,1,2210
IMR90|chr19:45246161-45246181,chr19,45246161,45246181,IMR90|chr19:45248301-45248405,chr19,45248301,45248405,1,2140
IMR90|chr19:45246200-45246259,chr19,45246200,45246259,IMR90|chr19:45248301-45248392,chr19,45248301,45248392,1,2101
IMR90|chr19:45246207-45246259,chr19,45246207,45246259,IMR90|chr19:45248301-45248370,chr19,45248301,45248370,1,2094
IMR90|chr19:45246223-45246258,chr19,45246223,45246258,IMR90|chr19:45248299-45248394,chr19,45248299,45248394,1,2076
IMR90|chr19:45246224-45246256,chr19,45246224,45246256,IMR90|chr19:45248299-45248394,chr19,45248299,45248394,1,2075
IMR90|chr19:45879530-45879615,chr19,45879530,45879615,IMR90|chr19:45876133-45876205,chr19,45876133,45876205,1,3397
IMR90|chr19:45879537-45879615,chr19,45879537,45879615,IMR90|chr19:45876133-45876205,chr19,45876133,45876205,1,3404
IMR90|chr19:45879863-45879975,chr19,45879863,45879975,IMR90|chr19:45879048-45879195,chr19,45879048,45879195,1,815
IMR90|chr19:47368887-47368978,chr19,47368887,47368978,IMR90|chr19:39972124-39972149,chr19,39972124,39972149,1,7396763
IMR90|chr19:47368922-47368978,chr19,47368922,47368978,IMR90|chr19:39972124-39972149,chr19,39972124,39972149,1,7396798
IMR90|chr19:47372391-47372433,chr19,47372391,47372433,IMR90|chr19:39969527-39969576,chr19,39969527,39969576,1,7402864
IMR90|chr19:47382194-47382248,chr19,47382194,47382248,IMR90|chr19:13903990-13904055,chr19,13903990,13904055,1,33478204
IMR90|chr19:47382195-47382248,chr19,47382195,47382248,IMR90|chr19:13903990-13904055,chr19,13903990,13904055,1,33478205
IMR90|chr19:47386619-47386697,chr19,47386619,47386697,IMR90|chr19:47354798-47354845,chr19,47354798,47354845,1,31821
IMR90|chr19:47394178-47394208,chr19,47394178,47394208,IMR90|chr19:47352584-47352680,chr19,47352584,47352680,1,41594
IMR90|chr19:47404732-47404770,chr19,47404732,47404770,IMR90|chr19:47350084-47350196,chr19,47350084,47350196,1,54648
IMR90|chr19:47406331-47406397,chr19,47406331,47406397,IMR90|chr19:39972124-39972148,chr19,39972124,39972148,1,7434207
IMR90|chr19:47406331-47406366,chr19,47406331,47406366,IMR90|chr19:39972124-39972148,chr19,39972124,39972148,1,7434207
IMR90|chr19:47435255-47435307,chr19,47435255,47435307,IMR90|chr19:47352016-47352137,chr19,47352016,47352137,1,83239
IMR90|chr19:47463444-47463475,chr19,47463444,47463475,IMR90|chr19:30205285-30205404,chr19,30205285,30205404,1,17258159
IMR90|chr19:47467477-47467567,chr19,47467477,47467567,IMR90|chr19:47352076-47352144,chr19,47352076,47352144,1,115401
IMR90|chr19:47467477-47467554,chr19,47467477,47467554,IMR90|chr19:47352076-47352144,chr19,47352076,47352144,1,115401
IMR90|chr19:47657627-47657690,chr19,47657627,47657690,IMR90|chr19:47352899-47352961,chr19,47352899,47352961,1,304728
IMR90|chr19:48222023-48222102,chr19,48222023,48222102,IMR90|chr19:54984148-54984179,chr19,54984148,54984179,1,6762125
IMR90|chr19:48222131-48222220,chr19,48222131,48222220,IMR90|chr19:54983206-54983268,chr19,54983206,54983268,1,6761075
IMR90|chr19:48223926-48223989,chr19,48223926,48223989,IMR90|chr19:50141077-50141135,chr19,50141077,50141135,1,1917151
IMR90|chr19:48223926-48223988,chr19,48223926,48223988,IMR90|chr19:50141077-50141135,chr19,50141077,50141135,1,1917151
IMR90|chr19:48226080-48226187,chr19,48226080,48226187,IMR90|chr19:678647-678677,chr19,678647,678677,1,47547433
IMR90|chr19:48227111-48227168,chr19,48227111,48227168,IMR90|chr19:574505-574567,chr19,574505,574567,1,47652606
IMR90|chr19:48227199-48227277,chr19,48227199,48227277,IMR90|chr19:48248168-48248208,chr19,48248168,48248208,1,20969
IMR90|chr19:48227201-48227277,chr19,48227201,48227277,IMR90|chr19:48248168-48248208,chr19,48248168,48248208,1,20967
IMR90|chr19:48228578-48228676,chr19,48228578,48228676,IMR90|chr19:678641-678674,chr19,678641,678674,1,47549937
IMR90|chr19:48228594-48228676,chr19,48228594,48228676,IMR90|chr19:678646-678677,chr19,678646,678677,1,47549948
IMR90|chr19:48228604-48228676,chr19,48228604,48228676,IMR90|chr19:678642-678674,chr19,678642,678674,1,47549962
IMR90|chr19:48234749-48234840,chr19,48234749,48234840,IMR90|chr19:48248136-48248184,chr19,48248136,48248184,1,13387
IMR90|chr19:48234750-48234861,chr19,48234750,48234861,IMR90|chr19:48248136-48248184,chr19,48248136,48248184,1,13386
IMR90|chr19:48234948-48234978,chr19,48234948,48234978,IMR90|chr19:48250409-48250478,chr19,48250409,48250478,1,15461
IMR90|chr19:48234950-48234978,chr19,48234950,48234978,IMR90|chr19:48250409-48250478,chr19,48250409,48250478,1,15459
IMR90|chr19:48239065-48239172,chr19,48239065,48239172,IMR90|chr19:48247468-48247583,chr19,48247468,48247583,1,8403
IMR90|chr19:49482495-49482539,chr19,49482495,49482539,IMR90|chr19:1400060-1400132,chr19,1400060,1400132,1,48082435
IMR90|chr19:49482495-49482535,chr19,49482495,49482535,IMR90|chr19:1400060-1400132,chr19,1400060,1400132,1,48082435
IMR90|chr19:52203238-52203350,chr19,52203238,52203350,IMR90|chr19:1018759-1018779,chr19,1018759,1018779,1,51184479
IMR90|chr19:53151045-53151104,chr19,53151045,53151104,IMR90|chr19:53395885-53395964,chr19,53395885,53395964,1,244840
IMR90|chr19:53151059-53151104,chr19,53151059,53151104,IMR90|chr19:53395885-53395964,chr19,53395885,53395964,1,244826
IMR90|chr19:53151227-53151270,chr19,53151227,53151270,IMR90|chr19:53396065-53396147,chr19,53396065,53396147,1,244838
IMR90|chr19:53687124-53687179,chr19,53687124,53687179,IMR90|chr19:54705488-54705528,chr19,54705488,54705528,1,1018364
IMR90|chr19:53687124-53687178,chr19,53687124,53687178,IMR90|chr19:54705488-54705528,chr19,54705488,54705528,1,1018364
IMR90|chr19:53936047-53936127,chr19,53936047,53936127,IMR90|chr19:53899391-53899505,chr19,53899391,53899505,1,36656
IMR90|chr19:53936082-53936108,chr19,53936082,53936108,IMR90|chr19:53192872-53193013,chr19,53192872,53193013,1,743210
IMR90|chr19:53936144-53936291,chr19,53936144,53936291,IMR90|chr19:53192541-53192691,chr19,53192541,53192691,1,743603
IMR90|chr19:53936177-53936242,chr19,53936177,53936242,IMR90|chr19:53899407-53899492,chr19,53899407,53899492,1,36770
IMR90|chr19:53936245-53936269,chr19,53936245,53936269,IMR90|chr19:53192669-53192711,chr19,53192669,53192711,1,743576
IMR90|chr19:56034171-56034205,chr19,56034171,56034205,IMR90|chr19:58325105-58325200,chr19,58325105,58325200,1,2290934
IMR90|chr20:1343769-1343819,chr20,1343769,1343819,IMR90|chr20:1100316-1100338,chr20,1100316,1100338,1,243453
IMR90|chr20:1345198-1345245,chr20,1345198,1345245,IMR90|chr20:1099764-1099849,chr20,1099764,1099849,1,245434
IMR90|chr20:1345201-1345245,chr20,1345201,1345245,IMR90|chr20:1099764-1099849,chr20,1099764,1099849,1,245437
IMR90|chr20:3880440-3880522,chr20,3880440,3880522,IMR90|chr20:3797690-3797726,chr20,3797690,3797726,1,82750
IMR90|chr20:3881732-3881882,chr20,3881732,3881882,IMR90|chr20:3797343-3797394,chr20,3797343,3797394,1,84389
IMR90|chr20:3881874-3881973,chr20,3881874,3881973,IMR90|chr20:3797343-3797394,chr20,3797343,3797394,1,84531
IMR90|chr20:9070619-9070756,chr20,9070619,9070756,IMR90|chr20:521801-521839,chr20,521801,521839,1,8548818
IMR90|chr20:9070644-9070756,chr20,9070644,9070756,IMR90|chr20:521801-521839,chr20,521801,521839,1,8548843
IMR90|chr20:9094573-9094690,chr20,9094573,9094690,IMR90|chr20:17946191-17946235,chr20,17946191,17946235,1,8851618
IMR90|chr20:9094573-9094679,chr20,9094573,9094679,IMR90|chr20:17946191-17946235,chr20,17946191,17946235,1,8851618
IMR90|chr20:9133429-9133516,chr20,9133429,9133516,IMR90|chr20:2630837-2630878,chr20,2630837,2630878,1,6502592
IMR90|chr20:9158770-9158878,chr20,9158770,9158878,IMR90|chr20:57557386-57557428,chr20,57557386,57557428,1,48398616
IMR90|chr20:9158770-9158800,chr20,9158770,9158800,IMR90|chr20:57557386-57557428,chr20,57557386,57557428,1,48398616
IMR90|chr20:9158774-9158897,chr20,9158774,9158897,IMR90|chr20:57557386-57557428,chr20,57557386,57557428,1,48398612
IMR90|chr20:17563539-17563565,chr20,17563539,17563565,IMR90|chr20:17947594-17947618,chr20,17947594,17947618,1,384055
IMR90|chr20:17569609-17569678,chr20,17569609,17569678,IMR90|chr20:17945097-17945155,chr20,17945097,17945155,1,375488
IMR90|chr20:17569611-17569678,chr20,17569611,17569678,IMR90|chr20:17945097-17945155,chr20,17945097,17945155,1,375486
IMR90|chr20:19744940-19745038,chr20,19744940,19745038,IMR90|chr20:19869834-19869857,chr20,19869834,19869857,1,124894
IMR90|chr20:19744942-19745038,chr20,19744942,19745038,IMR90|chr20:19869834-19869857,chr20,19869834,19869857,1,124892
IMR90|chr20:19746172-19746248,chr20,19746172,19746248,IMR90|chr20:19868471-19868519,chr20,19868471,19868519,1,122299
IMR90|chr20:19747422-19747512,chr20,19747422,19747512,IMR90|chr20:19864002-19864133,chr20,19864002,19864133,1,116580
IMR90|chr20:19747568-19747626,chr20,19747568,19747626,IMR90|chr20:19869391-19869440,chr20,19869391,19869440,1,121823
IMR90|chr20:19761688-19761778,chr20,19761688,19761778,IMR90|chr20:19866823-19866863,chr20,19866823,19866863,1,105135
IMR90|chr20:19761688-19761757,chr20,19761688,19761757,IMR90|chr20:19866823-19866863,chr20,19866823,19866863,1,105135
IMR90|chr20:19789401-19789543,chr20,19789401,19789543,IMR90|chr20:19868003-19868069,chr20,19868003,19868069,1,78602
IMR90|chr20:19789453-19789537,chr20,19789453,19789537,IMR90|chr20:19868003-19868069,chr20,19868003,19868069,1,78550
IMR90|chr20:19805136-19805197,chr20,19805136,19805197,IMR90|chr20:19869334-19869415,chr20,19869334,19869415,1,64198
IMR90|chr20:19805165-19805197,chr20,19805165,19805197,IMR90|chr20:19869334-19869415,chr20,19869334,19869415,1,64169
IMR90|chr20:19807208-19807247,chr20,19807208,19807247,IMR90|chr20:19868728-19868769,chr20,19868728,19868769,1,61520
IMR90|chr20:19853137-19853236,chr20,19853137,19853236,IMR90|chr20:19870064-19870144,chr20,19870064,19870144,1,16927
IMR90|chr20:19853137-19853205,chr20,19853137,19853205,IMR90|chr20:19870064-19870143,chr20,19870064,19870143,1,16927
IMR90|chr20:19853138-19853197,chr20,19853138,19853197,IMR90|chr20:19870064-19870144,chr20,19870064,19870144,1,16926
IMR90|chr20:19853183-19853241,chr20,19853183,19853241,IMR90|chr20:19865867-19865949,chr20,19865867,19865949,1,12684
IMR90|chr20:19853334-19853353,chr20,19853334,19853353,IMR90|chr20:19866966-19867012,chr20,19866966,19867012,1,13632
IMR90|chr20:19853379-19853443,chr20,19853379,19853443,IMR90|chr20:19866918-19866984,chr20,19866918,19866984,1,13539
IMR90|chr20:19853380-19853443,chr20,19853380,19853443,IMR90|chr20:19866918-19866984,chr20,19866918,19866984,1,13538
IMR90|chr20:19853780-19853903,chr20,19853780,19853903,IMR90|chr20:19866216-19866318,chr20,19866216,19866318,1,12436
IMR90|chr20:19853818-19853942,chr20,19853818,19853942,IMR90|chr20:19866153-19866206,chr20,19866153,19866206,1,12335
IMR90|chr20:19854035-19854079,chr20,19854035,19854079,IMR90|chr20:19864796-19864869,chr20,19864796,19864869,1,10761
IMR90|chr20:19856303-19856369,chr20,19856303,19856369,IMR90|chr20:19869055-19869104,chr20,19869055,19869104,1,12752
IMR90|chr20:19856570-19856623,chr20,19856570,19856623,IMR90|chr20:19869758-19869800,chr20,19869758,19869800,1,13188
IMR90|chr20:19856574-19856623,chr20,19856574,19856623,IMR90|chr20:19869758-19869800,chr20,19869758,19869800,1,13184
IMR90|chr20:19856668-19856697,chr20,19856668,19856697,IMR90|chr20:19868294-19868370,chr20,19868294,19868370,1,11626
IMR90|chr20:19857513-19857545,chr20,19857513,19857545,IMR90|chr20:19867770-19867825,chr20,19867770,19867825,1,10257
IMR90|chr20:19858359-19858465,chr20,19858359,19858465,IMR90|chr20:19864190-19864296,chr20,19864190,19864296,1,5831
IMR90|chr20:19858557-19858612,chr20,19858557,19858612,IMR90|chr20:19865697-19865747,chr20,19865697,19865747,1,7140
IMR90|chr20:19860305-19860329,chr20,19860305,19860329,IMR90|chr20:19866801-19866927,chr20,19866801,19866927,1,6496
IMR90|chr20:19860530-19860571,chr20,19860530,19860571,IMR90|chr20:19864048-19864137,chr20,19864048,19864137,1,3518
IMR90|chr20:19860584-19860682,chr20,19860584,19860682,IMR90|chr20:19867892-19867982,chr20,19867892,19867982,1,7308
IMR90|chr20:19860622-19860682,chr20,19860622,19860682,IMR90|chr20:19867892-19867982,chr20,19867892,19867982,1,7270
IMR90|chr20:19861048-19861182,chr20,19861048,19861182,IMR90|chr20:19866268-19866319,chr20,19866268,19866319,1,5220
IMR90|chr20:19861048-19861138,chr20,19861048,19861138,IMR90|chr20:19866268-19866319,chr20,19866268,19866319,1,5220
IMR90|chr20:19861282-19861320,chr20,19861282,19861320,IMR90|chr20:19866024-19866140,chr20,19866024,19866140,1,4742
IMR90|chr20:19861286-19861320,chr20,19861286,19861320,IMR90|chr20:19866024-19866140,chr20,19866024,19866140,1,4738
IMR90|chr20:19861978-19861996,chr20,19861978,19861996,IMR90|chr20:19868894-19869010,chr20,19868894,19869010,1,6916
IMR90|chr20:19861979-19861996,chr20,19861979,19861996,IMR90|chr20:19868894-19869010,chr20,19868894,19869010,1,6915
IMR90|chr20:19917690-19917759,chr20,19917690,19917759,IMR90|chr20:19862232-19862287,chr20,19862232,19862287,1,55458
IMR90|chr20:19917690-19917758,chr20,19917690,19917758,IMR90|chr20:19862232-19862287,chr20,19862232,19862287,1,55458
IMR90|chr20:19917691-19917758,chr20,19917691,19917758,IMR90|chr20:19862232-19862287,chr20,19862232,19862287,1,55459
IMR90|chr20:19923720-19923808,chr20,19923720,19923808,IMR90|chr20:45985071-45985135,chr20,45985071,45985135,1,26061351
IMR90|chr20:19923723-19923809,chr20,19923723,19923809,IMR90|chr20:45985071-45985135,chr20,45985071,45985135,1,26061348
IMR90|chr20:19923725-19923808,chr20,19923725,19923808,IMR90|chr20:45985071-45985135,chr20,45985071,45985135,1,26061346
IMR90|chr20:19978936-19978965,chr20,19978936,19978965,IMR90|chr20:19863695-19863845,chr20,19863695,19863845,1,115241
IMR90|chr20:20009983-20010056,chr20,20009983,20010056,IMR90|chr20:19867903-19867980,chr20,19867903,19867980,1,142080
IMR90|chr20:25345060-25345108,chr20,25345060,25345108,IMR90|chr20:4156270-4156357,chr20,4156270,4156357,1,21188790
IMR90|chr20:25354363-25354473,chr20,25354363,25354473,IMR90|chr20:30944741-30944788,chr20,30944741,30944788,1,5590378
IMR90|chr20:25354363-25354420,chr20,25354363,25354420,IMR90|chr20:30944741-30944788,chr20,30944741,30944788,1,5590378
IMR90|chr20:25354370-25354473,chr20,25354370,25354473,IMR90|chr20:30944741-30944788,chr20,30944741,30944788,1,5590371
IMR90|chr20:30131869-30131953,chr20,30131869,30131953,IMR90|chr20:19868104-19868131,chr20,19868104,19868131,1,10263765
IMR90|chr20:30136689-30136824,chr20,30136689,30136824,IMR90|chr20:30308520-30308546,chr20,30308520,30308546,1,171831
IMR90|chr20:30136689-30136800,chr20,30136689,30136800,IMR90|chr20:30308520-30308546,chr20,30308520,30308546,1,171831
IMR90|chr20:30138927-30139024,chr20,30138927,30139024,IMR90|chr20:30308021-30308064,chr20,30308021,30308064,1,169094
IMR90|chr20:30139076-30139186,chr20,30139076,30139186,IMR90|chr20:30194331-30194385,chr20,30194331,30194385,1,55255
IMR90|chr20:30144636-30144786,chr20,30144636,30144786,IMR90|chr20:30191300-30191358,chr20,30191300,30191358,1,46664
IMR90|chr20:30250822-30250869,chr20,30250822,30250869,IMR90|chr20:30308080-30308148,chr20,30308080,30308148,1,57258
IMR90|chr20:30251325-30251365,chr20,30251325,30251365,IMR90|chr20:30308335-30308413,chr20,30308335,30308413,1,57010
IMR90|chr20:30280871-30280986,chr20,30280871,30280986,IMR90|chr20:30542104-30542129,chr20,30542104,30542129,1,261233
IMR90|chr20:30281850-30281876,chr20,30281850,30281876,IMR90|chr20:34330646-34330701,chr20,34330646,34330701,1,4048796
IMR90|chr20:30281850-30281874,chr20,30281850,30281874,IMR90|chr20:34330646-34330709,chr20,34330646,34330709,1,4048796
IMR90|chr20:30286497-30286639,chr20,30286497,30286639,IMR90|chr20:30540346-30540382,chr20,30540346,30540382,1,253849
IMR90|chr20:30286528-30286639,chr20,30286528,30286639,IMR90|chr20:30540346-30540382,chr20,30540346,30540382,1,253818
IMR90|chr20:30294702-30294733,chr20,30294702,30294733,IMR90|chr20:30325890-30325963,chr20,30325890,30325963,1,31188
IMR90|chr20:30302293-30302372,chr20,30302293,30302372,IMR90|chr20:30322631-30322664,chr20,30322631,30322664,1,20338
IMR90|chr20:30302423-30302536,chr20,30302423,30302536,IMR90|chr20:30322631-30322664,chr20,30322631,30322664,1,20208
IMR90|chr20:30925192-30925262,chr20,30925192,30925262,IMR90|chr20:30941129-30941188,chr20,30941129,30941188,1,15937
IMR90|chr20:30926668-30926813,chr20,30926668,30926813,IMR90|chr20:30942071-30942155,chr20,30942071,30942155,1,15403
IMR90|chr20:30926683-30926749,chr20,30926683,30926749,IMR90|chr20:30942071-30942155,chr20,30942071,30942155,1,15388
IMR90|chr20:33059657-33059724,chr20,33059657,33059724,IMR90|chr20:43975369-43975434,chr20,43975369,43975434,1,10915712
IMR90|chr20:33059658-33059724,chr20,33059658,33059724,IMR90|chr20:43975368-43975434,chr20,43975368,43975434,1,10915710
IMR90|chr20:33059658-33059678,chr20,33059658,33059678,IMR90|chr20:43975368-43975434,chr20,43975368,43975434,1,10915710
IMR90|chr20:33111158-33111256,chr20,33111158,33111256,IMR90|chr20:33101279-33101301,chr20,33101279,33101301,1,9879
IMR90|chr20:33113402-33113437,chr20,33113402,33113437,IMR90|chr20:33103570-33103656,chr20,33103570,33103656,1,9832
IMR90|chr20:33347954-33347997,chr20,33347954,33347997,IMR90|chr20:33103734-33103837,chr20,33103734,33103837,1,244220
IMR90|chr20:33717500-33717570,chr20,33717500,33717570,IMR90|chr20:5590869-5590921,chr20,5590869,5590921,1,28126631
IMR90|chr20:33717501-33717570,chr20,33717501,33717570,IMR90|chr20:5590869-5590921,chr20,5590869,5590921,1,28126632
IMR90|chr20:33901106-33901177,chr20,33901106,33901177,IMR90|chr20:34200061-34200112,chr20,34200061,34200112,1,298955
IMR90|chr20:33901900-33901950,chr20,33901900,33901950,IMR90|chr20:34204737-34204789,chr20,34204737,34204789,1,302837
IMR90|chr20:33912236-33912306,chr20,33912236,33912306,IMR90|chr20:34126851-34126913,chr20,34126851,34126913,1,214615
IMR90|chr20:33912239-33912306,chr20,33912239,33912306,IMR90|chr20:34126851-34126913,chr20,34126851,34126913,1,214612
IMR90|chr20:33912665-33912768,chr20,33912665,33912768,IMR90|chr20:34198210-34198234,chr20,34198210,34198234,1,285545
IMR90|chr20:33930756-33930781,chr20,33930756,33930781,IMR90|chr20:34198083-34198192,chr20,34198083,34198192,1,267327
IMR90|chr20:34446622-34446653,chr20,34446622,34446653,IMR90|chr20:34821581-34821698,chr20,34821581,34821698,1,374959
IMR90|chr20:34464855-34464903,chr20,34464855,34464903,IMR90|chr20:34821596-34821652,chr20,34821596,34821652,1,356741
IMR90|chr20:35102682-35102743,chr20,35102682,35102743,IMR90|chr20:35489749-35489770,chr20,35489749,35489770,1,387067
IMR90|chr20:35113904-35113968,chr20,35113904,35113968,IMR90|chr20:35490539-35490585,chr20,35490539,35490585,1,376635
IMR90|chr20:35458003-35458143,chr20,35458003,35458143,IMR90|chr20:49546486-49546517,chr20,49546486,49546517,1,14088483
IMR90|chr20:35458004-35458123,chr20,35458004,35458123,IMR90|chr20:49546486-49546517,chr20,49546486,49546517,1,14088482
IMR90|chr20:35458017-35458143,chr20,35458017,35458143,IMR90|chr20:49546486-49546517,chr20,49546486,49546517,1,14088469
IMR90|chr20:35468788-35468908,chr20,35468788,35468908,IMR90|chr20:30947849-30947877,chr20,30947849,30947877,1,4520939
IMR90|chr20:35468789-35468905,chr20,35468789,35468905,IMR90|chr20:30947849-30947877,chr20,30947849,30947877,1,4520940
IMR90|chr20:35468795-35468908,chr20,35468795,35468908,IMR90|chr20:30947849-30947877,chr20,30947849,30947877,1,4520946
IMR90|chr20:39625953-39626018,chr20,39625953,39626018,IMR90|chr20:39659031-39659085,chr20,39659031,39659085,1,33078
IMR90|chr20:39625957-39626018,chr20,39625957,39626018,IMR90|chr20:39659031-39659085,chr20,39659031,39659085,1,33074
IMR90|chr20:39630799-39630949,chr20,39630799,39630949,IMR90|chr20:39658317-39658428,chr20,39658317,39658428,1,27518
IMR90|chr20:39631613-39631690,chr20,39631613,39631690,IMR90|chr20:49546395-49546440,chr20,49546395,49546440,1,9914782
IMR90|chr20:39667647-39667770,chr20,39667647,39667770,IMR90|chr20:47896161-47896208,chr20,47896161,47896208,1,8228514
IMR90|chr20:39667714-39667771,chr20,39667714,39667771,IMR90|chr20:47896159-47896208,chr20,47896159,47896208,1,8228445
IMR90|chr20:39716993-39717114,chr20,39716993,39717114,IMR90|chr20:57225674-57225771,chr20,57225674,57225771,1,17508681
IMR90|chr20:39716993-39717045,chr20,39716993,39717045,IMR90|chr20:57225673-57225771,chr20,57225673,57225771,1,17508680
IMR90|chr20:42557319-42557432,chr20,42557319,42557432,IMR90|chr20:17946540-17946578,chr20,17946540,17946578,1,24610779
IMR90|chr20:42557323-42557432,chr20,42557323,42557432,IMR90|chr20:17946540-17946578,chr20,17946540,17946578,1,24610783
IMR90|chr20:42558582-42558715,chr20,42558582,42558715,IMR90|chr20:44559640-44559784,chr20,44559640,44559784,1,2001058
IMR90|chr20:42565582-42565704,chr20,42565582,42565704,IMR90|chr20:17947525-17947545,chr20,17947525,17947545,1,24618057
IMR90|chr20:42565582-42565703,chr20,42565582,42565703,IMR90|chr20:17947525-17947545,chr20,17947525,17947545,1,24618057
IMR90|chr20:42581663-42581689,chr20,42581663,42581689,IMR90|chr20:3827195-3827277,chr20,3827195,3827277,1,38754468
IMR90|chr20:42582864-42582901,chr20,42582864,42582901,IMR90|chr20:31991790-31991811,chr20,31991790,31991811,1,10591074
IMR90|chr20:42588807-42588891,chr20,42588807,42588891,IMR90|chr20:42939094-42939160,chr20,42939094,42939160,1,350287
IMR90|chr20:42588808-42588897,chr20,42588808,42588897,IMR90|chr20:42939094-42939160,chr20,42939094,42939160,1,350286
IMR90|chr20:42588824-42588897,chr20,42588824,42588897,IMR90|chr20:42939094-42939160,chr20,42939094,42939160,1,350270
IMR90|chr20:42600942-42601040,chr20,42600942,42601040,IMR90|chr20:56964899-56964948,chr20,56964899,56964948,1,14363957
IMR90|chr20:42606142-42606180,chr20,42606142,42606180,IMR90|chr20:44561903-44561996,chr20,44561903,44561996,1,1955761
IMR90|chr20:43677161-43677268,chr20,43677161,43677268,IMR90|chr20:47896088-47896157,chr20,47896088,47896157,1,4218927
IMR90|chr20:43677161-43677242,chr20,43677161,43677242,IMR90|chr20:47896088-47896157,chr20,47896088,47896157,1,4218927
IMR90|chr20:43677161-43677241,chr20,43677161,43677241,IMR90|chr20:47896088-47896157,chr20,47896088,47896157,1,4218927
IMR90|chr20:45870165-45870204,chr20,45870165,45870204,IMR90|chr20:45337964-45338036,chr20,45337964,45338036,1,532201
IMR90|chr20:45870165-45870203,chr20,45870165,45870203,IMR90|chr20:45337964-45338036,chr20,45337964,45338036,1,532201
IMR90|chr20:45873686-45873757,chr20,45873686,45873757,IMR90|chr20:45333851-45333905,chr20,45333851,45333905,1,539835
IMR90|chr20:45959839-45959892,chr20,45959839,45959892,IMR90|chr20:30307639-30307718,chr20,30307639,30307718,1,15652200
IMR90|chr20:47580608-47580688,chr20,47580608,47580688,IMR90|chr20:62583289-62583323,chr20,62583289,62583323,1,15002681
IMR90|chr20:48762735-48762777,chr20,48762735,48762777,IMR90|chr20:49127515-49127602,chr20,49127515,49127602,1,364780
IMR90|chr20:48762736-48762777,chr20,48762736,48762777,IMR90|chr20:49127515-49127602,chr20,49127515,49127602,1,364779
IMR90|chr20:50059507-50059530,chr20,50059507,50059530,IMR90|chr20:35170104-35170231,chr20,35170104,35170231,1,14889403
IMR90|chr20:50059508-50059620,chr20,50059508,50059620,IMR90|chr20:35170104-35170231,chr20,35170104,35170231,1,14889404
IMR90|chr20:56990532-56990586,chr20,56990532,56990586,IMR90|chr20:30308131-30308281,chr20,30308131,30308281,1,26682401
IMR90|chr20:61524803-61524892,chr20,61524803,61524892,IMR90|chr20:36154341-36154441,chr20,36154341,36154441,1,25370462
IMR90|chr20:61524803-61524850,chr20,61524803,61524850,IMR90|chr20:36154341-36154441,chr20,36154341,36154441,1,25370462
IMR90|chr21:27506220-27506316,chr21,27506220,27506316,IMR90|chr21:47647361-47647415,chr21,47647361,47647415,1,20141141
IMR90|chr21:27506232-27506382,chr21,27506232,27506382,IMR90|chr21:47647361-47647415,chr21,47647361,47647415,1,20141129
IMR90|chr21:27506233-27506382,chr21,27506233,27506382,IMR90|chr21:47647361-47647415,chr21,47647361,47647415,1,20141128
IMR90|chr21:30109776-30109828,chr21,30109776,30109828,IMR90|chr21:30676434-30676507,chr21,30676434,30676507,1,566658
IMR90|chr21:30109779-30109828,chr21,30109779,30109828,IMR90|chr21:30676434-30676507,chr21,30676434,30676507,1,566655
IMR90|chr21:30109779-30109822,chr21,30109779,30109822,IMR90|chr21:30676431-30676507,chr21,30676431,30676507,1,566652
IMR90|chr21:34752531-34752569,chr21,34752531,34752569,IMR90|chr21:34866529-34866630,chr21,34866529,34866630,1,113998
IMR90|chr21:36287008-36287027,chr21,36287008,36287027,IMR90|chr21:45208696-45208794,chr21,45208696,45208794,1,8921688
IMR90|chr21:47395159-47395286,chr21,47395159,47395286,IMR90|chr21:47397051-47397201,chr21,47397051,47397201,1,1892
IMR90|chr21:47395232-47395286,chr21,47395232,47395286,IMR90|chr21:47397043-47397167,chr21,47397043,47397167,1,1811
IMR90|chr21:47395240-47395269,chr21,47395240,47395269,IMR90|chr21:47397043-47397141,chr21,47397043,47397141,1,1803
IMR90|chr21:47395260-47395286,chr21,47395260,47395286,IMR90|chr21:47397043-47397167,chr21,47397043,47397167,1,1783
IMR90|chr21:47395265-47395286,chr21,47395265,47395286,IMR90|chr21:47397043-47397167,chr21,47397043,47397167,1,1778
IMR90|chr21:47395266-47395286,chr21,47395266,47395286,IMR90|chr21:47397043-47397173,chr21,47397043,47397173,1,1777
IMR90|chr21:47395270-47395286,chr21,47395270,47395286,IMR90|chr21:47397043-47397141,chr21,47397043,47397141,1,1773
IMR90|chr22:17089842-17089914,chr22,17089842,17089914,IMR90|chr22:38793166-38793274,chr22,38793166,38793274,1,21703324
IMR90|chr22:17089842-17089913,chr22,17089842,17089913,IMR90|chr22:38793168-38793273,chr22,38793168,38793273,1,21703326
IMR90|chr22:18447163-18447216,chr22,18447163,18447216,IMR90|chr22:46475292-46475331,chr22,46475292,46475331,1,28028129
IMR90|chr22:18447164-18447186,chr22,18447164,18447186,IMR90|chr22:46475291-46475331,chr22,46475291,46475331,1,28028127
IMR90|chr22:18447247-18447335,chr22,18447247,18447335,IMR90|chr22:46475291-46475331,chr22,46475291,46475331,1,28028044
IMR90|chr22:18447280-18447335,chr22,18447280,18447335,IMR90|chr22:46475291-46475331,chr22,46475291,46475331,1,28028011
IMR90|chr22:19446188-19446271,chr22,19446188,19446271,IMR90|chr22:20849300-20849350,chr22,20849300,20849350,1,1403112
IMR90|chr22:19446189-19446271,chr22,19446189,19446271,IMR90|chr22:20849300-20849350,chr22,20849300,20849350,1,1403111
IMR90|chr22:19446190-19446271,chr22,19446190,19446271,IMR90|chr22:20849300-20849350,chr22,20849300,20849350,1,1403110
IMR90|chr22:22151231-22151275,chr22,22151231,22151275,IMR90|chr22:21922597-21922747,chr22,21922597,21922747,1,228634
IMR90|chr22:24799863-24799908,chr22,24799863,24799908,IMR90|chr22:23491189-23491244,chr22,23491189,23491244,1,1308674
IMR90|chr22:28603893-28603921,chr22,28603893,28603921,IMR90|chr22:30640124-30640209,chr22,30640124,30640209,1,2036231
IMR90|chr22:28603896-28603921,chr22,28603896,28603921,IMR90|chr22:30640124-30640209,chr22,30640124,30640209,1,2036228
IMR90|chr22:30011468-30011506,chr22,30011468,30011506,IMR90|chr22:20069956-20070054,chr22,20069956,20070054,1,9941512
IMR90|chr22:30011468-30011505,chr22,30011468,30011505,IMR90|chr22:20069956-20070054,chr22,20069956,20070054,1,9941512
IMR90|chr22:36280235-36280344,chr22,36280235,36280344,IMR90|chr22:22222642-22222699,chr22,22222642,22222699,1,14057593
IMR90|chr22:36280254-36280344,chr22,36280254,36280344,IMR90|chr22:22222642-22222699,chr22,22222642,22222699,1,14057612
IMR90|chr22:36727127-36727226,chr22,36727127,36727226,IMR90|chr22:36906478-36906522,chr22,36906478,36906522,1,179351
IMR90|chr22:36727941-36728091,chr22,36727941,36728091,IMR90|chr22:30987244-30987295,chr22,30987244,30987295,1,5740697
IMR90|chr22:36727998-36728097,chr22,36727998,36728097,IMR90|chr22:30987244-30987295,chr22,30987244,30987295,1,5740754
IMR90|chr22:36730723-36730784,chr22,36730723,36730784,IMR90|chr22:24200121-24200167,chr22,24200121,24200167,1,12530602
IMR90|chr22:36730723-36730783,chr22,36730723,36730783,IMR90|chr22:24200121-24200167,chr22,24200121,24200167,1,12530602
IMR90|chr22:36736626-36736711,chr22,36736626,36736711,IMR90|chr22:36905601-36905635,chr22,36905601,36905635,1,168975
IMR90|chr22:36736738-36736799,chr22,36736738,36736799,IMR90|chr22:37417579-37417667,chr22,37417579,37417667,1,680841
IMR90|chr22:36736739-36736799,chr22,36736739,36736799,IMR90|chr22:37417579-37417667,chr22,37417579,37417667,1,680840
IMR90|chr22:36744382-36744445,chr22,36744382,36744445,IMR90|chr22:37418111-37418176,chr22,37418111,37418176,1,673729
IMR90|chr22:36766408-36766470,chr22,36766408,36766470,IMR90|chr22:39053448-39053514,chr22,39053448,39053514,1,2287040
IMR90|chr22:36769333-36769389,chr22,36769333,36769389,IMR90|chr22:41031853-41031942,chr22,41031853,41031942,1,4262520
IMR90|chr22:36769333-36769386,chr22,36769333,36769386,IMR90|chr22:41031853-41031942,chr22,41031853,41031942,1,4262520
IMR90|chr22:36772097-36772188,chr22,36772097,36772188,IMR90|chr22:38007898-38007999,chr22,38007898,38007999,1,1235801
IMR90|chr22:36774228-36774308,chr22,36774228,36774308,IMR90|chr22:38005876-38005933,chr22,38005876,38005933,1,1231648
IMR90|chr22:37946511-37946565,chr22,37946511,37946565,IMR90|chr22:38146176-38146231,chr22,38146176,38146231,1,199665
IMR90|chr22:38029626-38029683,chr22,38029626,38029683,IMR90|chr22:38032235-38032323,chr22,38032235,38032323,1,2609
IMR90|chr22:38029626-38029673,chr22,38029626,38029673,IMR90|chr22:38032235-38032323,chr22,38032235,38032323,1,2609
IMR90|chr22:38030210-38030241,chr22,38030210,38030241,IMR90|chr22:38032734-38032848,chr22,38032734,38032848,1,2524
IMR90|chr22:38030212-38030241,chr22,38030212,38030241,IMR90|chr22:38032734-38032848,chr22,38032734,38032848,1,2522
IMR90|chr22:38030225-38030252,chr22,38030225,38030252,IMR90|chr22:38034321-38034393,chr22,38034321,38034393,1,4096
IMR90|chr22:38030226-38030252,chr22,38030226,38030252,IMR90|chr22:38034321-38034393,chr22,38034321,38034393,1,4095
IMR90|chr22:38175849-38175915,chr22,38175849,38175915,IMR90|chr22:38145462-38145502,chr22,38145462,38145502,1,30387
IMR90|chr22:38176853-38176992,chr22,38176853,38176992,IMR90|chr22:38144780-38144806,chr22,38144780,38144806,1,32073
IMR90|chr22:38176853-38176977,chr22,38176853,38176977,IMR90|chr22:38144780-38144806,chr22,38144780,38144806,1,32073
IMR90|chr22:38177337-38177409,chr22,38177337,38177409,IMR90|chr22:38145666-38145720,chr22,38145666,38145720,1,31671
IMR90|chr22:38659182-38659303,chr22,38659182,38659303,IMR90|chr22:20848571-20848635,chr22,20848571,20848635,1,17810611
IMR90|chr22:38659182-38659302,chr22,38659182,38659302,IMR90|chr22:20848571-20848635,chr22,20848571,20848635,1,17810611
IMR90|chr22:38659182-38659265,chr22,38659182,38659265,IMR90|chr22:20848571-20848635,chr22,20848571,20848635,1,17810611
IMR90|chr22:40833560-40833612,chr22,40833560,40833612,IMR90|chr22:41217493-41217549,chr22,41217493,41217549,1,383933
IMR90|chr22:40836304-40836347,chr22,40836304,40836347,IMR90|chr22:37823219-37823369,chr22,37823219,37823369,1,3013085
IMR90|chr22:40844795-40844851,chr22,40844795,40844851,IMR90|chr22:41213975-41214073,chr22,41213975,41214073,1,369180
IMR90|chr22:40844799-40844851,chr22,40844799,40844851,IMR90|chr22:41213975-41214073,chr22,41213975,41214073,1,369176
IMR90|chr22:40848483-40848633,chr22,40848483,40848633,IMR90|chr22:41217180-41217232,chr22,41217180,41217232,1,368697
IMR90|chr22:40848553-40848651,chr22,40848553,40848651,IMR90|chr22:41217180-41217232,chr22,41217180,41217232,1,368627
IMR90|chr22:40880982-40881029,chr22,40880982,40881029,IMR90|chr22:41214861-41214918,chr22,41214861,41214918,1,333879
IMR90|chr22:40887123-40887216,chr22,40887123,40887216,IMR90|chr22:41213118-41213145,chr22,41213118,41213145,1,325995
IMR90|chr22:40923898-40923968,chr22,40923898,40923968,IMR90|chr22:41212679-41212757,chr22,41212679,41212757,1,288781
IMR90|chr22:40923898-40923939,chr22,40923898,40923939,IMR90|chr22:41212679-41212757,chr22,41212679,41212757,1,288781
IMR90|chr22:41878333-41878448,chr22,41878333,41878448,IMR90|chr22:42089003-42089050,chr22,42089003,42089050,1,210670
IMR90|chr22:41878333-41878447,chr22,41878333,41878447,IMR90|chr22:42089003-42089050,chr22,42089003,42089050,1,210670
IMR90|chr22:41878335-41878419,chr22,41878335,41878419,IMR90|chr22:42089003-42089050,chr22,42089003,42089050,1,210668
IMR90|chr22:41878344-41878447,chr22,41878344,41878447,IMR90|chr22:42089003-42089050,chr22,42089003,42089050,1,210659
IMR90|chr22:43182286-43182365,chr22,43182286,43182365,IMR90|chr22:26875903-26875938,chr22,26875903,26875938,1,16306383
IMR90|chr22:43182286-43182364,chr22,43182286,43182364,IMR90|chr22:26875903-26875938,chr22,26875903,26875938,1,16306383
IMR90|chr22:43206034-43206171,chr22,43206034,43206171,IMR90|chr22:46478170-46478232,chr22,46478170,46478232,1,3272136
IMR90|chr22:43206100-43206185,chr22,43206100,43206185,IMR90|chr22:46478170-46478232,chr22,46478170,46478232,1,3272070
IMR90|chr22:43206100-43206180,chr22,43206100,43206180,IMR90|chr22:46478170-46478237,chr22,46478170,46478237,1,3272070
IMR90|chr22:43206586-43206659,chr22,43206586,43206659,IMR90|chr22:43010170-43010229,chr22,43010170,43010229,1,196416
IMR90|chr22:43214822-43214867,chr22,43214822,43214867,IMR90|chr22:43046605-43046680,chr22,43046605,43046680,1,168217
IMR90|chr22:43214832-43214904,chr22,43214832,43214904,IMR90|chr22:43046610-43046688,chr22,43046610,43046688,1,168222
IMR90|chr22:46140065-46140115,chr22,46140065,46140115,IMR90|chr22:46480607-46480660,chr22,46480607,46480660,1,340542
IMR90|chr22:46140066-46140115,chr22,46140066,46140115,IMR90|chr22:46480607-46480660,chr22,46480607,46480660,1,340541
IMR90|chr22:46149014-46149122,chr22,46149014,46149122,IMR90|chr22:39716783-39716839,chr22,39716783,39716839,1,6432231
IMR90|chr22:46149014-46149121,chr22,46149014,46149121,IMR90|chr22:39716783-39716839,chr22,39716783,39716839,1,6432231
IMR90|chr22:46149028-46149122,chr22,46149028,46149122,IMR90|chr22:39716783-39716839,chr22,39716783,39716839,1,6432245
IMR90|chr22:46167398-46167447,chr22,46167398,46167447,IMR90|chr22:46473495-46473514,chr22,46473495,46473514,1,306097
IMR90|chr22:46167763-46167803,chr22,46167763,46167803,IMR90|chr22:46473495-46473517,chr22,46473495,46473517,1,305732
IMR90|chr22:46179795-46179844,chr22,46179795,46179844,IMR90|chr22:46481245-46481268,chr22,46481245,46481268,1,301450
IMR90|chr22:47414779-47414804,chr22,47414779,47414804,IMR90|chr22:30279846-30279953,chr22,30279846,30279953,1,17134933
IMR90|chr22:47414784-47414804,chr22,47414784,47414804,IMR90|chr22:30279845-30279953,chr22,30279845,30279953,1,17134939
IMR90|chr1:119440-119519,chr1,119440,119519,IMR90|chr1:200381748-200381781,chr1,200381748,200381781,0,200262308
IMR90|chr1:223309-223330,chr1,223309,223330,IMR90|chr1:85932324-85932432,chr1,85932324,85932432,0,85709015
IMR90|chr1:368757-368803,chr1,368757,368803,IMR90|chr1:220443595-220443660,chr1,220443595,220443660,0,220074838
IMR90|chr1:540128-540242,chr1,540128,540242,IMR90|chr1:173442090-173442110,chr1,173442090,173442110,0,172901962
IMR90|chr1:813623-813732,chr1,813623,813732,IMR90|chr1:1255670-1255710,chr1,1255670,1255710,0,442047
IMR90|chr1:950134-950284,chr1,950134,950284,IMR90|chr1:148558250-148558286,chr1,148558250,148558286,0,147608116
IMR90|chr1:1075658-1075721,chr1,1075658,1075721,IMR90|chr1:27323379-27323427,chr1,27323379,27323427,0,26247721
IMR90|chr1:1229275-1229345,chr1,1229275,1229345,IMR90|chr1:27321204-27321224,chr1,27321204,27321224,0,26091929
IMR90|chr1:1384171-1384224,chr1,1384171,1384224,IMR90|chr1:114302851-114302946,chr1,114302851,114302946,0,112918680
IMR90|chr1:1474016-1474118,chr1,1474016,1474118,IMR90|chr1:173445770-173445819,chr1,173445770,173445819,0,171971754
IMR90|chr1:1868567-1868627,chr1,1868567,1868627,IMR90|chr1:173445770-173445808,chr1,173445770,173445808,0,171577203
IMR90|chr1:1907577-1907615,chr1,1907577,1907615,IMR90|chr1:27322133-27322242,chr1,27322133,27322242,0,25414556
IMR90|chr1:1921848-1921882,chr1,1921848,1921882,IMR90|chr1:247496642-247496700,chr1,247496642,247496700,0,245574794
IMR90|chr1:1962738-1962885,chr1,1962738,1962885,IMR90|chr1:148560205-148560352,chr1,148560205,148560352,0,146597467
IMR90|chr1:2186131-2186221,chr1,2186131,2186221,IMR90|chr1:148556223-148556368,chr1,148556223,148556368,0,146370092
IMR90|chr1:2417661-2417691,chr1,2417661,2417691,IMR90|chr1:95005629-95005741,chr1,95005629,95005741,0,92587968
IMR90|chr1:2506200-2506235,chr1,2506200,2506235,IMR90|chr1:93301093-93301208,chr1,93301093,93301208,0,90794893
IMR90|chr1:2593960-2594054,chr1,2593960,2594054,IMR90|chr1:173832265-173832320,chr1,173832265,173832320,0,171238305
IMR90|chr1:2955522-2955672,chr1,2955522,2955672,IMR90|chr1:148558783-148558805,chr1,148558783,148558805,0,145603261
IMR90|chr1:3251566-3251673,chr1,3251566,3251673,IMR90|chr1:148558187-148558335,chr1,148558187,148558335,0,145306621
IMR90|chr1:3255777-3255827,chr1,3255777,3255827,IMR90|chr1:1241898-1241976,chr1,1241898,1241976,0,2013879
IMR90|chr1:3397221-3397337,chr1,3397221,3397337,IMR90|chr1:78227455-78227475,chr1,78227455,78227475,0,74830234
IMR90|chr1:3445499-3445649,chr1,3445499,3445649,IMR90|chr1:205090786-205090834,chr1,205090786,205090834,0,201645287
IMR90|chr1:3690688-3690736,chr1,3690688,3690736,IMR90|chr1:27322133-27322232,chr1,27322133,27322232,0,23631445
IMR90|chr1:3741697-3741759,chr1,3741697,3741759,IMR90|chr1:29507193-29507231,chr1,29507193,29507231,0,25765496
IMR90|chr1:3850580-3850603,chr1,3850580,3850603,IMR90|chr1:182993599-182993657,chr1,182993599,182993657,0,179143019
IMR90|chr1:4378542-4378617,chr1,4378542,4378617,IMR90|chr1:156253166-156253241,chr1,156253166,156253241,0,151874624
IMR90|chr1:4430075-4430106,chr1,4430075,4430106,IMR90|chr1:148558145-148558286,chr1,148558145,148558286,0,144128070
IMR90|chr1:4457551-4457602,chr1,4457551,4457602,IMR90|chr1:27322133-27322232,chr1,27322133,27322232,0,22864582
IMR90|chr1:4558769-4558919,chr1,4558769,4558919,IMR90|chr1:148556791-148556810,chr1,148556791,148556810,0,143998022
IMR90|chr1:4699645-4699714,chr1,4699645,4699714,IMR90|chr1:162532853-162532902,chr1,162532853,162532902,0,157833208
IMR90|chr1:4727008-4727066,chr1,4727008,4727066,IMR90|chr1:9190714-9190814,chr1,9190714,9190814,0,4463706
IMR90|chr1:4755858-4755915,chr1,4755858,4755915,IMR90|chr1:10093899-10093935,chr1,10093899,10093935,0,5338041
IMR90|chr1:4764747-4764828,chr1,4764747,4764828,IMR90|chr1:43149374-43149461,chr1,43149374,43149461,0,38384627
IMR90|chr1:4766347-4766405,chr1,4766347,4766405,IMR90|chr1:27322431-27322483,chr1,27322431,27322483,0,22556084
IMR90|chr1:4886724-4886760,chr1,4886724,4886760,IMR90|chr1:171455337-171455427,chr1,171455337,171455427,0,166568613
IMR90|chr1:5011700-5011727,chr1,5011700,5011727,IMR90|chr1:40421092-40421197,chr1,40421092,40421197,0,35409392
IMR90|chr1:5582980-5583101,chr1,5582980,5583101,IMR90|chr1:28558788-28558899,chr1,28558788,28558899,0,22975808
IMR90|chr1:5776432-5776526,chr1,5776432,5776526,IMR90|chr1:64240364-64240433,chr1,64240364,64240433,0,58463932
IMR90|chr1:5786197-5786267,chr1,5786197,5786267,IMR90|chr1:27321204-27321224,chr1,27321204,27321224,0,21535007
IMR90|chr1:5965714-5965829,chr1,5965714,5965829,IMR90|chr1:148556199-148556302,chr1,148556199,148556302,0,142590485
IMR90|chr1:6455235-6455316,chr1,6455235,6455316,IMR90|chr1:162606170-162606204,chr1,162606170,162606204,0,156150935
IMR90|chr1:6586006-6586073,chr1,6586006,6586073,IMR90|chr1:27323236-27323307,chr1,27323236,27323307,0,20737230
IMR90|chr1:6664221-6664323,chr1,6664221,6664323,IMR90|chr1:180470505-180470553,chr1,180470505,180470553,0,173806284
IMR90|chr1:6744170-6744233,chr1,6744170,6744233,IMR90|chr1:715921-715958,chr1,715921,715958,0,6028249
IMR90|chr1:6884266-6884322,chr1,6884266,6884322,IMR90|chr1:1255194-1255236,chr1,1255194,1255236,0,5629072
IMR90|chr1:7051891-7052038,chr1,7051891,7052038,IMR90|chr1:148558193-148558343,chr1,148558193,148558343,0,141506302
IMR90|chr1:7060002-7060074,chr1,7060002,7060074,IMR90|chr1:173447038-173447112,chr1,173447038,173447112,0,166387036
IMR90|chr1:7243884-7243949,chr1,7243884,7243949,IMR90|chr1:46770222-46770302,chr1,46770222,46770302,0,39526338
IMR90|chr1:7253545-7253653,chr1,7253545,7253653,IMR90|chr1:57043981-57044010,chr1,57043981,57044010,0,49790436
IMR90|chr1:7340086-7340118,chr1,7340086,7340118,IMR90|chr1:220222335-220222402,chr1,220222335,220222402,0,212882249
IMR90|chr1:7375367-7375447,chr1,7375367,7375447,IMR90|chr1:110158254-110158313,chr1,110158254,110158313,0,102782887
IMR90|chr1:7653975-7654025,chr1,7653975,7654025,IMR90|chr1:148556798-148556898,chr1,148556798,148556898,0,140902823
IMR90|chr1:8043216-8043279,chr1,8043216,8043279,IMR90|chr1:148558168-148558212,chr1,148558168,148558212,0,140514952
IMR90|chr1:8231378-8231417,chr1,8231378,8231417,IMR90|chr1:95004029-95004071,chr1,95004029,95004071,0,86772651
IMR90|chr1:8259905-8259946,chr1,8259905,8259946,IMR90|chr1:113247346-113247398,chr1,113247346,113247398,0,104987441
IMR90|chr1:8354831-8354902,chr1,8354831,8354902,IMR90|chr1:9193785-9193860,chr1,9193785,9193860,0,838954
IMR90|chr1:8373661-8373763,chr1,8373661,8373763,IMR90|chr1:27322294-27322382,chr1,27322294,27322382,0,18948633
IMR90|chr1:8636025-8636166,chr1,8636025,8636166,IMR90|chr1:7832457-7832479,chr1,7832457,7832479,0,803568
IMR90|chr1:8637644-8637713,chr1,8637644,8637713,IMR90|chr1:148556134-148556180,chr1,148556134,148556180,0,139918490
IMR90|chr1:8765908-8766053,chr1,8765908,8766053,IMR90|chr1:148556476-148556626,chr1,148556476,148556626,0,139790568
IMR90|chr1:8848761-8848829,chr1,8848761,8848829,IMR90|chr1:38461304-38461342,chr1,38461304,38461342,0,29612543
IMR90|chr1:8999307-8999401,chr1,8999307,8999401,IMR90|chr1:173832265-173832320,chr1,173832265,173832320,0,164832958
IMR90|chr1:9350270-9350420,chr1,9350270,9350420,IMR90|chr1:173445770-173445790,chr1,173445770,173445790,0,164095500
IMR90|chr1:9360337-9360389,chr1,9360337,9360389,IMR90|chr1:114303265-114303363,chr1,114303265,114303363,0,104942928
IMR90|chr1:9360811-9360960,chr1,9360811,9360960,IMR90|chr1:148558220-148558286,chr1,148558220,148558286,0,139197409
IMR90|chr1:9435008-9435055,chr1,9435008,9435055,IMR90|chr1:24067634-24067735,chr1,24067634,24067735,0,14632626
IMR90|chr1:9454098-9454171,chr1,9454098,9454171,IMR90|chr1:27322888-27322995,chr1,27322888,27322995,0,17868790
IMR90|chr1:9891108-9891185,chr1,9891108,9891185,IMR90|chr1:8938147-8938208,chr1,8938147,8938208,0,952961
IMR90|chr1:10016905-10016945,chr1,10016905,10016945,IMR90|chr1:95003794-95003911,chr1,95003794,95003911,0,84986889
IMR90|chr1:10194643-10194761,chr1,10194643,10194761,IMR90|chr1:112302487-112302617,chr1,112302487,112302617,0,102107844
IMR90|chr1:10282905-10283005,chr1,10282905,10283005,IMR90|chr1:173829382-173829432,chr1,173829382,173829432,0,163546477
IMR90|chr1:10404554-10404584,chr1,10404554,10404584,IMR90|chr1:173830433-173830545,chr1,173830433,173830545,0,163425879
IMR90|chr1:10685786-10685905,chr1,10685786,10685905,IMR90|chr1:201434533-201434558,chr1,201434533,201434558,0,190748747
IMR90|chr1:11221072-11221192,chr1,11221072,11221192,IMR90|chr1:150546478-150546523,chr1,150546478,150546523,0,139325406
IMR90|chr1:11334230-11334378,chr1,11334230,11334378,IMR90|chr1:151963626-151963648,chr1,151963626,151963648,0,140629396
IMR90|chr1:11665063-11665098,chr1,11665063,11665098,IMR90|chr1:148556486-148556616,chr1,148556486,148556616,0,136891423
IMR90|chr1:11827944-11828094,chr1,11827944,11828094,IMR90|chr1:148559577-148559721,chr1,148559577,148559721,0,136731633
IMR90|chr1:11922364-11922413,chr1,11922364,11922413,IMR90|chr1:33812912-33812993,chr1,33812912,33812993,0,21890548
IMR90|chr1:11997645-11997717,chr1,11997645,11997717,IMR90|chr1:173447038-173447112,chr1,173447038,173447112,0,161449393
IMR90|chr1:12352312-12352348,chr1,12352312,12352348,IMR90|chr1:24972816-24972942,chr1,24972816,24972942,0,12620504
IMR90|chr1:12856240-12856346,chr1,12856240,12856346,IMR90|chr1:27322689-27322718,chr1,27322689,27322718,0,14466449
IMR90|chr1:13135346-13135389,chr1,13135346,13135389,IMR90|chr1:32167805-32167863,chr1,32167805,32167863,0,19032459
IMR90|chr1:13144079-13144151,chr1,13144079,13144151,IMR90|chr1:150126479-150126523,chr1,150126479,150126523,0,136982400
IMR90|chr1:13219091-13219162,chr1,13219091,13219162,IMR90|chr1:150546164-150546266,chr1,150546164,150546266,0,137327073
IMR90|chr1:13247736-13247768,chr1,13247736,13247768,IMR90|chr1:27324256-27324374,chr1,27324256,27324374,0,14076520
IMR90|chr1:13275994-13276071,chr1,13275994,13276071,IMR90|chr1:110282718-110282753,chr1,110282718,110282753,0,97006724
IMR90|chr1:13354626-13354682,chr1,13354626,13354682,IMR90|chr1:1255194-1255236,chr1,1255194,1255236,0,12099432
IMR90|chr1:13687243-13687278,chr1,13687243,13687278,IMR90|chr1:27321217-27321243,chr1,27321217,27321243,0,13633974
IMR90|chr1:13695014-13695060,chr1,13695014,13695060,IMR90|chr1:2345970-2346065,chr1,2345970,2346065,0,11349044
IMR90|chr1:13742175-13742244,chr1,13742175,13742244,IMR90|chr1:78150360-78150391,chr1,78150360,78150391,0,64408185
IMR90|chr1:14458866-14459016,chr1,14458866,14459016,IMR90|chr1:148558223-148558286,chr1,148558223,148558286,0,134099357
IMR90|chr1:14743586-14743624,chr1,14743586,14743624,IMR90|chr1:33814741-33814826,chr1,33814741,33814826,0,19071155
IMR90|chr1:14751615-14751765,chr1,14751615,14751765,IMR90|chr1:148558154-148558286,chr1,148558154,148558286,0,133806539
IMR90|chr1:14773185-14773234,chr1,14773185,14773234,IMR90|chr1:200381739-200381781,chr1,200381739,200381781,0,185608554
IMR90|chr1:14806808-14806918,chr1,14806808,14806918,IMR90|chr1:24066527-24066564,chr1,24066527,24066564,0,9259719
IMR90|chr1:15060203-15060254,chr1,15060203,15060254,IMR90|chr1:220442805-220442941,chr1,220442805,220442941,0,205382602
IMR90|chr1:15091950-15092071,chr1,15091950,15092071,IMR90|chr1:148556231-148556269,chr1,148556231,148556269,0,133464281
IMR90|chr1:15302594-15302656,chr1,15302594,15302656,IMR90|chr1:148556220-148556273,chr1,148556220,148556273,0,133253626
IMR90|chr1:15419019-15419157,chr1,15419019,15419157,IMR90|chr1:173445770-173445797,chr1,173445770,173445797,0,158026751
IMR90|chr1:15685740-15685803,chr1,15685740,15685803,IMR90|chr1:27322713-27322775,chr1,27322713,27322775,0,11636973
IMR90|chr1:15692047-15692110,chr1,15692047,15692110,IMR90|chr1:27322713-27322775,chr1,27322713,27322775,0,11630666
IMR90|chr1:15773789-15773868,chr1,15773789,15773868,IMR90|chr1:148559469-148559546,chr1,148559469,148559546,0,132785680
IMR90|chr1:15805454-15805480,chr1,15805454,15805480,IMR90|chr1:227751790-227751894,chr1,227751790,227751894,0,211946336
IMR90|chr1:15932815-15932846,chr1,15932815,15932846,IMR90|chr1:148556554-148556672,chr1,148556554,148556672,0,132623739
IMR90|chr1:16093518-16093556,chr1,16093518,16093556,IMR90|chr1:16479875-16479973,chr1,16479875,16479973,0,386357
IMR90|chr1:16256546-16256597,chr1,16256546,16256597,IMR90|chr1:32481719-32481792,chr1,32481719,32481792,0,16225173
IMR90|chr1:16334785-16334926,chr1,16334785,16334926,IMR90|chr1:7832457-7832479,chr1,7832457,7832479,0,8502328
IMR90|chr1:16402946-16403024,chr1,16402946,16403024,IMR90|chr1:27324285-27324337,chr1,27324285,27324337,0,10921339
IMR90|chr1:16714354-16714485,chr1,16714354,16714485,IMR90|chr1:148560416-148560566,chr1,148560416,148560566,0,131846062
IMR90|chr1:16806239-16806358,chr1,16806239,16806358,IMR90|chr1:173445770-173445801,chr1,173445770,173445801,0,156639531
IMR90|chr1:17018711-17018759,chr1,17018711,17018759,IMR90|chr1:203599103-203599139,chr1,203599103,203599139,0,186580392
IMR90|chr1:17036863-17036911,chr1,17036863,17036911,IMR90|chr1:153964666-153964722,chr1,153964666,153964722,0,136927803
IMR90|chr1:17234894-17234947,chr1,17234894,17234947,IMR90|chr1:27323706-27323778,chr1,27323706,27323778,0,10088812
IMR90|chr1:17356364-17356501,chr1,17356364,17356501,IMR90|chr1:9192620-9192731,chr1,9192620,9192731,0,8163744
IMR90|chr1:17453101-17453191,chr1,17453101,17453191,IMR90|chr1:27324368-27324398,chr1,27324368,27324398,0,9871267
IMR90|chr1:17548134-17548249,chr1,17548134,17548249,IMR90|chr1:165600519-165600565,chr1,165600519,165600565,0,148052385
IMR90|chr1:17569277-17569359,chr1,17569277,17569359,IMR90|chr1:156085784-156085817,chr1,156085784,156085817,0,138516507
IMR90|chr1:18470882-18470919,chr1,18470882,18470919,IMR90|chr1:112302465-112302595,chr1,112302465,112302595,0,93831583
IMR90|chr1:18659728-18659837,chr1,18659728,18659837,IMR90|chr1:173986494-173986535,chr1,173986494,173986535,0,155326766
IMR90|chr1:18763824-18763873,chr1,18763824,18763873,IMR90|chr1:161118705-161118748,chr1,161118705,161118748,0,142354881
IMR90|chr1:18879060-18879132,chr1,18879060,18879132,IMR90|chr1:21115769-21115891,chr1,21115769,21115891,0,2236709
IMR90|chr1:18931984-18932134,chr1,18931984,18932134,IMR90|chr1:24970815-24970843,chr1,24970815,24970843,0,6038831
IMR90|chr1:18988634-18988707,chr1,18988634,18988707,IMR90|chr1:2322239-2322287,chr1,2322239,2322287,0,16666395
IMR90|chr1:19014991-19015087,chr1,19014991,19015087,IMR90|chr1:15481761-15481812,chr1,15481761,15481812,0,3533230
IMR90|chr1:19215365-19215417,chr1,19215365,19215417,IMR90|chr1:200379821-200379880,chr1,200379821,200379880,0,181164456
IMR90|chr1:19500070-19500220,chr1,19500070,19500220,IMR90|chr1:148558160-148558297,chr1,148558160,148558297,0,129058090
IMR90|chr1:19587931-19587975,chr1,19587931,19587975,IMR90|chr1:27322379-27322431,chr1,27322379,27322431,0,7734448
IMR90|chr1:19714058-19714143,chr1,19714058,19714143,IMR90|chr1:173831087-173831152,chr1,173831087,173831152,0,154117029
IMR90|chr1:19747775-19747831,chr1,19747775,19747831,IMR90|chr1:203765175-203765226,chr1,203765175,203765226,0,184017400
IMR90|chr1:20021347-20021401,chr1,20021347,20021401,IMR90|chr1:156089263-156089359,chr1,156089263,156089359,0,136067916
IMR90|chr1:20144531-20144605,chr1,20144531,20144605,IMR90|chr1:120189024-120189123,chr1,120189024,120189123,0,100044493
IMR90|chr1:20149235-20149286,chr1,20149235,20149286,IMR90|chr1:8085007-8085064,chr1,8085007,8085064,0,12064228
IMR90|chr1:20461133-20461211,chr1,20461133,20461211,IMR90|chr1:32174218-32174239,chr1,32174218,32174239,0,11713085
IMR90|chr1:20528474-20528546,chr1,20528474,20528546,IMR90|chr1:150126479-150126523,chr1,150126479,150126523,0,129598005
IMR90|chr1:20824947-20824986,chr1,20824947,20824986,IMR90|chr1:24068069-24068219,chr1,24068069,24068219,0,3243122
IMR90|chr1:20878128-20878174,chr1,20878128,20878174,IMR90|chr1:150546164-150546266,chr1,150546164,150546266,0,129668036
IMR90|chr1:20967519-20967553,chr1,20967519,20967553,IMR90|chr1:94702692-94702800,chr1,94702692,94702800,0,73735173
IMR90|chr1:21046568-21046636,chr1,21046568,21046636,IMR90|chr1:154196656-154196695,chr1,154196656,154196695,0,133150088
IMR90|chr1:21272725-21272742,chr1,21272725,21272742,IMR90|chr1:182809209-182809342,chr1,182809209,182809342,0,161536484
IMR90|chr1:21327225-21327375,chr1,21327225,21327375,IMR90|chr1:148558160-148558287,chr1,148558160,148558287,0,127230935
IMR90|chr1:21924036-21924183,chr1,21924036,21924183,IMR90|chr1:148558239-148558286,chr1,148558239,148558286,0,126634203
IMR90|chr1:22088247-22088317,chr1,22088247,22088317,IMR90|chr1:1820471-1820522,chr1,1820471,1820522,0,20267776
IMR90|chr1:22212580-22212697,chr1,22212580,22212697,IMR90|chr1:19811544-19811577,chr1,19811544,19811577,0,2401036
IMR90|chr1:22237406-22237449,chr1,22237406,22237449,IMR90|chr1:161086759-161086866,chr1,161086759,161086866,0,138849353
IMR90|chr1:22238866-22238947,chr1,22238866,22238947,IMR90|chr1:224620980-224621012,chr1,224620980,224621012,0,202382114
IMR90|chr1:22374846-22374881,chr1,22374846,22374881,IMR90|chr1:32574945-32575019,chr1,32574945,32575019,0,10200099
IMR90|chr1:22546795-22546876,chr1,22546795,22546876,IMR90|chr1:22380841-22380873,chr1,22380841,22380873,0,165954
IMR90|chr1:22756393-22756493,chr1,22756393,22756493,IMR90|chr1:247499894-247499945,chr1,247499894,247499945,0,224743501
IMR90|chr1:22835730-22835781,chr1,22835730,22835781,IMR90|chr1:149283041-149283073,chr1,149283041,149283073,0,126447311
IMR90|chr1:22859388-22859494,chr1,22859388,22859494,IMR90|chr1:43837242-43837321,chr1,43837242,43837321,0,20977854
IMR90|chr1:22865214-22865282,chr1,22865214,22865282,IMR90|chr1:27322312-27322394,chr1,27322312,27322394,0,4457098
IMR90|chr1:22906181-22906281,chr1,22906181,22906281,IMR90|chr1:715919-715966,chr1,715919,715966,0,22190262
IMR90|chr1:23038378-23038396,chr1,23038378,23038396,IMR90|chr1:148558184-148558287,chr1,148558184,148558287,0,125519806
IMR90|chr1:23167880-23167982,chr1,23167880,23167982,IMR90|chr1:54201565-54201613,chr1,54201565,54201613,0,31033685
IMR90|chr1:23180955-23181076,chr1,23180955,23181076,IMR90|chr1:28558788-28558899,chr1,28558788,28558899,0,5377833
IMR90|chr1:23665634-23665712,chr1,23665634,23665712,IMR90|chr1:43837259-43837327,chr1,43837259,43837327,0,20171625
IMR90|chr1:23686521-23686581,chr1,23686521,23686581,IMR90|chr1:32480973-32481055,chr1,32480973,32481055,0,8794452
IMR90|chr1:23882584-23882631,chr1,23882584,23882631,IMR90|chr1:24068677-24068730,chr1,24068677,24068730,0,186093
IMR90|chr1:23882740-23882783,chr1,23882740,23882783,IMR90|chr1:32401156-32401230,chr1,32401156,32401230,0,8518416
IMR90|chr1:23883460-23883505,chr1,23883460,23883505,IMR90|chr1:33814396-33814451,chr1,33814396,33814451,0,9930936
IMR90|chr1:24139514-24139664,chr1,24139514,24139664,IMR90|chr1:46597443-46597471,chr1,46597443,46597471,0,22457929
IMR90|chr1:24270612-24270672,chr1,24270612,24270672,IMR90|chr1:43837390-43837431,chr1,43837390,43837431,0,19566778
IMR90|chr1:24395415-24395520,chr1,24395415,24395520,IMR90|chr1:54200818-54200846,chr1,54200818,54200846,0,29805403
IMR90|chr1:24421011-24421096,chr1,24421011,24421096,IMR90|chr1:27930330-27930392,chr1,27930330,27930392,0,3509319
IMR90|chr1:24543035-24543185,chr1,24543035,24543185,IMR90|chr1:148558195-148558286,chr1,148558195,148558286,0,124015160
IMR90|chr1:24560334-24560397,chr1,24560334,24560397,IMR90|chr1:227128147-227128203,chr1,227128147,227128203,0,202567813
IMR90|chr1:24568097-24568138,chr1,24568097,24568138,IMR90|chr1:27321825-27321925,chr1,27321825,27321925,0,2753728
IMR90|chr1:24599808-24599827,chr1,24599808,24599827,IMR90|chr1:148556203-148556353,chr1,148556203,148556353,0,123956395
IMR90|chr1:24704246-24704396,chr1,24704246,24704396,IMR90|chr1:1206366-1206422,chr1,1206366,1206422,0,23497880
IMR90|chr1:24926977-24927127,chr1,24926977,24927127,IMR90|chr1:148560453-148560603,chr1,148560453,148560603,0,123633476
IMR90|chr1:25000155-25000305,chr1,25000155,25000305,IMR90|chr1:173445770-173445815,chr1,173445770,173445815,0,148445615
IMR90|chr1:25005428-25005484,chr1,25005428,25005484,IMR90|chr1:95005545-95005610,chr1,95005545,95005610,0,70000117
IMR90|chr1:25098228-25098259,chr1,25098228,25098259,IMR90|chr1:220222336-220222402,chr1,220222336,220222402,0,195124108
IMR90|chr1:25544245-25544351,chr1,25544245,25544351,IMR90|chr1:27322689-27322718,chr1,27322689,27322718,0,1778444
IMR90|chr1:25723378-25723396,chr1,25723378,25723396,IMR90|chr1:94703420-94703508,chr1,94703420,94703508,0,68980042
IMR90|chr1:25758295-25758326,chr1,25758295,25758326,IMR90|chr1:27323944-27324067,chr1,27323944,27324067,0,1565649
IMR90|chr1:26051305-26051365,chr1,26051305,26051365,IMR90|chr1:173445770-173445808,chr1,173445770,173445808,0,147394465
IMR90|chr1:26083965-26084027,chr1,26083965,26084027,IMR90|chr1:95006991-95007129,chr1,95006991,95007129,0,68923026
IMR90|chr1:26143146-26143268,chr1,26143146,26143268,IMR90|chr1:201434533-201434558,chr1,201434533,201434558,0,175291387
IMR90|chr1:26215929-26215989,chr1,26215929,26215989,IMR90|chr1:32480973-32481055,chr1,32480973,32481055,0,6265044
IMR90|chr1:26445711-26445807,chr1,26445711,26445807,IMR90|chr1:148558218-148558286,chr1,148558218,148558286,0,122112507
IMR90|chr1:26542334-26542369,chr1,26542334,26542369,IMR90|chr1:52832302-52832380,chr1,52832302,52832380,0,26289968
IMR90|chr1:26953434-26953582,chr1,26953434,26953582,IMR90|chr1:29506951-29506994,chr1,29506951,29506994,0,2553517
IMR90|chr1:27059852-27059906,chr1,27059852,27059906,IMR90|chr1:94702468-94702554,chr1,94702468,94702554,0,67642616
IMR90|chr1:27101867-27101961,chr1,27101867,27101961,IMR90|chr1:54203716-54203779,chr1,54203716,54203779,0,27101849
IMR90|chr1:27461404-27461424,chr1,27461404,27461424,IMR90|chr1:42800126-42800256,chr1,42800126,42800256,0,15338722
IMR90|chr1:27467040-27467099,chr1,27467040,27467099,IMR90|chr1:162602439-162602530,chr1,162602439,162602530,0,135135399
IMR90|chr1:27467465-27467534,chr1,27467465,27467534,IMR90|chr1:95003552-95003632,chr1,95003552,95003632,0,67536087
IMR90|chr1:27521253-27521294,chr1,27521253,27521294,IMR90|chr1:148558176-148558291,chr1,148558176,148558291,0,121036923
IMR90|chr1:27632325-27632438,chr1,27632325,27632438,IMR90|chr1:173442090-173442110,chr1,173442090,173442110,0,145809765
IMR90|chr1:27669665-27669781,chr1,27669665,27669781,IMR90|chr1:148560501-148560648,chr1,148560501,148560648,0,120890836
IMR90|chr1:27800852-27800933,chr1,27800852,27800933,IMR90|chr1:173445770-173445819,chr1,173445770,173445819,0,145644918
IMR90|chr1:27863897-27863942,chr1,27863897,27863942,IMR90|chr1:32480973-32481056,chr1,32480973,32481056,0,4617076
IMR90|chr1:28045482-28045575,chr1,28045482,28045575,IMR90|chr1:173986948-173986990,chr1,173986948,173986990,0,145941466
IMR90|chr1:28129216-28129238,chr1,28129216,28129238,IMR90|chr1:95006659-95006685,chr1,95006659,95006685,0,66877443
IMR90|chr1:28155219-28155302,chr1,28155219,28155302,IMR90|chr1:25068789-25068844,chr1,25068789,25068844,0,3086430
IMR90|chr1:28244704-28244750,chr1,28244704,28244750,IMR90|chr1:27323730-27323795,chr1,27323730,27323795,0,920974
IMR90|chr1:28312966-28313015,chr1,28312966,28313015,IMR90|chr1:1820133-1820213,chr1,1820133,1820213,0,26492833
IMR90|chr1:28683068-28683149,chr1,28683068,28683149,IMR90|chr1:179047351-179047384,chr1,179047351,179047384,0,150364283
IMR90|chr1:28974522-28974629,chr1,28974522,28974629,IMR90|chr1:148556149-148556180,chr1,148556149,148556180,0,119581627
IMR90|chr1:29089943-29089973,chr1,29089943,29089973,IMR90|chr1:201707075-201707177,chr1,201707075,201707177,0,172617132
IMR90|chr1:29272054-29272182,chr1,29272054,29272182,IMR90|chr1:7832457-7832479,chr1,7832457,7832479,0,21439597
IMR90|chr1:29464563-29464663,chr1,29464563,29464663,IMR90|chr1:715919-715966,chr1,715919,715966,0,28748644
IMR90|chr1:29505793-29505828,chr1,29505793,29505828,IMR90|chr1:93301093-93301208,chr1,93301093,93301208,0,63795300
IMR90|chr1:29509673-29509711,chr1,29509673,29509711,IMR90|chr1:173827852-173827933,chr1,173827852,173827933,0,144318179
IMR90|chr1:29629047-29629075,chr1,29629047,29629075,IMR90|chr1:93302102-93302174,chr1,93302102,93302174,0,63673055
IMR90|chr1:29919746-29919896,chr1,29919746,29919896,IMR90|chr1:148558202-148558351,chr1,148558202,148558351,0,118638456
IMR90|chr1:30097465-30097516,chr1,30097465,30097516,IMR90|chr1:33814917-33815067,chr1,33814917,33815067,0,3717452
IMR90|chr1:30295879-30295926,chr1,30295879,30295926,IMR90|chr1:1241898-1241976,chr1,1241898,1241976,0,29053981
IMR90|chr1:30442767-30442819,chr1,30442767,30442819,IMR90|chr1:32481719-32481792,chr1,32481719,32481792,0,2038952
IMR90|chr1:30590712-30590790,chr1,30590712,30590790,IMR90|chr1:40941437-40941526,chr1,40941437,40941526,0,10350725
IMR90|chr1:30722628-30722720,chr1,30722628,30722720,IMR90|chr1:40041095-40041153,chr1,40041095,40041153,0,9318467
IMR90|chr1:30758267-30758376,chr1,30758267,30758376,IMR90|chr1:1255670-1255710,chr1,1255670,1255710,0,29502597
IMR90|chr1:30764347-30764396,chr1,30764347,30764396,IMR90|chr1:27323235-27323321,chr1,27323235,27323321,0,3441112
IMR90|chr1:30899346-30899397,chr1,30899346,30899397,IMR90|chr1:149283041-149283073,chr1,149283041,149283073,0,118383695
IMR90|chr1:31191803-31191878,chr1,31191803,31191878,IMR90|chr1:1820471-1820522,chr1,1820471,1820522,0,29371332
IMR90|chr1:31547628-31547669,chr1,31547628,31547669,IMR90|chr1:148556153-148556180,chr1,148556153,148556180,0,117008525
IMR90|chr1:31591264-31591282,chr1,31591264,31591282,IMR90|chr1:27323333-27323435,chr1,27323333,27323435,0,4267931
IMR90|chr1:31807151-31807231,chr1,31807151,31807231,IMR90|chr1:148556136-148556180,chr1,148556136,148556180,0,116748985
IMR90|chr1:32140815-32140892,chr1,32140815,32140892,IMR90|chr1:150550114-150550170,chr1,150550114,150550170,0,118409299
IMR90|chr1:32168279-32168340,chr1,32168279,32168340,IMR90|chr1:1255194-1255236,chr1,1255194,1255236,0,30913085
IMR90|chr1:32212193-32212324,chr1,32212193,32212324,IMR90|chr1:148556135-148556180,chr1,148556135,148556180,0,116343942
IMR90|chr1:32217808-32217856,chr1,32217808,32217856,IMR90|chr1:182810054-182810095,chr1,182810054,182810095,0,150592246
IMR90|chr1:32251830-32251847,chr1,32251830,32251847,IMR90|chr1:148556202-148556349,chr1,148556202,148556349,0,116304372
IMR90|chr1:32641099-32641118,chr1,32641099,32641118,IMR90|chr1:148556203-148556353,chr1,148556203,148556353,0,115915104
IMR90|chr1:32715526-32715601,chr1,32715526,32715601,IMR90|chr1:179047638-179047680,chr1,179047638,179047680,0,146332112
IMR90|chr1:32795941-32795999,chr1,32795941,32795999,IMR90|chr1:162533461-162533518,chr1,162533461,162533518,0,129737520
IMR90|chr1:33113028-33113051,chr1,33113028,33113051,IMR90|chr1:44441395-44441481,chr1,44441395,44441481,0,11328367
IMR90|chr1:33139070-33139139,chr1,33139070,33139139,IMR90|chr1:78150360-78150391,chr1,78150360,78150391,0,45011290
IMR90|chr1:33407317-33407339,chr1,33407317,33407339,IMR90|chr1:27324398-27324525,chr1,27324398,27324525,0,6082919
IMR90|chr1:33528226-33528277,chr1,33528226,33528277,IMR90|chr1:54201826-54201925,chr1,54201826,54201925,0,20673600
IMR90|chr1:33648049-33648140,chr1,33648049,33648140,IMR90|chr1:27322363-27322422,chr1,27322363,27322422,0,6325686
IMR90|chr1:34050485-34050534,chr1,34050485,34050534,IMR90|chr1:223901130-223901223,chr1,223901130,223901223,0,189850645
IMR90|chr1:34264310-34264387,chr1,34264310,34264387,IMR90|chr1:27324285-27324337,chr1,27324285,27324337,0,6940025
IMR90|chr1:34438477-34438523,chr1,34438477,34438523,IMR90|chr1:220443595-220443660,chr1,220443595,220443660,0,186005118
IMR90|chr1:34582674-34582746,chr1,34582674,34582746,IMR90|chr1:173828184-173828247,chr1,173828184,173828247,0,139245510
IMR90|chr1:34735092-34735162,chr1,34735092,34735162,IMR90|chr1:109633581-109633636,chr1,109633581,109633636,0,74898489
IMR90|chr1:34898866-34898968,chr1,34898866,34898968,IMR90|chr1:180470505-180470553,chr1,180470505,180470553,0,145571639
IMR90|chr1:35086867-35086893,chr1,35086867,35086893,IMR90|chr1:1204953-1205100,chr1,1204953,1205100,0,33881914
IMR90|chr1:35273859-35274009,chr1,35273859,35274009,IMR90|chr1:148559579-148559729,chr1,148559579,148559729,0,113285720
IMR90|chr1:35467751-35467827,chr1,35467751,35467827,IMR90|chr1:150534733-150534780,chr1,150534733,150534780,0,115066982
IMR90|chr1:35660687-35660747,chr1,35660687,35660747,IMR90|chr1:78472831-78472901,chr1,78472831,78472901,0,42812144
IMR90|chr1:35825514-35825646,chr1,35825514,35825646,IMR90|chr1:27322363-27322422,chr1,27322363,27322422,0,8503151
IMR90|chr1:35841460-35841509,chr1,35841460,35841509,IMR90|chr1:1820133-1820213,chr1,1820133,1820213,0,34021327
IMR90|chr1:35879059-35879138,chr1,35879059,35879138,IMR90|chr1:148559469-148559546,chr1,148559469,148559546,0,112680410
IMR90|chr1:36054824-36054889,chr1,36054824,36054889,IMR90|chr1:57042661-57042705,chr1,57042661,57042705,0,20987837
IMR90|chr1:36310741-36310788,chr1,36310741,36310788,IMR90|chr1:112302467-112302595,chr1,112302467,112302595,0,75991726
IMR90|chr1:36589832-36589943,chr1,36589832,36589943,IMR90|chr1:63155856-63155895,chr1,63155856,63155895,0,26566024
IMR90|chr1:36640901-36641020,chr1,36640901,36641020,IMR90|chr1:173445770-173445801,chr1,173445770,173445801,0,136804869
IMR90|chr1:37183357-37183395,chr1,37183357,37183395,IMR90|chr1:52832302-52832380,chr1,52832302,52832380,0,15648945
IMR90|chr1:37387775-37387867,chr1,37387775,37387867,IMR90|chr1:40045466-40045524,chr1,40045466,40045524,0,2657691
IMR90|chr1:37417007-37417027,chr1,37417007,37417027,IMR90|chr1:42800126-42800256,chr1,42800126,42800256,0,5383119
IMR90|chr1:37422488-37422546,chr1,37422488,37422546,IMR90|chr1:223902186-223902267,chr1,223902186,223902267,0,186479698
IMR90|chr1:37865149-37865256,chr1,37865149,37865256,IMR90|chr1:173447038-173447112,chr1,173447038,173447112,0,135581889
IMR90|chr1:37956660-37956719,chr1,37956660,37956719,IMR90|chr1:154958393-154958471,chr1,154958393,154958471,0,117001733
IMR90|chr1:38046570-38046588,chr1,38046570,38046588,IMR90|chr1:225965764-225965858,chr1,225965764,225965858,0,187919194
IMR90|chr1:38098110-38098194,chr1,38098110,38098194,IMR90|chr1:42799717-42799734,chr1,42799717,42799734,0,4701607
IMR90|chr1:38101242-38101331,chr1,38101242,38101331,IMR90|chr1:24972863-24972910,chr1,24972863,24972910,0,13128379
IMR90|chr1:38158383-38158448,chr1,38158383,38158448,IMR90|chr1:78472831-78472901,chr1,78472831,78472901,0,40314448
IMR90|chr1:38267781-38267821,chr1,38267781,38267821,IMR90|chr1:113247345-113247397,chr1,113247345,113247397,0,74979564
IMR90|chr1:38346162-38346252,chr1,38346162,38346252,IMR90|chr1:214725857-214725909,chr1,214725857,214725909,0,176379695
IMR90|chr1:38371979-38372041,chr1,38371979,38372041,IMR90|chr1:27322294-27322382,chr1,27322294,27322382,0,11049685
IMR90|chr1:38384788-38384878,chr1,38384788,38384878,IMR90|chr1:27324368-27324398,chr1,27324368,27324398,0,11060420
IMR90|chr1:38476838-38476919,chr1,38476838,38476919,IMR90|chr1:173836015-173836065,chr1,173836015,173836065,0,135359177
IMR90|chr1:38481595-38481736,chr1,38481595,38481736,IMR90|chr1:148556306-148556397,chr1,148556306,148556397,0,110074711
IMR90|chr1:38492666-38492728,chr1,38492666,38492728,IMR90|chr1:27322294-27322382,chr1,27322294,27322382,0,11170372
IMR90|chr1:38519609-38519636,chr1,38519609,38519636,IMR90|chr1:110158186-110158228,chr1,110158186,110158228,0,71638577
IMR90|chr1:38548275-38548321,chr1,38548275,38548321,IMR90|chr1:155024646-155024750,chr1,155024646,155024750,0,116476371
IMR90|chr1:38571352-38571454,chr1,38571352,38571454,IMR90|chr1:67391702-67391724,chr1,67391702,67391724,0,28820350
IMR90|chr1:38574256-38574338,chr1,38574256,38574338,IMR90|chr1:32480002-32480064,chr1,32480002,32480064,0,6094254
IMR90|chr1:38630547-38630632,chr1,38630547,38630632,IMR90|chr1:67215309-67215341,chr1,67215309,67215341,0,28584762
IMR90|chr1:38831983-38832065,chr1,38831983,38832065,IMR90|chr1:173445770-173445819,chr1,173445770,173445819,0,134613787
IMR90|chr1:38933683-38933833,chr1,38933683,38933833,IMR90|chr1:148558160-148558287,chr1,148558160,148558287,0,109624477
IMR90|chr1:39267956-39268018,chr1,39267956,39268018,IMR90|chr1:1820996-1821054,chr1,1820996,1821054,0,37446960
IMR90|chr1:39339935-39339985,chr1,39339935,39339985,IMR90|chr1:201620360-201620460,chr1,201620360,201620460,0,162280425
IMR90|chr1:39465407-39465529,chr1,39465407,39465529,IMR90|chr1:150550504-150550590,chr1,150550504,150550590,0,111085097
IMR90|chr1:39478561-39478659,chr1,39478561,39478659,IMR90|chr1:112302467-112302595,chr1,112302467,112302595,0,72823906
IMR90|chr1:39661326-39661343,chr1,39661326,39661343,IMR90|chr1:33812543-33812603,chr1,33812543,33812603,0,5848783
IMR90|chr1:39718959-39719057,chr1,39718959,39719057,IMR90|chr1:27323337-27323389,chr1,27323337,27323389,0,12395622
IMR90|chr1:39836093-39836224,chr1,39836093,39836224,IMR90|chr1:173445770-173445788,chr1,173445770,173445788,0,133609677
IMR90|chr1:40143598-40143626,chr1,40143598,40143626,IMR90|chr1:93302102-93302174,chr1,93302102,93302174,0,53158504
IMR90|chr1:40370481-40370580,chr1,40370481,40370580,IMR90|chr1:21111658-21111706,chr1,21111658,21111706,0,19258823
IMR90|chr1:40620974-40621124,chr1,40620974,40621124,IMR90|chr1:148560400-148560550,chr1,148560400,148560550,0,107939426
IMR90|chr1:40888756-40888802,chr1,40888756,40888802,IMR90|chr1:150546164-150546266,chr1,150546164,150546266,0,109657408
IMR90|chr1:40907709-40907832,chr1,40907709,40907832,IMR90|chr1:173445770-173445797,chr1,173445770,173445797,0,132538061
IMR90|chr1:41139622-41139665,chr1,41139622,41139665,IMR90|chr1:27321519-27321553,chr1,27321519,27321553,0,13818103
IMR90|chr1:41170755-41170772,chr1,41170755,41170772,IMR90|chr1:33812543-33812603,chr1,33812543,33812603,0,7358212
IMR90|chr1:41193578-41193663,chr1,41193578,41193663,IMR90|chr1:33938332-33938365,chr1,33938332,33938365,0,7255246
IMR90|chr1:41198080-41198140,chr1,41198080,41198140,IMR90|chr1:12041821-12041911,chr1,12041821,12041911,0,29156259
IMR90|chr1:41483453-41483514,chr1,41483453,41483514,IMR90|chr1:173828336-173828425,chr1,173828336,173828425,0,132344883
IMR90|chr1:41609307-41609395,chr1,41609307,41609395,IMR90|chr1:29506951-29506994,chr1,29506951,29506994,0,12102356
IMR90|chr1:41813073-41813107,chr1,41813073,41813107,IMR90|chr1:27323713-27323806,chr1,27323713,27323806,0,14489360
IMR90|chr1:41817512-41817571,chr1,41817512,41817571,IMR90|chr1:173445770-173445812,chr1,173445770,173445812,0,131628258
IMR90|chr1:41834230-41834380,chr1,41834230,41834380,IMR90|chr1:2323674-2323720,chr1,2323674,2323720,0,39510556
IMR90|chr1:41837718-41837772,chr1,41837718,41837772,IMR90|chr1:156089263-156089359,chr1,156089263,156089359,0,114251545
IMR90|chr1:41993051-41993072,chr1,41993051,41993072,IMR90|chr1:110158302-110158427,chr1,110158302,110158427,0,68165251
IMR90|chr1:42130001-42130098,chr1,42130001,42130098,IMR90|chr1:148556217-148556367,chr1,148556217,148556367,0,106426216
IMR90|chr1:42334991-42335141,chr1,42334991,42335141,IMR90|chr1:148559577-148559721,chr1,148559577,148559721,0,106224586
IMR90|chr1:42424634-42424679,chr1,42424634,42424679,IMR90|chr1:33814396-33814451,chr1,33814396,33814451,0,8610238
IMR90|chr1:42605768-42605889,chr1,42605768,42605889,IMR90|chr1:180470505-180470553,chr1,180470505,180470553,0,137864737
IMR90|chr1:42714664-42714695,chr1,42714664,42714695,IMR90|chr1:148556554-148556672,chr1,148556554,148556672,0,105841890
IMR90|chr1:43114330-43114369,chr1,43114330,43114369,IMR90|chr1:27321825-27321925,chr1,27321825,27321925,0,15792505
IMR90|chr1:43224515-43224564,chr1,43224515,43224564,IMR90|chr1:161118705-161118748,chr1,161118705,161118748,0,117894190
IMR90|chr1:43395933-43395976,chr1,43395933,43395976,IMR90|chr1:205717808-205717907,chr1,205717808,205717907,0,162321875
IMR90|chr1:43396782-43396830,chr1,43396782,43396830,IMR90|chr1:33167634-33167732,chr1,33167634,33167732,0,10229148
IMR90|chr1:43891257-43891391,chr1,43891257,43891391,IMR90|chr1:27323233-27323269,chr1,27323233,27323269,0,16568024
IMR90|chr1:43980219-43980258,chr1,43980219,43980258,IMR90|chr1:9192620-9192731,chr1,9192620,9192731,0,34787599
IMR90|chr1:43987218-43987305,chr1,43987218,43987305,IMR90|chr1:200381738-200381781,chr1,200381738,200381781,0,156394520
IMR90|chr1:44088096-44088187,chr1,44088096,44088187,IMR90|chr1:223902186-223902267,chr1,223902186,223902267,0,179814090
IMR90|chr1:44129438-44129472,chr1,44129438,44129472,IMR90|chr1:43425569-43425682,chr1,43425569,43425682,0,703869
IMR90|chr1:44137778-44137825,chr1,44137778,44137825,IMR90|chr1:1241898-1241976,chr1,1241898,1241976,0,42895880
IMR90|chr1:44558166-44558211,chr1,44558166,44558211,IMR90|chr1:27322903-27322930,chr1,27322903,27322930,0,17235263
IMR90|chr1:44598385-44598450,chr1,44598385,44598450,IMR90|chr1:24066677-24066725,chr1,24066677,24066725,0,20531708
IMR90|chr1:45041162-45041219,chr1,45041162,45041219,IMR90|chr1:27322728-27322761,chr1,27322728,27322761,0,17718434
IMR90|chr1:45064194-45064239,chr1,45064194,45064239,IMR90|chr1:24745522-24745589,chr1,24745522,24745589,0,20318672
IMR90|chr1:45232763-45232815,chr1,45232763,45232815,IMR90|chr1:173830996-173831105,chr1,173830996,173831105,0,128598233
IMR90|chr1:45286005-45286077,chr1,45286005,45286077,IMR90|chr1:151139498-151139526,chr1,151139498,151139526,0,105853493
IMR90|chr1:45461800-45461950,chr1,45461800,45461950,IMR90|chr1:27324578-27324617,chr1,27324578,27324617,0,18137222
IMR90|chr1:45483318-45483394,chr1,45483318,45483394,IMR90|chr1:201620360-201620460,chr1,201620360,201620460,0,156137042
IMR90|chr1:45535740-45535786,chr1,45535740,45535786,IMR90|chr1:27323746-27323807,chr1,27323746,27323807,0,18211994
IMR90|chr1:45810244-45810391,chr1,45810244,45810391,IMR90|chr1:148558239-148558286,chr1,148558239,148558286,0,102747995
IMR90|chr1:45916829-45916860,chr1,45916829,45916860,IMR90|chr1:27323944-27324067,chr1,27323944,27324067,0,18592885
IMR90|chr1:46210214-46210243,chr1,46210214,46210243,IMR90|chr1:40421092-40421197,chr1,40421092,40421197,0,5789122
IMR90|chr1:46482260-46482319,chr1,46482260,46482319,IMR90|chr1:27323235-27323299,chr1,27323235,27323299,0,19159025
IMR90|chr1:46556407-46556557,chr1,46556407,46556557,IMR90|chr1:148556134-148556180,chr1,148556134,148556180,0,101999727
IMR90|chr1:46580092-46580141,chr1,46580092,46580141,IMR90|chr1:223901130-223901223,chr1,223901130,223901223,0,177321038
IMR90|chr1:46662641-46662663,chr1,46662641,46662663,IMR90|chr1:29506313-29506406,chr1,29506313,29506406,0,17156328
IMR90|chr1:46670852-46670954,chr1,46670852,46670954,IMR90|chr1:54201565-54201613,chr1,54201565,54201613,0,7530713
IMR90|chr1:46674222-46674248,chr1,46674222,46674248,IMR90|chr1:1820119-1820266,chr1,1820119,1820266,0,44854103
IMR90|chr1:46699851-46699982,chr1,46699851,46699982,IMR90|chr1:173445770-173445788,chr1,173445770,173445788,0,126745919
IMR90|chr1:46852016-46852071,chr1,46852016,46852071,IMR90|chr1:203832414-203832483,chr1,203832414,203832483,0,156980398
IMR90|chr1:46941744-46941894,chr1,46941744,46941894,IMR90|chr1:148556015-148556165,chr1,148556015,148556165,0,101614271
IMR90|chr1:46961168-46961318,chr1,46961168,46961318,IMR90|chr1:19811544-19811577,chr1,19811544,19811577,0,27149624
IMR90|chr1:47274168-47274203,chr1,47274168,47274203,IMR90|chr1:156089263-156089359,chr1,156089263,156089359,0,108815095
IMR90|chr1:47287426-47287471,chr1,47287426,47287471,IMR90|chr1:205288085-205288193,chr1,205288085,205288193,0,158000659
IMR90|chr1:47390590-47390639,chr1,47390590,47390639,IMR90|chr1:16570495-16570573,chr1,16570495,16570573,0,30820095
IMR90|chr1:47409975-47410125,chr1,47409975,47410125,IMR90|chr1:148558699-148558849,chr1,148558699,148558849,0,101148724
IMR90|chr1:47526109-47526125,chr1,47526109,47526125,IMR90|chr1:27321387-27321417,chr1,27321387,27321417,0,20204722
IMR90|chr1:47777752-47777791,chr1,47777752,47777791,IMR90|chr1:24068069-24068219,chr1,24068069,24068219,0,23709683
IMR90|chr1:47857930-47858040,chr1,47857930,47858040,IMR90|chr1:29064950-29064979,chr1,29064950,29064979,0,18792980
IMR90|chr1:47944185-47944279,chr1,47944185,47944279,IMR90|chr1:40041095-40041153,chr1,40041095,40041153,0,7903090
IMR90|chr1:48062736-48062886,chr1,48062736,48062886,IMR90|chr1:148556238-148556385,chr1,148556238,148556385,0,100493502
IMR90|chr1:48087730-48087756,chr1,48087730,48087756,IMR90|chr1:110282718-110282753,chr1,110282718,110282753,0,62194988
IMR90|chr1:48106379-48106460,chr1,48106379,48106460,IMR90|chr1:179047351-179047384,chr1,179047351,179047384,0,130940972
IMR90|chr1:48113368-48113432,chr1,48113368,48113432,IMR90|chr1:173175348-173175434,chr1,173175348,173175434,0,125061980
IMR90|chr1:48160704-48160852,chr1,48160704,48160852,IMR90|chr1:148558190-148558334,chr1,148558190,148558334,0,100397486
IMR90|chr1:48182253-48182327,chr1,48182253,48182327,IMR90|chr1:173445770-173445811,chr1,173445770,173445811,0,125263517
IMR90|chr1:48258226-48258260,chr1,48258226,48258260,IMR90|chr1:43425569-43425682,chr1,43425569,43425682,0,4832657
IMR90|chr1:48494577-48494724,chr1,48494577,48494724,IMR90|chr1:223901424-223901450,chr1,223901424,223901450,0,175406847
IMR90|chr1:48626552-48626606,chr1,48626552,48626606,IMR90|chr1:27323394-27323490,chr1,27323394,27323490,0,21303158
IMR90|chr1:48778684-48778713,chr1,48778684,48778713,IMR90|chr1:8083827-8083927,chr1,8083827,8083927,0,40694857
IMR90|chr1:48858183-48858316,chr1,48858183,48858316,IMR90|chr1:8083645-8083725,chr1,8083645,8083725,0,40774538
IMR90|chr1:49035150-49035294,chr1,49035150,49035294,IMR90|chr1:148556231-148556381,chr1,148556231,148556381,0,99521081
IMR90|chr1:49170960-49171022,chr1,49170960,49171022,IMR90|chr1:16483819-16483907,chr1,16483819,16483907,0,32687141
IMR90|chr1:49736225-49736371,chr1,49736225,49736371,IMR90|chr1:27322348-27322427,chr1,27322348,27322427,0,22413877
IMR90|chr1:49769112-49769195,chr1,49769112,49769195,IMR90|chr1:178064523-178064589,chr1,178064523,178064589,0,128295411
IMR90|chr1:49888530-49888674,chr1,49888530,49888674,IMR90|chr1:148557990-148558127,chr1,148557990,148558127,0,98669460
IMR90|chr1:50052026-50052129,chr1,50052026,50052129,IMR90|chr1:24972876-24972912,chr1,24972876,24972912,0,25079150
IMR90|chr1:50593962-50594046,chr1,50593962,50594046,IMR90|chr1:178064523-178064589,chr1,178064523,178064589,0,127470561
IMR90|chr1:50705911-50706005,chr1,50705911,50706005,IMR90|chr1:1206366-1206422,chr1,1206366,1206422,0,49499545
IMR90|chr1:50718185-50718257,chr1,50718185,50718257,IMR90|chr1:24972872-24972910,chr1,24972872,24972910,0,25745313
IMR90|chr1:50744579-50744635,chr1,50744579,50744635,IMR90|chr1:173445770-173445849,chr1,173445770,173445849,0,122701191
IMR90|chr1:50771365-50771456,chr1,50771365,50771456,IMR90|chr1:40041095-40041153,chr1,40041095,40041153,0,10730270
IMR90|chr1:50855591-50855671,chr1,50855591,50855671,IMR90|chr1:154196609-154196695,chr1,154196609,154196695,0,103341018
IMR90|chr1:51184311-51184349,chr1,51184311,51184349,IMR90|chr1:95005198-95005223,chr1,95005198,95005223,0,43820887
IMR90|chr1:51291408-51291510,chr1,51291408,51291510,IMR90|chr1:67391702-67391724,chr1,67391702,67391724,0,16100294
IMR90|chr1:51299714-51299739,chr1,51299714,51299739,IMR90|chr1:150124614-150124702,chr1,150124614,150124702,0,98824900
IMR90|chr1:51301906-51302000,chr1,51301906,51302000,IMR90|chr1:64240364-64240433,chr1,64240364,64240433,0,12938458
IMR90|chr1:51347152-51347232,chr1,51347152,51347232,IMR90|chr1:19814850-19814881,chr1,19814850,19814881,0,31532302
IMR90|chr1:51361500-51361544,chr1,51361500,51361544,IMR90|chr1:41155932-41156015,chr1,41155932,41156015,0,10205568
IMR90|chr1:51408877-51408898,chr1,51408877,51408898,IMR90|chr1:156253167-156253293,chr1,156253167,156253293,0,104844290
IMR90|chr1:51435164-51435208,chr1,51435164,51435208,IMR90|chr1:201620789-201620875,chr1,201620789,201620875,0,150185625
IMR90|chr1:51584912-51584933,chr1,51584912,51584933,IMR90|chr1:148556136-148556180,chr1,148556136,148556180,0,96971224
IMR90|chr1:51966437-51966458,chr1,51966437,51966458,IMR90|chr1:85932324-85932432,chr1,85932324,85932432,0,33965887
IMR90|chr1:52058810-52058871,chr1,52058810,52058871,IMR90|chr1:12037560-12037643,chr1,12037560,12037643,0,40021250
IMR90|chr1:52074082-52074112,chr1,52074082,52074112,IMR90|chr1:95005629-95005741,chr1,95005629,95005741,0,42931547
IMR90|chr1:52496300-52496372,chr1,52496300,52496372,IMR90|chr1:24972872-24972910,chr1,24972872,24972910,0,27523428
IMR90|chr1:52683078-52683145,chr1,52683078,52683145,IMR90|chr1:151428933-151428993,chr1,151428933,151428993,0,98745855
IMR90|chr1:52716506-52716549,chr1,52716506,52716549,IMR90|chr1:148556691-148556733,chr1,148556691,148556733,0,95840185
IMR90|chr1:52717125-52717174,chr1,52717125,52717174,IMR90|chr1:173831389-173831460,chr1,173831389,173831460,0,121114264
IMR90|chr1:52825817-52825924,chr1,52825817,52825924,IMR90|chr1:27322312-27322394,chr1,27322312,27322394,0,25503505
IMR90|chr1:52868109-52868259,chr1,52868109,52868259,IMR90|chr1:148558223-148558286,chr1,148558223,148558286,0,95690114
IMR90|chr1:52881361-52881407,chr1,52881361,52881407,IMR90|chr1:156086701-156086805,chr1,156086701,156086805,0,103205340
IMR90|chr1:52904918-52904992,chr1,52904918,52904992,IMR90|chr1:85724919-85724954,chr1,85724919,85724954,0,32820001
IMR90|chr1:52924607-52924673,chr1,52924607,52924673,IMR90|chr1:112302480-112302618,chr1,112302480,112302618,0,59377873
IMR90|chr1:52949211-52949271,chr1,52949211,52949271,IMR90|chr1:33818414-33818478,chr1,33818414,33818478,0,19130797
IMR90|chr1:53178868-53178913,chr1,53178868,53178913,IMR90|chr1:205288085-205288193,chr1,205288085,205288193,0,152109217
IMR90|chr1:53248825-53248908,chr1,53248825,53248908,IMR90|chr1:200384029-200384172,chr1,200384029,200384172,0,147135204
IMR90|chr1:53600817-53600867,chr1,53600817,53600867,IMR90|chr1:173445770-173445835,chr1,173445770,173445835,0,119844953
IMR90|chr1:53610984-53611011,chr1,53610984,53611011,IMR90|chr1:40421092-40421197,chr1,40421092,40421197,0,13189892
IMR90|chr1:53671808-53671868,chr1,53671808,53671868,IMR90|chr1:154196609-154196695,chr1,154196609,154196695,0,100524801
IMR90|chr1:53737991-53738018,chr1,53737991,53738018,IMR90|chr1:110158186-110158228,chr1,110158186,110158228,0,56420195
IMR90|chr1:53867225-53867274,chr1,53867225,53867274,IMR90|chr1:148558595-148558696,chr1,148558595,148558696,0,94691370
IMR90|chr1:53995863-53995932,chr1,53995863,53995932,IMR90|chr1:27323394-27323490,chr1,27323394,27323490,0,26672469
IMR90|chr1:54149257-54149329,chr1,54149257,54149329,IMR90|chr1:214722548-214722600,chr1,214722548,214722600,0,160573291
IMR90|chr1:54156560-54156592,chr1,54156560,54156592,IMR90|chr1:54203566-54203716,chr1,54203566,54203716,0,47006
IMR90|chr1:54535217-54535239,chr1,54535217,54535239,IMR90|chr1:148557615-148557676,chr1,148557615,148557676,0,94022398
IMR90|chr1:54679629-54679700,chr1,54679629,54679700,IMR90|chr1:8936920-8937010,chr1,8936920,8937010,0,45742709
IMR90|chr1:54815929-54815967,chr1,54815929,54815967,IMR90|chr1:16479875-16479973,chr1,16479875,16479973,0,38336054
IMR90|chr1:54831600-54831722,chr1,54831600,54831722,IMR90|chr1:150848144-150848172,chr1,150848144,150848172,0,96016544
IMR90|chr1:54832683-54832727,chr1,54832683,54832727,IMR90|chr1:27321407-27321473,chr1,27321407,27321473,0,27511276
IMR90|chr1:54912887-54912932,chr1,54912887,54912932,IMR90|chr1:179111360-179111403,chr1,179111360,179111403,0,124198473
IMR90|chr1:54993376-54993433,chr1,54993376,54993433,IMR90|chr1:203765175-203765226,chr1,203765175,203765226,0,148771799
IMR90|chr1:55220057-55220151,chr1,55220057,55220151,IMR90|chr1:148556133-148556180,chr1,148556133,148556180,0,93336076
IMR90|chr1:55234133-55234182,chr1,55234133,55234182,IMR90|chr1:155024646-155024750,chr1,155024646,155024750,0,99790513
IMR90|chr1:55270189-55270257,chr1,55270189,55270257,IMR90|chr1:1714214-1714244,chr1,1714214,1714244,0,53555975
IMR90|chr1:55358377-55358457,chr1,55358377,55358457,IMR90|chr1:1709363-1709384,chr1,1709363,1709384,0,53649014
IMR90|chr1:55361474-55361534,chr1,55361474,55361534,IMR90|chr1:12041821-12041911,chr1,12041821,12041911,0,43319653
IMR90|chr1:55514247-55514323,chr1,55514247,55514323,IMR90|chr1:148556313-148556458,chr1,148556313,148556458,0,93042066
IMR90|chr1:55518198-55518280,chr1,55518198,55518280,IMR90|chr1:162606170-162606204,chr1,162606170,162606204,0,107087972
IMR90|chr1:55693183-55693249,chr1,55693183,55693249,IMR90|chr1:154530175-154530228,chr1,154530175,154530228,0,98836992
IMR90|chr1:55735226-55735306,chr1,55735226,55735306,IMR90|chr1:110158254-110158313,chr1,110158254,110158313,0,54423028
IMR90|chr1:55759860-55759941,chr1,55759860,55759941,IMR90|chr1:38455059-38455132,chr1,38455059,38455132,0,17304801
IMR90|chr1:55861734-55861851,chr1,55861734,55861851,IMR90|chr1:155881927-155881974,chr1,155881927,155881974,0,100020193
IMR90|chr1:55912751-55912772,chr1,55912751,55912772,IMR90|chr1:205717706-205717800,chr1,205717706,205717800,0,149804955
IMR90|chr1:55937164-55937203,chr1,55937164,55937203,IMR90|chr1:27323884-27323955,chr1,27323884,27323955,0,28613280
IMR90|chr1:56420290-56420369,chr1,56420290,56420369,IMR90|chr1:24968881-24968952,chr1,24968881,24968952,0,31451409
IMR90|chr1:56487222-56487304,chr1,56487222,56487304,IMR90|chr1:156085784-156085817,chr1,156085784,156085817,0,99598562
IMR90|chr1:56533748-56533806,chr1,56533748,56533806,IMR90|chr1:27322728-27322761,chr1,27322728,27322761,0,29211020
IMR90|chr1:56587151-56587266,chr1,56587151,56587266,IMR90|chr1:16089475-16089505,chr1,16089475,16089505,0,40497676
IMR90|chr1:56800384-56800437,chr1,56800384,56800437,IMR90|chr1:8083645-8083725,chr1,8083645,8083725,0,48716739
IMR90|chr1:56852787-56852903,chr1,56852787,56852903,IMR90|chr1:78227455-78227475,chr1,78227455,78227475,0,21374668
IMR90|chr1:57067792-57067863,chr1,57067792,57067863,IMR90|chr1:150546164-150546266,chr1,150546164,150546266,0,93478372
IMR90|chr1:57118088-57118165,chr1,57118088,57118165,IMR90|chr1:78442905-78442960,chr1,78442905,78442960,0,21324817
IMR90|chr1:57217207-57217248,chr1,57217207,57217248,IMR90|chr1:32401156-32401230,chr1,32401156,32401230,0,24816051
IMR90|chr1:57217844-57217884,chr1,57217844,57217884,IMR90|chr1:173827890-173827992,chr1,173827890,173827992,0,116610046
IMR90|chr1:57222539-57222644,chr1,57222539,57222644,IMR90|chr1:1255669-1255713,chr1,1255669,1255713,0,55966870
IMR90|chr1:57258747-57258838,chr1,57258747,57258838,IMR90|chr1:27322363-27322422,chr1,27322363,27322422,0,29936384
IMR90|chr1:57342054-57342095,chr1,57342054,57342095,IMR90|chr1:76254147-76254208,chr1,76254147,76254208,0,18912093
IMR90|chr1:57447262-57447381,chr1,57447262,57447381,IMR90|chr1:94702468-94702554,chr1,94702468,94702554,0,37255206
IMR90|chr1:57610152-57610188,chr1,57610152,57610188,IMR90|chr1:182992242-182992365,chr1,182992242,182992365,0,125382090
IMR90|chr1:57613106-57613220,chr1,57613106,57613220,IMR90|chr1:173442090-173442110,chr1,173442090,173442110,0,115828984
IMR90|chr1:57636538-57636584,chr1,57636538,57636584,IMR90|chr1:227916656-227916729,chr1,227916656,227916729,0,170280118
IMR90|chr1:57807213-57807277,chr1,57807213,57807277,IMR90|chr1:173445770-173445856,chr1,173445770,173445856,0,115638557
IMR90|chr1:57921357-57921440,chr1,57921357,57921440,IMR90|chr1:148556124-148556180,chr1,148556124,148556180,0,90634767
IMR90|chr1:58001235-58001313,chr1,58001235,58001313,IMR90|chr1:64240364-64240433,chr1,64240364,64240433,0,6239129
IMR90|chr1:58068577-58068688,chr1,58068577,58068688,IMR90|chr1:95003775-95003806,chr1,95003775,95003806,0,36935198
IMR90|chr1:58111187-58111261,chr1,58111187,58111261,IMR90|chr1:22376429-22376471,chr1,22376429,22376471,0,35734758
IMR90|chr1:58123858-58123934,chr1,58123858,58123934,IMR90|chr1:173836015-173836065,chr1,173836015,173836065,0,115712157
IMR90|chr1:58537836-58537912,chr1,58537836,58537912,IMR90|chr1:201620360-201620460,chr1,201620360,201620460,0,143082524
IMR90|chr1:58623751-58623805,chr1,58623751,58623805,IMR90|chr1:173445770-173445865,chr1,173445770,173445865,0,114822019
IMR90|chr1:58884757-58884840,chr1,58884757,58884840,IMR90|chr1:43837259-43837327,chr1,43837259,43837327,0,15047498
IMR90|chr1:59078331-59078450,chr1,59078331,59078450,IMR90|chr1:94702468-94702554,chr1,94702468,94702554,0,35624137
IMR90|chr1:59109107-59109154,chr1,59109107,59109154,IMR90|chr1:24068677-24068730,chr1,24068677,24068730,0,35040430
IMR90|chr1:59319185-59319281,chr1,59319185,59319281,IMR90|chr1:148558218-148558286,chr1,148558218,148558286,0,89239033
IMR90|chr1:59549204-59549289,chr1,59549204,59549289,IMR90|chr1:148556310-148556376,chr1,148556310,148556376,0,89007106
IMR90|chr1:59666684-59666800,chr1,59666684,59666800,IMR90|chr1:12037941-12037960,chr1,12037941,12037960,0,47628743
IMR90|chr1:59703927-59703959,chr1,59703927,59703959,IMR90|chr1:95003552-95003632,chr1,95003552,95003632,0,35299625
IMR90|chr1:59741995-59742123,chr1,59741995,59742123,IMR90|chr1:151963626-151963648,chr1,151963626,151963648,0,92221631
IMR90|chr1:59924560-59924635,chr1,59924560,59924635,IMR90|chr1:156253166-156253241,chr1,156253166,156253241,0,96328606
IMR90|chr1:60027961-60028003,chr1,60027961,60028003,IMR90|chr1:33812388-33812496,chr1,33812388,33812496,0,26215573
IMR90|chr1:60048242-60048319,chr1,60048242,60048319,IMR90|chr1:78442905-78442960,chr1,78442905,78442960,0,18394663
IMR90|chr1:60112277-60112316,chr1,60112277,60112316,IMR90|chr1:27323884-27323955,chr1,27323884,27323955,0,32788393
IMR90|chr1:60577344-60577402,chr1,60577344,60577402,IMR90|chr1:57042363-57042383,chr1,57042363,57042383,0,3534981
IMR90|chr1:60618712-60618773,chr1,60618712,60618773,IMR90|chr1:12037560-12037643,chr1,12037560,12037643,0,48581152
IMR90|chr1:60682928-60682992,chr1,60682928,60682992,IMR90|chr1:27323539-27323633,chr1,27323539,27323633,0,33359389
IMR90|chr1:60881512-60881606,chr1,60881512,60881606,IMR90|chr1:2323674-2323720,chr1,2323674,2323720,0,58557838
IMR90|chr1:60951345-60951411,chr1,60951345,60951411,IMR90|chr1:151428933-151428993,chr1,151428933,151428993,0,90477588
IMR90|chr1:61048174-61048275,chr1,61048174,61048275,IMR90|chr1:173445770-173445819,chr1,173445770,173445819,0,112397596
IMR90|chr1:61069475-61069571,chr1,61069475,61069571,IMR90|chr1:173445770-173445839,chr1,173445770,173445839,0,112376295
IMR90|chr1:61144828-61144893,chr1,61144828,61144893,IMR90|chr1:151225291-151225372,chr1,151225291,151225372,0,90080463
IMR90|chr1:61153053-61153102,chr1,61153053,61153102,IMR90|chr1:173831389-173831460,chr1,173831389,173831460,0,112678336
IMR90|chr1:61296059-61296176,chr1,61296059,61296176,IMR90|chr1:219347314-219347352,chr1,219347314,219347352,0,158051255
IMR90|chr1:61360813-61360869,chr1,61360813,61360869,IMR90|chr1:112302467-112302595,chr1,112302467,112302595,0,50941654
IMR90|chr1:61489343-61489422,chr1,61489343,61489422,IMR90|chr1:22380841-22380873,chr1,22380841,22380873,0,39108502
IMR90|chr1:61720283-61720366,chr1,61720283,61720366,IMR90|chr1:54201826-54201925,chr1,54201826,54201925,0,7518457
IMR90|chr1:61986900-61987006,chr1,61986900,61987006,IMR90|chr1:173829408-173829432,chr1,173829408,173829432,0,111842508
IMR90|chr1:62189192-62189338,chr1,62189192,62189338,IMR90|chr1:148558223-148558286,chr1,148558223,148558286,0,86369031
IMR90|chr1:62272139-62272285,chr1,62272139,62272285,IMR90|chr1:27322348-27322427,chr1,27322348,27322427,0,34949791
IMR90|chr1:62279754-62279857,chr1,62279754,62279857,IMR90|chr1:247498524-247498571,chr1,247498524,247498571,0,185218770
IMR90|chr1:62614010-62614074,chr1,62614010,62614074,IMR90|chr1:27321406-27321497,chr1,27321406,27321497,0,35292604
IMR90|chr1:62743472-62743549,chr1,62743472,62743549,IMR90|chr1:38455059-38455132,chr1,38455059,38455132,0,24288413
IMR90|chr1:62845782-62845896,chr1,62845782,62845896,IMR90|chr1:212965674-212965691,chr1,212965674,212965691,0,150119892
IMR90|chr1:62883303-62883379,chr1,62883303,62883379,IMR90|chr1:110160070-110160106,chr1,110160070,110160106,0,47276767
IMR90|chr1:62941941-62942051,chr1,62941941,62942051,IMR90|chr1:24066527-24066564,chr1,24066527,24066564,0,38875414
IMR90|chr1:62995267-62995318,chr1,62995267,62995318,IMR90|chr1:32481719-32481792,chr1,32481719,32481792,0,30513548
IMR90|chr1:63034282-63034343,chr1,63034282,63034343,IMR90|chr1:1820995-1821055,chr1,1820995,1821055,0,61213287
IMR90|chr1:63200641-63200736,chr1,63200641,63200736,IMR90|chr1:173828380-173828444,chr1,173828380,173828444,0,110627739
IMR90|chr1:63696648-63696738,chr1,63696648,63696738,IMR90|chr1:148556145-148556180,chr1,148556145,148556180,0,84859497
IMR90|chr1:63745327-63745371,chr1,63745327,63745371,IMR90|chr1:201620789-201620875,chr1,201620789,201620875,0,137875462
IMR90|chr1:63908297-63908447,chr1,63908297,63908447,IMR90|chr1:148558180-148558286,chr1,148558180,148558286,0,84649883
IMR90|chr1:64013886-64013936,chr1,64013886,64013936,IMR90|chr1:173830841-173830954,chr1,173830841,173830954,0,109816955
IMR90|chr1:64092325-64092380,chr1,64092325,64092380,IMR90|chr1:16302213-16302286,chr1,16302213,16302286,0,47790112
IMR90|chr1:64312292-64312343,chr1,64312292,64312343,IMR90|chr1:27322133-27322232,chr1,27322133,27322232,0,36990159
IMR90|chr1:64637405-64637451,chr1,64637405,64637451,IMR90|chr1:120837872-120837976,chr1,120837872,120837976,0,56200467
IMR90|chr1:64715440-64715537,chr1,64715440,64715537,IMR90|chr1:27321344-27321368,chr1,27321344,27321368,0,37394096
IMR90|chr1:64737792-64737833,chr1,64737792,64737833,IMR90|chr1:95004096-95004170,chr1,95004096,95004170,0,30266304
IMR90|chr1:64906925-64906947,chr1,64906925,64906947,IMR90|chr1:27324398-27324525,chr1,27324398,27324525,0,37582527
IMR90|chr1:65679163-65679218,chr1,65679163,65679218,IMR90|chr1:95005560-95005610,chr1,95005560,95005610,0,29326397
IMR90|chr1:65700138-65700221,chr1,65700138,65700221,IMR90|chr1:221911416-221911435,chr1,221911416,221911435,0,156211278
IMR90|chr1:65954157-65954199,chr1,65954157,65954199,IMR90|chr1:25074422-25074529,chr1,25074422,25074529,0,40879735
IMR90|chr1:66452596-66452711,chr1,66452596,66452711,IMR90|chr1:12037941-12037960,chr1,12037941,12037960,0,54414655
IMR90|chr1:66474794-66474891,chr1,66474794,66474891,IMR90|chr1:223902186-223902267,chr1,223902186,223902267,0,157427392
IMR90|chr1:66479197-66479279,chr1,66479197,66479279,IMR90|chr1:1292611-1292677,chr1,1292611,1292677,0,65186586
IMR90|chr1:66550937-66551082,chr1,66550937,66551082,IMR90|chr1:44396896-44396919,chr1,44396896,44396919,0,22154041
IMR90|chr1:66689187-66689232,chr1,66689187,66689232,IMR90|chr1:24745522-24745589,chr1,24745522,24745589,0,41943665
IMR90|chr1:66709736-66709783,chr1,66709736,66709783,IMR90|chr1:25563127-25563169,chr1,25563127,25563169,0,41146609
IMR90|chr1:66884676-66884719,chr1,66884676,66884719,IMR90|chr1:148556691-148556733,chr1,148556691,148556733,0,81672015
IMR90|chr1:66886803-66886915,chr1,66886803,66886915,IMR90|chr1:95003775-95003806,chr1,95003775,95003806,0,28116972
IMR90|chr1:66978596-66978629,chr1,66978596,66978629,IMR90|chr1:43425601-43425682,chr1,43425601,43425682,0,23552995
IMR90|chr1:67548000-67548070,chr1,67548000,67548070,IMR90|chr1:9194007-9194036,chr1,9194007,9194036,0,58353993
IMR90|chr1:67708364-67708508,chr1,67708364,67708508,IMR90|chr1:24066527-24066564,chr1,24066527,24066564,0,43641837
IMR90|chr1:67794100-67794163,chr1,67794100,67794163,IMR90|chr1:43149374-43149461,chr1,43149374,43149461,0,24644726
IMR90|chr1:67828175-67828252,chr1,67828175,67828252,IMR90|chr1:38455059-38455132,chr1,38455059,38455132,0,29373116
IMR90|chr1:67994711-67994742,chr1,67994711,67994742,IMR90|chr1:213225449-213225500,chr1,213225449,213225500,0,145230738
IMR90|chr1:68031272-68031337,chr1,68031272,68031337,IMR90|chr1:9296188-9296256,chr1,9296188,9296256,0,58735084
IMR90|chr1:68207098-68207173,chr1,68207098,68207173,IMR90|chr1:54406894-54406969,chr1,54406894,54406969,0,13800204
IMR90|chr1:68679487-68679603,chr1,68679487,68679603,IMR90|chr1:247498524-247498571,chr1,247498524,247498571,0,178819037
IMR90|chr1:68832403-68832465,chr1,68832403,68832465,IMR90|chr1:57042661-57042705,chr1,57042661,57042705,0,11789742
IMR90|chr1:68854425-68854454,chr1,68854425,68854454,IMR90|chr1:173830433-173830545,chr1,173830433,173830545,0,104976008
IMR90|chr1:69220796-69220866,chr1,69220796,69220866,IMR90|chr1:8083645-8083725,chr1,8083645,8083725,0,61137151
IMR90|chr1:69426169-69426274,chr1,69426169,69426274,IMR90|chr1:148558179-148558291,chr1,148558179,148558291,0,79132010
IMR90|chr1:69593349-69593428,chr1,69593349,69593428,IMR90|chr1:32477894-32477958,chr1,32477894,32477958,0,37115455
IMR90|chr1:69624413-69624507,chr1,69624413,69624507,IMR90|chr1:148556133-148556180,chr1,148556133,148556180,0,78931720
IMR90|chr1:69654472-69654546,chr1,69654472,69654546,IMR90|chr1:148556134-148556180,chr1,148556134,148556180,0,78901662
IMR90|chr1:69841170-69841320,chr1,69841170,69841320,IMR90|chr1:148558202-148558351,chr1,148558202,148558351,0,78717032
IMR90|chr1:69898072-69898128,chr1,69898072,69898128,IMR90|chr1:21502007-21502081,chr1,21502007,21502081,0,48396065
IMR90|chr1:70033551-70033604,chr1,70033551,70033604,IMR90|chr1:243420113-243420166,chr1,243420113,243420166,0,173386562
IMR90|chr1:70193882-70194032,chr1,70193882,70194032,IMR90|chr1:63156306-63156358,chr1,63156306,63156358,0,7037576
IMR90|chr1:70194248-70194306,chr1,70194248,70194306,IMR90|chr1:33814917-33815067,chr1,33814917,33815067,0,36379331
IMR90|chr1:70276770-70276865,chr1,70276770,70276865,IMR90|chr1:173831991-173832013,chr1,173831991,173832013,0,103555221
IMR90|chr1:70442672-70442704,chr1,70442672,70442704,IMR90|chr1:43425569-43425682,chr1,43425569,43425682,0,27017103
IMR90|chr1:70705173-70705206,chr1,70705173,70705206,IMR90|chr1:33812801-33812902,chr1,33812801,33812902,0,36892372
IMR90|chr1:70795617-70795727,chr1,70795617,70795727,IMR90|chr1:27322083-27322113,chr1,27322083,27322113,0,43473534
IMR90|chr1:71058523-71058640,chr1,71058523,71058640,IMR90|chr1:19811544-19811577,chr1,19811544,19811577,0,51246979
IMR90|chr1:71167715-71167791,chr1,71167715,71167791,IMR90|chr1:39736176-39736247,chr1,39736176,39736247,0,31431539
IMR90|chr1:71810770-71810915,chr1,71810770,71810915,IMR90|chr1:148556476-148556626,chr1,148556476,148556626,0,76745706
IMR90|chr1:71811855-71811886,chr1,71811855,71811886,IMR90|chr1:36788493-36788575,chr1,36788493,36788575,0,35023362
IMR90|chr1:72126271-72126319,chr1,72126271,72126319,IMR90|chr1:182810054-182810095,chr1,182810054,182810095,0,110683783
IMR90|chr1:72130027-72130100,chr1,72130027,72130100,IMR90|chr1:151963735-151963765,chr1,151963735,151963765,0,79833708
IMR90|chr1:72144983-72145058,chr1,72144983,72145058,IMR90|chr1:148558660-148558722,chr1,148558660,148558722,0,76413677
IMR90|chr1:72190098-72190159,chr1,72190098,72190159,IMR90|chr1:1255194-1255236,chr1,1255194,1255236,0,70934904
IMR90|chr1:72345398-72345445,chr1,72345398,72345445,IMR90|chr1:8084794-8084894,chr1,8084794,8084894,0,64260604
IMR90|chr1:72462283-72462305,chr1,72462283,72462305,IMR90|chr1:24972816-24972942,chr1,24972816,24972942,0,47489467
IMR90|chr1:72600395-72600455,chr1,72600395,72600455,IMR90|chr1:43422847-43422882,chr1,43422847,43422882,0,29177548
IMR90|chr1:72723494-72723616,chr1,72723494,72723616,IMR90|chr1:150550504-150550590,chr1,150550504,150550590,0,77827010
IMR90|chr1:72771164-72771247,chr1,72771164,72771247,IMR90|chr1:200384029-200384172,chr1,200384029,200384172,0,127612865
IMR90|chr1:72866392-72866422,chr1,72866392,72866422,IMR90|chr1:173830781-173830869,chr1,173830781,173830869,0,100964389
IMR90|chr1:73124013-73124100,chr1,73124013,73124100,IMR90|chr1:24974523-24974583,chr1,24974523,24974583,0,48149490
IMR90|chr1:73216107-73216187,chr1,73216107,73216187,IMR90|chr1:1709363-1709384,chr1,1709363,1709384,0,71506744
IMR90|chr1:73427936-73428011,chr1,73427936,73428011,IMR90|chr1:104068950-104068979,chr1,104068950,104068979,0,30641014
IMR90|chr1:73513155-73513196,chr1,73513155,73513196,IMR90|chr1:148556153-148556180,chr1,148556153,148556180,0,75042998
IMR90|chr1:73514493-73514578,chr1,73514493,73514578,IMR90|chr1:27321289-27321398,chr1,27321289,27321398,0,46193204
IMR90|chr1:73522788-73522888,chr1,73522788,73522888,IMR90|chr1:173829382-173829432,chr1,173829382,173829432,0,100306594
IMR90|chr1:73765187-73765223,chr1,73765187,73765223,IMR90|chr1:27323768-27323819,chr1,27323768,27323819,0,46441419
IMR90|chr1:73796285-73796375,chr1,73796285,73796375,IMR90|chr1:162469031-162469071,chr1,162469031,162469071,0,88672746
IMR90|chr1:73865937-73865996,chr1,73865937,73865996,IMR90|chr1:39736176-39736247,chr1,39736176,39736247,0,34129761
IMR90|chr1:73900099-73900128,chr1,73900099,73900128,IMR90|chr1:1205326-1205380,chr1,1205326,1205380,0,72694773
IMR90|chr1:73980114-73980158,chr1,73980114,73980158,IMR90|chr1:173831348-173831494,chr1,173831348,173831494,0,99851234
IMR90|chr1:74228146-74228172,chr1,74228146,74228172,IMR90|chr1:160258244-160258305,chr1,160258244,160258305,0,86030098
IMR90|chr1:74521958-74522010,chr1,74521958,74522010,IMR90|chr1:243420113-243420167,chr1,243420113,243420167,0,168898155
IMR90|chr1:74528757-74528832,chr1,74528757,74528832,IMR90|chr1:235291849-235291916,chr1,235291849,235291916,0,160763092
IMR90|chr1:74654108-74654177,chr1,74654108,74654177,IMR90|chr1:16483819-16483907,chr1,16483819,16483907,0,58170289
IMR90|chr1:75081527-75081559,chr1,75081527,75081559,IMR90|chr1:95003552-95003632,chr1,95003552,95003632,0,19922025
IMR90|chr1:75270433-75270471,chr1,75270433,75270471,IMR90|chr1:27322133-27322242,chr1,27322133,27322242,0,47948300
IMR90|chr1:75403979-75404086,chr1,75403979,75404086,IMR90|chr1:148556149-148556180,chr1,148556149,148556180,0,73152170
IMR90|chr1:75598890-75598941,chr1,75598890,75598941,IMR90|chr1:162533461-162533518,chr1,162533461,162533518,0,86934571
IMR90|chr1:75718486-75718633,chr1,75718486,75718633,IMR90|chr1:148560205-148560352,chr1,148560205,148560352,0,72841719
IMR90|chr1:76112776-76112887,chr1,76112776,76112887,IMR90|chr1:63155856-63155895,chr1,63155856,63155895,0,12956920
IMR90|chr1:76245330-76245424,chr1,76245330,76245424,IMR90|chr1:1206366-1206422,chr1,1206366,1206422,0,75038964
IMR90|chr1:76661963-76661998,chr1,76661963,76661998,IMR90|chr1:27323713-27323806,chr1,27323713,27323806,0,49338250
IMR90|chr1:76667765-76667846,chr1,76667765,76667846,IMR90|chr1:173445770-173445819,chr1,173445770,173445819,0,96778005
IMR90|chr1:76937661-76937752,chr1,76937661,76937752,IMR90|chr1:153896379-153896438,chr1,153896379,153896438,0,76958718
IMR90|chr1:77118875-77119025,chr1,77118875,77119025,IMR90|chr1:148560453-148560603,chr1,148560453,148560603,0,71441578
IMR90|chr1:77127876-77127935,chr1,77127876,77127935,IMR90|chr1:39736176-39736247,chr1,39736176,39736247,0,37391700
IMR90|chr1:77175752-77175837,chr1,77175752,77175837,IMR90|chr1:148556310-148556376,chr1,148556310,148556376,0,71380558
IMR90|chr1:77206754-77206797,chr1,77206754,77206797,IMR90|chr1:223901169-223901276,chr1,223901169,223901276,0,146694415
IMR90|chr1:77221448-77221481,chr1,77221448,77221481,IMR90|chr1:43425601-43425682,chr1,43425601,43425682,0,33795847
IMR90|chr1:77290686-77290823,chr1,77290686,77290823,IMR90|chr1:1202058-1202123,chr1,1202058,1202123,0,76088628
IMR90|chr1:77619405-77619476,chr1,77619405,77619476,IMR90|chr1:148556217-148556289,chr1,148556217,148556289,0,70936812
IMR90|chr1:77713126-77713202,chr1,77713126,77713202,IMR90|chr1:76253362-76253386,chr1,76253362,76253386,0,1459764
IMR90|chr1:77895901-77895976,chr1,77895901,77895976,IMR90|chr1:87790692-87790718,chr1,87790692,87790718,0,9894791
IMR90|chr1:78065630-78065685,chr1,78065630,78065685,IMR90|chr1:24066174-24066269,chr1,24066174,24066269,0,53999456
IMR90|chr1:78191908-78191929,chr1,78191908,78191929,IMR90|chr1:180125365-180125432,chr1,180125365,180125432,0,101933457
IMR90|chr1:78581381-78581509,chr1,78581381,78581509,IMR90|chr1:45310665-45310683,chr1,45310665,45310683,0,33270716
IMR90|chr1:78611652-78611726,chr1,78611652,78611726,IMR90|chr1:222881930-222881985,chr1,222881930,222881985,0,144270278
IMR90|chr1:78754565-78754590,chr1,78754565,78754590,IMR90|chr1:150532448-150532496,chr1,150532448,150532496,0,71777883
IMR90|chr1:78831951-78832050,chr1,78831951,78832050,IMR90|chr1:182809335-182809358,chr1,182809335,182809358,0,103977384
IMR90|chr1:78916250-78916335,chr1,78916250,78916335,IMR90|chr1:40508198-40508263,chr1,40508198,40508263,0,38408052
IMR90|chr1:79160264-79160362,chr1,79160264,79160362,IMR90|chr1:173828321-173828353,chr1,173828321,173828353,0,94668057
IMR90|chr1:79283905-79283952,chr1,79283905,79283952,IMR90|chr1:25563127-25563169,chr1,25563127,25563169,0,53720778
IMR90|chr1:79361884-79361992,chr1,79361884,79361992,IMR90|chr1:148556678-148556717,chr1,148556678,148556717,0,69194794
IMR90|chr1:79366590-79366642,chr1,79366590,79366642,IMR90|chr1:173830996-173831105,chr1,173830996,173831105,0,94464406
IMR90|chr1:79483040-79483070,chr1,79483040,79483070,IMR90|chr1:8936517-8936568,chr1,8936517,8936568,0,70546523
IMR90|chr1:79548393-79548422,chr1,79548393,79548422,IMR90|chr1:40421092-40421197,chr1,40421092,40421197,0,39127301
IMR90|chr1:79549435-79549521,chr1,79549435,79549521,IMR90|chr1:67215309-67215341,chr1,67215309,67215341,0,12334126
IMR90|chr1:79690764-79690824,chr1,79690764,79690824,IMR90|chr1:78472831-78472901,chr1,78472831,78472901,0,1217933
IMR90|chr1:79698547-79698609,chr1,79698547,79698609,IMR90|chr1:154958258-154958346,chr1,154958258,154958346,0,75259711
IMR90|chr1:79698984-79699033,chr1,79698984,79699033,IMR90|chr1:183442360-183442416,chr1,183442360,183442416,0,103743376
IMR90|chr1:79710259-79710312,chr1,79710259,79710312,IMR90|chr1:27323540-27323619,chr1,27323540,27323619,0,52386719
IMR90|chr1:80204645-80204712,chr1,80204645,80204712,IMR90|chr1:25074776-25074827,chr1,25074776,25074827,0,55129869
IMR90|chr1:80378665-80378707,chr1,80378665,80378707,IMR90|chr1:148558244-148558283,chr1,148558244,148558283,0,68179579
IMR90|chr1:80401395-80401443,chr1,80401395,80401443,IMR90|chr1:148558160-148558300,chr1,148558160,148558300,0,68156765
IMR90|chr1:80650467-80650488,chr1,80650467,80650488,IMR90|chr1:205717706-205717800,chr1,205717706,205717800,0,125067239
IMR90|chr1:80717303-80717379,chr1,80717303,80717379,IMR90|chr1:150534733-150534780,chr1,150534733,150534780,0,69817430
IMR90|chr1:80873316-80873418,chr1,80873316,80873418,IMR90|chr1:173445770-173445819,chr1,173445770,173445819,0,92572454
IMR90|chr1:80966699-80966762,chr1,80966699,80966762,IMR90|chr1:180126522-180126581,chr1,180126522,180126581,0,99159823
IMR90|chr1:81196586-81196654,chr1,81196586,81196654,IMR90|chr1:1714214-1714244,chr1,1714214,1714244,0,79482372
IMR90|chr1:81260679-81260727,chr1,81260679,81260727,IMR90|chr1:114304363-114304448,chr1,114304363,114304448,0,33043684
IMR90|chr1:81436417-81436501,chr1,81436417,81436501,IMR90|chr1:67215310-67215341,chr1,67215310,67215341,0,14221107
IMR90|chr1:81500781-81500864,chr1,81500781,81500864,IMR90|chr1:148556124-148556180,chr1,148556124,148556180,0,67055343
IMR90|chr1:81531797-81531947,chr1,81531797,81531947,IMR90|chr1:148558551-148558601,chr1,148558551,148558601,0,67026754
IMR90|chr1:81668139-81668188,chr1,81668139,81668188,IMR90|chr1:203599038-203599139,chr1,203599038,203599139,0,121930899
IMR90|chr1:81800398-81800451,chr1,81800398,81800451,IMR90|chr1:150550983-150551045,chr1,150550983,150551045,0,68750585
IMR90|chr1:81898935-81899007,chr1,81898935,81899007,IMR90|chr1:27322227-27322305,chr1,27322227,27322305,0,54576708
IMR90|chr1:82149787-82149820,chr1,82149787,82149820,IMR90|chr1:1715650-1715774,chr1,1715650,1715774,0,80434137
IMR90|chr1:82184172-82184213,chr1,82184172,82184213,IMR90|chr1:27321825-27321925,chr1,27321825,27321925,0,54862347
IMR90|chr1:82434293-82434319,chr1,82434293,82434319,IMR90|chr1:2323403-2323527,chr1,2323403,2323527,0,80110890
IMR90|chr1:82505895-82505971,chr1,82505895,82505971,IMR90|chr1:219348136-219348172,chr1,219348136,219348172,0,136842241
IMR90|chr1:82537023-82537144,chr1,82537023,82537144,IMR90|chr1:180470505-180470553,chr1,180470505,180470553,0,97933482
IMR90|chr1:82984239-82984305,chr1,82984239,82984305,IMR90|chr1:151428933-151428993,chr1,151428933,151428993,0,68444694
IMR90|chr1:82998103-82998173,chr1,82998103,82998173,IMR90|chr1:12041831-12041911,chr1,12041831,12041911,0,70956272
IMR90|chr1:83047801-83047881,chr1,83047801,83047881,IMR90|chr1:179048012-179048049,chr1,179048012,179048049,0,96000211
IMR90|chr1:83145674-83145765,chr1,83145674,83145765,IMR90|chr1:78471894-78471990,chr1,78471894,78471990,0,4673780
IMR90|chr1:83310786-83310864,chr1,83310786,83310864,IMR90|chr1:148556134-148556180,chr1,148556134,148556180,0,65245348
IMR90|chr1:83460105-83460131,chr1,83460105,83460131,IMR90|chr1:44441395-44441480,chr1,44441395,44441480,0,39018710
IMR90|chr1:83754574-83754626,chr1,83754574,83754626,IMR90|chr1:114303265-114303363,chr1,114303265,114303363,0,30548691
IMR90|chr1:84006981-84007057,chr1,84006981,84007057,IMR90|chr1:148556141-148556180,chr1,148556141,148556180,0,64549160
IMR90|chr1:84064746-84064841,chr1,84064746,84064841,IMR90|chr1:173832265-173832320,chr1,173832265,173832320,0,89767519
IMR90|chr1:84145569-84145648,chr1,84145569,84145648,IMR90|chr1:173836013-173836060,chr1,173836013,173836060,0,89690444
IMR90|chr1:84164245-84164395,chr1,84164245,84164395,IMR90|chr1:148556288-148556438,chr1,148556288,148556438,0,64392043
IMR90|chr1:84174162-84174268,chr1,84174162,84174268,IMR90|chr1:33167689-33167732,chr1,33167689,33167732,0,51006473
IMR90|chr1:84295612-84295684,chr1,84295612,84295684,IMR90|chr1:22382044-22382121,chr1,22382044,22382121,0,61913568
IMR90|chr1:84417773-84417849,chr1,84417773,84417849,IMR90|chr1:36027532-36027582,chr1,36027532,36027582,0,48390241
IMR90|chr1:84463521-84463665,chr1,84463521,84463665,IMR90|chr1:148556739-148556810,chr1,148556739,148556810,0,64093218
IMR90|chr1:84551438-84551491,chr1,84551438,84551491,IMR90|chr1:150550983-150551045,chr1,150550983,150551045,0,65999545
IMR90|chr1:84639988-84640056,chr1,84639988,84640056,IMR90|chr1:148556135-148556180,chr1,148556135,148556180,0,63916147
IMR90|chr1:84788947-84789092,chr1,84788947,84789092,IMR90|chr1:148558160-148558300,chr1,148558160,148558300,0,63769213
IMR90|chr1:84799602-84799645,chr1,84799602,84799645,IMR90|chr1:161086759-161086866,chr1,161086759,161086866,0,76287157
IMR90|chr1:84841166-84841220,chr1,84841166,84841220,IMR90|chr1:78471894-78471990,chr1,78471894,78471990,0,6369272
IMR90|chr1:84861031-84861102,chr1,84861031,84861102,IMR90|chr1:8936920-8937010,chr1,8936920,8937010,0,75924111
IMR90|chr1:84982103-84982144,chr1,84982103,84982144,IMR90|chr1:113247346-113247398,chr1,113247346,113247398,0,28265243
IMR90|chr1:85145314-85145429,chr1,85145314,85145429,IMR90|chr1:27150392-27150428,chr1,27150392,27150428,0,57994922
IMR90|chr1:85183621-85183749,chr1,85183621,85183749,IMR90|chr1:45310665-45310683,chr1,45310665,45310683,0,39872956
IMR90|chr1:85293888-85293920,chr1,85293888,85293920,IMR90|chr1:43425569-43425682,chr1,43425569,43425682,0,41868319
IMR90|chr1:85344682-85344792,chr1,85344682,85344792,IMR90|chr1:27323962-27324002,chr1,27323962,27324002,0,58020720
IMR90|chr1:85417005-85417061,chr1,85417005,85417061,IMR90|chr1:24974523-24974583,chr1,24974523,24974583,0,60442482
IMR90|chr1:85623795-85623931,chr1,85623795,85623931,IMR90|chr1:173445770-173445789,chr1,173445770,173445789,0,87821975
IMR90|chr1:85972894-85972956,chr1,85972894,85972956,IMR90|chr1:95006991-95007129,chr1,95006991,95007129,0,9034097
IMR90|chr1:86362512-86362562,chr1,86362512,86362562,IMR90|chr1:7834703-7834748,chr1,7834703,7834748,0,78527809
IMR90|chr1:86381413-86381518,chr1,86381413,86381518,IMR90|chr1:24067913-24068063,chr1,24067913,24068063,0,62313500
IMR90|chr1:86405543-86405574,chr1,86405543,86405574,IMR90|chr1:95003647-95003694,chr1,95003647,95003694,0,8598104
IMR90|chr1:86455607-86455757,chr1,86455607,86455757,IMR90|chr1:27323900-27323926,chr1,27323900,27323926,0,59131707
IMR90|chr1:86615274-86615418,chr1,86615274,86615418,IMR90|chr1:24066527-24066564,chr1,24066527,24066564,0,62548747
IMR90|chr1:86792277-86792299,chr1,86792277,86792299,IMR90|chr1:95006659-95006685,chr1,95006659,95006685,0,8214382
IMR90|chr1:87007839-87007989,chr1,87007839,87007989,IMR90|chr1:19813989-19814048,chr1,19813989,19814048,0,67193850
IMR90|chr1:87169999-87170068,chr1,87169999,87170068,IMR90|chr1:16483819-16483907,chr1,16483819,16483907,0,70686180
IMR90|chr1:87256168-87256217,chr1,87256168,87256217,IMR90|chr1:27324256-27324374,chr1,27324256,27324374,0,59931912
IMR90|chr1:87306820-87306845,chr1,87306820,87306845,IMR90|chr1:44441395-44441480,chr1,44441395,44441480,0,42865425
IMR90|chr1:87427150-87427226,chr1,87427150,87427226,IMR90|chr1:148556141-148556180,chr1,148556141,148556180,0,61128991
IMR90|chr1:87790421-87790505,chr1,87790421,87790505,IMR90|chr1:173441697-173441747,chr1,173441697,173441747,0,85651276
IMR90|chr1:88040656-88040766,chr1,88040656,88040766,IMR90|chr1:27322083-27322113,chr1,27322083,27322113,0,60718573
IMR90|chr1:88050217-88050301,chr1,88050217,88050301,IMR90|chr1:42799717-42799734,chr1,42799717,42799734,0,45250500
IMR90|chr1:88062787-88062862,chr1,88062787,88062862,IMR90|chr1:148559562-148559709,chr1,148559562,148559709,0,60496775
IMR90|chr1:88171522-88171576,chr1,88171522,88171576,IMR90|chr1:78471894-78471990,chr1,78471894,78471990,0,9699628
IMR90|chr1:88183578-88183621,chr1,88183578,88183621,IMR90|chr1:33813881-33813977,chr1,33813881,33813977,0,54369697
IMR90|chr1:88189802-88189899,chr1,88189802,88189899,IMR90|chr1:148556217-148556367,chr1,148556217,148556367,0,60366415
IMR90|chr1:88380537-88380630,chr1,88380537,88380630,IMR90|chr1:26147788-26147809,chr1,26147788,26147809,0,62232749
IMR90|chr1:88412897-88412988,chr1,88412897,88412988,IMR90|chr1:114303265-114303363,chr1,114303265,114303363,0,25890368
IMR90|chr1:88577292-88577338,chr1,88577292,88577338,IMR90|chr1:27323730-27323795,chr1,27323730,27323795,0,61253562
IMR90|chr1:89204415-89204506,chr1,89204415,89204506,IMR90|chr1:19811544-19811577,chr1,19811544,19811577,0,69392871
IMR90|chr1:89464805-89464828,chr1,89464805,89464828,IMR90|chr1:182993599-182993657,chr1,182993599,182993657,0,93528794
IMR90|chr1:89468998-89469048,chr1,89468998,89469048,IMR90|chr1:1241898-1241976,chr1,1241898,1241976,0,88227100
IMR90|chr1:89578896-89578973,chr1,89578896,89578973,IMR90|chr1:150550114-150550170,chr1,150550114,150550170,0,60971218
IMR90|chr1:89595368-89595443,chr1,89595368,89595443,IMR90|chr1:235291849-235291916,chr1,235291849,235291916,0,145696481
IMR90|chr1:89600903-89600948,chr1,89600903,89600948,IMR90|chr1:179111360-179111403,chr1,179111360,179111403,0,89510457
IMR90|chr1:89783364-89783489,chr1,89783364,89783489,IMR90|chr1:1259323-1259348,chr1,1259323,1259348,0,88524041
IMR90|chr1:89805369-89805519,chr1,89805369,89805519,IMR90|chr1:148560400-148560550,chr1,148560400,148560550,0,58755031
IMR90|chr1:89837850-89837951,chr1,89837850,89837951,IMR90|chr1:247499893-247499945,chr1,247499893,247499945,0,157662043
IMR90|chr1:89932270-89932346,chr1,89932270,89932346,IMR90|chr1:110282718-110282753,chr1,110282718,110282753,0,20350448
IMR90|chr1:89971684-89971798,chr1,89971684,89971798,IMR90|chr1:54202144-54202180,chr1,54202144,54202180,0,35769540
IMR90|chr1:90331730-90331756,chr1,90331730,90331756,IMR90|chr1:1204953-1205100,chr1,1204953,1205100,0,89126777
IMR90|chr1:90421298-90421393,chr1,90421298,90421393,IMR90|chr1:173832265-173832320,chr1,173832265,173832320,0,83410967
IMR90|chr1:90551423-90551466,chr1,90551423,90551466,IMR90|chr1:32167805-32167863,chr1,32167805,32167863,0,58383618
IMR90|chr1:90572898-90572955,chr1,90572898,90572955,IMR90|chr1:173445770-173445839,chr1,173445770,173445839,0,82872872
IMR90|chr1:90760168-90760268,chr1,90760168,90760268,IMR90|chr1:155881927-155881974,chr1,155881927,155881974,0,65121759
IMR90|chr1:90786835-90786950,chr1,90786835,90786950,IMR90|chr1:12037941-12037960,chr1,12037941,12037960,0,78748894
IMR90|chr1:90906737-90906817,chr1,90906737,90906817,IMR90|chr1:24066936-24067026,chr1,24066936,24067026,0,66839801
IMR90|chr1:90974793-90974864,chr1,90974793,90974864,IMR90|chr1:25074776-25074827,chr1,25074776,25074827,0,65900017
IMR90|chr1:91167535-91167581,chr1,91167535,91167581,IMR90|chr1:112939426-112939561,chr1,112939426,112939561,0,21771891
IMR90|chr1:91274710-91274788,chr1,91274710,91274788,IMR90|chr1:94703687-94703756,chr1,94703687,94703756,0,3428977
IMR90|chr1:91288671-91288760,chr1,91288671,91288760,IMR90|chr1:162469031-162469071,chr1,162469031,162469071,0,71180360
IMR90|chr1:91546165-91546241,chr1,91546165,91546241,IMR90|chr1:110160070-110160106,chr1,110160070,110160106,0,18613905
IMR90|chr1:91793128-91793178,chr1,91793128,91793178,IMR90|chr1:173445770-173445835,chr1,173445770,173445835,0,81652642
IMR90|chr1:91884471-91884567,chr1,91884471,91884567,IMR90|chr1:214725857-214725909,chr1,214725857,214725909,0,122841386
IMR90|chr1:92139450-92139512,chr1,92139450,92139512,IMR90|chr1:57042661-57042705,chr1,57042661,57042705,0,35096789
IMR90|chr1:92189290-92189373,chr1,92189290,92189373,IMR90|chr1:25074383-25074420,chr1,25074383,25074420,0,67114907
IMR90|chr1:92212098-92212229,chr1,92212098,92212229,IMR90|chr1:148560416-148560566,chr1,148560416,148560566,0,56348318
IMR90|chr1:92434777-92434849,chr1,92434777,92434849,IMR90|chr1:27322227-27322305,chr1,27322227,27322305,0,65112550
IMR90|chr1:92476620-92476770,chr1,92476620,92476770,IMR90|chr1:148558239-148558286,chr1,148558239,148558286,0,56081619
IMR90|chr1:92492862-92493012,chr1,92492862,92493012,IMR90|chr1:148559593-148559743,chr1,148559593,148559743,0,56066731
IMR90|chr1:92557955-92557993,chr1,92557955,92557993,IMR90|chr1:95005198-95005223,chr1,95005198,95005223,0,2447243
IMR90|chr1:92649192-92649340,chr1,92649192,92649340,IMR90|chr1:148558190-148558334,chr1,148558190,148558334,0,55908998
IMR90|chr1:92694283-92694400,chr1,92694283,92694400,IMR90|chr1:201708065-201708092,chr1,201708065,201708092,0,109013782
IMR90|chr1:92798522-92798591,chr1,92798522,92798591,IMR90|chr1:95003552-95003632,chr1,95003552,95003632,0,2205030
IMR90|chr1:92802516-92802613,chr1,92802516,92802613,IMR90|chr1:8083490-8083537,chr1,8083490,8083537,0,84719026
IMR90|chr1:92971903-92971948,chr1,92971903,92971948,IMR90|chr1:27322903-27322930,chr1,27322903,27322930,0,65649000
IMR90|chr1:93320584-93320630,chr1,93320584,93320630,IMR90|chr1:150546164-150546266,chr1,150546164,150546266,0,57225580
IMR90|chr1:93334406-93334515,chr1,93334406,93334515,IMR90|chr1:29064950-29064979,chr1,29064950,29064979,0,64269456
IMR90|chr1:93475933-93475981,chr1,93475933,93475981,IMR90|chr1:202112228-202112312,chr1,202112228,202112312,0,108636295
IMR90|chr1:93814457-93814537,chr1,93814457,93814537,IMR90|chr1:19814850-19814881,chr1,19814850,19814881,0,73999607
IMR90|chr1:93835760-93835793,chr1,93835760,93835793,IMR90|chr1:93299601-93299678,chr1,93299601,93299678,0,536159
IMR90|chr1:93948212-93948308,chr1,93948212,93948308,IMR90|chr1:182809177-182809215,chr1,182809177,182809215,0,88860965
IMR90|chr1:93989907-93989946,chr1,93989907,93989946,IMR90|chr1:173827756-173827844,chr1,173827756,173827844,0,79837849
IMR90|chr1:94185386-94185481,chr1,94185386,94185481,IMR90|chr1:173831991-173832013,chr1,173831991,173832013,0,79646605
IMR90|chr1:94342354-94342402,chr1,94342354,94342402,IMR90|chr1:27322133-27322232,chr1,27322133,27322232,0,67020221
IMR90|chr1:94379296-94379386,chr1,94379296,94379386,IMR90|chr1:162469031-162469071,chr1,162469031,162469071,0,68089735
IMR90|chr1:94397329-94397408,chr1,94397329,94397408,IMR90|chr1:173446118-173446148,chr1,173446118,173446148,0,79048789
IMR90|chr1:94404885-94404931,chr1,94404885,94404931,IMR90|chr1:155024646-155024750,chr1,155024646,155024750,0,60619761
IMR90|chr1:94541824-94541945,chr1,94541824,94541945,IMR90|chr1:148556231-148556269,chr1,148556231,148556269,0,54014407
IMR90|chr1:94594182-94594237,chr1,94594182,94594237,IMR90|chr1:114302851-114302946,chr1,114302851,114302946,0,19708669
IMR90|chr1:94603075-94603145,chr1,94603075,94603145,IMR90|chr1:219348136-219348172,chr1,219348136,219348172,0,124745061
IMR90|chr1:94769106-94769188,chr1,94769106,94769188,IMR90|chr1:23038661-23038694,chr1,23038661,23038694,0,71730445
IMR90|chr1:94798580-94798660,chr1,94798580,94798660,IMR90|chr1:179048012-179048049,chr1,179048012,179048049,0,84249432
IMR90|chr1:94845086-94845228,chr1,94845086,94845228,IMR90|chr1:25561485-25561513,chr1,25561485,25561513,0,69283601
IMR90|chr1:94846775-94846840,chr1,94846775,94846840,IMR90|chr1:151225291-151225372,chr1,151225291,151225372,0,56378516
IMR90|chr1:94993501-94993527,chr1,94993501,94993527,IMR90|chr1:44441395-44441480,chr1,44441395,44441480,0,50552106
IMR90|chr1:95001578-95001636,chr1,95001578,95001636,IMR90|chr1:162533461-162533518,chr1,162533461,162533518,0,67531883
IMR90|chr1:95118003-95118130,chr1,95118003,95118130,IMR90|chr1:173445770-173445790,chr1,173445770,173445790,0,78327767
IMR90|chr1:95152951-95152969,chr1,95152951,95152969,IMR90|chr1:27323908-27324058,chr1,27323908,27324058,0,67829043
IMR90|chr1:95308910-95309002,chr1,95308910,95309002,IMR90|chr1:173445770-173445808,chr1,173445770,173445808,0,78136860
IMR90|chr1:95983359-95983431,chr1,95983359,95983431,IMR90|chr1:173445770-173445845,chr1,173445770,173445845,0,77462411
IMR90|chr1:96056002-96056105,chr1,96056002,96056105,IMR90|chr1:27324051-27324080,chr1,27324051,27324080,0,68731951
IMR90|chr1:96215606-96215679,chr1,96215606,96215679,IMR90|chr1:150126479-150126523,chr1,150126479,150126523,0,53910873
IMR90|chr1:96254489-96254612,chr1,96254489,96254612,IMR90|chr1:148556703-148556810,chr1,148556703,148556810,0,52302214
IMR90|chr1:96272521-96272624,chr1,96272521,96272624,IMR90|chr1:24065933-24065972,chr1,24065933,24065972,0,72206588
IMR90|chr1:96345993-96346087,chr1,96345993,96346087,IMR90|chr1:33812388-33812496,chr1,33812388,33812496,0,62533605
IMR90|chr1:96466142-96466204,chr1,96466142,96466204,IMR90|chr1:29507193-29507231,chr1,29507193,29507231,0,66958949
IMR90|chr1:97431657-97431727,chr1,97431657,97431727,IMR90|chr1:150546164-150546266,chr1,150546164,150546266,0,53114507
IMR90|chr1:97700376-97700526,chr1,97700376,97700526,IMR90|chr1:46597443-46597471,chr1,46597443,46597471,0,51102933
IMR90|chr1:97839562-97839597,chr1,97839562,97839597,IMR90|chr1:156089263-156089359,chr1,156089263,156089359,0,58249701
IMR90|chr1:97863771-97863853,chr1,97863771,97863853,IMR90|chr1:224620980-224621012,chr1,224620980,224621012,0,126757209
IMR90|chr1:97864194-97864308,chr1,97864194,97864308,IMR90|chr1:212965674-212965691,chr1,212965674,212965691,0,115101480
IMR90|chr1:98109341-98109437,chr1,98109341,98109437,IMR90|chr1:182809177-182809215,chr1,182809177,182809215,0,84699836
IMR90|chr1:98112996-98113045,chr1,98112996,98113045,IMR90|chr1:148558595-148558696,chr1,148558595,148558696,0,50445599
IMR90|chr1:98443687-98443837,chr1,98443687,98443837,IMR90|chr1:8085007-8085037,chr1,8085007,8085037,0,90358680
IMR90|chr1:98585428-98585467,chr1,98585428,98585467,IMR90|chr1:28558788-28558899,chr1,28558788,28558899,0,70026640
IMR90|chr1:99267661-99267790,chr1,99267661,99267790,IMR90|chr1:104068950-104068980,chr1,104068950,104068980,0,4801289
IMR90|chr1:99485500-99485585,chr1,99485500,99485585,IMR90|chr1:247498734-247498760,chr1,247498734,247498760,0,148013234
IMR90|chr1:99532090-99532173,chr1,99532090,99532173,IMR90|chr1:221911416-221911435,chr1,221911416,221911435,0,122379326
IMR90|chr1:99829234-99829255,chr1,99829234,99829255,IMR90|chr1:114304363-114304448,chr1,114304363,114304448,0,14475129
IMR90|chr1:99889116-99889216,chr1,99889116,99889216,IMR90|chr1:148556153-148556180,chr1,148556153,148556180,0,48667037
IMR90|chr1:99984249-99984334,chr1,99984249,99984334,IMR90|chr1:1311281-1311334,chr1,1311281,1311334,0,98672968
IMR90|chr1:100378904-100378969,chr1,100378904,100378969,IMR90|chr1:156086701-156086805,chr1,156086701,156086805,0,55707797
IMR90|chr1:100578373-100578448,chr1,100578373,100578448,IMR90|chr1:148558660-148558722,chr1,148558660,148558722,0,47980287
IMR90|chr1:100623582-100623617,chr1,100623582,100623617,IMR90|chr1:38459894-38459983,chr1,38459894,38459983,0,62163688
IMR90|chr1:100667489-100667600,chr1,100667489,100667600,IMR90|chr1:148556678-148556717,chr1,148556678,148556717,0,47889189
IMR90|chr1:100748385-100748468,chr1,100748385,100748468,IMR90|chr1:54201826-54201925,chr1,54201826,54201925,0,46546559
IMR90|chr1:100833175-100833325,chr1,100833175,100833325,IMR90|chr1:148558233-148558286,chr1,148558233,148558286,0,47725058
IMR90|chr1:100949074-100949130,chr1,100949074,100949130,IMR90|chr1:12037560-12037643,chr1,12037560,12037643,0,88911514
IMR90|chr1:100992883-100993001,chr1,100992883,100993001,IMR90|chr1:112302487-112302617,chr1,112302487,112302617,0,11309604
IMR90|chr1:101033097-101033179,chr1,101033097,101033179,IMR90|chr1:224620980-224621012,chr1,224620980,224621012,0,123587883
IMR90|chr1:101056523-101056586,chr1,101056523,101056586,IMR90|chr1:43149374-43149461,chr1,43149374,43149461,0,57907149
IMR90|chr1:101105030-101105120,chr1,101105030,101105120,IMR90|chr1:43837387-43837446,chr1,43837387,43837446,0,57267643
IMR90|chr1:101188561-101188709,chr1,101188561,101188709,IMR90|chr1:1255670-1255710,chr1,1255670,1255710,0,99932891
IMR90|chr1:101575528-101575592,chr1,101575528,101575592,IMR90|chr1:27321406-27321497,chr1,27321406,27321497,0,74254122
IMR90|chr1:101705886-101705917,chr1,101705886,101705917,IMR90|chr1:91360247-91360295,chr1,91360247,91360295,0,10345639
IMR90|chr1:101706316-101706414,chr1,101706316,101706414,IMR90|chr1:247495583-247495609,chr1,247495583,247495609,0,145789267
IMR90|chr1:101788302-101788395,chr1,101788302,101788395,IMR90|chr1:173986948-173986990,chr1,173986948,173986990,0,72198646
IMR90|chr1:101887400-101887458,chr1,101887400,101887458,IMR90|chr1:162602439-162602530,chr1,162602439,162602530,0,60715039
IMR90|chr1:102088806-102088857,chr1,102088806,102088857,IMR90|chr1:162533461-162533518,chr1,162533461,162533518,0,60444655
IMR90|chr1:102099752-102099787,chr1,102099752,102099787,IMR90|chr1:38459894-38459983,chr1,38459894,38459983,0,63639858
IMR90|chr1:102477733-102477784,chr1,102477733,102477784,IMR90|chr1:200639527-200639605,chr1,200639527,200639605,0,98161794
IMR90|chr1:102591034-102591085,chr1,102591034,102591085,IMR90|chr1:148557503-148557620,chr1,148557503,148557620,0,45966469
IMR90|chr1:102661593-102661731,chr1,102661593,102661731,IMR90|chr1:27323962-27324002,chr1,27323962,27324002,0,75337631
IMR90|chr1:102799269-102799354,chr1,102799269,102799354,IMR90|chr1:156085784-156085817,chr1,156085784,156085817,0,53286515
IMR90|chr1:102848634-102848729,chr1,102848634,102848729,IMR90|chr1:15481761-15481812,chr1,15481761,15481812,0,87366873
IMR90|chr1:102885197-102885248,chr1,102885197,102885248,IMR90|chr1:200639527-200639605,chr1,200639527,200639605,0,97754330
IMR90|chr1:103019742-103019860,chr1,103019742,103019860,IMR90|chr1:223901424-223901450,chr1,223901424,223901450,0,120881682
IMR90|chr1:103213799-103213915,chr1,103213799,103213915,IMR90|chr1:173445770-173445801,chr1,173445770,173445801,0,70231971
IMR90|chr1:103316807-103316854,chr1,103316807,103316854,IMR90|chr1:120189024-120189123,chr1,120189024,120189123,0,16872217
IMR90|chr1:103410548-103410606,chr1,103410548,103410606,IMR90|chr1:9190714-9190814,chr1,9190714,9190814,0,94219834
IMR90|chr1:103417043-103417193,chr1,103417043,103417193,IMR90|chr1:148558224-148558286,chr1,148558224,148558286,0,45141181
IMR90|chr1:103432579-103432674,chr1,103432579,103432674,IMR90|chr1:27323761-27323794,chr1,27323761,27323794,0,76108818
IMR90|chr1:103490167-103490218,chr1,103490167,103490218,IMR90|chr1:32568964-32569063,chr1,32568964,32569063,0,70921203
IMR90|chr1:103504785-103504892,chr1,103504785,103504892,IMR90|chr1:16485516-16485545,chr1,16485516,16485545,0,87019269
IMR90|chr1:103694458-103694541,chr1,103694458,103694541,IMR90|chr1:27323912-27324052,chr1,27323912,27324052,0,76370546
IMR90|chr1:103951728-103951813,chr1,103951728,103951813,IMR90|chr1:33938332-33938365,chr1,33938332,33938365,0,70013396
IMR90|chr1:104029470-104029619,chr1,104029470,104029619,IMR90|chr1:148558154-148558286,chr1,148558154,148558286,0,44528684
IMR90|chr1:104242558-104242637,chr1,104242558,104242637,IMR90|chr1:32477894-32477958,chr1,32477894,32477958,0,71764664
IMR90|chr1:104444314-104444374,chr1,104444314,104444374,IMR90|chr1:43422847-43422882,chr1,43422847,43422882,0,61021467
IMR90|chr1:104481117-104481168,chr1,104481117,104481168,IMR90|chr1:33501974-33502007,chr1,33501974,33502007,0,70979143
IMR90|chr1:104552216-104552241,chr1,104552216,104552241,IMR90|chr1:42800126-42800256,chr1,42800126,42800256,0,61752090
IMR90|chr1:104822345-104822440,chr1,104822345,104822440,IMR90|chr1:27323761-27323794,chr1,27323761,27323794,0,77498584
IMR90|chr1:104858368-104858406,chr1,104858368,104858406,IMR90|chr1:52832302-52832380,chr1,52832302,52832380,0,52026066
IMR90|chr1:105225689-105225754,chr1,105225689,105225754,IMR90|chr1:8936518-8936542,chr1,8936518,8936542,0,96289171
IMR90|chr1:105242422-105242517,chr1,105242422,105242517,IMR90|chr1:15481761-15481812,chr1,15481761,15481812,0,89760661
IMR90|chr1:105252929-105252987,chr1,105252929,105252987,IMR90|chr1:27322431-27322483,chr1,27322431,27322483,0,77930498
IMR90|chr1:105414523-105414555,chr1,105414523,105414555,IMR90|chr1:93300048-93300114,chr1,93300048,93300114,0,12114475
IMR90|chr1:105437423-105437573,chr1,105437423,105437573,IMR90|chr1:148558160-148558306,chr1,148558160,148558306,0,43120737
IMR90|chr1:105589982-105590084,chr1,105589982,105590084,IMR90|chr1:27322294-27322382,chr1,27322294,27322382,0,78267688
IMR90|chr1:105618835-105618887,chr1,105618835,105618887,IMR90|chr1:243420113-243420167,chr1,243420113,243420167,0,137801278
IMR90|chr1:105826650-105826761,chr1,105826650,105826761,IMR90|chr1:148556678-148556717,chr1,148556678,148556717,0,42730028
IMR90|chr1:105912582-105912693,chr1,105912582,105912693,IMR90|chr1:95003775-95003806,chr1,95003775,95003806,0,10908807
IMR90|chr1:106102285-106102386,chr1,106102285,106102386,IMR90|chr1:243416615-243416651,chr1,243416615,243416651,0,137314330
IMR90|chr1:106203219-106203244,chr1,106203219,106203244,IMR90|chr1:44441395-44441480,chr1,44441395,44441480,0,61761824
IMR90|chr1:106219250-106219291,chr1,106219250,106219291,IMR90|chr1:8936901-8936931,chr1,8936901,8936931,0,97282349
IMR90|chr1:106381438-106381500,chr1,106381438,106381500,IMR90|chr1:148556220-148556273,chr1,148556220,148556273,0,42174782
IMR90|chr1:106406570-106406657,chr1,106406570,106406657,IMR90|chr1:24974523-24974583,chr1,24974523,24974583,0,81432047
IMR90|chr1:106503881-106504021,chr1,106503881,106504021,IMR90|chr1:16485516-16485545,chr1,16485516,16485545,0,90018365
IMR90|chr1:106607246-106607373,chr1,106607246,106607373,IMR90|chr1:151963626-151963648,chr1,151963626,151963648,0,45356380
IMR90|chr1:106697552-106697596,chr1,106697552,106697596,IMR90|chr1:173831389-173831460,chr1,173831389,173831460,0,67133837
IMR90|chr1:106912635-106912724,chr1,106912635,106912724,IMR90|chr1:203597399-203597440,chr1,203597399,203597440,0,96684764
IMR90|chr1:107019462-107019505,chr1,107019462,107019505,IMR90|chr1:57042363-57042383,chr1,57042363,57042383,0,49977099
IMR90|chr1:107032178-107032286,chr1,107032178,107032286,IMR90|chr1:57043981-57044010,chr1,57043981,57044010,0,49988197
IMR90|chr1:107401946-107402018,chr1,107401946,107402018,IMR90|chr1:110282718-110282753,chr1,110282718,110282753,0,2880772
IMR90|chr1:107406108-107406201,chr1,107406108,107406201,IMR90|chr1:173445770-173445790,chr1,173445770,173445790,0,66039662
IMR90|chr1:107458619-107458675,chr1,107458619,107458675,IMR90|chr1:203765175-203765226,chr1,203765175,203765226,0,96306556
IMR90|chr1:107528862-107529009,chr1,107528862,107529009,IMR90|chr1:173830748-173830859,chr1,173830748,173830859,0,66301886
IMR90|chr1:107643700-107643732,chr1,107643700,107643732,IMR90|chr1:95003647-95003695,chr1,95003647,95003695,0,12640053
IMR90|chr1:107643908-107643980,chr1,107643908,107643980,IMR90|chr1:38257546-38257602,chr1,38257546,38257602,0,69386362
IMR90|chr1:107733923-107734015,chr1,107733923,107734015,IMR90|chr1:161118705-161118748,chr1,161118705,161118748,0,53384782
IMR90|chr1:107883466-107883582,chr1,107883466,107883582,IMR90|chr1:40508198-40508263,chr1,40508198,40508263,0,67375268
IMR90|chr1:107919553-107919595,chr1,107919553,107919595,IMR90|chr1:148558244-148558283,chr1,148558244,148558283,0,40638691
IMR90|chr1:107990725-107990760,chr1,107990725,107990760,IMR90|chr1:2323403-2323527,chr1,2323403,2323527,0,105667322
IMR90|chr1:107993493-107993551,chr1,107993493,107993551,IMR90|chr1:27322728-27322761,chr1,27322728,27322761,0,80670765
IMR90|chr1:108410257-108410339,chr1,108410257,108410339,IMR90|chr1:32480002-32480064,chr1,32480002,32480064,0,75930255
IMR90|chr1:108500207-108500247,chr1,108500207,108500247,IMR90|chr1:173827890-173827992,chr1,173827890,173827992,0,65327683
IMR90|chr1:108838278-108838381,chr1,108838278,108838381,IMR90|chr1:148556145-148556180,chr1,148556145,148556180,0,39717867
IMR90|chr1:108911136-108911184,chr1,108911136,108911184,IMR90|chr1:16570495-16570573,chr1,16570495,16570573,0,92340641
IMR90|chr1:109099125-109099205,chr1,109099125,109099205,IMR90|chr1:173836013-173836060,chr1,173836013,173836060,0,64736888
IMR90|chr1:109385449-109385539,chr1,109385449,109385539,IMR90|chr1:43837387-43837446,chr1,43837387,43837446,0,65548062
IMR90|chr1:109402758-109402908,chr1,109402758,109402908,IMR90|chr1:8085007-8085037,chr1,8085007,8085037,0,101317751
IMR90|chr1:109439582-109439680,chr1,109439582,109439680,IMR90|chr1:173445770-173445829,chr1,173445770,173445829,0,64006188
IMR90|chr1:109639229-109639267,chr1,109639229,109639267,IMR90|chr1:33814741-33814826,chr1,33814741,33814826,0,75824488
IMR90|chr1:109738977-109739069,chr1,109738977,109739069,IMR90|chr1:182809209-182809342,chr1,182809209,182809342,0,73070232
IMR90|chr1:109766686-109766765,chr1,109766686,109766765,IMR90|chr1:200381748-200381781,chr1,200381748,200381781,0,90615062
IMR90|chr1:109784950-109785070,chr1,109784950,109785070,IMR90|chr1:8085007-8085037,chr1,8085007,8085037,0,101699943
IMR90|chr1:109801556-109801706,chr1,109801556,109801706,IMR90|chr1:151225291-151225372,chr1,151225291,151225372,0,41423735
IMR90|chr1:110167618-110167672,chr1,110167618,110167672,IMR90|chr1:247496642-247496700,chr1,247496642,247496700,0,137329024
IMR90|chr1:110498222-110498287,chr1,110498222,110498287,IMR90|chr1:148557518-148557625,chr1,148557518,148557625,0,38059296
IMR90|chr1:110588776-110588823,chr1,110588776,110588823,IMR90|chr1:8084794-8084894,chr1,8084794,8084894,0,102503982
IMR90|chr1:110867048-110867118,chr1,110867048,110867118,IMR90|chr1:148558217-148558359,chr1,148558217,148558359,0,37691169
IMR90|chr1:110965665-110965711,chr1,110965665,110965711,IMR90|chr1:120837872-120837976,chr1,120837872,120837976,0,9872207
IMR90|chr1:110967360-110967428,chr1,110967360,110967428,IMR90|chr1:154196656-154196695,chr1,154196656,154196695,0,43229296
IMR90|chr1:111067124-111067272,chr1,111067124,111067272,IMR90|chr1:29506951-29506994,chr1,29506951,29506994,0,81560173
IMR90|chr1:111358889-111358960,chr1,111358889,111358960,IMR90|chr1:25074776-25074827,chr1,25074776,25074827,0,86284113
IMR90|chr1:111400237-111400330,chr1,111400237,111400330,IMR90|chr1:26147788-26147809,chr1,26147788,26147809,0,85252449
IMR90|chr1:111423480-111423502,chr1,111423480,111423502,IMR90|chr1:24972816-24972942,chr1,24972816,24972942,0,86450664
IMR90|chr1:111553356-111553432,chr1,111553356,111553432,IMR90|chr1:148556313-148556458,chr1,148556313,148556458,0,37002957
IMR90|chr1:111611782-111611835,chr1,111611782,111611835,IMR90|chr1:24067821-24067952,chr1,24067821,24067952,0,87543961
IMR90|chr1:111617021-111617075,chr1,111617021,111617075,IMR90|chr1:9191845-9191901,chr1,9191845,9191901,0,102425176
IMR90|chr1:112049737-112049786,chr1,112049737,112049786,IMR90|chr1:155024646-155024750,chr1,155024646,155024750,0,42974909
IMR90|chr1:112057914-112057962,chr1,112057914,112057962,IMR90|chr1:153964666-153964722,chr1,153964666,153964722,0,41906752
IMR90|chr1:112116115-112116237,chr1,112116115,112116237,IMR90|chr1:25561485-25561513,chr1,25561485,25561513,0,86554630
IMR90|chr1:112387500-112387620,chr1,112387500,112387620,IMR90|chr1:150546478-150546523,chr1,150546478,150546523,0,38158978
IMR90|chr1:112452801-112452833,chr1,112452801,112452833,IMR90|chr1:148556554-148556672,chr1,148556554,148556672,0,36103753
IMR90|chr1:112583416-112583504,chr1,112583416,112583504,IMR90|chr1:27323936-27323975,chr1,27323936,27323975,0,85259480
IMR90|chr1:112679887-112679959,chr1,112679887,112679959,IMR90|chr1:2322239-2322287,chr1,2322239,2322287,0,110357648
IMR90|chr1:112692598-112692696,chr1,112692598,112692696,IMR90|chr1:247495583-247495609,chr1,247495583,247495609,0,134802985
IMR90|chr1:113064357-113064477,chr1,113064357,113064477,IMR90|chr1:54202144-54202180,chr1,54202144,54202180,0,58862213
IMR90|chr1:113081784-113081889,chr1,113081784,113081889,IMR90|chr1:54200818-54200846,chr1,54200818,54200846,0,58880966
IMR90|chr1:113094993-113095075,chr1,113094993,113095075,IMR90|chr1:1292611-1292677,chr1,1292611,1292677,0,111802382
IMR90|chr1:113227945-113227970,chr1,113227945,113227970,IMR90|chr1:150532448-150532496,chr1,150532448,150532496,0,37304503
IMR90|chr1:113507072-113507145,chr1,113507072,113507145,IMR90|chr1:226067704-226067763,chr1,226067704,226067763,0,112560632
IMR90|chr1:113550344-113550405,chr1,113550344,113550405,IMR90|chr1:227916656-227916729,chr1,227916656,227916729,0,114366312
IMR90|chr1:113671760-113671860,chr1,113671760,113671860,IMR90|chr1:148556153-148556180,chr1,148556153,148556180,0,34884393
IMR90|chr1:113778809-113778931,chr1,113778809,113778931,IMR90|chr1:46597443-46597471,chr1,46597443,46597471,0,67181366
IMR90|chr1:113819939-113820010,chr1,113819939,113820010,IMR90|chr1:9193785-9193860,chr1,9193785,9193860,0,104626154
IMR90|chr1:113956426-113956459,chr1,113956426,113956459,IMR90|chr1:27321788-27321862,chr1,27321788,27321862,0,86634638
IMR90|chr1:113993750-113993847,chr1,113993750,113993847,IMR90|chr1:8083490-8083537,chr1,8083490,8083537,0,105910260
IMR90|chr1:114025558-114025639,chr1,114025558,114025639,IMR90|chr1:43149374-43149461,chr1,43149374,43149461,0,70876184
IMR90|chr1:114064239-114064361,chr1,114064239,114064361,IMR90|chr1:173445770-173445797,chr1,173445770,173445797,0,59381531
IMR90|chr1:114133699-114133737,chr1,114133699,114133737,IMR90|chr1:221911147-221911227,chr1,221911147,221911227,0,107777448
IMR90|chr1:114229582-114229603,chr1,114229582,114229603,IMR90|chr1:114304363-114304448,chr1,114304363,114304448,0,74781
IMR90|chr1:114230348-114230401,chr1,114230348,114230401,IMR90|chr1:24067821-24067952,chr1,24067821,24067952,0,90162527
IMR90|chr1:114339697-114339847,chr1,114339697,114339847,IMR90|chr1:63156306-63156358,chr1,63156306,63156358,0,51183391
IMR90|chr1:114418097-114418149,chr1,114418097,114418149,IMR90|chr1:200379821-200379880,chr1,200379821,200379880,0,85961724
IMR90|chr1:114438623-114438742,chr1,114438623,114438742,IMR90|chr1:201434533-201434558,chr1,201434533,201434558,0,86995910
IMR90|chr1:114563033-114563054,chr1,114563033,114563054,IMR90|chr1:182993599-182993657,chr1,182993599,182993657,0,68430566
IMR90|chr1:114612933-114613030,chr1,114612933,114613030,IMR90|chr1:27321344-27321368,chr1,27321344,27321368,0,87291589
IMR90|chr1:114664992-114665084,chr1,114664992,114665084,IMR90|chr1:182809209-182809342,chr1,182809209,182809342,0,68144217
IMR90|chr1:114710444-114710551,chr1,114710444,114710551,IMR90|chr1:57043980-57044010,chr1,57043980,57044010,0,57666464
IMR90|chr1:114821321-114821339,chr1,114821321,114821339,IMR90|chr1:214724784-214724827,chr1,214724784,214724827,0,99903463
IMR90|chr1:114879627-114879718,chr1,114879627,114879718,IMR90|chr1:27323265-27323306,chr1,27323265,27323306,0,87556362
IMR90|chr1:115211985-115212054,chr1,115211985,115212054,IMR90|chr1:148556134-148556180,chr1,148556134,148556180,0,33344149
IMR90|chr1:115470442-115470515,chr1,115470442,115470515,IMR90|chr1:226067704-226067763,chr1,226067704,226067763,0,110597262
IMR90|chr1:115528648-115528706,chr1,115528648,115528706,IMR90|chr1:94702468-94702554,chr1,94702468,94702554,0,20826180
IMR90|chr1:115533209-115533359,chr1,115533209,115533359,IMR90|chr1:1843065-1843117,chr1,1843065,1843117,0,113690144
IMR90|chr1:115539606-115539726,chr1,115539606,115539726,IMR90|chr1:22384206-22384233,chr1,22384206,22384233,0,93155400
IMR90|chr1:115937914-115938000,chr1,115937914,115938000,IMR90|chr1:148556691-148556725,chr1,148556691,148556725,0,32618777
IMR90|chr1:116083531-116083680,chr1,116083531,116083680,IMR90|chr1:148558193-148558286,chr1,148558193,148558286,0,32474662
IMR90|chr1:116189964-116189990,chr1,116189964,116189990,IMR90|chr1:2323403-2323527,chr1,2323403,2323527,0,113866561
IMR90|chr1:116227819-116227873,chr1,116227819,116227873,IMR90|chr1:148557522-148557646,chr1,148557522,148557646,0,32329703
IMR90|chr1:116346112-116346167,chr1,116346112,116346167,IMR90|chr1:201440319-201440404,chr1,201440319,201440404,0,85094207
IMR90|chr1:116358962-116359110,chr1,116358962,116359110,IMR90|chr1:151963626-151963648,chr1,151963626,151963648,0,35604664
IMR90|chr1:116388900-116388963,chr1,116388900,116388963,IMR90|chr1:227128147-227128203,chr1,227128147,227128203,0,110739247
IMR90|chr1:116705839-116705968,chr1,116705839,116705968,IMR90|chr1:104068950-104068980,chr1,104068950,104068980,0,12636889
IMR90|chr1:116733619-116733769,chr1,116733619,116733769,IMR90|chr1:151225291-151225372,chr1,151225291,151225372,0,34491672
IMR90|chr1:116939445-116939595,chr1,116939445,116939595,IMR90|chr1:148558250-148558286,chr1,148558250,148558286,0,31618805
IMR90|chr1:116982672-116982765,chr1,116982672,116982765,IMR90|chr1:148556320-148556399,chr1,148556320,148556399,0,31573648
IMR90|chr1:116988288-116988379,chr1,116988288,116988379,IMR90|chr1:173445770-173445829,chr1,173445770,173445829,0,56457482
IMR90|chr1:117122666-117122690,chr1,117122666,117122690,IMR90|chr1:24972816-24972942,chr1,24972816,24972942,0,92149850
IMR90|chr1:117205417-117205539,chr1,117205417,117205539,IMR90|chr1:150848144-150848172,chr1,150848144,150848172,0,33642727
IMR90|chr1:117325401-117325468,chr1,117325401,117325468,IMR90|chr1:151428933-151428993,chr1,151428933,151428993,0,34103532
IMR90|chr1:117355846-117355938,chr1,117355846,117355938,IMR90|chr1:43837162-43837306,chr1,43837162,43837306,0,73518684
IMR90|chr1:117379216-117379330,chr1,117379216,117379330,IMR90|chr1:27323233-27323269,chr1,27323233,27323269,0,90055983
IMR90|chr1:117453310-117453454,chr1,117453310,117453454,IMR90|chr1:52826922-52827001,chr1,52826922,52827001,0,64626388
IMR90|chr1:117454695-117454839,chr1,117454695,117454839,IMR90|chr1:148556231-148556381,chr1,148556231,148556381,0,31101536
IMR90|chr1:117520074-117520142,chr1,117520074,117520142,IMR90|chr1:173445770-173445849,chr1,173445770,173445849,0,55925696
IMR90|chr1:117694290-117694417,chr1,117694290,117694417,IMR90|chr1:151963626-151963648,chr1,151963626,151963648,0,34269336
IMR90|chr1:117775522-117775672,chr1,117775522,117775672,IMR90|chr1:148558239-148558286,chr1,148558239,148558286,0,30782717
IMR90|chr1:117821503-117821572,chr1,117821503,117821572,IMR90|chr1:1714214-1714244,chr1,1714214,1714244,0,116107289
IMR90|chr1:117993212-117993263,chr1,117993212,117993263,IMR90|chr1:54201826-54201925,chr1,54201826,54201925,0,63791386
IMR90|chr1:118170592-118170732,chr1,118170592,118170732,IMR90|chr1:16485516-16485545,chr1,16485516,16485545,0,101685076
IMR90|chr1:118209549-118209699,chr1,118209549,118209699,IMR90|chr1:148556134-148556180,chr1,148556134,148556180,0,30346585
IMR90|chr1:118266283-118266398,chr1,118266283,118266398,IMR90|chr1:148556199-148556302,chr1,148556199,148556302,0,30289916
IMR90|chr1:118279654-118279751,chr1,118279654,118279751,IMR90|chr1:27323757-27323789,chr1,27323757,27323789,0,90955897
IMR90|chr1:118370229-118370294,chr1,118370229,118370294,IMR90|chr1:78472831-78472901,chr1,78472831,78472901,0,39897398
IMR90|chr1:118379565-118379613,chr1,118379565,118379613,IMR90|chr1:203599103-203599139,chr1,203599103,203599139,0,85219538
IMR90|chr1:118643048-118643130,chr1,118643048,118643130,IMR90|chr1:223901130-223901223,chr1,223901130,223901223,0,105258082
IMR90|chr1:118764913-118765016,chr1,118764913,118765016,IMR90|chr1:180470505-180470553,chr1,180470505,180470553,0,61705592
IMR90|chr1:118788991-118789038,chr1,118788991,118789038,IMR90|chr1:27324174-27324210,chr1,27324174,27324210,0,91464817
IMR90|chr1:118942152-118942207,chr1,118942152,118942207,IMR90|chr1:24065100-24065195,chr1,24065100,24065195,0,94877052
IMR90|chr1:118965753-118965802,chr1,118965753,118965802,IMR90|chr1:161086759-161086866,chr1,161086759,161086866,0,42121006
IMR90|chr1:119024955-119025083,chr1,119024955,119025083,IMR90|chr1:78245486-78245585,chr1,78245486,78245585,0,40779469
IMR90|chr1:119148662-119148695,chr1,119148662,119148695,IMR90|chr1:1715650-1715774,chr1,1715650,1715774,0,117433012
IMR90|chr1:119251123-119251254,chr1,119251123,119251254,IMR90|chr1:45310665-45310683,chr1,45310665,45310683,0,73940458
IMR90|chr1:119455002-119455074,chr1,119455002,119455074,IMR90|chr1:38257546-38257602,chr1,38257546,38257602,0,81197456
IMR90|chr1:119691908-119692050,chr1,119691908,119692050,IMR90|chr1:148556130-148556180,chr1,148556130,148556180,0,28864222
IMR90|chr1:119923604-119923642,chr1,119923604,119923642,IMR90|chr1:27321347-27321392,chr1,27321347,27321392,0,92602257
IMR90|chr1:120006780-120006827,chr1,120006780,120006827,IMR90|chr1:24067634-24067735,chr1,24067634,24067735,0,95939146
IMR90|chr1:120013655-120013717,chr1,120013655,120013717,IMR90|chr1:78147419-78147499,chr1,78147419,78147499,0,41866236
IMR90|chr1:120167559-120167701,chr1,120167559,120167701,IMR90|chr1:148558160-148558294,chr1,148558160,148558294,0,28390601
IMR90|chr1:120234238-120234318,chr1,120234238,120234318,IMR90|chr1:148558154-148558286,chr1,148558154,148558286,0,28323916
IMR90|chr1:120251029-120251101,chr1,120251029,120251101,IMR90|chr1:151139498-151139526,chr1,151139498,151139526,0,30888469
IMR90|chr1:120257169-120257234,chr1,120257169,120257234,IMR90|chr1:57042661-57042705,chr1,57042661,57042705,0,63214508
IMR90|chr1:120401238-120401366,chr1,120401238,120401366,IMR90|chr1:7832457-7832479,chr1,7832457,7832479,0,112568781
IMR90|chr1:120454899-120454924,chr1,120454899,120454924,IMR90|chr1:148556191-148556341,chr1,148556191,148556341,0,28101292
IMR90|chr1:120540903-120540985,chr1,120540903,120540985,IMR90|chr1:223901130-223901223,chr1,223901130,223901223,0,103360227
IMR90|chr1:120594371-120594454,chr1,120594371,120594454,IMR90|chr1:25068789-25068844,chr1,25068789,25068844,0,95525582
IMR90|chr1:120697196-120697280,chr1,120697196,120697280,IMR90|chr1:27930330-27930392,chr1,27930330,27930392,0,92766866
IMR90|chr1:120714477-120714531,chr1,120714477,120714531,IMR90|chr1:247496642-247496700,chr1,247496642,247496700,0,126782165
IMR90|chr1:120755101-120755251,chr1,120755101,120755251,IMR90|chr1:148558195-148558286,chr1,148558195,148558286,0,27803094
IMR90|chr1:120826527-120826583,chr1,120826527,120826583,IMR90|chr1:21502007-21502081,chr1,21502007,21502081,0,99324520
IMR90|chr1:120889314-120889423,chr1,120889314,120889423,IMR90|chr1:29064950-29064979,chr1,29064950,29064979,0,91824364
IMR90|chr1:121173001-121173058,chr1,121173001,121173058,IMR90|chr1:27322728-27322761,chr1,27322728,27322761,0,93850273
IMR90|chr1:121220129-121220244,chr1,121220129,121220244,IMR90|chr1:27322196-27322275,chr1,27322196,27322275,0,93897933
IMR90|chr1:121422548-121422674,chr1,121422548,121422674,IMR90|chr1:224372297-224372406,chr1,224372297,224372406,0,102949749
IMR90|chr1:121446837-121446916,chr1,121446837,121446916,IMR90|chr1:22380841-22380873,chr1,22380841,22380873,0,99065996
IMR90|chr1:121450719-121450756,chr1,121450719,121450756,IMR90|chr1:148556691-148556738,chr1,148556691,148556738,0,27105972
IMR90|chr1:121943194-121943291,chr1,121943194,121943291,IMR90|chr1:223902186-223902267,chr1,223902186,223902267,0,101958992
IMR90|chr1:122381584-122381641,chr1,122381584,122381641,IMR90|chr1:45310665-45310683,chr1,45310665,45310683,0,77070919
IMR90|chr1:122422382-122422424,chr1,122422382,122422424,IMR90|chr1:8936901-8936931,chr1,8936901,8936931,0,113485481
IMR90|chr1:122423431-122423461,chr1,122423431,122423461,IMR90|chr1:8936517-8936568,chr1,8936517,8936568,0,113486914
IMR90|chr1:122449646-122449796,chr1,122449646,122449796,IMR90|chr1:178064523-178064589,chr1,178064523,178064589,0,55614877
IMR90|chr1:122929098-122929169,chr1,122929098,122929169,IMR90|chr1:162532853-162532902,chr1,162532853,162532902,0,39603755
IMR90|chr1:122983961-122984067,chr1,122983961,122984067,IMR90|chr1:43837242-43837321,chr1,43837242,43837321,0,79146719
IMR90|chr1:123058710-123058748,chr1,123058710,123058748,IMR90|chr1:221911147-221911227,chr1,221911147,221911227,0,98852437
IMR90|chr1:123924154-123924172,chr1,123924154,123924172,IMR90|chr1:148558184-148558287,chr1,148558184,148558287,0,24634030
IMR90|chr1:124101960-124102004,chr1,124101960,124102004,IMR90|chr1:27322379-27322431,chr1,27322379,27322431,0,96779581
IMR90|chr1:124447575-124447725,chr1,124447575,124447725,IMR90|chr1:1206366-1206422,chr1,1206366,1206422,0,123241209
IMR90|chr1:124489565-124489597,chr1,124489565,124489597,IMR90|chr1:27324398-27324525,chr1,27324398,27324525,0,97165167
IMR90|chr1:124490082-124490214,chr1,124490082,124490214,IMR90|chr1:45310665-45310683,chr1,45310665,45310683,0,79179417
IMR90|chr1:124586062-124586124,chr1,124586062,124586124,IMR90|chr1:78147419-78147499,chr1,78147419,78147499,0,46438643
IMR90|chr1:124923624-124923673,chr1,124923624,124923673,IMR90|chr1:203599038-203599139,chr1,203599038,203599139,0,78675414
IMR90|chr1:125108145-125108184,chr1,125108145,125108184,IMR90|chr1:25074422-25074529,chr1,25074422,25074529,0,100033723
IMR90|chr1:125174612-125174648,chr1,125174612,125174648,IMR90|chr1:27323924-27323977,chr1,27323924,27323977,0,97850688
IMR90|chr1:125183804-125183830,chr1,125183804,125183830,IMR90|chr1:227751790-227751894,chr1,227751790,227751894,0,102567986
IMR90|chr1:125213021-125213136,chr1,125213021,125213136,IMR90|chr1:27322196-27322275,chr1,27322196,27322275,0,97890825
IMR90|chr1:125233804-125233836,chr1,125233804,125233836,IMR90|chr1:95003647-95003695,chr1,95003647,95003695,0,30230157
IMR90|chr1:126137854-126137935,chr1,126137854,126137935,IMR90|chr1:221911416-221911435,chr1,221911416,221911435,0,95773562
IMR90|chr1:126280270-126280301,chr1,126280270,126280301,IMR90|chr1:112302470-112302618,chr1,112302470,112302618,0,13977800
IMR90|chr1:126331934-126332038,chr1,126331934,126332038,IMR90|chr1:173445770-173445856,chr1,173445770,173445856,0,47113836
IMR90|chr1:126372940-126373090,chr1,126372940,126373090,IMR90|chr1:148559575-148559721,chr1,148559575,148559721,0,22186635
IMR90|chr1:126412428-126412476,chr1,126412428,126412476,IMR90|chr1:10005637-10005739,chr1,10005637,10005739,0,116406791
IMR90|chr1:126559673-126559765,chr1,126559673,126559765,IMR90|chr1:27322971-27322990,chr1,27322971,27322990,0,99236702
IMR90|chr1:126594972-126595018,chr1,126594972,126595018,IMR90|chr1:2345970-2346065,chr1,2345970,2346065,0,124249002
IMR90|chr1:126866756-126866900,chr1,126866756,126866900,IMR90|chr1:148556296-148556443,chr1,148556296,148556443,0,21689540
IMR90|chr1:127050092-127050157,chr1,127050092,127050157,IMR90|chr1:24067378-24067460,chr1,24067378,24067460,0,102982714
IMR90|chr1:127077745-127077856,chr1,127077745,127077856,IMR90|chr1:219347314-219347352,chr1,219347314,219347352,0,92269569
IMR90|chr1:127127517-127127581,chr1,127127517,127127581,IMR90|chr1:173175348-173175434,chr1,173175348,173175434,0,46047831
IMR90|chr1:127240078-127240115,chr1,127240078,127240115,IMR90|chr1:173986494-173986535,chr1,173986494,173986535,0,46746416
IMR90|chr1:127249247-127249287,chr1,127249247,127249287,IMR90|chr1:27322888-27322995,chr1,27322888,27322995,0,99926359
IMR90|chr1:127510758-127510908,chr1,127510758,127510908,IMR90|chr1:148559579-148559729,chr1,148559579,148559729,0,21048821
IMR90|chr1:127679850-127679920,chr1,127679850,127679920,IMR90|chr1:150546164-150546266,chr1,150546164,150546266,0,22866314
IMR90|chr1:127714977-127714998,chr1,127714977,127714998,IMR90|chr1:110158302-110158427,chr1,110158302,110158427,0,17556675
IMR90|chr1:127880972-127880994,chr1,127880972,127880994,IMR90|chr1:27322687-27322775,chr1,27322687,27322775,0,100558285
IMR90|chr1:127923286-127923416,chr1,127923286,127923416,IMR90|chr1:148556132-148556180,chr1,148556132,148556180,0,20632846
IMR90|chr1:128117703-128117853,chr1,128117703,128117853,IMR90|chr1:148558233-148558286,chr1,148558233,148558286,0,20440530
IMR90|chr1:128133425-128133535,chr1,128133425,128133535,IMR90|chr1:27323962-27324002,chr1,27323962,27324002,0,100809463
IMR90|chr1:128478724-128478873,chr1,128478724,128478873,IMR90|chr1:28971639-28971740,chr1,28971639,28971740,0,99507085
IMR90|chr1:128538969-128539049,chr1,128538969,128539049,IMR90|chr1:148556136-148556180,chr1,148556136,148556180,0,20017167
IMR90|chr1:128544819-128544952,chr1,128544819,128544952,IMR90|chr1:8083645-8083725,chr1,8083645,8083725,0,120461174
IMR90|chr1:128680617-128680692,chr1,128680617,128680692,IMR90|chr1:104068950-104068979,chr1,104068950,104068979,0,24611667
IMR90|chr1:128684843-128684906,chr1,128684843,128684906,IMR90|chr1:715921-715958,chr1,715921,715958,0,127968922
IMR90|chr1:128774391-128774440,chr1,128774391,128774440,IMR90|chr1:27324256-27324374,chr1,27324256,27324374,0,101450135
IMR90|chr1:129132780-129132856,chr1,129132780,129132856,IMR90|chr1:76253362-76253386,chr1,76253362,76253386,0,52879418
IMR90|chr1:129282948-129282987,chr1,129282948,129282987,IMR90|chr1:25074422-25074529,chr1,25074422,25074529,0,104208526
IMR90|chr1:129289605-129289643,chr1,129289605,129289643,IMR90|chr1:173827852-173827933,chr1,173827852,173827933,0,44538247
IMR90|chr1:129348527-129348621,chr1,129348527,129348621,IMR90|chr1:40041095-40041153,chr1,40041095,40041153,0,89307432
IMR90|chr1:129412782-129412836,chr1,129412782,129412836,IMR90|chr1:24065933-24065972,chr1,24065933,24065972,0,105346849
IMR90|chr1:129639352-129639396,chr1,129639352,129639396,IMR90|chr1:223901169-223901276,chr1,223901169,223901276,0,94261817
IMR90|chr1:129702721-129702755,chr1,129702721,129702755,IMR90|chr1:94702692-94702800,chr1,94702692,94702800,0,35000029
IMR90|chr1:129817366-129817406,chr1,129817366,129817406,IMR90|chr1:95003794-95003911,chr1,95003794,95003911,0,34813572
IMR90|chr1:129819148-129819197,chr1,129819148,129819197,IMR90|chr1:33812912-33812993,chr1,33812912,33812993,0,96006236
IMR90|chr1:129872469-129872559,chr1,129872469,129872559,IMR90|chr1:31851907-31851960,chr1,31851907,31851960,0,98020562
IMR90|chr1:130097234-130097295,chr1,130097234,130097295,IMR90|chr1:173828336-173828425,chr1,173828336,173828425,0,43731102
IMR90|chr1:130169873-130169934,chr1,130169873,130169934,IMR90|chr1:27321501-27321538,chr1,27321501,27321538,0,102848372
IMR90|chr1:130224354-130224429,chr1,130224354,130224429,IMR90|chr1:87790692-87790718,chr1,87790692,87790718,0,42433662
IMR90|chr1:130262283-130262399,chr1,130262283,130262399,IMR90|chr1:201708065-201708092,chr1,201708065,201708092,0,71445782
IMR90|chr1:130269286-130269400,chr1,130269286,130269400,IMR90|chr1:43837293-43837329,chr1,43837293,43837329,0,86431993
IMR90|chr1:130437437-130437510,chr1,130437437,130437510,IMR90|chr1:148556207-148556280,chr1,148556207,148556280,0,18118770
IMR90|chr1:130469895-130469977,chr1,130469895,130469977,IMR90|chr1:23038661-23038694,chr1,23038661,23038694,0,107431234
IMR90|chr1:130691924-130691992,chr1,130691924,130691992,IMR90|chr1:2325080-2325149,chr1,2325080,2325149,0,128366844
IMR90|chr1:130935369-130935516,chr1,130935369,130935516,IMR90|chr1:44396896-44396919,chr1,44396896,44396919,0,86538473
IMR90|chr1:131137901-131137949,chr1,131137901,131137949,IMR90|chr1:94705608-94705652,chr1,94705608,94705652,0,36432293
IMR90|chr1:131373522-131373569,chr1,131373522,131373569,IMR90|chr1:148556366-148556416,chr1,148556366,148556416,0,17182844
IMR90|chr1:131472102-131472128,chr1,131472102,131472128,IMR90|chr1:160258244-160258305,chr1,160258244,160258305,0,28786142
IMR90|chr1:131484431-131484489,chr1,131484431,131484489,IMR90|chr1:223902186-223902267,chr1,223902186,223902267,0,92417755
IMR90|chr1:131486054-131486100,chr1,131486054,131486100,IMR90|chr1:227916656-227916729,chr1,227916656,227916729,0,96430602
IMR90|chr1:131522081-131522117,chr1,131522081,131522117,IMR90|chr1:148556145-148556180,chr1,148556145,148556180,0,17034064
IMR90|chr1:131531883-131531934,chr1,131531883,131531934,IMR90|chr1:222884430-222884524,chr1,222884430,222884524,0,91352547
IMR90|chr1:131535780-131535892,chr1,131535780,131535892,IMR90|chr1:173445770-173445786,chr1,173445770,173445786,0,41909990
IMR90|chr1:131536260-131536361,chr1,131536260,131536361,IMR90|chr1:173445770-173445819,chr1,173445770,173445819,0,41909510
IMR90|chr1:131654627-131654690,chr1,131654627,131654690,IMR90|chr1:180126522-180126581,chr1,180126522,180126581,0,48471895
IMR90|chr1:131914520-131914598,chr1,131914520,131914598,IMR90|chr1:43837259-43837327,chr1,43837259,43837327,0,88077261
IMR90|chr1:132049784-132049830,chr1,132049784,132049830,IMR90|chr1:112939426-112939561,chr1,112939426,112939561,0,19110358
IMR90|chr1:132241747-132241773,chr1,132241747,132241773,IMR90|chr1:110282718-110282753,chr1,110282718,110282753,0,21959029
IMR90|chr1:132504778-132504927,chr1,132504778,132504927,IMR90|chr1:148558223-148558286,chr1,148558223,148558286,0,16053445
IMR90|chr1:132539375-132539450,chr1,132539375,132539450,IMR90|chr1:179047638-179047680,chr1,179047638,179047680,0,46508263
IMR90|chr1:132816168-132816290,chr1,132816168,132816290,IMR90|chr1:201434533-201434558,chr1,201434533,201434558,0,68618365
IMR90|chr1:132913112-132913213,chr1,132913112,132913213,IMR90|chr1:244618197-244618244,chr1,244618197,244618244,0,111705085
IMR90|chr1:133055816-133055929,chr1,133055816,133055929,IMR90|chr1:156714265-156714302,chr1,156714265,156714302,0,23658449
IMR90|chr1:133191761-133191790,chr1,133191761,133191790,IMR90|chr1:27155691-27155814,chr1,27155691,27155814,0,106036070
IMR90|chr1:133220459-133220570,chr1,133220459,133220570,IMR90|chr1:219347314-219347352,chr1,219347314,219347352,0,86126855
IMR90|chr1:133321365-133321406,chr1,133321365,133321406,IMR90|chr1:33814396-33814451,chr1,33814396,33814451,0,99506969
IMR90|chr1:133444482-133444523,chr1,133444482,133444523,IMR90|chr1:161086759-161086866,chr1,161086759,161086866,0,27642277
IMR90|chr1:133490445-133490550,chr1,133490445,133490550,IMR90|chr1:148558179-148558291,chr1,148558179,148558291,0,15067734
IMR90|chr1:133604135-133604259,chr1,133604135,133604259,IMR90|chr1:27323900-27323926,chr1,27323900,27323926,0,106280235
IMR90|chr1:133674617-133674725,chr1,133674617,133674725,IMR90|chr1:148556678-148556717,chr1,148556678,148556717,0,14882061
IMR90|chr1:133880195-133880243,chr1,133880195,133880243,IMR90|chr1:10005637-10005739,chr1,10005637,10005739,0,123874558
IMR90|chr1:133913711-133913796,chr1,133913711,133913796,IMR90|chr1:25074383-25074420,chr1,25074383,25074420,0,108839328
IMR90|chr1:133967363-133967435,chr1,133967363,133967435,IMR90|chr1:2322239-2322287,chr1,2322239,2322287,0,131645124
IMR90|chr1:134064915-134065025,chr1,134064915,134065025,IMR90|chr1:54201565-54201613,chr1,54201565,54201613,0,79863350
IMR90|chr1:134136814-134136964,chr1,134136814,134136964,IMR90|chr1:173445770-173445815,chr1,173445770,173445815,0,39308956
IMR90|chr1:134201997-134202050,chr1,134201997,134202050,IMR90|chr1:9296188-9296254,chr1,9296188,9296254,0,124905809
IMR90|chr1:134271964-134272013,chr1,134271964,134272013,IMR90|chr1:27323235-27323321,chr1,27323235,27323321,0,106948729
IMR90|chr1:134574516-134574561,chr1,134574516,134574561,IMR90|chr1:148558154-148558286,chr1,148558154,148558286,0,13983638
IMR90|chr1:134697556-134697642,chr1,134697556,134697642,IMR90|chr1:173445770-173445819,chr1,173445770,173445819,0,38748214
IMR90|chr1:134773842-134773916,chr1,134773842,134773916,IMR90|chr1:120189024-120189123,chr1,120189024,120189123,0,14584818
IMR90|chr1:134835728-134835755,chr1,134835728,134835755,IMR90|chr1:27322472-27322540,chr1,27322472,27322540,0,107513256
IMR90|chr1:134956394-134956521,chr1,134956394,134956521,IMR90|chr1:148556283-148556398,chr1,148556283,148556398,0,13599889
IMR90|chr1:135102219-135102291,chr1,135102219,135102291,IMR90|chr1:110282718-110282753,chr1,110282718,110282753,0,24819501
IMR90|chr1:135542337-135542468,chr1,135542337,135542468,IMR90|chr1:45310665-45310683,chr1,45310665,45310683,0,90231672
IMR90|chr1:135605671-135605707,chr1,135605671,135605707,IMR90|chr1:32574945-32575018,chr1,32574945,32575018,0,103030726
IMR90|chr1:135749116-135749229,chr1,135749116,135749229,IMR90|chr1:173442090-173442110,chr1,173442090,173442110,0,37692974
IMR90|chr1:136242019-136242065,chr1,136242019,136242065,IMR90|chr1:156086701-156086805,chr1,156086701,156086805,0,19844682
IMR90|chr1:136589105-136589212,chr1,136589105,136589212,IMR90|chr1:173447038-173447112,chr1,173447038,173447112,0,36857933
IMR90|chr1:136610071-136610116,chr1,136610071,136610116,IMR90|chr1:2345970-2346065,chr1,2345970,2346065,0,134264101
IMR90|chr1:136702346-136702424,chr1,136702346,136702424,IMR90|chr1:173446118-173446148,chr1,173446118,173446148,0,36743772
IMR90|chr1:136729991-136730085,chr1,136729991,136730085,IMR90|chr1:54203716-54203779,chr1,54203716,54203779,0,82526275
IMR90|chr1:136914073-136914120,chr1,136914073,136914120,IMR90|chr1:112302467-112302595,chr1,112302467,112302595,0,24611606
IMR90|chr1:137051325-137051368,chr1,137051325,137051368,IMR90|chr1:57042363-57042383,chr1,57042363,57042383,0,80008962
IMR90|chr1:137264935-137265063,chr1,137264935,137265063,IMR90|chr1:78245486-78245585,chr1,78245486,78245585,0,59019449
IMR90|chr1:137283241-137283391,chr1,137283241,137283391,IMR90|chr1:148556466-148556616,chr1,148556466,148556616,0,11273225
IMR90|chr1:137284440-137284473,chr1,137284440,137284473,IMR90|chr1:95003794-95003911,chr1,95003794,95003911,0,42280646
IMR90|chr1:137329786-137329836,chr1,137329786,137329836,IMR90|chr1:8584810-8584907,chr1,8584810,8584907,0,128744976
IMR90|chr1:137356693-137356791,chr1,137356693,137356791,IMR90|chr1:40045466-40045524,chr1,40045466,40045524,0,97311227
IMR90|chr1:137442972-137443050,chr1,137442972,137443050,IMR90|chr1:162602442-162602510,chr1,162602442,162602510,0,25159470
IMR90|chr1:137488978-137489105,chr1,137488978,137489105,IMR90|chr1:173445770-173445790,chr1,173445770,173445790,0,35956792
IMR90|chr1:137564345-137564415,chr1,137564345,137564415,IMR90|chr1:45312634-45312678,chr1,45312634,45312678,0,92251711
IMR90|chr1:137599071-137599132,chr1,137599071,137599132,IMR90|chr1:33814396-33814451,chr1,33814396,33814451,0,103784675
IMR90|chr1:137662269-137662418,chr1,137662269,137662418,IMR90|chr1:28971639-28971740,chr1,28971639,28971740,0,108690630
IMR90|chr1:137741165-137741290,chr1,137741165,137741290,IMR90|chr1:1259323-1259348,chr1,1259323,1259348,0,136481842
IMR90|chr1:137774758-137774828,chr1,137774758,137774828,IMR90|chr1:148558217-148558359,chr1,148558217,148558359,0,10783459
IMR90|chr1:137825404-137825422,chr1,137825404,137825422,IMR90|chr1:27323333-27323435,chr1,27323333,27323435,0,110502071
IMR90|chr1:137881536-137881635,chr1,137881536,137881635,IMR90|chr1:15481761-15481812,chr1,15481761,15481812,0,122399775
IMR90|chr1:138104692-138104733,chr1,138104692,138104733,IMR90|chr1:148558176-148558291,chr1,148558176,148558291,0,10453484
IMR90|chr1:138307020-138307078,chr1,138307020,138307078,IMR90|chr1:57042363-57042383,chr1,57042363,57042383,0,81264657
IMR90|chr1:138317978-138318063,chr1,138317978,138318063,IMR90|chr1:67215309-67215341,chr1,67215309,67215341,0,71102669
IMR90|chr1:138699463-138699570,chr1,138699463,138699570,IMR90|chr1:148558187-148558335,chr1,148558187,148558335,0,9858724
IMR90|chr1:138835903-138835926,chr1,138835903,138835926,IMR90|chr1:27321973-27322065,chr1,27321973,27322065,0,111513930
IMR90|chr1:138949255-138949294,chr1,138949255,138949294,IMR90|chr1:173830748-173830859,chr1,173830748,173830859,0,34881493
IMR90|chr1:139030954-139031005,chr1,139030954,139031005,IMR90|chr1:27323746-27323807,chr1,27323746,27323807,0,111707208
IMR90|chr1:139071236-139071312,chr1,139071236,139071312,IMR90|chr1:36027532-36027582,chr1,36027532,36027582,0,103043704
IMR90|chr1:139079035-139079086,chr1,139079035,139079086,IMR90|chr1:78245486-78245585,chr1,78245486,78245585,0,60833549
IMR90|chr1:139191313-139191332,chr1,139191313,139191332,IMR90|chr1:33281457-33281552,chr1,33281457,33281552,0,105909856
IMR90|chr1:139287068-139287127,chr1,139287068,139287127,IMR90|chr1:162602439-162602530,chr1,162602439,162602530,0,23315371
IMR90|chr1:139613000-139613032,chr1,139613000,139613032,IMR90|chr1:54203718-54203779,chr1,54203718,54203779,0,85409282
IMR90|chr1:139794919-139794997,chr1,139794919,139794997,IMR90|chr1:32174218-32174239,chr1,32174218,32174239,0,107620701
IMR90|chr1:140032344-140032388,chr1,140032344,140032388,IMR90|chr1:173831348-173831494,chr1,173831348,173831494,0,33799004
IMR90|chr1:140344236-140344278,chr1,140344236,140344278,IMR90|chr1:8936901-8936931,chr1,8936901,8936931,0,131407335
IMR90|chr1:140611552-140611639,chr1,140611552,140611639,IMR90|chr1:182993725-182993776,chr1,182993725,182993776,0,42382173
IMR90|chr1:140638137-140638201,chr1,140638137,140638201,IMR90|chr1:27321501-27321538,chr1,27321501,27321538,0,113316636
IMR90|chr1:140760406-140760467,chr1,140760406,140760467,IMR90|chr1:33814396-33814451,chr1,33814396,33814451,0,106946010
IMR90|chr1:140766356-140766417,chr1,140766356,140766417,IMR90|chr1:43837267-43837323,chr1,43837267,43837323,0,96929089
IMR90|chr1:140933017-140933078,chr1,140933017,140933078,IMR90|chr1:173445770-173445808,chr1,173445770,173445808,0,32512753
IMR90|chr1:141007049-141007091,chr1,141007049,141007091,IMR90|chr1:33812388-33812496,chr1,33812388,33812496,0,107194661
IMR90|chr1:141154466-141154543,chr1,141154466,141154543,IMR90|chr1:110282718-110282753,chr1,110282718,110282753,0,30871748
IMR90|chr1:141263093-141263134,chr1,141263093,141263134,IMR90|chr1:95004096-95004170,chr1,95004096,95004170,0,46258997
IMR90|chr1:141336051-141336078,chr1,141336051,141336078,IMR90|chr1:27155691-27155814,chr1,27155691,27155814,0,114180360
IMR90|chr1:141395608-141395640,chr1,141395608,141395640,IMR90|chr1:148556554-148556672,chr1,148556554,148556672,0,7160946
IMR90|chr1:141437526-141437657,chr1,141437526,141437657,IMR90|chr1:148556135-148556180,chr1,148556135,148556180,0,7118609
IMR90|chr1:141465242-141465305,chr1,141465242,141465305,IMR90|chr1:148558168-148558212,chr1,148558168,148558212,0,7092926
IMR90|chr1:141909417-141909493,chr1,141909417,141909493,IMR90|chr1:173836015-173836065,chr1,173836015,173836065,0,31926598
IMR90|chr1:141917894-141917951,chr1,141917894,141917951,IMR90|chr1:45310665-45310683,chr1,45310665,45310683,0,96607229
IMR90|chr1:142030928-142031003,chr1,142030928,142031003,IMR90|chr1:1820471-1820522,chr1,1820471,1820522,0,140210457
IMR90|chr1:142058009-142058066,chr1,142058009,142058066,IMR90|chr1:173445770-173445839,chr1,173445770,173445839,0,31387761
IMR90|chr1:142284198-142284252,chr1,142284198,142284252,IMR90|chr1:9191845-9191901,chr1,9191845,9191901,0,133092353
IMR90|chr1:142339721-142339788,chr1,142339721,142339788,IMR90|chr1:25074776-25074827,chr1,25074776,25074827,0,117264945
IMR90|chr1:142351847-142351898,chr1,142351847,142351898,IMR90|chr1:27322912-27322976,chr1,27322912,27322976,0,115028935
IMR90|chr1:142573155-142573219,chr1,142573155,142573219,IMR90|chr1:27323539-27323633,chr1,27323539,27323633,0,115249616
IMR90|chr1:142639071-142639196,chr1,142639071,142639196,IMR90|chr1:1259323-1259348,chr1,1259323,1259348,0,141379748
IMR90|chr1:142946234-142946282,chr1,142946234,142946282,IMR90|chr1:94705608-94705652,chr1,94705608,94705652,0,48240626
IMR90|chr1:143007815-143007930,chr1,143007815,143007930,IMR90|chr1:27150392-27150428,chr1,27150392,27150428,0,115857423
IMR90|chr1:143252385-143252439,chr1,143252385,143252439,IMR90|chr1:148557522-148557646,chr1,148557522,148557646,0,5305137
IMR90|chr1:143271983-143272036,chr1,143271983,143272036,IMR90|chr1:27323540-27323619,chr1,27323540,27323619,0,115948443
IMR90|chr1:143399934-143400023,chr1,143399934,143400023,IMR90|chr1:10005637-10005739,chr1,10005637,10005739,0,133394297
IMR90|chr1:143432624-143432694,chr1,143432624,143432694,IMR90|chr1:244618197-244618256,chr1,244618197,244618256,0,101185573
IMR90|chr1:143444807-143444943,chr1,143444807,143444943,IMR90|chr1:148560505-148560654,chr1,148560505,148560654,0,5115698
IMR90|chr1:143591497-143591568,chr1,143591497,143591568,IMR90|chr1:43313495-43313556,chr1,43313495,43313556,0,100278002
IMR90|chr1:143625531-143625620,chr1,143625531,143625620,IMR90|chr1:32480973-32481056,chr1,32480973,32481056,0,111144558
IMR90|chr1:143659832-143659898,chr1,143659832,143659898,IMR90|chr1:162532404-162532477,chr1,162532404,162532477,0,18872572
IMR90|chr1:143688092-143688159,chr1,143688092,143688159,IMR90|chr1:27321204-27321224,chr1,27321204,27321224,0,116366888
IMR90|chr1:143821432-143821510,chr1,143821432,143821510,IMR90|chr1:64240364-64240433,chr1,64240364,64240433,0,79581068
IMR90|chr1:143991288-143991435,chr1,143991288,143991435,IMR90|chr1:173445770-173445797,chr1,173445770,173445797,0,29454482
IMR90|chr1:144048015-144048091,chr1,144048015,144048091,IMR90|chr1:219348136-219348172,chr1,219348136,219348172,0,75300121
IMR90|chr1:144066423-144066526,chr1,144066423,144066526,IMR90|chr1:27324051-27324080,chr1,27324051,27324080,0,116742372
IMR90|chr1:144155688-144155838,chr1,144155688,144155838,IMR90|chr1:19811544-19811577,chr1,19811544,19811577,0,124344144
IMR90|chr1:144364293-144364339,chr1,144364293,144364339,IMR90|chr1:27323746-27323807,chr1,27323746,27323807,0,117040547
IMR90|chr1:144403871-144403889,chr1,144403871,144403889,IMR90|chr1:225965764-225965858,chr1,225965764,225965858,0,81561893
IMR90|chr1:144437968-144438088,chr1,144437968,144438088,IMR90|chr1:54202144-54202180,chr1,54202144,54202180,0,90235824
IMR90|chr1:144613934-144614014,chr1,144613934,144614014,IMR90|chr1:173836013-173836060,chr1,173836013,173836060,0,29222079
IMR90|chr1:144705045-144705106,chr1,144705045,144705106,IMR90|chr1:148556153-148556180,chr1,148556153,148556180,0,3851108
IMR90|chr1:144953443-144953491,chr1,144953443,144953491,IMR90|chr1:1820133-1820213,chr1,1820133,1820213,0,143133310
IMR90|chr1:145055741-145055825,chr1,145055741,145055825,IMR90|chr1:32480002-32480064,chr1,32480002,32480064,0,112575739
IMR90|chr1:145124026-145124081,chr1,145124026,145124081,IMR90|chr1:16302213-16302286,chr1,16302213,16302286,0,128821813
IMR90|chr1:145159148-145159251,chr1,145159148,145159251,IMR90|chr1:8083490-8083537,chr1,8083490,8083537,0,137075658
IMR90|chr1:145271415-145271484,chr1,145271415,145271484,IMR90|chr1:162532853-162532902,chr1,162532853,162532902,0,17261438
IMR90|chr1:145566961-145567039,chr1,145566961,145567039,IMR90|chr1:148556134-148556180,chr1,148556134,148556180,0,2989173
IMR90|chr1:145593614-145593684,chr1,145593614,145593684,IMR90|chr1:244618197-244618256,chr1,244618197,244618256,0,99024583
IMR90|chr1:145643611-145643658,chr1,145643611,145643658,IMR90|chr1:180125883-180125941,chr1,180125883,180125941,0,34482272
IMR90|chr1:145671703-145671768,chr1,145671703,145671768,IMR90|chr1:24067378-24067460,chr1,24067378,24067460,0,121604325
IMR90|chr1:145703699-145703745,chr1,145703699,145703745,IMR90|chr1:148556366-148556417,chr1,148556366,148556417,0,2852667
IMR90|chr1:145873697-145873729,chr1,145873697,145873729,IMR90|chr1:27321788-27321862,chr1,27321788,27321862,0,118551909
IMR90|chr1:145953583-145953624,chr1,145953583,145953624,IMR90|chr1:8936901-8936931,chr1,8936901,8936931,0,137016682
IMR90|chr1:146194532-146194573,chr1,146194532,146194573,IMR90|chr1:76254147-76254208,chr1,76254147,76254208,0,69940385
IMR90|chr1:146290142-146290272,chr1,146290142,146290272,IMR90|chr1:104068950-104068979,chr1,104068950,104068979,0,42221192
IMR90|chr1:146317592-146317710,chr1,146317592,146317710,IMR90|chr1:223901424-223901450,chr1,223901424,223901450,0,77583832
IMR90|chr1:146448155-146448207,chr1,146448155,146448207,IMR90|chr1:8085007-8085064,chr1,8085007,8085064,0,138363148
IMR90|chr1:146557852-146557883,chr1,146557852,146557883,IMR90|chr1:213225449-213225500,chr1,213225449,213225500,0,66667597
IMR90|chr1:146770708-146770740,chr1,146770708,146770740,IMR90|chr1:27321788-27321862,chr1,27321788,27321862,0,119448920
IMR90|chr1:146877848-146877878,chr1,146877848,146877878,IMR90|chr1:173830433-173830545,chr1,173830433,173830545,0,26952585
IMR90|chr1:146887752-146887820,chr1,146887752,146887820,IMR90|chr1:27322348-27322427,chr1,27322348,27322427,0,119565404
IMR90|chr1:146939839-146939922,chr1,146939839,146939922,IMR90|chr1:43837259-43837327,chr1,43837259,43837327,0,103102580
IMR90|chr1:146951132-146951203,chr1,146951132,146951203,IMR90|chr1:148556217-148556289,chr1,148556217,148556289,0,1605085
IMR90|chr1:147083346-147083493,chr1,147083346,147083493,IMR90|chr1:173445770-173445797,chr1,173445770,173445797,0,26362424
IMR90|chr1:147787299-147787352,chr1,147787299,147787352,IMR90|chr1:114302851-114302946,chr1,114302851,114302946,0,33484448
IMR90|chr1:147818303-147818328,chr1,147818303,147818328,IMR90|chr1:42800126-42800256,chr1,42800126,42800256,0,105018177
IMR90|chr1:147823999-147824110,chr1,147823999,147824110,IMR90|chr1:716005-716144,chr1,716005,716144,0,147107994
IMR90|chr1:147842304-147842454,chr1,147842304,147842454,IMR90|chr1:148558180-148558286,chr1,148558180,148558286,0,715876
IMR90|chr1:147850565-147850592,chr1,147850565,147850592,IMR90|chr1:27155691-27155814,chr1,27155691,27155814,0,120694874
IMR90|chr1:147936675-147936809,chr1,147936675,147936809,IMR90|chr1:27323233-27323269,chr1,27323233,27323269,0,120613442
IMR90|chr1:147975504-147975551,chr1,147975504,147975551,IMR90|chr1:180125883-180125941,chr1,180125883,180125941,0,32150379
IMR90|chr1:148072571-148072661,chr1,148072571,148072661,IMR90|chr1:31851907-31851960,chr1,31851907,31851960,0,116220664
IMR90|chr1:148418085-148418107,chr1,148418085,148418107,IMR90|chr1:27322687-27322775,chr1,27322687,27322775,0,121095398
IMR90|chr1:148881819-148881883,chr1,148881819,148881883,IMR90|chr1:27321501-27321538,chr1,27321501,27321538,0,121560318
IMR90|chr1:149636084-149636163,chr1,149636084,149636163,IMR90|chr1:39736176-39736247,chr1,39736176,39736247,0,109899908
IMR90|chr1:149788196-149788343,chr1,149788196,149788343,IMR90|chr1:148558193-148558343,chr1,148558193,148558343,0,1230003
IMR90|chr1:150216431-150216486,chr1,150216431,150216486,IMR90|chr1:24066174-24066269,chr1,24066174,24066269,0,126150257
IMR90|chr1:150291555-150291596,chr1,150291555,150291596,IMR90|chr1:32401156-32401230,chr1,32401156,32401230,0,117890399
IMR90|chr1:150330068-150330142,chr1,150330068,150330142,IMR90|chr1:63156306-63156358,chr1,63156306,63156358,0,87173762
IMR90|chr1:150477290-150477397,chr1,150477290,150477397,IMR90|chr1:57043980-57044010,chr1,57043980,57044010,0,93433310
IMR90|chr1:150484602-150484740,chr1,150484602,150484740,IMR90|chr1:27323962-27324002,chr1,27323962,27324002,0,123160640
IMR90|chr1:150884403-150884553,chr1,150884403,150884553,IMR90|chr1:148559593-148559743,chr1,148559593,148559743,0,2324810
IMR90|chr1:150968226-150968258,chr1,150968226,150968258,IMR90|chr1:27324398-27324525,chr1,27324398,27324525,0,123643828
IMR90|chr1:150992159-150992233,chr1,150992159,150992233,IMR90|chr1:85724919-85724954,chr1,85724919,85724954,0,65267240
IMR90|chr1:151101864-151101968,chr1,151101864,151101968,IMR90|chr1:173834904-173834943,chr1,173834904,173834943,0,22733040
IMR90|chr1:151161775-151161887,chr1,151161775,151161887,IMR90|chr1:95003775-95003806,chr1,95003775,95003806,0,56158000
IMR90|chr1:151185383-151185480,chr1,151185383,151185480,IMR90|chr1:247495583-247495609,chr1,247495583,247495609,0,96310200
IMR90|chr1:151273569-151273661,chr1,151273569,151273661,IMR90|chr1:40045466-40045524,chr1,40045466,40045524,0,111228103
IMR90|chr1:151524871-151524914,chr1,151524871,151524914,IMR90|chr1:25074422-25074529,chr1,25074422,25074529,0,126450449
IMR90|chr1:151792655-151792693,chr1,151792655,151792693,IMR90|chr1:221911147-221911227,chr1,221911147,221911227,0,70118492
IMR90|chr1:152464668-152464711,chr1,152464668,152464711,IMR90|chr1:205717808-205717907,chr1,205717808,205717907,0,53253140
IMR90|chr1:152617456-152617565,chr1,152617456,152617565,IMR90|chr1:173986494-173986535,chr1,173986494,173986535,0,21369038
IMR90|chr1:152667092-152667110,chr1,152667092,152667110,IMR90|chr1:148556195-148556345,chr1,148556195,148556345,0,4110897
IMR90|chr1:152810851-152811001,chr1,152810851,152811001,IMR90|chr1:27323900-27323926,chr1,27323900,27323926,0,125486951
IMR90|chr1:152905757-152905789,chr1,152905757,152905789,IMR90|chr1:27324256-27324374,chr1,27324256,27324374,0,125581501
IMR90|chr1:152917963-152918113,chr1,152917963,152918113,IMR90|chr1:27324578-27324617,chr1,27324578,27324617,0,125593385
IMR90|chr1:153135420-153135467,chr1,153135420,153135467,IMR90|chr1:27324174-27324210,chr1,27324174,27324210,0,125811246
IMR90|chr1:153186650-153186738,chr1,153186650,153186738,IMR90|chr1:29506951-29506994,chr1,29506951,29506994,0,123679699
IMR90|chr1:153293457-153293607,chr1,153293457,153293607,IMR90|chr1:148556254-148556272,chr1,148556254,148556272,0,4737203
IMR90|chr1:153409046-153409115,chr1,153409046,153409115,IMR90|chr1:148556134-148556180,chr1,148556134,148556180,0,4852912
IMR90|chr1:153461253-153461313,chr1,153461253,153461313,IMR90|chr1:43837390-43837431,chr1,43837390,43837431,0,109623863
IMR90|chr1:153489638-153489689,chr1,153489638,153489689,IMR90|chr1:222884430-222884524,chr1,222884430,222884524,0,69394792
IMR90|chr1:153511992-153512068,chr1,153511992,153512068,IMR90|chr1:39736176-39736247,chr1,39736176,39736247,0,113775816
IMR90|chr1:153512880-153512997,chr1,153512880,153512997,IMR90|chr1:27323942-27323975,chr1,27323942,27323975,0,126188938
IMR90|chr1:153647207-153647286,chr1,153647207,153647286,IMR90|chr1:173446118-173446148,chr1,173446118,173446148,0,19798911
IMR90|chr1:153736060-153736138,chr1,153736060,153736138,IMR90|chr1:173446118-173446148,chr1,173446118,173446148,0,19710058
IMR90|chr1:153777237-153777303,chr1,153777237,153777303,IMR90|chr1:213225449-213225500,chr1,213225449,213225500,0,59448212
IMR90|chr1:153865879-153865908,chr1,153865879,153865908,IMR90|chr1:173830433-173830545,chr1,173830433,173830545,0,19964554
IMR90|chr1:154101175-154101262,chr1,154101175,154101262,IMR90|chr1:19813989-19814048,chr1,19813989,19814048,0,134287186
IMR90|chr1:154130327-154130442,chr1,154130327,154130442,IMR90|chr1:165600519-165600565,chr1,165600519,165600565,0,11470192
IMR90|chr1:154197036-154197186,chr1,154197036,154197186,IMR90|chr1:28971639-28971740,chr1,28971639,28971740,0,125225397
IMR90|chr1:154295313-154295429,chr1,154295313,154295429,IMR90|chr1:173986494-173986535,chr1,173986494,173986535,0,19691181
IMR90|chr1:154396104-154396251,chr1,154396104,154396251,IMR90|chr1:173830748-173830859,chr1,173830748,173830859,0,19434644
IMR90|chr1:154494839-154494894,chr1,154494839,154494894,IMR90|chr1:201440319-201440404,chr1,201440319,201440404,0,46945480
IMR90|chr1:154603672-154603795,chr1,154603672,154603795,IMR90|chr1:173445770-173445797,chr1,173445770,173445797,0,18842098
IMR90|chr1:154999062-154999117,chr1,154999062,154999117,IMR90|chr1:24071154-24071201,chr1,24071154,24071201,0,130927908
IMR90|chr1:155024256-155024329,chr1,155024256,155024329,IMR90|chr1:22382044-22382121,chr1,22382044,22382121,0,132642212
IMR90|chr1:155101944-155101991,chr1,155101944,155101991,IMR90|chr1:16570495-16570573,chr1,16570495,16570573,0,138531449
IMR90|chr1:155767581-155767649,chr1,155767581,155767649,IMR90|chr1:27322312-27322394,chr1,27322312,27322394,0,128445269
IMR90|chr1:156183885-156183934,chr1,156183885,156183934,IMR90|chr1:161086759-161086866,chr1,161086759,161086866,0,4902874
IMR90|chr1:156233104-156233251,chr1,156233104,156233251,IMR90|chr1:173445770-173445797,chr1,173445770,173445797,0,17212666
IMR90|chr1:156360511-156360600,chr1,156360511,156360600,IMR90|chr1:32480973-32481056,chr1,32480973,32481056,0,123879538
IMR90|chr1:156458259-156458292,chr1,156458259,156458292,IMR90|chr1:148558257-148558317,chr1,148558257,148558317,0,7900002
IMR90|chr1:156645995-156646098,chr1,156645995,156646098,IMR90|chr1:24972876-24972912,chr1,24972876,24972912,0,131673119
IMR90|chr1:156753593-156753691,chr1,156753593,156753691,IMR90|chr1:27321344-27321368,chr1,27321344,27321368,0,129432249
IMR90|chr1:157096910-157096995,chr1,157096910,157096995,IMR90|chr1:27930330-27930392,chr1,27930330,27930392,0,129166580
IMR90|chr1:157127086-157127189,chr1,157127086,157127189,IMR90|chr1:148556145-148556180,chr1,148556145,148556180,0,8570941
IMR90|chr1:157203950-157204003,chr1,157203950,157204003,IMR90|chr1:8083645-8083725,chr1,8083645,8083725,0,149120305
IMR90|chr1:157490488-157490531,chr1,157490488,157490531,IMR90|chr1:223901169-223901276,chr1,223901169,223901276,0,66410681
IMR90|chr1:157710173-157710225,chr1,157710173,157710225,IMR90|chr1:2118077-2118142,chr1,2118077,2118142,0,155592096
IMR90|chr1:157982868-157982884,chr1,157982868,157982884,IMR90|chr1:27321387-27321417,chr1,27321387,27321417,0,130661481
IMR90|chr1:158058885-158058996,chr1,158058885,158058996,IMR90|chr1:27324578-27324617,chr1,27324578,27324617,0,130734307
IMR90|chr1:158273867-158273915,chr1,158273867,158273915,IMR90|chr1:114304363-114304448,chr1,114304363,114304448,0,43969504
IMR90|chr1:158341042-158341111,chr1,158341042,158341111,IMR90|chr1:1714214-1714244,chr1,1714214,1714244,0,156626828
IMR90|chr1:158616865-158616935,chr1,158616865,158616935,IMR90|chr1:219348136-219348172,chr1,219348136,219348172,0,60731271
IMR90|chr1:158621126-158621217,chr1,158621126,158621217,IMR90|chr1:223902186-223902267,chr1,223902186,223902267,0,65281060
IMR90|chr1:159452044-159452103,chr1,159452044,159452103,IMR90|chr1:200379424-200379441,chr1,200379424,200379441,0,40927380
IMR90|chr1:159611757-159611799,chr1,159611757,159611799,IMR90|chr1:205288085-205288193,chr1,205288085,205288193,0,45676328
IMR90|chr1:159808056-159808179,chr1,159808056,159808179,IMR90|chr1:43837293-43837329,chr1,43837293,43837329,0,115970763
IMR90|chr1:159865461-159865611,chr1,159865461,159865611,IMR90|chr1:148558170-148558320,chr1,148558170,148558320,0,11307291
IMR90|chr1:160058352-160058407,chr1,160058352,160058407,IMR90|chr1:24065100-24065195,chr1,24065100,24065195,0,135993252
IMR90|chr1:160077984-160078043,chr1,160077984,160078043,IMR90|chr1:200379424-200379441,chr1,200379424,200379441,0,40301440
IMR90|chr1:160372658-160372701,chr1,160372658,160372701,IMR90|chr1:27321519-27321553,chr1,27321519,27321553,0,133051139
IMR90|chr1:160466072-160466183,chr1,160466072,160466183,IMR90|chr1:173445770-173445837,chr1,173445770,173445837,0,12979698
IMR90|chr1:160499005-160499049,chr1,160499005,160499049,IMR90|chr1:861899-862049,chr1,861899,862049,0,159637106
IMR90|chr1:160519539-160519630,chr1,160519539,160519630,IMR90|chr1:40041095-40041153,chr1,40041095,40041153,0,120478444
IMR90|chr1:160655918-160655999,chr1,160655918,160655999,IMR90|chr1:38455059-38455132,chr1,38455059,38455132,0,122200859
IMR90|chr1:161296428-161296528,chr1,161296428,161296528,IMR90|chr1:33813206-33813246,chr1,33813206,33813246,0,127483222
IMR90|chr1:161303701-161303759,chr1,161303701,161303759,IMR90|chr1:162602439-162602530,chr1,162602439,162602530,0,1298738
IMR90|chr1:161317548-161317596,chr1,161317548,161317596,IMR90|chr1:148558160-148558300,chr1,148558160,148558300,0,12759388
IMR90|chr1:161359356-161359374,chr1,161359356,161359374,IMR90|chr1:94703420-94703508,chr1,94703420,94703508,0,66655936
IMR90|chr1:161390709-161390848,chr1,161390709,161390848,IMR90|chr1:43422850-43422882,chr1,43422850,43422882,0,117967859
IMR90|chr1:161655751-161655829,chr1,161655751,161655829,IMR90|chr1:162602442-162602510,chr1,162602442,162602510,0,946691
IMR90|chr1:161850160-161850220,chr1,161850160,161850220,IMR90|chr1:33818414-33818478,chr1,33818414,33818478,0,128031746
IMR90|chr1:161894431-161894489,chr1,161894431,161894489,IMR90|chr1:27323235-27323322,chr1,27323235,27323322,0,134571196
IMR90|chr1:161974929-161974968,chr1,161974929,161974968,IMR90|chr1:9192620-9192731,chr1,9192620,9192731,0,152782309
IMR90|chr1:162327586-162327669,chr1,162327586,162327669,IMR90|chr1:27323912-27324052,chr1,27323912,27324052,0,135003674
IMR90|chr1:162501631-162501658,chr1,162501631,162501658,IMR90|chr1:27322159-27322279,chr1,27322159,27322279,0,135179472
IMR90|chr1:162569259-162569354,chr1,162569259,162569354,IMR90|chr1:182809177-182809215,chr1,182809177,182809215,0,20239918
IMR90|chr1:162623992-162624035,chr1,162623992,162624035,IMR90|chr1:78150360-78150391,chr1,78150360,78150391,0,84473632
IMR90|chr1:162726251-162726312,chr1,162726251,162726312,IMR90|chr1:27322912-27322976,chr1,27322912,27322976,0,135403339
IMR90|chr1:162883977-162884020,chr1,162883977,162884020,IMR90|chr1:182993725-182993776,chr1,182993725,182993776,0,20109748
IMR90|chr1:163185809-163185912,chr1,163185809,163185912,IMR90|chr1:24065933-24065972,chr1,24065933,24065972,0,139119876
IMR90|chr1:163536183-163536258,chr1,163536183,163536258,IMR90|chr1:24064903-24065053,chr1,24064903,24065053,0,139471280
IMR90|chr1:163682171-163682207,chr1,163682171,163682207,IMR90|chr1:148556145-148556180,chr1,148556145,148556180,0,15126026
IMR90|chr1:163745200-163745299,chr1,163745200,163745299,IMR90|chr1:33938332-33938394,chr1,33938332,33938394,0,129806868
IMR90|chr1:163993259-163993345,chr1,163993259,163993345,IMR90|chr1:173445770-173445819,chr1,173445770,173445819,0,9452511
IMR90|chr1:164195439-164195531,chr1,164195439,164195531,IMR90|chr1:43837162-43837306,chr1,43837162,43837306,0,120358277
IMR90|chr1:164247631-164247725,chr1,164247631,164247725,IMR90|chr1:26147788-26147809,chr1,26147788,26147809,0,138099843
IMR90|chr1:164295818-164295870,chr1,164295818,164295870,IMR90|chr1:2118077-2118142,chr1,2118077,2118142,0,162177741
IMR90|chr1:164321286-164321327,chr1,164321286,164321327,IMR90|chr1:161086759-161086866,chr1,161086759,161086866,0,3234527
IMR90|chr1:164389255-164389318,chr1,164389255,164389318,IMR90|chr1:27323379-27323427,chr1,27323379,27323427,0,137065876
IMR90|chr1:164423763-164423802,chr1,164423763,164423802,IMR90|chr1:173830748-173830859,chr1,173830748,173830859,0,9406985
IMR90|chr1:164498782-164498932,chr1,164498782,164498932,IMR90|chr1:148558160-148558306,chr1,148558160,148558306,0,15940622
IMR90|chr1:164533387-164533469,chr1,164533387,164533469,IMR90|chr1:173445770-173445819,chr1,173445770,173445819,0,8912383
IMR90|chr1:164616487-164616579,chr1,164616487,164616579,IMR90|chr1:27322971-27322990,chr1,27322971,27322990,0,137293516
IMR90|chr1:164623952-164624002,chr1,164623952,164624002,IMR90|chr1:173830841-173830954,chr1,173830841,173830954,0,9206889
IMR90|chr1:164804495-164804644,chr1,164804495,164804644,IMR90|chr1:148558154-148558286,chr1,148558154,148558286,0,16246341
IMR90|chr1:164816317-164816366,chr1,164816317,164816366,IMR90|chr1:247499893-247499945,chr1,247499893,247499945,0,82683576
IMR90|chr1:164820554-164820602,chr1,164820554,164820602,IMR90|chr1:180125883-180125941,chr1,180125883,180125941,0,15305329
IMR90|chr1:165169307-165169412,chr1,165169307,165169412,IMR90|chr1:148557625-148557655,chr1,148557625,148557655,0,16611682
IMR90|chr1:165657288-165657389,chr1,165657288,165657389,IMR90|chr1:243416615-243416651,chr1,243416615,243416651,0,77759327
IMR90|chr1:165909956-165910005,chr1,165909956,165910005,IMR90|chr1:200381739-200381781,chr1,200381739,200381781,0,34471783
IMR90|chr1:165924531-165924597,chr1,165924531,165924597,IMR90|chr1:213225449-213225500,chr1,213225449,213225500,0,47300918
IMR90|chr1:165956367-165956457,chr1,165956367,165956457,IMR90|chr1:148556145-148556180,chr1,148556145,148556180,0,17400222
IMR90|chr1:165957127-165957277,chr1,165957127,165957277,IMR90|chr1:148556254-148556272,chr1,148556254,148556272,0,17400873
IMR90|chr1:166270766-166270883,chr1,166270766,166270883,IMR90|chr1:155881927-155881974,chr1,155881927,155881974,0,10388839
IMR90|chr1:166441179-166441229,chr1,166441179,166441229,IMR90|chr1:8584810-8584907,chr1,8584810,8584907,0,157856369
IMR90|chr1:166538280-166538382,chr1,166538280,166538382,IMR90|chr1:22384154-22384174,chr1,22384154,22384174,0,144154126
IMR90|chr1:166668009-166668129,chr1,166668009,166668129,IMR90|chr1:22384206-22384233,chr1,22384206,22384233,0,144283803
IMR90|chr1:166670240-166670325,chr1,166670240,166670325,IMR90|chr1:40508198-40508263,chr1,40508198,40508263,0,126162042
IMR90|chr1:166932796-166932883,chr1,166932796,166932883,IMR90|chr1:54203716-54203779,chr1,54203716,54203779,0,112729080
IMR90|chr1:166933135-166933188,chr1,166933135,166933188,IMR90|chr1:243420113-243420166,chr1,243420113,243420166,0,76486978
IMR90|chr1:166966456-166966559,chr1,166966456,166966559,IMR90|chr1:8083490-8083537,chr1,8083490,8083537,0,158882966
IMR90|chr1:167093232-167093326,chr1,167093232,167093326,IMR90|chr1:2323674-2323720,chr1,2323674,2323720,0,164769558
IMR90|chr1:167178646-167178762,chr1,167178646,167178762,IMR90|chr1:173986494-173986535,chr1,173986494,173986535,0,6807848
IMR90|chr1:167384508-167384569,chr1,167384508,167384569,IMR90|chr1:148556153-148556180,chr1,148556153,148556180,0,18828355
IMR90|chr1:167740397-167740502,chr1,167740397,167740502,IMR90|chr1:173445770-173445815,chr1,173445770,173445815,0,5705373
IMR90|chr1:167840080-167840138,chr1,167840080,167840138,IMR90|chr1:27323235-27323322,chr1,27323235,27323322,0,140516845
IMR90|chr1:167840477-167840564,chr1,167840477,167840564,IMR90|chr1:1311281-1311334,chr1,1311281,1311334,0,166529196
IMR90|chr1:167866148-167866201,chr1,167866148,167866201,IMR90|chr1:27323706-27323778,chr1,27323706,27323778,0,140542442
IMR90|chr1:167919997-167920028,chr1,167919997,167920028,IMR90|chr1:226067647-226067692,chr1,226067647,226067692,0,58147650
IMR90|chr1:168007414-168007531,chr1,168007414,168007531,IMR90|chr1:219347314-219347352,chr1,219347314,219347352,0,51339900
IMR90|chr1:168479831-168479948,chr1,168479831,168479948,IMR90|chr1:201708065-201708092,chr1,201708065,201708092,0,33228234
IMR90|chr1:168875175-168875230,chr1,168875175,168875230,IMR90|chr1:24071154-24071201,chr1,24071154,24071201,0,144804021
IMR90|chr1:169106292-169106358,chr1,169106292,169106358,IMR90|chr1:27322903-27323053,chr1,27322903,27323053,0,141783389
IMR90|chr1:169570240-169570306,chr1,169570240,169570306,IMR90|chr1:154530175-154530228,chr1,154530175,154530228,0,15040065
IMR90|chr1:169590156-169590205,chr1,169590156,169590205,IMR90|chr1:7834703-7834748,chr1,7834703,7834748,0,161755453
IMR90|chr1:169972292-169972442,chr1,169972292,169972442,IMR90|chr1:148558154-148558286,chr1,148558154,148558286,0,21414138
IMR90|chr1:169989547-169989648,chr1,169989547,169989648,IMR90|chr1:165600519-165600565,chr1,165600519,165600565,0,4389028
IMR90|chr1:170107719-170107778,chr1,170107719,170107778,IMR90|chr1:54204471-54204525,chr1,54204471,54204525,0,115903248
IMR90|chr1:170166100-170166148,chr1,170166100,170166148,IMR90|chr1:202112228-202112312,chr1,202112228,202112312,0,31946128
IMR90|chr1:170457564-170457674,chr1,170457564,170457674,IMR90|chr1:148556063-148556173,chr1,148556063,148556173,0,21901501
IMR90|chr1:170605563-170605584,chr1,170605563,170605584,IMR90|chr1:180125365-180125432,chr1,180125365,180125432,0,9519802
IMR90|chr1:170674345-170674495,chr1,170674345,170674495,IMR90|chr1:148556791-148556810,chr1,148556791,148556810,0,22117554
IMR90|chr1:170700198-170700268,chr1,170700198,170700268,IMR90|chr1:1820471-1820522,chr1,1820471,1820522,0,168879727
IMR90|chr1:170833929-170833973,chr1,170833929,170833973,IMR90|chr1:861899-862049,chr1,861899,862049,0,169972030
IMR90|chr1:170950221-170950290,chr1,170950221,170950290,IMR90|chr1:162532404-162532477,chr1,162532404,162532477,0,8417817
IMR90|chr1:171003991-171004050,chr1,171003991,171004050,IMR90|chr1:27321406-27321497,chr1,27321406,27321497,0,143682585
IMR90|chr1:171094454-171094490,chr1,171094454,171094490,IMR90|chr1:27323768-27323819,chr1,27323768,27323819,0,143770686
IMR90|chr1:171191901-171191965,chr1,171191901,171191965,IMR90|chr1:205718968-205719017,chr1,205718968,205719017,0,34527067
IMR90|chr1:171283300-171283361,chr1,171283300,171283361,IMR90|chr1:27321501-27321538,chr1,27321501,27321538,0,143961799
IMR90|chr1:171361977-171362083,chr1,171361977,171362083,IMR90|chr1:54200818-54200846,chr1,54200818,54200846,0,117161159
IMR90|chr1:171432863-171432898,chr1,171432863,171432898,IMR90|chr1:2323403-2323527,chr1,2323403,2323527,0,169109460
IMR90|chr1:171623033-171623078,chr1,171623033,171623078,IMR90|chr1:2345970-2346065,chr1,2345970,2346065,0,169277063
IMR90|chr1:171792140-171792213,chr1,171792140,171792213,IMR90|chr1:173445770-173445817,chr1,173445770,173445817,0,1653630
IMR90|chr1:171806444-171806487,chr1,171806444,171806487,IMR90|chr1:32401156-32401230,chr1,32401156,32401230,0,139405288
IMR90|chr1:171877626-171877647,chr1,171877626,171877647,IMR90|chr1:24071154-24071201,chr1,24071154,24071201,0,147806472
IMR90|chr1:171882837-171882886,chr1,171882837,171882886,IMR90|chr1:182810054-182810095,chr1,182810054,182810095,0,10927217
IMR90|chr1:172040187-172040206,chr1,172040187,172040206,IMR90|chr1:27321695-27321733,chr1,27321695,27321733,0,144718492
IMR90|chr1:172156041-172156154,chr1,172156041,172156154,IMR90|chr1:156714265-156714302,chr1,156714265,156714302,0,15441776
IMR90|chr1:172260580-172260656,chr1,172260580,172260656,IMR90|chr1:85724919-85724954,chr1,85724919,85724954,0,86535661
IMR90|chr1:172306686-172306717,chr1,172306686,172306717,IMR90|chr1:36788493-36788575,chr1,36788493,36788575,0,135518193
IMR90|chr1:172843212-172843361,chr1,172843212,172843361,IMR90|chr1:148558193-148558286,chr1,148558193,148558286,0,24285019
IMR90|chr1:172897650-172897694,chr1,172897650,172897694,IMR90|chr1:41155932-41156015,chr1,41155932,41156015,0,131741718
IMR90|chr1:173269967-173270103,chr1,173269967,173270103,IMR90|chr1:173445770-173445789,chr1,173445770,173445789,0,175803
IMR90|chr1:173295772-173295804,chr1,173295772,173295804,IMR90|chr1:54203566-54203716,chr1,54203566,54203716,0,119092206
IMR90|chr1:173400651-173400756,chr1,173400651,173400756,IMR90|chr1:173445770-173445815,chr1,173445770,173445815,0,45119
IMR90|chr1:173505221-173505371,chr1,173505221,173505371,IMR90|chr1:19813989-19814048,chr1,19813989,19814048,0,153691232
IMR90|chr1:173544745-173544788,chr1,173544745,173544788,IMR90|chr1:220443595-220443660,chr1,220443595,220443660,0,46898850
IMR90|chr1:173572410-173572506,chr1,173572410,173572506,IMR90|chr1:214725857-214725909,chr1,214725857,214725909,0,41153447
IMR90|chr1:173697919-173697971,chr1,173697919,173697971,IMR90|chr1:8085007-8085064,chr1,8085007,8085064,0,165612912
IMR90|chr1:173745785-173745891,chr1,173745785,173745891,IMR90|chr1:173829408-173829432,chr1,173829408,173829432,0,83623
IMR90|chr1:173838525-173838556,chr1,173838525,173838556,IMR90|chr1:91360247-91360295,chr1,91360247,91360295,0,82478278
IMR90|chr1:173969946-173970020,chr1,173969946,173970020,IMR90|chr1:63156306-63156358,chr1,63156306,63156358,0,110813640
IMR90|chr1:174247386-174247447,chr1,174247386,174247447,IMR90|chr1:1820995-1821055,chr1,1820995,1821055,0,172426391
IMR90|chr1:174280698-174280751,chr1,174280698,174280751,IMR90|chr1:9296188-9296254,chr1,9296188,9296254,0,164984510
IMR90|chr1:174340330-174340400,chr1,174340330,174340400,IMR90|chr1:9194007-9194036,chr1,9194007,9194036,0,165146323
IMR90|chr1:174362416-174362455,chr1,174362416,174362455,IMR90|chr1:95004029-95004071,chr1,95004029,95004071,0,79358387
IMR90|chr1:174486446-174486596,chr1,174486446,174486596,IMR90|chr1:148559575-148559721,chr1,148559575,148559721,0,25926871
IMR90|chr1:174746204-174746277,chr1,174746204,174746277,IMR90|chr1:2322239-2322287,chr1,2322239,2322287,0,172423965
IMR90|chr1:174810750-174810793,chr1,174810750,174810793,IMR90|chr1:220443595-220443660,chr1,220443595,220443660,0,45632845
IMR90|chr1:174934618-174934677,chr1,174934618,174934677,IMR90|chr1:173445770-173445812,chr1,173445770,173445812,0,1488848
IMR90|chr1:175023314-175023350,chr1,175023314,175023350,IMR90|chr1:201619888-201619941,chr1,201619888,201619941,0,26596574
IMR90|chr1:175079361-175079426,chr1,175079361,175079426,IMR90|chr1:148557518-148557625,chr1,148557518,148557625,0,26521843
IMR90|chr1:175096658-175096768,chr1,175096658,175096768,IMR90|chr1:29064950-29064979,chr1,29064950,29064979,0,146031708
IMR90|chr1:175176815-175176856,chr1,175176815,175176856,IMR90|chr1:173830996-173831105,chr1,173830996,173831105,0,1345819
IMR90|chr1:175270406-175270425,chr1,175270406,175270425,IMR90|chr1:27321695-27321733,chr1,27321695,27321733,0,147948711
IMR90|chr1:175273095-175273145,chr1,175273095,175273145,IMR90|chr1:148556798-148556898,chr1,148556798,148556898,0,26716297
IMR90|chr1:175288356-175288433,chr1,175288356,175288433,IMR90|chr1:247498108-247498129,chr1,247498108,247498129,0,72209752
IMR90|chr1:175348829-175348910,chr1,175348829,175348910,IMR90|chr1:221911416-221911435,chr1,221911416,221911435,0,46562587
IMR90|chr1:175372798-175372875,chr1,175372798,175372875,IMR90|chr1:148557543-148557625,chr1,148557543,148557625,0,26815255
IMR90|chr1:175387964-175388053,chr1,175387964,175388053,IMR90|chr1:24972863-24972910,chr1,24972863,24972910,0,150415101
IMR90|chr1:175413321-175413360,chr1,175413321,175413360,IMR90|chr1:28558788-28558899,chr1,28558788,28558899,0,146854533
IMR90|chr1:175665124-175665173,chr1,175665124,175665173,IMR90|chr1:183442360-183442416,chr1,183442360,183442416,0,7777236
IMR90|chr1:175806226-175806317,chr1,175806226,175806317,IMR90|chr1:78471894-78471990,chr1,78471894,78471990,0,97334332
IMR90|chr1:175840047-175840116,chr1,175840047,175840116,IMR90|chr1:148556134-148556180,chr1,148556134,148556180,0,27283913
IMR90|chr1:175934086-175934167,chr1,175934086,175934167,IMR90|chr1:162606170-162606204,chr1,162606170,162606204,0,13327916
IMR90|chr1:176044247-176044278,chr1,176044247,176044278,IMR90|chr1:226067647-226067692,chr1,226067647,226067692,0,50023400
IMR90|chr1:176098622-176098738,chr1,176098622,176098738,IMR90|chr1:12037941-12037960,chr1,12037941,12037960,0,164060681
IMR90|chr1:176243650-176243770,chr1,176243650,176243770,IMR90|chr1:8085007-8085037,chr1,8085007,8085037,0,168158643
IMR90|chr1:176452492-176452584,chr1,176452492,176452584,IMR90|chr1:161118705-161118748,chr1,161118705,161118748,0,15333787
IMR90|chr1:176724069-176724144,chr1,176724069,176724144,IMR90|chr1:24064903-24065053,chr1,24064903,24065053,0,152659166
IMR90|chr1:177041642-177041792,chr1,177041642,177041792,IMR90|chr1:148556015-148556165,chr1,148556015,148556165,0,28485627
IMR90|chr1:177197852-177198002,chr1,177197852,177198002,IMR90|chr1:205090786-205090834,chr1,205090786,205090834,0,27892934
IMR90|chr1:177229828-177229908,chr1,177229828,177229908,IMR90|chr1:24066936-24067026,chr1,24066936,24067026,0,153162892
IMR90|chr1:177332880-177332992,chr1,177332880,177332992,IMR90|chr1:173445770-173445786,chr1,173445770,173445786,0,3887110
IMR90|chr1:177458883-177458981,chr1,177458883,177458981,IMR90|chr1:247499893-247499945,chr1,247499893,247499945,0,70041010
IMR90|chr1:178171954-178172076,chr1,178171954,178172076,IMR90|chr1:173445770-173445797,chr1,173445770,173445797,0,4726184
IMR90|chr1:178185799-178185871,chr1,178185799,178185871,IMR90|chr1:173828184-173828247,chr1,173828184,173828247,0,4357615
IMR90|chr1:178733196-178733251,chr1,178733196,178733251,IMR90|chr1:9296188-9296256,chr1,9296188,9296256,0,169437008
IMR90|chr1:178753201-178753230,chr1,178753201,178753230,IMR90|chr1:8083827-8083927,chr1,8083827,8083927,0,170669374
IMR90|chr1:178786245-178786294,chr1,178786245,178786294,IMR90|chr1:247499893-247499945,chr1,247499893,247499945,0,68713648
IMR90|chr1:179022555-179022617,chr1,179022555,179022617,IMR90|chr1:16483819-16483907,chr1,16483819,16483907,0,162538736
IMR90|chr1:179049572-179049587,chr1,179049572,179049587,IMR90|chr1:148558163-148558274,chr1,148558163,148558274,0,30491409
IMR90|chr1:179062074-179062181,chr1,179062074,179062181,IMR90|chr1:16485516-16485545,chr1,16485516,16485545,0,162576558
IMR90|chr1:179133480-179133628,chr1,179133480,179133628,IMR90|chr1:1255670-1255710,chr1,1255670,1255710,0,177877810
IMR90|chr1:179183877-179183992,chr1,179183877,179183992,IMR90|chr1:16089475-16089505,chr1,16089475,16089505,0,163094402
IMR90|chr1:179199128-179199158,chr1,179199128,179199158,IMR90|chr1:201707075-201707177,chr1,201707075,201707177,0,22507947
IMR90|chr1:179411426-179411504,chr1,179411426,179411504,IMR90|chr1:40941437-40941526,chr1,40941437,40941526,0,138469989
IMR90|chr1:179525239-179525355,chr1,179525239,179525355,IMR90|chr1:201708065-201708092,chr1,201708065,201708092,0,22182826
IMR90|chr1:179555681-179555804,chr1,179555681,179555804,IMR90|chr1:43837293-43837329,chr1,43837293,43837329,0,135718388
IMR90|chr1:179645120-179645234,chr1,179645120,179645234,IMR90|chr1:54202144-54202180,chr1,54202144,54202180,0,125442976
IMR90|chr1:179683023-179683094,chr1,179683023,179683094,IMR90|chr1:43313495-43313556,chr1,43313495,43313556,0,136369528
IMR90|chr1:179747647-179747698,chr1,179747647,179747698,IMR90|chr1:33501974-33502007,chr1,33501974,33502007,0,146245673
IMR90|chr1:179900645-179900683,chr1,179900645,179900683,IMR90|chr1:27324345-27324363,chr1,27324345,27324363,0,152576300
IMR90|chr1:180145378-180145475,chr1,180145378,180145475,IMR90|chr1:247495583-247495609,chr1,247495583,247495609,0,67350205
IMR90|chr1:180242214-180242279,chr1,180242214,180242279,IMR90|chr1:24066677-24066725,chr1,24066677,24066725,0,156175537
IMR90|chr1:180431887-180431932,chr1,180431887,180431932,IMR90|chr1:32480973-32481056,chr1,32480973,32481056,0,147950914
IMR90|chr1:180536507-180536563,chr1,180536507,180536563,IMR90|chr1:112302467-112302595,chr1,112302467,112302595,0,68234040
IMR90|chr1:180791448-180791478,chr1,180791448,180791478,IMR90|chr1:173830781-173830869,chr1,173830781,173830869,0,6960667
IMR90|chr1:181016028-181016061,chr1,181016028,181016061,IMR90|chr1:95003794-95003911,chr1,95003794,95003911,0,86012234
IMR90|chr1:181158483-181158525,chr1,181158483,181158525,IMR90|chr1:25074422-25074529,chr1,25074422,25074529,0,156084061
IMR90|chr1:181185597-181185644,chr1,181185597,181185644,IMR90|chr1:120189024-120189123,chr1,120189024,120189123,0,60996573
IMR90|chr1:181317035-181317068,chr1,181317035,181317068,IMR90|chr1:148558257-148558317,chr1,148558257,148558317,0,32758778
IMR90|chr1:181397667-181397752,chr1,181397667,181397752,IMR90|chr1:173831087-173831152,chr1,173831087,173831152,0,7566580
IMR90|chr1:181710577-181710608,chr1,181710577,181710608,IMR90|chr1:220222336-220222402,chr1,220222336,220222402,0,38511759
IMR90|chr1:181973161-181973199,chr1,181973161,181973199,IMR90|chr1:27321289-27321398,chr1,27321289,27321398,0,154651872
IMR90|chr1:182075319-182075353,chr1,182075319,182075353,IMR90|chr1:247496642-247496700,chr1,247496642,247496700,0,65421323
IMR90|chr1:182162510-182162593,chr1,182162510,182162593,IMR90|chr1:25074383-25074420,chr1,25074383,25074420,0,157088127
IMR90|chr1:182427636-182427653,chr1,182427636,182427653,IMR90|chr1:182809209-182809342,chr1,182809209,182809342,0,381573
IMR90|chr1:182821150-182821237,chr1,182821150,182821237,IMR90|chr1:54203716-54203779,chr1,54203716,54203779,0,128617434
IMR90|chr1:183182599-183182671,chr1,183182599,183182671,IMR90|chr1:214722548-214722600,chr1,214722548,214722600,0,31539949
IMR90|chr1:183396602-183396684,chr1,183396602,183396684,IMR90|chr1:162606170-162606204,chr1,162606170,162606204,0,20790432
IMR90|chr1:183966861-183966945,chr1,183966861,183966945,IMR90|chr1:178064523-178064589,chr1,178064523,178064589,0,5902338
IMR90|chr1:184114237-184114300,chr1,184114237,184114300,IMR90|chr1:78147419-78147499,chr1,78147419,78147499,0,105966818
IMR90|chr1:184134566-184134609,chr1,184134566,184134609,IMR90|chr1:25074422-25074529,chr1,25074422,25074529,0,159060144
IMR90|chr1:184168180-184168256,chr1,184168180,184168256,IMR90|chr1:110159274-110159315,chr1,110159274,110159315,0,74008906
IMR90|chr1:184683684-184683775,chr1,184683684,184683775,IMR90|chr1:114303265-114303363,chr1,114303265,114303363,0,70380419
IMR90|chr1:184888594-184888632,chr1,184888594,184888632,IMR90|chr1:221911147-221911227,chr1,221911147,221911227,0,37022553
IMR90|chr1:185135315-185135372,chr1,185135315,185135372,IMR90|chr1:10093899-10093935,chr1,10093899,10093935,0,175041416
IMR90|chr1:185189559-185189595,chr1,185189559,185189595,IMR90|chr1:27323924-27323977,chr1,27323924,27323977,0,157865635
IMR90|chr1:185561157-185561178,chr1,185561157,185561178,IMR90|chr1:182993599-182993657,chr1,182993599,182993657,0,2567558
IMR90|chr1:185719797-185719832,chr1,185719797,185719832,IMR90|chr1:27323713-27323806,chr1,27323713,27323806,0,158396084
IMR90|chr1:185800674-185800735,chr1,185800674,185800735,IMR90|chr1:40941437-40941526,chr1,40941437,40941526,0,144859237
IMR90|chr1:185916904-185916973,chr1,185916904,185916973,IMR90|chr1:27323394-27323490,chr1,27323394,27323490,0,158593510
IMR90|chr1:186120518-186120668,chr1,186120518,186120668,IMR90|chr1:2323674-2323720,chr1,2323674,2323720,0,183796844
IMR90|chr1:186323686-186323763,chr1,186323686,186323763,IMR90|chr1:148557543-148557625,chr1,148557543,148557625,0,37766143
IMR90|chr1:187051498-187051536,chr1,187051498,187051536,IMR90|chr1:27321347-27321392,chr1,27321347,27321392,0,159730151
IMR90|chr1:187367613-187367666,chr1,187367613,187367666,IMR90|chr1:9191845-9191901,chr1,9191845,9191901,0,178175768
IMR90|chr1:187425286-187425385,chr1,187425286,187425385,IMR90|chr1:243416615-243416651,chr1,243416615,243416651,0,55991329
IMR90|chr1:187514859-187514891,chr1,187514859,187514891,IMR90|chr1:220222335-220222402,chr1,220222335,220222402,0,32707476
IMR90|chr1:187639779-187639866,chr1,187639779,187639866,IMR90|chr1:182993725-182993776,chr1,182993725,182993776,0,4646054
IMR90|chr1:187685625-187685712,chr1,187685625,187685712,IMR90|chr1:1311281-1311334,chr1,1311281,1311334,0,186374344
IMR90|chr1:187734738-187734847,chr1,187734738,187734847,IMR90|chr1:24974523-24974583,chr1,24974523,24974583,0,162760215
IMR90|chr1:188000079-188000115,chr1,188000079,188000115,IMR90|chr1:32574945-32575018,chr1,32574945,32575018,0,155425134
IMR90|chr1:188032134-188032245,chr1,188032134,188032245,IMR90|chr1:716005-716144,chr1,716005,716144,0,187316129
IMR90|chr1:188197204-188197225,chr1,188197204,188197225,IMR90|chr1:94702692-94702800,chr1,94702692,94702800,0,93494512
IMR90|chr1:188227606-188227632,chr1,188227606,188227632,IMR90|chr1:1820119-1820266,chr1,1820119,1820266,0,186407487
IMR90|chr1:188324356-188324485,chr1,188324356,188324485,IMR90|chr1:78245486-78245585,chr1,78245486,78245585,0,110078870
IMR90|chr1:188509202-188509306,chr1,188509202,188509306,IMR90|chr1:173829382-173829432,chr1,173829382,173829432,0,14679820
IMR90|chr1:188612837-188612935,chr1,188612837,188612935,IMR90|chr1:173445770-173445829,chr1,173445770,173445829,0,15167067
IMR90|chr1:188614805-188614863,chr1,188614805,188614863,IMR90|chr1:94702468-94702554,chr1,94702468,94702554,0,93912337
IMR90|chr1:188881626-188881703,chr1,188881626,188881703,IMR90|chr1:8938147-8938208,chr1,8938147,8938208,0,179943479
IMR90|chr1:188904041-188904096,chr1,188904041,188904096,IMR90|chr1:9296188-9296256,chr1,9296188,9296256,0,179607853
IMR90|chr1:188983408-188983519,chr1,188983408,188983519,IMR90|chr1:27324578-27324617,chr1,27324578,27324617,0,161658830
IMR90|chr1:189364513-189364531,chr1,189364513,189364531,IMR90|chr1:214724784-214724827,chr1,214724784,214724827,0,25360271
IMR90|chr1:189511607-189511694,chr1,189511607,189511694,IMR90|chr1:148556133-148556180,chr1,148556133,148556180,0,40955474
IMR90|chr1:189543402-189543468,chr1,189543402,189543468,IMR90|chr1:162532404-162532477,chr1,162532404,162532477,0,27010998
IMR90|chr1:189543777-189543827,chr1,189543777,189543827,IMR90|chr1:7834703-7834748,chr1,7834703,7834748,0,181709074
IMR90|chr1:189559528-189559565,chr1,189559528,189559565,IMR90|chr1:8084836-8084896,chr1,8084836,8084896,0,181474692
IMR90|chr1:189576043-189576159,chr1,189576043,189576159,IMR90|chr1:247498524-247498571,chr1,247498524,247498571,0,57922481
IMR90|chr1:189677423-189677528,chr1,189677423,189677528,IMR90|chr1:1255669-1255713,chr1,1255669,1255713,0,188421754
IMR90|chr1:189709298-189709337,chr1,189709298,189709337,IMR90|chr1:27321825-27321925,chr1,27321825,27321925,0,162387473
IMR90|chr1:189731472-189731588,chr1,189731472,189731588,IMR90|chr1:148560501-148560648,chr1,148560501,148560648,0,41170971
IMR90|chr1:190031024-190031127,chr1,190031024,190031127,IMR90|chr1:173445770-173445817,chr1,173445770,173445817,0,16585254
IMR90|chr1:190080095-190080133,chr1,190080095,190080133,IMR90|chr1:27321289-27321398,chr1,27321289,27321398,0,162758806
IMR90|chr1:190176451-190176595,chr1,190176451,190176595,IMR90|chr1:148556296-148556443,chr1,148556296,148556443,0,41620155
IMR90|chr1:190360405-190360503,chr1,190360405,190360503,IMR90|chr1:112302467-112302595,chr1,112302467,112302595,0,78057938
IMR90|chr1:190592667-190592741,chr1,190592667,190592741,IMR90|chr1:22376429-22376471,chr1,22376429,22376471,0,168216238
IMR90|chr1:190655627-190655716,chr1,190655627,190655716,IMR90|chr1:162469031-162469071,chr1,162469031,162469071,0,28186596
IMR90|chr1:190891613-190891680,chr1,190891613,190891680,IMR90|chr1:45312634-45312678,chr1,45312634,45312678,0,145578979
IMR90|chr1:191604035-191604112,chr1,191604035,191604112,IMR90|chr1:247498108-247498129,chr1,247498108,247498129,0,55894073
IMR90|chr1:192060334-192060437,chr1,192060334,192060437,IMR90|chr1:180470505-180470553,chr1,180470505,180470553,0,11589829
IMR90|chr1:192195819-192195886,chr1,192195819,192195886,IMR90|chr1:27321204-27321224,chr1,27321204,27321224,0,164874615
IMR90|chr1:192351045-192351124,chr1,192351045,192351124,IMR90|chr1:39736176-39736247,chr1,39736176,39736247,0,152614869
IMR90|chr1:192480385-192480502,chr1,192480385,192480502,IMR90|chr1:27323942-27323975,chr1,27323942,27323975,0,165156443
IMR90|chr1:192522422-192522495,chr1,192522422,192522495,IMR90|chr1:148556207-148556280,chr1,148556207,148556280,0,43966215
IMR90|chr1:192618739-192618884,chr1,192618739,192618884,IMR90|chr1:173445770-173445865,chr1,173445770,173445865,0,19172969
IMR90|chr1:192876120-192876200,chr1,192876120,192876200,IMR90|chr1:173445770-173445819,chr1,173445770,173445819,0,19430350
IMR90|chr1:192901924-192901994,chr1,192901924,192901994,IMR90|chr1:32806166-32806210,chr1,32806166,32806210,0,160095758
IMR90|chr1:193170319-193170377,chr1,193170319,193170377,IMR90|chr1:221914345-221914379,chr1,221914345,221914379,0,28744026
IMR90|chr1:193487282-193487396,chr1,193487282,193487396,IMR90|chr1:43837293-43837329,chr1,43837293,43837329,0,149649989
IMR90|chr1:194131492-194131572,chr1,194131492,194131572,IMR90|chr1:148558154-148558286,chr1,148558154,148558286,0,45573338
IMR90|chr1:194211757-194211778,chr1,194211757,194211778,IMR90|chr1:156253167-156253293,chr1,156253167,156253293,0,37958590
IMR90|chr1:194695621-194695659,chr1,194695621,194695659,IMR90|chr1:148558145-148558286,chr1,148558145,148558286,0,46137476
IMR90|chr1:194897560-194897652,chr1,194897560,194897652,IMR90|chr1:1820362-1820411,chr1,1820362,1820411,0,193077198
IMR90|chr1:195057372-195057522,chr1,195057372,195057522,IMR90|chr1:148556288-148556438,chr1,148556288,148556438,0,46501084
IMR90|chr1:195127682-195127700,chr1,195127682,195127700,IMR90|chr1:33281457-33281552,chr1,33281457,33281552,0,161846225
IMR90|chr1:195200394-195200429,chr1,195200394,195200429,IMR90|chr1:32574945-32575019,chr1,32574945,32575019,0,162625449
IMR90|chr1:195218592-195218690,chr1,195218592,195218690,IMR90|chr1:27321344-27321368,chr1,27321344,27321368,0,167897248
IMR90|chr1:195368860-195368985,chr1,195368860,195368985,IMR90|chr1:1259323-1259348,chr1,1259323,1259348,0,194109537
IMR90|chr1:195977070-195977155,chr1,195977070,195977155,IMR90|chr1:1311281-1311334,chr1,1311281,1311334,0,194665789
IMR90|chr1:196454312-196454397,chr1,196454312,196454397,IMR90|chr1:247498734-247498760,chr1,247498734,247498760,0,51044422
IMR90|chr1:196548116-196548134,chr1,196548116,196548134,IMR90|chr1:148556195-148556345,chr1,148556195,148556345,0,47991921
IMR90|chr1:196558257-196558374,chr1,196558257,196558374,IMR90|chr1:1844308-1844341,chr1,1844308,1844341,0,194713949
IMR90|chr1:196645867-196645953,chr1,196645867,196645953,IMR90|chr1:148556691-148556725,chr1,148556691,148556725,0,48089176
IMR90|chr1:196695598-196695659,chr1,196695598,196695659,IMR90|chr1:227916656-227916729,chr1,227916656,227916729,0,31221058
IMR90|chr1:196796523-196796645,chr1,196796523,196796645,IMR90|chr1:25561485-25561513,chr1,25561485,25561513,0,171235038
IMR90|chr1:196959386-196959457,chr1,196959386,196959457,IMR90|chr1:109633581-109633636,chr1,109633581,109633636,0,87325805
IMR90|chr1:196991413-196991560,chr1,196991413,196991560,IMR90|chr1:44396896-44396919,chr1,44396896,44396919,0,152594517
IMR90|chr1:197191972-197192027,chr1,197191972,197192027,IMR90|chr1:145571705-145571750,chr1,145571705,145571750,0,51620267
IMR90|chr1:197297593-197297652,chr1,197297593,197297652,IMR90|chr1:27321406-27321497,chr1,27321406,27321497,0,169976187
IMR90|chr1:197409990-197410021,chr1,197409990,197410021,IMR90|chr1:148558145-148558286,chr1,148558145,148558286,0,48851845
IMR90|chr1:197458349-197458491,chr1,197458349,197458491,IMR90|chr1:148558160-148558294,chr1,148558160,148558294,0,48900189
IMR90|chr1:197547701-197547827,chr1,197547701,197547827,IMR90|chr1:224372297-224372406,chr1,224372297,224372406,0,26824596
IMR90|chr1:197557541-197557602,chr1,197557541,197557602,IMR90|chr1:27322912-27322976,chr1,27322912,27322976,0,170234629
IMR90|chr1:198162169-198162199,chr1,198162169,198162199,IMR90|chr1:148557541-148557625,chr1,148557541,148557625,0,49604628
IMR90|chr1:198190456-198190554,chr1,198190456,198190554,IMR90|chr1:27323337-27323389,chr1,27323337,27323389,0,170867119
IMR90|chr1:198212670-198212695,chr1,198212670,198212695,IMR90|chr1:27322150-27322242,chr1,27322150,27322242,0,170890520
IMR90|chr1:198943928-198944014,chr1,198943928,198944014,IMR90|chr1:67215309-67215341,chr1,67215309,67215341,0,131728619
IMR90|chr1:198978208-198978231,chr1,198978208,198978231,IMR90|chr1:27321973-27322065,chr1,27321973,27322065,0,171656235
IMR90|chr1:199180863-199180899,chr1,199180863,199180899,IMR90|chr1:171455337-171455427,chr1,171455337,171455427,0,27725526
IMR90|chr1:199337318-199337419,chr1,199337318,199337419,IMR90|chr1:205090786-205090834,chr1,205090786,205090834,0,5753468
IMR90|chr1:199361996-199362052,chr1,199361996,199362052,IMR90|chr1:38461304-38461342,chr1,38461304,38461342,0,160900692
IMR90|chr1:199482091-199482167,chr1,199482091,199482167,IMR90|chr1:247498108-247498130,chr1,247498108,247498130,0,48016017
IMR90|chr1:199847147-199847185,chr1,199847147,199847185,IMR90|chr1:148558145-148558286,chr1,148558145,148558286,0,51289002
IMR90|chr1:200365161-200365262,chr1,200365161,200365262,IMR90|chr1:205090786-205090834,chr1,205090786,205090834,0,4725625
IMR90|chr1:200521388-200521443,chr1,200521388,200521443,IMR90|chr1:95005560-95005610,chr1,95005560,95005610,0,105515828
IMR90|chr1:200697639-200697687,chr1,200697639,200697687,IMR90|chr1:180125883-180125941,chr1,180125883,180125941,0,20571756
IMR90|chr1:200916349-200916373,chr1,200916349,200916373,IMR90|chr1:24972816-24972942,chr1,24972816,24972942,0,175943533
IMR90|chr1:200930713-200930811,chr1,200930713,200930811,IMR90|chr1:173828321-173828353,chr1,173828321,173828353,0,27102392
IMR90|chr1:200987784-200987868,chr1,200987784,200987868,IMR90|chr1:151122686-151122733,chr1,151122686,151122733,0,49865098
IMR90|chr1:201119841-201119940,chr1,201119841,201119940,IMR90|chr1:21111658-21111706,chr1,21111658,21111706,0,180008183
IMR90|chr1:201182344-201182435,chr1,201182344,201182435,IMR90|chr1:151139498-151139526,chr1,151139498,151139526,0,50042846
IMR90|chr1:201247971-201248088,chr1,201247971,201248088,IMR90|chr1:1844308-1844341,chr1,1844308,1844341,0,199403663
IMR90|chr1:201327550-201327609,chr1,201327550,201327609,IMR90|chr1:54204471-54204525,chr1,54204471,54204525,0,147123079
IMR90|chr1:201985424-201985546,chr1,201985424,201985546,IMR90|chr1:156089263-156089359,chr1,156089263,156089359,0,45896161
IMR90|chr1:202287966-202288066,chr1,202287966,202288066,IMR90|chr1:247499894-247499945,chr1,247499894,247499945,0,45211928
IMR90|chr1:202552134-202552215,chr1,202552134,202552215,IMR90|chr1:173836015-173836065,chr1,173836015,173836065,0,28716119
IMR90|chr1:202564410-202564494,chr1,202564410,202564494,IMR90|chr1:151122686-151122733,chr1,151122686,151122733,0,51441724
IMR90|chr1:202725034-202725109,chr1,202725034,202725109,IMR90|chr1:148559562-148559709,chr1,148559562,148559709,0,54165472
IMR90|chr1:202980377-202980522,chr1,202980377,202980522,IMR90|chr1:148558160-148558300,chr1,148558160,148558300,0,54422217
IMR90|chr1:203104538-203104688,chr1,203104538,203104688,IMR90|chr1:173445770-173445790,chr1,173445770,173445790,0,29658768
IMR90|chr1:203143869-203143930,chr1,203143869,203143930,IMR90|chr1:173445770-173445808,chr1,173445770,173445808,0,29698099
IMR90|chr1:203199381-203199531,chr1,203199381,203199531,IMR90|chr1:1843065-1843117,chr1,1843065,1843117,0,201356316
IMR90|chr1:204067411-204067502,chr1,204067411,204067502,IMR90|chr1:27323265-27323306,chr1,27323265,27323306,0,176744146
IMR90|chr1:204419537-204419622,chr1,204419537,204419622,IMR90|chr1:156085784-156085817,chr1,156085784,156085817,0,48333753
IMR90|chr1:204530667-204530750,chr1,204530667,204530750,IMR90|chr1:23038661-23038694,chr1,23038661,23038694,0,181492006
IMR90|chr1:204534535-204534581,chr1,204534535,204534581,IMR90|chr1:183442360-183442416,chr1,183442360,183442416,0,21092175
IMR90|chr1:204764300-204764393,chr1,204764300,204764393,IMR90|chr1:173445770-173445790,chr1,173445770,173445790,0,31318530
IMR90|chr1:205001826-205001936,chr1,205001826,205001936,IMR90|chr1:148556063-148556173,chr1,148556063,148556173,0,56445763
IMR90|chr1:205024461-205024603,chr1,205024461,205024603,IMR90|chr1:25561485-25561513,chr1,25561485,25561513,0,179462976
IMR90|chr1:205298556-205298621,chr1,205298556,205298621,IMR90|chr1:156086701-156086805,chr1,156086701,156086805,0,49211855
IMR90|chr1:205415567-205415585,chr1,205415567,205415585,IMR90|chr1:27323908-27324058,chr1,27323908,27324058,0,178091659
IMR90|chr1:205603857-205603937,chr1,205603857,205603937,IMR90|chr1:154196609-154196695,chr1,154196609,154196695,0,51407248
IMR90|chr1:205651203-205651235,chr1,205651203,205651235,IMR90|chr1:112939426-112939561,chr1,112939426,112939561,0,92711777
IMR90|chr1:205719945-205720021,chr1,205719945,205720021,IMR90|chr1:110159274-110159315,chr1,110159274,110159315,0,95560671
IMR90|chr1:205755861-205755937,chr1,205755861,205755937,IMR90|chr1:110282718-110282753,chr1,110282718,110282753,0,95473143
IMR90|chr1:205782789-205782833,chr1,205782789,205782833,IMR90|chr1:153964673-153964721,chr1,153964673,153964721,0,51818116
IMR90|chr1:205920208-205920257,chr1,205920208,205920257,IMR90|chr1:7834703-7834748,chr1,7834703,7834748,0,198085505
IMR90|chr1:205941234-205941348,chr1,205941234,205941348,IMR90|chr1:27323233-27323269,chr1,27323233,27323269,0,178618001
IMR90|chr1:205944938-205945010,chr1,205944938,205945010,IMR90|chr1:21115769-21115891,chr1,21115769,21115891,0,184829169
IMR90|chr1:206060534-206060595,chr1,206060534,206060595,IMR90|chr1:40941437-40941526,chr1,40941437,40941526,0,165119097
IMR90|chr1:206199606-206199635,chr1,206199606,206199635,IMR90|chr1:27155691-27155814,chr1,27155691,27155814,0,179043915
IMR90|chr1:206505236-206505279,chr1,206505236,206505279,IMR90|chr1:78150360-78150391,chr1,78150360,78150391,0,128354876
IMR90|chr1:206700133-206700191,chr1,206700133,206700191,IMR90|chr1:33814917-33815067,chr1,33814917,33815067,0,172885216
IMR90|chr1:206941398-206941440,chr1,206941398,206941440,IMR90|chr1:205288085-205288193,chr1,205288085,205288193,0,1653313
IMR90|chr1:207156354-207156416,chr1,207156354,207156416,IMR90|chr1:154958258-154958346,chr1,154958258,154958346,0,52198096
IMR90|chr1:207210075-207210164,chr1,207210075,207210164,IMR90|chr1:10005637-10005739,chr1,10005637,10005739,0,197204438
IMR90|chr1:207369322-207369349,chr1,207369322,207369349,IMR90|chr1:27322472-27322540,chr1,27322472,27322540,0,180046850
IMR90|chr1:207570680-207570705,chr1,207570680,207570705,IMR90|chr1:27322150-27322242,chr1,27322150,27322242,0,180248530
IMR90|chr1:208052559-208052643,chr1,208052559,208052643,IMR90|chr1:67215310-67215341,chr1,67215310,67215341,0,140837249
IMR90|chr1:208280284-208280389,chr1,208280284,208280389,IMR90|chr1:148557625-148557655,chr1,148557625,148557655,0,59722659
IMR90|chr1:208589270-208589295,chr1,208589270,208589295,IMR90|chr1:148556191-148556341,chr1,148556191,148556341,0,60033079
IMR90|chr1:208897442-208897540,chr1,208897442,208897540,IMR90|chr1:247499893-247499945,chr1,247499893,247499945,0,38602451
IMR90|chr1:208910709-208910802,chr1,208910709,208910802,IMR90|chr1:148556320-148556399,chr1,148556320,148556399,0,60354389
IMR90|chr1:209033803-209033945,chr1,209033803,209033945,IMR90|chr1:148556130-148556180,chr1,148556130,148556180,0,60477673
IMR90|chr1:209118195-209118263,chr1,209118195,209118263,IMR90|chr1:27322348-27322427,chr1,27322348,27322427,0,181795847
IMR90|chr1:209281883-209281916,chr1,209281883,209281916,IMR90|chr1:33812801-33812902,chr1,33812801,33812902,0,175469082
IMR90|chr1:209669189-209669257,chr1,209669189,209669257,IMR90|chr1:148556135-148556180,chr1,148556135,148556180,0,61113054
IMR90|chr1:209785886-209785973,chr1,209785886,209785973,IMR90|chr1:200381738-200381781,chr1,200381738,200381781,0,9404148
IMR90|chr1:209820459-209820486,chr1,209820459,209820486,IMR90|chr1:27322159-27322279,chr1,27322159,27322279,0,182498300
IMR90|chr1:210120802-210120878,chr1,210120802,210120878,IMR90|chr1:247498108-247498130,chr1,247498108,247498130,0,37377306
IMR90|chr1:210195969-210196056,chr1,210195969,210196056,IMR90|chr1:19813989-19814048,chr1,19813989,19814048,0,190381980
IMR90|chr1:210260398-210260537,chr1,210260398,210260537,IMR90|chr1:43422850-43422882,chr1,43422850,43422882,0,166837548
IMR90|chr1:210288614-210288756,chr1,210288614,210288756,IMR90|chr1:173445770-173445834,chr1,173445770,173445834,0,36842844
IMR90|chr1:210372732-210372784,chr1,210372732,210372784,IMR90|chr1:200639527-200639605,chr1,200639527,200639605,0,9733205
IMR90|chr1:210388199-210388252,chr1,210388199,210388252,IMR90|chr1:27323706-27323778,chr1,27323706,27323778,0,183064493
IMR90|chr1:210634780-210634827,chr1,210634780,210634827,IMR90|chr1:16570495-16570573,chr1,16570495,16570573,0,194064285
IMR90|chr1:210646427-210646517,chr1,210646427,210646517,IMR90|chr1:214725857-214725909,chr1,214725857,214725909,0,4079430
IMR90|chr1:210721022-210721149,chr1,210721022,210721149,IMR90|chr1:148556283-148556398,chr1,148556283,148556398,0,62164739
IMR90|chr1:210923494-210923516,chr1,210923494,210923516,IMR90|chr1:148557615-148557676,chr1,148557615,148557676,0,62365879
IMR90|chr1:211074475-211074613,chr1,211074475,211074613,IMR90|chr1:173445770-173445797,chr1,173445770,173445797,0,37628705
IMR90|chr1:211097165-211097245,chr1,211097165,211097245,IMR90|chr1:173445770-173445819,chr1,173445770,173445819,0,37651395
IMR90|chr1:211190739-211190800,chr1,211190739,211190800,IMR90|chr1:221914345-221914398,chr1,221914345,221914398,0,10723606
IMR90|chr1:211219491-211219592,chr1,211219491,211219592,IMR90|chr1:244618197-244618244,chr1,244618197,244618244,0,33398706
IMR90|chr1:211283095-211283161,chr1,211283095,211283161,IMR90|chr1:173445770-173445819,chr1,173445770,173445819,0,37837325
IMR90|chr1:211494777-211494818,chr1,211494777,211494818,IMR90|chr1:156865818-156865863,chr1,156865818,156865863,0,54628959
IMR90|chr1:211527949-211528049,chr1,211527949,211528049,IMR90|chr1:155881927-155881974,chr1,155881927,155881974,0,55646022
IMR90|chr1:211575519-211575573,chr1,211575519,211575573,IMR90|chr1:173445770-173445865,chr1,173445770,173445865,0,38129749
IMR90|chr1:211704747-211704803,chr1,211704747,211704803,IMR90|chr1:173445770-173445849,chr1,173445770,173445849,0,38258977
IMR90|chr1:211937638-211937788,chr1,211937638,211937788,IMR90|chr1:24970815-24970843,chr1,24970815,24970843,0,186966823
IMR90|chr1:212195183-212195268,chr1,212195183,212195268,IMR90|chr1:25074383-25074420,chr1,25074383,25074420,0,187120800
IMR90|chr1:212278540-212278656,chr1,212278540,212278656,IMR90|chr1:173445770-173445801,chr1,173445770,173445801,0,38832770
IMR90|chr1:212385784-212385815,chr1,212385784,212385815,IMR90|chr1:95003647-95003694,chr1,95003647,95003694,0,117382137
IMR90|chr1:212411156-212411230,chr1,212411156,212411230,IMR90|chr1:222881930-222881985,chr1,222881930,222881985,0,10470774
IMR90|chr1:212537916-212538015,chr1,212537916,212538015,IMR90|chr1:15481761-15481812,chr1,15481761,15481812,0,197056155
IMR90|chr1:212579067-212579165,chr1,212579067,212579165,IMR90|chr1:40045466-40045524,chr1,40045466,40045524,0,172533601
IMR90|chr1:212675354-212675427,chr1,212675354,212675427,IMR90|chr1:150126479-150126523,chr1,150126479,150126523,0,62548875
IMR90|chr1:212771793-212771894,chr1,212771793,212771894,IMR90|chr1:165600519-165600565,chr1,165600519,165600565,0,47171274
IMR90|chr1:212869802-212869853,chr1,212869802,212869853,IMR90|chr1:78245486-78245585,chr1,78245486,78245585,0,134624316
IMR90|chr1:212909009-212909097,chr1,212909009,212909097,IMR90|chr1:1311281-1311334,chr1,1311281,1311334,0,211597728
IMR90|chr1:212991895-212992019,chr1,212991895,212992019,IMR90|chr1:27323900-27323926,chr1,27323900,27323926,0,185667995
IMR90|chr1:213149150-213149253,chr1,213149150,213149253,IMR90|chr1:173445770-173445817,chr1,173445770,173445817,0,39703380
IMR90|chr1:213177691-213177724,chr1,213177691,213177724,IMR90|chr1:27321788-27321862,chr1,27321788,27321862,0,185855903
IMR90|chr1:213261206-213261274,chr1,213261206,213261274,IMR90|chr1:2325080-2325149,chr1,2325080,2325149,0,210936126
IMR90|chr1:213646505-213646583,chr1,213646505,213646583,IMR90|chr1:95390033-95390105,chr1,95390033,95390105,0,118256472
IMR90|chr1:213800180-213800231,chr1,213800180,213800231,IMR90|chr1:33814917-33815067,chr1,33814917,33815067,0,179985263
IMR90|chr1:213818348-213818464,chr1,213818348,213818464,IMR90|chr1:40508198-40508263,chr1,40508198,40508263,0,173310150
IMR90|chr1:213840006-213840076,chr1,213840006,213840076,IMR90|chr1:45312634-45312678,chr1,45312634,45312678,0,168527372
IMR90|chr1:213852845-213852892,chr1,213852845,213852892,IMR90|chr1:148556366-148556416,chr1,148556366,148556416,0,65296479
IMR90|chr1:213877905-213877939,chr1,213877905,213877939,IMR90|chr1:27323713-27323806,chr1,27323713,27323806,0,186554192
IMR90|chr1:213945376-213945470,chr1,213945376,213945470,IMR90|chr1:26147788-26147809,chr1,26147788,26147809,0,187797588
IMR90|chr1:214159246-214159320,chr1,214159246,214159320,IMR90|chr1:173445770-173445811,chr1,173445770,173445811,0,40713476
IMR90|chr1:214159977-214160049,chr1,214159977,214160049,IMR90|chr1:22382044-22382121,chr1,22382044,22382121,0,191777933
IMR90|chr1:214224926-214225071,chr1,214224926,214225071,IMR90|chr1:44396896-44396919,chr1,44396896,44396919,0,169828030
IMR90|chr1:214306013-214306152,chr1,214306013,214306152,IMR90|chr1:148558251-148558286,chr1,148558251,148558286,0,65747762
IMR90|chr1:214825460-214825543,chr1,214825460,214825543,IMR90|chr1:23038661-23038694,chr1,23038661,23038694,0,191786799
IMR90|chr1:215146161-215146261,chr1,215146161,215146261,IMR90|chr1:33813206-33813246,chr1,33813206,33813246,0,181332955
IMR90|chr1:215175398-215175548,chr1,215175398,215175548,IMR90|chr1:148556466-148556616,chr1,148556466,148556616,0,66618932
IMR90|chr1:215270372-215270457,chr1,215270372,215270457,IMR90|chr1:27321289-27321398,chr1,27321289,27321398,0,187949083
IMR90|chr1:215368993-215369057,chr1,215368993,215369057,IMR90|chr1:205718968-205719017,chr1,205718968,205719017,0,9650025
IMR90|chr1:215452988-215453007,chr1,215452988,215453007,IMR90|chr1:33281457-33281552,chr1,33281457,33281552,0,182171531
IMR90|chr1:215510890-215510919,chr1,215510890,215510919,IMR90|chr1:1205326-1205380,chr1,1205326,1205380,0,214305564
IMR90|chr1:215587233-215587250,chr1,215587233,215587250,IMR90|chr1:148556202-148556349,chr1,148556202,148556349,0,67031031
IMR90|chr1:216102964-216103029,chr1,216102964,216103029,IMR90|chr1:26852979-26853022,chr1,26852979,26853022,0,189249985
IMR90|chr1:216658942-216658979,chr1,216658942,216658979,IMR90|chr1:8084836-8084896,chr1,8084836,8084896,0,208574106
IMR90|chr1:216720777-216720832,chr1,216720777,216720832,IMR90|chr1:114302851-114302946,chr1,114302851,114302946,0,102417926
IMR90|chr1:216847606-216847690,chr1,216847606,216847690,IMR90|chr1:32480002-32480064,chr1,32480002,32480064,0,184367604
IMR90|chr1:216913670-216913738,chr1,216913670,216913738,IMR90|chr1:173445770-173445849,chr1,173445770,173445849,0,43467900
IMR90|chr1:217551204-217551280,chr1,217551204,217551280,IMR90|chr1:247497847-247497917,chr1,247497847,247497917,0,29946643
IMR90|chr1:217563232-217563287,chr1,217563232,217563287,IMR90|chr1:145571705-145571750,chr1,145571705,145571750,0,71991527
IMR90|chr1:217736053-217736200,chr1,217736053,217736200,IMR90|chr1:223901424-223901450,chr1,223901424,223901450,0,6165371
IMR90|chr1:217876275-217876347,chr1,217876275,217876347,IMR90|chr1:173445770-173445845,chr1,173445770,173445845,0,44430505
IMR90|chr1:217966704-217966783,chr1,217966704,217966783,IMR90|chr1:24968881-24968952,chr1,24968881,24968952,0,192997823
IMR90|chr1:218005278-218005330,chr1,218005278,218005330,IMR90|chr1:200639527-200639605,chr1,200639527,200639605,0,17365751
IMR90|chr1:218115618-218115650,chr1,218115618,218115650,IMR90|chr1:112939426-112939561,chr1,112939426,112939561,0,105176192
IMR90|chr1:218193314-218193360,chr1,218193314,218193360,IMR90|chr1:150546164-150546266,chr1,150546164,150546266,0,67647150
IMR90|chr1:218239185-218239234,chr1,218239185,218239234,IMR90|chr1:182810054-182810095,chr1,182810054,182810095,0,35429131
IMR90|chr1:218271808-218271892,chr1,218271808,218271892,IMR90|chr1:27930330-27930392,chr1,27930330,27930392,0,190341478
IMR90|chr1:218549434-218549507,chr1,218549434,218549507,IMR90|chr1:151963735-151963765,chr1,151963735,151963765,0,66585699
IMR90|chr1:218566139-218566174,chr1,218566139,218566174,IMR90|chr1:27321217-27321243,chr1,27321217,27321243,0,191244922
IMR90|chr1:218604106-218604228,chr1,218604106,218604228,IMR90|chr1:156089263-156089359,chr1,156089263,156089359,0,62514843
IMR90|chr1:218713313-218713386,chr1,218713313,218713386,IMR90|chr1:173175348-173175434,chr1,173175348,173175434,0,45537965
IMR90|chr1:219011988-219012063,chr1,219011988,219012063,IMR90|chr1:54406894-54406969,chr1,54406894,54406969,0,164605094
IMR90|chr1:219089823-219089927,chr1,219089823,219089927,IMR90|chr1:173829382-173829432,chr1,173829382,173829432,0,45260441
IMR90|chr1:219134346-219134433,chr1,219134346,219134433,IMR90|chr1:148556133-148556180,chr1,148556133,148556180,0,70578213
IMR90|chr1:219335466-219335558,chr1,219335466,219335558,IMR90|chr1:173445770-173445808,chr1,173445770,173445808,0,45889696
IMR90|chr1:219523097-219523164,chr1,219523097,219523164,IMR90|chr1:45312634-45312678,chr1,45312634,45312678,0,174210463
IMR90|chr1:219695603-219695699,chr1,219695603,219695699,IMR90|chr1:173445770-173445839,chr1,173445770,173445839,0,46249833
IMR90|chr1:219776006-219776130,chr1,219776006,219776130,IMR90|chr1:153896379-153896438,chr1,153896379,153896438,0,65879627
IMR90|chr1:219901821-219901865,chr1,219901821,219901865,IMR90|chr1:223901169-223901276,chr1,223901169,223901276,0,3999348
IMR90|chr1:220896619-220896720,chr1,220896619,220896720,IMR90|chr1:247499893-247499945,chr1,247499893,247499945,0,26603274
IMR90|chr1:221589014-221589105,chr1,221589014,221589105,IMR90|chr1:173445770-173445829,chr1,173445770,173445829,0,48143244
IMR90|chr1:221628153-221628231,chr1,221628153,221628231,IMR90|chr1:27324285-27324337,chr1,27324285,27324337,0,194303868
IMR90|chr1:221764564-221764714,chr1,221764564,221764714,IMR90|chr1:148556238-148556385,chr1,148556238,148556385,0,73208326
IMR90|chr1:221793194-221793250,chr1,221793194,221793250,IMR90|chr1:24974523-24974583,chr1,24974523,24974583,0,196818671
IMR90|chr1:222263728-222263750,chr1,222263728,222263750,IMR90|chr1:29506313-29506406,chr1,29506313,29506406,0,192757415
IMR90|chr1:222354368-222354411,chr1,222354368,222354411,IMR90|chr1:33813881-33813977,chr1,33813881,33813977,0,188540487
IMR90|chr1:222816501-222816648,chr1,222816501,222816648,IMR90|chr1:173445770-173445797,chr1,173445770,173445797,0,49370731
IMR90|chr1:223183279-223183378,chr1,223183279,223183378,IMR90|chr1:243416615-243416651,chr1,243416615,243416651,0,20233336
IMR90|chr1:223368430-223368451,chr1,223368430,223368451,IMR90|chr1:24071154-24071201,chr1,24071154,24071201,0,199297276
IMR90|chr1:223554804-223554909,chr1,223554804,223554909,IMR90|chr1:24067913-24068063,chr1,24067913,24068063,0,199486891
IMR90|chr1:223751112-223751185,chr1,223751112,223751185,IMR90|chr1:173445770-173445817,chr1,173445770,173445817,0,50305342
IMR90|chr1:223843002-223843039,chr1,223843002,223843039,IMR90|chr1:112302465-112302595,chr1,112302465,112302595,0,111540537
IMR90|chr1:223936137-223936162,chr1,223936137,223936162,IMR90|chr1:150124614-150124702,chr1,150124614,150124702,0,73811523
IMR90|chr1:224030609-224030686,chr1,224030609,224030686,IMR90|chr1:27324285-27324337,chr1,27324285,27324337,0,196706324
IMR90|chr1:224186938-224186970,chr1,224186938,224186970,IMR90|chr1:54203718-54203779,chr1,54203718,54203779,0,169983220
IMR90|chr1:224375636-224375733,chr1,224375636,224375733,IMR90|chr1:27323757-27323789,chr1,27323757,27323789,0,197051879
IMR90|chr1:224393273-224393313,chr1,224393273,224393313,IMR90|chr1:113247345-113247397,chr1,113247345,113247397,0,111145928
IMR90|chr1:224607740-224607791,chr1,224607740,224607791,IMR90|chr1:27322912-27322976,chr1,27322912,27322976,0,197284828
IMR90|chr1:224607881-224608030,chr1,224607881,224608030,IMR90|chr1:148558223-148558286,chr1,148558223,148558286,0,76049658
IMR90|chr1:224635097-224635128,chr1,224635097,224635128,IMR90|chr1:112302470-112302618,chr1,112302470,112302618,0,112332627
IMR90|chr1:224710392-224710438,chr1,224710392,224710438,IMR90|chr1:148556366-148556417,chr1,148556366,148556417,0,76154026
IMR90|chr1:224950581-224950713,chr1,224950581,224950713,IMR90|chr1:27322363-27322422,chr1,27322363,27322422,0,197628218
IMR90|chr1:225258486-225258537,chr1,225258486,225258537,IMR90|chr1:220442805-220442941,chr1,220442805,220442941,0,4815681
IMR90|chr1:225262132-225262168,chr1,225262132,225262168,IMR90|chr1:201619888-201619941,chr1,201619888,201619941,0,23642244
IMR90|chr1:225294742-225294886,chr1,225294742,225294886,IMR90|chr1:52826922-52827001,chr1,52826922,52827001,0,172467820
IMR90|chr1:225466266-225466384,chr1,225466266,225466384,IMR90|chr1:1711936-1711957,chr1,1711936,1711957,0,223754330
IMR90|chr1:226184303-226184414,chr1,226184303,226184414,IMR90|chr1:173445770-173445837,chr1,173445770,173445837,0,52738533
IMR90|chr1:226314972-226315016,chr1,226314972,226315016,IMR90|chr1:27321407-27321473,chr1,27321407,27321473,0,198993565
IMR90|chr1:226570221-226570323,chr1,226570221,226570323,IMR90|chr1:205090786-205090834,chr1,205090786,205090834,0,21479435
IMR90|chr1:226610435-226610534,chr1,226610435,226610534,IMR90|chr1:33938332-33938394,chr1,33938332,33938394,0,192672103
IMR90|chr1:226638402-226638475,chr1,226638402,226638475,IMR90|chr1:27322888-27322995,chr1,27322888,27322995,0,199315514
IMR90|chr1:226664273-226664303,chr1,226664273,226664303,IMR90|chr1:148557541-148557625,chr1,148557541,148557625,0,78106732
IMR90|chr1:226701997-226702147,chr1,226701997,226702147,IMR90|chr1:28971639-28971740,chr1,28971639,28971740,0,197730358
IMR90|chr1:226786614-226786763,chr1,226786614,226786763,IMR90|chr1:148558220-148558286,chr1,148558220,148558286,0,78228394
IMR90|chr1:226916625-226916661,chr1,226916625,226916661,IMR90|chr1:54406855-54406969,chr1,54406855,54406969,0,172509770
IMR90|chr1:227212087-227212142,chr1,227212087,227212142,IMR90|chr1:212964775-212964840,chr1,212964775,212964840,0,14247312
IMR90|chr1:227604093-227604183,chr1,227604093,227604183,IMR90|chr1:148556223-148556368,chr1,148556223,148556368,0,79047870
IMR90|chr1:227873499-227873644,chr1,227873499,227873644,IMR90|chr1:173445770-173445865,chr1,173445770,173445865,0,54427729
IMR90|chr1:227927098-227927171,chr1,227927098,227927171,IMR90|chr1:22382044-22382121,chr1,22382044,22382121,0,205545054
IMR90|chr1:227937379-227937446,chr1,227937379,227937446,IMR90|chr1:27323236-27323307,chr1,27323236,27323307,0,200614143
IMR90|chr1:228018940-228019044,chr1,228018940,228019044,IMR90|chr1:173834904-173834943,chr1,173834904,173834943,0,54184036
IMR90|chr1:228077459-228077498,chr1,228077459,228077498,IMR90|chr1:173827756-173827844,chr1,173827756,173827844,0,54249703
IMR90|chr1:228127373-228127479,chr1,228127373,228127479,IMR90|chr1:54200818-54200846,chr1,54200818,54200846,0,173926555
IMR90|chr1:228602074-228602140,chr1,228602074,228602140,IMR90|chr1:173445770-173445819,chr1,173445770,173445819,0,55156304
IMR90|chr1:228602145-228602286,chr1,228602145,228602286,IMR90|chr1:148556306-148556397,chr1,148556306,148556397,0,80045839
IMR90|chr1:228661515-228661568,chr1,228661515,228661568,IMR90|chr1:9191845-9191901,chr1,9191845,9191901,0,219469670
IMR90|chr1:228728555-228728599,chr1,228728555,228728599,IMR90|chr1:173831389-173831460,chr1,173831389,173831460,0,54897166
IMR90|chr1:229105662-229105780,chr1,229105662,229105780,IMR90|chr1:1711936-1711957,chr1,1711936,1711957,0,227393726
IMR90|chr1:229446780-229446930,chr1,229446780,229446930,IMR90|chr1:178064523-178064589,chr1,178064523,178064589,0,51382257
IMR90|chr1:229862103-229862194,chr1,229862103,229862194,IMR90|chr1:151139498-151139526,chr1,151139498,151139526,0,78722605
IMR90|chr1:229885663-229885717,chr1,229885663,229885717,IMR90|chr1:94702468-94702554,chr1,94702468,94702554,0,135183195
IMR90|chr1:229917539-229917669,chr1,229917539,229917669,IMR90|chr1:148556132-148556180,chr1,148556132,148556180,0,81361407
IMR90|chr1:230216109-230216205,chr1,230216109,230216205,IMR90|chr1:15481761-15481812,chr1,15481761,15481812,0,214734348
IMR90|chr1:230280549-230280613,chr1,230280549,230280613,IMR90|chr1:173828336-173828425,chr1,173828336,173828425,0,56452213
IMR90|chr1:230407042-230407133,chr1,230407042,230407133,IMR90|chr1:19811544-19811577,chr1,19811544,19811577,0,210595498
IMR90|chr1:230449076-230449117,chr1,230449076,230449117,IMR90|chr1:173830996-173831105,chr1,173830996,173831105,0,56618080
IMR90|chr1:230584326-230584372,chr1,230584326,230584372,IMR90|chr1:183442360-183442416,chr1,183442360,183442416,0,47141966
IMR90|chr1:230837498-230837530,chr1,230837498,230837530,IMR90|chr1:93300048-93300114,chr1,93300048,93300114,0,137537450
IMR90|chr1:230858585-230858655,chr1,230858585,230858655,IMR90|chr1:8083645-8083725,chr1,8083645,8083725,0,222774940
IMR90|chr1:231135798-231135948,chr1,231135798,231135948,IMR90|chr1:148558170-148558320,chr1,148558170,148558320,0,82577628
IMR90|chr1:231169622-231169687,chr1,231169622,231169687,IMR90|chr1:46770222-46770302,chr1,46770222,46770302,0,184399400
IMR90|chr1:231288509-231288527,chr1,231288509,231288527,IMR90|chr1:33281457-33281552,chr1,33281457,33281552,0,198007052
IMR90|chr1:231456105-231456140,chr1,231456105,231456140,IMR90|chr1:148558176-148558291,chr1,148558176,148558291,0,82897929
IMR90|chr1:231627269-231627350,chr1,231627269,231627350,IMR90|chr1:22380841-22380873,chr1,22380841,22380873,0,209246428
IMR90|chr1:231629434-231629484,chr1,231629434,231629484,IMR90|chr1:201620360-201620460,chr1,201620360,201620460,0,30009074
IMR90|chr1:231830855-231830936,chr1,231830855,231830936,IMR90|chr1:224620980-224621012,chr1,224620980,224621012,0,7209875
IMR90|chr1:231843707-231843857,chr1,231843707,231843857,IMR90|chr1:148558224-148558286,chr1,148558224,148558286,0,83285483
IMR90|chr1:232018770-232018880,chr1,232018770,232018880,IMR90|chr1:54201565-54201613,chr1,54201565,54201613,0,177817205
IMR90|chr1:232226214-232226302,chr1,232226214,232226302,IMR90|chr1:27323936-27323975,chr1,27323936,27323975,0,204902278
IMR90|chr1:232420560-232420583,chr1,232420560,232420583,IMR90|chr1:44441395-44441481,chr1,44441395,44441481,0,187979165
IMR90|chr1:232450357-232450378,chr1,232450357,232450378,IMR90|chr1:94702692-94702800,chr1,94702692,94702800,0,137747665
IMR90|chr1:232711905-232711997,chr1,232711905,232711997,IMR90|chr1:1820362-1820411,chr1,1820362,1820411,0,230891543
IMR90|chr1:232717910-232718056,chr1,232717910,232718056,IMR90|chr1:148558223-148558286,chr1,148558223,148558286,0,84159687
IMR90|chr1:232841190-232841296,chr1,232841190,232841296,IMR90|chr1:33167689-33167732,chr1,33167689,33167732,0,199673501
IMR90|chr1:233295294-233295358,chr1,233295294,233295358,IMR90|chr1:173445770-173445856,chr1,173445770,173445856,0,59849524
IMR90|chr1:233418853-233418990,chr1,233418853,233418990,IMR90|chr1:9192620-9192731,chr1,9192620,9192731,0,224226233
IMR90|chr1:233481256-233481292,chr1,233481256,233481292,IMR90|chr1:9296989-9297086,chr1,9296989,9297086,0,224184267
IMR90|chr1:233486527-233486560,chr1,233486527,233486560,IMR90|chr1:93299601-93299678,chr1,93299601,93299678,0,140186926
IMR90|chr1:233528108-233528184,chr1,233528108,233528184,IMR90|chr1:247497847-247497917,chr1,247497847,247497917,0,13969739
IMR90|chr1:234258166-234258230,chr1,234258166,234258230,IMR90|chr1:173828336-173828425,chr1,173828336,173828425,0,60429830
IMR90|chr1:234365845-234365915,chr1,234365845,234365915,IMR90|chr1:32806166-32806210,chr1,32806166,32806210,0,201559679
IMR90|chr1:234420978-234421082,chr1,234420978,234421082,IMR90|chr1:173445770-173445856,chr1,173445770,173445856,0,60975208
IMR90|chr1:234432590-234432663,chr1,234432590,234432663,IMR90|chr1:173175348-173175434,chr1,173175348,173175434,0,61257242
IMR90|chr1:234433577-234433653,chr1,234433577,234433653,IMR90|chr1:85724919-85724954,chr1,85724919,85724954,0,148708658
IMR90|chr1:234521069-234521147,chr1,234521069,234521147,IMR90|chr1:95390033-95390105,chr1,95390033,95390105,0,139131036
IMR90|chr1:234742359-234742448,chr1,234742359,234742448,IMR90|chr1:203597399-203597440,chr1,203597399,203597440,0,31144960
IMR90|chr1:234861799-234861894,chr1,234861799,234861894,IMR90|chr1:173828380-173828444,chr1,173828380,173828444,0,61033419
IMR90|chr1:234903697-234903748,chr1,234903697,234903748,IMR90|chr1:32568964-32569063,chr1,32568964,32569063,0,202334733
IMR90|chr1:234909701-234909848,chr1,234909701,234909848,IMR90|chr1:63155856-63155895,chr1,63155856,63155895,0,171753845
IMR90|chr1:234967807-234967878,chr1,234967807,234967878,IMR90|chr1:109633581-109633636,chr1,109633581,109633636,0,125334226
IMR90|chr1:235110716-235110844,chr1,235110716,235110844,IMR90|chr1:151963626-151963648,chr1,151963626,151963648,0,83147090
IMR90|chr1:235119949-235120041,chr1,235119949,235120041,IMR90|chr1:40041095-40041153,chr1,40041095,40041153,0,195078854
IMR90|chr1:235240949-235241086,chr1,235240949,235241086,IMR90|chr1:1202058-1202123,chr1,1202058,1202123,0,234038891
IMR90|chr1:235446566-235446607,chr1,235446566,235446607,IMR90|chr1:156865818-156865863,chr1,156865818,156865863,0,78580748
IMR90|chr1:235627983-235628127,chr1,235627983,235628127,IMR90|chr1:148556739-148556810,chr1,148556739,148556810,0,87071244
IMR90|chr1:235632771-235632833,chr1,235632771,235632833,IMR90|chr1:1820996-1821054,chr1,1820996,1821054,0,233811775
IMR90|chr1:235871131-235871275,chr1,235871131,235871275,IMR90|chr1:148557990-148558127,chr1,148557990,148558127,0,87313141
IMR90|chr1:235969476-235969626,chr1,235969476,235969626,IMR90|chr1:148558699-148558849,chr1,148558699,148558849,0,87410777
IMR90|chr1:236036207-236036330,chr1,236036207,236036330,IMR90|chr1:148556703-148556810,chr1,148556703,148556810,0,87479504
IMR90|chr1:236330093-236330161,chr1,236330093,236330161,IMR90|chr1:38461304-38461342,chr1,38461304,38461342,0,197868789
IMR90|chr1:236390019-236390079,chr1,236390019,236390079,IMR90|chr1:154196609-154196695,chr1,154196609,154196695,0,82193410
IMR90|chr1:236682719-236682770,chr1,236682719,236682770,IMR90|chr1:148557503-148557620,chr1,148557503,148557620,0,88125216
IMR90|chr1:236782604-236782746,chr1,236782604,236782746,IMR90|chr1:173445770-173445834,chr1,173445770,173445834,0,63336834
IMR90|chr1:237382473-237382575,chr1,237382473,237382575,IMR90|chr1:205090786-205090834,chr1,205090786,205090834,0,32291687
IMR90|chr1:237434320-237434355,chr1,237434320,237434355,IMR90|chr1:52832302-52832380,chr1,52832302,52832380,0,184602018
IMR90|chr1:237584252-237584311,chr1,237584252,237584311,IMR90|chr1:154958393-154958471,chr1,154958393,154958471,0,82625859
IMR90|chr1:237854590-237854720,chr1,237854590,237854720,IMR90|chr1:104068950-104068979,chr1,104068950,104068979,0,133785640
IMR90|chr1:237894313-237894369,chr1,237894313,237894369,IMR90|chr1:12037560-12037643,chr1,12037560,12037643,0,225856753
IMR90|chr1:238016125-238016179,chr1,238016125,238016179,IMR90|chr1:27323394-27323490,chr1,27323394,27323490,0,210692731
IMR90|chr1:238041857-238041913,chr1,238041857,238041913,IMR90|chr1:95005545-95005610,chr1,95005545,95005610,0,143036312
IMR90|chr1:238113892-238113928,chr1,238113892,238113928,IMR90|chr1:54406855-54406969,chr1,54406855,54406969,0,183707037
IMR90|chr1:238200030-238200180,chr1,238200030,238200180,IMR90|chr1:148558551-148558601,chr1,148558551,148558601,0,89641479
IMR90|chr1:238298124-238298139,chr1,238298124,238298139,IMR90|chr1:148558163-148558274,chr1,148558163,148558274,0,89739961
IMR90|chr1:238440915-238440963,chr1,238440915,238440963,IMR90|chr1:33167634-33167732,chr1,33167634,33167732,0,205273281
IMR90|chr1:238615217-238615295,chr1,238615217,238615295,IMR90|chr1:94703687-94703756,chr1,94703687,94703756,0,143911530
IMR90|chr1:238616818-238616947,chr1,238616818,238616947,IMR90|chr1:78245486-78245585,chr1,78245486,78245585,0,160371332
IMR90|chr1:239140538-239140582,chr1,239140538,239140582,IMR90|chr1:153964673-153964721,chr1,153964673,153964721,0,85175865
IMR90|chr1:239396850-239396901,chr1,239396850,239396901,IMR90|chr1:27323746-27323807,chr1,27323746,27323807,0,212073104
IMR90|chr1:239399924-239400029,chr1,239399924,239400029,IMR90|chr1:148556150-148556180,chr1,148556150,148556180,0,90843774
IMR90|chr1:239532770-239532892,chr1,239532770,239532892,IMR90|chr1:46597443-46597471,chr1,46597443,46597471,0,192935327
IMR90|chr1:239561445-239561502,chr1,239561445,239561502,IMR90|chr1:203765175-203765226,chr1,203765175,203765226,0,35796270
IMR90|chr1:239593565-239593701,chr1,239593565,239593701,IMR90|chr1:148560505-148560654,chr1,148560505,148560654,0,91033060
IMR90|chr1:239669485-239669576,chr1,239669485,239669576,IMR90|chr1:153896379-153896438,chr1,153896379,153896438,0,85773106
IMR90|chr1:239880627-239880675,chr1,239880627,239880675,IMR90|chr1:1820133-1820213,chr1,1820133,1820213,0,238060494
IMR90|chr1:240056746-240056812,chr1,240056746,240056812,IMR90|chr1:112302480-112302618,chr1,112302480,112302618,0,127754266
IMR90|chr1:240167040-240167093,chr1,240167040,240167093,IMR90|chr1:27323706-27323778,chr1,27323706,27323778,0,212843334
IMR90|chr1:240341278-240341334,chr1,240341278,240341334,IMR90|chr1:38461304-38461342,chr1,38461304,38461342,0,201879974
IMR90|chr1:240886033-240886103,chr1,240886033,240886103,IMR90|chr1:12041831-12041911,chr1,12041831,12041911,0,228844202
IMR90|chr1:241140260-241140319,chr1,241140260,241140319,IMR90|chr1:27323235-27323299,chr1,27323235,27323299,0,213817025
IMR90|chr1:241142627-241142648,chr1,241142627,241142648,IMR90|chr1:148556136-148556180,chr1,148556136,148556180,0,92586491
IMR90|chr1:241358387-241358435,chr1,241358387,241358435,IMR90|chr1:16570495-16570573,chr1,16570495,16570573,0,224787892
IMR90|chr1:241417881-241417918,chr1,241417881,241417918,IMR90|chr1:173986494-173986535,chr1,173986494,173986535,0,67431387
IMR90|chr1:241587672-241587737,chr1,241587672,241587737,IMR90|chr1:26852979-26853022,chr1,26852979,26853022,0,214734693
IMR90|chr1:241883478-241883557,chr1,241883478,241883557,IMR90|chr1:173836013-173836060,chr1,173836013,173836060,0,68047465
IMR90|chr1:241897078-241897123,chr1,241897078,241897123,IMR90|chr1:148558154-148558286,chr1,148558154,148558286,0,93338924
IMR90|chr1:241899067-241899133,chr1,241899067,241899133,IMR90|chr1:27322903-27323053,chr1,27322903,27323053,0,214576164
IMR90|chr1:242078965-242079041,chr1,242078965,242079041,IMR90|chr1:27322077-27322105,chr1,27322077,27322105,0,214756888
IMR90|chr1:242090085-242090136,chr1,242090085,242090136,IMR90|chr1:8085007-8085064,chr1,8085007,8085064,0,234005078
IMR90|chr1:242427075-242427133,chr1,242427075,242427133,IMR90|chr1:221914345-221914379,chr1,221914345,221914379,0,20512730
IMR90|chr1:242758799-242758949,chr1,242758799,242758949,IMR90|chr1:148558783-148558805,chr1,148558783,148558805,0,94200016
IMR90|chr1:242898914-242898985,chr1,242898914,242898985,IMR90|chr1:162532853-162532902,chr1,162532853,162532902,0,80366061
IMR90|chr1:242919936-242919988,chr1,242919936,242919988,IMR90|chr1:32481719-32481792,chr1,32481719,32481792,0,210438217
IMR90|chr1:243177938-243178062,chr1,243177938,243178062,IMR90|chr1:153896379-153896438,chr1,153896379,153896438,0,89281559
IMR90|chr1:243240125-243240180,chr1,243240125,243240180,IMR90|chr1:203832414-203832483,chr1,203832414,203832483,0,39407711
IMR90|chr1:243289965-243290041,chr1,243289965,243290041,IMR90|chr1:27322077-27322105,chr1,27322077,27322105,0,215967888
IMR90|chr1:243696812-243696911,chr1,243696812,243696911,IMR90|chr1:182809335-182809358,chr1,182809335,182809358,0,60887477
IMR90|chr1:244030888-244030942,chr1,244030888,244030942,IMR90|chr1:24065933-24065972,chr1,24065933,24065972,0,219964955
IMR90|chr1:244278840-244278903,chr1,244278840,244278903,IMR90|chr1:78147419-78147499,chr1,78147419,78147499,0,166131421
IMR90|chr1:244381453-244381493,chr1,244381453,244381493,IMR90|chr1:27322888-27322995,chr1,27322888,27322995,0,217058565
IMR90|chr1:244485396-244485499,chr1,244485396,244485499,IMR90|chr1:247498524-247498571,chr1,247498524,247498571,0,3013128
IMR90|chr1:245110379-245110529,chr1,245110379,245110529,IMR90|chr1:148558160-148558297,chr1,148558160,148558297,0,96552219
IMR90|chr1:245270163-245270206,chr1,245270163,245270206,IMR90|chr1:182993725-182993776,chr1,182993725,182993776,0,62276438
IMR90|chr1:245280410-245280447,chr1,245280410,245280447,IMR90|chr1:148556691-148556738,chr1,148556691,148556738,0,96723719
IMR90|chr1:245481380-245481468,chr1,245481380,245481468,IMR90|chr1:1311281-1311334,chr1,1311281,1311334,0,244170099
IMR90|chr1:245499686-245499788,chr1,245499686,245499788,IMR90|chr1:22384154-22384174,chr1,22384154,22384174,0,223115532
IMR90|chr1:245822335-245822442,chr1,245822335,245822442,IMR90|chr1:27322312-27322394,chr1,27322312,27322394,0,218500023
IMR90|chr1:246016567-246016714,chr1,246016567,246016714,IMR90|chr1:63155856-63155895,chr1,63155856,63155895,0,182860711
IMR90|chr1:246328146-246328207,chr1,246328146,246328207,IMR90|chr1:43837267-43837323,chr1,43837267,43837323,0,202490879
IMR90|chr1:246336654-246336724,chr1,246336654,246336724,IMR90|chr1:109633581-109633636,chr1,109633581,109633636,0,136703073
IMR90|chr1:246474165-246474201,chr1,246474165,246474201,IMR90|chr1:24972816-24972942,chr1,24972816,24972942,0,221501349
IMR90|chr1:246564126-246564187,chr1,246564126,246564187,IMR90|chr1:221914345-221914398,chr1,221914345,221914398,0,24649781
IMR90|chr1:246579198-246579263,chr1,246579198,246579263,IMR90|chr1:9296188-9296256,chr1,9296188,9296256,0,237283010
IMR90|chr1:246689014-246689109,chr1,246689014,246689109,IMR90|chr1:182809177-182809215,chr1,182809177,182809215,0,63879837
IMR90|chr1:246696736-246696772,chr1,246696736,246696772,IMR90|chr1:182992242-182992365,chr1,182992242,182992365,0,63704494
IMR90|chr1:246745007-246745112,chr1,246745007,246745112,IMR90|chr1:148556150-148556180,chr1,148556150,148556180,0,98188857
IMR90|chr1:246812395-246812489,chr1,246812395,246812489,IMR90|chr1:33812388-33812496,chr1,33812388,33812496,0,213000007
IMR90|chr1:246871228-246871266,chr1,246871228,246871266,IMR90|chr1:27324345-27324363,chr1,27324345,27324363,0,219546883
IMR90|chr1:246941897-246941938,chr1,246941897,246941938,IMR90|chr1:33814396-33814451,chr1,33814396,33814451,0,213127501
IMR90|chr1:247071759-247071794,chr1,247071759,247071794,IMR90|chr1:148556486-148556616,chr1,148556486,148556616,0,98515273
IMR90|chr1:247125860-247125896,chr1,247125860,247125896,IMR90|chr1:9296989-9297086,chr1,9296989,9297086,0,237828871
IMR90|chr1:247142123-247142172,chr1,247142123,247142172,IMR90|chr1:16570495-16570573,chr1,16570495,16570573,0,230571628
IMR90|chr1:247536604-247536639,chr1,247536604,247536639,IMR90|chr1:148558176-148558291,chr1,148558176,148558291,0,98978428
IMR90|chr1:247563731-247563870,chr1,247563731,247563870,IMR90|chr1:148558251-148558286,chr1,148558251,148558286,0,99005480
IMR90|chr1:247832434-247832517,chr1,247832434,247832517,IMR90|chr1:178064523-178064589,chr1,178064523,178064589,0,69767911
IMR90|chr1:247880901-247881010,chr1,247880901,247881010,IMR90|chr1:24974523-24974583,chr1,24974523,24974583,0,222906378
IMR90|chr1:248005983-248006115,chr1,248005983,248006115,IMR90|chr1:45310665-45310683,chr1,45310665,45310683,0,202695318
IMR90|chr1:248112903-248112968,chr1,248112903,248112968,IMR90|chr1:8936518-8936542,chr1,8936518,8936542,0,239176385
IMR90|chr1:248339040-248339124,chr1,248339040,248339124,IMR90|chr1:173441697-173441747,chr1,173441697,173441747,0,74897343
IMR90|chr1:248411547-248411616,chr1,248411547,248411616,IMR90|chr1:162532404-162532477,chr1,162532404,162532477,0,85879143
IMR90|chr1:248527928-248528002,chr1,248527928,248528002,IMR90|chr1:148556134-148556180,chr1,148556134,148556180,0,99971794
IMR90|chr1:248970537-248970592,chr1,248970537,248970592,IMR90|chr1:212964775-212964840,chr1,212964775,212964840,0,36005762
IMR90|chr2:159502-159614,chr2,159502,159614,IMR90|chr2:218806753-218806788,chr2,218806753,218806788,0,218647251
IMR90|chr2:462284-462400,chr2,462284,462400,IMR90|chr2:15732460-15732494,chr2,15732460,15732494,0,15270176
IMR90|chr2:723300-723355,chr2,723300,723355,IMR90|chr2:33362856-33362945,chr2,33362856,33362945,0,32639556
IMR90|chr2:1000739-1000834,chr2,1000739,1000834,IMR90|chr2:47400765-47400789,chr2,47400765,47400789,0,46400026
IMR90|chr2:1143149-1143201,chr2,1143149,1143201,IMR90|chr2:33823666-33823732,chr2,33823666,33823732,0,32680517
IMR90|chr2:1354084-1354108,chr2,1354084,1354108,IMR90|chr2:55273050-55273192,chr2,55273050,55273192,0,53918966
IMR90|chr2:1617836-1617884,chr2,1617836,1617884,IMR90|chr2:73052647-73052742,chr2,73052647,73052742,0,71434811
IMR90|chr2:1652163-1652183,chr2,1652163,1652183,IMR90|chr2:106011919-106012069,chr2,106011919,106012069,0,104359756
IMR90|chr2:1721478-1721569,chr2,1721478,1721569,IMR90|chr2:227659525-227659584,chr2,227659525,227659584,0,225938047
IMR90|chr2:2040854-2040905,chr2,2040854,2040905,IMR90|chr2:70422531-70422594,chr2,70422531,70422594,0,68381677
IMR90|chr2:2479541-2479654,chr2,2479541,2479654,IMR90|chr2:219193014-219193034,chr2,219193014,219193034,0,216713473
IMR90|chr2:2947101-2947210,chr2,2947101,2947210,IMR90|chr2:55512578-55512608,chr2,55512578,55512608,0,52565477
IMR90|chr2:3483432-3483485,chr2,3483432,3483485,IMR90|chr2:203734353-203734405,chr2,203734353,203734405,0,200250921
IMR90|chr2:3807871-3807936,chr2,3807871,3807936,IMR90|chr2:33360612-33360673,chr2,33360612,33360673,0,29552741
IMR90|chr2:4456936-4457001,chr2,4456936,4457001,IMR90|chr2:33360612-33360673,chr2,33360612,33360673,0,28903676
IMR90|chr2:4592502-4592549,chr2,4592502,4592549,IMR90|chr2:47402043-47402128,chr2,47402043,47402128,0,42809541
IMR90|chr2:5058750-5058852,chr2,5058750,5058852,IMR90|chr2:37894595-37894618,chr2,37894595,37894618,0,32835845
IMR90|chr2:5222661-5222703,chr2,5222661,5222703,IMR90|chr2:265671-265752,chr2,265671,265752,0,4956990
IMR90|chr2:5424938-5425028,chr2,5424938,5425028,IMR90|chr2:67620174-67620224,chr2,67620174,67620224,0,62195236
IMR90|chr2:5495621-5495652,chr2,5495621,5495652,IMR90|chr2:85193944-85193998,chr2,85193944,85193998,0,79698323
IMR90|chr2:5631625-5631684,chr2,5631625,5631684,IMR90|chr2:84687750-84687800,chr2,84687750,84687800,0,79056125
IMR90|chr2:5750679-5750700,chr2,5750679,5750700,IMR90|chr2:27580364-27580482,chr2,27580364,27580482,0,21829685
IMR90|chr2:6196292-6196412,chr2,6196292,6196412,IMR90|chr2:73299750-73299779,chr2,73299750,73299779,0,67103458
IMR90|chr2:6970318-6970402,chr2,6970318,6970402,IMR90|chr2:85194890-85195010,chr2,85194890,85195010,0,78224572
IMR90|chr2:6984558-6984612,chr2,6984558,6984612,IMR90|chr2:85194423-85194504,chr2,85194423,85194504,0,78209865
IMR90|chr2:7018800-7018875,chr2,7018800,7018875,IMR90|chr2:109746699-109746774,chr2,109746699,109746774,0,102727899
IMR90|chr2:7122863-7122890,chr2,7122863,7122890,IMR90|chr2:85193944-85194005,chr2,85193944,85194005,0,78071081
IMR90|chr2:7317696-7317761,chr2,7317696,7317761,IMR90|chr2:242443724-242443804,chr2,242443724,242443804,0,235126028
IMR90|chr2:7404436-7404491,chr2,7404436,7404491,IMR90|chr2:85130191-85130286,chr2,85130191,85130286,0,77725755
IMR90|chr2:7937500-7937569,chr2,7937500,7937569,IMR90|chr2:198315923-198316073,chr2,198315923,198316073,0,190378423
IMR90|chr2:8086935-8086958,chr2,8086935,8086958,IMR90|chr2:201989439-201989521,chr2,201989439,201989521,0,193902504
IMR90|chr2:8421182-8421257,chr2,8421182,8421257,IMR90|chr2:85194921-85195015,chr2,85194921,85195015,0,76773739
IMR90|chr2:8896945-8896968,chr2,8896945,8896968,IMR90|chr2:101868747-101868874,chr2,101868747,101868874,0,92971802
IMR90|chr2:9136516-9136586,chr2,9136516,9136586,IMR90|chr2:19546935-19546974,chr2,19546935,19546974,0,10410419
IMR90|chr2:9253388-9253459,chr2,9253388,9253459,IMR90|chr2:65356082-65356115,chr2,65356082,65356115,0,56102694
IMR90|chr2:9363037-9363108,chr2,9363037,9363108,IMR90|chr2:216174161-216174224,chr2,216174161,216174224,0,206811124
IMR90|chr2:9562394-9562459,chr2,9562394,9562459,IMR90|chr2:67620174-67620224,chr2,67620174,67620224,0,58057780
IMR90|chr2:9568859-9568933,chr2,9568859,9568933,IMR90|chr2:242444044-242444120,chr2,242444044,242444120,0,232875185
IMR90|chr2:9634988-9635089,chr2,9634988,9635089,IMR90|chr2:74777010-74777066,chr2,74777010,74777066,0,65142022
IMR90|chr2:10137255-10137278,chr2,10137255,10137278,IMR90|chr2:27251981-27252089,chr2,27251981,27252089,0,17114726
IMR90|chr2:10349975-10350064,chr2,10349975,10350064,IMR90|chr2:37894806-37894853,chr2,37894806,37894853,0,27544831
IMR90|chr2:10469463-10469585,chr2,10469463,10469585,IMR90|chr2:63820229-63820257,chr2,63820229,63820257,0,53350766
IMR90|chr2:10834544-10834562,chr2,10834544,10834562,IMR90|chr2:216298509-216298625,chr2,216298509,216298625,0,205463965
IMR90|chr2:11032742-11032795,chr2,11032742,11032795,IMR90|chr2:219083852-219083914,chr2,219083852,219083914,0,208051110
IMR90|chr2:11096385-11096441,chr2,11096385,11096441,IMR90|chr2:26466923-26466974,chr2,26466923,26466974,0,15370538
IMR90|chr2:11228394-11228482,chr2,11228394,11228482,IMR90|chr2:178079342-178079452,chr2,178079342,178079452,0,166850948
IMR90|chr2:11411346-11411379,chr2,11411346,11411379,IMR90|chr2:242444561-242444656,chr2,242444561,242444656,0,231033215
IMR90|chr2:11598219-11598268,chr2,11598219,11598268,IMR90|chr2:73052647-73052742,chr2,73052647,73052742,0,61454428
IMR90|chr2:11626860-11626934,chr2,11626860,11626934,IMR90|chr2:55458750-55458778,chr2,55458750,55458778,0,43831890
IMR90|chr2:12021314-12021337,chr2,12021314,12021337,IMR90|chr2:101868747-101868874,chr2,101868747,101868874,0,89847433
IMR90|chr2:12305842-12305873,chr2,12305842,12305873,IMR90|chr2:36586197-36586228,chr2,36586197,36586228,0,24280355
IMR90|chr2:12599486-12599610,chr2,12599486,12599610,IMR90|chr2:238320005-238320028,chr2,238320005,238320028,0,225720519
IMR90|chr2:12603263-12603353,chr2,12603263,12603353,IMR90|chr2:218866150-218866191,chr2,218866150,218866191,0,206262887
IMR90|chr2:12831261-12831319,chr2,12831261,12831319,IMR90|chr2:131095684-131095751,chr2,131095684,131095751,0,118264423
IMR90|chr2:13440808-13440840,chr2,13440808,13440840,IMR90|chr2:208577289-208577407,chr2,208577289,208577407,0,195136481
IMR90|chr2:13505829-13505897,chr2,13505829,13505897,IMR90|chr2:85195915-85195984,chr2,85195915,85195984,0,71690086
IMR90|chr2:13596238-13596342,chr2,13596238,13596342,IMR90|chr2:39662486-39662531,chr2,39662486,39662531,0,26066248
IMR90|chr2:13762921-13762984,chr2,13762921,13762984,IMR90|chr2:218806753-218806788,chr2,218806753,218806788,0,205043832
IMR90|chr2:14531512-14531614,chr2,14531512,14531614,IMR90|chr2:37894595-37894618,chr2,37894595,37894618,0,23363083
IMR90|chr2:14763720-14763742,chr2,14763720,14763742,IMR90|chr2:67620175-67620224,chr2,67620175,67620224,0,52856455
IMR90|chr2:15052654-15052748,chr2,15052654,15052748,IMR90|chr2:242444044-242444120,chr2,242444044,242444120,0,227391390
IMR90|chr2:15119757-15119781,chr2,15119757,15119781,IMR90|chr2:54197349-54197475,chr2,54197349,54197475,0,39077592
IMR90|chr2:15255475-15255549,chr2,15255475,15255549,IMR90|chr2:75786736-75786802,chr2,75786736,75786802,0,60531261
IMR90|chr2:15383598-15383658,chr2,15383598,15383658,IMR90|chr2:134877594-134877626,chr2,134877594,134877626,0,119493996
IMR90|chr2:15405741-15405809,chr2,15405741,15405809,IMR90|chr2:85195915-85195984,chr2,85195915,85195984,0,69790174
IMR90|chr2:15830603-15830670,chr2,15830603,15830670,IMR90|chr2:219266714-219266783,chr2,219266714,219266783,0,203436111
IMR90|chr2:16066396-16066451,chr2,16066396,16066451,IMR90|chr2:85197479-85197563,chr2,85197479,85197563,0,69131083
IMR90|chr2:16151097-16151143,chr2,16151097,16151143,IMR90|chr2:74782165-74782260,chr2,74782165,74782260,0,58631068
IMR90|chr2:16320378-16320451,chr2,16320378,16320451,IMR90|chr2:112813985-112814079,chr2,112813985,112814079,0,96493607
IMR90|chr2:16340822-16340846,chr2,16340822,16340846,IMR90|chr2:218766245-218766337,chr2,218766245,218766337,0,202425423
IMR90|chr2:16444177-16444220,chr2,16444177,16444220,IMR90|chr2:224705721-224705752,chr2,224705721,224705752,0,208261544
IMR90|chr2:16509806-16509864,chr2,16509806,16509864,IMR90|chr2:169309798-169309887,chr2,169309798,169309887,0,152799992
IMR90|chr2:16527049-16527094,chr2,16527049,16527094,IMR90|chr2:162017027-162017132,chr2,162017027,162017132,0,145489978
IMR90|chr2:16594714-16594736,chr2,16594714,16594736,IMR90|chr2:219084303-219084395,chr2,219084303,219084395,0,202489589
IMR90|chr2:16641003-16641153,chr2,16641003,16641153,IMR90|chr2:66674189-66674224,chr2,66674189,66674224,0,50033186
IMR90|chr2:16651818-16651876,chr2,16651818,16651876,IMR90|chr2:131095684-131095751,chr2,131095684,131095751,0,114443866
IMR90|chr2:16870521-16870606,chr2,16870521,16870606,IMR90|chr2:85639845-85639892,chr2,85639845,85639892,0,68769324
IMR90|chr2:17050927-17050985,chr2,17050927,17050985,IMR90|chr2:37894781-37894852,chr2,37894781,37894852,0,20843854
IMR90|chr2:17090100-17090156,chr2,17090100,17090156,IMR90|chr2:63821124-63821167,chr2,63821124,63821167,0,46731024
IMR90|chr2:17113879-17113914,chr2,17113879,17113914,IMR90|chr2:242629763-242629876,chr2,242629763,242629876,0,225515884
IMR90|chr2:17852961-17853020,chr2,17852961,17853020,IMR90|chr2:192546902-192546936,chr2,192546902,192546936,0,174693941
IMR90|chr2:18255824-18255910,chr2,18255824,18255910,IMR90|chr2:85195016-85195054,chr2,85195016,85195054,0,66939192
IMR90|chr2:18430916-18430964,chr2,18430916,18430964,IMR90|chr2:74405670-74405739,chr2,74405670,74405739,0,55974754
IMR90|chr2:18540390-18540413,chr2,18540390,18540413,IMR90|chr2:55274150-55274249,chr2,55274150,55274249,0,36733760
IMR90|chr2:18625998-18626147,chr2,18625998,18626147,IMR90|chr2:85194342-85194403,chr2,85194342,85194403,0,66568344
IMR90|chr2:18738323-18738370,chr2,18738323,18738370,IMR90|chr2:74782165-74782260,chr2,74782165,74782260,0,56043842
IMR90|chr2:18766125-18766213,chr2,18766125,18766213,IMR90|chr2:47139976-47140033,chr2,47139976,47140033,0,28373851
IMR90|chr2:19272065-19272086,chr2,19272065,19272086,IMR90|chr2:85196761-85196843,chr2,85196761,85196843,0,65924696
IMR90|chr2:20070539-20070617,chr2,20070539,20070617,IMR90|chr2:85193933-85194005,chr2,85193933,85194005,0,65123394
IMR90|chr2:20143230-20143291,chr2,20143230,20143291,IMR90|chr2:55273514-55273602,chr2,55273514,55273602,0,35130284
IMR90|chr2:20296678-20296731,chr2,20296678,20296731,IMR90|chr2:85194423-85194504,chr2,85194423,85194504,0,64897745
IMR90|chr2:20337989-20338042,chr2,20337989,20338042,IMR90|chr2:85194423-85194504,chr2,85194423,85194504,0,64856434
IMR90|chr2:20704110-20704142,chr2,20704110,20704142,IMR90|chr2:242453415-242453533,chr2,242453415,242453533,0,221749305
IMR90|chr2:20741318-20741391,chr2,20741318,20741391,IMR90|chr2:238880106-238880138,chr2,238880106,238880138,0,218138788
IMR90|chr2:20875503-20875569,chr2,20875503,20875569,IMR90|chr2:219266714-219266783,chr2,219266714,219266783,0,198391211
IMR90|chr2:21259389-21259412,chr2,21259389,21259412,IMR90|chr2:218769260-218769343,chr2,218769260,218769343,0,197509871
IMR90|chr2:21434661-21434753,chr2,21434661,21434753,IMR90|chr2:85193944-85193968,chr2,85193944,85193968,0,63759283
IMR90|chr2:21489437-21489485,chr2,21489437,21489485,IMR90|chr2:73052647-73052742,chr2,73052647,73052742,0,51563210
IMR90|chr2:21852659-21852703,chr2,21852659,21852703,IMR90|chr2:47402318-47402387,chr2,47402318,47402387,0,25549659
IMR90|chr2:22035790-22035888,chr2,22035790,22035888,IMR90|chr2:37894502-37894541,chr2,37894502,37894541,0,15858712
IMR90|chr2:22500576-22500625,chr2,22500576,22500625,IMR90|chr2:37192690-37192730,chr2,37192690,37192730,0,14692114
IMR90|chr2:23011056-23011160,chr2,23011056,23011160,IMR90|chr2:65356082-65356115,chr2,65356082,65356115,0,42345026
IMR90|chr2:23263412-23263562,chr2,23263412,23263562,IMR90|chr2:102758193-102758229,chr2,102758193,102758229,0,79494781
IMR90|chr2:23336834-23336920,chr2,23336834,23336920,IMR90|chr2:85195016-85195054,chr2,85195016,85195054,0,61858182
IMR90|chr2:23801673-23801765,chr2,23801673,23801765,IMR90|chr2:37895882-37895936,chr2,37895882,37895936,0,14094209
IMR90|chr2:24080752-24080902,chr2,24080752,24080902,IMR90|chr2:216298901-216298924,chr2,216298901,216298924,0,192218149
IMR90|chr2:24139742-24139803,chr2,24139742,24139803,IMR90|chr2:228334364-228334443,chr2,228334364,228334443,0,204194622
IMR90|chr2:24302670-24302768,chr2,24302670,24302768,IMR90|chr2:36585525-36585645,chr2,36585525,36585645,0,12282855
IMR90|chr2:24595929-24596017,chr2,24595929,24596017,IMR90|chr2:178079342-178079452,chr2,178079342,178079452,0,153483413
IMR90|chr2:24858201-24858298,chr2,24858201,24858298,IMR90|chr2:69869904-69869983,chr2,69869904,69869983,0,45011703
IMR90|chr2:24883920-24883941,chr2,24883920,24883941,IMR90|chr2:151337708-151337779,chr2,151337708,151337779,0,126453788
IMR90|chr2:24890534-24890614,chr2,24890534,24890614,IMR90|chr2:192546930-192546969,chr2,192546930,192546969,0,167656396
IMR90|chr2:25465591-25465640,chr2,25465591,25465640,IMR90|chr2:74777010-74777065,chr2,74777010,74777065,0,49311419
IMR90|chr2:25468357-25468401,chr2,25468357,25468401,IMR90|chr2:85194057-85194147,chr2,85194057,85194147,0,59725700
IMR90|chr2:25539840-25539903,chr2,25539840,25539903,IMR90|chr2:216300208-216300316,chr2,216300208,216300316,0,190760368
IMR90|chr2:25754591-25754665,chr2,25754591,25754665,IMR90|chr2:75786736-75786802,chr2,75786736,75786802,0,50032145
IMR90|chr2:26175066-26175089,chr2,26175066,26175089,IMR90|chr2:55274150-55274249,chr2,55274150,55274249,0,29099084
IMR90|chr2:26248187-26248301,chr2,26248187,26248301,IMR90|chr2:106012209-106012270,chr2,106012209,106012270,0,79764022
IMR90|chr2:26362622-26362705,chr2,26362622,26362705,IMR90|chr2:85195636-85195735,chr2,85195636,85195735,0,58833014
IMR90|chr2:26416341-26416464,chr2,26416341,26416464,IMR90|chr2:201983145-201983170,chr2,201983145,201983170,0,175566804
IMR90|chr2:27169632-27169684,chr2,27169632,27169684,IMR90|chr2:190539728-190539789,chr2,190539728,190539789,0,163370096
IMR90|chr2:27368856-27368924,chr2,27368856,27368924,IMR90|chr2:201451422-201451544,chr2,201451422,201451544,0,174082566
IMR90|chr2:27388856-27388926,chr2,27388856,27388926,IMR90|chr2:36582962-36583024,chr2,36582962,36583024,0,9194106
IMR90|chr2:27690495-27690540,chr2,27690495,27690540,IMR90|chr2:106012711-106012818,chr2,106012711,106012818,0,78322216
IMR90|chr2:27710559-27710584,chr2,27710559,27710584,IMR90|chr2:197664046-197664193,chr2,197664046,197664193,0,169953487
IMR90|chr2:27778666-27778741,chr2,27778666,27778741,IMR90|chr2:37898425-37898477,chr2,37898425,37898477,0,10119759
IMR90|chr2:27903357-27903402,chr2,27903357,27903402,IMR90|chr2:47402043-47402128,chr2,47402043,47402128,0,19498686
IMR90|chr2:28002500-28002555,chr2,28002500,28002555,IMR90|chr2:190305748-190305822,chr2,190305748,190305822,0,162303248
IMR90|chr2:28038120-28038198,chr2,28038120,28038198,IMR90|chr2:192019322-192019412,chr2,192019322,192019412,0,163981202
IMR90|chr2:28138714-28138828,chr2,28138714,28138828,IMR90|chr2:218806753-218806788,chr2,218806753,218806788,0,190668039
IMR90|chr2:28885055-28885074,chr2,28885055,28885074,IMR90|chr2:47402593-47402682,chr2,47402593,47402682,0,18517538
IMR90|chr2:28923178-28923282,chr2,28923178,28923282,IMR90|chr2:190041156-190041236,chr2,190041156,190041236,0,161117978
IMR90|chr2:29165121-29165138,chr2,29165121,29165138,IMR90|chr2:178079438-178079545,chr2,178079438,178079545,0,148914317
IMR90|chr2:29808116-29808176,chr2,29808116,29808176,IMR90|chr2:85194545-85194635,chr2,85194545,85194635,0,55386429
IMR90|chr2:30472843-30472925,chr2,30472843,30472925,IMR90|chr2:242210704-242210725,chr2,242210704,242210725,0,211737861
IMR90|chr2:30600132-30600174,chr2,30600132,30600174,IMR90|chr2:37898288-37898396,chr2,37898288,37898396,0,7298156
IMR90|chr2:30680558-30680644,chr2,30680558,30680644,IMR90|chr2:218768060-218768121,chr2,218768060,218768121,0,188087502
IMR90|chr2:30968132-30968195,chr2,30968132,30968195,IMR90|chr2:192020014-192020101,chr2,192020014,192020101,0,161051882
IMR90|chr2:31408234-31408348,chr2,31408234,31408348,IMR90|chr2:106012209-106012270,chr2,106012209,106012270,0,74603975
IMR90|chr2:31597435-31597459,chr2,31597435,31597459,IMR90|chr2:54197349-54197475,chr2,54197349,54197475,0,22599914
IMR90|chr2:31623518-31623560,chr2,31623518,31623560,IMR90|chr2:84690368-84690428,chr2,84690368,84690428,0,53066850
IMR90|chr2:31854628-31854659,chr2,31854628,31854659,IMR90|chr2:85193944-85193998,chr2,85193944,85193998,0,53339316
IMR90|chr2:31865275-31865302,chr2,31865275,31865302,IMR90|chr2:85193193-85193285,chr2,85193193,85193285,0,53327918
IMR90|chr2:31964560-31964676,chr2,31964560,31964676,IMR90|chr2:85195530-85195584,chr2,85195530,85195584,0,53230970
IMR90|chr2:32002612-32002647,chr2,32002612,32002647,IMR90|chr2:67620110-67620224,chr2,67620110,67620224,0,35617498
IMR90|chr2:32387899-32387992,chr2,32387899,32387992,IMR90|chr2:85193640-85193697,chr2,85193640,85193697,0,52805741
IMR90|chr2:32465143-32465205,chr2,32465143,32465205,IMR90|chr2:236403672-236403712,chr2,236403672,236403712,0,203938529
IMR90|chr2:32707400-32707447,chr2,32707400,32707447,IMR90|chr2:231579013-231579116,chr2,231579013,231579116,0,198871613
IMR90|chr2:33719008-33719101,chr2,33719008,33719101,IMR90|chr2:85193297-85193327,chr2,85193297,85193327,0,51474289
IMR90|chr2:34333999-34334043,chr2,34333999,34334043,IMR90|chr2:36586611-36586694,chr2,36586611,36586694,0,2252612
IMR90|chr2:34593871-34593954,chr2,34593871,34593954,IMR90|chr2:47400774-47400831,chr2,47400774,47400831,0,12806903
IMR90|chr2:34906412-34906513,chr2,34906412,34906513,IMR90|chr2:85194668-85194732,chr2,85194668,85194732,0,50288256
IMR90|chr2:34940316-34940409,chr2,34940316,34940409,IMR90|chr2:85193640-85193697,chr2,85193640,85193697,0,50253324
IMR90|chr2:34955639-34955733,chr2,34955639,34955733,IMR90|chr2:66667525-66667581,chr2,66667525,66667581,0,31711886
IMR90|chr2:35099818-35099844,chr2,35099818,35099844,IMR90|chr2:85195073-85195115,chr2,85195073,85195115,0,50095255
IMR90|chr2:35359790-35359812,chr2,35359790,35359812,IMR90|chr2:201451422-201451544,chr2,201451422,201451544,0,166091632
IMR90|chr2:35537908-35537975,chr2,35537908,35537975,IMR90|chr2:203241437-203241520,chr2,203241437,203241520,0,167703529
IMR90|chr2:36194256-36194291,chr2,36194256,36194291,IMR90|chr2:242629763-242629876,chr2,242629763,242629876,0,206435507
IMR90|chr2:36310288-36310319,chr2,36310288,36310319,IMR90|chr2:232651695-232651771,chr2,232651695,232651771,0,196341407
IMR90|chr2:36364681-36364705,chr2,36364681,36364705,IMR90|chr2:55273050-55273192,chr2,55273050,55273192,0,18908369
IMR90|chr2:36907116-36907189,chr2,36907116,36907189,IMR90|chr2:112813985-112814079,chr2,112813985,112814079,0,75906869
IMR90|chr2:36958353-36958503,chr2,36958353,36958503,IMR90|chr2:66674189-66674224,chr2,66674189,66674224,0,29715836
IMR90|chr2:37419857-37419903,chr2,37419857,37419903,IMR90|chr2:219156470-219156620,chr2,219156470,219156620,0,181736613
IMR90|chr2:37927270-37927315,chr2,37927270,37927315,IMR90|chr2:9615871-9615919,chr2,9615871,9615919,0,28311399
IMR90|chr2:37945490-37945524,chr2,37945490,37945524,IMR90|chr2:148777079-148777225,chr2,148777079,148777225,0,110831589
IMR90|chr2:37982517-37982553,chr2,37982517,37982553,IMR90|chr2:29095011-29095136,chr2,29095011,29095136,0,8887506
IMR90|chr2:39125588-39125622,chr2,39125588,39125622,IMR90|chr2:3627267-3627322,chr2,3627267,3627322,0,35498321
IMR90|chr2:39384184-39384286,chr2,39384184,39384286,IMR90|chr2:39662486-39662531,chr2,39662486,39662531,0,278302
IMR90|chr2:39533909-39533934,chr2,39533909,39533934,IMR90|chr2:55274389-55274463,chr2,55274389,55274463,0,15740480
IMR90|chr2:39616014-39616061,chr2,39616014,39616061,IMR90|chr2:74782165-74782260,chr2,74782165,74782260,0,35166151
IMR90|chr2:39657113-39657208,chr2,39657113,39657208,IMR90|chr2:65659417-65659486,chr2,65659417,65659486,0,26002304
IMR90|chr2:40091059-40091115,chr2,40091059,40091115,IMR90|chr2:33362856-33362945,chr2,33362856,33362945,0,6728203
IMR90|chr2:40331350-40331395,chr2,40331350,40331395,IMR90|chr2:176046017-176046110,chr2,176046017,176046110,0,135714667
IMR90|chr2:40381843-40381932,chr2,40381843,40381932,IMR90|chr2:203734353-203734409,chr2,203734353,203734409,0,163352510
IMR90|chr2:40469407-40469493,chr2,40469407,40469493,IMR90|chr2:169311582-169311600,chr2,169311582,169311600,0,128842175
IMR90|chr2:40878369-40878422,chr2,40878369,40878422,IMR90|chr2:64071740-64071819,chr2,64071740,64071819,0,23193371
IMR90|chr2:40986377-40986441,chr2,40986377,40986441,IMR90|chr2:33360612-33360673,chr2,33360612,33360673,0,7625765
IMR90|chr2:41030534-41030632,chr2,41030534,41030632,IMR90|chr2:36585525-36585645,chr2,36585525,36585645,0,4445009
IMR90|chr2:41039378-41039502,chr2,41039378,41039502,IMR90|chr2:238320005-238320028,chr2,238320005,238320028,0,197280627
IMR90|chr2:41476416-41476438,chr2,41476416,41476438,IMR90|chr2:230785874-230785988,chr2,230785874,230785988,0,189309458
IMR90|chr2:41725090-41725140,chr2,41725090,41725140,IMR90|chr2:241529047-241529139,chr2,241529047,241529139,0,199803957
IMR90|chr2:41801618-41801670,chr2,41801618,41801670,IMR90|chr2:192020027-192020104,chr2,192020027,192020104,0,150218409
IMR90|chr2:41887388-41887420,chr2,41887388,41887420,IMR90|chr2:208577289-208577407,chr2,208577289,208577407,0,166689901
IMR90|chr2:41962833-41962949,chr2,41962833,41962949,IMR90|chr2:85195530-85195584,chr2,85195530,85195584,0,43232697
IMR90|chr2:42013100-42013194,chr2,42013100,42013194,IMR90|chr2:242444044-242444120,chr2,242444044,242444120,0,200430944
IMR90|chr2:42531372-42531416,chr2,42531372,42531416,IMR90|chr2:47402318-47402387,chr2,47402318,47402387,0,4870946
IMR90|chr2:42578549-42578574,chr2,42578549,42578574,IMR90|chr2:218766245-218766337,chr2,218766245,218766337,0,176187696
IMR90|chr2:43283453-43283516,chr2,43283453,43283516,IMR90|chr2:192020014-192020101,chr2,192020014,192020101,0,148736561
IMR90|chr2:43721698-43721777,chr2,43721698,43721777,IMR90|chr2:218767138-218767176,chr2,218767138,218767176,0,175045440
IMR90|chr2:44070266-44070296,chr2,44070266,44070296,IMR90|chr2:242211243-242211340,chr2,242211243,242211340,0,198140977
IMR90|chr2:44075232-44075325,chr2,44075232,44075325,IMR90|chr2:85193933-85194005,chr2,85193933,85194005,0,41118701
IMR90|chr2:44111697-44111723,chr2,44111697,44111723,IMR90|chr2:190306707-190306761,chr2,190306707,190306761,0,146195010
IMR90|chr2:44159002-44159058,chr2,44159002,44159058,IMR90|chr2:162017027-162017132,chr2,162017027,162017132,0,117858025
IMR90|chr2:44665916-44665987,chr2,44665916,44665987,IMR90|chr2:37898440-37898476,chr2,37898440,37898476,0,6767476
IMR90|chr2:44777778-44777844,chr2,44777778,44777844,IMR90|chr2:106013771-106013857,chr2,106013771,106013857,0,61235993
IMR90|chr2:44928891-44928947,chr2,44928891,44928947,IMR90|chr2:85195578-85195672,chr2,85195578,85195672,0,40266687
IMR90|chr2:45493576-45493608,chr2,45493576,45493608,IMR90|chr2:190540934-190540964,chr2,190540934,190540964,0,145047358
IMR90|chr2:45543661-45543729,chr2,45543661,45543729,IMR90|chr2:69869828-69869875,chr2,69869828,69869875,0,24326167
IMR90|chr2:45616607-45616677,chr2,45616607,45616677,IMR90|chr2:36582962-36583024,chr2,36582962,36583024,0,9033645
IMR90|chr2:46510642-46510666,chr2,46510642,46510666,IMR90|chr2:54197349-54197475,chr2,54197349,54197475,0,7686707
IMR90|chr2:46529899-46529939,chr2,46529899,46529939,IMR90|chr2:85197526-85197671,chr2,85197526,85197671,0,38667627
IMR90|chr2:47549052-47549112,chr2,47549052,47549112,IMR90|chr2:192019322-192019412,chr2,192019322,192019412,0,144470270
IMR90|chr2:48521138-48521211,chr2,48521138,48521211,IMR90|chr2:201982446-201982471,chr2,201982446,201982471,0,153461308
IMR90|chr2:48669470-48669547,chr2,48669470,48669547,IMR90|chr2:208577289-208577344,chr2,208577289,208577344,0,159907819
IMR90|chr2:48786068-48786136,chr2,48786068,48786136,IMR90|chr2:69869904-69869983,chr2,69869904,69869983,0,21083836
IMR90|chr2:49521022-49521114,chr2,49521022,49521114,IMR90|chr2:232651695-232651771,chr2,232651695,232651771,0,183130673
IMR90|chr2:49621714-49621797,chr2,49621714,49621797,IMR90|chr2:43822657-43822774,chr2,43822657,43822774,0,5799057
IMR90|chr2:50042554-50042635,chr2,50042554,50042635,IMR90|chr2:197668622-197668687,chr2,197668622,197668687,0,147626068
IMR90|chr2:50743669-50743749,chr2,50743669,50743749,IMR90|chr2:197668622-197668687,chr2,197668622,197668687,0,146924953
IMR90|chr2:50811959-50812067,chr2,50811959,50812067,IMR90|chr2:26212997-26213030,chr2,26212997,26213030,0,24598962
IMR90|chr2:50946843-50946868,chr2,50946843,50946868,IMR90|chr2:197664046-197664193,chr2,197664046,197664193,0,146717203
IMR90|chr2:51956288-51956346,chr2,51956288,51956346,IMR90|chr2:169309798-169309887,chr2,169309798,169309887,0,117353510
IMR90|chr2:52105798-52105825,chr2,52105798,52105825,IMR90|chr2:36585525-36585645,chr2,36585525,36585645,0,15520273
IMR90|chr2:52181417-52181567,chr2,52181417,52181567,IMR90|chr2:39662486-39662531,chr2,39662486,39662531,0,12518931
IMR90|chr2:52249674-52249741,chr2,52249674,52249741,IMR90|chr2:174831520-174831552,chr2,174831520,174831552,0,122581846
IMR90|chr2:52724655-52724677,chr2,52724655,52724677,IMR90|chr2:19546935-19546979,chr2,19546935,19546979,0,33177720
IMR90|chr2:52859769-52859826,chr2,52859769,52859826,IMR90|chr2:67620157-67620224,chr2,67620157,67620224,0,14760388
IMR90|chr2:53359583-53359651,chr2,53359583,53359651,IMR90|chr2:238536942-238537023,chr2,238536942,238537023,0,185177359
IMR90|chr2:53450365-53450493,chr2,53450365,53450493,IMR90|chr2:26213000-26213022,chr2,26213000,26213022,0,27237365
IMR90|chr2:54421414-54421488,chr2,54421414,54421488,IMR90|chr2:242444044-242444120,chr2,242444044,242444120,0,188022630
IMR90|chr2:54535582-54535613,chr2,54535582,54535613,IMR90|chr2:232651695-232651771,chr2,232651695,232651771,0,178116113
IMR90|chr2:54751936-54751968,chr2,54751936,54751968,IMR90|chr2:242453415-242453533,chr2,242453415,242453533,0,187701479
IMR90|chr2:54756409-54756438,chr2,54756409,54756438,IMR90|chr2:216300208-216300316,chr2,216300208,216300316,0,161543799
IMR90|chr2:54795879-54795934,chr2,54795879,54795934,IMR90|chr2:73052647-73052742,chr2,73052647,73052742,0,18256768
IMR90|chr2:54818256-54818330,chr2,54818256,54818330,IMR90|chr2:153031560-153031590,chr2,153031560,153031590,0,98213304
IMR90|chr2:54974633-54974698,chr2,54974633,54974698,IMR90|chr2:227666226-227666246,chr2,227666226,227666246,0,172691593
IMR90|chr2:55208695-55208714,chr2,55208695,55208714,IMR90|chr2:47402593-47402682,chr2,47402593,47402682,0,7806102
IMR90|chr2:55368809-55368829,chr2,55368809,55368829,IMR90|chr2:106011919-106012069,chr2,106011919,106012069,0,50643110
IMR90|chr2:56390300-56390347,chr2,56390300,56390347,IMR90|chr2:231579013-231579116,chr2,231579013,231579116,0,175188713
IMR90|chr2:56635224-56635297,chr2,56635224,56635297,IMR90|chr2:232651695-232651771,chr2,232651695,232651771,0,176016471
IMR90|chr2:56647788-56647838,chr2,56647788,56647838,IMR90|chr2:37192690-37192729,chr2,37192690,37192729,0,19455098
IMR90|chr2:56938643-56938742,chr2,56938643,56938742,IMR90|chr2:174829593-174829619,chr2,174829593,174829619,0,117890950
IMR90|chr2:57006223-57006254,chr2,57006223,57006254,IMR90|chr2:85195607-85195658,chr2,85195607,85195658,0,28189384
IMR90|chr2:57157592-57157672,chr2,57157592,57157672,IMR90|chr2:65659417-65659486,chr2,65659417,65659486,0,8501825
IMR90|chr2:57398299-57398388,chr2,57398299,57398388,IMR90|chr2:85196204-85196223,chr2,85196204,85196223,0,27797905
IMR90|chr2:57627863-57627889,chr2,57627863,57627889,IMR90|chr2:85194566-85194623,chr2,85194566,85194623,0,27566703
IMR90|chr2:58417967-58418037,chr2,58417967,58418037,IMR90|chr2:33361204-33361275,chr2,33361204,33361275,0,25056763
IMR90|chr2:58566400-58566493,chr2,58566400,58566493,IMR90|chr2:242446514-242446571,chr2,242446514,242446571,0,183880114
IMR90|chr2:58940377-58940396,chr2,58940377,58940396,IMR90|chr2:74603693-74603771,chr2,74603693,74603771,0,15663316
IMR90|chr2:60352628-60352699,chr2,60352628,60352699,IMR90|chr2:201982448-201982495,chr2,201982448,201982495,0,141629820
IMR90|chr2:60578769-60578824,chr2,60578769,60578824,IMR90|chr2:85197479-85197563,chr2,85197479,85197563,0,24618710
IMR90|chr2:61648054-61648121,chr2,61648054,61648121,IMR90|chr2:190041156-190041236,chr2,190041156,190041236,0,128393102
IMR90|chr2:61662745-61662867,chr2,61662745,61662867,IMR90|chr2:85193395-85193491,chr2,85193395,85193491,0,23530650
IMR90|chr2:61690646-61690742,chr2,61690646,61690742,IMR90|chr2:85195530-85195584,chr2,85195530,85195584,0,23504884
IMR90|chr2:61691104-61691125,chr2,61691104,61691125,IMR90|chr2:151337708-151337779,chr2,151337708,151337779,0,89646604
IMR90|chr2:61836915-61836934,chr2,61836915,61836934,IMR90|chr2:178079438-178079545,chr2,178079438,178079545,0,116242523
IMR90|chr2:61990215-61990272,chr2,61990215,61990272,IMR90|chr2:63821124-63821167,chr2,63821124,63821167,0,1830909
IMR90|chr2:62246975-62247007,chr2,62246975,62247007,IMR90|chr2:43822657-43822774,chr2,43822657,43822774,0,18424318
IMR90|chr2:62300822-62300914,chr2,62300822,62300914,IMR90|chr2:85194317-85194362,chr2,85194317,85194362,0,22893495
IMR90|chr2:62387609-62387650,chr2,62387609,62387650,IMR90|chr2:84690368-84690428,chr2,84690368,84690428,0,22302759
IMR90|chr2:62393760-62393788,chr2,62393760,62393788,IMR90|chr2:74230260-74230330,chr2,74230260,74230330,0,11836500
IMR90|chr2:62545892-62545925,chr2,62545892,62545925,IMR90|chr2:26466923-26466974,chr2,26466923,26466974,0,36078969
IMR90|chr2:62685608-62685653,chr2,62685608,62685653,IMR90|chr2:55458808-55458830,chr2,55458808,55458830,0,7226800
IMR90|chr2:62839704-62839766,chr2,62839704,62839766,IMR90|chr2:42276496-42276540,chr2,42276496,42276540,0,20563208
IMR90|chr2:63024461-63024571,chr2,63024461,63024571,IMR90|chr2:190042371-190042453,chr2,190042371,190042453,0,127017910
IMR90|chr2:63484143-63484234,chr2,63484143,63484234,IMR90|chr2:85195578-85195672,chr2,85195578,85195672,0,21711435
IMR90|chr2:63972922-63972940,chr2,63972922,63972940,IMR90|chr2:216298509-216298625,chr2,216298509,216298625,0,152325587
IMR90|chr2:64154230-64154266,chr2,64154230,64154266,IMR90|chr2:29095011-29095136,chr2,29095011,29095136,0,35059219
IMR90|chr2:64231157-64231234,chr2,64231157,64231234,IMR90|chr2:85133262-85133313,chr2,85133262,85133313,0,20902105
IMR90|chr2:64317789-64317866,chr2,64317789,64317866,IMR90|chr2:48542494-48542595,chr2,48542494,48542595,0,15775295
IMR90|chr2:64343041-64343071,chr2,64343041,64343071,IMR90|chr2:47401329-47401364,chr2,47401329,47401364,0,16941712
IMR90|chr2:64537790-64537863,chr2,64537790,64537863,IMR90|chr2:67620179-67620224,chr2,67620179,67620224,0,3082389
IMR90|chr2:64723293-64723379,chr2,64723293,64723379,IMR90|chr2:46927167-46927191,chr2,46927167,46927191,0,17796126
IMR90|chr2:64753248-64753304,chr2,64753248,64753304,IMR90|chr2:178080044-178080129,chr2,178080044,178080129,0,113326796
IMR90|chr2:65326278-65326374,chr2,65326278,65326374,IMR90|chr2:192544209-192544263,chr2,192544209,192544263,0,127217931
IMR90|chr2:65885605-65885677,chr2,65885605,65885677,IMR90|chr2:36587170-36587200,chr2,36587170,36587200,0,29298435
IMR90|chr2:66017680-66017717,chr2,66017680,66017717,IMR90|chr2:71298938-71298995,chr2,71298938,71298995,0,5281258
IMR90|chr2:66348495-66348614,chr2,66348495,66348614,IMR90|chr2:190041054-190041089,chr2,190041054,190041089,0,123692559
IMR90|chr2:66494444-66494532,chr2,66494444,66494532,IMR90|chr2:203734353-203734409,chr2,203734353,203734409,0,137239909
IMR90|chr2:66713339-66713403,chr2,66713339,66713403,IMR90|chr2:47400223-47400257,chr2,47400223,47400257,0,19313116
IMR90|chr2:66765415-66765524,chr2,66765415,66765524,IMR90|chr2:36586865-36586945,chr2,36586865,36586945,0,30178550
IMR90|chr2:66780830-66780858,chr2,66780830,66780858,IMR90|chr2:201754967-201755063,chr2,201754967,201755063,0,134974137
IMR90|chr2:67144921-67144968,chr2,67144921,67144968,IMR90|chr2:242642112-242642220,chr2,242642112,242642220,0,175497191
IMR90|chr2:68744188-68744292,chr2,68744188,68744292,IMR90|chr2:192544209-192544263,chr2,192544209,192544263,0,123800021
IMR90|chr2:69140128-69140216,chr2,69140128,69140216,IMR90|chr2:47139976-47140033,chr2,47139976,47140033,0,22000152
IMR90|chr2:69212803-69212859,chr2,69212803,69212859,IMR90|chr2:162017027-162017132,chr2,162017027,162017132,0,92804224
IMR90|chr2:69366334-69366406,chr2,69366334,69366406,IMR90|chr2:74227345-74227397,chr2,74227345,74227397,0,4861011
IMR90|chr2:69450776-69450858,chr2,69450776,69450858,IMR90|chr2:102315169-102315237,chr2,102315169,102315237,0,32864393
IMR90|chr2:69580692-69580792,chr2,69580692,69580792,IMR90|chr2:190047031-190047081,chr2,190047031,190047081,0,120466339
IMR90|chr2:69907967-69908056,chr2,69907967,69908056,IMR90|chr2:242640566-242640612,chr2,242640566,242640612,0,172732599
IMR90|chr2:70788122-70788222,chr2,70788122,70788222,IMR90|chr2:190047031-190047081,chr2,190047031,190047081,0,119258909
IMR90|chr2:71011694-71011764,chr2,71011694,71011764,IMR90|chr2:75786722-75786802,chr2,75786722,75786802,0,4775028
IMR90|chr2:71244882-71244931,chr2,71244882,71244931,IMR90|chr2:55273463-55273526,chr2,55273463,55273526,0,15971419
IMR90|chr2:71528123-71528175,chr2,71528123,71528175,IMR90|chr2:242445945-242446095,chr2,242445945,242446095,0,170917822
IMR90|chr2:71668563-71668619,chr2,71668563,71668619,IMR90|chr2:26466923-26466974,chr2,26466923,26466974,0,45201640
IMR90|chr2:71899691-71899757,chr2,71899691,71899757,IMR90|chr2:157294031-157294115,chr2,157294031,157294115,0,85394340
IMR90|chr2:71956154-71956224,chr2,71956154,71956224,IMR90|chr2:66666918-66666940,chr2,66666918,66666940,0,5289236
IMR90|chr2:72519676-72519757,chr2,72519676,72519757,IMR90|chr2:224705721-224705752,chr2,224705721,224705752,0,152186045
IMR90|chr2:72842929-72843057,chr2,72842929,72843057,IMR90|chr2:26213000-26213022,chr2,26213000,26213022,0,46629929
IMR90|chr2:73117400-73117456,chr2,73117400,73117456,IMR90|chr2:85195578-85195672,chr2,85195578,85195672,0,12078178
IMR90|chr2:73129518-73129635,chr2,73129518,73129635,IMR90|chr2:74231016-74231036,chr2,74231016,74231036,0,1101498
IMR90|chr2:73157320-73157409,chr2,73157320,73157409,IMR90|chr2:85196204-85196223,chr2,85196204,85196223,0,12038884
IMR90|chr2:73211609-73211660,chr2,73211609,73211660,IMR90|chr2:241529047-241529139,chr2,241529047,241529139,0,168317438
IMR90|chr2:73880066-73880178,chr2,73880066,73880178,IMR90|chr2:242446514-242446571,chr2,242446514,242446571,0,168566448
IMR90|chr2:74086719-74086788,chr2,74086719,74086788,IMR90|chr2:238536942-238537023,chr2,238536942,238537023,0,164450223
IMR90|chr2:74438935-74438995,chr2,74438935,74438995,IMR90|chr2:228334364-228334443,chr2,228334364,228334443,0,153895429
IMR90|chr2:74775278-74775354,chr2,74775278,74775354,IMR90|chr2:64245367-64245404,chr2,64245367,64245404,0,10529911
IMR90|chr2:74946027-74946095,chr2,74946027,74946095,IMR90|chr2:190042371-190042453,chr2,190042371,190042453,0,115096344
IMR90|chr2:75862827-75862867,chr2,75862827,75862867,IMR90|chr2:113994707-113994817,chr2,113994707,113994817,0,38131880
IMR90|chr2:76175285-76175398,chr2,76175285,76175398,IMR90|chr2:219193014-219193034,chr2,219193014,219193034,0,143017729
IMR90|chr2:76523638-76523729,chr2,76523638,76523729,IMR90|chr2:169311582-169311600,chr2,169311582,169311600,0,92787944
IMR90|chr2:76582161-76582250,chr2,76582161,76582250,IMR90|chr2:106012209-106012270,chr2,106012209,106012270,0,29430048
IMR90|chr2:76981990-76982094,chr2,76981990,76982094,IMR90|chr2:242640566-242640612,chr2,242640566,242640612,0,165658576
IMR90|chr2:77731856-77731890,chr2,77731856,77731890,IMR90|chr2:37894517-37894559,chr2,37894517,37894559,0,39837339
IMR90|chr2:77761637-77761686,chr2,77761637,77761686,IMR90|chr2:55273463-55273526,chr2,55273463,55273526,0,22488174
IMR90|chr2:77887458-77887608,chr2,77887458,77887608,IMR90|chr2:73299750-73299779,chr2,73299750,73299779,0,4587708
IMR90|chr2:78598735-78598850,chr2,78598735,78598850,IMR90|chr2:66674189-66674224,chr2,66674189,66674224,0,11924546
IMR90|chr2:79975196-79975259,chr2,79975196,79975259,IMR90|chr2:85193944-85194004,chr2,85193944,85194004,0,5218748
IMR90|chr2:79976542-79976581,chr2,79976542,79976581,IMR90|chr2:219084023-219084119,chr2,219084023,219084119,0,139107481
IMR90|chr2:80146146-80146245,chr2,80146146,80146245,IMR90|chr2:242443724-242443804,chr2,242443724,242443804,0,162297578
IMR90|chr2:80239962-80240042,chr2,80239962,80240042,IMR90|chr2:64245721-64245791,chr2,64245721,64245791,0,15994241
IMR90|chr2:80791320-80791434,chr2,80791320,80791434,IMR90|chr2:8823775-8823810,chr2,8823775,8823810,0,71967545
IMR90|chr2:81144215-81144256,chr2,81144215,81144256,IMR90|chr2:85195624-85195739,chr2,85195624,85195739,0,4051409
IMR90|chr2:81576666-81576749,chr2,81576666,81576749,IMR90|chr2:55273607-55273659,chr2,55273607,55273659,0,26303059
IMR90|chr2:81967001-81967121,chr2,81967001,81967121,IMR90|chr2:66672180-66672234,chr2,66672180,66672234,0,15294821
IMR90|chr2:82125336-82125436,chr2,82125336,82125436,IMR90|chr2:85194328-85194360,chr2,85194328,85194360,0,3068992
IMR90|chr2:82669459-82669529,chr2,82669459,82669529,IMR90|chr2:242210100-242210146,chr2,242210100,242210146,0,159540641
IMR90|chr2:82708564-82708588,chr2,82708564,82708588,IMR90|chr2:54197349-54197475,chr2,54197349,54197475,0,28511215
IMR90|chr2:82723268-82723314,chr2,82723268,82723314,IMR90|chr2:47400695-47400805,chr2,47400695,47400805,0,35322573
IMR90|chr2:82780944-82781071,chr2,82780944,82781071,IMR90|chr2:74231016-74231036,chr2,74231016,74231036,0,8549928
IMR90|chr2:83182293-83182369,chr2,83182293,83182369,IMR90|chr2:64245367-64245404,chr2,64245367,64245404,0,18936926
IMR90|chr2:83218595-83218649,chr2,83218595,83218649,IMR90|chr2:190539728-190539789,chr2,190539728,190539789,0,107321133
IMR90|chr2:83472673-83472823,chr2,83472673,83472823,IMR90|chr2:216298901-216298924,chr2,216298901,216298924,0,132826228
IMR90|chr2:83475390-83475450,chr2,83475390,83475450,IMR90|chr2:228334364-228334443,chr2,228334364,228334443,0,144858974
IMR90|chr2:83583860-83583888,chr2,83583860,83583888,IMR90|chr2:61698247-61698286,chr2,61698247,61698286,0,21885613
IMR90|chr2:83593150-83593172,chr2,83593150,83593172,IMR90|chr2:36585525-36585645,chr2,36585525,36585645,0,47007625
IMR90|chr2:83688479-83688529,chr2,83688479,83688529,IMR90|chr2:241529047-241529139,chr2,241529047,241529139,0,157840568
IMR90|chr2:83747591-83747640,chr2,83747591,83747640,IMR90|chr2:37192690-37192730,chr2,37192690,37192730,0,46554901
IMR90|chr2:83787472-83787513,chr2,83787472,83787513,IMR90|chr2:190539728-190539789,chr2,190539728,190539789,0,106752256
IMR90|chr2:84276603-84276622,chr2,84276603,84276622,IMR90|chr2:178079438-178079545,chr2,178079438,178079545,0,93802835
IMR90|chr2:84347783-84347848,chr2,84347783,84347848,IMR90|chr2:242443724-242443804,chr2,242443724,242443804,0,158095941
IMR90|chr2:84506364-84506401,chr2,84506364,84506401,IMR90|chr2:29095011-29095136,chr2,29095011,29095136,0,55411353
IMR90|chr2:84669459-84669504,chr2,84669459,84669504,IMR90|chr2:112896668-112896713,chr2,112896668,112896713,0,28227209
IMR90|chr2:84692573-84692669,chr2,84692573,84692669,IMR90|chr2:70485992-70486046,chr2,70485992,70486046,0,14206581
IMR90|chr2:84918804-84918887,chr2,84918804,84918887,IMR90|chr2:85193944-85194057,chr2,85193944,85194057,0,275140
IMR90|chr2:85024786-85024806,chr2,85024786,85024806,IMR90|chr2:128642983-128643069,chr2,128642983,128643069,0,43618197
IMR90|chr2:85375974-85376003,chr2,85375974,85376003,IMR90|chr2:102091302-102091390,chr2,102091302,102091390,0,16715328
IMR90|chr2:85378280-85378331,chr2,85378280,85378331,IMR90|chr2:85195636-85195735,chr2,85195636,85195735,0,182644
IMR90|chr2:85462777-85462810,chr2,85462777,85462810,IMR90|chr2:43822657-43822774,chr2,43822657,43822774,0,41640120
IMR90|chr2:85483222-85483332,chr2,85483222,85483332,IMR90|chr2:68478758-68478781,chr2,68478758,68478781,0,17004464
IMR90|chr2:85584499-85584559,chr2,85584499,85584559,IMR90|chr2:192546902-192546936,chr2,192546902,192546936,0,106962403
IMR90|chr2:85637936-85638027,chr2,85637936,85638027,IMR90|chr2:169311582-169311600,chr2,169311582,169311600,0,83673646
IMR90|chr2:85656147-85656186,chr2,85656147,85656186,IMR90|chr2:106012711-106012818,chr2,106012711,106012818,0,20356564
IMR90|chr2:86168021-86168080,chr2,86168021,86168080,IMR90|chr2:228334364-228334431,chr2,228334364,228334431,0,142166343
IMR90|chr2:86823785-86823871,chr2,86823785,86823871,IMR90|chr2:85194668-85194732,chr2,85194668,85194732,0,1629117
IMR90|chr2:86879799-86879845,chr2,86879799,86879845,IMR90|chr2:9615848-9615918,chr2,9615848,9615918,0,77263951
IMR90|chr2:87354966-87355059,chr2,87354966,87355059,IMR90|chr2:218866150-218866191,chr2,218866150,218866191,0,131511184
IMR90|chr2:87369062-87369160,chr2,87369062,87369160,IMR90|chr2:242446514-242446571,chr2,242446514,242446571,0,155077452
IMR90|chr2:87437163-87437248,chr2,87437163,87437248,IMR90|chr2:192545221-192545253,chr2,192545221,192545253,0,105108058
IMR90|chr2:87620390-87620483,chr2,87620390,87620483,IMR90|chr2:151340083-151340133,chr2,151340083,151340133,0,63719693
IMR90|chr2:88212876-88213014,chr2,88212876,88213014,IMR90|chr2:26213000-26213022,chr2,26213000,26213022,0,61999876
IMR90|chr2:88669472-88669567,chr2,88669472,88669567,IMR90|chr2:201984547-201984660,chr2,201984547,201984660,0,113315075
IMR90|chr2:88783529-88783589,chr2,88783529,88783589,IMR90|chr2:192546902-192546936,chr2,192546902,192546936,0,103763373
IMR90|chr2:88871499-88871593,chr2,88871499,88871593,IMR90|chr2:85193933-85194005,chr2,85193933,85194005,0,3677566
IMR90|chr2:88873652-88873704,chr2,88873652,88873704,IMR90|chr2:242446008-242446106,chr2,242446008,242446106,0,153572356
IMR90|chr2:88880707-88880756,chr2,88880707,88880756,IMR90|chr2:37898344-37898436,chr2,37898344,37898436,0,50982363
IMR90|chr2:89012220-89012250,chr2,89012220,89012250,IMR90|chr2:105945430-105945499,chr2,105945430,105945499,0,16933210
IMR90|chr2:89107291-89107332,chr2,89107291,89107332,IMR90|chr2:85195624-85195739,chr2,85195624,85195739,0,3911667
IMR90|chr2:89354885-89354923,chr2,89354885,89354923,IMR90|chr2:118572530-118572636,chr2,118572530,118572636,0,29217645
IMR90|chr2:89359947-89360061,chr2,89359947,89360061,IMR90|chr2:102758193-102758229,chr2,102758193,102758229,0,13398246
IMR90|chr2:89434163-89434189,chr2,89434163,89434189,IMR90|chr2:190306707-190306761,chr2,190306707,190306761,0,100872544
IMR90|chr2:90228560-90228650,chr2,90228560,90228650,IMR90|chr2:218866150-218866191,chr2,218866150,218866191,0,128637590
IMR90|chr2:90291402-90291501,chr2,90291402,90291501,IMR90|chr2:174829593-174829619,chr2,174829593,174829619,0,84538191
IMR90|chr2:91064814-91064859,chr2,91064814,91064859,IMR90|chr2:106012711-106012818,chr2,106012711,106012818,0,14947897
IMR90|chr2:91082121-91082214,chr2,91082121,91082214,IMR90|chr2:70121400-70121457,chr2,70121400,70121457,0,20960721
IMR90|chr2:91492745-91492820,chr2,91492745,91492820,IMR90|chr2:157294030-157294105,chr2,157294030,157294105,0,65801285
IMR90|chr2:92137877-92137936,chr2,92137877,92137936,IMR90|chr2:192543583-192543650,chr2,192543583,192543650,0,100405706
IMR90|chr2:92203357-92203438,chr2,92203357,92203438,IMR90|chr2:197668622-197668687,chr2,197668622,197668687,0,105465265
IMR90|chr2:92547504-92547597,chr2,92547504,92547597,IMR90|chr2:218866150-218866191,chr2,218866150,218866191,0,126318646
IMR90|chr2:92679205-92679281,chr2,92679205,92679281,IMR90|chr2:189162191-189162222,chr2,189162191,189162222,0,96482986
IMR90|chr2:93090642-93090750,chr2,93090642,93090750,IMR90|chr2:26212997-26213030,chr2,26212997,26213030,0,66877645
IMR90|chr2:93571948-93572040,chr2,93571948,93572040,IMR90|chr2:85194317-85194362,chr2,85194317,85194362,0,8377631
IMR90|chr2:93642680-93642814,chr2,93642680,93642814,IMR90|chr2:37383559-37383613,chr2,37383559,37383613,0,56259121
IMR90|chr2:93801703-93801751,chr2,93801703,93801751,IMR90|chr2:36586536-36586617,chr2,36586536,36586617,0,57215167
IMR90|chr2:93930519-93930572,chr2,93930519,93930572,IMR90|chr2:219083852-219083914,chr2,219083852,219083914,0,125153333
IMR90|chr2:94310515-94310561,chr2,94310515,94310561,IMR90|chr2:54090720-54090790,chr2,54090720,54090790,0,40219795
IMR90|chr2:94486080-94486146,chr2,94486080,94486146,IMR90|chr2:67620174-67620224,chr2,67620174,67620224,0,26865906
IMR90|chr2:94505898-94505968,chr2,94505898,94505968,IMR90|chr2:218768045-218768120,chr2,218768045,218768120,0,124262147
IMR90|chr2:94563416-94563464,chr2,94563416,94563464,IMR90|chr2:46927167-46927191,chr2,46927167,46927191,0,47636249
IMR90|chr2:95004496-95004573,chr2,95004496,95004573,IMR90|chr2:85194668-85194732,chr2,85194668,85194732,0,9809828
IMR90|chr2:95084674-95084751,chr2,95084674,95084751,IMR90|chr2:238876309-238876382,chr2,238876309,238876382,0,143791635
IMR90|chr2:95094860-95094914,chr2,95094860,95094914,IMR90|chr2:85194423-85194504,chr2,85194423,85194504,0,9900437
IMR90|chr2:95122858-95122913,chr2,95122858,95122913,IMR90|chr2:190305748-190305822,chr2,190305748,190305822,0,95182890
IMR90|chr2:95202555-95202598,chr2,95202555,95202598,IMR90|chr2:151337708-151337779,chr2,151337708,151337779,0,56135153
IMR90|chr2:95728957-95729031,chr2,95728957,95729031,IMR90|chr2:85195689-85195764,chr2,85195689,85195764,0,10533268
IMR90|chr2:96438088-96438183,chr2,96438088,96438183,IMR90|chr2:85194317-85194362,chr2,85194317,85194362,0,11243771
IMR90|chr2:96511687-96511755,chr2,96511687,96511755,IMR90|chr2:190042371-190042453,chr2,190042371,190042453,0,93530684
IMR90|chr2:96813430-96813520,chr2,96813430,96813520,IMR90|chr2:27251841-27251882,chr2,27251841,27251882,0,69561589
IMR90|chr2:96879866-96879928,chr2,96879866,96879928,IMR90|chr2:113994707-113994817,chr2,113994707,113994817,0,17114841
IMR90|chr2:97110082-97110127,chr2,97110082,97110127,IMR90|chr2:189162193-189162223,chr2,189162193,189162223,0,92052111
IMR90|chr2:97235918-97236009,chr2,97235918,97236009,IMR90|chr2:227659525-227659584,chr2,227659525,227659584,0,130423607
IMR90|chr2:97416332-97416408,chr2,97416332,97416408,IMR90|chr2:15733243-15733317,chr2,15733243,15733317,0,81683089
IMR90|chr2:97713805-97713885,chr2,97713805,97713885,IMR90|chr2:55276763-55276810,chr2,55276763,55276810,0,42437042
IMR90|chr2:97748530-97748584,chr2,97748530,97748584,IMR90|chr2:174828255-174828303,chr2,174828255,174828303,0,77079725
IMR90|chr2:98241758-98241823,chr2,98241758,98241823,IMR90|chr2:47401938-47401977,chr2,47401938,47401977,0,50839820
IMR90|chr2:98262496-98262563,chr2,98262496,98262563,IMR90|chr2:174831520-174831552,chr2,174831520,174831552,0,76569024
IMR90|chr2:98959588-98959644,chr2,98959588,98959644,IMR90|chr2:63821124-63821167,chr2,63821124,63821167,0,35138464
IMR90|chr2:98961040-98961132,chr2,98961040,98961132,IMR90|chr2:232651695-232651771,chr2,232651695,232651771,0,133690655
IMR90|chr2:98983505-98983573,chr2,98983505,98983573,IMR90|chr2:201451422-201451544,chr2,201451422,201451544,0,102467917
IMR90|chr2:99348013-99348117,chr2,99348013,99348117,IMR90|chr2:37895882-37895936,chr2,37895882,37895936,0,61452131
IMR90|chr2:99610671-99610730,chr2,99610671,99610730,IMR90|chr2:170442006-170442077,chr2,170442006,170442077,0,70831335
IMR90|chr2:99912078-99912172,chr2,99912078,99912172,IMR90|chr2:85193933-85194005,chr2,85193933,85194005,0,14718145
IMR90|chr2:100213357-100213407,chr2,100213357,100213407,IMR90|chr2:37898344-37898436,chr2,37898344,37898436,0,62315013
IMR90|chr2:101223490-101223624,chr2,101223490,101223624,IMR90|chr2:160472082-160472128,chr2,160472082,160472128,0,59248592
IMR90|chr2:101329017-101329103,chr2,101329017,101329103,IMR90|chr2:218768060-218768121,chr2,218768060,218768121,0,117439043
IMR90|chr2:101919288-101919325,chr2,101919288,101919325,IMR90|chr2:71298938-71298995,chr2,71298938,71298995,0,30620350
IMR90|chr2:101979249-101979321,chr2,101979249,101979321,IMR90|chr2:238537243-238537271,chr2,238537243,238537271,0,136557994
IMR90|chr2:102110280-102110301,chr2,102110280,102110301,IMR90|chr2:27580364-27580482,chr2,27580364,27580482,0,74529916
IMR90|chr2:102422004-102422039,chr2,102422004,102422039,IMR90|chr2:242446858-242446945,chr2,242446858,242446945,0,140024854
IMR90|chr2:102470994-102471020,chr2,102470994,102471020,IMR90|chr2:85194566-85194623,chr2,85194566,85194623,0,17276428
IMR90|chr2:102699957-102700025,chr2,102699957,102700025,IMR90|chr2:201982448-201982495,chr2,201982448,201982495,0,99282491
IMR90|chr2:103367615-103367672,chr2,103367615,103367672,IMR90|chr2:231579012-231579105,chr2,231579012,231579105,0,128211397
IMR90|chr2:103603038-103603107,chr2,103603038,103603107,IMR90|chr2:238536942-238537023,chr2,238536942,238537023,0,134933904
IMR90|chr2:103700727-103700795,chr2,103700727,103700795,IMR90|chr2:238536942-238537023,chr2,238536942,238537023,0,134836215
IMR90|chr2:103945500-103945545,chr2,103945500,103945545,IMR90|chr2:55458808-55458830,chr2,55458808,55458830,0,48486692
IMR90|chr2:104083238-104083309,chr2,104083238,104083309,IMR90|chr2:238537243-238537271,chr2,238537243,238537271,0,134454005
IMR90|chr2:104431637-104431667,chr2,104431637,104431667,IMR90|chr2:242211243-242211340,chr2,242211243,242211340,0,137779606
IMR90|chr2:104517249-104517363,chr2,104517249,104517363,IMR90|chr2:102758193-102758229,chr2,102758193,102758229,0,1759056
IMR90|chr2:104778347-104778448,chr2,104778347,104778448,IMR90|chr2:15732460-15732494,chr2,15732460,15732494,0,89045887
IMR90|chr2:104853347-104853429,chr2,104853347,104853429,IMR90|chr2:192545221-192545253,chr2,192545221,192545253,0,87691874
IMR90|chr2:105250692-105250758,chr2,105250692,105250758,IMR90|chr2:67620174-67620224,chr2,67620174,67620224,0,37630518
IMR90|chr2:105392486-105392610,chr2,105392486,105392610,IMR90|chr2:190047031-190047081,chr2,190047031,190047081,0,84654545
IMR90|chr2:105434527-105434631,chr2,105434527,105434631,IMR90|chr2:160472082-160472128,chr2,160472082,160472128,0,55037555
IMR90|chr2:105437822-105437878,chr2,105437822,105437878,IMR90|chr2:37898288-37898396,chr2,37898288,37898396,0,67539534
IMR90|chr2:105447908-105447953,chr2,105447908,105447953,IMR90|chr2:33361796-33361836,chr2,33361796,33361836,0,72086112
IMR90|chr2:106200366-106200453,chr2,106200366,106200453,IMR90|chr2:47139976-47140033,chr2,47139976,47140033,0,59060390
IMR90|chr2:106204205-106204284,chr2,106204205,106204284,IMR90|chr2:65356523-65356584,chr2,65356523,65356584,0,40847682
IMR90|chr2:106426780-106426889,chr2,106426780,106426889,IMR90|chr2:55512578-55512608,chr2,55512578,55512608,0,50914202
IMR90|chr2:106574893-106574939,chr2,106574893,106574939,IMR90|chr2:74405670-74405739,chr2,74405670,74405739,0,32169223
IMR90|chr2:106784356-106784419,chr2,106784356,106784419,IMR90|chr2:242446008-242446106,chr2,242446008,242446106,0,135661652
IMR90|chr2:107743873-107743915,chr2,107743873,107743915,IMR90|chr2:37898288-37898396,chr2,37898288,37898396,0,69845585
IMR90|chr2:108067853-108067902,chr2,108067853,108067902,IMR90|chr2:101868475-101868557,chr2,101868475,101868557,0,6199378
IMR90|chr2:108238091-108238193,chr2,108238091,108238193,IMR90|chr2:85195642-85195695,chr2,85195642,85195695,0,23042449
IMR90|chr2:108344706-108344758,chr2,108344706,108344758,IMR90|chr2:242446008-242446106,chr2,242446008,242446106,0,134101302
IMR90|chr2:108496383-108496460,chr2,108496383,108496460,IMR90|chr2:48542494-48542595,chr2,48542494,48542595,0,59953889
IMR90|chr2:108654717-108654831,chr2,108654717,108654831,IMR90|chr2:190041054-190041089,chr2,190041054,190041089,0,81386337
IMR90|chr2:108698654-108698696,chr2,108698654,108698696,IMR90|chr2:47402402-47402477,chr2,47402402,47402477,0,61296252
IMR90|chr2:108741297-108741376,chr2,108741297,108741376,IMR90|chr2:71358457-71358519,chr2,71358457,71358519,0,37382840
IMR90|chr2:108793041-108793112,chr2,108793041,108793112,IMR90|chr2:65356082-65356115,chr2,65356082,65356115,0,43436959
IMR90|chr2:108874502-108874636,chr2,108874502,108874636,IMR90|chr2:160472082-160472128,chr2,160472082,160472128,0,51597580
IMR90|chr2:109301819-109301876,chr2,109301819,109301876,IMR90|chr2:67620157-67620224,chr2,67620157,67620224,0,41681662
IMR90|chr2:109333218-109333322,chr2,109333218,109333322,IMR90|chr2:37895882-37895936,chr2,37895882,37895936,0,71437336
IMR90|chr2:109525796-109525884,chr2,109525796,109525884,IMR90|chr2:203734353-203734409,chr2,203734353,203734409,0,94208557
IMR90|chr2:109669325-109669389,chr2,109669325,109669389,IMR90|chr2:33361531-33361597,chr2,33361531,33361597,0,76307794
IMR90|chr2:109854332-109854401,chr2,109854332,109854401,IMR90|chr2:198315923-198316073,chr2,198315923,198316073,0,88461591
IMR90|chr2:109865427-109865488,chr2,109865427,109865488,IMR90|chr2:70422851-70422909,chr2,70422851,70422909,0,39442576
IMR90|chr2:110092416-110092459,chr2,110092416,110092459,IMR90|chr2:224705721-224705752,chr2,224705721,224705752,0,114613305
IMR90|chr2:110232329-110232366,chr2,110232329,110232366,IMR90|chr2:118572530-118572636,chr2,118572530,118572636,0,8340201
IMR90|chr2:110320675-110320750,chr2,110320675,110320750,IMR90|chr2:19546935-19546974,chr2,19546935,19546974,0,90773740
IMR90|chr2:110449385-110449487,chr2,110449385,110449487,IMR90|chr2:27545005-27545073,chr2,27545005,27545073,0,82904380
IMR90|chr2:110920987-110921051,chr2,110920987,110921051,IMR90|chr2:201754864-201754907,chr2,201754864,201754907,0,90833877
IMR90|chr2:110974873-110974898,chr2,110974873,110974898,IMR90|chr2:55274389-55274463,chr2,55274389,55274463,0,55700484
IMR90|chr2:110982354-110982424,chr2,110982354,110982424,IMR90|chr2:33361204-33361275,chr2,33361204,33361275,0,77621150
IMR90|chr2:111132871-111132904,chr2,111132871,111132904,IMR90|chr2:96930792-96930909,chr2,96930792,96930909,0,14202079
IMR90|chr2:111740143-111740221,chr2,111740143,111740221,IMR90|chr2:65356523-65356584,chr2,65356523,65356584,0,46383620
IMR90|chr2:112265597-112265629,chr2,112265597,112265629,IMR90|chr2:190540934-190540964,chr2,190540934,190540964,0,78275337
IMR90|chr2:112475082-112475117,chr2,112475082,112475117,IMR90|chr2:85195580-85195624,chr2,85195580,85195624,0,27279502
IMR90|chr2:112963943-112964047,chr2,112963943,112964047,IMR90|chr2:190041156-190041236,chr2,190041156,190041236,0,77077213
IMR90|chr2:113494627-113494667,chr2,113494627,113494667,IMR90|chr2:36586589-36586690,chr2,36586589,36586690,0,76908038
IMR90|chr2:113730778-113730803,chr2,113730778,113730803,IMR90|chr2:201989439-201989521,chr2,201989439,201989521,0,88258661
IMR90|chr2:114427776-114427886,chr2,114427776,114427886,IMR90|chr2:70485992-70486046,chr2,70485992,70486046,0,43941784
IMR90|chr2:115010302-115010324,chr2,115010302,115010324,IMR90|chr2:67620175-67620224,chr2,67620175,67620224,0,47390127
IMR90|chr2:115668990-115669059,chr2,115668990,115669059,IMR90|chr2:71358142-71358261,chr2,71358142,71358261,0,44310848
IMR90|chr2:115744974-115745044,chr2,115744974,115745044,IMR90|chr2:227659525-227659602,chr2,227659525,227659602,0,111914551
IMR90|chr2:116602284-116602324,chr2,116602284,116602324,IMR90|chr2:113994707-113994817,chr2,113994707,113994817,0,2607577
IMR90|chr2:116629842-116629870,chr2,116629842,116629870,IMR90|chr2:47400739-47400758,chr2,47400739,47400758,0,69229103
IMR90|chr2:116731449-116731548,chr2,116731449,116731548,IMR90|chr2:242443724-242443804,chr2,242443724,242443804,0,125712275
IMR90|chr2:116888171-116888204,chr2,116888171,116888204,IMR90|chr2:33361531-33361597,chr2,33361531,33361597,0,83526640
IMR90|chr2:117289948-117290039,chr2,117289948,117290039,IMR90|chr2:102315169-102315237,chr2,102315169,102315237,0,14974779
IMR90|chr2:117393184-117393207,chr2,117393184,117393207,IMR90|chr2:27251981-27252089,chr2,27251981,27252089,0,90141203
IMR90|chr2:117627167-117627238,chr2,117627167,117627238,IMR90|chr2:201982448-201982495,chr2,201982448,201982495,0,84355281
IMR90|chr2:117718787-117718857,chr2,117718787,117718857,IMR90|chr2:242210100-242210146,chr2,242210100,242210146,0,124491313
IMR90|chr2:117900375-117900434,chr2,117900375,117900434,IMR90|chr2:228334364-228334431,chr2,228334364,228334431,0,110433989
IMR90|chr2:118105600-118105642,chr2,118105600,118105642,IMR90|chr2:265671-265752,chr2,265671,265752,0,117839929
IMR90|chr2:118264143-118264184,chr2,118264143,118264184,IMR90|chr2:96930792-96930909,chr2,96930792,96930909,0,21333351
IMR90|chr2:119207530-119207565,chr2,119207530,119207565,IMR90|chr2:242446858-242446945,chr2,242446858,242446945,0,123239328
IMR90|chr2:119429722-119429786,chr2,119429722,119429786,IMR90|chr2:201754864-201754907,chr2,201754864,201754907,0,82325142
IMR90|chr2:119550564-119550612,chr2,119550564,119550612,IMR90|chr2:36586536-36586617,chr2,36586536,36586617,0,82964028
IMR90|chr2:119778754-119778771,chr2,119778754,119778771,IMR90|chr2:178079438-178079545,chr2,178079438,178079545,0,58300684
IMR90|chr2:119894149-119894213,chr2,119894149,119894213,IMR90|chr2:33360612-33360673,chr2,33360612,33360673,0,86533537
IMR90|chr2:119918799-119918828,chr2,119918799,119918828,IMR90|chr2:55274434-55274481,chr2,55274434,55274481,0,64644365
IMR90|chr2:119969707-119969766,chr2,119969707,119969766,IMR90|chr2:192546902-192546936,chr2,192546902,192546936,0,72577195
IMR90|chr2:120068605-120068651,chr2,120068605,120068651,IMR90|chr2:47400695-47400805,chr2,47400695,47400805,0,72667910
IMR90|chr2:120153065-120153114,chr2,120153065,120153114,IMR90|chr2:73052647-73052742,chr2,73052647,73052742,0,47100418
IMR90|chr2:120299633-120299708,chr2,120299633,120299708,IMR90|chr2:85194921-85195015,chr2,85194921,85195015,0,35104712
IMR90|chr2:120366095-120366146,chr2,120366095,120366146,IMR90|chr2:241529047-241529139,chr2,241529047,241529139,0,121162952
IMR90|chr2:120694588-120694652,chr2,120694588,120694652,IMR90|chr2:106013771-106013857,chr2,106013771,106013857,0,14680817
IMR90|chr2:120781137-120781207,chr2,120781137,120781207,IMR90|chr2:109746699-109746777,chr2,109746699,109746777,0,11034438
IMR90|chr2:121063493-121063538,chr2,121063493,121063538,IMR90|chr2:162017027-162017132,chr2,162017027,162017132,0,40953534
IMR90|chr2:121144737-121144817,chr2,121144737,121144817,IMR90|chr2:55276763-55276810,chr2,55276763,55276810,0,65867974
IMR90|chr2:121227978-121228025,chr2,121227978,121228025,IMR90|chr2:231579013-231579116,chr2,231579013,231579116,0,110351035
IMR90|chr2:121561294-121561350,chr2,121561294,121561350,IMR90|chr2:33362856-33362945,chr2,33362856,33362945,0,88198438
IMR90|chr2:122067347-122067369,chr2,122067347,122067369,IMR90|chr2:230785874-230785988,chr2,230785874,230785988,0,108718527
IMR90|chr2:122155350-122155459,chr2,122155350,122155459,IMR90|chr2:36586865-36586945,chr2,36586865,36586945,0,85568485
IMR90|chr2:122226103-122226169,chr2,122226103,122226169,IMR90|chr2:84691003-84691031,chr2,84691003,84691031,0,37535100
IMR90|chr2:122401204-122401252,chr2,122401204,122401252,IMR90|chr2:192547939-192548038,chr2,192547939,192548038,0,70146735
IMR90|chr2:122582048-122582129,chr2,122582048,122582129,IMR90|chr2:224705721-224705752,chr2,224705721,224705752,0,102123673
IMR90|chr2:122719870-122719970,chr2,122719870,122719970,IMR90|chr2:162017917-162017958,chr2,162017917,162017958,0,39298047
IMR90|chr2:122800710-122800751,chr2,122800710,122800751,IMR90|chr2:96930792-96930909,chr2,96930792,96930909,0,25869918
IMR90|chr2:123025290-123025338,chr2,123025290,123025338,IMR90|chr2:36582962-36583064,chr2,36582962,36583064,0,86442328
IMR90|chr2:123059775-123059841,chr2,123059775,123059841,IMR90|chr2:219266714-219266783,chr2,219266714,219266783,0,96206939
IMR90|chr2:123567210-123567294,chr2,123567210,123567294,IMR90|chr2:85194890-85195010,chr2,85194890,85195010,0,38372320
IMR90|chr2:123587878-123587950,chr2,123587878,123587950,IMR90|chr2:36587170-36587200,chr2,36587170,36587200,0,87000708
IMR90|chr2:123588333-123588467,chr2,123588333,123588467,IMR90|chr2:224707000-224707055,chr2,224707000,224707055,0,101118667
IMR90|chr2:123751858-123751926,chr2,123751858,123751926,IMR90|chr2:203241438-203241520,chr2,203241438,203241520,0,79489580
IMR90|chr2:123773274-123773303,chr2,123773274,123773303,IMR90|chr2:47141963-47142064,chr2,47141963,47142064,0,76631311
IMR90|chr2:123836512-123836543,chr2,123836512,123836543,IMR90|chr2:71358142-71358261,chr2,71358142,71358261,0,52478370
IMR90|chr2:124050647-124050707,chr2,124050647,124050707,IMR90|chr2:85194545-85194635,chr2,85194545,85194635,0,38856102
IMR90|chr2:124174817-124174843,chr2,124174817,124174843,IMR90|chr2:55274153-55274249,chr2,55274153,55274249,0,68900664
IMR90|chr2:124279871-124279937,chr2,124279871,124279937,IMR90|chr2:157294031-157294115,chr2,157294031,157294115,0,33014160
IMR90|chr2:124507023-124507146,chr2,124507023,124507146,IMR90|chr2:201983145-201983170,chr2,201983145,201983170,0,77476122
IMR90|chr2:124553756-124553857,chr2,124553756,124553857,IMR90|chr2:85194668-85194732,chr2,85194668,85194732,0,39359088
IMR90|chr2:124730298-124730360,chr2,124730298,124730360,IMR90|chr2:55273514-55273602,chr2,55273514,55273602,0,69456784
IMR90|chr2:124913508-124913603,chr2,124913508,124913603,IMR90|chr2:65659417-65659486,chr2,65659417,65659486,0,59254091
IMR90|chr2:125026173-125026262,chr2,125026173,125026262,IMR90|chr2:85194342-85194403,chr2,85194342,85194403,0,39831831
IMR90|chr2:125240918-125240979,chr2,125240918,125240979,IMR90|chr2:70422851-70422909,chr2,70422851,70422909,0,54818067
IMR90|chr2:125941483-125941514,chr2,125941483,125941514,IMR90|chr2:36586197-36586228,chr2,36586197,36586228,0,89355286
IMR90|chr2:126292910-126292943,chr2,126292910,126292943,IMR90|chr2:33361531-33361597,chr2,33361531,33361597,0,92931379
IMR90|chr2:126341801-126341832,chr2,126341801,126341832,IMR90|chr2:85195607-85195658,chr2,85195607,85195658,0,41146194
IMR90|chr2:126401211-126401239,chr2,126401211,126401239,IMR90|chr2:201754967-201755063,chr2,201754967,201755063,0,75353756
IMR90|chr2:126800186-126800259,chr2,126800186,126800259,IMR90|chr2:238880106-238880138,chr2,238880106,238880138,0,112079920
IMR90|chr2:126917531-126917622,chr2,126917531,126917622,IMR90|chr2:85193944-85193982,chr2,85193944,85193982,0,41723587
IMR90|chr2:126992969-126993006,chr2,126992969,126993006,IMR90|chr2:118572530-118572636,chr2,118572530,118572636,0,8420439
IMR90|chr2:127250712-127250795,chr2,127250712,127250795,IMR90|chr2:43822657-43822774,chr2,43822657,43822774,0,83428055
IMR90|chr2:127527336-127527370,chr2,127527336,127527370,IMR90|chr2:242444561-242444656,chr2,242444561,242444656,0,114917225
IMR90|chr2:127914790-127914875,chr2,127914790,127914875,IMR90|chr2:33822849-33822879,chr2,33822849,33822879,0,94091941
IMR90|chr2:129079286-129079370,chr2,129079286,129079370,IMR90|chr2:85197658-85197701,chr2,85197658,85197701,0,43881628
IMR90|chr2:129282155-129282195,chr2,129282155,129282195,IMR90|chr2:85197526-85197671,chr2,85197526,85197671,0,44084629
IMR90|chr2:129546268-129546390,chr2,129546268,129546390,IMR90|chr2:85193395-85193491,chr2,85193395,85193491,0,44352873
IMR90|chr2:130483478-130483501,chr2,130483478,130483501,IMR90|chr2:218769260-218769343,chr2,218769260,218769343,0,88285782
IMR90|chr2:130771270-130771347,chr2,130771270,130771347,IMR90|chr2:85194668-85194732,chr2,85194668,85194732,0,45576602
IMR90|chr2:130975158-130975259,chr2,130975158,130975259,IMR90|chr2:67620175-67620224,chr2,67620175,67620224,0,63354983
IMR90|chr2:131052869-131052930,chr2,131052869,131052930,IMR90|chr2:134877594-134877626,chr2,134877594,134877626,0,3824725
IMR90|chr2:131128412-131128471,chr2,131128412,131128471,IMR90|chr2:170442006-170442077,chr2,170442006,170442077,0,39313594
IMR90|chr2:131383089-131383157,chr2,131383089,131383157,IMR90|chr2:203241438-203241520,chr2,203241438,203241520,0,71858349
IMR90|chr2:131606383-131606407,chr2,131606383,131606407,IMR90|chr2:218769260-218769343,chr2,218769260,218769343,0,87162877
IMR90|chr2:131686113-131686161,chr2,131686113,131686161,IMR90|chr2:192547939-192548038,chr2,192547939,192548038,0,60861826
IMR90|chr2:131880751-131880849,chr2,131880751,131880849,IMR90|chr2:242446514-242446571,chr2,242446514,242446571,0,110565763
IMR90|chr2:131924992-131925049,chr2,131924992,131925049,IMR90|chr2:148779633-148779720,chr2,148779633,148779720,0,16854641
IMR90|chr2:132089354-132089428,chr2,132089354,132089428,IMR90|chr2:55458750-55458778,chr2,55458750,55458778,0,76630604
IMR90|chr2:132217997-132218042,chr2,132217997,132218042,IMR90|chr2:176046017-176046110,chr2,176046017,176046110,0,43828020
IMR90|chr2:132289796-132289890,chr2,132289796,132289890,IMR90|chr2:66667525-66667581,chr2,66667525,66667581,0,65622271
IMR90|chr2:132400990-132401035,chr2,132400990,132401035,IMR90|chr2:112896668-112896713,chr2,112896668,112896713,0,19504322
IMR90|chr2:132672765-132672838,chr2,132672765,132672838,IMR90|chr2:201982446-201982471,chr2,201982446,201982471,0,69309681
IMR90|chr2:132797730-132797812,chr2,132797730,132797812,IMR90|chr2:27545005-27545073,chr2,27545005,27545073,0,105252725
IMR90|chr2:132919925-132919989,chr2,132919925,132919989,IMR90|chr2:55275291-55275354,chr2,55275291,55275354,0,77644634
IMR90|chr2:133350091-133350124,chr2,133350091,133350124,IMR90|chr2:242642493-242642529,chr2,242642493,242642529,0,109292402
IMR90|chr2:133436028-133436108,chr2,133436028,133436108,IMR90|chr2:218767138-218767176,chr2,218767138,218767176,0,85331110
IMR90|chr2:133484638-133484667,chr2,133484638,133484667,IMR90|chr2:55274434-55274481,chr2,55274434,55274481,0,78210204
IMR90|chr2:133694699-133694768,chr2,133694699,133694768,IMR90|chr2:234474775-234474820,chr2,234474775,234474820,0,100780076
IMR90|chr2:134069733-134069848,chr2,134069733,134069848,IMR90|chr2:151340083-151340133,chr2,151340083,151340133,0,17270350
IMR90|chr2:134320184-134320261,chr2,134320184,134320261,IMR90|chr2:85133262-85133313,chr2,85133262,85133313,0,49186922
IMR90|chr2:134577394-134577416,chr2,134577394,134577416,IMR90|chr2:19546935-19546979,chr2,19546935,19546979,0,115030459
IMR90|chr2:135169226-135169327,chr2,135169226,135169327,IMR90|chr2:47399892-47399932,chr2,47399892,47399932,0,87769334
IMR90|chr2:135272823-135272860,chr2,135272823,135272860,IMR90|chr2:29095011-29095136,chr2,29095011,29095136,0,106177812
IMR90|chr2:135668567-135668621,chr2,135668567,135668621,IMR90|chr2:190539728-190539789,chr2,190539728,190539789,0,54871161
IMR90|chr2:135701661-135701758,chr2,135701661,135701758,IMR90|chr2:69869904-69869983,chr2,69869904,69869983,0,65831757
IMR90|chr2:135836983-135837064,chr2,135836983,135837064,IMR90|chr2:47399863-47399932,chr2,47399863,47399932,0,88437120
IMR90|chr2:136291237-136291277,chr2,136291237,136291277,IMR90|chr2:36586589-36586690,chr2,36586589,36586690,0,99704648
IMR90|chr2:137390422-137390538,chr2,137390422,137390538,IMR90|chr2:15732460-15732494,chr2,15732460,15732494,0,121657962
IMR90|chr2:137464233-137464312,chr2,137464233,137464312,IMR90|chr2:201451519-201451586,chr2,201451519,201451586,0,63987286
IMR90|chr2:137605382-137605430,chr2,137605382,137605430,IMR90|chr2:46927167-46927191,chr2,46927167,46927191,0,90678215
IMR90|chr2:137667309-137667380,chr2,137667309,137667380,IMR90|chr2:66666918-66666940,chr2,66666918,66666940,0,71000391
IMR90|chr2:137801998-137802081,chr2,137801998,137802081,IMR90|chr2:85193944-85194057,chr2,85193944,85194057,0,52608054
IMR90|chr2:137847863-137847920,chr2,137847863,137847920,IMR90|chr2:148779633-148779720,chr2,148779633,148779720,0,10931770
IMR90|chr2:138171692-138171727,chr2,138171692,138171727,IMR90|chr2:169309798-169309887,chr2,169309798,169309887,0,31138106
IMR90|chr2:138178162-138178253,chr2,138178162,138178253,IMR90|chr2:85193944-85193982,chr2,85193944,85193982,0,52984218
IMR90|chr2:138242485-138242572,chr2,138242485,138242572,IMR90|chr2:47139976-47140033,chr2,47139976,47140033,0,91102509
IMR90|chr2:138248186-138248253,chr2,138248186,138248253,IMR90|chr2:190041156-190041236,chr2,190041156,190041236,0,51792970
IMR90|chr2:138847831-138847878,chr2,138847831,138847878,IMR90|chr2:231579013-231579116,chr2,231579013,231579116,0,92731182
IMR90|chr2:139256847-139256966,chr2,139256847,139256966,IMR90|chr2:190041054-190041089,chr2,190041054,190041089,0,50784207
IMR90|chr2:139455957-139456060,chr2,139455957,139456060,IMR90|chr2:198315923-198316073,chr2,198315923,198316073,0,58859966
IMR90|chr2:139463491-139463542,chr2,139463491,139463542,IMR90|chr2:85195636-85195735,chr2,85195636,85195735,0,54267855
IMR90|chr2:139613757-139613874,chr2,139613757,139613874,IMR90|chr2:74231016-74231036,chr2,74231016,74231036,0,65382741
IMR90|chr2:139649409-139649456,chr2,139649409,139649456,IMR90|chr2:192547939-192548038,chr2,192547939,192548038,0,52898530
IMR90|chr2:140279840-140279967,chr2,140279840,140279967,IMR90|chr2:74231016-74231036,chr2,74231016,74231036,0,66048824
IMR90|chr2:140376790-140376869,chr2,140376790,140376869,IMR90|chr2:218767138-218767176,chr2,218767138,218767176,0,78390348
IMR90|chr2:140495484-140495539,chr2,140495484,140495539,IMR90|chr2:33362856-33362945,chr2,33362856,33362945,0,107132628
IMR90|chr2:140792958-140793016,chr2,140792958,140793016,IMR90|chr2:68478758-68478781,chr2,68478758,68478781,0,72314200
IMR90|chr2:141134581-141134656,chr2,141134581,141134656,IMR90|chr2:157294030-157294105,chr2,157294030,157294105,0,16159449
IMR90|chr2:141197989-141198049,chr2,141197989,141198049,IMR90|chr2:84687750-84687800,chr2,84687750,84687800,0,56510239
IMR90|chr2:141279257-141279355,chr2,141279257,141279355,IMR90|chr2:85193640-85193697,chr2,85193640,85193697,0,56085617
IMR90|chr2:141309105-141309172,chr2,141309105,141309172,IMR90|chr2:219266714-219266783,chr2,219266714,219266783,0,77957609
IMR90|chr2:141698743-141698811,chr2,141698743,141698811,IMR90|chr2:69869828-69869875,chr2,69869828,69869875,0,71828915
IMR90|chr2:141850181-141850319,chr2,141850181,141850319,IMR90|chr2:26213000-26213022,chr2,26213000,26213022,0,115637181
IMR90|chr2:141884559-141884625,chr2,141884559,141884625,IMR90|chr2:84691003-84691031,chr2,84691003,84691031,0,57193556
IMR90|chr2:142082911-142082965,chr2,142082911,142082965,IMR90|chr2:85193395-85193491,chr2,85193395,85193491,0,56889516
IMR90|chr2:142208919-142209031,chr2,142208919,142209031,IMR90|chr2:218806753-218806788,chr2,218806753,218806788,0,76597834
IMR90|chr2:142446303-142446395,chr2,142446303,142446395,IMR90|chr2:37895882-37895936,chr2,37895882,37895936,0,104550421
IMR90|chr2:142650285-142650362,chr2,142650285,142650362,IMR90|chr2:64245367-64245404,chr2,64245367,64245404,0,78404918
IMR90|chr2:143056716-143056770,chr2,143056716,143056770,IMR90|chr2:201172642-201172680,chr2,201172642,201172680,0,58115926
IMR90|chr2:143593225-143593310,chr2,143593225,143593310,IMR90|chr2:64245721-64245791,chr2,64245721,64245791,0,79347504
IMR90|chr2:143901159-143901269,chr2,143901159,143901269,IMR90|chr2:70485992-70486046,chr2,70485992,70486046,0,73415167
IMR90|chr2:143947231-143947292,chr2,143947231,143947292,IMR90|chr2:173293321-173293369,chr2,173293321,173293369,0,29346090
IMR90|chr2:144184744-144184777,chr2,144184744,144184777,IMR90|chr2:26466923-26466974,chr2,26466923,26466974,0,117717821
IMR90|chr2:144550508-144550579,chr2,144550508,144550579,IMR90|chr2:66666918-66666940,chr2,66666918,66666940,0,77883590
IMR90|chr2:144779338-144779388,chr2,144779338,144779388,IMR90|chr2:27257518-27257618,chr2,27257518,27257618,0,117521820
IMR90|chr2:144946411-144946461,chr2,144946411,144946461,IMR90|chr2:36586536-36586617,chr2,36586536,36586617,0,108359875
IMR90|chr2:146020806-146020865,chr2,146020806,146020865,IMR90|chr2:192543583-192543650,chr2,192543583,192543650,0,46522777
IMR90|chr2:146553340-146553407,chr2,146553340,146553407,IMR90|chr2:203241437-203241520,chr2,203241437,203241520,0,56688097
IMR90|chr2:146729460-146729493,chr2,146729460,146729493,IMR90|chr2:242444561-242444656,chr2,242444561,242444656,0,95715101
IMR90|chr2:146748581-146748613,chr2,146748581,146748613,IMR90|chr2:65659576-65659644,chr2,65659576,65659644,0,81089005
IMR90|chr2:147086736-147086816,chr2,147086736,147086816,IMR90|chr2:65659417-65659486,chr2,65659417,65659486,0,81427319
IMR90|chr2:147936241-147936341,chr2,147936241,147936341,IMR90|chr2:162017917-162017958,chr2,162017917,162017958,0,14081676
IMR90|chr2:148084409-148084455,chr2,148084409,148084455,IMR90|chr2:9615848-9615918,chr2,9615848,9615918,0,138468561
IMR90|chr2:148539342-148539371,chr2,148539342,148539371,IMR90|chr2:216300208-216300316,chr2,216300208,216300316,0,67760866
IMR90|chr2:148558113-148558193,chr2,148558113,148558193,IMR90|chr2:192546930-192546969,chr2,192546930,192546969,0,43988817
IMR90|chr2:148616349-148616384,chr2,148616349,148616384,IMR90|chr2:85195580-85195624,chr2,85195580,85195624,0,63420769
IMR90|chr2:148659251-148659300,chr2,148659251,148659300,IMR90|chr2:74777010-74777065,chr2,74777010,74777065,0,73882241
IMR90|chr2:148863816-148863907,chr2,148863816,148863907,IMR90|chr2:85195578-85195672,chr2,85195578,85195672,0,63668238
IMR90|chr2:149079947-149079981,chr2,149079947,149079981,IMR90|chr2:242444561-242444656,chr2,242444561,242444656,0,93364614
IMR90|chr2:149531254-149531349,chr2,149531254,149531349,IMR90|chr2:85194317-85194362,chr2,85194317,85194362,0,64336937
IMR90|chr2:149710375-149710446,chr2,149710375,149710446,IMR90|chr2:37898440-37898476,chr2,37898440,37898476,0,111811935
IMR90|chr2:149873893-149873939,chr2,149873893,149873939,IMR90|chr2:219156470-219156620,chr2,219156470,219156620,0,69282577
IMR90|chr2:150674965-150675045,chr2,150674965,150675045,IMR90|chr2:64245721-64245791,chr2,64245721,64245791,0,86429244
IMR90|chr2:150763677-150763739,chr2,150763677,150763739,IMR90|chr2:236403672-236403712,chr2,236403672,236403712,0,85639995
IMR90|chr2:150794830-150794857,chr2,150794830,150794857,IMR90|chr2:85193944-85194005,chr2,85193944,85194005,0,65600886
IMR90|chr2:151183417-151183516,chr2,151183417,151183516,IMR90|chr2:203241438-203241520,chr2,203241438,203241520,0,52058021
IMR90|chr2:151389829-151389937,chr2,151389829,151389937,IMR90|chr2:55274729-55274771,chr2,55274729,55274771,0,96115100
IMR90|chr2:151594140-151594233,chr2,151594140,151594233,IMR90|chr2:66672180-66672234,chr2,66672180,66672234,0,84921960
IMR90|chr2:151690459-151690560,chr2,151690459,151690560,IMR90|chr2:67620175-67620224,chr2,67620175,67620224,0,84070284
IMR90|chr2:151793124-151793229,chr2,151793124,151793229,IMR90|chr2:70121400-70121457,chr2,70121400,70121457,0,81671724
IMR90|chr2:151806897-151806996,chr2,151806897,151806996,IMR90|chr2:203241438-203241520,chr2,203241438,203241520,0,51434541
IMR90|chr2:152189671-152189691,chr2,152189671,152189691,IMR90|chr2:128642983-128643069,chr2,128642983,128643069,0,23546688
IMR90|chr2:152582358-152582388,chr2,152582358,152582388,IMR90|chr2:105945430-105945499,chr2,105945430,105945499,0,46636928
IMR90|chr2:152752974-152753054,chr2,152752974,152753054,IMR90|chr2:203734353-203734405,chr2,203734353,203734405,0,50981379
IMR90|chr2:152848509-152848533,chr2,152848509,152848533,IMR90|chr2:218769260-218769343,chr2,218769260,218769343,0,65920751
IMR90|chr2:153100369-153100432,chr2,153100369,153100432,IMR90|chr2:85193944-85194004,chr2,85193944,85194004,0,67906425
IMR90|chr2:153382983-153383017,chr2,153382983,153383017,IMR90|chr2:148777079-148777225,chr2,148777079,148777225,0,4605904
IMR90|chr2:153604128-153604158,chr2,153604128,153604158,IMR90|chr2:47401329-47401364,chr2,47401329,47401364,0,106202799
IMR90|chr2:153897645-153897738,chr2,153897645,153897738,IMR90|chr2:70121400-70121457,chr2,70121400,70121457,0,83776245
IMR90|chr2:153907609-153907626,chr2,153907609,153907626,IMR90|chr2:42276470-42276578,chr2,42276470,42276578,0,111631139
IMR90|chr2:154493034-154493079,chr2,154493034,154493079,IMR90|chr2:189162193-189162223,chr2,189162193,189162223,0,34669159
IMR90|chr2:154663800-154663920,chr2,154663800,154663920,IMR90|chr2:201983145-201983170,chr2,201983145,201983170,0,47319345
IMR90|chr2:154718967-154719000,chr2,154718967,154719000,IMR90|chr2:96930792-96930909,chr2,96930792,96930909,0,57788175
IMR90|chr2:155197700-155197783,chr2,155197700,155197783,IMR90|chr2:47400774-47400831,chr2,47400774,47400831,0,107796926
IMR90|chr2:155584584-155584668,chr2,155584584,155584668,IMR90|chr2:46927167-46927191,chr2,46927167,46927191,0,108657417
IMR90|chr2:155739212-155739290,chr2,155739212,155739290,IMR90|chr2:85193933-85194005,chr2,85193933,85194005,0,70545279
IMR90|chr2:155961504-155961618,chr2,155961504,155961618,IMR90|chr2:219193014-219193034,chr2,219193014,219193034,0,63231510
IMR90|chr2:156381370-156381450,chr2,156381370,156381450,IMR90|chr2:197668622-197668687,chr2,197668622,197668687,0,41287252
IMR90|chr2:156990877-156990955,chr2,156990877,156990955,IMR90|chr2:65356523-65356584,chr2,65356523,65356584,0,91634354
IMR90|chr2:157061896-157061944,chr2,157061896,157061944,IMR90|chr2:48542494-48542595,chr2,48542494,48542595,0,108519402
IMR90|chr2:157246946-157247025,chr2,157246946,157247025,IMR90|chr2:201451519-201451586,chr2,201451519,201451586,0,44204573
IMR90|chr2:157972736-157972821,chr2,157972736,157972821,IMR90|chr2:192545221-192545253,chr2,192545221,192545253,0,34572485
IMR90|chr2:158499076-158499118,chr2,158499076,158499118,IMR90|chr2:84690368-84690428,chr2,84690368,84690428,0,73808708
IMR90|chr2:159031732-159031811,chr2,159031732,159031811,IMR90|chr2:71358457-71358519,chr2,71358457,71358519,0,87673275
IMR90|chr2:159505267-159505321,chr2,159505267,159505321,IMR90|chr2:219083852-219083914,chr2,219083852,219083914,0,59578585
IMR90|chr2:159534756-159534869,chr2,159534756,159534869,IMR90|chr2:55512578-55512608,chr2,55512578,55512608,0,104022178
IMR90|chr2:159857453-159857523,chr2,159857453,159857523,IMR90|chr2:227659525-227659602,chr2,227659525,227659602,0,67802072
IMR90|chr2:160035018-160035050,chr2,160035018,160035050,IMR90|chr2:43822657-43822774,chr2,43822657,43822774,0,116212361
IMR90|chr2:161030619-161030692,chr2,161030619,161030692,IMR90|chr2:232651695-232651771,chr2,232651695,232651771,0,71621076
IMR90|chr2:161125691-161125736,chr2,161125691,161125736,IMR90|chr2:9615871-9615919,chr2,9615871,9615919,0,151509820
IMR90|chr2:161135081-161135136,chr2,161135081,161135136,IMR90|chr2:73052647-73052742,chr2,73052647,73052742,0,88082434
IMR90|chr2:161266357-161266404,chr2,161266357,161266404,IMR90|chr2:192547939-192548038,chr2,192547939,192548038,0,31281582
IMR90|chr2:161893583-161893657,chr2,161893583,161893657,IMR90|chr2:85195689-85195764,chr2,85195689,85195764,0,76697894
IMR90|chr2:162116011-162116093,chr2,162116011,162116093,IMR90|chr2:242211534-242211552,chr2,242211534,242211552,0,80095523
IMR90|chr2:162213620-162213760,chr2,162213620,162213760,IMR90|chr2:55274729-55274771,chr2,55274729,55274771,0,106938891
IMR90|chr2:162490271-162490307,chr2,162490271,162490307,IMR90|chr2:71298938-71298995,chr2,71298938,71298995,0,91191333
IMR90|chr2:162930263-162930329,chr2,162930263,162930329,IMR90|chr2:55513000-55513134,chr2,55513000,55513134,0,107417263
IMR90|chr2:163207346-163207415,chr2,163207346,163207415,IMR90|chr2:242210100-242210146,chr2,242210100,242210146,0,79002754
IMR90|chr2:163467834-163467865,chr2,163467834,163467865,IMR90|chr2:71358142-71358261,chr2,71358142,71358261,0,92109692
IMR90|chr2:163597457-163597558,chr2,163597457,163597558,IMR90|chr2:162017917-162017958,chr2,162017917,162017958,0,1579540
IMR90|chr2:163684734-163684884,chr2,163684734,163684884,IMR90|chr2:73299750-73299779,chr2,73299750,73299779,0,90384984
IMR90|chr2:164146419-164146469,chr2,164146419,164146469,IMR90|chr2:27257518-27257618,chr2,27257518,27257618,0,136888901
IMR90|chr2:164682933-164682971,chr2,164682933,164682971,IMR90|chr2:219084023-219084119,chr2,219084023,219084119,0,54401090
IMR90|chr2:164990253-164990274,chr2,164990253,164990274,IMR90|chr2:27251981-27252089,chr2,27251981,27252089,0,137738272
IMR90|chr2:165296990-165297140,chr2,165296990,165297140,IMR90|chr2:192020014-192020101,chr2,192020014,192020101,0,26723024
IMR90|chr2:165403431-165403534,chr2,165403431,165403534,IMR90|chr2:85193297-85193327,chr2,85193297,85193327,0,80210134
IMR90|chr2:165599396-165599477,chr2,165599396,165599477,IMR90|chr2:47399863-47399932,chr2,47399863,47399932,0,118199533
IMR90|chr2:165639409-165639495,chr2,165639409,165639495,IMR90|chr2:85639845-85639891,chr2,85639845,85639891,0,79999564
IMR90|chr2:166173026-166173115,chr2,166173026,166173115,IMR90|chr2:37894806-37894853,chr2,37894806,37894853,0,128278220
IMR90|chr2:166300537-166300563,chr2,166300537,166300563,IMR90|chr2:42276494-42276540,chr2,42276494,42276540,0,124024043
IMR90|chr2:166414877-166414925,chr2,166414877,166414925,IMR90|chr2:48542494-48542595,chr2,48542494,48542595,0,117872383
IMR90|chr2:166625433-166625462,chr2,166625433,166625462,IMR90|chr2:105945430-105945499,chr2,105945430,105945499,0,60680003
IMR90|chr2:166670892-166670988,chr2,166670892,166670988,IMR90|chr2:70485992-70486046,chr2,70485992,70486046,0,96184900
IMR90|chr2:167060908-167060958,chr2,167060908,167060958,IMR90|chr2:101868475-101868557,chr2,101868475,101868557,0,65192433
IMR90|chr2:168299370-168299417,chr2,168299370,168299417,IMR90|chr2:47402043-47402128,chr2,47402043,47402128,0,120897327
IMR90|chr2:168646896-168646989,chr2,168646896,168646989,IMR90|chr2:242446514-242446571,chr2,242446514,242446571,0,73799618
IMR90|chr2:168875319-168875381,chr2,168875319,168875381,IMR90|chr2:42276496-42276540,chr2,42276496,42276540,0,126598823
IMR90|chr2:168922596-168922720,chr2,168922596,168922720,IMR90|chr2:190047031-190047081,chr2,190047031,190047081,0,21124435
IMR90|chr2:168961750-168961852,chr2,168961750,168961852,IMR90|chr2:85195642-85195695,chr2,85195642,85195695,0,83766108
IMR90|chr2:169044596-169044692,chr2,169044596,169044692,IMR90|chr2:85195530-85195584,chr2,85195530,85195584,0,83849066
IMR90|chr2:169054489-169054553,chr2,169054489,169054553,IMR90|chr2:55275291-55275354,chr2,55275291,55275354,0,113779198
IMR90|chr2:169353485-169353513,chr2,169353485,169353513,IMR90|chr2:73337978-73338045,chr2,73337978,73338045,0,96015507
IMR90|chr2:169417972-169418001,chr2,169417972,169418001,IMR90|chr2:242211243-242211340,chr2,242211243,242211340,0,72793271
IMR90|chr2:169569775-169569835,chr2,169569775,169569835,IMR90|chr2:37894781-37894852,chr2,37894781,37894852,0,131674994
IMR90|chr2:169849065-169849178,chr2,169849065,169849178,IMR90|chr2:55512578-55512608,chr2,55512578,55512608,0,114336487
IMR90|chr2:170621552-170621635,chr2,170621552,170621635,IMR90|chr2:85195636-85195735,chr2,85195636,85195735,0,85425916
IMR90|chr2:170756666-170756800,chr2,170756666,170756800,IMR90|chr2:37383559-37383613,chr2,37383559,37383613,0,133373107
IMR90|chr2:171175986-171176012,chr2,171175986,171176012,IMR90|chr2:42276494-42276540,chr2,42276494,42276540,0,128899492
IMR90|chr2:171218950-171219000,chr2,171218950,171219000,IMR90|chr2:33823666-33823732,chr2,33823666,33823732,0,137395284
IMR90|chr2:171315618-171315663,chr2,171315618,171315663,IMR90|chr2:54090720-54090790,chr2,54090720,54090790,0,117224898
IMR90|chr2:171692156-171692290,chr2,171692156,171692290,IMR90|chr2:224707000-224707055,chr2,224707000,224707055,0,53014844
IMR90|chr2:172505664-172505791,chr2,172505664,172505791,IMR90|chr2:216298901-216298924,chr2,216298901,216298924,0,43793237
IMR90|chr2:172524114-172524217,chr2,172524114,172524217,IMR90|chr2:85197640-85197663,chr2,85197640,85197663,0,87326474
IMR90|chr2:172570383-172570421,chr2,172570383,172570421,IMR90|chr2:219084023-219084119,chr2,219084023,219084119,0,46513640
IMR90|chr2:172647651-172647709,chr2,172647651,172647709,IMR90|chr2:148779633-148779720,chr2,148779633,148779720,0,23868018
IMR90|chr2:172920129-172920227,chr2,172920129,172920227,IMR90|chr2:85193640-85193697,chr2,85193640,85193697,0,87726489
IMR90|chr2:173377646-173377702,chr2,173377646,173377702,IMR90|chr2:37894595-37894618,chr2,37894595,37894618,0,135483051
IMR90|chr2:174255871-174255917,chr2,174255871,174255917,IMR90|chr2:74782165-74782260,chr2,74782165,74782260,0,99473706
IMR90|chr2:174384733-174384807,chr2,174384733,174384807,IMR90|chr2:153031560-153031590,chr2,153031560,153031590,0,21353173
IMR90|chr2:174433506-174433607,chr2,174433506,174433607,IMR90|chr2:47399892-47399932,chr2,47399892,47399932,0,127033614
IMR90|chr2:174833268-174833318,chr2,174833268,174833318,IMR90|chr2:37898344-37898436,chr2,37898344,37898436,0,136934924
IMR90|chr2:174994567-174994642,chr2,174994567,174994642,IMR90|chr2:109746699-109746774,chr2,109746699,109746774,0,65247868
IMR90|chr2:175062894-175062954,chr2,175062894,175062954,IMR90|chr2:37894781-37894852,chr2,37894781,37894852,0,137168113
IMR90|chr2:176316283-176316330,chr2,176316283,176316330,IMR90|chr2:242642112-242642220,chr2,242642112,242642220,0,66325829
IMR90|chr2:176343909-176343979,chr2,176343909,176343979,IMR90|chr2:19546935-19546974,chr2,19546935,19546974,0,156796974
IMR90|chr2:176439430-176439474,chr2,176439430,176439474,IMR90|chr2:85194057-85194147,chr2,85194057,85194147,0,91245373
IMR90|chr2:176473062-176473110,chr2,176473062,176473110,IMR90|chr2:74405670-74405739,chr2,74405670,74405739,0,102067392
IMR90|chr2:176603356-176603414,chr2,176603356,176603414,IMR90|chr2:238319732-238319798,chr2,238319732,238319798,0,61716376
IMR90|chr2:176646730-176646771,chr2,176646730,176646771,IMR90|chr2:84690368-84690428,chr2,84690368,84690428,0,91956362
IMR90|chr2:176999696-176999755,chr2,176999696,176999755,IMR90|chr2:86420526-86420654,chr2,86420526,86420654,0,90579170
IMR90|chr2:179227179-179227203,chr2,179227179,179227203,IMR90|chr2:218766245-218766337,chr2,218766245,218766337,0,39539066
IMR90|chr2:179519830-179519886,chr2,179519830,179519886,IMR90|chr2:37894595-37894618,chr2,37894595,37894618,0,141625235
IMR90|chr2:179633135-179633221,chr2,179633135,179633221,IMR90|chr2:85194668-85194732,chr2,85194668,85194732,0,94438467
IMR90|chr2:179863845-179863861,chr2,179863845,179863861,IMR90|chr2:85194671-85194794,chr2,85194671,85194794,0,94669174
IMR90|chr2:179946671-179946720,chr2,179946671,179946720,IMR90|chr2:101868475-101868557,chr2,101868475,101868557,0,78078196
IMR90|chr2:180045616-180045680,chr2,180045616,180045680,IMR90|chr2:33361531-33361597,chr2,33361531,33361597,0,146684085
IMR90|chr2:180070970-180070991,chr2,180070970,180070991,IMR90|chr2:27251981-27252089,chr2,27251981,27252089,0,152818989
IMR90|chr2:180943211-180943238,chr2,180943211,180943238,IMR90|chr2:36585525-36585645,chr2,36585525,36585645,0,144357686
IMR90|chr2:181082559-181082585,chr2,181082559,181082585,IMR90|chr2:55274153-55274249,chr2,55274153,55274249,0,125808406
IMR90|chr2:181615125-181615195,chr2,181615125,181615195,IMR90|chr2:218768045-218768120,chr2,218768045,218768120,0,37152920
IMR90|chr2:181939136-181939197,chr2,181939136,181939197,IMR90|chr2:134877594-134877626,chr2,134877594,134877626,0,47061542
IMR90|chr2:182000553-182000616,chr2,182000553,182000616,IMR90|chr2:216300208-216300316,chr2,216300208,216300316,0,34299655
IMR90|chr2:182000835-182000904,chr2,182000835,182000904,IMR90|chr2:242210100-242210146,chr2,242210100,242210146,0,60209265
IMR90|chr2:182118056-182118176,chr2,182118056,182118176,IMR90|chr2:201983145-201983170,chr2,201983145,201983170,0,19865089
IMR90|chr2:182462838-182462904,chr2,182462838,182462904,IMR90|chr2:55513000-55513134,chr2,55513000,55513134,0,126949838
IMR90|chr2:182941925-182941988,chr2,182941925,182941988,IMR90|chr2:218806753-218806788,chr2,218806753,218806788,0,35864828
IMR90|chr2:183107053-183107090,chr2,183107053,183107090,IMR90|chr2:85193944-85194057,chr2,85193944,85194057,0,97913109
IMR90|chr2:183187482-183187552,chr2,183187482,183187552,IMR90|chr2:109746699-109746777,chr2,109746699,109746777,0,73440783
IMR90|chr2:183803175-183803244,chr2,183803175,183803244,IMR90|chr2:234474775-234474820,chr2,234474775,234474820,0,50671600
IMR90|chr2:183881280-183881320,chr2,183881280,183881320,IMR90|chr2:178079342-178079452,chr2,178079342,178079452,0,5801938
IMR90|chr2:184248648-184248743,chr2,184248648,184248743,IMR90|chr2:47400765-47400789,chr2,47400765,47400789,0,136847883
IMR90|chr2:184301151-184301172,chr2,184301151,184301172,IMR90|chr2:85196761-85196843,chr2,85196761,85196843,0,99104390
IMR90|chr2:184634601-184634699,chr2,184634601,184634699,IMR90|chr2:201451519-201451571,chr2,201451519,201451571,0,16816918
IMR90|chr2:184835908-184836035,chr2,184835908,184836035,IMR90|chr2:216298901-216298924,chr2,216298901,216298924,0,31462993
IMR90|chr2:185101581-185101639,chr2,185101581,185101639,IMR90|chr2:68478758-68478781,chr2,68478758,68478781,0,116622823
IMR90|chr2:185236330-185236444,chr2,185236330,185236444,IMR90|chr2:242444044-242444120,chr2,242444044,242444120,0,57207714
IMR90|chr2:185366773-185366877,chr2,185366773,185366877,IMR90|chr2:39662486-39662531,chr2,39662486,39662531,0,145704287
IMR90|chr2:185945515-185945559,chr2,185945515,185945559,IMR90|chr2:36586611-36586694,chr2,36586611,36586694,0,149358904
IMR90|chr2:185959630-185959706,chr2,185959630,185959706,IMR90|chr2:15733243-15733317,chr2,15733243,15733317,0,170226387
IMR90|chr2:186032867-186032936,chr2,186032867,186032936,IMR90|chr2:71358142-71358261,chr2,71358142,71358261,0,114674725
IMR90|chr2:186220408-186220464,chr2,186220408,186220464,IMR90|chr2:112813985-112814079,chr2,112813985,112814079,0,73406423
IMR90|chr2:187451285-187451314,chr2,187451285,187451314,IMR90|chr2:242211243-242211340,chr2,242211243,242211340,0,54759958
IMR90|chr2:187483606-187483706,chr2,187483606,187483706,IMR90|chr2:74777010-74777065,chr2,74777010,74777065,0,112706596
IMR90|chr2:187688545-187688665,chr2,187688545,187688665,IMR90|chr2:66672180-66672234,chr2,66672180,66672234,0,121016365
IMR90|chr2:188232363-188232466,chr2,188232363,188232466,IMR90|chr2:85197640-85197663,chr2,85197640,85197663,0,103034723
IMR90|chr2:188467653-188467776,chr2,188467653,188467776,IMR90|chr2:190047031-190047081,chr2,190047031,190047081,0,1579378
IMR90|chr2:188479838-188479888,chr2,188479838,188479888,IMR90|chr2:37192690-37192729,chr2,37192690,37192729,0,151287148
IMR90|chr2:188563153-188563247,chr2,188563153,188563247,IMR90|chr2:74777010-74777066,chr2,74777010,74777066,0,113786143
IMR90|chr2:188609038-188609110,chr2,188609038,188609110,IMR90|chr2:238880103-238880138,chr2,238880103,238880138,0,50271065
IMR90|chr2:188675197-188675220,chr2,188675197,188675220,IMR90|chr2:201989439-201989521,chr2,201989439,201989521,0,13314242
IMR90|chr2:188685414-188685462,chr2,188685414,188685462,IMR90|chr2:36582962-36583064,chr2,36582962,36583064,0,152102452
IMR90|chr2:188968029-188968139,chr2,188968029,188968139,IMR90|chr2:190042371-190042453,chr2,190042371,190042453,0,1074342
IMR90|chr2:189040853-189040914,chr2,189040853,189040914,IMR90|chr2:228334364-228334443,chr2,228334364,228334443,0,39293511
IMR90|chr2:189240453-189240535,chr2,189240453,189240535,IMR90|chr2:27545005-27545073,chr2,27545005,27545073,0,161695448
IMR90|chr2:189574942-189574967,chr2,189574942,189574967,IMR90|chr2:218766245-218766337,chr2,218766245,218766337,0,29191303
IMR90|chr2:189602959-189603073,chr2,189602959,189603073,IMR90|chr2:8823775-8823810,chr2,8823775,8823810,0,180779184
IMR90|chr2:189742677-189742706,chr2,189742677,189742706,IMR90|chr2:105945430-105945499,chr2,105945430,105945499,0,83797247
IMR90|chr2:189840156-189840212,chr2,189840156,189840212,IMR90|chr2:37898288-37898396,chr2,37898288,37898396,0,151941868
IMR90|chr2:189878133-189878234,chr2,189878133,189878234,IMR90|chr2:162017917-162017958,chr2,162017917,162017958,0,27860216
IMR90|chr2:190129043-190129136,chr2,190129043,190129136,IMR90|chr2:85193933-85194005,chr2,85193933,85194005,0,104935110
IMR90|chr2:190448956-190449042,chr2,190448956,190449042,IMR90|chr2:85639845-85639891,chr2,85639845,85639891,0,104809111
IMR90|chr2:190449757-190449795,chr2,190449757,190449795,IMR90|chr2:118572530-118572636,chr2,118572530,118572636,0,71877227
IMR90|chr2:190622369-190622405,chr2,190622369,190622405,IMR90|chr2:71298938-71298995,chr2,71298938,71298995,0,119323431
IMR90|chr2:190826846-190826938,chr2,190826846,190826938,IMR90|chr2:85193944-85193968,chr2,85193944,85193968,0,105632902
IMR90|chr2:191183049-191183094,chr2,191183049,191183094,IMR90|chr2:47402043-47402128,chr2,47402043,47402128,0,143781006
IMR90|chr2:191315383-191315429,chr2,191315383,191315429,IMR90|chr2:54090720-54090790,chr2,54090720,54090790,0,137224663
IMR90|chr2:191327733-191327791,chr2,191327733,191327791,IMR90|chr2:37894781-37894852,chr2,37894781,37894852,0,153432952
IMR90|chr2:191459187-191459285,chr2,191459187,191459285,IMR90|chr2:201451519-201451571,chr2,201451519,201451571,0,9992332
IMR90|chr2:191663840-191663894,chr2,191663840,191663894,IMR90|chr2:174828255-174828303,chr2,174828255,174828303,0,16835585
IMR90|chr2:191802141-191802197,chr2,191802141,191802197,IMR90|chr2:178080044-178080129,chr2,178080044,178080129,0,13722097
IMR90|chr2:192074701-192074806,chr2,192074701,192074806,IMR90|chr2:70121400-70121457,chr2,70121400,70121457,0,121953301
IMR90|chr2:192158175-192158197,chr2,192158175,192158197,IMR90|chr2:219084303-219084395,chr2,219084303,219084395,0,26926128
IMR90|chr2:192250637-192250658,chr2,192250637,192250658,IMR90|chr2:47402593-47402682,chr2,47402593,47402682,0,144848044
IMR90|chr2:192316122-192316144,chr2,192316122,192316144,IMR90|chr2:201451422-201451544,chr2,201451422,201451544,0,9135300
IMR90|chr2:192451423-192451482,chr2,192451423,192451482,IMR90|chr2:86420526-86420654,chr2,86420526,86420654,0,106030897
IMR90|chr2:192868531-192868585,chr2,192868531,192868585,IMR90|chr2:201172642-201172680,chr2,201172642,201172680,0,8304111
IMR90|chr2:193376185-193376247,chr2,193376185,193376247,IMR90|chr2:113994707-113994817,chr2,113994707,113994817,0,79381478
IMR90|chr2:193466619-193466734,chr2,193466619,193466734,IMR90|chr2:66674189-66674224,chr2,66674189,66674224,0,126792430
IMR90|chr2:193707719-193707758,chr2,193707719,193707758,IMR90|chr2:36586589-36586690,chr2,36586589,36586690,0,157121130
IMR90|chr2:193786522-193786558,chr2,193786522,193786558,IMR90|chr2:219154109-219154208,chr2,219154109,219154208,0,25367587
IMR90|chr2:194001221-194001273,chr2,194001221,194001273,IMR90|chr2:33823666-33823732,chr2,33823666,33823732,0,160177555
IMR90|chr2:194359568-194359657,chr2,194359568,194359657,IMR90|chr2:236403982-236404020,chr2,236403982,236404020,0,42044414
IMR90|chr2:194376456-194376558,chr2,194376456,194376558,IMR90|chr2:39662486-39662531,chr2,39662486,39662531,0,154713970
IMR90|chr2:194676130-194676198,chr2,194676130,194676198,IMR90|chr2:69869904-69869983,chr2,69869904,69869983,0,124806226
IMR90|chr2:194750197-194750249,chr2,194750197,194750249,IMR90|chr2:190539728-190539789,chr2,190539728,190539789,0,4210469
IMR90|chr2:194753840-194753874,chr2,194753840,194753874,IMR90|chr2:37894517-37894559,chr2,37894517,37894559,0,156859323
IMR90|chr2:194949317-194949362,chr2,194949317,194949362,IMR90|chr2:54090720-54090790,chr2,54090720,54090790,0,140858597
IMR90|chr2:195443140-195443224,chr2,195443140,195443224,IMR90|chr2:55276344-55276375,chr2,55276344,55276375,0,140166796
IMR90|chr2:195668379-195668419,chr2,195668379,195668419,IMR90|chr2:178079342-178079452,chr2,178079342,178079452,0,17589037
IMR90|chr2:195752002-195752027,chr2,195752002,195752027,IMR90|chr2:201989439-201989521,chr2,201989439,201989521,0,6237437
IMR90|chr2:195764542-195764561,chr2,195764542,195764561,IMR90|chr2:74603693-74603771,chr2,74603693,74603771,0,121160849
IMR90|chr2:196235760-196235841,chr2,196235760,196235841,IMR90|chr2:64245740-64245791,chr2,64245740,64245791,0,131990020
IMR90|chr2:196464597-196464674,chr2,196464597,196464674,IMR90|chr2:64245367-64245404,chr2,64245367,64245404,0,132219230
IMR90|chr2:196807257-196807285,chr2,196807257,196807285,IMR90|chr2:47400739-47400758,chr2,47400739,47400758,0,149406518
IMR90|chr2:197286326-197286358,chr2,197286326,197286358,IMR90|chr2:65659576-65659644,chr2,65659576,65659644,0,131626750
IMR90|chr2:197924212-197924254,chr2,197924212,197924254,IMR90|chr2:242642112-242642220,chr2,242642112,242642220,0,44717900
IMR90|chr2:198621087-198621201,chr2,198621087,198621201,IMR90|chr2:85195826-85195976,chr2,85195826,85195976,0,113425261
IMR90|chr2:198889818-198889869,chr2,198889818,198889869,IMR90|chr2:70422531-70422594,chr2,70422531,70422594,0,128467287
IMR90|chr2:199323038-199323110,chr2,199323038,199323110,IMR90|chr2:238537243-238537271,chr2,238537243,238537271,0,39214205
IMR90|chr2:199873907-199873940,chr2,199873907,199873940,IMR90|chr2:242642493-242642529,chr2,242642493,242642529,0,42768586
IMR90|chr2:199884641-199884698,chr2,199884641,199884698,IMR90|chr2:231579012-231579105,chr2,231579012,231579105,0,31694371
IMR90|chr2:200120221-200120335,chr2,200120221,200120335,IMR90|chr2:242444044-242444120,chr2,242444044,242444120,0,42323823
IMR90|chr2:200196424-200196517,chr2,200196424,200196517,IMR90|chr2:151340083-151340133,chr2,151340083,151340133,0,48856341
IMR90|chr2:200280557-200280628,chr2,200280557,200280628,IMR90|chr2:24715112-24715160,chr2,24715112,24715160,0,175565445
IMR90|chr2:200799273-200799338,chr2,200799273,200799338,IMR90|chr2:33822954-33823026,chr2,33822954,33823026,0,166976319
IMR90|chr2:200801170-200801216,chr2,200801170,200801216,IMR90|chr2:74405670-74405739,chr2,74405670,74405739,0,126395500
IMR90|chr2:200810733-200810762,chr2,200810733,200810762,IMR90|chr2:47141963-47142064,chr2,47141963,47142064,0,153668770
IMR90|chr2:200902012-200902124,chr2,200902012,200902124,IMR90|chr2:242446514-242446571,chr2,242446514,242446571,0,41544502
IMR90|chr2:201431904-201431943,chr2,201431904,201431943,IMR90|chr2:36586589-36586690,chr2,36586589,36586690,0,164845315
IMR90|chr2:201738398-201738457,chr2,201738398,201738457,IMR90|chr2:85194201-85194261,chr2,85194201,85194261,0,116544197
IMR90|chr2:201863196-201863252,chr2,201863196,201863252,IMR90|chr2:112813985-112814079,chr2,112813985,112814079,0,89049211
IMR90|chr2:201902904-201902954,chr2,201902904,201902954,IMR90|chr2:183580326-183580384,chr2,183580326,183580384,0,18322578
IMR90|chr2:202024690-202024840,chr2,202024690,202024840,IMR90|chr2:192020014-192020101,chr2,192020014,192020101,0,10004676
IMR90|chr2:202453377-202453457,chr2,202453377,202453457,IMR90|chr2:203734353-203734405,chr2,203734353,203734405,0,1280976
IMR90|chr2:203227377-203227405,chr2,203227377,203227405,IMR90|chr2:74230260-74230330,chr2,74230260,74230330,0,128997117
IMR90|chr2:203339528-203339642,chr2,203339528,203339642,IMR90|chr2:85195826-85195976,chr2,85195826,85195976,0,118143702
IMR90|chr2:204175820-204175880,chr2,204175820,204175880,IMR90|chr2:192019322-192019412,chr2,192019322,192019412,0,12156498
IMR90|chr2:205929901-205929917,chr2,205929901,205929917,IMR90|chr2:85194671-85194794,chr2,85194671,85194794,0,120735230
IMR90|chr2:205938230-205938326,chr2,205938230,205938326,IMR90|chr2:37383559-37383613,chr2,37383559,37383613,0,168554671
IMR90|chr2:206314068-206314157,chr2,206314068,206314157,IMR90|chr2:85194342-85194403,chr2,85194342,85194403,0,121119726
IMR90|chr2:206825415-206825488,chr2,206825415,206825488,IMR90|chr2:67620179-67620224,chr2,67620179,67620224,0,139205236
IMR90|chr2:206984951-206985073,chr2,206984951,206985073,IMR90|chr2:63820229-63820257,chr2,63820229,63820257,0,143164722
IMR90|chr2:207062664-207062759,chr2,207062664,207062759,IMR90|chr2:201984547-201984660,chr2,201984547,201984660,0,5078117
IMR90|chr2:207314032-207314083,chr2,207314032,207314083,IMR90|chr2:192020028-192020104,chr2,192020028,192020104,0,15294004
IMR90|chr2:208186126-208186190,chr2,208186126,208186190,IMR90|chr2:47400223-47400257,chr2,47400223,47400257,0,160785903
IMR90|chr2:208339626-208339689,chr2,208339626,208339689,IMR90|chr2:242446008-242446106,chr2,242446008,242446106,0,34106382
IMR90|chr2:209238810-209238911,chr2,209238810,209238911,IMR90|chr2:74777010-74777066,chr2,74777010,74777066,0,134461800
IMR90|chr2:209249087-209249176,chr2,209249087,209249176,IMR90|chr2:242640566-242640612,chr2,242640566,242640612,0,33391479
IMR90|chr2:209455993-209456071,chr2,209455993,209456071,IMR90|chr2:192019322-192019412,chr2,192019322,192019412,0,17436671
IMR90|chr2:209552905-209552995,chr2,209552905,209552995,IMR90|chr2:67620174-67620224,chr2,67620174,67620224,0,141932731
IMR90|chr2:209690124-209690189,chr2,209690124,209690189,IMR90|chr2:47401938-47401977,chr2,47401938,47401977,0,162288186
IMR90|chr2:209711395-209711437,chr2,209711395,209711437,IMR90|chr2:27580352-27580460,chr2,27580352,27580460,0,182131043
IMR90|chr2:209725701-209725799,chr2,209725701,209725799,IMR90|chr2:37894502-37894541,chr2,37894502,37894541,0,171831199
IMR90|chr2:209782171-209782192,chr2,209782171,209782192,IMR90|chr2:47402593-47402682,chr2,47402593,47402682,0,162379578
IMR90|chr2:209884994-209885060,chr2,209884994,209885060,IMR90|chr2:106013771-106013857,chr2,106013771,106013857,0,103871223
IMR90|chr2:210127569-210127626,chr2,210127569,210127626,IMR90|chr2:85193944-85193998,chr2,85193944,85193998,0,124933625
IMR90|chr2:210531658-210531735,chr2,210531658,210531735,IMR90|chr2:208577289-208577344,chr2,208577289,208577344,0,1954369
IMR90|chr2:210980630-210980690,chr2,210980630,210980690,IMR90|chr2:84687750-84687800,chr2,84687750,84687800,0,126292880
IMR90|chr2:211273782-211273864,chr2,211273782,211273864,IMR90|chr2:242210704-242210725,chr2,242210704,242210725,0,30936922
IMR90|chr2:211451301-211451401,chr2,211451301,211451401,IMR90|chr2:74777010-74777065,chr2,74777010,74777065,0,136674291
IMR90|chr2:212152444-212152558,chr2,212152444,212152558,IMR90|chr2:219193014-219193034,chr2,219193014,219193034,0,7040570
IMR90|chr2:212430955-212430989,chr2,212430955,212430989,IMR90|chr2:3627267-3627322,chr2,3627267,3627322,0,208803688
IMR90|chr2:212941268-212941320,chr2,212941268,212941320,IMR90|chr2:242445945-242446095,chr2,242445945,242446095,0,29504677
IMR90|chr2:212943876-212943947,chr2,212943876,212943947,IMR90|chr2:238537243-238537271,chr2,238537243,238537271,0,25593367
IMR90|chr2:212986176-212986209,chr2,212986176,212986209,IMR90|chr2:43822657-43822774,chr2,43822657,43822774,0,169163519
IMR90|chr2:213148448-213148538,chr2,213148448,213148538,IMR90|chr2:27251841-27251882,chr2,27251841,27251882,0,185896607
IMR90|chr2:213296450-213296532,chr2,213296450,213296532,IMR90|chr2:192545221-192545253,chr2,192545221,192545253,0,20751229
IMR90|chr2:213376196-213376249,chr2,213376196,213376249,IMR90|chr2:64071740-64071819,chr2,64071740,64071819,0,149304456
IMR90|chr2:214113701-214113730,chr2,214113701,214113730,IMR90|chr2:102091302-102091390,chr2,102091302,102091390,0,112022399
IMR90|chr2:214137425-214137484,chr2,214137425,214137484,IMR90|chr2:85194201-85194261,chr2,85194201,85194261,0,128943224
IMR90|chr2:214154189-214154231,chr2,214154189,214154231,IMR90|chr2:27580352-27580460,chr2,27580352,27580460,0,186573837
IMR90|chr2:214201886-214201954,chr2,214201886,214201954,IMR90|chr2:201982448-201982495,chr2,201982448,201982495,0,12219438
IMR90|chr2:214727023-214727073,chr2,214727023,214727073,IMR90|chr2:183580326-183580384,chr2,183580326,183580384,0,31146697
IMR90|chr2:214881496-214881599,chr2,214881496,214881599,IMR90|chr2:85193297-85193327,chr2,85193297,85193327,0,129688199
IMR90|chr2:215597400-215597549,chr2,215597400,215597549,IMR90|chr2:85194342-85194403,chr2,85194342,85194403,0,130403058
IMR90|chr2:215626909-215626993,chr2,215626909,215626993,IMR90|chr2:55276344-55276375,chr2,55276344,55276375,0,160350565
IMR90|chr2:215907528-215907554,chr2,215907528,215907554,IMR90|chr2:85195073-85195115,chr2,85195073,85195115,0,130712455
IMR90|chr2:216114890-216114923,chr2,216114890,216114923,IMR90|chr2:65659540-65659643,chr2,65659540,65659643,0,150455350
IMR90|chr2:216419820-216419934,chr2,216419820,216419934,IMR90|chr2:218806753-218806788,chr2,218806753,218806788,0,2386933
IMR90|chr2:216563855-216563926,chr2,216563855,216563926,IMR90|chr2:24715112-24715160,chr2,24715112,24715160,0,191848743
IMR90|chr2:216769650-216769677,chr2,216769650,216769677,IMR90|chr2:85193193-85193285,chr2,85193193,85193285,0,131576457
IMR90|chr2:216927585-216927618,chr2,216927585,216927618,IMR90|chr2:65659540-65659643,chr2,65659540,65659643,0,151268045
IMR90|chr2:217023461-217023576,chr2,217023461,217023576,IMR90|chr2:170222336-170222371,chr2,170222336,170222371,0,46801125
IMR90|chr2:217427892-217428007,chr2,217427892,217428007,IMR90|chr2:151340083-151340133,chr2,151340083,151340133,0,66087809
IMR90|chr2:218625200-218625253,chr2,218625200,218625253,IMR90|chr2:203734353-203734405,chr2,203734353,203734405,0,14890847
IMR90|chr2:218712671-218712712,chr2,218712671,218712712,IMR90|chr2:190539728-190539789,chr2,190539728,190539789,0,28172943
IMR90|chr2:218821100-218821240,chr2,218821100,218821240,IMR90|chr2:55274729-55274771,chr2,55274729,55274771,0,163546371
IMR90|chr2:219183601-219183685,chr2,219183601,219183685,IMR90|chr2:46927167-46927191,chr2,46927167,46927191,0,172256434
IMR90|chr2:219496809-219496924,chr2,219496809,219496924,IMR90|chr2:170222336-170222371,chr2,170222336,170222371,0,49274473
IMR90|chr2:219993430-219993516,chr2,219993430,219993516,IMR90|chr2:46927167-46927191,chr2,46927167,46927191,0,173066263
IMR90|chr2:220215082-220215133,chr2,220215082,220215133,IMR90|chr2:192020028-192020104,chr2,192020028,192020104,0,28195054
IMR90|chr2:220420175-220420257,chr2,220420175,220420257,IMR90|chr2:102315169-102315237,chr2,102315169,102315237,0,118105006
IMR90|chr2:220535648-220535742,chr2,220535648,220535742,IMR90|chr2:74777010-74777066,chr2,74777010,74777066,0,145758638
IMR90|chr2:220631587-220631672,chr2,220631587,220631672,IMR90|chr2:33822849-33822879,chr2,33822849,33822879,0,186808738
IMR90|chr2:220639119-220639203,chr2,220639119,220639203,IMR90|chr2:85197658-85197701,chr2,85197658,85197701,0,135441461
IMR90|chr2:221372526-221372565,chr2,221372526,221372565,IMR90|chr2:106012711-106012818,chr2,106012711,106012818,0,115359815
IMR90|chr2:221912523-221912619,chr2,221912523,221912619,IMR90|chr2:192544209-192544263,chr2,192544209,192544263,0,29368314
IMR90|chr2:222112415-222112477,chr2,222112415,222112477,IMR90|chr2:173293316-173293369,chr2,173293316,173293369,0,48819099
IMR90|chr2:223045589-223045689,chr2,223045589,223045689,IMR90|chr2:85194328-85194360,chr2,85194328,85194360,0,137851261
IMR90|chr2:223198387-223198488,chr2,223198387,223198488,IMR90|chr2:15732460-15732494,chr2,15732460,15732494,0,207465927
IMR90|chr2:223352705-223352790,chr2,223352705,223352790,IMR90|chr2:85639845-85639892,chr2,85639845,85639892,0,137712860
IMR90|chr2:223497036-223497125,chr2,223497036,223497125,IMR90|chr2:236403982-236404020,chr2,236403982,236404020,0,12906946
IMR90|chr2:223506841-223506897,chr2,223506841,223506897,IMR90|chr2:131095684-131095751,chr2,131095684,131095751,0,92411157
IMR90|chr2:223886122-223886157,chr2,223886122,223886157,IMR90|chr2:169309798-169309887,chr2,169309798,169309887,0,54576324
IMR90|chr2:223969133-223969205,chr2,223969133,223969205,IMR90|chr2:238880103-238880138,chr2,238880103,238880138,0,14910970
IMR90|chr2:224292344-224292454,chr2,224292344,224292454,IMR90|chr2:68478758-68478781,chr2,68478758,68478781,0,155813586
IMR90|chr2:224797387-224797448,chr2,224797387,224797448,IMR90|chr2:55273514-55273602,chr2,55273514,55273602,0,169523873
IMR90|chr2:224921773-224921877,chr2,224921773,224921877,IMR90|chr2:160472082-160472128,chr2,160472082,160472128,0,64449691
IMR90|chr2:225029758-225029820,chr2,225029758,225029820,IMR90|chr2:173293316-173293369,chr2,173293316,173293369,0,51736442
IMR90|chr2:225175879-225175955,chr2,225175879,225175955,IMR90|chr2:189162191-189162222,chr2,189162191,189162222,0,36013688
IMR90|chr2:225726175-225726217,chr2,225726175,225726217,IMR90|chr2:47402402-47402477,chr2,47402402,47402477,0,178323773
IMR90|chr2:225881470-225881541,chr2,225881470,225881541,IMR90|chr2:216174161-216174224,chr2,216174161,216174224,0,9707309
IMR90|chr2:226338856-226338913,chr2,226338856,226338913,IMR90|chr2:85193944-85193998,chr2,85193944,85193998,0,141144912
IMR90|chr2:226446184-226446266,chr2,226446184,226446266,IMR90|chr2:242211534-242211552,chr2,242211534,242211552,0,15765350
IMR90|chr2:226741548-226741652,chr2,226741548,226741652,IMR90|chr2:65356082-65356115,chr2,65356082,65356115,0,161385466
IMR90|chr2:226989770-226989812,chr2,226989770,226989812,IMR90|chr2:242642112-242642220,chr2,242642112,242642220,0,15652342
IMR90|chr2:227012191-227012245,chr2,227012191,227012245,IMR90|chr2:219083852-219083914,chr2,219083852,219083914,0,7928339
IMR90|chr2:227123192-227123237,chr2,227123192,227123237,IMR90|chr2:33361796-33361836,chr2,33361796,33361836,0,193761396
IMR90|chr2:227241182-227241204,chr2,227241182,227241204,IMR90|chr2:36585525-36585645,chr2,36585525,36585645,0,190655657
IMR90|chr2:227247953-227248033,chr2,227247953,227248033,IMR90|chr2:218767138-218767176,chr2,218767138,218767176,0,8480815
IMR90|chr2:227448797-227448836,chr2,227448797,227448836,IMR90|chr2:219084023-219084119,chr2,219084023,219084119,0,8364774
IMR90|chr2:228006009-228006067,chr2,228006009,228006067,IMR90|chr2:148779633-148779720,chr2,148779633,148779720,0,79226376
IMR90|chr2:228006682-228006767,chr2,228006682,228006767,IMR90|chr2:64245721-64245791,chr2,64245721,64245791,0,163760961
IMR90|chr2:228277165-228277224,chr2,228277165,228277224,IMR90|chr2:84687750-84687800,chr2,84687750,84687800,0,143589415
IMR90|chr2:228699915-228699992,chr2,228699915,228699992,IMR90|chr2:238876309-238876382,chr2,238876309,238876382,0,10176394
IMR90|chr2:228753872-228753934,chr2,228753872,228753934,IMR90|chr2:55273514-55273602,chr2,55273514,55273602,0,173480358
IMR90|chr2:228870482-228870532,chr2,228870482,228870532,IMR90|chr2:101868475-101868557,chr2,101868475,101868557,0,127002007
IMR90|chr2:228887210-228887271,chr2,228887210,228887271,IMR90|chr2:173293321-173293369,chr2,173293321,173293369,0,55593889
IMR90|chr2:229004527-229004677,chr2,229004527,229004677,IMR90|chr2:102758193-102758229,chr2,102758193,102758229,0,126246334
IMR90|chr2:229376191-229376273,chr2,229376191,229376273,IMR90|chr2:36584871-36584887,chr2,36584871,36584887,0,192791320
IMR90|chr2:229650167-229650195,chr2,229650167,229650195,IMR90|chr2:61698247-61698286,chr2,61698247,61698286,0,167951920
IMR90|chr2:230546345-230546441,chr2,230546345,230546441,IMR90|chr2:37383559-37383613,chr2,37383559,37383613,0,193162786
IMR90|chr2:231033102-231033152,chr2,231033102,231033152,IMR90|chr2:33823666-33823732,chr2,33823666,33823732,0,197209436
IMR90|chr2:231072064-231072157,chr2,231072064,231072157,IMR90|chr2:66672180-66672234,chr2,66672180,66672234,0,164399884
IMR90|chr2:232025599-232025707,chr2,232025599,232025707,IMR90|chr2:55274729-55274771,chr2,55274729,55274771,0,176750870
IMR90|chr2:232048559-232048576,chr2,232048559,232048576,IMR90|chr2:42276470-42276578,chr2,42276470,42276578,0,189772089
IMR90|chr2:232218259-232218363,chr2,232218259,232218363,IMR90|chr2:192544209-192544263,chr2,192544209,192544263,0,39674050
IMR90|chr2:232326804-232326918,chr2,232326804,232326918,IMR90|chr2:190041054-190041089,chr2,190041054,190041089,0,42285750
IMR90|chr2:232465168-232465228,chr2,232465168,232465228,IMR90|chr2:134877594-134877626,chr2,134877594,134877626,0,97587574
IMR90|chr2:232690817-232690887,chr2,232690817,232690887,IMR90|chr2:75786722-75786802,chr2,75786722,75786802,0,156904095
IMR90|chr2:232728565-232728630,chr2,232728565,232728630,IMR90|chr2:67620174-67620224,chr2,67620174,67620224,0,165108391
IMR90|chr2:232910666-232910718,chr2,232910666,232910718,IMR90|chr2:192020027-192020104,chr2,192020027,192020104,0,40890639
IMR90|chr2:232913798-232913855,chr2,232913798,232913855,IMR90|chr2:63821124-63821167,chr2,63821124,63821167,0,169092674
IMR90|chr2:232938309-232938374,chr2,232938309,232938374,IMR90|chr2:227666226-227666246,chr2,227666226,227666246,0,5272083
IMR90|chr2:233401733-233401776,chr2,233401733,233401776,IMR90|chr2:151337708-151337779,chr2,151337708,151337779,0,82064025
IMR90|chr2:233905362-233905416,chr2,233905362,233905416,IMR90|chr2:85193395-85193491,chr2,85193395,85193491,0,148711967
IMR90|chr2:234067278-234067348,chr2,234067278,234067348,IMR90|chr2:66666918-66666940,chr2,66666918,66666940,0,167400360
IMR90|chr2:234471403-234471475,chr2,234471403,234471475,IMR90|chr2:74227345-74227397,chr2,74227345,74227397,0,160244058
IMR90|chr2:234520023-234520059,chr2,234520023,234520059,IMR90|chr2:219154109-219154208,chr2,219154109,219154208,0,15365914
IMR90|chr2:234910102-234910130,chr2,234910102,234910130,IMR90|chr2:73337978-73338045,chr2,73337978,73338045,0,161572124
IMR90|chr2:235033050-235033114,chr2,235033050,235033114,IMR90|chr2:106013771-106013857,chr2,106013771,106013857,0,129019279
IMR90|chr2:235263573-235263648,chr2,235263573,235263648,IMR90|chr2:19546935-19546974,chr2,19546935,19546974,0,215716638
IMR90|chr2:235337652-235337772,chr2,235337652,235337772,IMR90|chr2:73299750-73299779,chr2,73299750,73299779,0,162037902
IMR90|chr2:235551260-235551353,chr2,235551260,235551353,IMR90|chr2:85193297-85193327,chr2,85193297,85193327,0,150357963
IMR90|chr2:236050308-236050387,chr2,236050308,236050387,IMR90|chr2:65356523-65356584,chr2,65356523,65356584,0,170693785
IMR90|chr2:236063254-236063337,chr2,236063254,236063337,IMR90|chr2:55273607-55273659,chr2,55273607,55273659,0,180789647
IMR90|chr2:236567151-236567255,chr2,236567151,236567255,IMR90|chr2:242640566-242640612,chr2,242640566,242640612,0,6073415
IMR90|chr2:236833915-236834017,chr2,236833915,236834017,IMR90|chr2:27545005-27545073,chr2,27545005,27545073,0,209288910
IMR90|chr2:236920037-236920112,chr2,236920037,236920112,IMR90|chr2:37898425-37898477,chr2,37898425,37898477,0,199021612
IMR90|chr2:237418263-237418386,chr2,237418263,237418386,IMR90|chr2:190047031-190047081,chr2,190047031,190047081,0,47371232
IMR90|chr2:237645153-237645234,chr2,237645153,237645234,IMR90|chr2:64245740-64245791,chr2,64245740,64245791,0,173399413
IMR90|chr2:239846854-239846889,chr2,239846854,239846889,IMR90|chr2:67620110-67620224,chr2,67620110,67620224,0,172226744
IMR90|chr2:240072597-240072653,chr2,240072597,240072653,IMR90|chr2:131095684-131095751,chr2,131095684,131095751,0,108976913
IMR90|chr2:240160108-240160158,chr2,240160108,240160158,IMR90|chr2:36586536-36586617,chr2,36586536,36586617,0,203573572
IMR90|chr2:240442894-240442983,chr2,240442894,240442983,IMR90|chr2:203734353-203734409,chr2,203734353,203734409,0,36708541
IMR90|chr2:240456089-240456144,chr2,240456089,240456144,IMR90|chr2:85130191-85130286,chr2,85130191,85130286,0,155325898
IMR90|chr2:241345640-241345677,chr2,241345640,241345677,IMR90|chr2:85193944-85194057,chr2,85193944,85194057,0,156151696
IMR90|chr2:241577493-241577596,chr2,241577493,241577596,IMR90|chr2:198315923-198316073,chr2,198315923,198316073,0,43261570
IMR90|chr2:241677956-241678042,chr2,241677956,241678042,IMR90|chr2:169311582-169311600,chr2,169311582,169311600,0,72366374
IMR90|chr2:242196584-242196675,chr2,242196584,242196675,IMR90|chr2:102315169-102315237,chr2,102315169,102315237,0,139881415
IMR90|chr2:242446915-242446964,chr2,242446915,242446964,IMR90|chr2:37898344-37898436,chr2,37898344,37898436,0,204548571
IMR90|chr2:242515960-242516049,chr2,242515960,242516049,IMR90|chr2:106012209-106012270,chr2,106012209,106012270,0,136503751
IMR90|chr2:242527459-242527524,chr2,242527459,242527524,IMR90|chr2:33822954-33823026,chr2,33822954,33823026,0,208704505
IMR90|chr2:242609624-242609774,chr2,242609624,242609774,IMR90|chr2:39662486-39662531,chr2,39662486,39662531,0,202947138
IMR90|chr2:242992192-242992250,chr2,242992192,242992250,IMR90|chr2:238319732-238319798,chr2,238319732,238319798,0,4672460
IMR90|chr2:243170216-243170298,chr2,243170216,243170298,IMR90|chr2:36584871-36584887,chr2,36584871,36584887,0,206585345
IMR90|chr3:565185-565288,chr3,565185,565288,IMR90|chr3:120166693-120166799,chr3,120166693,120166799,0,119601508
IMR90|chr3:1986232-1986288,chr3,1986232,1986288,IMR90|chr3:185653772-185653823,chr3,185653772,185653823,0,183667540
IMR90|chr3:2244848-2244904,chr3,2244848,2244904,IMR90|chr3:150132709-150132782,chr3,150132709,150132782,0,147887861
IMR90|chr3:2627737-2627887,chr3,2627737,2627887,IMR90|chr3:38175002-38175030,chr3,38175002,38175030,0,35547265
IMR90|chr3:2794872-2794918,chr3,2794872,2794918,IMR90|chr3:180630825-180630874,chr3,180630825,180630874,0,177835953
IMR90|chr3:3967552-3967604,chr3,3967552,3967604,IMR90|chr3:57995891-57995991,chr3,57995891,57995991,0,54028339
IMR90|chr3:4092554-4092661,chr3,4092554,4092661,IMR90|chr3:120170534-120170579,chr3,120170534,120170579,0,116077980
IMR90|chr3:4391890-4391981,chr3,4391890,4391981,IMR90|chr3:52439622-52439681,chr3,52439622,52439681,0,48047732
IMR90|chr3:4872585-4872712,chr3,4872585,4872712,IMR90|chr3:38176772-38176790,chr3,38176772,38176790,0,33304187
IMR90|chr3:5273550-5273670,chr3,5273550,5273670,IMR90|chr3:55520410-55520454,chr3,55520410,55520454,0,50246860
IMR90|chr3:5278898-5278963,chr3,5278898,5278963,IMR90|chr3:151987721-151987787,chr3,151987721,151987787,0,146708823
IMR90|chr3:5605350-5605386,chr3,5605350,5605386,IMR90|chr3:37219605-37219753,chr3,37219605,37219753,0,31614255
IMR90|chr3:5980516-5980559,chr3,5980516,5980559,IMR90|chr3:128906788-128906846,chr3,128906788,128906846,0,122926272
IMR90|chr3:6106605-6106694,chr3,6106605,6106694,IMR90|chr3:51574789-51574913,chr3,51574789,51574913,0,45468184
IMR90|chr3:6263506-6263626,chr3,6263506,6263626,IMR90|chr3:49974750-49974817,chr3,49974750,49974817,0,43711244
IMR90|chr3:6444133-6444183,chr3,6444133,6444183,IMR90|chr3:38174529-38174619,chr3,38174529,38174619,0,31730396
IMR90|chr3:7019941-7020068,chr3,7019941,7020068,IMR90|chr3:38176772-38176790,chr3,38176772,38176790,0,31156831
IMR90|chr3:7867835-7867905,chr3,7867835,7867905,IMR90|chr3:196013388-196013427,chr3,196013388,196013427,0,188145553
IMR90|chr3:7918051-7918087,chr3,7918051,7918087,IMR90|chr3:99981740-99981804,chr3,99981740,99981804,0,92063689
IMR90|chr3:8684590-8684694,chr3,8684590,8684694,IMR90|chr3:50284087-50284146,chr3,50284087,50284146,0,41599497
IMR90|chr3:8879664-8879812,chr3,8879664,8879812,IMR90|chr3:156270271-156270313,chr3,156270271,156270313,0,147390607
IMR90|chr3:9004266-9004354,chr3,9004266,9004354,IMR90|chr3:128885943-128886005,chr3,128885943,128886005,0,119881677
IMR90|chr3:9157128-9157174,chr3,9157128,9157174,IMR90|chr3:180630825-180630874,chr3,180630825,180630874,0,171473697
IMR90|chr3:9317643-9317703,chr3,9317643,9317703,IMR90|chr3:44803609-44803699,chr3,44803609,44803699,0,35485966
IMR90|chr3:9528231-9528314,chr3,9528231,9528314,IMR90|chr3:49974750-49974817,chr3,49974750,49974817,0,40446519
IMR90|chr3:9698284-9698386,chr3,9698284,9698386,IMR90|chr3:150263714-150263746,chr3,150263714,150263746,0,140565430
IMR90|chr3:9938060-9938079,chr3,9938060,9938079,IMR90|chr3:139107206-139107258,chr3,139107206,139107258,0,129169146
IMR90|chr3:9975771-9975860,chr3,9975771,9975860,IMR90|chr3:50276512-50276573,chr3,50276512,50276573,0,40300741
IMR90|chr3:10136030-10136123,chr3,10136030,10136123,IMR90|chr3:157251197-157251225,chr3,157251197,157251225,0,147115167
IMR90|chr3:10542069-10542133,chr3,10542069,10542133,IMR90|chr3:15901802-15901838,chr3,15901802,15901838,0,5359733
IMR90|chr3:10631082-10631138,chr3,10631082,10631138,IMR90|chr3:149687754-149687811,chr3,149687754,149687811,0,139056672
IMR90|chr3:11443715-11443833,chr3,11443715,11443833,IMR90|chr3:50373516-50373549,chr3,50373516,50373549,0,38929801
IMR90|chr3:11450202-11450276,chr3,11450202,11450276,IMR90|chr3:50276208-50276284,chr3,50276208,50276284,0,38826006
IMR90|chr3:12322981-12323099,chr3,12322981,12323099,IMR90|chr3:50373516-50373549,chr3,50373516,50373549,0,38050535
IMR90|chr3:12517140-12517181,chr3,12517140,12517181,IMR90|chr3:141102642-141102705,chr3,141102642,141102705,0,128585502
IMR90|chr3:12804793-12804901,chr3,12804793,12804901,IMR90|chr3:156270271-156270313,chr3,156270271,156270313,0,143465478
IMR90|chr3:12821667-12821719,chr3,12821667,12821719,IMR90|chr3:98618165-98618277,chr3,98618165,98618277,0,85796498
IMR90|chr3:12988034-12988118,chr3,12988034,12988118,IMR90|chr3:9432286-9432345,chr3,9432286,9432345,0,3555748
IMR90|chr3:13073769-13073828,chr3,13073769,13073828,IMR90|chr3:185653718-185653807,chr3,185653718,185653807,0,172579949
IMR90|chr3:13669605-13669639,chr3,13669605,13669639,IMR90|chr3:128883602-128883706,chr3,128883602,128883706,0,115213997
IMR90|chr3:14157227-14157283,chr3,14157227,14157283,IMR90|chr3:149687754-149687811,chr3,149687754,149687811,0,135530527
IMR90|chr3:14613097-14613127,chr3,14613097,14613127,IMR90|chr3:48635844-48635929,chr3,48635844,48635929,0,34022747
IMR90|chr3:14855826-14855869,chr3,14855826,14855869,IMR90|chr3:123601986-123602136,chr3,123601986,123602136,0,108746160
IMR90|chr3:15345946-15346053,chr3,15345946,15346053,IMR90|chr3:128903265-128903315,chr3,128903265,128903315,0,113557319
IMR90|chr3:15430923-15430998,chr3,15430923,15430998,IMR90|chr3:64209975-64210009,chr3,64209975,64210009,0,48779052
IMR90|chr3:15607871-15607892,chr3,15607871,15607892,IMR90|chr3:99982366-99982437,chr3,99982366,99982437,0,84374495
IMR90|chr3:15880716-15880773,chr3,15880716,15880773,IMR90|chr3:12709615-12709692,chr3,12709615,12709692,0,3171101
IMR90|chr3:16036366-16036403,chr3,16036366,16036403,IMR90|chr3:185653840-185653920,chr3,185653840,185653920,0,169617474
IMR90|chr3:16334502-16334596,chr3,16334502,16334596,IMR90|chr3:27523973-27524082,chr3,27523973,27524082,0,11189471
IMR90|chr3:16428317-16428358,chr3,16428317,16428358,IMR90|chr3:141102642-141102705,chr3,141102642,141102705,0,124674325
IMR90|chr3:16701723-16701765,chr3,16701723,16701765,IMR90|chr3:156270010-156270080,chr3,156270010,156270080,0,139568287
IMR90|chr3:16805947-16806060,chr3,16805947,16806060,IMR90|chr3:48130118-48130149,chr3,48130118,48130149,0,31324171
IMR90|chr3:16809570-16809608,chr3,16809570,16809608,IMR90|chr3:159485657-159485755,chr3,159485657,159485755,0,142676087
IMR90|chr3:17192161-17192218,chr3,17192161,17192218,IMR90|chr3:120169364-120169419,chr3,120169364,120169419,0,102977203
IMR90|chr3:17992884-17992912,chr3,17992884,17992912,IMR90|chr3:49447579-49447607,chr3,49447579,49447607,0,31454695
IMR90|chr3:18347813-18347855,chr3,18347813,18347855,IMR90|chr3:52004387-52004422,chr3,52004387,52004422,0,33656574
IMR90|chr3:18421600-18421651,chr3,18421600,18421651,IMR90|chr3:98619232-98619309,chr3,98619232,98619309,0,80197632
IMR90|chr3:18516952-18517054,chr3,18516952,18517054,IMR90|chr3:58478568-58478616,chr3,58478568,58478616,0,39961616
IMR90|chr3:19183878-19183920,chr3,19183878,19183920,IMR90|chr3:196228677-196228785,chr3,196228677,196228785,0,177044799
IMR90|chr3:19915853-19915904,chr3,19915853,19915904,IMR90|chr3:52736430-52736511,chr3,52736430,52736511,0,32820577
IMR90|chr3:19998378-19998452,chr3,19998378,19998452,IMR90|chr3:69058994-69059029,chr3,69058994,69059029,0,49060616
IMR90|chr3:20005953-20006079,chr3,20005953,20006079,IMR90|chr3:38176772-38176790,chr3,38176772,38176790,0,18170819
IMR90|chr3:20675680-20675728,chr3,20675680,20675728,IMR90|chr3:12709716-12709788,chr3,12709716,12709788,0,7965964
IMR90|chr3:20677293-20677372,chr3,20677293,20677372,IMR90|chr3:183896954-183896996,chr3,183896954,183896996,0,163219661
IMR90|chr3:21202428-21202494,chr3,21202428,21202494,IMR90|chr3:23805252-23805336,chr3,23805252,23805336,0,2602824
IMR90|chr3:21209104-21209212,chr3,21209104,21209212,IMR90|chr3:187461059-187461101,chr3,187461059,187461101,0,166251955
IMR90|chr3:21251064-21251110,chr3,21251064,21251110,IMR90|chr3:48721772-48721821,chr3,48721772,48721821,0,27470708
IMR90|chr3:21256342-21256388,chr3,21256342,21256388,IMR90|chr3:98618165-98618277,chr3,98618165,98618277,0,77361823
IMR90|chr3:22726272-22726313,chr3,22726272,22726313,IMR90|chr3:193311487-193311596,chr3,193311487,193311596,0,170585215
IMR90|chr3:22959566-22959643,chr3,22959566,22959643,IMR90|chr3:73048228-73048298,chr3,73048228,73048298,0,50088662
IMR90|chr3:23212925-23212959,chr3,23212925,23212959,IMR90|chr3:37286000-37286104,chr3,37286000,37286104,0,14073075
IMR90|chr3:23326452-23326506,chr3,23326452,23326506,IMR90|chr3:156394892-156394910,chr3,156394892,156394910,0,133068440
IMR90|chr3:23340408-23340430,chr3,23340408,23340430,IMR90|chr3:14167589-14167698,chr3,14167589,14167698,0,9172819
IMR90|chr3:23960855-23960910,chr3,23960855,23960910,IMR90|chr3:186283762-186283807,chr3,186283762,186283807,0,162322907
IMR90|chr3:24275957-24276002,chr3,24275957,24276002,IMR90|chr3:17744788-17744887,chr3,17744788,17744887,0,6531169
IMR90|chr3:24815112-24815241,chr3,24815112,24815241,IMR90|chr3:195684393-195684451,chr3,195684393,195684451,0,170869281
IMR90|chr3:25068176-25068232,chr3,25068176,25068232,IMR90|chr3:123303123-123303173,chr3,123303123,123303173,0,98234947
IMR90|chr3:25606595-25606632,chr3,25606595,25606632,IMR90|chr3:9440915-9441028,chr3,9440915,9441028,0,16165680
IMR90|chr3:26046988-26047007,chr3,26046988,26047007,IMR90|chr3:37220179-37220307,chr3,37220179,37220307,0,11173191
IMR90|chr3:26112558-26112594,chr3,26112558,26112594,IMR90|chr3:55512651-55512729,chr3,55512651,55512729,0,29400093
IMR90|chr3:26690067-26690128,chr3,26690067,26690128,IMR90|chr3:57581557-57581646,chr3,57581557,57581646,0,30891490
IMR90|chr3:26744007-26744065,chr3,26744007,26744065,IMR90|chr3:120169364-120169419,chr3,120169364,120169419,0,93425357
IMR90|chr3:26780827-26780891,chr3,26780827,26780891,IMR90|chr3:184037367-184037446,chr3,184037367,184037446,0,157256540
IMR90|chr3:26936732-26936845,chr3,26936732,26936845,IMR90|chr3:39419991-39420027,chr3,39419991,39420027,0,12483259
IMR90|chr3:27793201-27793224,chr3,27793201,27793224,IMR90|chr3:9435500-9435571,chr3,9435500,9435571,0,18357701
IMR90|chr3:28286762-28286836,chr3,28286762,28286836,IMR90|chr3:12706623-12706688,chr3,12706623,12706688,0,15580139
IMR90|chr3:28479791-28479876,chr3,28479791,28479876,IMR90|chr3:195684324-195684449,chr3,195684324,195684449,0,167204533
IMR90|chr3:28542550-28542604,chr3,28542550,28542604,IMR90|chr3:156394892-156394910,chr3,156394892,156394910,0,127852342
IMR90|chr3:29008454-29008532,chr3,29008454,29008532,IMR90|chr3:183893432-183893470,chr3,183893432,183893470,0,154884978
IMR90|chr3:29070194-29070286,chr3,29070194,29070286,IMR90|chr3:157251197-157251224,chr3,157251197,157251224,0,128181003
IMR90|chr3:29198928-29199036,chr3,29198928,29199036,IMR90|chr3:156270271-156270313,chr3,156270271,156270313,0,127071343
IMR90|chr3:29344314-29344361,chr3,29344314,29344361,IMR90|chr3:9439681-9439783,chr3,9439681,9439783,0,19904633
IMR90|chr3:29731348-29731423,chr3,29731348,29731423,IMR90|chr3:69058994-69059029,chr3,69058994,69059029,0,39327646
IMR90|chr3:29798173-29798247,chr3,29798173,29798247,IMR90|chr3:50276208-50276284,chr3,50276208,50276284,0,20478035
IMR90|chr3:30274967-30275033,chr3,30274967,30275033,IMR90|chr3:187453784-187453832,chr3,187453784,187453832,0,157178817
IMR90|chr3:30394793-30394854,chr3,30394793,30394854,IMR90|chr3:64252603-64252638,chr3,64252603,64252638,0,33857810
IMR90|chr3:30537427-30537491,chr3,30537427,30537491,IMR90|chr3:151987720-151987787,chr3,151987720,151987787,0,121450293
IMR90|chr3:31006436-31006476,chr3,31006436,31006476,IMR90|chr3:44045137-44045188,chr3,44045137,44045188,0,13038701
IMR90|chr3:31280561-31280654,chr3,31280561,31280654,IMR90|chr3:157251197-157251225,chr3,157251197,157251225,0,125970636
IMR90|chr3:31345366-31345429,chr3,31345366,31345429,IMR90|chr3:184036791-184036857,chr3,184036791,184036857,0,152691425
IMR90|chr3:31446031-31446065,chr3,31446031,31446065,IMR90|chr3:183893432-183893470,chr3,183893432,183893470,0,152447401
IMR90|chr3:31460829-31460866,chr3,31460829,31460866,IMR90|chr3:9440915-9441028,chr3,9440915,9441028,0,22019914
IMR90|chr3:31542064-31542163,chr3,31542064,31542163,IMR90|chr3:150131894-150131933,chr3,150131894,150131933,0,118589830
IMR90|chr3:31593821-31593878,chr3,31593821,31593878,IMR90|chr3:186283762-186283807,chr3,186283762,186283807,0,154689941
IMR90|chr3:32061081-32061122,chr3,32061081,32061122,IMR90|chr3:27523973-27524082,chr3,27523973,27524082,0,4537108
IMR90|chr3:32108723-32108804,chr3,32108723,32108804,IMR90|chr3:141106420-141106462,chr3,141106420,141106462,0,108997697
IMR90|chr3:32467461-32467571,chr3,32467461,32467571,IMR90|chr3:142720980-142721020,chr3,142720980,142721020,0,110253519
IMR90|chr3:32842343-32842387,chr3,32842343,32842387,IMR90|chr3:17744788-17744807,chr3,17744788,17744807,0,15097555
IMR90|chr3:33628319-33628369,chr3,33628319,33628369,IMR90|chr3:57995891-57995991,chr3,57995891,57995991,0,24367572
IMR90|chr3:33849609-33849693,chr3,33849609,33849693,IMR90|chr3:150263714-150263746,chr3,150263714,150263746,0,116414105
IMR90|chr3:33928392-33928495,chr3,33928392,33928495,IMR90|chr3:15905455-15905546,chr3,15905455,15905546,0,18022937
IMR90|chr3:34015348-34015400,chr3,34015348,34015400,IMR90|chr3:48129889-48130039,chr3,48129889,48130039,0,14114541
IMR90|chr3:34094973-34095007,chr3,34094973,34095007,IMR90|chr3:183893432-183893470,chr3,183893432,183893470,0,149798459
IMR90|chr3:34327386-34327444,chr3,34327386,34327444,IMR90|chr3:55521638-55521730,chr3,55521638,55521730,0,21194252
IMR90|chr3:34638902-34638938,chr3,34638902,34638938,IMR90|chr3:33479940-33480078,chr3,33479940,33480078,0,1158962
IMR90|chr3:34752823-34752861,chr3,34752823,34752861,IMR90|chr3:120166693-120166799,chr3,120166693,120166799,0,85413870
IMR90|chr3:34807999-34808053,chr3,34807999,34808053,IMR90|chr3:132376918-132377014,chr3,132376918,132377014,0,97568919
IMR90|chr3:34849164-34849191,chr3,34849164,34849191,IMR90|chr3:99980791-99980874,chr3,99980791,99980874,0,65131627
IMR90|chr3:35047943-35047986,chr3,35047943,35047986,IMR90|chr3:141105962-141106069,chr3,141105962,141106069,0,106058019
IMR90|chr3:35372920-35372986,chr3,35372920,35372986,IMR90|chr3:53287011-53287078,chr3,53287011,53287078,0,17914091
IMR90|chr3:35858032-35858121,chr3,35858032,35858121,IMR90|chr3:51574789-51574913,chr3,51574789,51574913,0,15716757
IMR90|chr3:35938158-35938199,chr3,35938158,35938199,IMR90|chr3:71113758-71113807,chr3,71113758,71113807,0,35175600
IMR90|chr3:36927190-36927266,chr3,36927190,36927266,IMR90|chr3:124450613-124450713,chr3,124450613,124450713,0,87523423
IMR90|chr3:37432818-37432852,chr3,37432818,37432852,IMR90|chr3:141105953-141106069,chr3,141105953,141106069,0,103673135
IMR90|chr3:37450761-37450794,chr3,37450761,37450794,IMR90|chr3:48344454-48344503,chr3,48344454,48344503,0,10893693
IMR90|chr3:37759134-37759181,chr3,37759134,37759181,IMR90|chr3:50274025-50274128,chr3,50274025,50274128,0,12514891
IMR90|chr3:37810922-37810998,chr3,37810922,37810998,IMR90|chr3:124450613-124450713,chr3,124450613,124450713,0,86639691
IMR90|chr3:37845131-37845191,chr3,37845131,37845191,IMR90|chr3:44803609-44803699,chr3,44803609,44803699,0,6958478
IMR90|chr3:37852090-37852145,chr3,37852090,37852145,IMR90|chr3:51574100-51574137,chr3,51574100,51574137,0,13722010
IMR90|chr3:38056310-38056386,chr3,38056310,38056386,IMR90|chr3:15838596-15838677,chr3,15838596,15838677,0,22217714
IMR90|chr3:38991027-38991068,chr3,38991027,38991068,IMR90|chr3:69135147-69135214,chr3,69135147,69135214,0,30144120
IMR90|chr3:39157817-39157842,chr3,39157817,39157842,IMR90|chr3:39450784-39450934,chr3,39450784,39450934,0,292967
IMR90|chr3:39177691-39177769,chr3,39177691,39177769,IMR90|chr3:187929430-187929479,chr3,187929430,187929479,0,148751739
IMR90|chr3:39550325-39550370,chr3,39550325,39550370,IMR90|chr3:156272118-156272135,chr3,156272118,156272135,0,116721793
IMR90|chr3:39724048-39724100,chr3,39724048,39724100,IMR90|chr3:48129889-48130039,chr3,48129889,48130039,0,8405841
IMR90|chr3:39905216-39905261,chr3,39905216,39905261,IMR90|chr3:155027990-155028018,chr3,155027990,155028018,0,115122774
IMR90|chr3:39979132-39979282,chr3,39979132,39979282,IMR90|chr3:99982295-99982442,chr3,99982295,99982442,0,60003163
IMR90|chr3:40149523-40149562,chr3,40149523,40149562,IMR90|chr3:120462150-120462285,chr3,120462150,120462285,0,80312627
IMR90|chr3:40226620-40226685,chr3,40226620,40226685,IMR90|chr3:157154894-157155031,chr3,157154894,157155031,0,116928274
IMR90|chr3:40400485-40400589,chr3,40400485,40400589,IMR90|chr3:136581162-136581309,chr3,136581162,136581309,0,96180677
IMR90|chr3:40483139-40483217,chr3,40483139,40483217,IMR90|chr3:128903262-128903315,chr3,128903262,128903315,0,88420123
IMR90|chr3:40612033-40612079,chr3,40612033,40612079,IMR90|chr3:12328009-12328106,chr3,12328009,12328106,0,28284024
IMR90|chr3:41134963-41135068,chr3,41134963,41135068,IMR90|chr3:120170534-120170579,chr3,120170534,120170579,0,79035571
IMR90|chr3:41542539-41542589,chr3,41542539,41542589,IMR90|chr3:124450613-124450713,chr3,124450613,124450713,0,82908074
IMR90|chr3:41673571-41673590,chr3,41673571,41673590,IMR90|chr3:139107206-139107258,chr3,139107206,139107258,0,97433635
IMR90|chr3:41956229-41956316,chr3,41956229,41956316,IMR90|chr3:123601382-123601445,chr3,123601382,123601445,0,81645153
IMR90|chr3:42315064-42315124,chr3,42315064,42315124,IMR90|chr3:64252609-64252638,chr3,64252609,64252638,0,21937545
IMR90|chr3:42565925-42566075,chr3,42565925,42566075,IMR90|chr3:99982295-99982442,chr3,99982295,99982442,0,57416370
IMR90|chr3:42800119-42800148,chr3,42800119,42800148,IMR90|chr3:48635844-48635929,chr3,48635844,48635929,0,5835725
IMR90|chr3:43242683-43242702,chr3,43242683,43242702,IMR90|chr3:37220179-37220307,chr3,37220179,37220307,0,6022504
IMR90|chr3:43341293-43341418,chr3,43341293,43341418,IMR90|chr3:10029172-10029200,chr3,10029172,10029200,0,33312121
IMR90|chr3:43419170-43419248,chr3,43419170,43419248,IMR90|chr3:183893432-183893470,chr3,183893432,183893470,0,140474262
IMR90|chr3:43573953-43574056,chr3,43573953,43574056,IMR90|chr3:128886165-128886222,chr3,128886165,128886222,0,85312212
IMR90|chr3:43876968-43877004,chr3,43876968,43877004,IMR90|chr3:37219605-37219753,chr3,37219605,37219753,0,6657363
IMR90|chr3:44447708-44447801,chr3,44447708,44447801,IMR90|chr3:128886165-128886222,chr3,128886165,128886222,0,84438457
IMR90|chr3:44451107-44451165,chr3,44451107,44451165,IMR90|chr3:52721711-52721793,chr3,52721711,52721793,0,8270604
IMR90|chr3:44627750-44627796,chr3,44627750,44627796,IMR90|chr3:64251823-64251893,chr3,64251823,64251893,0,19624073
IMR90|chr3:45582850-45582926,chr3,45582850,45582926,IMR90|chr3:112737635-112737709,chr3,112737635,112737709,0,67154785
IMR90|chr3:45712966-45713035,chr3,45712966,45713035,IMR90|chr3:45018176-45018249,chr3,45018176,45018249,0,694790
IMR90|chr3:46246322-46246344,chr3,46246322,46246344,IMR90|chr3:9435500-9435571,chr3,9435500,9435571,0,36810822
IMR90|chr3:46797913-46797961,chr3,46797913,46797961,IMR90|chr3:50274404-50274503,chr3,50274404,50274503,0,3476491
IMR90|chr3:46824582-46824660,chr3,46824582,46824660,IMR90|chr3:73048230-73048298,chr3,73048230,73048298,0,26223648
IMR90|chr3:46864753-46864790,chr3,46864753,46864790,IMR90|chr3:185653840-185653920,chr3,185653840,185653920,0,138789087
IMR90|chr3:46889362-46889455,chr3,46889362,46889455,IMR90|chr3:128886165-128886222,chr3,128886165,128886222,0,81996803
IMR90|chr3:47056040-47056098,chr3,47056040,47056098,IMR90|chr3:196227616-196227701,chr3,196227616,196227701,0,149171576
IMR90|chr3:47144179-47144273,chr3,47144179,47144273,IMR90|chr3:128901133-128901188,chr3,128901133,128901188,0,81756954
IMR90|chr3:47273043-47273193,chr3,47273043,47273193,IMR90|chr3:132383837-132383858,chr3,132383837,132383858,0,85110794
IMR90|chr3:47435923-47435968,chr3,47435923,47435968,IMR90|chr3:155027990-155028018,chr3,155027990,155028018,0,107592067
IMR90|chr3:47923771-47923802,chr3,47923771,47923802,IMR90|chr3:150129367-150129486,chr3,150129367,150129486,0,102205596
IMR90|chr3:48140565-48140608,chr3,48140565,48140608,IMR90|chr3:44045137-44045188,chr3,44045137,44045188,0,4095428
IMR90|chr3:48392182-48392306,chr3,48392182,48392306,IMR90|chr3:10029172-10029200,chr3,10029172,10029200,0,38363010
IMR90|chr3:49150518-49150548,chr3,49150518,49150548,IMR90|chr3:123303123-123303173,chr3,123303123,123303173,0,74152605
IMR90|chr3:49301991-49302026,chr3,49301991,49302026,IMR90|chr3:99981740-99981804,chr3,99981740,99981804,0,50679749
IMR90|chr3:49419328-49419405,chr3,49419328,49419405,IMR90|chr3:73048228-73048298,chr3,73048228,73048298,0,23628900
IMR90|chr3:49445498-49445557,chr3,49445498,49445557,IMR90|chr3:12328009-12328106,chr3,12328009,12328106,0,37117489
IMR90|chr3:49704990-49705062,chr3,49704990,49705062,IMR90|chr3:47822986-47823035,chr3,47822986,47823035,0,1882004
IMR90|chr3:49724128-49724186,chr3,49724128,49724186,IMR90|chr3:196227616-196227701,chr3,196227616,196227701,0,146503488
IMR90|chr3:50120185-50120235,chr3,50120185,50120235,IMR90|chr3:124450613-124450713,chr3,124450613,124450713,0,74330428
IMR90|chr3:50356348-50356414,chr3,50356348,50356414,IMR90|chr3:186283762-186283807,chr3,186283762,186283807,0,135927414
IMR90|chr3:50458989-50459099,chr3,50458989,50459099,IMR90|chr3:142720980-142721020,chr3,142720980,142721020,0,92261991
IMR90|chr3:50848613-50848669,chr3,50848613,50848669,IMR90|chr3:123303123-123303173,chr3,123303123,123303173,0,72454510
IMR90|chr3:51214720-51214766,chr3,51214720,51214766,IMR90|chr3:193311267-193311325,chr3,193311267,193311325,0,142096547
IMR90|chr3:51272877-51272932,chr3,51272877,51272932,IMR90|chr3:123303123-123303173,chr3,123303123,123303173,0,72030246
IMR90|chr3:51670015-51670068,chr3,51670015,51670068,IMR90|chr3:9834968-9835002,chr3,9834968,9835002,0,41835047
IMR90|chr3:52290487-52290528,chr3,52290487,52290528,IMR90|chr3:73048924-73049027,chr3,73048924,73049027,0,20758437
IMR90|chr3:52807603-52807650,chr3,52807603,52807650,IMR90|chr3:64252603-64252638,chr3,64252603,64252638,0,11445000
IMR90|chr3:53330305-53330356,chr3,53330305,53330356,IMR90|chr3:52736430-52736511,chr3,52736430,52736511,0,593875
IMR90|chr3:53418793-53418834,chr3,53418793,53418834,IMR90|chr3:52004387-52004422,chr3,52004387,52004422,0,1414406
IMR90|chr3:53538587-53538618,chr3,53538587,53538618,IMR90|chr3:150129367-150129486,chr3,150129367,150129486,0,96590780
IMR90|chr3:53636078-53636181,chr3,53636078,53636181,IMR90|chr3:150263714-150263746,chr3,150263714,150263746,0,96627636
IMR90|chr3:53718399-53718506,chr3,53718399,53718506,IMR90|chr3:48130118-48130149,chr3,48130118,48130149,0,5588281
IMR90|chr3:53891070-53891195,chr3,53891070,53891195,IMR90|chr3:58478568-58478616,chr3,58478568,58478616,0,4587498
IMR90|chr3:53908743-53908872,chr3,53908743,53908872,IMR90|chr3:132383837-132383858,chr3,132383837,132383858,0,78475094
IMR90|chr3:54201263-54201323,chr3,54201263,54201323,IMR90|chr3:52721711-52721793,chr3,52721711,52721793,0,1479552
IMR90|chr3:54205035-54205084,chr3,54205035,54205084,IMR90|chr3:52566821-52566949,chr3,52566821,52566949,0,1638214
IMR90|chr3:54425126-54425221,chr3,54425126,54425221,IMR90|chr3:150132784-150132826,chr3,150132784,150132826,0,95707658
IMR90|chr3:54427457-54427491,chr3,54427457,54427491,IMR90|chr3:37286000-37286104,chr3,37286000,37286104,0,17141457
IMR90|chr3:54739978-54740091,chr3,54739978,54740091,IMR90|chr3:48130118-48130149,chr3,48130118,48130149,0,6609860
IMR90|chr3:54921062-54921169,chr3,54921062,54921169,IMR90|chr3:15905455-15905545,chr3,15905455,15905545,0,39015607
IMR90|chr3:54980315-54980367,chr3,54980315,54980367,IMR90|chr3:98618165-98618277,chr3,98618165,98618277,0,43637850
IMR90|chr3:54990299-54990341,chr3,54990299,54990341,IMR90|chr3:69135147-69135214,chr3,69135147,69135214,0,14144848
IMR90|chr3:55255713-55255781,chr3,55255713,55255781,IMR90|chr3:132376918-132377014,chr3,132376918,132377014,0,77121205
IMR90|chr3:55613312-55613396,chr3,55613312,55613396,IMR90|chr3:125092502-125092652,chr3,125092502,125092652,0,69479190
IMR90|chr3:55636124-55636196,chr3,55636124,55636196,IMR90|chr3:39451399-39451524,chr3,39451399,39451524,0,16184725
IMR90|chr3:55762431-55762534,chr3,55762431,55762534,IMR90|chr3:120166693-120166799,chr3,120166693,120166799,0,64404262
IMR90|chr3:56214682-56214741,chr3,56214682,56214741,IMR90|chr3:30649449-30649523,chr3,30649449,30649523,0,25565233
IMR90|chr3:57070907-57070956,chr3,57070907,57070956,IMR90|chr3:99982366-99982437,chr3,99982366,99982437,0,42911459
IMR90|chr3:57104068-57104154,chr3,57104068,57104154,IMR90|chr3:123601382-123601445,chr3,123601382,123601445,0,66497314
IMR90|chr3:57328799-57328873,chr3,57328799,57328873,IMR90|chr3:185545025-185545087,chr3,185545025,185545087,0,128216226
IMR90|chr3:57615419-57615484,chr3,57615419,57615484,IMR90|chr3:157154894-157155031,chr3,157154894,157155031,0,99539475
IMR90|chr3:57665289-57665365,chr3,57665289,57665365,IMR90|chr3:120168132-120168186,chr3,120168132,120168186,0,62502843
IMR90|chr3:58262911-58263002,chr3,58262911,58263002,IMR90|chr3:50284087-50284146,chr3,50284087,50284146,0,7978824
IMR90|chr3:58364404-58364498,chr3,58364404,58364498,IMR90|chr3:128903259-128903315,chr3,128903259,128903315,0,70538855
IMR90|chr3:58832356-58832447,chr3,58832356,58832447,IMR90|chr3:52439622-52439681,chr3,52439622,52439681,0,6392734
IMR90|chr3:59182223-59182246,chr3,59182223,59182246,IMR90|chr3:9435500-9435571,chr3,9435500,9435571,0,49746723
IMR90|chr3:59514381-59514436,chr3,59514381,59514436,IMR90|chr3:186283762-186283807,chr3,186283762,186283807,0,126769381
IMR90|chr3:60451858-60451950,chr3,60451858,60451950,IMR90|chr3:157251197-157251224,chr3,157251197,157251224,0,96799339
IMR90|chr3:60602275-60602305,chr3,60602275,60602305,IMR90|chr3:184036609-184036743,chr3,184036609,184036743,0,123434334
IMR90|chr3:60997337-60997435,chr3,60997337,60997435,IMR90|chr3:120172388-120172514,chr3,120172388,120172514,0,59175051
IMR90|chr3:61118823-61118880,chr3,61118823,61118880,IMR90|chr3:150132709-150132782,chr3,150132709,150132782,0,89013886
IMR90|chr3:61437679-61437718,chr3,61437679,61437718,IMR90|chr3:73048924-73049027,chr3,73048924,73049027,0,11611245
IMR90|chr3:61658900-61658957,chr3,61658900,61658957,IMR90|chr3:150132709-150132782,chr3,150132709,150132782,0,88473809
IMR90|chr3:61870398-61870486,chr3,61870398,61870486,IMR90|chr3:183894158-183894188,chr3,183894158,183894188,0,122023760
IMR90|chr3:62620634-62620739,chr3,62620634,62620739,IMR90|chr3:55520410-55520454,chr3,55520410,55520454,0,7100224
IMR90|chr3:62702142-62702206,chr3,62702142,62702206,IMR90|chr3:98618883-98618920,chr3,98618883,98618920,0,35916741
IMR90|chr3:62722935-62722983,chr3,62722935,62722983,IMR90|chr3:159485657-159485755,chr3,159485657,159485755,0,96762722
IMR90|chr3:62967104-62967180,chr3,62967104,62967180,IMR90|chr3:49447437-49447470,chr3,49447437,49447470,0,13519667
IMR90|chr3:63161288-63161338,chr3,63161288,63161338,IMR90|chr3:120169088-120169148,chr3,120169088,120169148,0,57007800
IMR90|chr3:63466830-63466867,chr3,63466830,63466867,IMR90|chr3:128883602-128883706,chr3,128883602,128883706,0,65416772
IMR90|chr3:63617139-63617246,chr3,63617139,63617246,IMR90|chr3:52347667-52347710,chr3,52347667,52347710,0,11269472
IMR90|chr3:63622634-63622680,chr3,63622634,63622680,IMR90|chr3:50276031-50276127,chr3,50276031,50276127,0,13346603
IMR90|chr3:64571309-64571378,chr3,64571309,64571378,IMR90|chr3:55515632-55515701,chr3,55515632,55515701,0,9055677
IMR90|chr3:64696014-64696072,chr3,64696014,64696072,IMR90|chr3:55521638-55521730,chr3,55521638,55521730,0,9174376
IMR90|chr3:65515103-65515175,chr3,65515103,65515175,IMR90|chr3:185545025-185545087,chr3,185545025,185545087,0,120029922
IMR90|chr3:65581098-65581220,chr3,65581098,65581220,IMR90|chr3:38175002-38175030,chr3,38175002,38175030,0,27406096
IMR90|chr3:65621034-65621119,chr3,65621034,65621119,IMR90|chr3:195684324-195684449,chr3,195684324,195684449,0,130063290
IMR90|chr3:66069602-66069696,chr3,66069602,66069696,IMR90|chr3:136581162-136581309,chr3,136581162,136581309,0,70511560
IMR90|chr3:66137644-66137666,chr3,66137644,66137666,IMR90|chr3:98618335-98618457,chr3,98618335,98618457,0,32480691
IMR90|chr3:66339473-66339523,chr3,66339473,66339523,IMR90|chr3:187873055-187873155,chr3,187873055,187873155,0,121533582
IMR90|chr3:66374799-66374829,chr3,66374799,66374829,IMR90|chr3:110794368-110794466,chr3,110794368,110794466,0,44419569
IMR90|chr3:66495084-66495137,chr3,66495084,66495137,IMR90|chr3:12328009-12328106,chr3,12328009,12328106,0,54167075
IMR90|chr3:66600893-66601019,chr3,66600893,66601019,IMR90|chr3:48482766-48482873,chr3,48482766,48482873,0,18118127
IMR90|chr3:66665788-66665859,chr3,66665788,66665859,IMR90|chr3:37217153-37217222,chr3,37217153,37217222,0,29448635
IMR90|chr3:66963808-66963854,chr3,66963808,66963854,IMR90|chr3:64251823-64251893,chr3,64251823,64251893,0,2711985
IMR90|chr3:66963966-66964034,chr3,66963966,66964034,IMR90|chr3:132376918-132377014,chr3,132376918,132377014,0,65412952
IMR90|chr3:67149135-67149188,chr3,67149135,67149188,IMR90|chr3:156270937-156271056,chr3,156270937,156271056,0,89121802
IMR90|chr3:67177385-67177438,chr3,67177385,67177438,IMR90|chr3:9834968-9835002,chr3,9834968,9835002,0,57342417
IMR90|chr3:67234956-67235055,chr3,67234956,67235055,IMR90|chr3:53293642-53293679,chr3,53293642,53293679,0,13941314
IMR90|chr3:67528531-67528580,chr3,67528531,67528580,IMR90|chr3:113463150-113463296,chr3,113463150,113463296,0,45934619
IMR90|chr3:67791484-67791557,chr3,67791484,67791557,IMR90|chr3:98619393-98619448,chr3,98619393,98619448,0,30827909
IMR90|chr3:68057851-68057899,chr3,68057851,68057899,IMR90|chr3:9439681-9439783,chr3,9439681,9439783,0,58618170
IMR90|chr3:68133904-68134013,chr3,68133904,68134013,IMR90|chr3:50394934-50394975,chr3,50394934,50394975,0,17738970
IMR90|chr3:68180983-68181017,chr3,68180983,68181017,IMR90|chr3:141105953-141106069,chr3,141105953,141106069,0,72924970
IMR90|chr3:68624159-68624223,chr3,68624159,68624223,IMR90|chr3:184037367-184037446,chr3,184037367,184037446,0,115413208
IMR90|chr3:68635857-68635960,chr3,68635857,68635960,IMR90|chr3:150263714-150263746,chr3,150263714,150263746,0,81627857
IMR90|chr3:68645372-68645427,chr3,68645372,68645427,IMR90|chr3:149686564-149686655,chr3,149686564,149686655,0,81041192
IMR90|chr3:68889165-68889205,chr3,68889165,68889205,IMR90|chr3:44045137-44045188,chr3,44045137,44045188,0,24844028
IMR90|chr3:69505882-69505989,chr3,69505882,69505989,IMR90|chr3:187454966-187454989,chr3,187454966,187454989,0,117949084
IMR90|chr3:69518249-69518339,chr3,69518249,69518339,IMR90|chr3:51573466-51573521,chr3,51573466,51573521,0,17944783
IMR90|chr3:69547079-69547145,chr3,69547079,69547145,IMR90|chr3:53287011-53287078,chr3,53287011,53287078,0,16260068
IMR90|chr3:69643246-69643332,chr3,69643246,69643332,IMR90|chr3:183894158-183894188,chr3,183894158,183894188,0,114250912
IMR90|chr3:69785140-69785266,chr3,69785140,69785266,IMR90|chr3:38176772-38176790,chr3,38176772,38176790,0,31608368
IMR90|chr3:69882043-69882114,chr3,69882043,69882114,IMR90|chr3:98619393-98619448,chr3,98619393,98619448,0,28737350
IMR90|chr3:70998405-70998458,chr3,70998405,70998458,IMR90|chr3:17744788-17744887,chr3,17744788,17744887,0,53253617
IMR90|chr3:71027455-71027562,chr3,71027455,71027562,IMR90|chr3:52347667-52347710,chr3,52347667,52347710,0,18679788
IMR90|chr3:71527791-71527839,chr3,71527791,71527839,IMR90|chr3:37220179-37220307,chr3,37220179,37220307,0,34307612
IMR90|chr3:71608341-71608394,chr3,71608341,71608394,IMR90|chr3:17744788-17744887,chr3,17744788,17744887,0,53863553
IMR90|chr3:71648997-71649062,chr3,71648997,71649062,IMR90|chr3:44803609-44803699,chr3,44803609,44803699,0,26845388
IMR90|chr3:71779198-71779276,chr3,71779198,71779276,IMR90|chr3:64209975-64210009,chr3,64209975,64210009,0,7569223
IMR90|chr3:72582725-72582774,chr3,72582725,72582774,IMR90|chr3:99982366-99982437,chr3,99982366,99982437,0,27399641
IMR90|chr3:72847576-72847726,chr3,72847576,72847726,IMR90|chr3:39419991-39420027,chr3,39419991,39420027,0,33427585
IMR90|chr3:72933717-72933836,chr3,72933717,72933836,IMR90|chr3:128901133-128901188,chr3,128901133,128901188,0,55967416
IMR90|chr3:72960718-72960765,chr3,72960718,72960765,IMR90|chr3:50274025-50274128,chr3,50274025,50274128,0,22686693
IMR90|chr3:73151436-73151491,chr3,73151436,73151491,IMR90|chr3:149687754-149687811,chr3,149687754,149687811,0,76536318
IMR90|chr3:73219533-73219648,chr3,73219533,73219648,IMR90|chr3:187454649-187454684,chr3,187454649,187454684,0,114235116
IMR90|chr3:73689316-73689465,chr3,73689316,73689465,IMR90|chr3:122916460-122916542,chr3,122916460,122916542,0,49227144
IMR90|chr3:73724842-73724920,chr3,73724842,73724920,IMR90|chr3:64209975-64210009,chr3,64209975,64210009,0,9514867
IMR90|chr3:73788454-73788501,chr3,73788454,73788501,IMR90|chr3:184036791-184036857,chr3,184036791,184036857,0,110248337
IMR90|chr3:74296700-74296757,chr3,74296700,74296757,IMR90|chr3:12709615-12709692,chr3,12709615,12709692,0,61587085
IMR90|chr3:75222540-75222657,chr3,75222540,75222657,IMR90|chr3:50373516-50373549,chr3,50373516,50373549,0,24849024
IMR90|chr3:75584549-75584648,chr3,75584549,75584648,IMR90|chr3:124450613-124450713,chr3,124450613,124450713,0,48866064
IMR90|chr3:76223618-76223731,chr3,76223618,76223731,IMR90|chr3:39419991-39420027,chr3,39419991,39420027,0,36803627
IMR90|chr3:76229273-76229353,chr3,76229273,76229353,IMR90|chr3:141106420-141106462,chr3,141106420,141106462,0,64877147
IMR90|chr3:77027162-77027227,chr3,77027162,77027227,IMR90|chr3:186283762-186283807,chr3,186283762,186283807,0,109256600
IMR90|chr3:78050447-78050515,chr3,78050447,78050515,IMR90|chr3:50276031-50276127,chr3,50276031,50276127,0,27774416
IMR90|chr3:78171580-78171641,chr3,78171580,78171641,IMR90|chr3:48596796-48596866,chr3,48596796,48596866,0,29574784
IMR90|chr3:78994992-78995055,chr3,78994992,78995055,IMR90|chr3:184037367-184037446,chr3,184037367,184037446,0,105042375
IMR90|chr3:79049946-79050068,chr3,79049946,79050068,IMR90|chr3:38175002-38175030,chr3,38175002,38175030,0,40874944
IMR90|chr3:79511438-79511545,chr3,79511438,79511545,IMR90|chr3:187454966-187454989,chr3,187454966,187454989,0,107943528
IMR90|chr3:79890360-79890410,chr3,79890360,79890410,IMR90|chr3:38174529-38174619,chr3,38174529,38174619,0,41715831
IMR90|chr3:80286178-80286287,chr3,80286178,80286287,IMR90|chr3:50394934-50394975,chr3,50394934,50394975,0,29891244
IMR90|chr3:80645250-80645382,chr3,80645250,80645382,IMR90|chr3:187873055-187873155,chr3,187873055,187873155,0,107227805
IMR90|chr3:80800651-80800720,chr3,80800651,80800720,IMR90|chr3:49132427-49132496,chr3,49132427,49132496,0,31668224
IMR90|chr3:81004889-81004967,chr3,81004889,81004967,IMR90|chr3:12703605-12703720,chr3,12703605,12703720,0,68301284
IMR90|chr3:81243406-81243486,chr3,81243406,81243486,IMR90|chr3:39451564-39451603,chr3,39451564,39451603,0,41791842
IMR90|chr3:81456717-81456784,chr3,81456717,81456784,IMR90|chr3:53287011-53287078,chr3,53287011,53287078,0,28169706
IMR90|chr3:81564722-81564764,chr3,81564722,81564764,IMR90|chr3:52004387-52004422,chr3,52004387,52004422,0,29560335
IMR90|chr3:81581014-81581067,chr3,81581014,81581067,IMR90|chr3:156270937-156271056,chr3,156270937,156271056,0,74689923
IMR90|chr3:81818826-81818926,chr3,81818826,81818926,IMR90|chr3:48343475-48343514,chr3,48343475,48343514,0,33475351
IMR90|chr3:82406954-82406999,chr3,82406954,82406999,IMR90|chr3:52442938-52443001,chr3,52442938,52443001,0,29964016
IMR90|chr3:82842827-82842889,chr3,82842827,82842889,IMR90|chr3:48596796-48596866,chr3,48596796,48596866,0,34246031
IMR90|chr3:83008636-83008692,chr3,83008636,83008692,IMR90|chr3:150132709-150132782,chr3,150132709,150132782,0,67124073
IMR90|chr3:83336042-83336166,chr3,83336042,83336166,IMR90|chr3:10029172-10029200,chr3,10029172,10029200,0,73306870
IMR90|chr3:83568694-83568790,chr3,83568694,83568790,IMR90|chr3:52439622-52439681,chr3,52439622,52439681,0,31129072
IMR90|chr3:83648222-83648308,chr3,83648222,83648308,IMR90|chr3:183894158-183894188,chr3,183894158,183894188,0,100245936
IMR90|chr3:84317516-84317586,chr3,84317516,84317586,IMR90|chr3:196013388-196013427,chr3,196013388,196013427,0,111695872
IMR90|chr3:84349458-84349516,chr3,84349458,84349516,IMR90|chr3:30649449-30649523,chr3,30649449,30649523,0,53700009
IMR90|chr3:84741677-84741713,chr3,84741677,84741713,IMR90|chr3:9440915-9441028,chr3,9440915,9441028,0,75300762
IMR90|chr3:84772071-84772113,chr3,84772071,84772113,IMR90|chr3:196228677-196228785,chr3,196228677,196228785,0,111456606
IMR90|chr3:84934658-84934755,chr3,84934658,84934755,IMR90|chr3:184034690-184034743,chr3,184034690,184034743,0,99100032
IMR90|chr3:85653770-85653802,chr3,85653770,85653802,IMR90|chr3:135913485-135913548,chr3,135913485,135913548,0,50259715
IMR90|chr3:85849666-85849725,chr3,85849666,85849725,IMR90|chr3:30649449-30649523,chr3,30649449,30649523,0,55200217
IMR90|chr3:85982446-85982490,chr3,85982446,85982490,IMR90|chr3:17744788-17744807,chr3,17744788,17744807,0,68237658
IMR90|chr3:86203662-86203776,chr3,86203662,86203776,IMR90|chr3:150132784-150132826,chr3,150132784,150132826,0,63929122
IMR90|chr3:86344649-86344718,chr3,86344649,86344718,IMR90|chr3:48344455-48344503,chr3,48344455,48344503,0,38000194
IMR90|chr3:86462457-86462564,chr3,86462457,86462564,IMR90|chr3:15905455-15905545,chr3,15905455,15905545,0,70557002
IMR90|chr3:88276937-88276959,chr3,88276937,88276959,IMR90|chr3:98618335-98618457,chr3,98618335,98618457,0,10341398
IMR90|chr3:88277792-88277854,chr3,88277792,88277854,IMR90|chr3:48596796-48596866,chr3,48596796,48596866,0,39680996
IMR90|chr3:88407128-88407156,chr3,88407128,88407156,IMR90|chr3:49447579-49447607,chr3,49447579,49447607,0,38959549
IMR90|chr3:88630943-88631017,chr3,88630943,88631017,IMR90|chr3:185545025-185545087,chr3,185545025,185545087,0,96914082
IMR90|chr3:88843937-88844086,chr3,88843937,88844086,IMR90|chr3:122916460-122916542,chr3,122916460,122916542,0,34072523
IMR90|chr3:89510003-89510069,chr3,89510003,89510069,IMR90|chr3:99983035-99983129,chr3,99983035,99983129,0,10473032
IMR90|chr3:89689099-89689149,chr3,89689099,89689149,IMR90|chr3:195684350-195684373,chr3,195684350,195684373,0,105995251
IMR90|chr3:89773139-89773165,chr3,89773139,89773165,IMR90|chr3:185653759-185653833,chr3,185653759,185653833,0,95880620
IMR90|chr3:89934278-89934403,chr3,89934278,89934403,IMR90|chr3:10029172-10029200,chr3,10029172,10029200,0,79905106
IMR90|chr3:89942115-89942137,chr3,89942115,89942137,IMR90|chr3:14167589-14167698,chr3,14167589,14167698,0,75774526
IMR90|chr3:90282185-90282288,chr3,90282185,90282288,IMR90|chr3:128886165-128886222,chr3,128886165,128886222,0,38603980
IMR90|chr3:90390310-90390368,chr3,90390310,90390368,IMR90|chr3:27412251-27412308,chr3,27412251,27412308,0,62978059
IMR90|chr3:90588576-90588631,chr3,90588576,90588631,IMR90|chr3:51574100-51574137,chr3,51574100,51574137,0,39014476
IMR90|chr3:90833516-90833568,chr3,90833516,90833568,IMR90|chr3:9834968-9835002,chr3,9834968,9835002,0,80998548
IMR90|chr3:91048841-91048925,chr3,91048841,91048925,IMR90|chr3:45018176-45018249,chr3,45018176,45018249,0,46030665
IMR90|chr3:91270653-91270803,chr3,91270653,91270803,IMR90|chr3:38175002-38175030,chr3,38175002,38175030,0,53095651
IMR90|chr3:91456274-91456329,chr3,91456274,91456329,IMR90|chr3:120169364-120169419,chr3,120169364,120169419,0,28713090
IMR90|chr3:91959704-91959740,chr3,91959704,91959740,IMR90|chr3:9440915-9441028,chr3,9440915,9441028,0,82518789
IMR90|chr3:92219448-92219528,chr3,92219448,92219528,IMR90|chr3:39451399-39451524,chr3,39451399,39451524,0,52768049
IMR90|chr3:92710397-92710547,chr3,92710397,92710547,IMR90|chr3:39419991-39420027,chr3,39419991,39420027,0,53290406
IMR90|chr3:93203540-93203573,chr3,93203540,93203573,IMR90|chr3:48344454-48344503,chr3,48344454,48344503,0,44859086
IMR90|chr3:93468125-93468179,chr3,93468125,93468179,IMR90|chr3:194388130-194388244,chr3,194388130,194388244,0,100920005
IMR90|chr3:93624605-93624692,chr3,93624605,93624692,IMR90|chr3:185538858-185538921,chr3,185538858,185538921,0,91914253
IMR90|chr3:93635159-93635228,chr3,93635159,93635228,IMR90|chr3:45018176-45018249,chr3,45018176,45018249,0,48616983
IMR90|chr3:93932948-93933024,chr3,93932948,93933024,IMR90|chr3:49447437-49447470,chr3,49447437,49447470,0,44485511
IMR90|chr3:93940594-93940687,chr3,93940594,93940687,IMR90|chr3:51999437-51999471,chr3,51999437,51999471,0,41941157
IMR90|chr3:94192474-94192529,chr3,94192474,94192529,IMR90|chr3:120169364-120169419,chr3,120169364,120169419,0,25976890
IMR90|chr3:94537951-94538028,chr3,94537951,94538028,IMR90|chr3:183893432-183893470,chr3,183893432,183893470,0,89355481
IMR90|chr3:94580072-94580155,chr3,94580072,94580155,IMR90|chr3:49974750-49974817,chr3,49974750,49974817,0,44605322
IMR90|chr3:94599373-94599457,chr3,94599373,94599457,IMR90|chr3:187454649-187454684,chr3,187454649,187454684,0,92855276
IMR90|chr3:94861922-94861999,chr3,94861922,94861999,IMR90|chr3:45018176-45018249,chr3,45018176,45018249,0,49843746
IMR90|chr3:95141547-95141612,chr3,95141547,95141612,IMR90|chr3:44803609-44803699,chr3,44803609,44803699,0,50337938
IMR90|chr3:95432631-95432688,chr3,95432631,95432688,IMR90|chr3:149687753-149687811,chr3,149687753,149687811,0,54255122
IMR90|chr3:96336859-96336910,chr3,96336859,96336910,IMR90|chr3:139107740-139107812,chr3,139107740,139107812,0,42770881
IMR90|chr3:96413550-96413608,chr3,96413550,96413608,IMR90|chr3:120169364-120169419,chr3,120169364,120169419,0,23755814
IMR90|chr3:97081553-97081610,chr3,97081553,97081610,IMR90|chr3:186283762-186283807,chr3,186283762,186283807,0,89202209
IMR90|chr3:97610383-97610533,chr3,97610383,97610533,IMR90|chr3:132383837-132383858,chr3,132383837,132383858,0,34773454
IMR90|chr3:98247846-98247953,chr3,98247846,98247953,IMR90|chr3:48130118-48130149,chr3,48130118,48130149,0,50117728
IMR90|chr3:98679913-98679964,chr3,98679913,98679964,IMR90|chr3:139107740-139107812,chr3,139107740,139107812,0,40427827
IMR90|chr3:99627015-99627063,chr3,99627015,99627063,IMR90|chr3:37220179-37220307,chr3,37220179,37220307,0,62406836
IMR90|chr3:99643671-99643770,chr3,99643671,99643770,IMR90|chr3:150131894-150131933,chr3,150131894,150131933,0,50488223
IMR90|chr3:99682197-99682246,chr3,99682197,99682246,IMR90|chr3:113463150-113463296,chr3,113463150,113463296,0,13780953
IMR90|chr3:99766546-99766659,chr3,99766546,99766659,IMR90|chr3:184034690-184034743,chr3,184034690,184034743,0,84268144
IMR90|chr3:99896313-99896393,chr3,99896313,99896393,IMR90|chr3:141106420-141106462,chr3,141106420,141106462,0,41210107
IMR90|chr3:100062987-100063076,chr3,100062987,100063076,IMR90|chr3:112737635-112737709,chr3,112737635,112737709,0,12674648
IMR90|chr3:100284557-100284584,chr3,100284557,100284584,IMR90|chr3:99980791-99980874,chr3,99980791,99980874,0,303766
IMR90|chr3:100619078-100619126,chr3,100619078,100619126,IMR90|chr3:9439681-9439783,chr3,9439681,9439783,0,91179397
IMR90|chr3:101424108-101424155,chr3,101424108,101424155,IMR90|chr3:184036791-184036857,chr3,184036791,184036857,0,82612683
IMR90|chr3:101502140-101502193,chr3,101502140,101502193,IMR90|chr3:75705090-75705169,chr3,75705090,75705169,0,25797050
IMR90|chr3:101570522-101570602,chr3,101570522,101570602,IMR90|chr3:39451399-39451524,chr3,39451399,39451524,0,62119123
IMR90|chr3:101634097-101634123,chr3,101634097,101634123,IMR90|chr3:185653759-185653833,chr3,185653759,185653833,0,84019662
IMR90|chr3:101820760-101820826,chr3,101820760,101820826,IMR90|chr3:187453784-187453832,chr3,187453784,187453832,0,85633024
IMR90|chr3:101901035-101901080,chr3,101901035,101901080,IMR90|chr3:52442938-52443001,chr3,52442938,52443001,0,49458097
IMR90|chr3:101936605-101936627,chr3,101936605,101936627,IMR90|chr3:9435500-9435571,chr3,9435500,9435571,0,92501105
IMR90|chr3:101941122-101941200,chr3,101941122,101941200,IMR90|chr3:55514332-55514387,chr3,55514332,55514387,0,46426790
IMR90|chr3:102267563-102267621,chr3,102267563,102267621,IMR90|chr3:186283762-186283807,chr3,186283762,186283807,0,84016199
IMR90|chr3:104080480-104080568,chr3,104080480,104080568,IMR90|chr3:110792095-110792145,chr3,110792095,110792145,0,6711615
IMR90|chr3:104141059-104141178,chr3,104141059,104141178,IMR90|chr3:128901133-128901188,chr3,128901133,128901188,0,24760074
IMR90|chr3:104439412-104439461,chr3,104439412,104439461,IMR90|chr3:52566821-52566949,chr3,52566821,52566949,0,51872591
IMR90|chr3:104536004-104536108,chr3,104536004,104536108,IMR90|chr3:136581162-136581309,chr3,136581162,136581309,0,32045158
IMR90|chr3:105105227-105105321,chr3,105105227,105105321,IMR90|chr3:51999437-51999471,chr3,51999437,51999471,0,53105790
IMR90|chr3:105643172-105643208,chr3,105643172,105643208,IMR90|chr3:55512651-55512729,chr3,55512651,55512729,0,50130521
IMR90|chr3:105835918-105835968,chr3,105835918,105835968,IMR90|chr3:57995891-57995991,chr3,57995891,57995991,0,47840027
IMR90|chr3:106097472-106097530,chr3,106097472,106097530,IMR90|chr3:27412251-27412308,chr3,27412251,27412308,0,78685221
IMR90|chr3:106492653-106492735,chr3,106492653,106492735,IMR90|chr3:185653718-185653807,chr3,185653718,185653807,0,79161065
IMR90|chr3:106916483-106916577,chr3,106916483,106916577,IMR90|chr3:128903259-128903315,chr3,128903259,128903315,0,21986776
IMR90|chr3:107093494-107093569,chr3,107093494,107093569,IMR90|chr3:69058994-69059029,chr3,69058994,69059029,0,38034500
IMR90|chr3:107160320-107160395,chr3,107160320,107160395,IMR90|chr3:64209975-64210009,chr3,64209975,64210009,0,42950345
IMR90|chr3:107505523-107505564,chr3,107505523,107505564,IMR90|chr3:27523973-27524082,chr3,27523973,27524082,0,79981550
IMR90|chr3:107559578-107559623,chr3,107559578,107559623,IMR90|chr3:156272118-156272135,chr3,156272118,156272135,0,48712540
IMR90|chr3:107794382-107794504,chr3,107794382,107794504,IMR90|chr3:51574781-51574898,chr3,51574781,51574898,0,56219601
IMR90|chr3:107876369-107876477,chr3,107876369,107876477,IMR90|chr3:184034840-184034878,chr3,184034840,184034878,0,76158471
IMR90|chr3:107893287-107893401,chr3,107893287,107893401,IMR90|chr3:150132784-150132826,chr3,150132784,150132826,0,42239497
IMR90|chr3:107902802-107902870,chr3,107902802,107902870,IMR90|chr3:150130198-150130280,chr3,150130198,150130280,0,42227396
IMR90|chr3:108216801-108216849,chr3,108216801,108216849,IMR90|chr3:184532447-184532496,chr3,184532447,184532496,0,76315646
IMR90|chr3:108440757-108440850,chr3,108440757,108440850,IMR90|chr3:51999437-51999471,chr3,51999437,51999471,0,56441320
IMR90|chr3:108513351-108513383,chr3,108513351,108513383,IMR90|chr3:135913485-135913548,chr3,135913485,135913548,0,27400134
IMR90|chr3:108785734-108785836,chr3,108785734,108785836,IMR90|chr3:58478568-58478616,chr3,58478568,58478616,0,50307166
IMR90|chr3:109145034-109145100,chr3,109145034,109145100,IMR90|chr3:99983035-99983129,chr3,99983035,99983129,0,9161999
IMR90|chr3:109522055-109522144,chr3,109522055,109522144,IMR90|chr3:112737635-112737709,chr3,112737635,112737709,0,3215580
IMR90|chr3:109565794-109565844,chr3,109565794,109565844,IMR90|chr3:187873055-187873155,chr3,187873055,187873155,0,78307261
IMR90|chr3:109861442-109861505,chr3,109861442,109861505,IMR90|chr3:185543034-185543088,chr3,185543034,185543088,0,75681592
IMR90|chr3:110277695-110277727,chr3,110277695,110277727,IMR90|chr3:194993378-194993471,chr3,194993378,194993471,0,84715683
IMR90|chr3:110340358-110340464,chr3,110340358,110340464,IMR90|chr3:150129367-150129486,chr3,150129367,150129486,0,39789009
IMR90|chr3:110472814-110472962,chr3,110472814,110472962,IMR90|chr3:156270271-156270313,chr3,156270271,156270313,0,45797457
IMR90|chr3:111934985-111935072,chr3,111934985,111935072,IMR90|chr3:185538858-185538921,chr3,185538858,185538921,0,73603873
IMR90|chr3:111960810-111960873,chr3,111960810,111960873,IMR90|chr3:15901802-15901838,chr3,15901802,15901838,0,96059008
IMR90|chr3:112869051-112869110,chr3,112869051,112869110,IMR90|chr3:185653718-185653807,chr3,185653718,185653807,0,72784667
IMR90|chr3:113060700-113060799,chr3,113060700,113060799,IMR90|chr3:53293642-53293679,chr3,53293642,53293679,0,59767058
IMR90|chr3:113095403-113095491,chr3,113095403,113095491,IMR90|chr3:183894158-183894188,chr3,183894158,183894188,0,70798755
IMR90|chr3:113540459-113540560,chr3,113540459,113540560,IMR90|chr3:38176981-38177019,chr3,38176981,38177019,0,75363478
IMR90|chr3:113759011-113759034,chr3,113759011,113759034,IMR90|chr3:14167589-14167698,chr3,14167589,14167698,0,99591422
IMR90|chr3:114043464-114043522,chr3,114043464,114043522,IMR90|chr3:9440162-9440213,chr3,9440162,9440213,0,104603302
IMR90|chr3:114109738-114109779,chr3,114109738,114109779,IMR90|chr3:73048924-73049027,chr3,73048924,73049027,0,41060814
IMR90|chr3:114679084-114679234,chr3,114679084,114679234,IMR90|chr3:52347667-52347710,chr3,52347667,52347710,0,62331417
IMR90|chr3:114960601-114960652,chr3,114960601,114960652,IMR90|chr3:50365013-50365105,chr3,50365013,50365105,0,64595588
IMR90|chr3:114988670-114988725,chr3,114988670,114988725,IMR90|chr3:123303123-123303173,chr3,123303123,123303173,0,8314453
IMR90|chr3:115176781-115176880,chr3,115176781,115176880,IMR90|chr3:9434250-9434293,chr3,9434250,9434293,0,105742531
IMR90|chr3:115236743-115236824,chr3,115236743,115236824,IMR90|chr3:141106420-141106462,chr3,141106420,141106462,0,25869677
IMR90|chr3:115265172-115265230,chr3,115265172,115265230,IMR90|chr3:149687754-149687811,chr3,149687754,149687811,0,34422582
IMR90|chr3:115426330-115426438,chr3,115426330,115426438,IMR90|chr3:187931772-187931809,chr3,187931772,187931809,0,72505442
IMR90|chr3:116245890-116246007,chr3,116245890,116246007,IMR90|chr3:195684405-195684447,chr3,195684405,195684447,0,79438515
IMR90|chr3:116438183-116438227,chr3,116438183,116438227,IMR90|chr3:185544272-185544337,chr3,185544272,185544337,0,69106089
IMR90|chr3:116446427-116446494,chr3,116446427,116446494,IMR90|chr3:53287011-53287078,chr3,53287011,53287078,0,63159416
IMR90|chr3:116634492-116634558,chr3,116634492,116634558,IMR90|chr3:186283762-186283807,chr3,186283762,186283807,0,69649270
IMR90|chr3:117025176-117025301,chr3,117025176,117025301,IMR90|chr3:58478568-58478616,chr3,58478568,58478616,0,58546608
IMR90|chr3:117765694-117765752,chr3,117765694,117765752,IMR90|chr3:149687754-149687811,chr3,149687754,149687811,0,31922060
IMR90|chr3:117857127-117857195,chr3,117857127,117857195,IMR90|chr3:150130198-150130280,chr3,150130198,150130280,0,32273071
IMR90|chr3:117891689-117891783,chr3,117891689,117891783,IMR90|chr3:51999437-51999471,chr3,51999437,51999471,0,65892252
IMR90|chr3:118451893-118451973,chr3,118451893,118451973,IMR90|chr3:39451564-39451603,chr3,39451564,39451603,0,79000329
IMR90|chr3:120053152-120053230,chr3,120053152,120053230,IMR90|chr3:73048230-73048298,chr3,73048230,73048298,0,47004922
IMR90|chr3:120891301-120891340,chr3,120891301,120891340,IMR90|chr3:120462150-120462285,chr3,120462150,120462285,0,429151
IMR90|chr3:121190914-121190972,chr3,121190914,121190972,IMR90|chr3:186283762-186283807,chr3,186283762,186283807,0,65092848
IMR90|chr3:121705210-121705273,chr3,121705210,121705273,IMR90|chr3:128906088-128906141,chr3,128906088,128906141,0,7200878
IMR90|chr3:121975597-121975647,chr3,121975597,121975647,IMR90|chr3:120169088-120169148,chr3,120169088,120169148,0,1806509
IMR90|chr3:122389504-122389556,chr3,122389504,122389556,IMR90|chr3:9834968-9835002,chr3,9834968,9835002,0,112554536
IMR90|chr3:122437688-122437796,chr3,122437688,122437796,IMR90|chr3:184034840-184034878,chr3,184034840,184034878,0,61597152
IMR90|chr3:122556211-122556256,chr3,122556211,122556256,IMR90|chr3:194993434-194993504,chr3,194993434,194993504,0,72437223
IMR90|chr3:122860966-122861030,chr3,122860966,122861030,IMR90|chr3:98618883-98618920,chr3,98618883,98618920,0,24242083
IMR90|chr3:123649858-123649966,chr3,123649858,123649966,IMR90|chr3:142720980-142721019,chr3,142720980,142721019,0,19071122
IMR90|chr3:123788488-123788618,chr3,123788488,123788618,IMR90|chr3:50394934-50394975,chr3,50394934,50394975,0,73393554
IMR90|chr3:123828985-123829026,chr3,123828985,123829026,IMR90|chr3:71113758-71113807,chr3,71113758,71113807,0,52715227
IMR90|chr3:123939535-123939630,chr3,123939535,123939630,IMR90|chr3:50276208-50276284,chr3,50276208,50276284,0,73663327
IMR90|chr3:124078859-124078889,chr3,124078859,124078889,IMR90|chr3:110794368-110794466,chr3,110794368,110794466,0,13284491
IMR90|chr3:124398289-124398349,chr3,124398289,124398349,IMR90|chr3:52721711-52721793,chr3,52721711,52721793,0,71676578
IMR90|chr3:124758918-124758970,chr3,124758918,124758970,IMR90|chr3:52736430-52736511,chr3,52736430,52736511,0,72022488
IMR90|chr3:124813086-124813170,chr3,124813086,124813170,IMR90|chr3:45018176-45018249,chr3,45018176,45018249,0,79794910
IMR90|chr3:124925488-124925530,chr3,124925488,124925530,IMR90|chr3:99983035-99983143,chr3,99983035,99983143,0,24942453
IMR90|chr3:125168846-125168894,chr3,125168846,125168894,IMR90|chr3:159485657-159485755,chr3,159485657,159485755,0,34316811
IMR90|chr3:125578889-125578954,chr3,125578889,125578954,IMR90|chr3:186283762-186283807,chr3,186283762,186283807,0,60704873
IMR90|chr3:126285770-126285877,chr3,126285770,126285877,IMR90|chr3:128903265-128903315,chr3,128903265,128903315,0,2617495
IMR90|chr3:126483932-126483993,chr3,126483932,126483993,IMR90|chr3:48596796-48596866,chr3,48596796,48596866,0,77887136
IMR90|chr3:126608229-126608259,chr3,126608229,126608259,IMR90|chr3:187873499-187873617,chr3,187873499,187873617,0,61265270
IMR90|chr3:126723268-126723304,chr3,126723268,126723304,IMR90|chr3:9440915-9441028,chr3,9440915,9441028,0,117282353
IMR90|chr3:126788570-126788630,chr3,126788570,126788630,IMR90|chr3:9440162-9440213,chr3,9440162,9440213,0,117348408
IMR90|chr3:127082676-127082726,chr3,127082676,127082726,IMR90|chr3:195684350-195684373,chr3,195684350,195684373,0,68601674
IMR90|chr3:127348687-127348726,chr3,127348687,127348726,IMR90|chr3:185654845-185654946,chr3,185654845,185654946,0,58306158
IMR90|chr3:127652018-127652135,chr3,127652018,127652135,IMR90|chr3:50373516-50373549,chr3,50373516,50373549,0,77278502
IMR90|chr3:127665004-127665067,chr3,127665004,127665067,IMR90|chr3:185543034-185543088,chr3,185543034,185543088,0,57878030
IMR90|chr3:127711102-127711149,chr3,127711102,127711149,IMR90|chr3:64252603-64252638,chr3,64252603,64252638,0,63458499
IMR90|chr3:127877988-127878045,chr3,127877988,127878045,IMR90|chr3:149686564-149686655,chr3,149686564,149686655,0,21808576
IMR90|chr3:127911483-127911556,chr3,127911483,127911556,IMR90|chr3:128903216-128903315,chr3,128903216,128903315,0,991733
IMR90|chr3:128709830-128709888,chr3,128709830,128709888,IMR90|chr3:52721711-52721793,chr3,52721711,52721793,0,75988119
IMR90|chr3:128764748-128764898,chr3,128764748,128764898,IMR90|chr3:187461059-187461101,chr3,187461059,187461101,0,58696311
IMR90|chr3:128877854-128877883,chr3,128877854,128877883,IMR90|chr3:48635844-48635929,chr3,48635844,48635929,0,80242010
IMR90|chr3:128886895-128886949,chr3,128886895,128886949,IMR90|chr3:156270937-156271056,chr3,156270937,156271056,0,27384042
IMR90|chr3:129018042-129018144,chr3,129018042,129018144,IMR90|chr3:48343475-48343514,chr3,48343475,48343514,0,80674567
IMR90|chr3:129248946-129248992,chr3,129248946,129248992,IMR90|chr3:98618165-98618277,chr3,98618165,98618277,0,30630781
IMR90|chr3:129464433-129464537,chr3,129464433,129464537,IMR90|chr3:50284087-50284146,chr3,50284087,50284146,0,79180346
IMR90|chr3:129997433-129997519,chr3,129997433,129997519,IMR90|chr3:123601382-123601445,chr3,123601382,123601445,0,6396051
IMR90|chr3:130469928-130470043,chr3,130469928,130470043,IMR90|chr3:187454649-187454684,chr3,187454649,187454684,0,56984721
IMR90|chr3:131142466-131142563,chr3,131142466,131142563,IMR90|chr3:184034690-184034743,chr3,184034690,184034743,0,52892224
IMR90|chr3:131792373-131792451,chr3,131792373,131792451,IMR90|chr3:128903262-128903315,chr3,128903262,128903315,0,2889111
IMR90|chr3:132400269-132400321,chr3,132400269,132400321,IMR90|chr3:140951171-140951244,chr3,140951171,140951244,0,8550902
IMR90|chr3:132825378-132825426,chr3,132825378,132825426,IMR90|chr3:50274404-50274503,chr3,50274404,50274503,0,82550974
IMR90|chr3:132894376-132894439,chr3,132894376,132894439,IMR90|chr3:184037367-184037446,chr3,184037367,184037446,0,51142991
IMR90|chr3:133024806-133024851,chr3,133024806,133024851,IMR90|chr3:17744788-17744887,chr3,17744788,17744887,0,115280018
IMR90|chr3:133082832-133082868,chr3,133082832,133082868,IMR90|chr3:99981740-99981804,chr3,99981740,99981804,0,33101092
IMR90|chr3:133162974-133163058,chr3,133162974,133163058,IMR90|chr3:125092502-125092652,chr3,125092502,125092652,0,8070472
IMR90|chr3:133974608-133974682,chr3,133974608,133974682,IMR90|chr3:69058994-69059029,chr3,69058994,69059029,0,64915614
IMR90|chr3:134159361-134159490,chr3,134159361,134159490,IMR90|chr3:132383837-132383858,chr3,132383837,132383858,0,1775524
IMR90|chr3:134417098-134417175,chr3,134417098,134417175,IMR90|chr3:183893432-183893470,chr3,183893432,183893470,0,49476334
IMR90|chr3:134450123-134450243,chr3,134450123,134450243,IMR90|chr3:49974750-49974817,chr3,49974750,49974817,0,84475373
IMR90|chr3:134460246-134460344,chr3,134460246,134460344,IMR90|chr3:120172388-120172514,chr3,120172388,120172514,0,14287858
IMR90|chr3:134826250-134826271,chr3,134826250,134826271,IMR90|chr3:14167589-14167698,chr3,14167589,14167698,0,120658661
IMR90|chr3:135453115-135453148,chr3,135453115,135453148,IMR90|chr3:51574781-51574898,chr3,51574781,51574898,0,83878334
IMR90|chr3:135483133-135483202,chr3,135483133,135483202,IMR90|chr3:186283889-186283968,chr3,186283889,186283968,0,50800756
IMR90|chr3:135510447-135510525,chr3,135510447,135510525,IMR90|chr3:12703605-12703720,chr3,12703605,12703720,0,122806842
IMR90|chr3:135757532-135757661,chr3,135757532,135757661,IMR90|chr3:195684393-195684451,chr3,195684393,195684451,0,59926861
IMR90|chr3:135958693-135958745,chr3,135958693,135958745,IMR90|chr3:52736430-52736511,chr3,52736430,52736511,0,83222263
IMR90|chr3:136634861-136634914,chr3,136634861,136634914,IMR90|chr3:75705090-75705169,chr3,75705090,75705169,0,60929771
IMR90|chr3:138068567-138068600,chr3,138068567,138068600,IMR90|chr3:51574781-51574898,chr3,51574781,51574898,0,86493786
IMR90|chr3:138329079-138329120,chr3,138329079,138329120,IMR90|chr3:128447458-128447593,chr3,128447458,128447593,0,9881621
IMR90|chr3:138406933-138407027,chr3,138406933,138407027,IMR90|chr3:156272118-156272135,chr3,156272118,156272135,0,17865185
IMR90|chr3:138783926-138784028,chr3,138783926,138784028,IMR90|chr3:48343475-48343514,chr3,48343475,48343514,0,90440451
IMR90|chr3:139058617-139058699,chr3,139058617,139058699,IMR90|chr3:185653718-185653807,chr3,185653718,185653807,0,46595101
IMR90|chr3:139195468-139195509,chr3,139195468,139195509,IMR90|chr3:69135147-69135214,chr3,69135147,69135214,0,70060321
IMR90|chr3:139355248-139355332,chr3,139355248,139355332,IMR90|chr3:187454649-187454684,chr3,187454649,187454684,0,48099401
IMR90|chr3:139387185-139387228,chr3,139387185,139387228,IMR90|chr3:141105962-141106069,chr3,141105962,141106069,0,1718777
IMR90|chr3:139425051-139425157,chr3,139425051,139425157,IMR90|chr3:150129367-150129486,chr3,150129367,150129486,0,10704316
IMR90|chr3:139611202-139611324,chr3,139611202,139611324,IMR90|chr3:51574781-51574898,chr3,51574781,51574898,0,88036421
IMR90|chr3:139819965-139820052,chr3,139819965,139820052,IMR90|chr3:123601382-123601445,chr3,123601382,123601445,0,16218583
IMR90|chr3:140158925-140158976,chr3,140158925,140158976,IMR90|chr3:128903216-128903315,chr3,128903216,128903315,0,11255709
IMR90|chr3:140500724-140500754,chr3,140500724,140500754,IMR90|chr3:184036609-184036743,chr3,184036609,184036743,0,43535885
IMR90|chr3:141080526-141080556,chr3,141080526,141080556,IMR90|chr3:187873499-187873617,chr3,187873499,187873617,0,46792973
IMR90|chr3:141214993-141215034,chr3,141214993,141215034,IMR90|chr3:128447458-128447593,chr3,128447458,128447593,0,12767535
IMR90|chr3:141358146-141358276,chr3,141358146,141358276,IMR90|chr3:50394934-50394975,chr3,50394934,50394975,0,90963212
IMR90|chr3:141404130-141404201,chr3,141404130,141404201,IMR90|chr3:98619393-98619448,chr3,98619393,98619448,0,42784737
IMR90|chr3:141728760-141728817,chr3,141728760,141728817,IMR90|chr3:185547403-185547472,chr3,185547403,185547472,0,43818643
IMR90|chr3:142058092-142058134,chr3,142058092,142058134,IMR90|chr3:99983035-99983143,chr3,99983035,99983143,0,42075057
IMR90|chr3:142097581-142097672,chr3,142097581,142097672,IMR90|chr3:51573466-51573521,chr3,51573466,51573521,0,90524115
IMR90|chr3:142289403-142289476,chr3,142289403,142289476,IMR90|chr3:128903216-128903315,chr3,128903216,128903315,0,13386187
IMR90|chr3:142792910-142793018,chr3,142792910,142793018,IMR90|chr3:187931772-187931809,chr3,187931772,187931809,0,45138862
IMR90|chr3:143099469-143099530,chr3,143099469,143099530,IMR90|chr3:135913101-135913128,chr3,135913101,135913128,0,7186368
IMR90|chr3:143149987-143150026,chr3,143149987,143150026,IMR90|chr3:185654845-185654946,chr3,185654845,185654946,0,42504858
IMR90|chr3:143339317-143339367,chr3,143339317,143339367,IMR90|chr3:139107740-139107803,chr3,139107740,139107803,0,4231577
IMR90|chr3:143787518-143787617,chr3,143787518,143787617,IMR90|chr3:124450613-124450713,chr3,124450613,124450713,0,19336905
IMR90|chr3:144042738-144042826,chr3,144042738,144042826,IMR90|chr3:128885943-128886005,chr3,128885943,128886005,0,15156795
IMR90|chr3:144733002-144733091,chr3,144733002,144733091,IMR90|chr3:50276512-50276573,chr3,50276512,50276573,0,94456490
IMR90|chr3:145382790-145382907,chr3,145382790,145382907,IMR90|chr3:195684405-195684447,chr3,195684405,195684447,0,50301615
IMR90|chr3:145435966-145436061,chr3,145435966,145436061,IMR90|chr3:150132784-150132826,chr3,150132784,150132826,0,4696818
IMR90|chr3:146134592-146134742,chr3,146134592,146134742,IMR90|chr3:52347667-52347710,chr3,52347667,52347710,0,93786925
IMR90|chr3:147082470-147082524,chr3,147082470,147082524,IMR90|chr3:99982366-99982437,chr3,99982366,99982437,0,47100104
IMR90|chr3:147143771-147143807,chr3,147143771,147143807,IMR90|chr3:184532282-184532328,chr3,184532282,184532328,0,37388511
IMR90|chr3:147322221-147322300,chr3,147322221,147322300,IMR90|chr3:183896954-183896996,chr3,183896954,183896996,0,36574733
IMR90|chr3:148063676-148063703,chr3,148063676,148063703,IMR90|chr3:45270925-45271030,chr3,45270925,45271030,0,102792751
IMR90|chr3:148159257-148159347,chr3,148159257,148159347,IMR90|chr3:51573466-51573521,chr3,51573466,51573521,0,96585791
IMR90|chr3:149640259-149640283,chr3,149640259,149640283,IMR90|chr3:23806602-23806642,chr3,23806602,23806642,0,125833657
IMR90|chr3:149820678-149820762,chr3,149820678,149820762,IMR90|chr3:150263714-150263746,chr3,150263714,150263746,0,443036
IMR90|chr3:150236746-150236780,chr3,150236746,150236780,IMR90|chr3:128883602-128883706,chr3,128883602,128883706,0,21353144
IMR90|chr3:150699434-150699487,chr3,150699434,150699487,IMR90|chr3:12328009-12328106,chr3,12328009,12328106,0,138371425
IMR90|chr3:151730980-151731052,chr3,151730980,151731052,IMR90|chr3:47822986-47823035,chr3,47822986,47823035,0,103907994
IMR90|chr3:151739653-151739690,chr3,151739653,151739690,IMR90|chr3:128883602-128883706,chr3,128883602,128883706,0,22856051
IMR90|chr3:151837421-151837460,chr3,151837421,151837460,IMR90|chr3:73048924-73049027,chr3,73048924,73049027,0,78788497
IMR90|chr3:151993097-151993132,chr3,151993097,151993132,IMR90|chr3:99981740-99981804,chr3,99981740,99981804,0,52011357
IMR90|chr3:152491247-152491285,chr3,152491247,152491285,IMR90|chr3:120166693-120166799,chr3,120166693,120166799,0,32324554
IMR90|chr3:153115107-153115237,chr3,153115107,153115237,IMR90|chr3:187454649-187454684,chr3,187454649,187454684,0,34339542
IMR90|chr3:153119421-153119493,chr3,153119421,153119493,IMR90|chr3:185545025-185545087,chr3,185545025,185545087,0,32425604
IMR90|chr3:153391473-153391564,chr3,153391473,153391564,IMR90|chr3:50284087-50284146,chr3,50284087,50284146,0,103107386
IMR90|chr3:153508529-153508598,chr3,153508529,153508598,IMR90|chr3:48344455-48344503,chr3,48344455,48344503,0,105164074
IMR90|chr3:153536652-153536723,chr3,153536652,153536723,IMR90|chr3:63898642-63898705,chr3,63898642,63898705,0,89638010
IMR90|chr3:153570521-153570599,chr3,153570521,153570599,IMR90|chr3:187929430-187929479,chr3,187929430,187929479,0,34358909
IMR90|chr3:154204125-154204168,chr3,154204125,154204168,IMR90|chr3:44045137-44045188,chr3,44045137,44045188,0,110158988
IMR90|chr3:154233205-154233240,chr3,154233205,154233240,IMR90|chr3:66023049-66023133,chr3,66023049,66023133,0,88210156
IMR90|chr3:154485567-154485610,chr3,154485567,154485610,IMR90|chr3:123601986-123602136,chr3,123601986,123602136,0,30883581
IMR90|chr3:154818880-154818921,chr3,154818880,154818921,IMR90|chr3:52004387-52004422,chr3,52004387,52004422,0,102814493
IMR90|chr3:155222508-155222618,chr3,155222508,155222618,IMR90|chr3:142720980-142721020,chr3,142720980,142721020,0,12501528
IMR90|chr3:155225412-155225481,chr3,155225412,155225481,IMR90|chr3:186283889-186283968,chr3,186283889,186283968,0,31058477
IMR90|chr3:155370937-155371042,chr3,155370937,155371042,IMR90|chr3:55520410-55520454,chr3,55520410,55520454,0,99850527
IMR90|chr3:155908693-155908787,chr3,155908693,155908787,IMR90|chr3:128901133-128901188,chr3,128901133,128901188,0,27007560
IMR90|chr3:155976790-155976836,chr3,155976790,155976836,IMR90|chr3:182512163-182512263,chr3,182512163,182512263,0,26535373
IMR90|chr3:156412719-156412854,chr3,156412719,156412854,IMR90|chr3:150130198-150130280,chr3,150130198,150130280,0,6282521
IMR90|chr3:156771953-156771983,chr3,156771953,156771983,IMR90|chr3:48635844-48635929,chr3,48635844,48635929,0,108136109
IMR90|chr3:157050216-157050254,chr3,157050216,157050254,IMR90|chr3:159485657-159485755,chr3,159485657,159485755,0,2435441
IMR90|chr3:157121298-157121367,chr3,157121298,157121367,IMR90|chr3:55515632-55515701,chr3,55515632,55515701,0,101605666
IMR90|chr3:157266647-157266707,chr3,157266647,157266707,IMR90|chr3:64252609-64252638,chr3,64252609,64252638,0,93014038
IMR90|chr3:157303734-157303822,chr3,157303734,157303822,IMR90|chr3:110792095-110792145,chr3,110792095,110792145,0,46511639
IMR90|chr3:157463003-157463103,chr3,157463003,157463103,IMR90|chr3:38176981-38177019,chr3,38176981,38177019,0,119286022
IMR90|chr3:157469095-157469196,chr3,157469095,157469196,IMR90|chr3:195684406-195684447,chr3,195684406,195684447,0,38215311
IMR90|chr3:158676497-158676552,chr3,158676497,158676552,IMR90|chr3:196228677-196228785,chr3,196228677,196228785,0,37552180
IMR90|chr3:158711105-158711240,chr3,158711105,158711240,IMR90|chr3:150130198-150130280,chr3,150130198,150130280,0,8580907
IMR90|chr3:158883536-158883585,chr3,158883536,158883585,IMR90|chr3:122916430-122916548,chr3,122916430,122916548,0,35967106
IMR90|chr3:159643943-159643967,chr3,159643943,159643967,IMR90|chr3:23806602-23806642,chr3,23806602,23806642,0,135837341
IMR90|chr3:159846837-159846874,chr3,159846837,159846874,IMR90|chr3:150124331-150124396,chr3,150124331,150124396,0,9722506
IMR90|chr3:160272421-160272541,chr3,160272421,160272541,IMR90|chr3:55520410-55520454,chr3,55520410,55520454,0,104752011
IMR90|chr3:160729740-160729797,chr3,160729740,160729797,IMR90|chr3:149686564-149686655,chr3,149686564,149686655,0,11043176
IMR90|chr3:161576312-161576422,chr3,161576312,161576422,IMR90|chr3:150131894-150131933,chr3,150131894,150131933,0,11444418
IMR90|chr3:161576582-161576732,chr3,161576582,161576732,IMR90|chr3:187461059-187461101,chr3,187461059,187461101,0,25884477
IMR90|chr3:162034708-162034759,chr3,162034708,162034759,IMR90|chr3:50365013-50365105,chr3,50365013,50365105,0,111669695
IMR90|chr3:162255084-162255125,chr3,162255084,162255125,IMR90|chr3:159483750-159483818,chr3,159483750,159483818,0,2771334
IMR90|chr3:162679072-162679142,chr3,162679072,162679142,IMR90|chr3:50276499-50276573,chr3,50276499,50276573,0,112402573
IMR90|chr3:163170352-163170474,chr3,163170352,163170474,IMR90|chr3:10029172-10029200,chr3,10029172,10029200,0,153141180
IMR90|chr3:163350069-163350130,chr3,163350069,163350130,IMR90|chr3:57581557-57581646,chr3,57581557,57581646,0,105768512
IMR90|chr3:163986735-163986782,chr3,163986735,163986782,IMR90|chr3:9439681-9439783,chr3,9439681,9439783,0,154547054
IMR90|chr3:164223318-164223413,chr3,164223318,164223413,IMR90|chr3:50276208-50276284,chr3,50276208,50276284,0,113947110
IMR90|chr3:164231445-164231539,chr3,164231445,164231539,IMR90|chr3:136581162-136581309,chr3,136581162,136581309,0,27650283
IMR90|chr3:164504761-164504813,chr3,164504761,164504813,IMR90|chr3:57995891-57995991,chr3,57995891,57995991,0,106508870
IMR90|chr3:164534165-164534268,chr3,164534165,164534268,IMR90|chr3:15905455-15905546,chr3,15905455,15905546,0,148628710
IMR90|chr3:164598931-164599009,chr3,164598931,164599009,IMR90|chr3:55514332-55514387,chr3,55514332,55514387,0,109084599
IMR90|chr3:165039349-165039410,chr3,165039349,165039410,IMR90|chr3:64252603-64252638,chr3,64252603,64252638,0,100786746
IMR90|chr3:165237439-165237475,chr3,165237439,165237475,IMR90|chr3:184532282-184532328,chr3,184532282,184532328,0,19294843
IMR90|chr3:165265290-165265391,chr3,165265290,165265391,IMR90|chr3:38176981-38177019,chr3,38176981,38177019,0,127088309
IMR90|chr3:165597792-165597858,chr3,165597792,165597858,IMR90|chr3:23805252-23805336,chr3,23805252,23805336,0,141792540
IMR90|chr3:166333951-166334002,chr3,166333951,166334002,IMR90|chr3:98619232-98619309,chr3,98619232,98619309,0,67714719
IMR90|chr3:166400976-166401067,chr3,166400976,166401067,IMR90|chr3:51573466-51573521,chr3,51573466,51573521,0,114827510
IMR90|chr3:166447805-166447913,chr3,166447805,166447913,IMR90|chr3:142720980-142721019,chr3,142720980,142721019,0,23726825
IMR90|chr3:167024702-167024760,chr3,167024702,167024760,IMR90|chr3:9440162-9440213,chr3,9440162,9440213,0,157584540
IMR90|chr3:167142291-167142353,chr3,167142291,167142353,IMR90|chr3:27412253-27412308,chr3,27412253,27412308,0,139730038
IMR90|chr3:167272334-167272370,chr3,167272334,167272370,IMR90|chr3:33479940-33480078,chr3,33479940,33480078,0,133792394
IMR90|chr3:167331876-167331926,chr3,167331876,167331926,IMR90|chr3:139107740-139107803,chr3,139107740,139107803,0,28224136
IMR90|chr3:167540790-167540858,chr3,167540790,167540858,IMR90|chr3:50276031-50276127,chr3,50276031,50276127,0,117264759
IMR90|chr3:167571528-167571574,chr3,167571528,167571574,IMR90|chr3:48721772-48721821,chr3,48721772,48721821,0,118849756
IMR90|chr3:167674542-167674596,chr3,167674542,167674596,IMR90|chr3:99982366-99982437,chr3,99982366,99982437,0,67692176
IMR90|chr3:168889566-168889676,chr3,168889566,168889676,IMR90|chr3:142720980-142721020,chr3,142720980,142721020,0,26168586
IMR90|chr3:168958579-168958711,chr3,168958579,168958711,IMR90|chr3:187873055-187873155,chr3,187873055,187873155,0,18914476
IMR90|chr3:169254225-169254319,chr3,169254225,169254319,IMR90|chr3:156272118-156272135,chr3,156272118,156272135,0,12982107
IMR90|chr3:169291789-169291875,chr3,169291789,169291875,IMR90|chr3:128903255-128903315,chr3,128903255,128903315,0,40388534
IMR90|chr3:169465041-169465112,chr3,169465041,169465112,IMR90|chr3:37217153-37217222,chr3,37217153,37217222,0,132247888
IMR90|chr3:169842514-169842574,chr3,169842514,169842574,IMR90|chr3:9440162-9440213,chr3,9440162,9440213,0,160402352
IMR90|chr3:169940692-169940754,chr3,169940692,169940754,IMR90|chr3:27412253-27412308,chr3,27412253,27412308,0,142528439
IMR90|chr3:170080424-170080472,chr3,170080424,170080472,IMR90|chr3:12709716-12709788,chr3,12709716,12709788,0,157370708
IMR90|chr3:170244737-170244871,chr3,170244737,170244871,IMR90|chr3:128903259-128903315,chr3,128903259,128903315,0,41341478
IMR90|chr3:170386884-170386925,chr3,170386884,170386925,IMR90|chr3:159483750-159483818,chr3,159483750,159483818,0,10903134
IMR90|chr3:170643422-170643530,chr3,170643422,170643530,IMR90|chr3:187461059-187461101,chr3,187461059,187461101,0,16817637
IMR90|chr3:171054087-171054143,chr3,171054087,171054143,IMR90|chr3:185653772-185653823,chr3,185653772,185653823,0,14599685
IMR90|chr3:171088782-171088844,chr3,171088782,171088844,IMR90|chr3:53287677-53287728,chr3,53287677,53287728,0,117801105
IMR90|chr3:171089494-171089540,chr3,171089494,171089540,IMR90|chr3:50276031-50276127,chr3,50276031,50276127,0,120813463
IMR90|chr3:171471928-171472028,chr3,171471928,171472028,IMR90|chr3:38176981-38177019,chr3,38176981,38177019,0,133294947
IMR90|chr3:171602248-171602347,chr3,171602248,171602347,IMR90|chr3:9434250-9434293,chr3,9434250,9434293,0,162167998
IMR90|chr3:172170739-172170826,chr3,172170739,172170826,IMR90|chr3:194388402-194388451,chr3,194388402,194388451,0,22217663
IMR90|chr3:172253739-172253781,chr3,172253739,172253781,IMR90|chr3:156270010-156270080,chr3,156270010,156270080,0,15983729
IMR90|chr3:172342172-172342229,chr3,172342172,172342229,IMR90|chr3:149687753-149687811,chr3,149687753,149687811,0,22654419
IMR90|chr3:172559340-172559386,chr3,172559340,172559386,IMR90|chr3:193311267-193311325,chr3,193311267,193311325,0,20751927
IMR90|chr3:173239521-173239542,chr3,173239521,173239542,IMR90|chr3:99982366-99982437,chr3,99982366,99982437,0,73257155
IMR90|chr3:173411278-173411334,chr3,173411278,173411334,IMR90|chr3:196228677-196228785,chr3,196228677,196228785,0,22817399
IMR90|chr3:173613152-173613172,chr3,173613152,173613172,IMR90|chr3:98618335-98618457,chr3,98618335,98618457,0,74994817
IMR90|chr3:173790023-173790086,chr3,173790023,173790086,IMR90|chr3:184036791-184036857,chr3,184036791,184036857,0,10246768
IMR90|chr3:174054662-174054710,chr3,174054662,174054710,IMR90|chr3:193311487-193311596,chr3,193311487,193311596,0,19256825
IMR90|chr3:174241013-174241115,chr3,174241013,174241115,IMR90|chr3:150263714-150263746,chr3,150263714,150263746,0,23977299
IMR90|chr3:174311315-174311409,chr3,174311315,174311409,IMR90|chr3:27523973-27524082,chr3,27523973,27524082,0,146787342
IMR90|chr3:174684684-174684745,chr3,174684684,174684745,IMR90|chr3:135913101-135913128,chr3,135913101,135913128,0,38771583
IMR90|chr3:175851590-175851652,chr3,175851590,175851652,IMR90|chr3:53287677-53287728,chr3,53287677,53287728,0,122563913
IMR90|chr3:176174635-176174694,chr3,176174635,176174694,IMR90|chr3:12328009-12328106,chr3,12328009,12328106,0,163846626
IMR90|chr3:176882072-176882148,chr3,176882072,176882148,IMR90|chr3:15838596-15838677,chr3,15838596,15838677,0,161043476
IMR90|chr3:177004244-177004331,chr3,177004244,177004331,IMR90|chr3:194388402-194388451,chr3,194388402,194388451,0,17384158
IMR90|chr3:177134051-177134100,chr3,177134051,177134100,IMR90|chr3:122916430-122916548,chr3,122916430,122916548,0,54217621
IMR90|chr3:177345472-177345508,chr3,177345472,177345508,IMR90|chr3:9440915-9441028,chr3,9440915,9441028,0,167904557
IMR90|chr3:177380154-177380227,chr3,177380154,177380227,IMR90|chr3:98619393-98619448,chr3,98619393,98619448,0,78760761
IMR90|chr3:177772563-177772586,chr3,177772563,177772586,IMR90|chr3:14167589-14167698,chr3,14167589,14167698,0,163604974
IMR90|chr3:177837392-177837424,chr3,177837392,177837424,IMR90|chr3:194993378-194993471,chr3,194993378,194993471,0,17155986
IMR90|chr3:177919384-177919421,chr3,177919384,177919421,IMR90|chr3:150124331-150124396,chr3,150124331,150124396,0,27795053
IMR90|chr3:178462856-178462927,chr3,178462856,178462927,IMR90|chr3:63898642-63898705,chr3,63898642,63898705,0,114564214
IMR90|chr3:178903824-178903883,chr3,178903824,178903883,IMR90|chr3:180632999-180633090,chr3,180632999,180633090,0,1729175
IMR90|chr3:179435840-179435875,chr3,179435840,179435875,IMR90|chr3:66023049-66023133,chr3,66023049,66023133,0,113412791
IMR90|chr3:179778269-179778374,chr3,179778269,179778374,IMR90|chr3:120170534-120170579,chr3,120170534,120170579,0,59607735
IMR90|chr3:179785435-179785486,chr3,179785435,179785486,IMR90|chr3:128903216-128903315,chr3,128903216,128903315,0,50882219
IMR90|chr3:179963582-179963628,chr3,179963582,179963628,IMR90|chr3:182512163-182512263,chr3,182512163,182512263,0,2548581
IMR90|chr3:180136669-180136734,chr3,180136669,180136734,IMR90|chr3:151987721-151987787,chr3,151987721,151987787,0,28148948
IMR90|chr3:180332086-180332163,chr3,180332086,180332163,IMR90|chr3:45018176-45018249,chr3,45018176,45018249,0,135313910
IMR90|chr3:180662838-180662934,chr3,180662838,180662934,IMR90|chr3:52439622-52439681,chr3,52439622,52439681,0,128223216
IMR90|chr3:181014032-181014101,chr3,181014032,181014101,IMR90|chr3:49132427-49132496,chr3,49132427,49132496,0,131881605
IMR90|chr3:181270422-181270498,chr3,181270422,181270498,IMR90|chr3:112737635-112737709,chr3,112737635,112737709,0,68532787
IMR90|chr3:181420100-181420200,chr3,181420100,181420200,IMR90|chr3:48343475-48343514,chr3,48343475,48343514,0,133076625
IMR90|chr3:182735787-182735829,chr3,182735787,182735829,IMR90|chr3:69135147-69135214,chr3,69135147,69135214,0,113600640
IMR90|chr3:182850790-182850912,chr3,182850790,182850912,IMR90|chr3:10029172-10029200,chr3,10029172,10029200,0,172821618
IMR90|chr3:183742990-183743011,chr3,183742990,183743011,IMR90|chr3:14167589-14167698,chr3,14167589,14167698,0,169575401
IMR90|chr3:184821762-184821818,chr3,184821762,184821818,IMR90|chr3:196228677-196228785,chr3,196228677,196228785,0,11406915
IMR90|chr3:185370412-185370470,chr3,185370412,185370470,IMR90|chr3:30649449-30649523,chr3,30649449,30649523,0,154720963
IMR90|chr3:185591689-185591802,chr3,185591689,185591802,IMR90|chr3:184034690-184034743,chr3,184034690,184034743,0,1556999
IMR90|chr3:185620705-185620750,chr3,185620705,185620750,IMR90|chr3:194993434-194993504,chr3,194993434,194993504,0,9372729
IMR90|chr3:186004091-186004155,chr3,186004091,186004155,IMR90|chr3:15901802-15901838,chr3,15901802,15901838,0,170102289
IMR90|chr3:186054827-186054886,chr3,186054827,186054886,IMR90|chr3:180632999-180633090,chr3,180632999,180633090,0,5421828
IMR90|chr3:186770652-186770707,chr3,186770652,186770707,IMR90|chr3:196228677-196228785,chr3,196228677,196228785,0,9458025
IMR90|chr3:186902852-186902978,chr3,186902852,186902978,IMR90|chr3:48482766-48482873,chr3,48482766,48482873,0,138420086
IMR90|chr3:188046524-188046578,chr3,188046524,188046578,IMR90|chr3:194388130-194388244,chr3,194388130,194388244,0,6341606
IMR90|chr3:188323344-188323382,chr3,188323344,188323382,IMR90|chr3:159483750-159483818,chr3,159483750,159483818,0,28839594
IMR90|chr3:189314002-189314057,chr3,189314002,189314057,IMR90|chr3:149686564-149686655,chr3,149686564,149686655,0,39627438
IMR90|chr3:189729068-189729112,chr3,189729068,189729112,IMR90|chr3:185544272-185544337,chr3,185544272,185544337,0,4184796
IMR90|chr3:190249759-190249807,chr3,190249759,190249807,IMR90|chr3:193311487-193311596,chr3,193311487,193311596,0,3061728
IMR90|chr3:190354533-190354634,chr3,190354533,190354634,IMR90|chr3:195684406-195684447,chr3,195684406,195684447,0,5329873
IMR90|chr3:191025158-191025234,chr3,191025158,191025234,IMR90|chr3:120168132-120168186,chr3,120168132,120168186,0,70857026
IMR90|chr3:191240707-191240781,chr3,191240707,191240781,IMR90|chr3:12706623-12706688,chr3,12706623,12706688,0,178534084
IMR90|chr3:191267168-191267298,chr3,191267168,191267298,IMR90|chr3:187454649-187454684,chr3,187454649,187454684,0,3812519
IMR90|chr3:191269732-191269757,chr3,191269732,191269757,IMR90|chr3:39450784-39450934,chr3,39450784,39450934,0,151818948
IMR90|chr3:191668938-191668976,chr3,191668938,191668976,IMR90|chr3:159483750-159483818,chr3,159483750,159483818,0,32185188
IMR90|chr3:191822275-191822361,chr3,191822275,191822361,IMR90|chr3:128903255-128903315,chr3,128903255,128903315,0,62919020
IMR90|chr3:192362279-192362325,chr3,192362279,192362325,IMR90|chr3:12328009-12328106,chr3,12328009,12328106,0,180034270
IMR90|chr3:192374768-192374825,chr3,192374768,192374825,IMR90|chr3:120169364-120169419,chr3,120169364,120169419,0,72205404
IMR90|chr3:192496467-192496531,chr3,192496467,192496531,IMR90|chr3:151987720-151987787,chr3,151987720,151987787,0,40508747
IMR90|chr3:192802081-192802101,chr3,192802081,192802101,IMR90|chr3:98618335-98618457,chr3,98618335,98618457,0,94183746
IMR90|chr3:193213348-193213375,chr3,193213348,193213375,IMR90|chr3:45270925-45271030,chr3,45270925,45271030,0,147942423
IMR90|chr3:193267663-193267733,chr3,193267663,193267733,IMR90|chr3:50276499-50276573,chr3,50276499,50276573,0,142991164
IMR90|chr3:193489731-193489761,chr3,193489731,193489761,IMR90|chr3:123303123-123303173,chr3,123303123,123303173,0,70186608
IMR90|chr3:193672611-193672654,chr3,193672611,193672654,IMR90|chr3:128906788-128906846,chr3,128906788,128906846,0,64765823
IMR90|chr3:194151419-194151553,chr3,194151419,194151553,IMR90|chr3:128903259-128903315,chr3,128903259,128903315,0,65248160
IMR90|chr3:194219910-194219982,chr3,194219910,194219982,IMR90|chr3:39451399-39451524,chr3,39451399,39451524,0,154768511
IMR90|chr3:194250281-194250338,chr3,194250281,194250338,IMR90|chr3:185547403-185547472,chr3,185547403,185547472,0,8702878
IMR90|chr3:194432299-194432409,chr3,194432299,194432409,IMR90|chr3:150131894-150131933,chr3,150131894,150131933,0,44300405
IMR90|chr3:194495486-194495534,chr3,194495486,194495534,IMR90|chr3:184532447-184532496,chr3,184532447,184532496,0,9963039
IMR90|chr3:194748264-194748371,chr3,194748264,194748371,IMR90|chr3:120170534-120170579,chr3,120170534,120170579,0,74577730
IMR90|chr3:195022916-195022979,chr3,195022916,195022979,IMR90|chr3:128906088-128906141,chr3,128906088,128906141,0,66116828
IMR90|chr3:195066587-195066639,chr3,195066587,195066639,IMR90|chr3:140951171-140951244,chr3,140951171,140951244,0,54115416
IMR90|chr3:195297272-195297326,chr3,195297272,195297326,IMR90|chr3:156270937-156271056,chr3,156270937,156271056,0,39026335
IMR90|chr3:195672955-195673010,chr3,195672955,195673010,IMR90|chr3:149687754-149687811,chr3,149687754,149687811,0,45985201
IMR90|chr3:195693285-195693353,chr3,195693285,195693353,IMR90|chr3:53287011-53287077,chr3,53287011,53287077,0,142406274
IMR90|chr3:197069481-197069549,chr3,197069481,197069549,IMR90|chr3:53287011-53287077,chr3,53287011,53287077,0,143782470
IMR90|chr3:197250248-197250302,chr3,197250248,197250302,IMR90|chr3:132376918-132377014,chr3,132376918,132377014,0,64873330
IMR90|chr3:197641177-197641218,chr3,197641177,197641218,IMR90|chr3:193311487-193311596,chr3,193311487,193311596,0,4329690
IMR90|chr3:197842695-197842779,chr3,197842695,197842779,IMR90|chr3:9432286-9432345,chr3,9432286,9432345,0,188410409
IMR90|chr3:197888797-197888860,chr3,197888797,197888860,IMR90|chr3:15901802-15901838,chr3,15901802,15901838,0,181986995
IMR90|chr4:280733-280864,chr4,280733,280864,IMR90|chr4:81192168-81192233,chr4,81192168,81192233,0,80911435
IMR90|chr4:665887-665973,chr4,665887,665973,IMR90|chr4:83349875-83349896,chr4,83349875,83349896,0,82683988
IMR90|chr4:2011235-2011292,chr4,2011235,2011292,IMR90|chr4:177712733-177712848,chr4,177712733,177712848,0,175701498
IMR90|chr4:3531395-3531496,chr4,3531395,3531496,IMR90|chr4:177713229-177713257,chr4,177713229,177713257,0,174181834
IMR90|chr4:6353054-6353120,chr4,6353054,6353120,IMR90|chr4:57842027-57842115,chr4,57842027,57842115,0,51488973
IMR90|chr4:7491064-7491109,chr4,7491064,7491109,IMR90|chr4:139938418-139938523,chr4,139938418,139938523,0,132447354
IMR90|chr4:8517384-8517488,chr4,8517384,8517488,IMR90|chr4:177712575-177712613,chr4,177712575,177712613,0,169195191
IMR90|chr4:9630372-9630423,chr4,9630372,9630423,IMR90|chr4:128797731-128797769,chr4,128797731,128797769,0,119167359
IMR90|chr4:10131952-10132053,chr4,10131952,10132053,IMR90|chr4:177713229-177713257,chr4,177713229,177713257,0,167581277
IMR90|chr4:10319804-10319875,chr4,10319804,10319875,IMR90|chr4:139937939-139937996,chr4,139937939,139937996,0,129618135
IMR90|chr4:11105035-11105151,chr4,11105035,11105151,IMR90|chr4:178365522-178365650,chr4,178365522,178365650,0,167260487
IMR90|chr4:11264203-11264248,chr4,11264203,11264248,IMR90|chr4:139938418-139938523,chr4,139938418,139938523,0,128674215
IMR90|chr4:11535567-11535610,chr4,11535567,11535610,IMR90|chr4:99578267-99578311,chr4,99578267,99578311,0,88042700
IMR90|chr4:11571535-11571586,chr4,11571535,11571586,IMR90|chr4:128797731-128797769,chr4,128797731,128797769,0,117226196
IMR90|chr4:12035232-12035283,chr4,12035232,12035283,IMR90|chr4:73936556-73936607,chr4,73936556,73936607,0,61901324
IMR90|chr4:12300152-12300172,chr4,12300152,12300172,IMR90|chr4:73935651-73935717,chr4,73935651,73935717,0,61635499
IMR90|chr4:12570872-12570959,chr4,12570872,12570959,IMR90|chr4:128797735-128797769,chr4,128797735,128797769,0,116226863
IMR90|chr4:13695481-13695502,chr4,13695481,13695502,IMR90|chr4:55525119-55525223,chr4,55525119,55525223,0,41829638
IMR90|chr4:16322012-16322106,chr4,16322012,16322106,IMR90|chr4:71767083-71767138,chr4,71767083,71767138,0,55445071
IMR90|chr4:17406802-17406931,chr4,17406802,17406931,IMR90|chr4:83293689-83293775,chr4,83293689,83293775,0,65886887
IMR90|chr4:17646297-17646317,chr4,17646297,17646317,IMR90|chr4:8441167-8441208,chr4,8441167,8441208,0,9205130
IMR90|chr4:19274767-19274832,chr4,19274767,19274832,IMR90|chr4:99849365-99849448,chr4,99849365,99849448,0,80574598
IMR90|chr4:19582030-19582112,chr4,19582030,19582112,IMR90|chr4:26854343-26854484,chr4,26854343,26854484,0,7272313
IMR90|chr4:19595564-19595607,chr4,19595564,19595607,IMR90|chr4:39458388-39458495,chr4,39458388,39458495,0,19862824
IMR90|chr4:19639710-19639766,chr4,19639710,19639766,IMR90|chr4:103748513-103748585,chr4,103748513,103748585,0,84108803
IMR90|chr4:20013763-20013858,chr4,20013763,20013858,IMR90|chr4:81192168-81192233,chr4,81192168,81192233,0,61178405
IMR90|chr4:21607287-21607364,chr4,21607287,21607364,IMR90|chr4:775117-775239,chr4,775117,775239,0,20832170
IMR90|chr4:27529278-27529343,chr4,27529278,27529343,IMR90|chr4:57330255-57330291,chr4,57330255,57330291,0,29800977
IMR90|chr4:28511995-28512131,chr4,28511995,28512131,IMR90|chr4:157891115-157891172,chr4,157891115,157891172,0,129379120
IMR90|chr4:28612544-28612611,chr4,28612544,28612611,IMR90|chr4:129213288-129213330,chr4,129213288,129213330,0,100600744
IMR90|chr4:29038725-29038795,chr4,29038725,29038795,IMR90|chr4:177710332-177710381,chr4,177710332,177710381,0,148671607
IMR90|chr4:29244484-29244522,chr4,29244484,29244522,IMR90|chr4:74088300-74088414,chr4,74088300,74088414,0,44843816
IMR90|chr4:29245510-29245578,chr4,29245510,29245578,IMR90|chr4:7069036-7069118,chr4,7069036,7069118,0,22176474
IMR90|chr4:29278977-29279064,chr4,29278977,29279064,IMR90|chr4:128797735-128797769,chr4,128797735,128797769,0,99518758
IMR90|chr4:29415515-29415592,chr4,29415515,29415592,IMR90|chr4:160025598-160025663,chr4,160025598,160025663,0,130610083
IMR90|chr4:29657565-29657610,chr4,29657565,29657610,IMR90|chr4:57330186-57330291,chr4,57330186,57330291,0,27672621
IMR90|chr4:30111301-30111432,chr4,30111301,30111432,IMR90|chr4:81192168-81192233,chr4,81192168,81192233,0,51080867
IMR90|chr4:30873329-30873399,chr4,30873329,30873399,IMR90|chr4:77906872-77906931,chr4,77906872,77906931,0,47033543
IMR90|chr4:31259587-31259646,chr4,31259587,31259646,IMR90|chr4:47840222-47840299,chr4,47840222,47840299,0,16580635
IMR90|chr4:31557502-31557530,chr4,31557502,31557530,IMR90|chr4:139938008-139938124,chr4,139938008,139938124,0,108380506
IMR90|chr4:31838678-31838769,chr4,31838678,31838769,IMR90|chr4:177712293-177712352,chr4,177712293,177712352,0,145873615
IMR90|chr4:32053037-32053085,chr4,32053037,32053085,IMR90|chr4:122617566-122617668,chr4,122617566,122617668,0,90564529
IMR90|chr4:32414398-32414418,chr4,32414398,32414418,IMR90|chr4:73935651-73935717,chr4,73935651,73935717,0,41521253
IMR90|chr4:32583727-32583821,chr4,32583727,32583821,IMR90|chr4:71767083-71767138,chr4,71767083,71767138,0,39183356
IMR90|chr4:33030846-33030996,chr4,33030846,33030996,IMR90|chr4:114897724-114897770,chr4,114897724,114897770,0,81866878
IMR90|chr4:34229867-34229951,chr4,34229867,34229951,IMR90|chr4:56263407-56263469,chr4,56263407,56263469,0,22033540
IMR90|chr4:34639741-34639793,chr4,34639741,34639793,IMR90|chr4:157891677-157891752,chr4,157891677,157891752,0,123251936
IMR90|chr4:35574977-35575112,chr4,35574977,35575112,IMR90|chr4:26856254-26856307,chr4,26856254,26856307,0,8718723
IMR90|chr4:36634609-36634652,chr4,36634609,36634652,IMR90|chr4:187646349-187646430,chr4,187646349,187646430,0,151011740
IMR90|chr4:37725075-37725124,chr4,37725075,37725124,IMR90|chr4:47840295-47840403,chr4,47840295,47840403,0,10115220
IMR90|chr4:37818480-37818516,chr4,37818480,37818516,IMR90|chr4:81190227-81190282,chr4,81190227,81190282,0,43371747
IMR90|chr4:38065139-38065161,chr4,38065139,38065161,IMR90|chr4:123748541-123748669,chr4,123748541,123748669,0,85683402
IMR90|chr4:38346986-38347089,chr4,38346986,38347089,IMR90|chr4:83293689-83293775,chr4,83293689,83293775,0,44946703
IMR90|chr4:38595981-38596008,chr4,38595981,38596008,IMR90|chr4:74088300-74088414,chr4,74088300,74088414,0,35492319
IMR90|chr4:39384566-39384642,chr4,39384566,39384642,IMR90|chr4:77129876-77129946,chr4,77129876,77129946,0,37745310
IMR90|chr4:41224758-41224786,chr4,41224758,41224786,IMR90|chr4:775117-775239,chr4,775117,775239,0,40449641
IMR90|chr4:41282568-41282623,chr4,41282568,41282623,IMR90|chr4:157891166-157891261,chr4,157891166,157891261,0,116608598
IMR90|chr4:41497350-41497418,chr4,41497350,41497418,IMR90|chr4:177710308-177710390,chr4,177710308,177710390,0,136212958
IMR90|chr4:41764209-41764295,chr4,41764209,41764295,IMR90|chr4:128797735-128797769,chr4,128797735,128797769,0,87033526
IMR90|chr4:41768222-41768326,chr4,41768222,41768326,IMR90|chr4:114897724-114897770,chr4,114897724,114897770,0,73129502
IMR90|chr4:42036655-42036717,chr4,42036655,42036717,IMR90|chr4:47840222-47840299,chr4,47840222,47840299,0,5803567
IMR90|chr4:42408896-42408924,chr4,42408896,42408924,IMR90|chr4:139938008-139938124,chr4,139938008,139938124,0,97529112
IMR90|chr4:42512221-42512294,chr4,42512221,42512294,IMR90|chr4:129213461-129213501,chr4,129213461,129213501,0,86701240
IMR90|chr4:43140472-43140493,chr4,43140472,43140493,IMR90|chr4:55525119-55525223,chr4,55525119,55525223,0,12384647
IMR90|chr4:45547443-45547489,chr4,45547443,45547489,IMR90|chr4:76866094-76866229,chr4,76866094,76866229,0,31318651
IMR90|chr4:46002375-46002399,chr4,46002375,46002399,IMR90|chr4:122617220-122617324,chr4,122617220,122617324,0,76614845
IMR90|chr4:47021975-47022026,chr4,47021975,47022026,IMR90|chr4:73936556-73936607,chr4,73936556,73936607,0,26914581
IMR90|chr4:47413143-47413227,chr4,47413143,47413227,IMR90|chr4:56263407-56263469,chr4,56263407,56263469,0,8850264
IMR90|chr4:47537555-47537618,chr4,47537555,47537618,IMR90|chr4:99849365-99849448,chr4,99849365,99849448,0,52311810
IMR90|chr4:49418712-49418831,chr4,49418712,49418831,IMR90|chr4:76866094-76866229,chr4,76866094,76866229,0,27447382
IMR90|chr4:49755537-49755592,chr4,49755537,49755592,IMR90|chr4:157891166-157891261,chr4,157891166,157891261,0,108135629
IMR90|chr4:50022134-50022158,chr4,50022134,50022158,IMR90|chr4:122617220-122617324,chr4,122617220,122617324,0,72595086
IMR90|chr4:51018800-51018901,chr4,51018800,51018901,IMR90|chr4:57845312-57845358,chr4,57845312,57845358,0,6826512
IMR90|chr4:53637526-53637617,chr4,53637526,53637617,IMR90|chr4:128797735-128797769,chr4,128797735,128797769,0,75160209
IMR90|chr4:54182722-54182826,chr4,54182722,54182826,IMR90|chr4:114897724-114897770,chr4,114897724,114897770,0,60715002
IMR90|chr4:54611948-54612000,chr4,54611948,54612000,IMR90|chr4:103748513-103748585,chr4,103748513,103748585,0,49136565
IMR90|chr4:55080150-55080169,chr4,55080150,55080169,IMR90|chr4:55525119-55525223,chr4,55525119,55525223,0,444969
IMR90|chr4:55836952-55837070,chr4,55836952,55837070,IMR90|chr4:76866095-76866229,chr4,76866095,76866229,0,21029143
IMR90|chr4:56091928-56092025,chr4,56091928,56092025,IMR90|chr4:26856254-26856307,chr4,26856254,26856307,0,29235674
IMR90|chr4:56169461-56169607,chr4,56169461,56169607,IMR90|chr4:56263925-56263995,chr4,56263925,56263995,0,94464
IMR90|chr4:56420846-56420922,chr4,56420846,56420922,IMR90|chr4:120547970-120548044,chr4,120547970,120548044,0,64127124
IMR90|chr4:57557184-57557255,chr4,57557184,57557255,IMR90|chr4:139937939-139937996,chr4,139937939,139937996,0,82380755
IMR90|chr4:57671418-57671453,chr4,57671418,57671453,IMR90|chr4:177712733-177712848,chr4,177712733,177712848,0,120041315
IMR90|chr4:57707139-57707187,chr4,57707139,57707187,IMR90|chr4:129208056-129208137,chr4,129208056,129208137,0,71500917
IMR90|chr4:58575900-58575992,chr4,58575900,58575992,IMR90|chr4:177712770-177712818,chr4,177712770,177712818,0,119136870
IMR90|chr4:58776489-58776536,chr4,58776489,58776536,IMR90|chr4:177710356-177710433,chr4,177710356,177710433,0,118933867
IMR90|chr4:59915817-59915882,chr4,59915817,59915882,IMR90|chr4:99849365-99849448,chr4,99849365,99849448,0,39933548
IMR90|chr4:60041582-60041693,chr4,60041582,60041693,IMR90|chr4:38666474-38666555,chr4,38666474,38666555,0,21375108
IMR90|chr4:61145989-61146056,chr4,61145989,61146056,IMR90|chr4:129213288-129213330,chr4,129213288,129213330,0,68067299
IMR90|chr4:61291104-61291154,chr4,61291104,61291154,IMR90|chr4:56265241-56265298,chr4,56265241,56265298,0,5025863
IMR90|chr4:62346699-62346728,chr4,62346699,62346728,IMR90|chr4:123748541-123748669,chr4,123748541,123748669,0,61401842
IMR90|chr4:62459561-62459662,chr4,62459561,62459662,IMR90|chr4:81122811-81122836,chr4,81122811,81122836,0,18663250
IMR90|chr4:62792707-62792750,chr4,62792707,62792750,IMR90|chr4:99578267-99578311,chr4,99578267,99578311,0,36785560
IMR90|chr4:63360007-63360044,chr4,63360007,63360044,IMR90|chr4:2244120-2244235,chr4,2244120,2244235,0,61115887
IMR90|chr4:64442073-64442130,chr4,64442073,64442130,IMR90|chr4:104021370-104021394,chr4,104021370,104021394,0,39579297
IMR90|chr4:64651022-64651094,chr4,64651022,64651094,IMR90|chr4:186391819-186391884,chr4,186391819,186391884,0,121740797
IMR90|chr4:65752900-65752936,chr4,65752900,65752936,IMR90|chr4:81190227-81190282,chr4,81190227,81190282,0,15437327
IMR90|chr4:66553255-66553326,chr4,66553255,66553326,IMR90|chr4:77906872-77906931,chr4,77906872,77906931,0,11353617
IMR90|chr4:67337006-67337097,chr4,67337006,67337097,IMR90|chr4:128797735-128797769,chr4,128797735,128797769,0,61460729
IMR90|chr4:67476046-67476126,chr4,67476046,67476126,IMR90|chr4:56263925-56263995,chr4,56263925,56263995,0,11212121
IMR90|chr4:68537330-68537410,chr4,68537330,68537410,IMR90|chr4:160025598-160025663,chr4,160025598,160025663,0,91488268
IMR90|chr4:68711931-68712013,chr4,68711931,68712013,IMR90|chr4:26854343-26854484,chr4,26854343,26854484,0,41857588
IMR90|chr4:70513277-70513354,chr4,70513277,70513354,IMR90|chr4:160025598-160025663,chr4,160025598,160025663,0,89512321
IMR90|chr4:70614957-70615037,chr4,70614957,70615037,IMR90|chr4:160025598-160025663,chr4,160025598,160025663,0,89410641
IMR90|chr4:70811721-70811744,chr4,70811721,70811744,IMR90|chr4:57975509-57975598,chr4,57975509,57975598,0,12836212
IMR90|chr4:70841653-70841771,chr4,70841653,70841771,IMR90|chr4:76866095-76866229,chr4,76866095,76866229,0,6024442
IMR90|chr4:73179171-73179217,chr4,73179171,73179217,IMR90|chr4:76866094-76866229,chr4,76866094,76866229,0,3686923
IMR90|chr4:73426795-73426814,chr4,73426795,73426814,IMR90|chr4:55525119-55525223,chr4,55525119,55525223,0,17901676
IMR90|chr4:73536239-73536378,chr4,73536239,73536378,IMR90|chr4:122616446-122616484,chr4,122616446,122616484,0,49080207
IMR90|chr4:74792953-74793010,chr4,74792953,74793010,IMR90|chr4:56265242-56265327,chr4,56265242,56265327,0,18527711
IMR90|chr4:75380088-75380200,chr4,75380088,75380200,IMR90|chr4:122616446-122616484,chr4,122616446,122616484,0,47236358
IMR90|chr4:77936105-77936142,chr4,77936105,77936142,IMR90|chr4:2244120-2244235,chr4,2244120,2244235,0,75691985
IMR90|chr4:78500647-78500711,chr4,78500647,78500711,IMR90|chr4:83293689-83293775,chr4,83293689,83293775,0,4793042
IMR90|chr4:80522212-80522298,chr4,80522212,80522298,IMR90|chr4:122614799-122614896,chr4,122614799,122614896,0,42092587
IMR90|chr4:83373771-83373828,chr4,83373771,83373828,IMR90|chr4:104021370-104021394,chr4,104021370,104021394,0,20647599
IMR90|chr4:83810589-83810637,chr4,83810589,83810637,IMR90|chr4:122617566-122617668,chr4,122617566,122617668,0,38806977
IMR90|chr4:84222345-84222481,chr4,84222345,84222481,IMR90|chr4:157891115-157891172,chr4,157891115,157891172,0,73668770
IMR90|chr4:84460713-84460812,chr4,84460713,84460812,IMR90|chr4:120548001-120548052,chr4,120548001,120548052,0,36087288
IMR90|chr4:85165954-85166001,chr4,85165954,85166001,IMR90|chr4:177710356-177710433,chr4,177710356,177710433,0,92544402
IMR90|chr4:85932652-85932715,chr4,85932652,85932715,IMR90|chr4:99849365-99849448,chr4,99849365,99849448,0,13916713
IMR90|chr4:86025859-86025902,chr4,86025859,86025902,IMR90|chr4:39458388-39458495,chr4,39458388,39458495,0,46567471
IMR90|chr4:87653410-87653501,chr4,87653410,87653501,IMR90|chr4:177712293-177712352,chr4,177712293,177712352,0,90058883
IMR90|chr4:87993167-87993296,chr4,87993167,87993296,IMR90|chr4:83293689-83293775,chr4,83293689,83293775,0,4699478
IMR90|chr4:89457097-89457119,chr4,89457097,89457119,IMR90|chr4:123748541-123748669,chr4,123748541,123748669,0,34291444
IMR90|chr4:90003821-90003855,chr4,90003821,90003855,IMR90|chr4:7940297-7940446,chr4,7940297,7940446,0,82063524
IMR90|chr4:90611697-90611792,chr4,90611697,90611792,IMR90|chr4:177712293-177712352,chr4,177712293,177712352,0,87100596
IMR90|chr4:90846165-90846235,chr4,90846165,90846235,IMR90|chr4:178365542-178365579,chr4,178365542,178365579,0,87519377
IMR90|chr4:94239512-94239605,chr4,94239512,94239605,IMR90|chr4:157891115-157891172,chr4,157891115,157891172,0,63651603
IMR90|chr4:94700600-94700665,chr4,94700600,94700665,IMR90|chr4:139937939-139937996,chr4,139937939,139937996,0,45237339
IMR90|chr4:94790647-94790768,chr4,94790647,94790768,IMR90|chr4:41215355-41215401,chr4,41215355,41215401,0,53575292
IMR90|chr4:95794659-95794716,chr4,95794659,95794716,IMR90|chr4:177712733-177712848,chr4,177712733,177712848,0,81918074
IMR90|chr4:98349375-98349431,chr4,98349375,98349431,IMR90|chr4:104025672-104025759,chr4,104025672,104025759,0,5676297
IMR90|chr4:98823232-98823296,chr4,98823232,98823296,IMR90|chr4:57842027-57842115,chr4,57842027,57842115,0,40981205
IMR90|chr4:99653683-99653759,chr4,99653683,99653759,IMR90|chr4:775117-775239,chr4,775117,775239,0,98878566
IMR90|chr4:100239844-100239943,chr4,100239844,100239943,IMR90|chr4:120548001-120548052,chr4,120548001,120548052,0,20308157
IMR90|chr4:100687119-100687219,chr4,100687119,100687219,IMR90|chr4:57845312-57845358,chr4,57845312,57845358,0,42841807
IMR90|chr4:100841343-100841493,chr4,100841343,100841493,IMR90|chr4:114897724-114897770,chr4,114897724,114897770,0,14056381
IMR90|chr4:101046384-101046450,chr4,101046384,101046450,IMR90|chr4:178365542-178365579,chr4,178365542,178365579,0,77319158
IMR90|chr4:101417967-101418019,chr4,101417967,101418019,IMR90|chr4:56264144-56264222,chr4,56264144,56264222,0,45153823
IMR90|chr4:102129500-102129535,chr4,102129500,102129535,IMR90|chr4:177712733-177712848,chr4,177712733,177712848,0,75583233
IMR90|chr4:102918160-102918263,chr4,102918160,102918263,IMR90|chr4:83293689-83293775,chr4,83293689,83293775,0,19624471
IMR90|chr4:103700001-103700071,chr4,103700001,103700071,IMR90|chr4:178365542-178365579,chr4,178365542,178365579,0,74665541
IMR90|chr4:104075275-104075325,chr4,104075275,104075325,IMR90|chr4:56265241-56265298,chr4,56265241,56265298,0,47810034
IMR90|chr4:104162306-104162392,chr4,104162306,104162392,IMR90|chr4:128797735-128797769,chr4,128797735,128797769,0,24635429
IMR90|chr4:104624572-104624658,chr4,104624572,104624658,IMR90|chr4:122614799-122614896,chr4,122614799,122614896,0,17990227
IMR90|chr4:105016563-105016648,chr4,105016563,105016648,IMR90|chr4:177710308-177710390,chr4,177710308,177710390,0,72693745
IMR90|chr4:105374918-105374946,chr4,105374918,105374946,IMR90|chr4:775117-775239,chr4,775117,775239,0,104599801
IMR90|chr4:105446313-105446350,chr4,105446313,105446350,IMR90|chr4:77869041-77869087,chr4,77869041,77869087,0,27577272
IMR90|chr4:105589025-105589109,chr4,105589025,105589109,IMR90|chr4:77908368-77908518,chr4,77908368,77908518,0,27680657
IMR90|chr4:106083854-106083919,chr4,106083854,106083919,IMR90|chr4:57330255-57330291,chr4,57330255,57330291,0,48753599
IMR90|chr4:107068094-107068164,chr4,107068094,107068164,IMR90|chr4:177710332-177710381,chr4,177710332,177710381,0,70642238
IMR90|chr4:107480308-107480367,chr4,107480308,107480367,IMR90|chr4:47840222-47840299,chr4,47840222,47840299,0,59640086
IMR90|chr4:108068345-108068365,chr4,108068345,108068365,IMR90|chr4:8441167-8441208,chr4,8441167,8441208,0,99627178
IMR90|chr4:108091015-108091117,chr4,108091015,108091117,IMR90|chr4:81122811-81122836,chr4,81122811,81122836,0,26968204
IMR90|chr4:108231027-108231100,chr4,108231027,108231100,IMR90|chr4:177710332-177710381,chr4,177710332,177710381,0,69479305
IMR90|chr4:108998416-108998484,chr4,108998416,108998484,IMR90|chr4:7069036-7069118,chr4,7069036,7069118,0,101929380
IMR90|chr4:109342485-109342580,chr4,109342485,109342580,IMR90|chr4:177712293-177712352,chr4,177712293,177712352,0,68369808
IMR90|chr4:110801023-110801089,chr4,110801023,110801089,IMR90|chr4:57842027-57842115,chr4,57842027,57842115,0,52958996
IMR90|chr4:110840972-110841070,chr4,110840972,110841070,IMR90|chr4:4252225-4252278,chr4,4252225,4252278,0,106588747
IMR90|chr4:110856500-110856549,chr4,110856500,110856549,IMR90|chr4:104025672-104025759,chr4,104025672,104025759,0,6830828
IMR90|chr4:110966951-110967000,chr4,110966951,110967000,IMR90|chr4:139938151-139938246,chr4,139938151,139938246,0,28971200
IMR90|chr4:111738036-111738070,chr4,111738036,111738070,IMR90|chr4:7940297-7940446,chr4,7940297,7940446,0,103797739
IMR90|chr4:113607646-113607719,chr4,113607646,113607719,IMR90|chr4:177710332-177710381,chr4,177710332,177710381,0,64102686
IMR90|chr4:116429458-116429558,chr4,116429458,116429558,IMR90|chr4:57845312-57845358,chr4,57845312,57845358,0,58584146
IMR90|chr4:116680295-116680322,chr4,116680295,116680322,IMR90|chr4:74088300-74088414,chr4,74088300,74088414,0,42591995
IMR90|chr4:119262970-119263022,chr4,119262970,119263022,IMR90|chr4:77872069-77872139,chr4,77872069,77872139,0,41390901
IMR90|chr4:122106340-122106393,chr4,122106340,122106393,IMR90|chr4:122744487-122744537,chr4,122744487,122744537,0,638147
IMR90|chr4:122558346-122558411,chr4,122558346,122558411,IMR90|chr4:139937939-139937996,chr4,139937939,139937996,0,17379593
IMR90|chr4:124483157-124483259,chr4,124483157,124483259,IMR90|chr4:81122811-81122836,chr4,81122811,81122836,0,43360346
IMR90|chr4:124822537-124822593,chr4,124822537,124822593,IMR90|chr4:103748513-103748585,chr4,103748513,103748585,0,21074024
IMR90|chr4:124839848-124839900,chr4,124839848,124839900,IMR90|chr4:77872069-77872139,chr4,77872069,77872139,0,46967779
IMR90|chr4:125606753-125606829,chr4,125606753,125606829,IMR90|chr4:148655174-148655231,chr4,148655174,148655231,0,23048421
IMR90|chr4:126305463-126305562,chr4,126305463,126305562,IMR90|chr4:41215355-41215401,chr4,41215355,41215401,0,85090108
IMR90|chr4:126997721-126997871,chr4,126997721,126997871,IMR90|chr4:129211726-129211745,chr4,129211726,129211745,0,2214005
IMR90|chr4:127151308-127151443,chr4,127151308,127151443,IMR90|chr4:26856254-26856307,chr4,26856254,26856307,0,100295054
IMR90|chr4:127572208-127572309,chr4,127572208,127572309,IMR90|chr4:57845312-57845358,chr4,57845312,57845358,0,69726896
IMR90|chr4:130031284-130031383,chr4,130031284,130031383,IMR90|chr4:41215355-41215401,chr4,41215355,41215401,0,88815929
IMR90|chr4:130213998-130214095,chr4,130213998,130214095,IMR90|chr4:26856254-26856307,chr4,26856254,26856307,0,103357744
IMR90|chr4:130622413-130622489,chr4,130622413,130622489,IMR90|chr4:120547970-120548044,chr4,120547970,120548044,0,10074443
IMR90|chr4:130633423-130633573,chr4,130633423,130633573,IMR90|chr4:39458388-39458495,chr4,39458388,39458495,0,91175035
IMR90|chr4:130684376-130684495,chr4,130684376,130684495,IMR90|chr4:76866094-76866229,chr4,76866094,76866229,0,53818282
IMR90|chr4:131185521-131185647,chr4,131185521,131185647,IMR90|chr4:120548001-120548052,chr4,120548001,120548052,0,10637520
IMR90|chr4:131237630-131237681,chr4,131237630,131237681,IMR90|chr4:122744481-122744537,chr4,122744481,122744537,0,8493149
IMR90|chr4:132187929-132187952,chr4,132187929,132187952,IMR90|chr4:57975509-57975598,chr4,57975509,57975598,0,74212420
IMR90|chr4:133335397-133335493,chr4,133335397,133335493,IMR90|chr4:122617566-122617668,chr4,122617566,122617668,0,10717831
IMR90|chr4:133743968-133744019,chr4,133743968,133744019,IMR90|chr4:122744481-122744537,chr4,122744481,122744537,0,10999487
IMR90|chr4:133988573-133988618,chr4,133988573,133988618,IMR90|chr4:187646349-187646430,chr4,187646349,187646430,0,53657776
IMR90|chr4:134781958-134781995,chr4,134781958,134781995,IMR90|chr4:77869041-77869087,chr4,77869041,77869087,0,56912917
IMR90|chr4:135595366-135595462,chr4,135595366,135595462,IMR90|chr4:122617566-122617668,chr4,122617566,122617668,0,12977800
IMR90|chr4:136567052-136567105,chr4,136567052,136567105,IMR90|chr4:122744487-122744537,chr4,122744487,122744537,0,13822565
IMR90|chr4:138136891-138136962,chr4,138136891,138136962,IMR90|chr4:77906872-77906931,chr4,77906872,77906931,0,60230019
IMR90|chr4:138221898-138221921,chr4,138221898,138221921,IMR90|chr4:122617220-122617324,chr4,122617220,122617324,0,15604678
IMR90|chr4:138566152-138566245,chr4,138566152,138566245,IMR90|chr4:157891115-157891172,chr4,157891115,157891172,0,19324963
IMR90|chr4:138713515-138713574,chr4,138713515,138713574,IMR90|chr4:157891166-157891261,chr4,157891166,157891261,0,19177651
IMR90|chr4:140182907-140182981,chr4,140182907,140182981,IMR90|chr4:46391649-46391686,chr4,46391649,46391686,0,93791258
IMR90|chr4:140207358-140207401,chr4,140207358,140207401,IMR90|chr4:187646349-187646430,chr4,187646349,187646430,0,47438991
IMR90|chr4:140758271-140758397,chr4,140758271,140758397,IMR90|chr4:120548001-120548052,chr4,120548001,120548052,0,20210270
IMR90|chr4:141381107-141381177,chr4,141381107,141381177,IMR90|chr4:77129875-77129949,chr4,77129875,77129949,0,64251232
IMR90|chr4:143257562-143257624,chr4,143257562,143257624,IMR90|chr4:47840222-47840299,chr4,47840222,47840299,0,95417340
IMR90|chr4:143476877-143476929,chr4,143476877,143476929,IMR90|chr4:103748513-103748585,chr4,103748513,103748585,0,39728364
IMR90|chr4:144201122-144201199,chr4,144201122,144201199,IMR90|chr4:775117-775239,chr4,775117,775239,0,143426005
IMR90|chr4:144414631-144414687,chr4,144414631,144414687,IMR90|chr4:104025672-104025759,chr4,104025672,104025759,0,40388959
IMR90|chr4:144725624-144725763,chr4,144725624,144725763,IMR90|chr4:122616446-122616484,chr4,122616446,122616484,0,22109178
IMR90|chr4:146133529-146133597,chr4,146133529,146133597,IMR90|chr4:73936556-73936607,chr4,73936556,73936607,0,72196973
IMR90|chr4:147165071-147165127,chr4,147165071,147165127,IMR90|chr4:57842027-57842115,chr4,57842027,57842115,0,89323044
IMR90|chr4:147777400-147777476,chr4,147777400,147777476,IMR90|chr4:148655174-148655231,chr4,148655174,148655231,0,877774
IMR90|chr4:149317148-149317260,chr4,149317148,149317260,IMR90|chr4:122616446-122616484,chr4,122616446,122616484,0,26700702
IMR90|chr4:150259510-150259638,chr4,150259510,150259638,IMR90|chr4:129211726-129211745,chr4,129211726,129211745,0,21047784
IMR90|chr4:150460288-150460381,chr4,150460288,150460381,IMR90|chr4:107238052-107238073,chr4,107238052,107238073,0,43222236
IMR90|chr4:151525521-151525574,chr4,151525521,151525574,IMR90|chr4:139938151-139938246,chr4,139938151,139938246,0,11587370
IMR90|chr4:151696257-151696327,chr4,151696257,151696327,IMR90|chr4:77129875-77129949,chr4,77129875,77129949,0,74566382
IMR90|chr4:154543910-154543934,chr4,154543910,154543934,IMR90|chr4:77906407-77906457,chr4,77906407,77906457,0,76637503
IMR90|chr4:154683548-154683593,chr4,154683548,154683593,IMR90|chr4:57330186-57330291,chr4,57330186,57330291,0,97353362
IMR90|chr4:155011569-155011635,chr4,155011569,155011635,IMR90|chr4:178365542-178365579,chr4,178365542,178365579,0,23353973
IMR90|chr4:155362379-155362403,chr4,155362379,155362403,IMR90|chr4:77906407-77906457,chr4,77906407,77906457,0,77455972
IMR90|chr4:155887476-155887569,chr4,155887476,155887569,IMR90|chr4:107238052-107238073,chr4,107238052,107238073,0,48649424
IMR90|chr4:157515579-157515680,chr4,157515579,157515680,IMR90|chr4:81122811-81122836,chr4,81122811,81122836,0,76392768
IMR90|chr4:158706138-158706249,chr4,158706138,158706249,IMR90|chr4:38666474-38666555,chr4,38666474,38666555,0,120039664
IMR90|chr4:158851282-158851374,chr4,158851282,158851374,IMR90|chr4:177712770-177712818,chr4,177712770,177712818,0,18861488
IMR90|chr4:159613678-159613794,chr4,159613678,159613794,IMR90|chr4:178365522-178365650,chr4,178365522,178365650,0,18751844
IMR90|chr4:159919071-159919141,chr4,159919071,159919141,IMR90|chr4:77906872-77906931,chr4,77906872,77906931,0,82012199
IMR90|chr4:159928860-159928945,chr4,159928860,159928945,IMR90|chr4:186391819-186391884,chr4,186391819,186391884,0,26462959
IMR90|chr4:160105240-160105299,chr4,160105240,160105299,IMR90|chr4:157891166-157891261,chr4,157891166,157891261,0,2214074
IMR90|chr4:160973409-160973515,chr4,160973409,160973515,IMR90|chr4:4252231-4252297,chr4,4252231,4252297,0,156721178
IMR90|chr4:161123174-161123205,chr4,161123174,161123205,IMR90|chr4:46391567-46391686,chr4,46391567,46391686,0,114731607
IMR90|chr4:161164004-161164150,chr4,161164004,161164150,IMR90|chr4:56263925-56263995,chr4,56263925,56263995,0,104900079
IMR90|chr4:161728541-161728627,chr4,161728541,161728627,IMR90|chr4:83349875-83349896,chr4,83349875,83349896,0,78378666
IMR90|chr4:162547612-162547686,chr4,162547612,162547686,IMR90|chr4:46391649-46391686,chr4,46391649,46391686,0,116155963
IMR90|chr4:162680293-162680324,chr4,162680293,162680324,IMR90|chr4:46391567-46391686,chr4,46391567,46391686,0,116288726
IMR90|chr4:163275489-163275557,chr4,163275489,163275557,IMR90|chr4:177710308-177710390,chr4,177710308,177710390,0,14434819
IMR90|chr4:163394502-163394576,chr4,163394502,163394576,IMR90|chr4:83810947-83810985,chr4,83810947,83810985,0,79583555
IMR90|chr4:164201351-164201400,chr4,164201351,164201400,IMR90|chr4:139938151-139938246,chr4,139938151,139938246,0,24263200
IMR90|chr4:164758489-164758542,chr4,164758489,164758542,IMR90|chr4:139938151-139938246,chr4,139938151,139938246,0,24820338
IMR90|chr4:165262154-165262254,chr4,165262154,165262254,IMR90|chr4:177713229-177713257,chr4,177713229,177713257,0,12451075
IMR90|chr4:165329809-165329858,chr4,165329809,165329858,IMR90|chr4:47840295-47840403,chr4,47840295,47840403,0,117489514
IMR90|chr4:166230427-166230491,chr4,166230427,166230491,IMR90|chr4:57842027-57842115,chr4,57842027,57842115,0,108388400
IMR90|chr4:166277395-166277516,chr4,166277395,166277516,IMR90|chr4:41215355-41215401,chr4,41215355,41215401,0,125062040
IMR90|chr4:166592302-166592376,chr4,166592302,166592376,IMR90|chr4:83810947-83810985,chr4,83810947,83810985,0,82781355
IMR90|chr4:167145952-167145990,chr4,167145952,167145990,IMR90|chr4:74088300-74088414,chr4,74088300,74088414,0,93057652
IMR90|chr4:167565264-167565287,chr4,167565264,167565287,IMR90|chr4:122617220-122617324,chr4,122617220,122617324,0,44948044
IMR90|chr4:168448610-168448666,chr4,168448610,168448666,IMR90|chr4:57842027-57842115,chr4,57842027,57842115,0,110606583
IMR90|chr4:168658224-168658374,chr4,168658224,168658374,IMR90|chr4:129211726-129211745,chr4,129211726,129211745,0,39446498
IMR90|chr4:171042604-171042672,chr4,171042604,171042672,IMR90|chr4:73936556-73936607,chr4,73936556,73936607,0,97106048
IMR90|chr4:171369443-171369495,chr4,171369443,171369495,IMR90|chr4:56264144-56264222,chr4,56264144,56264222,0,115105299
IMR90|chr4:171778052-171778137,chr4,171778052,171778137,IMR90|chr4:186391819-186391884,chr4,186391819,186391884,0,14613767
IMR90|chr4:172011246-172011305,chr4,172011246,172011305,IMR90|chr4:177242738-177242797,chr4,177242738,177242797,0,5231492
IMR90|chr4:172379871-172379969,chr4,172379871,172379969,IMR90|chr4:4252225-4252278,chr4,4252225,4252278,0,168127646
IMR90|chr4:172517247-172517319,chr4,172517247,172517319,IMR90|chr4:186391819-186391884,chr4,186391819,186391884,0,13874572
IMR90|chr4:174367916-174367989,chr4,174367916,174367989,IMR90|chr4:129213461-129213501,chr4,129213461,129213501,0,45154455
IMR90|chr4:174890008-174890053,chr4,174890008,174890053,IMR90|chr4:187646349-187646430,chr4,187646349,187646430,0,12756341
IMR90|chr4:175306386-175306438,chr4,175306386,175306438,IMR90|chr4:157891677-157891752,chr4,157891677,157891752,0,17414709
IMR90|chr4:175605424-175605500,chr4,175605424,175605500,IMR90|chr4:775117-775239,chr4,775117,775239,0,174830307
IMR90|chr4:175649836-175649916,chr4,175649836,175649916,IMR90|chr4:56263925-56263995,chr4,56263925,56263995,0,119385911
IMR90|chr4:176528244-176528394,chr4,176528244,176528394,IMR90|chr4:39458388-39458495,chr4,39458388,39458495,0,137069856
IMR90|chr4:177245074-177245178,chr4,177245074,177245178,IMR90|chr4:177712575-177712613,chr4,177712575,177712613,0,467501
IMR90|chr4:177660244-177660339,chr4,177660244,177660339,IMR90|chr4:81192168-81192233,chr4,81192168,81192233,0,96468076
IMR90|chr4:179460918-179461003,chr4,179460918,179461003,IMR90|chr4:177710308-177710390,chr4,177710308,177710390,0,1750610
IMR90|chr4:179477130-179477194,chr4,179477130,179477194,IMR90|chr4:83293689-83293775,chr4,83293689,83293775,0,96183441
IMR90|chr4:180377225-180377353,chr4,180377225,180377353,IMR90|chr4:129211726-129211745,chr4,129211726,129211745,0,51165499
IMR90|chr4:181407356-181407403,chr4,181407356,181407403,IMR90|chr4:56265241-56265298,chr4,56265241,56265298,0,125142115
IMR90|chr4:182177587-182177644,chr4,182177587,182177644,IMR90|chr4:56265242-56265327,chr4,56265242,56265327,0,125912345
IMR90|chr4:182955845-182955893,chr4,182955845,182955893,IMR90|chr4:129208056-129208137,chr4,129208056,129208137,0,53747789
IMR90|chr4:184655211-184655260,chr4,184655211,184655260,IMR90|chr4:104025672-104025759,chr4,104025672,104025759,0,80629539
IMR90|chr4:185461751-185461798,chr4,185461751,185461798,IMR90|chr4:56265241-56265298,chr4,56265241,56265298,0,129196510
IMR90|chr4:186940620-186940720,chr4,186940620,186940720,IMR90|chr4:177713229-177713257,chr4,177713229,177713257,0,9227391
IMR90|chr4:187098697-187098781,chr4,187098697,187098781,IMR90|chr4:77908368-77908518,chr4,77908368,77908518,0,109190329
IMR90|chr4:187295252-187295281,chr4,187295252,187295281,IMR90|chr4:123748541-123748669,chr4,123748541,123748669,0,63546711
IMR90|chr4:188104071-188104147,chr4,188104071,188104147,IMR90|chr4:77129876-77129946,chr4,77129876,77129946,0,110974195
IMR90|chr4:188480140-188480199,chr4,188480140,188480199,IMR90|chr4:177242738-177242797,chr4,177242738,177242797,0,11237402
IMR90|chr4:189869212-189869318,chr4,189869212,189869318,IMR90|chr4:4252231-4252297,chr4,4252231,4252297,0,185616981
IMR90|chr5:300873-300920,chr5,300873,300920,IMR90|chr5:113692802-113692888,chr5,113692802,113692888,0,113391929
IMR90|chr5:307706-307729,chr5,307706,307729,IMR90|chr5:60624376-60624451,chr5,60624376,60624451,0,60316670
IMR90|chr5:489388-489448,chr5,489388,489448,IMR90|chr5:17219216-17219247,chr5,17219216,17219247,0,16729828
IMR90|chr5:506930-506953,chr5,506930,506953,IMR90|chr5:176904579-176904663,chr5,176904579,176904663,0,176397649
IMR90|chr5:613487-613526,chr5,613487,613526,IMR90|chr5:38844965-38845106,chr5,38844965,38845106,0,38231478
IMR90|chr5:697051-697116,chr5,697051,697116,IMR90|chr5:92923360-92923412,chr5,92923360,92923412,0,92226309
IMR90|chr5:749724-749874,chr5,749724,749874,IMR90|chr5:74906142-74906221,chr5,74906142,74906221,0,74156418
IMR90|chr5:1235580-1235652,chr5,1235580,1235652,IMR90|chr5:151065121-151065192,chr5,151065121,151065192,0,149829541
IMR90|chr5:1877458-1877513,chr5,1877458,1877513,IMR90|chr5:148522444-148522486,chr5,148522444,148522486,0,146644986
IMR90|chr5:1929050-1929181,chr5,1929050,1929181,IMR90|chr5:17219989-17220008,chr5,17219989,17220008,0,15290939
IMR90|chr5:2032388-2032445,chr5,2032388,2032445,IMR90|chr5:176904131-176904201,chr5,176904131,176904201,0,174871743
IMR90|chr5:2061087-2061169,chr5,2061087,2061169,IMR90|chr5:65221658-65221772,chr5,65221658,65221772,0,63160571
IMR90|chr5:2524326-2524367,chr5,2524326,2524367,IMR90|chr5:98110837-98110933,chr5,98110837,98110933,0,95586511
IMR90|chr5:3040600-3040642,chr5,3040600,3040642,IMR90|chr5:141702309-141702364,chr5,141702309,141702364,0,138661709
IMR90|chr5:3506648-3506697,chr5,3506648,3506697,IMR90|chr5:141702504-141702604,chr5,141702504,141702604,0,138195856
IMR90|chr5:3642506-3642587,chr5,3642506,3642587,IMR90|chr5:34661069-34661126,chr5,34661069,34661126,0,31018563
IMR90|chr5:3779727-3779766,chr5,3779727,3779766,IMR90|chr5:138634164-138634267,chr5,138634164,138634267,0,134854437
IMR90|chr5:4591258-4591300,chr5,4591258,4591300,IMR90|chr5:141702309-141702364,chr5,141702309,141702364,0,137111051
IMR90|chr5:4656570-4656717,chr5,4656570,4656717,IMR90|chr5:172754290-172754351,chr5,172754290,172754351,0,168097720
IMR90|chr5:4731488-4731528,chr5,4731488,4731528,IMR90|chr5:139738761-139738867,chr5,139738761,139738867,0,135007273
IMR90|chr5:5227702-5227784,chr5,5227702,5227784,IMR90|chr5:150535234-150535280,chr5,150535234,150535280,0,145307532
IMR90|chr5:5320529-5320603,chr5,5320529,5320603,IMR90|chr5:176906236-176906331,chr5,176906236,176906331,0,171585707
IMR90|chr5:5406839-5406905,chr5,5406839,5406905,IMR90|chr5:151060421-151060498,chr5,151060421,151060498,0,145653582
IMR90|chr5:5607658-5607716,chr5,5607658,5607716,IMR90|chr5:98108054-98108143,chr5,98108054,98108143,0,92500396
IMR90|chr5:6150220-6150324,chr5,6150220,6150324,IMR90|chr5:83679849-83679955,chr5,83679849,83679955,0,77529629
IMR90|chr5:6648113-6648148,chr5,6648113,6648148,IMR90|chr5:148522443-148522502,chr5,148522443,148522502,0,141874330
IMR90|chr5:7116817-7116867,chr5,7116817,7116867,IMR90|chr5:148928254-148928379,chr5,148928254,148928379,0,141811437
IMR90|chr5:7390749-7390791,chr5,7390749,7390791,IMR90|chr5:14147657-14147708,chr5,14147657,14147708,0,6756908
IMR90|chr5:7452927-7452999,chr5,7452927,7452999,IMR90|chr5:34657512-34657572,chr5,34657512,34657572,0,27204585
IMR90|chr5:7881863-7881909,chr5,7881863,7881909,IMR90|chr5:14147153-14147215,chr5,14147153,14147215,0,6265290
IMR90|chr5:7914429-7914482,chr5,7914429,7914482,IMR90|chr5:176906020-176906072,chr5,176906020,176906072,0,168991591
IMR90|chr5:7989826-7989951,chr5,7989826,7989951,IMR90|chr5:444943-444968,chr5,444943,444968,0,7544883
IMR90|chr5:8024259-8024331,chr5,8024259,8024331,IMR90|chr5:34657512-34657572,chr5,34657512,34657572,0,26633253
IMR90|chr5:8366277-8366301,chr5,8366277,8366301,IMR90|chr5:32173518-32173634,chr5,32173518,32173634,0,23807241
IMR90|chr5:8696689-8696711,chr5,8696689,8696711,IMR90|chr5:178053406-178053495,chr5,178053406,178053495,0,169356717
IMR90|chr5:9183705-9183748,chr5,9183705,9183748,IMR90|chr5:176901811-176901918,chr5,176901811,176901918,0,167718106
IMR90|chr5:9381977-9382005,chr5,9381977,9382005,IMR90|chr5:55289447-55289515,chr5,55289447,55289515,0,45907470
IMR90|chr5:9590505-9590652,chr5,9590505,9590652,IMR90|chr5:132167824-132167877,chr5,132167824,132167877,0,122577319
IMR90|chr5:9758383-9758454,chr5,9758383,9758454,IMR90|chr5:172196766-172196845,chr5,172196766,172196845,0,162438383
IMR90|chr5:9884291-9884393,chr5,9884291,9884393,IMR90|chr5:140070249-140070312,chr5,140070249,140070312,0,130185958
IMR90|chr5:10541829-10541890,chr5,10541829,10541890,IMR90|chr5:150159211-150159319,chr5,150159211,150159319,0,139617382
IMR90|chr5:10695285-10695346,chr5,10695285,10695346,IMR90|chr5:147763846-147763882,chr5,147763846,147763882,0,137068561
IMR90|chr5:11200610-11200668,chr5,11200610,11200668,IMR90|chr5:140780019-140780111,chr5,140780019,140780111,0,129579409
IMR90|chr5:11259342-11259417,chr5,11259342,11259417,IMR90|chr5:149828322-149828393,chr5,149828322,149828393,0,138568980
IMR90|chr5:11308655-11308731,chr5,11308655,11308731,IMR90|chr5:68628415-68628489,chr5,68628415,68628489,0,57319760
IMR90|chr5:11347188-11347276,chr5,11347188,11347276,IMR90|chr5:140070250-140070312,chr5,140070250,140070312,0,128723062
IMR90|chr5:11388430-11388545,chr5,11388430,11388545,IMR90|chr5:176904036-176904113,chr5,176904036,176904113,0,165515606
IMR90|chr5:11569426-11569480,chr5,11569426,11569480,IMR90|chr5:150534500-150534533,chr5,150534500,150534533,0,138965074
IMR90|chr5:11690474-11690516,chr5,11690474,11690516,IMR90|chr5:172752436-172752493,chr5,172752436,172752493,0,161061962
IMR90|chr5:12139052-12139118,chr5,12139052,12139118,IMR90|chr5:176904189-176904254,chr5,176904189,176904254,0,164765137
IMR90|chr5:12700964-12701049,chr5,12700964,12701049,IMR90|chr5:141701869-141701958,chr5,141701869,141701958,0,129000905
IMR90|chr5:12732566-12732638,chr5,12732566,12732638,IMR90|chr5:34657370-34657407,chr5,34657370,34657407,0,21924804
IMR90|chr5:12787979-12788037,chr5,12787979,12788037,IMR90|chr5:40835716-40835765,chr5,40835716,40835765,0,28047737
IMR90|chr5:12953766-12953849,chr5,12953766,12953849,IMR90|chr5:56112899-56112917,chr5,56112899,56112917,0,43159133
IMR90|chr5:13015702-13015799,chr5,13015702,13015799,IMR90|chr5:172752527-172752564,chr5,172752527,172752564,0,159736825
IMR90|chr5:13028741-13028767,chr5,13028741,13028767,IMR90|chr5:98112498-98112622,chr5,98112498,98112622,0,85083757
IMR90|chr5:13081681-13081779,chr5,13081681,13081779,IMR90|chr5:141028452-141028504,chr5,141028452,141028504,0,127946771
IMR90|chr5:13250243-13250364,chr5,13250243,13250364,IMR90|chr5:39424446-39424518,chr5,39424446,39424518,0,26174203
IMR90|chr5:13358113-13358182,chr5,13358113,13358182,IMR90|chr5:175967629-175967681,chr5,175967629,175967681,0,162609516
IMR90|chr5:13456795-13456871,chr5,13456795,13456871,IMR90|chr5:141702566-141702605,chr5,141702566,141702605,0,128245771
IMR90|chr5:13917037-13917089,chr5,13917037,13917089,IMR90|chr5:43064669-43064758,chr5,43064669,43064758,0,29147632
IMR90|chr5:14374149-14374184,chr5,14374149,14374184,IMR90|chr5:151064551-151064601,chr5,151064551,151064601,0,136690402
IMR90|chr5:14510660-14510703,chr5,14510660,14510703,IMR90|chr5:172196322-172196370,chr5,172196322,172196370,0,157685662
IMR90|chr5:14575750-14575829,chr5,14575750,14575829,IMR90|chr5:119801601-119801635,chr5,119801601,119801635,0,105225851
IMR90|chr5:14724781-14724831,chr5,14724781,14724831,IMR90|chr5:17219951-17220030,chr5,17219951,17220030,0,2495170
IMR90|chr5:14758041-14758095,chr5,14758041,14758095,IMR90|chr5:140791014-140791151,chr5,140791014,140791151,0,126032973
IMR90|chr5:14854833-14854858,chr5,14854833,14854858,IMR90|chr5:98112498-98112524,chr5,98112498,98112524,0,83257665
IMR90|chr5:15174755-15174801,chr5,15174755,15174801,IMR90|chr5:138634164-138634267,chr5,138634164,138634267,0,123459409
IMR90|chr5:15282809-15282868,chr5,15282809,15282868,IMR90|chr5:151061335-151061438,chr5,151061335,151061438,0,135778526
IMR90|chr5:15484611-15484668,chr5,15484611,15484668,IMR90|chr5:74900065-74900114,chr5,74900065,74900114,0,59415454
IMR90|chr5:15831893-15831925,chr5,15831893,15831925,IMR90|chr5:34657448-34657506,chr5,34657448,34657506,0,18825555
IMR90|chr5:16126179-16126235,chr5,16126179,16126235,IMR90|chr5:121414045-121414109,chr5,121414045,121414109,0,105287866
IMR90|chr5:16146636-16146711,chr5,16146636,16146711,IMR90|chr5:150534776-150534845,chr5,150534776,150534845,0,134388140
IMR90|chr5:16748808-16748887,chr5,16748808,16748887,IMR90|chr5:119801601-119801635,chr5,119801601,119801635,0,103052793
IMR90|chr5:16815492-16815549,chr5,16815492,16815549,IMR90|chr5:74900065-74900114,chr5,74900065,74900114,0,58084573
IMR90|chr5:16916065-16916163,chr5,16916065,16916163,IMR90|chr5:140780019-140780111,chr5,140780019,140780111,0,123863954
IMR90|chr5:17017647-17017709,chr5,17017647,17017709,IMR90|chr5:14148763-14148851,chr5,14148763,14148851,0,2868884
IMR90|chr5:17488264-17488362,chr5,17488264,17488362,IMR90|chr5:175878237-175878280,chr5,175878237,175878280,0,158389973
IMR90|chr5:17778180-17778246,chr5,17778180,17778246,IMR90|chr5:151060421-151060498,chr5,151060421,151060498,0,133282241
IMR90|chr5:18376693-18376840,chr5,18376693,18376840,IMR90|chr5:172754290-172754351,chr5,172754290,172754351,0,154377597
IMR90|chr5:18573173-18573217,chr5,18573173,18573217,IMR90|chr5:33891016-33891081,chr5,33891016,33891081,0,15317843
IMR90|chr5:18875631-18875678,chr5,18875631,18875678,IMR90|chr5:148928032-148928135,chr5,148928032,148928135,0,130052401
IMR90|chr5:18929904-18930018,chr5,18929904,18930018,IMR90|chr5:85914781-85914853,chr5,85914781,85914853,0,66984877
IMR90|chr5:18970090-18970161,chr5,18970090,18970161,IMR90|chr5:151065180-151065219,chr5,151065180,151065219,0,132095090
IMR90|chr5:19251199-19251274,chr5,19251199,19251274,IMR90|chr5:176904294-176904342,chr5,176904294,176904342,0,157653095
IMR90|chr5:19277715-19277831,chr5,19277715,19277831,IMR90|chr5:138634919-138635025,chr5,138634919,138635025,0,119357204
IMR90|chr5:19407178-19407245,chr5,19407178,19407245,IMR90|chr5:151061540-151061564,chr5,151061540,151061564,0,131654362
IMR90|chr5:19896000-19896093,chr5,19896000,19896093,IMR90|chr5:14146626-14146670,chr5,14146626,14146670,0,5749374
IMR90|chr5:19932767-19932843,chr5,19932767,19932843,IMR90|chr5:141704241-141704303,chr5,141704241,141704303,0,121771474
IMR90|chr5:20134562-20134586,chr5,20134562,20134586,IMR90|chr5:149532348-149532491,chr5,149532348,149532491,0,129397786
IMR90|chr5:20253244-20253314,chr5,20253244,20253314,IMR90|chr5:176905513-176905576,chr5,176905513,176905576,0,156652269
IMR90|chr5:20631921-20631953,chr5,20631921,20631953,IMR90|chr5:34657712-34657796,chr5,34657712,34657796,0,14025791
IMR90|chr5:20670645-20670720,chr5,20670645,20670720,IMR90|chr5:151061540-151061564,chr5,151061540,151061564,0,130390895
IMR90|chr5:20676491-20676525,chr5,20676491,20676525,IMR90|chr5:6709688-6709788,chr5,6709688,6709788,0,13966803
IMR90|chr5:20752472-20752576,chr5,20752472,20752576,IMR90|chr5:121415034-121415066,chr5,121415034,121415066,0,100662562
IMR90|chr5:21025273-21025346,chr5,21025273,21025346,IMR90|chr5:172196181-172196225,chr5,172196181,172196225,0,151170908
IMR90|chr5:21119466-21119514,chr5,21119466,21119514,IMR90|chr5:148925819-148925958,chr5,148925819,148925958,0,127806353
IMR90|chr5:21123195-21123306,chr5,21123195,21123306,IMR90|chr5:98107499-98107538,chr5,98107499,98107538,0,76984304
IMR90|chr5:21193065-21193106,chr5,21193065,21193106,IMR90|chr5:79649850-79649956,chr5,79649850,79649956,0,58456785
IMR90|chr5:21482053-21482132,chr5,21482053,21482132,IMR90|chr5:172197093-172197158,chr5,172197093,172197158,0,150715040
IMR90|chr5:21571758-21571794,chr5,21571758,21571794,IMR90|chr5:178053406-178053495,chr5,178053406,178053495,0,156481648
IMR90|chr5:21844290-21844329,chr5,21844290,21844329,IMR90|chr5:132298692-132298803,chr5,132298692,132298803,0,110454402
IMR90|chr5:21962256-21962329,chr5,21962256,21962329,IMR90|chr5:176904036-176904113,chr5,176904036,176904113,0,154941780
IMR90|chr5:21970794-21970853,chr5,21970794,21970853,IMR90|chr5:151061335-151061438,chr5,151061335,151061438,0,129090541
IMR90|chr5:22371937-22371981,chr5,22371937,22371981,IMR90|chr5:33891016-33891081,chr5,33891016,33891081,0,11519079
IMR90|chr5:22469558-22469690,chr5,22469558,22469690,IMR90|chr5:172197026-172197044,chr5,172197026,172197044,0,149727468
IMR90|chr5:22529227-22529309,chr5,22529227,22529309,IMR90|chr5:150535234-150535280,chr5,150535234,150535280,0,128006007
IMR90|chr5:22754774-22754813,chr5,22754774,22754813,IMR90|chr5:141701950-141702038,chr5,141701950,141702038,0,118947176
IMR90|chr5:22922604-22922669,chr5,22922604,22922669,IMR90|chr5:159612478-159612540,chr5,159612478,159612540,0,136689874
IMR90|chr5:23242793-23242869,chr5,23242793,23242869,IMR90|chr5:130604198-130604271,chr5,130604198,130604271,0,107361405
IMR90|chr5:23469207-23469233,chr5,23469207,23469233,IMR90|chr5:151061209-151061284,chr5,151061209,151061284,0,127592002
IMR90|chr5:23619111-23619157,chr5,23619111,23619157,IMR90|chr5:172194848-172194890,chr5,172194848,172194890,0,148575737
IMR90|chr5:23623510-23623614,chr5,23623510,23623614,IMR90|chr5:150160261-150160307,chr5,150160261,150160307,0,126536751
IMR90|chr5:23718292-23718381,chr5,23718292,23718381,IMR90|chr5:162934274-162934327,chr5,162934274,162934327,0,139215982
IMR90|chr5:23769665-23769771,chr5,23769665,23769771,IMR90|chr5:43190601-43190645,chr5,43190601,43190645,0,19420936
IMR90|chr5:23965633-23965671,chr5,23965633,23965671,IMR90|chr5:98110837-98110933,chr5,98110837,98110933,0,74145204
IMR90|chr5:24029127-24029175,chr5,24029127,24029175,IMR90|chr5:121411044-121411141,chr5,121411044,121411141,0,97381917
IMR90|chr5:24281580-24281627,chr5,24281580,24281627,IMR90|chr5:176904279-176904421,chr5,176904279,176904421,0,152622699
IMR90|chr5:24445665-24445698,chr5,24445665,24445698,IMR90|chr5:443993-444057,chr5,443993,444057,0,24001672
IMR90|chr5:24521688-24521714,chr5,24521688,24521714,IMR90|chr5:32713891-32714040,chr5,32713891,32714040,0,8192203
IMR90|chr5:24533533-24533575,chr5,24533533,24533575,IMR90|chr5:14147318-14147423,chr5,14147318,14147423,0,10386215
IMR90|chr5:24618421-24618446,chr5,24618421,24618446,IMR90|chr5:138942228-138942326,chr5,138942228,138942326,0,114323807
IMR90|chr5:25568424-25568497,chr5,25568424,25568497,IMR90|chr5:138632699-138632754,chr5,138632699,138632754,0,113064275
IMR90|chr5:25981119-25981162,chr5,25981119,25981162,IMR90|chr5:43190601-43190645,chr5,43190601,43190645,0,17209482
IMR90|chr5:26152639-26152685,chr5,26152639,26152685,IMR90|chr5:176906196-176906346,chr5,176906196,176906346,0,150753557
IMR90|chr5:26483419-26483448,chr5,26483419,26483448,IMR90|chr5:151136772-151136875,chr5,151136772,151136875,0,124653353
IMR90|chr5:26741606-26741702,chr5,26741606,26741702,IMR90|chr5:137879988-137880034,chr5,137879988,137880034,0,111138382
IMR90|chr5:26752975-26753025,chr5,26752975,26753025,IMR90|chr5:176905766-176905806,chr5,176905766,176905806,0,150152791
IMR90|chr5:28490629-28490700,chr5,28490629,28490700,IMR90|chr5:176904684-176904726,chr5,176904684,176904726,0,148414055
IMR90|chr5:29092114-29092166,chr5,29092114,29092166,IMR90|chr5:17219951-17220032,chr5,17219951,17220032,0,11872163
IMR90|chr5:29165476-29165586,chr5,29165476,29165586,IMR90|chr5:141028452-141028504,chr5,141028452,141028504,0,111862976
IMR90|chr5:29305365-29305423,chr5,29305365,29305423,IMR90|chr5:147763852-147763885,chr5,147763852,147763885,0,118458487
IMR90|chr5:29564986-29565034,chr5,29564986,29565034,IMR90|chr5:148925819-148925958,chr5,148925819,148925958,0,119360833
IMR90|chr5:29615549-29615608,chr5,29615549,29615608,IMR90|chr5:176904131-176904201,chr5,176904131,176904201,0,147288582
IMR90|chr5:30475191-30475208,chr5,30475191,30475208,IMR90|chr5:14139992-14140139,chr5,14139992,14140139,0,16335199
IMR90|chr5:30548441-30548480,chr5,30548441,30548480,IMR90|chr5:43064615-43064696,chr5,43064615,43064696,0,12516174
IMR90|chr5:31012310-31012376,chr5,31012310,31012376,IMR90|chr5:141700648-141700712,chr5,141700648,141700712,0,110688338
IMR90|chr5:31493121-31493223,chr5,31493121,31493223,IMR90|chr5:140070249-140070312,chr5,140070249,140070312,0,108577128
IMR90|chr5:32019315-32019352,chr5,32019315,32019352,IMR90|chr5:140791376-140791424,chr5,140791376,140791424,0,108772061
IMR90|chr5:33254895-33254940,chr5,33254895,33254940,IMR90|chr5:151137246-151137303,chr5,151137246,151137303,0,117882351
IMR90|chr5:33255872-33255946,chr5,33255872,33255946,IMR90|chr5:6711976-6712052,chr5,6711976,6712052,0,26543896
IMR90|chr5:33270232-33270359,chr5,33270232,33270359,IMR90|chr5:444945-444968,chr5,444945,444968,0,32825287
IMR90|chr5:33349218-33349314,chr5,33349218,33349314,IMR90|chr5:43064870-43064921,chr5,43064870,43064921,0,9715652
IMR90|chr5:33477442-33477557,chr5,33477442,33477557,IMR90|chr5:176904036-176904113,chr5,176904036,176904113,0,143426594
IMR90|chr5:33503144-33503241,chr5,33503144,33503241,IMR90|chr5:175878237-175878280,chr5,175878237,175878280,0,142375093
IMR90|chr5:33517996-33518077,chr5,33517996,33518077,IMR90|chr5:151060265-151060287,chr5,151060265,151060287,0,117542269
IMR90|chr5:33756735-33756812,chr5,33756735,33756812,IMR90|chr5:151063964-151064003,chr5,151063964,151064003,0,117307229
IMR90|chr5:33789116-33789173,chr5,33789116,33789173,IMR90|chr5:14144143-14144236,chr5,14144143,14144236,0,19644973
IMR90|chr5:34777771-34777886,chr5,34777771,34777886,IMR90|chr5:121411044-121411141,chr5,121411044,121411141,0,86633273
IMR90|chr5:35119109-35119151,chr5,35119109,35119151,IMR90|chr5:14147657-14147708,chr5,14147657,14147708,0,20971452
IMR90|chr5:35375717-35375809,chr5,35375717,35375809,IMR90|chr5:176906063-176906086,chr5,176906063,176906086,0,141530346
IMR90|chr5:35702894-35702957,chr5,35702894,35702957,IMR90|chr5:138613227-138613262,chr5,138613227,138613262,0,102910333
IMR90|chr5:36088295-36088334,chr5,36088295,36088334,IMR90|chr5:43064615-43064696,chr5,43064615,43064696,0,6976320
IMR90|chr5:36116162-36116215,chr5,36116162,36116215,IMR90|chr5:176904559-176904609,chr5,176904559,176904609,0,140788397
IMR90|chr5:36190574-36190628,chr5,36190574,36190628,IMR90|chr5:141700538-141700621,chr5,141700538,141700621,0,105509964
IMR90|chr5:36430421-36430492,chr5,36430421,36430492,IMR90|chr5:74906142-74906221,chr5,74906142,74906221,0,38475721
IMR90|chr5:36638266-36638340,chr5,36638266,36638340,IMR90|chr5:179049487-179049556,chr5,179049487,179049556,0,142411221
IMR90|chr5:36950271-36950363,chr5,36950271,36950363,IMR90|chr5:141702504-141702604,chr5,141702504,141702604,0,104752233
IMR90|chr5:36957163-36957240,chr5,36957163,36957240,IMR90|chr5:141701926-141701968,chr5,141701926,141701968,0,104744763
IMR90|chr5:37025621-37025665,chr5,37025621,37025665,IMR90|chr5:76326874-76326913,chr5,76326874,76326913,0,39301253
IMR90|chr5:37186697-37186772,chr5,37186697,37186772,IMR90|chr5:176904294-176904342,chr5,176904294,176904342,0,139717597
IMR90|chr5:37516690-37516764,chr5,37516690,37516764,IMR90|chr5:179049487-179049556,chr5,179049487,179049556,0,141532797
IMR90|chr5:37585923-37585994,chr5,37585923,37585994,IMR90|chr5:151065180-151065219,chr5,151065180,151065219,0,113479257
IMR90|chr5:37655742-37655831,chr5,37655742,37655831,IMR90|chr5:150535234-150535280,chr5,150535234,150535280,0,112879492
IMR90|chr5:37655997-37656031,chr5,37655997,37656031,IMR90|chr5:39424425-39424519,chr5,39424425,39424519,0,1768428
IMR90|chr5:37695491-37695513,chr5,37695491,37695513,IMR90|chr5:176924019-176924088,chr5,176924019,176924088,0,139228528
IMR90|chr5:37710197-37710233,chr5,37710197,37710233,IMR90|chr5:65221658-65221772,chr5,65221658,65221772,0,27511461
IMR90|chr5:37981895-37981979,chr5,37981895,37981979,IMR90|chr5:68628423-68628489,chr5,68628423,68628489,0,30646528
IMR90|chr5:39153412-39153466,chr5,39153412,39153466,IMR90|chr5:140791014-140791151,chr5,140791014,140791151,0,101637602
IMR90|chr5:39682117-39682177,chr5,39682117,39682177,IMR90|chr5:98112163-98112211,chr5,98112163,98112211,0,58430046
IMR90|chr5:39684116-39684140,chr5,39684116,39684140,IMR90|chr5:138942228-138942326,chr5,138942228,138942326,0,99258112
IMR90|chr5:39985462-39985514,chr5,39985462,39985514,IMR90|chr5:43064669-43064758,chr5,43064669,43064758,0,3079207
IMR90|chr5:40168975-40169033,chr5,40168975,40169033,IMR90|chr5:150534477-150534530,chr5,150534477,150534530,0,110365502
IMR90|chr5:40402850-40402918,chr5,40402850,40402918,IMR90|chr5:60630750-60630864,chr5,60630750,60630864,0,20227900
IMR90|chr5:41253094-41253152,chr5,41253094,41253152,IMR90|chr5:141700392-141700422,chr5,141700392,141700422,0,100447298
IMR90|chr5:41266970-41267031,chr5,41266970,41267031,IMR90|chr5:150159211-150159319,chr5,150159211,150159319,0,108892241
IMR90|chr5:41398570-41398668,chr5,41398570,41398668,IMR90|chr5:176946455-176946488,chr5,176946455,176946488,0,135547885
IMR90|chr5:41471750-41471803,chr5,41471750,41471803,IMR90|chr5:443700-443754,chr5,443700,443754,0,41028050
IMR90|chr5:41956992-41957075,chr5,41956992,41957075,IMR90|chr5:74902618-74902662,chr5,74902618,74902662,0,32945626
IMR90|chr5:42082406-42082449,chr5,42082406,42082449,IMR90|chr5:17219558-17219586,chr5,17219558,17219586,0,24862848
IMR90|chr5:42237409-42237427,chr5,42237409,42237427,IMR90|chr5:113696796-113696915,chr5,113696796,113696915,0,71459387
IMR90|chr5:42512938-42513024,chr5,42512938,42513024,IMR90|chr5:443700-443754,chr5,443700,443754,0,42069238
IMR90|chr5:42643064-42643135,chr5,42643064,42643135,IMR90|chr5:74906142-74906221,chr5,74906142,74906221,0,32263078
IMR90|chr5:42878756-42878830,chr5,42878756,42878830,IMR90|chr5:6711976-6712052,chr5,6711976,6712052,0,36166780
IMR90|chr5:43063925-43064033,chr5,43063925,43064033,IMR90|chr5:131593793-131593835,chr5,131593793,131593835,0,88529868
IMR90|chr5:43071562-43071623,chr5,43071562,43071623,IMR90|chr5:176905560-176905710,chr5,176905560,176905710,0,133833998
IMR90|chr5:43235825-43235868,chr5,43235825,43235868,IMR90|chr5:176901811-176901918,chr5,176901811,176901918,0,133665986
IMR90|chr5:43731379-43731503,chr5,43731379,43731503,IMR90|chr5:176904892-176904915,chr5,176904892,176904915,0,133173513
IMR90|chr5:43832315-43832443,chr5,43832315,43832443,IMR90|chr5:14870702-14870801,chr5,14870702,14870801,0,28961613
IMR90|chr5:43928122-43928177,chr5,43928122,43928177,IMR90|chr5:176905967-176906037,chr5,176905967,176906037,0,132977845
IMR90|chr5:44123197-44123240,chr5,44123197,44123240,IMR90|chr5:76326873-76326939,chr5,76326873,76326939,0,32203676
IMR90|chr5:44261031-44261072,chr5,44261031,44261072,IMR90|chr5:176905888-176905917,chr5,176905888,176905917,0,132644857
IMR90|chr5:44291189-44291265,chr5,44291189,44291265,IMR90|chr5:141704241-141704303,chr5,141704241,141704303,0,97413052
IMR90|chr5:44443064-44443170,chr5,44443064,44443170,IMR90|chr5:14657702-14657766,chr5,14657702,14657766,0,29785362
IMR90|chr5:44516475-44516622,chr5,44516475,44516622,IMR90|chr5:132167824-132167877,chr5,132167824,132167877,0,87651349
IMR90|chr5:44557147-44557265,chr5,44557147,44557265,IMR90|chr5:150534776-150534845,chr5,150534776,150534845,0,105977629
IMR90|chr5:44754675-44754744,chr5,44754675,44754744,IMR90|chr5:151060835-151060925,chr5,151060835,151060925,0,106306160
IMR90|chr5:44814552-44814699,chr5,44814552,44814699,IMR90|chr5:139738762-139738871,chr5,139738762,139738871,0,94924210
IMR90|chr5:45644635-45644691,chr5,45644635,45644691,IMR90|chr5:133703439-133703482,chr5,133703439,133703482,0,88058804
IMR90|chr5:46218818-46218855,chr5,46218818,46218855,IMR90|chr5:95296687-95296823,chr5,95296687,95296823,0,49077869
IMR90|chr5:46272680-46272822,chr5,46272680,46272822,IMR90|chr5:68510018-68510083,chr5,68510018,68510083,0,22237338
IMR90|chr5:46498867-46498977,chr5,46498867,46498977,IMR90|chr5:141028452-141028504,chr5,141028452,141028504,0,94529585
IMR90|chr5:46777925-46777981,chr5,46777925,46777981,IMR90|chr5:133703439-133703482,chr5,133703439,133703482,0,86925514
IMR90|chr5:46866303-46866406,chr5,46866303,46866406,IMR90|chr5:130604713-130604744,chr5,130604713,130604744,0,83738410
IMR90|chr5:47413379-47413433,chr5,47413379,47413433,IMR90|chr5:148522695-148522777,chr5,148522695,148522777,0,101109316
IMR90|chr5:47928375-47928425,chr5,47928375,47928425,IMR90|chr5:151061648-151061738,chr5,151061648,151061738,0,103133273
IMR90|chr5:48150881-48150932,chr5,48150881,48150932,IMR90|chr5:150533449-150533543,chr5,150533449,150533543,0,102382568
IMR90|chr5:48361085-48361131,chr5,48361085,48361131,IMR90|chr5:176906037-176906069,chr5,176906037,176906069,0,128544952
IMR90|chr5:48974410-48974471,chr5,48974410,48974471,IMR90|chr5:147763846-147763882,chr5,147763846,147763882,0,98789436
IMR90|chr5:48994720-48994789,chr5,48994720,48994789,IMR90|chr5:151060835-151060925,chr5,151060835,151060925,0,102066115
IMR90|chr5:49527272-49527359,chr5,49527272,49527359,IMR90|chr5:43190601-43190645,chr5,43190601,43190645,0,6336671
IMR90|chr5:49539467-49539544,chr5,49539467,49539544,IMR90|chr5:151063964-151064003,chr5,151063964,151064003,0,101524497
IMR90|chr5:49770644-49770671,chr5,49770644,49770671,IMR90|chr5:171432572-171432695,chr5,171432572,171432695,0,121661928
IMR90|chr5:49954243-49954302,chr5,49954243,49954302,IMR90|chr5:98112163-98112211,chr5,98112163,98112211,0,48157920
IMR90|chr5:50000303-50000361,chr5,50000303,50000361,IMR90|chr5:98108054-98108143,chr5,98108054,98108143,0,48107751
IMR90|chr5:50909468-50909495,chr5,50909468,50909495,IMR90|chr5:55289447-55289515,chr5,55289447,55289515,0,4379979
IMR90|chr5:51805891-51805983,chr5,51805891,51805983,IMR90|chr5:14147898-14147953,chr5,14147898,14147953,0,37657993
IMR90|chr5:52143794-52143895,chr5,52143794,52143895,IMR90|chr5:176906236-176906331,chr5,176906236,176906331,0,124762442
IMR90|chr5:52868584-52868699,chr5,52868584,52868699,IMR90|chr5:17219324-17219359,chr5,17219324,17219359,0,35649260
IMR90|chr5:52906789-52906875,chr5,52906789,52906875,IMR90|chr5:443700-443754,chr5,443700,443754,0,52463089
IMR90|chr5:53002607-53002687,chr5,53002607,53002687,IMR90|chr5:72922573-72922623,chr5,72922573,72922623,0,19919966
IMR90|chr5:53184334-53184423,chr5,53184334,53184423,IMR90|chr5:150535234-150535280,chr5,150535234,150535280,0,97350900
IMR90|chr5:53358232-53358268,chr5,53358232,53358268,IMR90|chr5:148925544-148925623,chr5,148925544,148925623,0,95567312
IMR90|chr5:54206048-54206099,chr5,54206048,54206099,IMR90|chr5:43064669-43064758,chr5,43064669,43064758,0,11141379
IMR90|chr5:54326134-54326189,chr5,54326134,54326189,IMR90|chr5:72797306-72797348,chr5,72797306,72797348,0,18471172
IMR90|chr5:54778426-54778522,chr5,54778426,54778522,IMR90|chr5:43064870-43064921,chr5,43064870,43064921,0,11713556
IMR90|chr5:55031006-55031110,chr5,55031006,55031110,IMR90|chr5:16469463-16469488,chr5,16469463,16469488,0,38561543
IMR90|chr5:55119809-55119873,chr5,55119809,55119873,IMR90|chr5:176905232-176905298,chr5,176905232,176905298,0,121785423
IMR90|chr5:55310170-55310258,chr5,55310170,55310258,IMR90|chr5:140734109-140734168,chr5,140734109,140734168,0,85423939
IMR90|chr5:55933454-55933512,chr5,55933454,55933512,IMR90|chr5:34930873-34930936,chr5,34930873,34930936,0,21002581
IMR90|chr5:55936297-55936341,chr5,55936297,55936341,IMR90|chr5:68483745-68483805,chr5,68483745,68483805,0,12547448
IMR90|chr5:56404422-56404514,chr5,56404422,56404514,IMR90|chr5:176906063-176906086,chr5,176906063,176906086,0,120501641
IMR90|chr5:56414666-56414728,chr5,56414666,56414728,IMR90|chr5:141703175-141703262,chr5,141703175,141703262,0,85288509
IMR90|chr5:56596855-56596941,chr5,56596855,56596941,IMR90|chr5:176905513-176905577,chr5,176905513,176905577,0,120308658
IMR90|chr5:56791502-56791590,chr5,56791502,56791590,IMR90|chr5:140734109-140734168,chr5,140734109,140734168,0,83942607
IMR90|chr5:56844185-56844292,chr5,56844185,56844292,IMR90|chr5:121415034-121415066,chr5,121415034,121415066,0,64570849
IMR90|chr5:56980222-56980264,chr5,56980222,56980264,IMR90|chr5:172752436-172752493,chr5,172752436,172752493,0,115772214
IMR90|chr5:57128850-57128934,chr5,57128850,57128934,IMR90|chr5:14146591-14146657,chr5,14146591,14146657,0,42982259
IMR90|chr5:57276165-57276236,chr5,57276165,57276236,IMR90|chr5:141702553-141702606,chr5,141702553,141702606,0,84426388
IMR90|chr5:57309099-57309241,chr5,57309099,57309241,IMR90|chr5:68510018-68510083,chr5,68510018,68510083,0,11200919
IMR90|chr5:57588509-57588556,chr5,57588509,57588556,IMR90|chr5:141702121-141702182,chr5,141702121,141702182,0,84113612
IMR90|chr5:57692080-57692123,chr5,57692080,57692123,IMR90|chr5:17219558-17219586,chr5,17219558,17219586,0,40472522
IMR90|chr5:57701537-57701576,chr5,57701537,57701576,IMR90|chr5:16935405-16935485,chr5,16935405,16935485,0,40766132
IMR90|chr5:58230674-58230715,chr5,58230674,58230715,IMR90|chr5:139738762-139738871,chr5,139738762,139738871,0,81508088
IMR90|chr5:58279610-58279727,chr5,58279610,58279727,IMR90|chr5:72796920-72796953,chr5,72796920,72796953,0,14517310
IMR90|chr5:58345929-58346079,chr5,58345929,58346079,IMR90|chr5:131593793-131593835,chr5,131593793,131593835,0,73247864
IMR90|chr5:58604589-58604652,chr5,58604589,58604652,IMR90|chr5:141702237-141702259,chr5,141702237,141702259,0,83097648
IMR90|chr5:58730993-58731080,chr5,58730993,58731080,IMR90|chr5:151148639-151148657,chr5,151148639,151148657,0,92417646
IMR90|chr5:58774034-58774078,chr5,58774034,58774078,IMR90|chr5:176905964-176906013,chr5,176905964,176906013,0,118131930
IMR90|chr5:58860608-58860647,chr5,58860608,58860647,IMR90|chr5:33891081-33891146,chr5,33891081,33891146,0,24969527
IMR90|chr5:58863298-58863382,chr5,58863298,58863382,IMR90|chr5:9546896-9546956,chr5,9546896,9546956,0,49316402
IMR90|chr5:59506396-59506497,chr5,59506396,59506497,IMR90|chr5:133560297-133560345,chr5,133560297,133560345,0,74053901
IMR90|chr5:59597900-59597984,chr5,59597900,59597984,IMR90|chr5:14657702-14657766,chr5,14657702,14657766,0,44940198
IMR90|chr5:59722434-59722485,chr5,59722434,59722485,IMR90|chr5:98111615-98111646,chr5,98111615,98111646,0,38389181
IMR90|chr5:59853842-59853957,chr5,59853842,59853957,IMR90|chr5:17219324-17219359,chr5,17219324,17219359,0,42634518
IMR90|chr5:60230766-60230807,chr5,60230766,60230807,IMR90|chr5:148925544-148925623,chr5,148925544,148925623,0,88694778
IMR90|chr5:60372277-60372323,chr5,60372277,60372323,IMR90|chr5:176906196-176906346,chr5,176906196,176906346,0,116533919
IMR90|chr5:60389809-60389850,chr5,60389809,60389850,IMR90|chr5:179049059-179049168,chr5,179049059,179049168,0,118659250
IMR90|chr5:60459458-60459498,chr5,60459458,60459498,IMR90|chr5:176905831-176905917,chr5,176905831,176905917,0,116446373
IMR90|chr5:60582770-60582874,chr5,60582770,60582874,IMR90|chr5:16469463-16469488,chr5,16469463,16469488,0,44113307
IMR90|chr5:60641043-60641140,chr5,60641043,60641140,IMR90|chr5:176946455-176946488,chr5,176946455,176946488,0,116305412
IMR90|chr5:60988781-60988838,chr5,60988781,60988838,IMR90|chr5:150534477-150534530,chr5,150534477,150534530,0,89545696
IMR90|chr5:61359915-61359990,chr5,61359915,61359990,IMR90|chr5:149828322-149828393,chr5,149828322,149828393,0,88468407
IMR90|chr5:61638904-61638927,chr5,61638904,61638927,IMR90|chr5:32173518-32173634,chr5,32173518,32173634,0,29465386
IMR90|chr5:62343996-62344045,chr5,62343996,62344045,IMR90|chr5:170842185-170842283,chr5,170842185,170842283,0,108498189
IMR90|chr5:63033350-63033477,chr5,63033350,63033477,IMR90|chr5:444945-444968,chr5,444945,444968,0,62588405
IMR90|chr5:63477792-63477887,chr5,63477792,63477887,IMR90|chr5:16935426-16935445,chr5,16935426,16935445,0,46542366
IMR90|chr5:63672976-63673058,chr5,63672976,63673058,IMR90|chr5:56112899-56112917,chr5,56112899,56112917,0,7560077
IMR90|chr5:63884902-63885005,chr5,63884902,63885005,IMR90|chr5:121417830-121417906,chr5,121417830,121417906,0,57532928
IMR90|chr5:64016353-64016373,chr5,64016353,64016373,IMR90|chr5:140781117-140781247,chr5,140781117,140781247,0,76764764
IMR90|chr5:64100347-64100393,chr5,64100347,64100393,IMR90|chr5:172194848-172194890,chr5,172194848,172194890,0,108094501
IMR90|chr5:64348727-64348776,chr5,64348727,64348776,IMR90|chr5:60625303-60625453,chr5,60625303,60625453,0,3723424
IMR90|chr5:64969538-64969611,chr5,64969538,64969611,IMR90|chr5:6711975-6712052,chr5,6711975,6712052,0,58257563
IMR90|chr5:65018842-65018920,chr5,65018842,65018920,IMR90|chr5:176903869-176903941,chr5,176903869,176903941,0,111885027
IMR90|chr5:65117629-65117669,chr5,65117629,65117669,IMR90|chr5:176905831-176905917,chr5,176905831,176905917,0,111788202
IMR90|chr5:65119659-65119754,chr5,65119659,65119754,IMR90|chr5:138613227-138613262,chr5,138613227,138613262,0,73493568
IMR90|chr5:65212136-65212224,chr5,65212136,65212224,IMR90|chr5:140070250-140070312,chr5,140070250,140070312,0,74858114
IMR90|chr5:65310275-65310313,chr5,65310275,65310313,IMR90|chr5:179049540-179049630,chr5,179049540,179049630,0,113739265
IMR90|chr5:65649628-65649778,chr5,65649628,65649778,IMR90|chr5:131593793-131593835,chr5,131593793,131593835,0,65944165
IMR90|chr5:66063035-66063090,chr5,66063035,66063090,IMR90|chr5:98108054-98108143,chr5,98108054,98108143,0,32045019
IMR90|chr5:66089376-66089442,chr5,66089376,66089442,IMR90|chr5:148928032-148928135,chr5,148928032,148928135,0,82838656
IMR90|chr5:66133921-66133973,chr5,66133921,66133973,IMR90|chr5:17219951-17220032,chr5,17219951,17220032,0,48913970
IMR90|chr5:66295700-66295736,chr5,66295700,66295736,IMR90|chr5:141703123-141703198,chr5,141703123,141703198,0,75407423
IMR90|chr5:66426648-66426730,chr5,66426648,66426730,IMR90|chr5:60630259-60630322,chr5,60630259,60630322,0,5796389
IMR90|chr5:66624729-66624759,chr5,66624729,66624759,IMR90|chr5:171432572-171432695,chr5,171432572,171432695,0,104807843
IMR90|chr5:66797846-66797891,chr5,66797846,66797891,IMR90|chr5:14147657-14147708,chr5,14147657,14147708,0,52650189
IMR90|chr5:67766342-67766459,chr5,67766342,67766459,IMR90|chr5:72796920-72796953,chr5,72796920,72796953,0,5030578
IMR90|chr5:67915842-67915925,chr5,67915842,67915925,IMR90|chr5:74902618-74902662,chr5,74902618,74902662,0,6986776
IMR90|chr5:68343538-68343585,chr5,68343538,68343585,IMR90|chr5:151061335-151061438,chr5,151061335,151061438,0,82717797
IMR90|chr5:68501815-68501930,chr5,68501815,68501930,IMR90|chr5:172197026-172197044,chr5,172197026,172197044,0,103695211
IMR90|chr5:68532987-68533038,chr5,68532987,68533038,IMR90|chr5:43064669-43064758,chr5,43064669,43064758,0,25468318
IMR90|chr5:68596940-68597013,chr5,68596940,68597013,IMR90|chr5:172196181-172196225,chr5,172196181,172196225,0,103599241
IMR90|chr5:68690365-68690387,chr5,68690365,68690387,IMR90|chr5:141703753-141703842,chr5,141703753,141703842,0,73013388
IMR90|chr5:69282808-69282875,chr5,69282808,69282875,IMR90|chr5:133703316-133703362,chr5,133703316,133703362,0,64420508
IMR90|chr5:70097079-70097124,chr5,70097079,70097124,IMR90|chr5:14147657-14147708,chr5,14147657,14147708,0,55949422
IMR90|chr5:70189170-70189258,chr5,70189170,70189258,IMR90|chr5:14148763-14148851,chr5,14148763,14148851,0,56040407
IMR90|chr5:70241726-70241800,chr5,70241726,70241800,IMR90|chr5:141704241-141704303,chr5,141704241,141704303,0,71462515
IMR90|chr5:70528396-70528419,chr5,70528396,70528419,IMR90|chr5:176904579-176904663,chr5,176904579,176904663,0,106376183
IMR90|chr5:70938419-70938494,chr5,70938419,70938494,IMR90|chr5:151061540-151061564,chr5,151061540,151061564,0,80123121
IMR90|chr5:71305518-71305574,chr5,71305518,71305574,IMR90|chr5:148522443-148522502,chr5,148522443,148522502,0,77216925
IMR90|chr5:71917324-71917372,chr5,71917324,71917372,IMR90|chr5:151060537-151060603,chr5,151060537,151060603,0,79143213
IMR90|chr5:72323408-72323504,chr5,72323408,72323504,IMR90|chr5:141702442-141702592,chr5,141702442,141702592,0,69379034
IMR90|chr5:72401002-72401062,chr5,72401002,72401062,IMR90|chr5:151060835-151060925,chr5,151060835,151060925,0,78659833
IMR90|chr5:73271222-73271279,chr5,73271222,73271279,IMR90|chr5:176905248-176905303,chr5,176905248,176905303,0,103634026
IMR90|chr5:73302859-73302949,chr5,73302859,73302949,IMR90|chr5:176905766-176905806,chr5,176905766,176905806,0,103602907
IMR90|chr5:73423870-73423957,chr5,73423870,73423957,IMR90|chr5:151148639-151148657,chr5,151148639,151148657,0,77724769
IMR90|chr5:73449555-73449647,chr5,73449555,73449647,IMR90|chr5:90676436-90676490,chr5,90676436,90676490,0,17226881
IMR90|chr5:73567890-73567934,chr5,73567890,73567934,IMR90|chr5:172196323-172196370,chr5,172196323,172196370,0,98628433
IMR90|chr5:73715552-73715627,chr5,73715552,73715627,IMR90|chr5:179049487-179049556,chr5,179049487,179049556,0,105333935
IMR90|chr5:73973346-73973401,chr5,73973346,73973401,IMR90|chr5:176905967-176906037,chr5,176905967,176906037,0,102932621
IMR90|chr5:74212858-74212917,chr5,74212858,74212917,IMR90|chr5:34930873-34930936,chr5,34930873,34930936,0,39281985
IMR90|chr5:74224832-74224891,chr5,74224832,74224891,IMR90|chr5:149867532-149867565,chr5,149867532,149867565,0,75642700
IMR90|chr5:74314607-74314648,chr5,74314607,74314648,IMR90|chr5:179049059-179049168,chr5,179049059,179049168,0,104734452
IMR90|chr5:74386234-74386266,chr5,74386234,74386266,IMR90|chr5:138941541-138941645,chr5,138941541,138941645,0,64555307
IMR90|chr5:74435004-74435094,chr5,74435004,74435094,IMR90|chr5:60630633-60630668,chr5,60630633,60630668,0,13804371
IMR90|chr5:75060244-75060270,chr5,75060244,75060270,IMR90|chr5:10567808-10567924,chr5,10567808,10567924,0,64492436
IMR90|chr5:75086890-75086949,chr5,75086890,75086949,IMR90|chr5:176904131-176904201,chr5,176904131,176904201,0,101817241
IMR90|chr5:75280453-75280603,chr5,75280453,75280603,IMR90|chr5:43064870-43064921,chr5,43064870,43064921,0,32215583
IMR90|chr5:75738338-75738404,chr5,75738338,75738404,IMR90|chr5:148928032-148928135,chr5,148928032,148928135,0,73189694
IMR90|chr5:75772615-75772682,chr5,75772615,75772682,IMR90|chr5:170844552-170844586,chr5,170844552,170844586,0,95071937
IMR90|chr5:75810456-75810510,chr5,75810456,75810510,IMR90|chr5:114520158-114520254,chr5,114520158,114520254,0,38709702
IMR90|chr5:75870455-75870498,chr5,75870455,75870498,IMR90|chr5:151137545-151137620,chr5,151137545,151137620,0,75267090
IMR90|chr5:75957572-75957623,chr5,75957572,75957623,IMR90|chr5:141734780-141734879,chr5,141734780,141734879,0,65777208
IMR90|chr5:76449020-76449082,chr5,76449020,76449082,IMR90|chr5:141700839-141700900,chr5,141700839,141700900,0,65251819
IMR90|chr5:76523129-76523186,chr5,76523129,76523186,IMR90|chr5:162864918-162864994,chr5,162864918,162864994,0,86341789
IMR90|chr5:77008195-77008217,chr5,77008195,77008217,IMR90|chr5:171432284-171432400,chr5,171432284,171432400,0,94424089
IMR90|chr5:77371507-77371622,chr5,77371507,77371622,IMR90|chr5:179718831-179718849,chr5,179718831,179718849,0,102347324
IMR90|chr5:77604356-77604412,chr5,77604356,77604412,IMR90|chr5:148522443-148522502,chr5,148522443,148522502,0,70918087
IMR90|chr5:77654729-77654830,chr5,77654729,77654830,IMR90|chr5:133560297-133560345,chr5,133560297,133560345,0,55905568
IMR90|chr5:77680953-77681012,chr5,77680953,77681012,IMR90|chr5:140792526-140792556,chr5,140792526,140792556,0,63111573
IMR90|chr5:77743912-77744005,chr5,77743912,77744005,IMR90|chr5:114520159-114520216,chr5,114520159,114520216,0,36776247
IMR90|chr5:77990700-77990798,chr5,77990700,77990798,IMR90|chr5:141028452-141028504,chr5,141028452,141028504,0,63037752
IMR90|chr5:78425689-78425727,chr5,78425689,78425727,IMR90|chr5:141703677-141703821,chr5,141703677,141703821,0,63277988
IMR90|chr5:78461357-78461441,chr5,78461357,78461441,IMR90|chr5:151060265-151060287,chr5,151060265,151060287,0,72598908
IMR90|chr5:78495216-78495289,chr5,78495216,78495289,IMR90|chr5:175967629-175967681,chr5,175967629,175967681,0,97472413
IMR90|chr5:78701206-78701350,chr5,78701206,78701350,IMR90|chr5:176904892-176904915,chr5,176904892,176904915,0,98203686
IMR90|chr5:78710355-78710393,chr5,78710355,78710393,IMR90|chr5:141703677-141703821,chr5,141703677,141703821,0,62993322
IMR90|chr5:78859668-78859700,chr5,78859668,78859700,IMR90|chr5:138941541-138941645,chr5,138941541,138941645,0,60081873
IMR90|chr5:78887052-78887076,chr5,78887052,78887076,IMR90|chr5:17219951-17220030,chr5,17219951,17220030,0,61667101
IMR90|chr5:79110098-79110199,chr5,79110098,79110199,IMR90|chr5:176906236-176906331,chr5,176906236,176906331,0,97796138
IMR90|chr5:79114969-79115048,chr5,79114969,79115048,IMR90|chr5:141703952-141704004,chr5,141703952,141704004,0,62588983
IMR90|chr5:79442613-79442672,chr5,79442613,79442672,IMR90|chr5:121414045-121414109,chr5,121414045,121414109,0,41971432
IMR90|chr5:79504870-79504954,chr5,79504870,79504954,IMR90|chr5:14657702-14657766,chr5,14657702,14657766,0,64847168
IMR90|chr5:79640431-79640455,chr5,79640431,79640455,IMR90|chr5:98112498-98112621,chr5,98112498,98112621,0,18472067
IMR90|chr5:80098525-80098641,chr5,80098525,80098641,IMR90|chr5:141028452-141028504,chr5,141028452,141028504,0,60929927
IMR90|chr5:80128557-80128597,chr5,80128557,80128597,IMR90|chr5:14147741-14147797,chr5,14147741,14147797,0,65980816
IMR90|chr5:80199473-80199533,chr5,80199473,80199533,IMR90|chr5:151060835-151060925,chr5,151060835,151060925,0,70861362
IMR90|chr5:80217801-80217820,chr5,80217801,80217820,IMR90|chr5:141702595-141702645,chr5,141702595,141702645,0,61484794
IMR90|chr5:80864742-80864783,chr5,80864742,80864783,IMR90|chr5:176905888-176905917,chr5,176905888,176905917,0,96041146
IMR90|chr5:81045909-81046010,chr5,81045909,81046010,IMR90|chr5:172752234-172752282,chr5,172752234,172752282,0,91706325
IMR90|chr5:81544408-81544523,chr5,81544408,81544523,IMR90|chr5:172197026-172197044,chr5,172197026,172197044,0,90652618
IMR90|chr5:81788275-81788306,chr5,81788275,81788306,IMR90|chr5:138941541-138941645,chr5,138941541,138941645,0,57153266
IMR90|chr5:82229669-82229819,chr5,82229669,82229819,IMR90|chr5:176904175-176904230,chr5,176904175,176904230,0,94674506
IMR90|chr5:82584254-82584319,chr5,82584254,82584319,IMR90|chr5:159612478-159612540,chr5,159612478,159612540,0,77028224
IMR90|chr5:83242140-83242186,chr5,83242140,83242186,IMR90|chr5:138634164-138634267,chr5,138634164,138634267,0,55392024
IMR90|chr5:83348248-83348365,chr5,83348248,83348365,IMR90|chr5:150160261-150160307,chr5,150160261,150160307,0,66812013
IMR90|chr5:83393355-83393449,chr5,83393355,83393449,IMR90|chr5:132167824-132167877,chr5,132167824,132167877,0,48774469
IMR90|chr5:83671640-83671715,chr5,83671640,83671715,IMR90|chr5:60631021-60631096,chr5,60631021,60631096,0,23040619
IMR90|chr5:84383942-84384092,chr5,84383942,84384092,IMR90|chr5:43064870-43064921,chr5,43064870,43064921,0,41319072
IMR90|chr5:84489448-84489485,chr5,84489448,84489485,IMR90|chr5:95296687-95296823,chr5,95296687,95296823,0,10807239
IMR90|chr5:85016610-85016654,chr5,85016610,85016654,IMR90|chr5:83679849-83679955,chr5,83679849,83679955,0,1336761
IMR90|chr5:85101966-85102016,chr5,85101966,85102016,IMR90|chr5:148928254-148928379,chr5,148928254,148928379,0,63826288
IMR90|chr5:85154507-85154604,chr5,85154507,85154604,IMR90|chr5:40833614-40833662,chr5,40833614,40833662,0,44320893
IMR90|chr5:85259603-85259674,chr5,85259603,85259674,IMR90|chr5:151065120-151065193,chr5,151065120,151065193,0,65805517
IMR90|chr5:85469574-85469611,chr5,85469574,85469611,IMR90|chr5:443700-443754,chr5,443700,443754,0,85025874
IMR90|chr5:85768630-85768685,chr5,85768630,85768685,IMR90|chr5:72797306-72797348,chr5,72797306,72797348,0,12971324
IMR90|chr5:85799682-85799757,chr5,85799682,85799757,IMR90|chr5:141702566-141702605,chr5,141702566,141702605,0,55902884
IMR90|chr5:85981662-85981716,chr5,85981662,85981716,IMR90|chr5:150534500-150534533,chr5,150534500,150534533,0,64552838
IMR90|chr5:86090726-86090822,chr5,86090726,86090822,IMR90|chr5:137879988-137880034,chr5,137879988,137880034,0,51789262
IMR90|chr5:86810412-86810458,chr5,86810412,86810458,IMR90|chr5:14147153-14147215,chr5,14147153,14147215,0,72663259
IMR90|chr5:86917631-86917766,chr5,86917631,86917766,IMR90|chr5:176903869-176903941,chr5,176903869,176903941,0,89986238
IMR90|chr5:87802986-87803008,chr5,87802986,87803008,IMR90|chr5:178053406-178053495,chr5,178053406,178053495,0,90250420
IMR90|chr5:87909954-87910007,chr5,87909954,87910007,IMR90|chr5:34658853-34658933,chr5,34658853,34658933,0,53251101
IMR90|chr5:88030995-88031096,chr5,88030995,88031096,IMR90|chr5:132298692-132298803,chr5,132298692,132298803,0,44267697
IMR90|chr5:88068433-88068487,chr5,88068433,88068487,IMR90|chr5:43041973-43042019,chr5,43041973,43042019,0,45026460
IMR90|chr5:88224536-88224602,chr5,88224536,88224602,IMR90|chr5:176905748-176905827,chr5,176905748,176905827,0,88681212
IMR90|chr5:88384636-88384686,chr5,88384636,88384686,IMR90|chr5:150159470-150159602,chr5,150159470,150159602,0,61774834
IMR90|chr5:88894370-88894420,chr5,88894370,88894420,IMR90|chr5:34660749-34660798,chr5,34660749,34660798,0,54233621
IMR90|chr5:89105741-89105860,chr5,89105741,89105860,IMR90|chr5:141028452-141028504,chr5,141028452,141028504,0,51922711
IMR90|chr5:89110947-89110991,chr5,89110947,89110991,IMR90|chr5:14147741-14147797,chr5,14147741,14147797,0,74963206
IMR90|chr5:89907567-89907637,chr5,89907567,89907637,IMR90|chr5:176905513-176905576,chr5,176905513,176905576,0,86997946
IMR90|chr5:90227504-90227535,chr5,90227504,90227535,IMR90|chr5:148925447-148925597,chr5,148925447,148925597,0,58697943
IMR90|chr5:91153937-91153960,chr5,91153937,91153960,IMR90|chr5:32173518-32173634,chr5,32173518,32173634,0,58980419
IMR90|chr5:91219592-91219665,chr5,91219592,91219665,IMR90|chr5:141703331-141703368,chr5,141703331,141703368,0,50483739
IMR90|chr5:91281170-91281217,chr5,91281170,91281217,IMR90|chr5:148928032-148928135,chr5,148928032,148928135,0,57646862
IMR90|chr5:91651084-91651132,chr5,91651084,91651132,IMR90|chr5:52285628-52285657,chr5,52285628,52285657,0,39365456
IMR90|chr5:91764475-91764508,chr5,91764475,91764508,IMR90|chr5:443993-444057,chr5,443993,444057,0,91320482
IMR90|chr5:91881475-91881516,chr5,91881475,91881516,IMR90|chr5:79649850-79649956,chr5,79649850,79649956,0,12231625
IMR90|chr5:91904315-91904357,chr5,91904315,91904357,IMR90|chr5:34660259-34660376,chr5,34660259,34660376,0,57244056
IMR90|chr5:92300109-92300190,chr5,92300109,92300190,IMR90|chr5:34661069-34661126,chr5,34661069,34661126,0,57639040
IMR90|chr5:92417909-92417987,chr5,92417909,92417987,IMR90|chr5:176903869-176903941,chr5,176903869,176903941,0,84485960
IMR90|chr5:92590240-92590298,chr5,92590240,92590298,IMR90|chr5:121412463-121412515,chr5,121412463,121412515,0,28822223
IMR90|chr5:92618747-92618816,chr5,92618747,92618816,IMR90|chr5:176905888-176905917,chr5,176905888,176905917,0,84287141
IMR90|chr5:92853772-92853825,chr5,92853772,92853825,IMR90|chr5:17219951-17220032,chr5,17219951,17220032,0,75633821
IMR90|chr5:93316038-93316074,chr5,93316038,93316074,IMR90|chr5:141703123-141703198,chr5,141703123,141703198,0,48387085
IMR90|chr5:93422406-93422431,chr5,93422406,93422431,IMR90|chr5:138942228-138942326,chr5,138942228,138942326,0,45519822
IMR90|chr5:93423430-93423499,chr5,93423430,93423499,IMR90|chr5:141706346-141706387,chr5,141706346,141706387,0,48282916
IMR90|chr5:93697838-93697913,chr5,93697838,93697913,IMR90|chr5:17219093-17219104,chr5,17219093,17219104,0,76478745
IMR90|chr5:93861023-93861116,chr5,93861023,93861116,IMR90|chr5:141701159-141701216,chr5,141701159,141701216,0,47840136
IMR90|chr5:93951531-93951605,chr5,93951531,93951605,IMR90|chr5:121417830-121417906,chr5,121417830,121417906,0,27466299
IMR90|chr5:93981808-93981832,chr5,93981808,93981832,IMR90|chr5:137885482-137885546,chr5,137885482,137885546,0,43903674
IMR90|chr5:94205160-94205266,chr5,94205160,94205266,IMR90|chr5:14657702-14657766,chr5,14657702,14657766,0,79547458
IMR90|chr5:94833203-94833234,chr5,94833203,94833234,IMR90|chr5:172196938-172196984,chr5,172196938,172196984,0,77363735
IMR90|chr5:94851552-94851632,chr5,94851552,94851632,IMR90|chr5:14870255-14870311,chr5,14870255,14870311,0,79981297
IMR90|chr5:95442302-95442333,chr5,95442302,95442333,IMR90|chr5:172754284-172754377,chr5,172754284,172754377,0,77311982
IMR90|chr5:95468818-95468880,chr5,95468818,95468880,IMR90|chr5:14148763-14148851,chr5,14148763,14148851,0,81320055
IMR90|chr5:95536463-95536578,chr5,95536463,95536578,IMR90|chr5:121411044-121411141,chr5,121411044,121411141,0,25874581
IMR90|chr5:95613013-95613098,chr5,95613013,95613098,IMR90|chr5:68510018-68510083,chr5,68510018,68510083,0,27102995
IMR90|chr5:95805998-95806045,chr5,95805998,95806045,IMR90|chr5:71614316-71614443,chr5,71614316,71614443,0,24191682
IMR90|chr5:96120158-96120194,chr5,96120158,96120194,IMR90|chr5:141702420-141702545,chr5,141702420,141702545,0,45582262
IMR90|chr5:96235352-96235405,chr5,96235352,96235405,IMR90|chr5:34658853-34658933,chr5,34658853,34658933,0,61576499
IMR90|chr5:96320308-96320373,chr5,96320308,96320373,IMR90|chr5:149866380-149866430,chr5,149866380,149866430,0,53546072
IMR90|chr5:96485958-96486008,chr5,96485958,96486008,IMR90|chr5:17219951-17220030,chr5,17219951,17220030,0,79266007
IMR90|chr5:96677512-96677589,chr5,96677512,96677589,IMR90|chr5:172197093-172197158,chr5,172197093,172197158,0,75519581
IMR90|chr5:96806941-96806972,chr5,96806941,96806972,IMR90|chr5:60624376-60624451,chr5,60624376,60624451,0,36182565
IMR90|chr5:97211277-97211365,chr5,97211277,97211365,IMR90|chr5:14148763-14148851,chr5,14148763,14148851,0,83062514
IMR90|chr5:97418946-97419039,chr5,97418946,97419039,IMR90|chr5:64786020-64786052,chr5,64786020,64786052,0,32632926
IMR90|chr5:97475523-97475570,chr5,97475523,97475570,IMR90|chr5:141702121-141702182,chr5,141702121,141702182,0,44226598
IMR90|chr5:98067977-98068031,chr5,98067977,98068031,IMR90|chr5:114520158-114520254,chr5,114520158,114520254,0,16452181
IMR90|chr5:98133772-98133860,chr5,98133772,98133860,IMR90|chr5:151148639-151148657,chr5,151148639,151148657,0,53014867
IMR90|chr5:98171110-98171196,chr5,98171110,98171196,IMR90|chr5:60630259-60630322,chr5,60630259,60630322,0,37540851
IMR90|chr5:98196475-98196512,chr5,98196475,98196512,IMR90|chr5:140791376-140791424,chr5,140791376,140791424,0,42594901
IMR90|chr5:98298465-98298496,chr5,98298465,98298496,IMR90|chr5:172196938-172196984,chr5,172196938,172196984,0,73898473
IMR90|chr5:98503423-98503462,chr5,98503423,98503462,IMR90|chr5:132298692-132298803,chr5,132298692,132298803,0,33795269
IMR90|chr5:99010899-99010965,chr5,99010899,99010965,IMR90|chr5:176904189-176904254,chr5,176904189,176904254,0,77893290
IMR90|chr5:99093292-99093329,chr5,99093292,99093329,IMR90|chr5:176904343-176904416,chr5,176904343,176904416,0,77811051
IMR90|chr5:99218610-99218669,chr5,99218610,99218669,IMR90|chr5:149867532-149867565,chr5,149867532,149867565,0,50648922
IMR90|chr5:99219248-99219321,chr5,99219248,99219321,IMR90|chr5:14148737-14148827,chr5,14148737,14148827,0,85070511
IMR90|chr5:99276943-99276994,chr5,99276943,99276994,IMR90|chr5:98111615-98111646,chr5,98111615,98111646,0,1165328
IMR90|chr5:99314948-99315030,chr5,99314948,99315030,IMR90|chr5:56112899-56112917,chr5,56112899,56112917,0,43202049
IMR90|chr5:99348085-99348143,chr5,99348085,99348143,IMR90|chr5:121412463-121412515,chr5,121412463,121412515,0,22064378
IMR90|chr5:99423325-99423472,chr5,99423325,99423472,IMR90|chr5:170842185-170842283,chr5,170842185,170842283,0,71418860
IMR90|chr5:99526954-99526980,chr5,99526954,99526980,IMR90|chr5:151061209-151061284,chr5,151061209,151061284,0,51534255
IMR90|chr5:99611069-99611119,chr5,99611069,99611119,IMR90|chr5:14147153-14147215,chr5,14147153,14147215,0,85463916
IMR90|chr5:99631111-99631186,chr5,99631111,99631186,IMR90|chr5:179049487-179049556,chr5,179049487,179049556,0,79418376
IMR90|chr5:99782065-99782151,chr5,99782065,99782151,IMR90|chr5:141703150-141703190,chr5,141703150,141703190,0,41921085
IMR90|chr5:99982725-99982805,chr5,99982725,99982805,IMR90|chr5:14870255-14870311,chr5,14870255,14870311,0,85112470
IMR90|chr5:100143946-100143983,chr5,100143946,100143983,IMR90|chr5:176904343-176904416,chr5,176904343,176904416,0,76760397
IMR90|chr5:100191365-100191438,chr5,100191365,100191438,IMR90|chr5:14148737-14148827,chr5,14148737,14148827,0,86042628
IMR90|chr5:100943134-100943151,chr5,100943134,100943151,IMR90|chr5:14139992-14140139,chr5,14139992,14140139,0,86803142
IMR90|chr5:101311449-101311539,chr5,101311449,101311539,IMR90|chr5:16935426-16935445,chr5,16935426,16935445,0,84376023
IMR90|chr5:101532873-101532965,chr5,101532873,101532965,IMR90|chr5:176905907-176905956,chr5,176905907,176905956,0,75373034
IMR90|chr5:101703124-101703182,chr5,101703124,101703182,IMR90|chr5:150534477-150534530,chr5,150534477,150534530,0,48831353
IMR90|chr5:101737923-101737973,chr5,101737923,101737973,IMR90|chr5:34660749-34660798,chr5,34660749,34660798,0,67077174
IMR90|chr5:101877035-101877082,chr5,101877035,101877082,IMR90|chr5:179049059-179049168,chr5,179049059,179049168,0,77172024
IMR90|chr5:101974253-101974323,chr5,101974253,101974323,IMR90|chr5:141701325-141701351,chr5,141701325,141701351,0,39727072
IMR90|chr5:102043812-102043854,chr5,102043812,102043854,IMR90|chr5:34660259-34660376,chr5,34660259,34660376,0,67383553
IMR90|chr5:102126254-102126346,chr5,102126254,102126346,IMR90|chr5:162934274-162934327,chr5,162934274,162934327,0,60808020
IMR90|chr5:102139864-102139899,chr5,102139864,102139899,IMR90|chr5:148522443-148522502,chr5,148522443,148522502,0,46382579
IMR90|chr5:102158609-102158698,chr5,102158609,102158698,IMR90|chr5:149532346-149532407,chr5,149532346,149532407,0,47373737
IMR90|chr5:102517208-102517309,chr5,102517208,102517309,IMR90|chr5:172752234-172752282,chr5,172752234,172752282,0,70235026
IMR90|chr5:102867878-102867979,chr5,102867878,102867979,IMR90|chr5:132298692-132298803,chr5,132298692,132298803,0,29430814
IMR90|chr5:102903347-102903437,chr5,102903347,102903437,IMR90|chr5:60630633-60630668,chr5,60630633,60630668,0,42272714
IMR90|chr5:103151501-103151586,chr5,103151501,103151586,IMR90|chr5:68510018-68510083,chr5,68510018,68510083,0,34641483
IMR90|chr5:104087286-104087362,chr5,104087286,104087362,IMR90|chr5:141702566-141702605,chr5,141702566,141702605,0,37615280
IMR90|chr5:104125334-104125394,chr5,104125334,104125394,IMR90|chr5:140792526-140792556,chr5,140792526,140792556,0,36667192
IMR90|chr5:104193102-104193125,chr5,104193102,104193125,IMR90|chr5:60624376-60624451,chr5,60624376,60624451,0,43568726
IMR90|chr5:104533473-104533504,chr5,104533473,104533504,IMR90|chr5:172754284-172754377,chr5,172754284,172754377,0,68220811
IMR90|chr5:104672036-104672081,chr5,104672036,104672081,IMR90|chr5:64787717-64787788,chr5,64787717,64787788,0,39884319
IMR90|chr5:104687074-104687159,chr5,104687074,104687159,IMR90|chr5:141703150-141703190,chr5,141703150,141703190,0,37016076
IMR90|chr5:104909108-104909162,chr5,104909108,104909162,IMR90|chr5:43041973-43042019,chr5,43041973,43042019,0,61867135
IMR90|chr5:105087198-105087252,chr5,105087198,105087252,IMR90|chr5:148522695-148522777,chr5,148522695,148522777,0,43435497
IMR90|chr5:105517001-105517060,chr5,105517001,105517060,IMR90|chr5:121414045-121414109,chr5,121414045,121414109,0,15897044
IMR90|chr5:105875401-105875423,chr5,105875401,105875423,IMR90|chr5:176924019-176924088,chr5,176924019,176924088,0,71048618
IMR90|chr5:106235905-106235968,chr5,106235905,106235968,IMR90|chr5:170815817-170815964,chr5,170815817,170815964,0,64579912
IMR90|chr5:106251068-106251142,chr5,106251068,106251142,IMR90|chr5:176906236-176906331,chr5,176906236,176906331,0,70655168
IMR90|chr5:106651974-106652058,chr5,106651974,106652058,IMR90|chr5:9546896-9546956,chr5,9546896,9546956,0,97105078
IMR90|chr5:106728161-106728208,chr5,106728161,106728208,IMR90|chr5:179049059-179049168,chr5,179049059,179049168,0,72320898
IMR90|chr5:106966247-106966338,chr5,106966247,106966338,IMR90|chr5:34657370-34657407,chr5,34657370,34657407,0,72308877
IMR90|chr5:107473580-107473685,chr5,107473580,107473685,IMR90|chr5:176905513-176905577,chr5,176905513,176905577,0,69431933
IMR90|chr5:107502471-107502531,chr5,107502471,107502531,IMR90|chr5:14148737-14148827,chr5,14148737,14148827,0,93353734
IMR90|chr5:107581431-107581470,chr5,107581431,107581470,IMR90|chr5:33891081-33891146,chr5,33891081,33891146,0,73690350
IMR90|chr5:107584118-107584211,chr5,107584118,107584211,IMR90|chr5:114520159-114520216,chr5,114520159,114520216,0,6936041
IMR90|chr5:107617717-107617831,chr5,107617717,107617831,IMR90|chr5:176904892-176904915,chr5,176904892,176904915,0,69287175
IMR90|chr5:107618627-107618701,chr5,107618627,107618701,IMR90|chr5:162867394-162867470,chr5,162867394,162867470,0,55248767
IMR90|chr5:107705403-107705477,chr5,107705403,107705477,IMR90|chr5:162867394-162867470,chr5,162867394,162867470,0,55161991
IMR90|chr5:107832604-107832689,chr5,107832604,107832689,IMR90|chr5:141701869-141701958,chr5,141701869,141701958,0,33869265
IMR90|chr5:107889137-107889169,chr5,107889137,107889169,IMR90|chr5:60624376-60624451,chr5,60624376,60624451,0,47264761
IMR90|chr5:108020797-108020882,chr5,108020797,108020882,IMR90|chr5:162867394-162867470,chr5,162867394,162867470,0,54846597
IMR90|chr5:108162755-108162859,chr5,108162755,108162859,IMR90|chr5:83679849-83679955,chr5,83679849,83679955,0,24482906
IMR90|chr5:108344760-108344800,chr5,108344760,108344800,IMR90|chr5:172751953-172752012,chr5,172751953,172752012,0,64407193
IMR90|chr5:108426146-108426199,chr5,108426146,108426199,IMR90|chr5:176906020-176906072,chr5,176906020,176906072,0,68479874
IMR90|chr5:108750096-108750132,chr5,108750096,108750132,IMR90|chr5:141702420-141702545,chr5,141702420,141702545,0,32952324
IMR90|chr5:108769434-108769480,chr5,108769434,108769480,IMR90|chr5:176906037-176906069,chr5,176906037,176906069,0,68136603
IMR90|chr5:108825938-108826029,chr5,108825938,108826029,IMR90|chr5:34657370-34657407,chr5,34657370,34657407,0,74168568
IMR90|chr5:109032431-109032525,chr5,109032431,109032525,IMR90|chr5:14146591-14146657,chr5,14146591,14146657,0,94885840
IMR90|chr5:109078491-109078602,chr5,109078491,109078602,IMR90|chr5:98107499-98107538,chr5,98107499,98107538,0,10970992
IMR90|chr5:109104561-109104666,chr5,109104561,109104666,IMR90|chr5:16469463-16469488,chr5,16469463,16469488,0,92635098
IMR90|chr5:109201574-109201608,chr5,109201574,109201608,IMR90|chr5:39424425-39424519,chr5,39424425,39424519,0,69777149
IMR90|chr5:109210185-109210243,chr5,109210185,109210243,IMR90|chr5:34930873-34930936,chr5,34930873,34930936,0,74279312
IMR90|chr5:109211397-109211541,chr5,109211397,109211541,IMR90|chr5:176904892-176904915,chr5,176904892,176904915,0,67693495
IMR90|chr5:109634532-109634605,chr5,109634532,109634605,IMR90|chr5:148926087-148926200,chr5,148926087,148926200,0,39291555
IMR90|chr5:109726943-109727024,chr5,109726943,109727024,IMR90|chr5:151060265-151060287,chr5,151060265,151060287,0,41333322
IMR90|chr5:109895432-109895482,chr5,109895432,109895482,IMR90|chr5:176905766-176905806,chr5,176905766,176905806,0,67010334
IMR90|chr5:110153251-110153301,chr5,110153251,110153301,IMR90|chr5:151064549-151064601,chr5,151064549,151064601,0,40911298
IMR90|chr5:110321850-110321913,chr5,110321850,110321913,IMR90|chr5:134074873-134074924,chr5,134074873,134074924,0,23753023
IMR90|chr5:110670994-110671051,chr5,110670994,110671051,IMR90|chr5:14144143-14144236,chr5,14144143,14144236,0,96526851
IMR90|chr5:110701373-110701442,chr5,110701373,110701442,IMR90|chr5:176905888-176905917,chr5,176905888,176905917,0,66204515
IMR90|chr5:110794577-110794616,chr5,110794577,110794616,IMR90|chr5:141701950-141702038,chr5,141701950,141702038,0,30907373
IMR90|chr5:110811379-110811418,chr5,110811379,110811418,IMR90|chr5:138634164-138634267,chr5,138634164,138634267,0,27822785
IMR90|chr5:110941457-110941560,chr5,110941457,110941560,IMR90|chr5:130604713-130604744,chr5,130604713,130604744,0,19663256
IMR90|chr5:111292679-111292750,chr5,111292679,111292750,IMR90|chr5:178053416-178053495,chr5,178053416,178053495,0,66760737
IMR90|chr5:111433384-111433470,chr5,111433384,111433470,IMR90|chr5:176906212-176906249,chr5,176906212,176906249,0,65472828
IMR90|chr5:111695624-111695677,chr5,111695624,111695677,IMR90|chr5:176904559-176904609,chr5,176904559,176904609,0,65208935
IMR90|chr5:111910030-111910088,chr5,111910030,111910088,IMR90|chr5:32172553-32172626,chr5,32172553,32172626,0,79737477
IMR90|chr5:112154452-112154527,chr5,112154452,112154527,IMR90|chr5:60631021-60631096,chr5,60631021,60631096,0,51523431
IMR90|chr5:112266795-112266869,chr5,112266795,112266869,IMR90|chr5:141704241-141704303,chr5,141704241,141704303,0,29437446
IMR90|chr5:112898681-112898805,chr5,112898681,112898805,IMR90|chr5:176904892-176904915,chr5,176904892,176904915,0,64006211
IMR90|chr5:113122740-113122833,chr5,113122740,113122833,IMR90|chr5:14146626-14146670,chr5,14146626,14146670,0,98976114
IMR90|chr5:113431596-113431701,chr5,113431596,113431701,IMR90|chr5:176905513-176905577,chr5,176905513,176905577,0,63473917
IMR90|chr5:113591634-113591708,chr5,113591634,113591708,IMR90|chr5:121417830-121417906,chr5,121417830,121417906,0,7826196
IMR90|chr5:113756396-113756546,chr5,113756396,113756546,IMR90|chr5:176904175-176904230,chr5,176904175,176904230,0,63147779
IMR90|chr5:113926494-113926607,chr5,113926494,113926607,IMR90|chr5:179718831-179718849,chr5,179718831,179718849,0,65792337
IMR90|chr5:114041882-114041953,chr5,114041882,114041953,IMR90|chr5:151065120-151065193,chr5,151065120,151065193,0,37023238
IMR90|chr5:114341230-114341252,chr5,114341230,114341252,IMR90|chr5:141703753-141703842,chr5,141703753,141703842,0,27362523
IMR90|chr5:114373170-114373268,chr5,114373170,114373268,IMR90|chr5:176946455-176946488,chr5,176946455,176946488,0,62573285
IMR90|chr5:114443657-114443702,chr5,114443657,114443702,IMR90|chr5:151137246-151137303,chr5,151137246,151137303,0,36693589
IMR90|chr5:114552003-114552076,chr5,114552003,114552076,IMR90|chr5:176904036-176904113,chr5,176904036,176904113,0,62352033
IMR90|chr5:114693501-114693562,chr5,114693501,114693562,IMR90|chr5:176905560-176905710,chr5,176905560,176905710,0,62212059
IMR90|chr5:115183701-115183808,chr5,115183701,115183808,IMR90|chr5:151060964-151060987,chr5,151060964,151060987,0,35877263
IMR90|chr5:115290399-115290468,chr5,115290399,115290468,IMR90|chr5:175967629-175967681,chr5,175967629,175967681,0,60677230
IMR90|chr5:115484367-115484474,chr5,115484367,115484474,IMR90|chr5:151060964-151060987,chr5,151060964,151060987,0,35576597
IMR90|chr5:115631985-115632101,chr5,115631985,115632101,IMR90|chr5:176904036-176904113,chr5,176904036,176904113,0,61272051
IMR90|chr5:115933896-115933922,chr5,115933896,115933922,IMR90|chr5:43041431-43041519,chr5,43041431,43041519,0,72892465
IMR90|chr5:115946366-115946421,chr5,115946366,115946421,IMR90|chr5:148522444-148522486,chr5,148522444,148522486,0,32576078
IMR90|chr5:116309536-116309609,chr5,116309536,116309609,IMR90|chr5:6711975-6712052,chr5,6711975,6712052,0,109597561
IMR90|chr5:117185809-117185846,chr5,117185809,117185846,IMR90|chr5:443700-443754,chr5,443700,443754,0,116742109
IMR90|chr5:117467503-117467563,chr5,117467503,117467563,IMR90|chr5:132167788-132167878,chr5,132167788,132167878,0,14700285
IMR90|chr5:117576463-117576495,chr5,117576463,117576495,IMR90|chr5:34657712-34657796,chr5,34657712,34657796,0,82918751
IMR90|chr5:119117849-119117954,chr5,119117849,119117954,IMR90|chr5:16469463-16469488,chr5,16469463,16469488,0,102648386
IMR90|chr5:119257670-119257774,chr5,119257670,119257774,IMR90|chr5:150160261-150160307,chr5,150160261,150160307,0,30902591
IMR90|chr5:119526303-119526365,chr5,119526303,119526365,IMR90|chr5:141703175-141703262,chr5,141703175,141703262,0,22176872
IMR90|chr5:119568932-119569005,chr5,119568932,119569005,IMR90|chr5:141703331-141703368,chr5,141703331,141703368,0,22134399
IMR90|chr5:120421355-120421452,chr5,120421355,120421452,IMR90|chr5:40833614-40833662,chr5,40833614,40833662,0,79587741
IMR90|chr5:120488344-120488469,chr5,120488344,120488469,IMR90|chr5:444943-444968,chr5,444943,444968,0,120043401
IMR90|chr5:120576607-120576701,chr5,120576607,120576701,IMR90|chr5:64786020-64786052,chr5,64786020,64786052,0,55790587
IMR90|chr5:120740734-120740764,chr5,120740734,120740764,IMR90|chr5:176904684-176904726,chr5,176904684,176904726,0,56163950
IMR90|chr5:120772509-120772613,chr5,120772509,120772613,IMR90|chr5:172196938-172196984,chr5,172196938,172196984,0,51424429
IMR90|chr5:120811120-120811214,chr5,120811120,120811214,IMR90|chr5:17219105-17219155,chr5,17219105,17219155,0,103592015
IMR90|chr5:121328629-121328684,chr5,121328629,121328684,IMR90|chr5:98108054-98108143,chr5,98108054,98108143,0,23220575
IMR90|chr5:121476520-121476551,chr5,121476520,121476551,IMR90|chr5:60624376-60624451,chr5,60624376,60624451,0,60852144
IMR90|chr5:121489175-121489293,chr5,121489175,121489293,IMR90|chr5:150534776-150534845,chr5,150534776,150534845,0,29045601
IMR90|chr5:122012538-122012616,chr5,122012538,122012616,IMR90|chr5:141700467-141700523,chr5,141700467,141700523,0,19687929
IMR90|chr5:122102859-122102991,chr5,122102859,122102991,IMR90|chr5:172197026-172197044,chr5,172197026,172197044,0,50094167
IMR90|chr5:122114255-122114279,chr5,122114255,122114279,IMR90|chr5:32173518-32173634,chr5,32173518,32173634,0,89940737
IMR90|chr5:122264500-122264549,chr5,122264500,122264549,IMR90|chr5:60625303-60625453,chr5,60625303,60625453,0,61639197
IMR90|chr5:122533585-122533628,chr5,122533585,122533628,IMR90|chr5:43190601-43190645,chr5,43190601,43190645,0,79342984
IMR90|chr5:122910837-122910908,chr5,122910837,122910908,IMR90|chr5:176904684-176904726,chr5,176904684,176904726,0,53993847
IMR90|chr5:123226945-123226999,chr5,123226945,123226999,IMR90|chr5:141700538-141700621,chr5,141700538,141700621,0,18473593
IMR90|chr5:123250833-123250857,chr5,123250833,123250857,IMR90|chr5:138942228-138942326,chr5,138942228,138942326,0,15691395
IMR90|chr5:123271035-123271092,chr5,123271035,123271092,IMR90|chr5:176904131-176904201,chr5,176904131,176904201,0,53633096
IMR90|chr5:123472361-123472424,chr5,123472361,123472424,IMR90|chr5:138613227-138613262,chr5,138613227,138613262,0,15140866
IMR90|chr5:123634844-123634874,chr5,123634844,123634874,IMR90|chr5:176904684-176904726,chr5,176904684,176904726,0,53269840
IMR90|chr5:123692115-123692208,chr5,123692115,123692208,IMR90|chr5:64786020-64786052,chr5,64786020,64786052,0,58906095
IMR90|chr5:123830717-123830735,chr5,123830717,123830735,IMR90|chr5:113696796-113696915,chr5,113696796,113696915,0,10133921
IMR90|chr5:123870681-123870789,chr5,123870681,123870789,IMR90|chr5:131593793-131593835,chr5,131593793,131593835,0,7723112
IMR90|chr5:124342578-124342666,chr5,124342578,124342666,IMR90|chr5:151148639-151148657,chr5,151148639,151148657,0,26806061
IMR90|chr5:125209338-125209397,chr5,125209338,125209397,IMR90|chr5:34930873-34930936,chr5,34930873,34930936,0,90278465
IMR90|chr5:125501774-125501800,chr5,125501774,125501800,IMR90|chr5:32713891-32714040,chr5,32713891,32714040,0,92787883
IMR90|chr5:125643083-125643200,chr5,125643083,125643200,IMR90|chr5:141701159-141701216,chr5,141701159,141701216,0,16058076
IMR90|chr5:125775601-125775676,chr5,125775601,125775676,IMR90|chr5:172754290-172754351,chr5,172754290,172754351,0,46978689
IMR90|chr5:126117436-126117526,chr5,126117436,126117526,IMR90|chr5:141702553-141702606,chr5,141702553,141702606,0,15585117
IMR90|chr5:126354064-126354121,chr5,126354064,126354121,IMR90|chr5:150534477-150534530,chr5,150534477,150534530,0,24180413
IMR90|chr5:126754371-126754464,chr5,126754371,126754464,IMR90|chr5:141701159-141701216,chr5,141701159,141701216,0,14946788
IMR90|chr5:126902579-126902603,chr5,126902579,126902603,IMR90|chr5:98112498-98112621,chr5,98112498,98112621,0,28790081
IMR90|chr5:126922859-126922885,chr5,126922859,126922885,IMR90|chr5:98112498-98112622,chr5,98112498,98112622,0,28810361
IMR90|chr5:127254930-127255033,chr5,127254930,127255033,IMR90|chr5:137879988-137880034,chr5,137879988,137880034,0,10625058
IMR90|chr5:127752325-127752368,chr5,127752325,127752368,IMR90|chr5:76326873-76326939,chr5,76326873,76326939,0,51425452
IMR90|chr5:128062851-128062895,chr5,128062851,128062895,IMR90|chr5:150534503-150534544,chr5,150534503,150534544,0,22471652
IMR90|chr5:128457412-128457456,chr5,128457412,128457456,IMR90|chr5:176905964-176906013,chr5,176905964,176906013,0,48448552
IMR90|chr5:128513672-128513744,chr5,128513672,128513744,IMR90|chr5:176901873-176901918,chr5,176901873,176901918,0,48388201
IMR90|chr5:128717272-128717387,chr5,128717272,128717387,IMR90|chr5:179718831-179718849,chr5,179718831,179718849,0,51001559
IMR90|chr5:128719637-128719704,chr5,128719637,128719704,IMR90|chr5:170844552-170844586,chr5,170844552,170844586,0,42124915
IMR90|chr5:128886085-128886132,chr5,128886085,128886132,IMR90|chr5:151061335-151061438,chr5,151061335,151061438,0,22175250
IMR90|chr5:129127420-129127447,chr5,129127420,129127447,IMR90|chr5:55289447-55289515,chr5,55289447,55289515,0,73837973
IMR90|chr5:129189762-129189809,chr5,129189762,129189809,IMR90|chr5:113692802-113692888,chr5,113692802,113692888,0,15496960
IMR90|chr5:129847115-129847183,chr5,129847115,129847183,IMR90|chr5:151060421-151060498,chr5,151060421,151060498,0,21213306
IMR90|chr5:129929651-129929726,chr5,129929651,129929726,IMR90|chr5:141702566-141702605,chr5,141702566,141702605,0,11772915
IMR90|chr5:130038534-130038632,chr5,130038534,130038632,IMR90|chr5:175878237-175878280,chr5,175878237,175878280,0,45839703
IMR90|chr5:130038689-130038737,chr5,130038689,130038737,IMR90|chr5:121411044-121411141,chr5,121411044,121411141,0,8627645
IMR90|chr5:130268404-130268471,chr5,130268404,130268471,IMR90|chr5:133703316-133703362,chr5,133703316,133703362,0,3434912
IMR90|chr5:130719188-130719248,chr5,130719188,130719248,IMR90|chr5:140792526-140792556,chr5,140792526,140792556,0,10073338
IMR90|chr5:130919860-130919946,chr5,130919860,130919946,IMR90|chr5:176905513-176905577,chr5,176905513,176905577,0,45985653
IMR90|chr5:130946823-130946913,chr5,130946823,130946913,IMR90|chr5:176905766-176905806,chr5,176905766,176905806,0,45958943
IMR90|chr5:131038945-131039011,chr5,131038945,131039011,IMR90|chr5:141700648-141700712,chr5,141700648,141700712,0,10661703
IMR90|chr5:131132603-131132686,chr5,131132603,131132686,IMR90|chr5:56112899-56112917,chr5,56112899,56112917,0,75019704
IMR90|chr5:131143016-131143091,chr5,131143016,131143091,IMR90|chr5:130604196-130604271,chr5,130604196,130604271,0,538820
IMR90|chr5:132188444-132188575,chr5,132188444,132188575,IMR90|chr5:17219989-17220008,chr5,17219989,17220008,0,114968455
IMR90|chr5:132773279-132773336,chr5,132773279,132773336,IMR90|chr5:176905248-176905303,chr5,176905248,176905303,0,44131969
IMR90|chr5:132786373-132786501,chr5,132786373,132786501,IMR90|chr5:14870702-14870801,chr5,14870702,14870801,0,117915671
IMR90|chr5:132791408-132791427,chr5,132791408,132791427,IMR90|chr5:141702595-141702645,chr5,141702595,141702645,0,8911187
IMR90|chr5:133081924-133081989,chr5,133081924,133081989,IMR90|chr5:172752234-172752282,chr5,172752234,172752282,0,39670310
IMR90|chr5:133187978-133188043,chr5,133187978,133188043,IMR90|chr5:149866380-149866430,chr5,149866380,149866430,0,16678402
IMR90|chr5:133241580-133241629,chr5,133241580,133241629,IMR90|chr5:170842185-170842283,chr5,170842185,170842283,0,37600605
IMR90|chr5:133271881-133271965,chr5,133271881,133271965,IMR90|chr5:151060265-151060287,chr5,151060265,151060287,0,17788384
IMR90|chr5:133275858-133275975,chr5,133275858,133275975,IMR90|chr5:150160261-150160307,chr5,150160261,150160307,0,16884403
IMR90|chr5:133619326-133619476,chr5,133619326,133619476,IMR90|chr5:172197026-172197044,chr5,172197026,172197044,0,38577700
IMR90|chr5:133731180-133731217,chr5,133731180,133731217,IMR90|chr5:14141164-14141229,chr5,14141164,14141229,0,119590016
IMR90|chr5:133762562-133762635,chr5,133762562,133762635,IMR90|chr5:175967629-175967681,chr5,175967629,175967681,0,42205067
IMR90|chr5:133779166-133779225,chr5,133779166,133779225,IMR90|chr5:98112163-98112211,chr5,98112163,98112211,0,35667003
IMR90|chr5:133929194-133929269,chr5,133929194,133929269,IMR90|chr5:130604196-130604271,chr5,130604196,130604271,0,3324998
IMR90|chr5:134008678-134008750,chr5,134008678,134008750,IMR90|chr5:176901873-176901918,chr5,176901873,176901918,0,42893195
IMR90|chr5:134123291-134123391,chr5,134123291,134123391,IMR90|chr5:133560297-133560345,chr5,133560297,133560345,0,562994
IMR90|chr5:134519118-134519178,chr5,134519118,134519178,IMR90|chr5:149867532-149867565,chr5,149867532,149867565,0,15348414
IMR90|chr5:134521215-134521302,chr5,134521215,134521302,IMR90|chr5:43190601-43190645,chr5,43190601,43190645,0,91330614
IMR90|chr5:134601531-134601604,chr5,134601531,134601604,IMR90|chr5:138632699-138632754,chr5,138632699,138632754,0,4031168
IMR90|chr5:134643231-134643270,chr5,134643231,134643270,IMR90|chr5:16935405-16935485,chr5,16935405,16935485,0,117707826
IMR90|chr5:134859663-134859759,chr5,134859663,134859759,IMR90|chr5:141702442-141702592,chr5,141702442,141702592,0,6842779
IMR90|chr5:135063675-135063710,chr5,135063675,135063710,IMR90|chr5:151064551-151064601,chr5,151064551,151064601,0,16000876
IMR90|chr5:135176975-135177047,chr5,135176975,135177047,IMR90|chr5:34657370-34657407,chr5,34657370,34657407,0,100519605
IMR90|chr5:135405267-135405343,chr5,135405267,135405343,IMR90|chr5:68628415-68628489,chr5,68628415,68628489,0,66776852
IMR90|chr5:136040760-136040823,chr5,136040760,136040823,IMR90|chr5:141702237-141702259,chr5,141702237,141702259,0,5661477
IMR90|chr5:136650546-136650681,chr5,136650546,136650681,IMR90|chr5:176903869-176903941,chr5,176903869,176903941,0,40253323
IMR90|chr5:136902049-136902078,chr5,136902049,136902078,IMR90|chr5:55290332-55290423,chr5,55290332,55290423,0,81611717
IMR90|chr5:137096786-137096838,chr5,137096786,137096838,IMR90|chr5:133703552-133703605,chr5,133703552,133703605,0,3393234
IMR90|chr5:137138007-137138064,chr5,137138007,137138064,IMR90|chr5:162864918-162864994,chr5,162864918,162864994,0,25726911
IMR90|chr5:137226210-137226237,chr5,137226210,137226237,IMR90|chr5:171432572-171432695,chr5,171432572,171432695,0,34206362
IMR90|chr5:137374690-137374733,chr5,137374690,137374733,IMR90|chr5:68483745-68483805,chr5,68483745,68483805,0,68890945
IMR90|chr5:137375471-137375514,chr5,137375471,137375514,IMR90|chr5:151137545-151137620,chr5,151137545,151137620,0,13762074
IMR90|chr5:137571571-137571665,chr5,137571571,137571665,IMR90|chr5:64786020-64786052,chr5,64786020,64786052,0,72785551
IMR90|chr5:137924696-137924747,chr5,137924696,137924747,IMR90|chr5:150533449-150533543,chr5,150533449,150533543,0,12608753
IMR90|chr5:138036617-138036670,chr5,138036617,138036670,IMR90|chr5:176906265-176906309,chr5,176906265,176906309,0,38869648
IMR90|chr5:138296966-138297083,chr5,138296966,138297083,IMR90|chr5:141701159-141701216,chr5,141701159,141701216,0,3404193
IMR90|chr5:139030202-139030265,chr5,139030202,139030265,IMR90|chr5:134074873-134074924,chr5,134074873,134074924,0,4955329
IMR90|chr5:139694214-139694264,chr5,139694214,139694264,IMR90|chr5:151061648-151061738,chr5,151061648,151061738,0,11367434
IMR90|chr5:139803838-139803930,chr5,139803838,139803930,IMR90|chr5:90676436-90676490,chr5,90676436,90676490,0,49127402
IMR90|chr5:139873894-139873960,chr5,139873894,139873960,IMR90|chr5:176905748-176905827,chr5,176905748,176905827,0,37031854
IMR90|chr5:140002450-140002564,chr5,140002450,140002564,IMR90|chr5:85914781-85914853,chr5,85914781,85914853,0,54087669
IMR90|chr5:140212704-140212732,chr5,140212704,140212732,IMR90|chr5:55289447-55289515,chr5,55289447,55289515,0,84923257
IMR90|chr5:140645942-140645992,chr5,140645942,140645992,IMR90|chr5:150159470-150159602,chr5,150159470,150159602,0,9513528
IMR90|chr5:140687709-140687756,chr5,140687709,140687756,IMR90|chr5:176904279-176904421,chr5,176904279,176904421,0,36216570
IMR90|chr5:141109852-141109910,chr5,141109852,141109910,IMR90|chr5:147763852-147763885,chr5,147763852,147763885,0,6654000
IMR90|chr5:141198212-141198244,chr5,141198212,141198244,IMR90|chr5:34657448-34657506,chr5,34657448,34657506,0,106540764
IMR90|chr5:141469897-141469982,chr5,141469897,141469982,IMR90|chr5:162867394-162867470,chr5,162867394,162867470,0,21397497
IMR90|chr5:142293315-142293412,chr5,142293315,142293412,IMR90|chr5:175878237-175878280,chr5,175878237,175878280,0,33584922
IMR90|chr5:142359612-142359746,chr5,142359612,142359746,IMR90|chr5:132167824-132167877,chr5,132167824,132167877,0,10191788
IMR90|chr5:142371045-142371113,chr5,142371045,142371113,IMR90|chr5:60630750-60630864,chr5,60630750,60630864,0,81740295
IMR90|chr5:142406890-142406965,chr5,142406890,142406965,IMR90|chr5:150534776-150534845,chr5,150534776,150534845,0,8127886
IMR90|chr5:142718104-142718148,chr5,142718104,142718148,IMR90|chr5:150534503-150534544,chr5,150534503,150534544,0,7816399
IMR90|chr5:142999964-143000008,chr5,142999964,143000008,IMR90|chr5:172196323-172196370,chr5,172196323,172196370,0,29196359
IMR90|chr5:143291910-143291969,chr5,143291910,143291969,IMR90|chr5:140792526-140792556,chr5,140792526,140792556,0,2499384
IMR90|chr5:143732432-143732548,chr5,143732432,143732548,IMR90|chr5:98107499-98107538,chr5,98107499,98107538,0,45624933
IMR90|chr5:144355800-144355851,chr5,144355800,144355851,IMR90|chr5:14870702-14870801,chr5,14870702,14870801,0,129485098
IMR90|chr5:144966819-144966841,chr5,144966819,144966841,IMR90|chr5:171432284-171432400,chr5,171432284,171432400,0,26465465
IMR90|chr5:145328638-145328722,chr5,145328638,145328722,IMR90|chr5:68628423-68628489,chr5,68628423,68628489,0,76700215
IMR90|chr5:145362347-145362405,chr5,145362347,145362405,IMR90|chr5:140780019-140780111,chr5,140780019,140780111,0,4582328
IMR90|chr5:145530350-145530417,chr5,145530350,145530417,IMR90|chr5:151061540-151061564,chr5,151061540,151061564,0,5531190
IMR90|chr5:145536766-145536869,chr5,145536766,145536869,IMR90|chr5:121417830-121417906,chr5,121417830,121417906,0,24118936
IMR90|chr5:145655931-145655974,chr5,145655931,145655974,IMR90|chr5:68483745-68483805,chr5,68483745,68483805,0,77172186
IMR90|chr5:145883098-145883151,chr5,145883098,145883151,IMR90|chr5:17219951-17220032,chr5,17219951,17220032,0,128663147
IMR90|chr5:145885829-145885909,chr5,145885829,145885909,IMR90|chr5:72922573-72922623,chr5,72922573,72922623,0,72963256
IMR90|chr5:146294721-146294761,chr5,146294721,146294761,IMR90|chr5:139738761-139738867,chr5,139738761,139738867,0,6555960
IMR90|chr5:146376123-146376187,chr5,146376123,146376187,IMR90|chr5:176905232-176905298,chr5,176905232,176905298,0,30529109
IMR90|chr5:146559618-146559712,chr5,146559618,146559712,IMR90|chr5:132167824-132167877,chr5,132167824,132167877,0,14391794
IMR90|chr5:146606268-146606341,chr5,146606268,146606341,IMR90|chr5:148926087-148926200,chr5,148926087,148926200,0,2319819
IMR90|chr5:147092157-147092254,chr5,147092157,147092254,IMR90|chr5:172752527-172752564,chr5,172752527,172752564,0,25660370
IMR90|chr5:147455985-147456077,chr5,147455985,147456077,IMR90|chr5:14147898-14147953,chr5,14147898,14147953,0,133308087
IMR90|chr5:147616427-147616487,chr5,147616427,147616487,IMR90|chr5:149867532-149867565,chr5,149867532,149867565,0,2251105
IMR90|chr5:147799892-147800008,chr5,147799892,147800008,IMR90|chr5:141028452-141028504,chr5,141028452,141028504,0,6771440
IMR90|chr5:148455537-148455567,chr5,148455537,148455567,IMR90|chr5:171432572-171432695,chr5,171432572,171432695,0,22977035
IMR90|chr5:148679182-148679211,chr5,148679182,148679211,IMR90|chr5:55290332-55290423,chr5,55290332,55290423,0,93388850
IMR90|chr5:149099574-149099650,chr5,149099574,149099650,IMR90|chr5:130604198-130604271,chr5,130604198,130604271,0,18495376
IMR90|chr5:149294703-149294797,chr5,149294703,149294797,IMR90|chr5:14146591-14146657,chr5,14146591,14146657,0,135148112
IMR90|chr5:149320459-149320519,chr5,149320459,149320519,IMR90|chr5:14147318-14147348,chr5,14147318,14147348,0,135173141
IMR90|chr5:149406216-149406255,chr5,149406216,149406255,IMR90|chr5:38844965-38845106,chr5,38844965,38845106,0,110561251
IMR90|chr5:149640599-149640696,chr5,149640599,149640696,IMR90|chr5:176946455-176946488,chr5,176946455,176946488,0,27305856
IMR90|chr5:149723012-149723059,chr5,149723012,149723059,IMR90|chr5:71614316-71614443,chr5,71614316,71614443,0,78108696
IMR90|chr5:149892850-149892997,chr5,149892850,149892997,IMR90|chr5:139738762-139738871,chr5,139738762,139738871,0,10154088
IMR90|chr5:149978137-149978229,chr5,149978137,149978229,IMR90|chr5:141702504-141702604,chr5,141702504,141702604,0,8275633
IMR90|chr5:149979326-149979421,chr5,149979326,149979421,IMR90|chr5:16935426-16935445,chr5,16935426,16935445,0,133043900
IMR90|chr5:150182404-150182467,chr5,150182404,150182467,IMR90|chr5:170815817-170815964,chr5,170815817,170815964,0,20633413
IMR90|chr5:150514383-150514427,chr5,150514383,150514427,IMR90|chr5:14147741-14147797,chr5,14147741,14147797,0,136366642
IMR90|chr5:150707838-150707876,chr5,150707838,150707876,IMR90|chr5:179049540-179049630,chr5,179049540,179049630,0,28341702
IMR90|chr5:150812770-150812828,chr5,150812770,150812828,IMR90|chr5:32172553-32172626,chr5,32172553,32172626,0,118640217
IMR90|chr5:150838401-150838449,chr5,150838401,150838449,IMR90|chr5:151060537-151060603,chr5,151060537,151060603,0,222136
IMR90|chr5:151441570-151441655,chr5,151441570,151441655,IMR90|chr5:141703150-141703190,chr5,141703150,141703190,0,9738420
IMR90|chr5:151879167-151879203,chr5,151879167,151879203,IMR90|chr5:148925544-148925623,chr5,148925544,148925623,0,2953623
IMR90|chr5:152012580-152012696,chr5,152012580,152012696,IMR90|chr5:138634919-138635025,chr5,138634919,138635025,0,13377661
IMR90|chr5:152030481-152030512,chr5,152030481,152030512,IMR90|chr5:10567806-10567837,chr5,10567806,10567837,0,141462675
IMR90|chr5:152047671-152047768,chr5,152047671,152047768,IMR90|chr5:141702914-141702941,chr5,141702914,141702941,0,10344757
IMR90|chr5:152735016-152735106,chr5,152735016,152735106,IMR90|chr5:133560094-133560164,chr5,133560094,133560164,0,19174922
IMR90|chr5:152789494-152789557,chr5,152789494,152789557,IMR90|chr5:98111967-98112014,chr5,98111967,98112014,0,54677527
IMR90|chr5:152833033-152833086,chr5,152833033,152833086,IMR90|chr5:443700-443754,chr5,443700,443754,0,152389333
IMR90|chr5:153079445-153079516,chr5,153079445,153079516,IMR90|chr5:178053416-178053495,chr5,178053416,178053495,0,24973971
IMR90|chr5:153244528-153244590,chr5,153244528,153244590,IMR90|chr5:151063964-151064003,chr5,151063964,151064003,0,2180564
IMR90|chr5:153313450-153313501,chr5,153313450,153313501,IMR90|chr5:14870702-14870801,chr5,14870702,14870801,0,138442748
IMR90|chr5:153425296-153425399,chr5,153425296,153425399,IMR90|chr5:121415034-121415066,chr5,121415034,121415066,0,32010262
IMR90|chr5:153443943-153444032,chr5,153443943,153444032,IMR90|chr5:162934274-162934327,chr5,162934274,162934327,0,9490331
IMR90|chr5:153548906-153548989,chr5,153548906,153548989,IMR90|chr5:9546896-9546956,chr5,9546896,9546956,0,144002010
IMR90|chr5:153870621-153870645,chr5,153870621,153870645,IMR90|chr5:17219951-17220030,chr5,17219951,17220030,0,136650670
IMR90|chr5:153887324-153887412,chr5,153887324,153887412,IMR90|chr5:176905907-176905956,chr5,176905907,176905956,0,23018583
IMR90|chr5:153915315-153915436,chr5,153915315,153915436,IMR90|chr5:39424446-39424518,chr5,39424446,39424518,0,114490869
IMR90|chr5:154248063-154248089,chr5,154248063,154248089,IMR90|chr5:10567808-10567924,chr5,10567808,10567924,0,143680255
IMR90|chr5:154297169-154297234,chr5,154297169,154297234,IMR90|chr5:172752234-172752282,chr5,172752234,172752282,0,18455065
IMR90|chr5:154468551-154468633,chr5,154468551,154468633,IMR90|chr5:65221658-65221772,chr5,65221658,65221772,0,89246893
IMR90|chr5:154831004-154831088,chr5,154831004,154831088,IMR90|chr5:14146591-14146657,chr5,14146591,14146657,0,140684413
IMR90|chr5:154937665-154937746,chr5,154937665,154937746,IMR90|chr5:56112899-56112917,chr5,56112899,56112917,0,98824766
IMR90|chr5:155044180-155044266,chr5,155044180,155044266,IMR90|chr5:176906212-176906249,chr5,176906212,176906249,0,21862032
IMR90|chr5:155119793-155119833,chr5,155119793,155119833,IMR90|chr5:14147741-14147797,chr5,14147741,14147797,0,140972052
IMR90|chr5:155430318-155430425,chr5,155430318,155430425,IMR90|chr5:121415034-121415066,chr5,121415034,121415066,0,34015284
IMR90|chr5:155884790-155884852,chr5,155884790,155884852,IMR90|chr5:151063964-151064003,chr5,151063964,151064003,0,4820826
IMR90|chr5:156979375-156979435,chr5,156979375,156979435,IMR90|chr5:17219216-17219247,chr5,17219216,17219247,0,139760159
IMR90|chr5:157105932-157106014,chr5,157105932,157106014,IMR90|chr5:60630259-60630322,chr5,60630259,60630322,0,96475673
IMR90|chr5:157309090-157309182,chr5,157309090,157309182,IMR90|chr5:162934274-162934327,chr5,162934274,162934327,0,5625184
IMR90|chr5:157369728-157369773,chr5,157369728,157369773,IMR90|chr5:64787717-64787788,chr5,64787717,64787788,0,92582011
IMR90|chr5:157389271-157389291,chr5,157389271,157389291,IMR90|chr5:140781117-140781247,chr5,140781117,140781247,0,16608154
IMR90|chr5:157927703-157927766,chr5,157927703,157927766,IMR90|chr5:98111967-98112014,chr5,98111967,98112014,0,59815736
IMR90|chr5:158070165-158070223,chr5,158070165,158070223,IMR90|chr5:141700392-141700422,chr5,141700392,141700422,0,16369773
IMR90|chr5:158580171-158580246,chr5,158580171,158580246,IMR90|chr5:17219093-17219104,chr5,17219093,17219104,0,141361078
IMR90|chr5:158813516-158813597,chr5,158813516,158813597,IMR90|chr5:56112899-56112917,chr5,56112899,56112917,0,102700617
IMR90|chr5:158860857-158860947,chr5,158860857,158860947,IMR90|chr5:141702553-141702606,chr5,141702553,141702606,0,17158304
IMR90|chr5:158885208-158885291,chr5,158885208,158885291,IMR90|chr5:9546896-9546956,chr5,9546896,9546956,0,149338312
IMR90|chr5:158986674-158986763,chr5,158986674,158986763,IMR90|chr5:149532346-149532407,chr5,149532346,149532407,0,9454328
IMR90|chr5:159705009-159705043,chr5,159705009,159705043,IMR90|chr5:6709688-6709788,chr5,6709688,6709788,0,152995321
IMR90|chr5:159810452-159810529,chr5,159810452,159810529,IMR90|chr5:119801601-119801635,chr5,119801601,119801635,0,40008851
IMR90|chr5:160146011-160146036,chr5,160146011,160146036,IMR90|chr5:98112498-98112524,chr5,98112498,98112524,0,62033513
IMR90|chr5:160151333-160151371,chr5,160151333,160151371,IMR90|chr5:98110837-98110933,chr5,98110837,98110933,0,62040496
IMR90|chr5:160766377-160766429,chr5,160766377,160766429,IMR90|chr5:34660749-34660798,chr5,34660749,34660798,0,126105628
IMR90|chr5:161168946-161168999,chr5,161168946,161168999,IMR90|chr5:176906265-176906309,chr5,176906265,176906309,0,15737319
IMR90|chr5:161353155-161353268,chr5,161353155,161353268,IMR90|chr5:179718831-179718849,chr5,179718831,179718849,0,18365676
IMR90|chr5:162032701-162032770,chr5,162032701,162032770,IMR90|chr5:141706346-141706387,chr5,141706346,141706387,0,20326355
IMR90|chr5:162441334-162441402,chr5,162441334,162441402,IMR90|chr5:151060421-151060498,chr5,151060421,151060498,0,11380913
IMR90|chr5:162686709-162686801,chr5,162686709,162686801,IMR90|chr5:176905907-176905956,chr5,176905907,176905956,0,14219198
IMR90|chr5:162698589-162698633,chr5,162698589,162698633,IMR90|chr5:68483745-68483805,chr5,68483745,68483805,0,94214844
IMR90|chr5:163053711-163053743,chr5,163053711,163053743,IMR90|chr5:60624376-60624451,chr5,60624376,60624451,0,102429335
IMR90|chr5:163300653-163300686,chr5,163300653,163300686,IMR90|chr5:172194144-172194213,chr5,172194144,172194213,0,8893491
IMR90|chr5:163310331-163310389,chr5,163310331,163310389,IMR90|chr5:147763846-147763882,chr5,147763846,147763882,0,15546485
IMR90|chr5:163374233-163374281,chr5,163374233,163374281,IMR90|chr5:52285628-52285657,chr5,52285628,52285657,0,111088605
IMR90|chr5:163840620-163840706,chr5,163840620,163840706,IMR90|chr5:60630259-60630322,chr5,60630259,60630322,0,103210361
IMR90|chr5:163875118-163875252,chr5,163875118,163875252,IMR90|chr5:132167824-132167877,chr5,132167824,132167877,0,31707294
IMR90|chr5:164044383-164044407,chr5,164044383,164044407,IMR90|chr5:137885482-137885546,chr5,137885482,137885546,0,26158901
IMR90|chr5:164211197-164211267,chr5,164211197,164211267,IMR90|chr5:141701325-141701351,chr5,141701325,141701351,0,22509872
IMR90|chr5:164251223-164251260,chr5,164251223,164251260,IMR90|chr5:14141164-14141229,chr5,14141164,14141229,0,150110059
IMR90|chr5:164253671-164253715,chr5,164253671,164253715,IMR90|chr5:76326874-76326913,chr5,76326874,76326913,0,87926797
IMR90|chr5:164433083-164433134,chr5,164433083,164433134,IMR90|chr5:141734780-141734879,chr5,141734780,141734879,0,22698303
IMR90|chr5:164575077-164575163,chr5,164575077,164575163,IMR90|chr5:141703150-141703190,chr5,141703150,141703190,0,22871927
IMR90|chr5:165076067-165076125,chr5,165076067,165076125,IMR90|chr5:147763846-147763882,chr5,147763846,147763882,0,17312221
IMR90|chr5:165117771-165117795,chr5,165117771,165117795,IMR90|chr5:149532348-149532491,chr5,149532348,149532491,0,15585423
IMR90|chr5:165164762-165164803,chr5,165164762,165164803,IMR90|chr5:139738762-139738871,chr5,139738762,139738871,0,25426000
IMR90|chr5:165245858-165245932,chr5,165245858,165245932,IMR90|chr5:98107844-98107879,chr5,98107844,98107879,0,67138014
IMR90|chr5:165565448-165565497,chr5,165565448,165565497,IMR90|chr5:141702504-141702604,chr5,141702504,141702604,0,23862944
IMR90|chr5:165701899-165701941,chr5,165701899,165701941,IMR90|chr5:150159211-150159319,chr5,150159211,150159319,0,15542688
IMR90|chr5:165778347-165778424,chr5,165778347,165778424,IMR90|chr5:172197093-172197158,chr5,172197093,172197158,0,6418746
IMR90|chr5:165787709-165787759,chr5,165787709,165787759,IMR90|chr5:151064549-151064601,chr5,151064549,151064601,0,14723160
IMR90|chr5:166050264-166050290,chr5,166050264,166050290,IMR90|chr5:43041431-43041519,chr5,43041431,43041519,0,123008833
IMR90|chr5:166071057-166071155,chr5,166071057,166071155,IMR90|chr5:140780019-140780111,chr5,140780019,140780111,0,25291038
IMR90|chr5:166287104-166287135,chr5,166287104,166287135,IMR90|chr5:138941541-138941645,chr5,138941541,138941645,0,27345563
IMR90|chr5:167333141-167333170,chr5,167333141,167333170,IMR90|chr5:151136772-151136875,chr5,151136772,151136875,0,16196369
IMR90|chr5:168492775-168492818,chr5,168492775,168492818,IMR90|chr5:172196322-172196370,chr5,172196322,172196370,0,3703547
IMR90|chr5:168724352-168724455,chr5,168724352,168724455,IMR90|chr5:121415034-121415066,chr5,121415034,121415066,0,47309318
IMR90|chr5:168765451-168765482,chr5,168765451,168765482,IMR90|chr5:148925447-148925597,chr5,148925447,148925597,0,19840004
IMR90|chr5:169250604-169250640,chr5,169250604,169250640,IMR90|chr5:65221658-65221772,chr5,65221658,65221772,0,104028946
IMR90|chr5:169426980-169427013,chr5,169426980,169427013,IMR90|chr5:172194144-172194213,chr5,172194144,172194213,0,2767164
IMR90|chr5:169453531-169453596,chr5,169453531,169453596,IMR90|chr5:92923360-92923412,chr5,92923360,92923412,0,76530171
IMR90|chr5:169532863-169532905,chr5,169532863,169532905,IMR90|chr5:14147318-14147423,chr5,14147318,14147423,0,155385545
IMR90|chr5:169825617-169825736,chr5,169825617,169825736,IMR90|chr5:141028452-141028504,chr5,141028452,141028504,0,28797165
IMR90|chr5:171040213-171040317,chr5,171040213,171040317,IMR90|chr5:172196938-172196984,chr5,172196938,172196984,0,1156725
IMR90|chr5:171266429-171266524,chr5,171266429,171266524,IMR90|chr5:138613227-138613262,chr5,138613227,138613262,0,32653202
IMR90|chr5:171461199-171461261,chr5,171461199,171461261,IMR90|chr5:141700839-141700900,chr5,141700839,141700900,0,29760360
IMR90|chr5:171611393-171611540,chr5,171611393,171611540,IMR90|chr5:170842185-170842283,chr5,170842185,170842283,0,769208
IMR90|chr5:171706954-171707104,chr5,171706954,171707104,IMR90|chr5:74906142-74906221,chr5,74906142,74906221,0,96800812
IMR90|chr5:171832826-171832867,chr5,171832826,171832867,IMR90|chr5:148925544-148925623,chr5,148925544,148925623,0,22907282
IMR90|chr5:171852765-171852825,chr5,171852765,171852825,IMR90|chr5:14147318-14147348,chr5,14147318,14147348,0,157705447
IMR90|chr5:172150675-172150716,chr5,172150675,172150716,IMR90|chr5:98110837-98110933,chr5,98110837,98110933,0,74039838
IMR90|chr5:172631473-172631563,chr5,172631473,172631563,IMR90|chr5:16935426-16935445,chr5,16935426,16935445,0,155696047
IMR90|chr5:172761666-172761745,chr5,172761666,172761745,IMR90|chr5:172197093-172197158,chr5,172197093,172197158,0,564573
IMR90|chr5:173392896-173392940,chr5,173392896,173392940,IMR90|chr5:83679849-83679955,chr5,83679849,83679955,0,89713047
IMR90|chr5:173510838-173510944,chr5,173510838,173510944,IMR90|chr5:43190601-43190645,chr5,43190601,43190645,0,130320237
IMR90|chr5:173602490-173602521,chr5,173602490,173602521,IMR90|chr5:10567806-10567837,chr5,10567806,10567837,0,163034684
IMR90|chr5:173662970-173663042,chr5,173662970,173663042,IMR90|chr5:151065121-151065192,chr5,151065121,151065192,0,22597849
IMR90|chr5:173716642-173716746,chr5,173716642,173716746,IMR90|chr5:121415034-121415066,chr5,121415034,121415066,0,52301608
IMR90|chr5:173761310-173761352,chr5,173761310,173761352,IMR90|chr5:150159211-150159319,chr5,150159211,150159319,0,23602099
IMR90|chr5:174054782-174054832,chr5,174054782,174054832,IMR90|chr5:14147153-14147215,chr5,14147153,14147215,0,159907629
IMR90|chr5:174075557-174075640,chr5,174075557,174075640,IMR90|chr5:172752436-172752493,chr5,172752436,172752493,0,1323121
IMR90|chr5:174228557-174228613,chr5,174228557,174228613,IMR90|chr5:121414045-121414109,chr5,121414045,121414109,0,52814512
IMR90|chr5:174517229-174517307,chr5,174517229,174517307,IMR90|chr5:141700467-141700523,chr5,141700467,141700523,0,32816762
IMR90|chr5:174675221-174675281,chr5,174675221,174675281,IMR90|chr5:132167788-132167878,chr5,132167788,132167878,0,42507433
IMR90|chr5:174970407-174970507,chr5,174970407,174970507,IMR90|chr5:133560297-133560345,chr5,133560297,133560345,0,41410110
IMR90|chr5:175147398-175147458,chr5,175147398,175147458,IMR90|chr5:98112163-98112211,chr5,98112163,98112211,0,77035235
IMR90|chr5:175879531-175879583,chr5,175879531,175879583,IMR90|chr5:34660749-34660798,chr5,34660749,34660798,0,141218782
IMR90|chr5:176124541-176124616,chr5,176124541,176124616,IMR90|chr5:172754290-172754351,chr5,172754290,172754351,0,3370251
IMR90|chr5:176187400-176187516,chr5,176187400,176187516,IMR90|chr5:176904036-176904113,chr5,176904036,176904113,0,716636
IMR90|chr5:176370261-176370349,chr5,176370261,176370349,IMR90|chr5:176905907-176905956,chr5,176905907,176905956,0,535646
IMR90|chr5:176592280-176592354,chr5,176592280,176592354,IMR90|chr5:98107844-98107879,chr5,98107844,98107879,0,78484436
IMR90|chr5:177209271-177209350,chr5,177209271,177209350,IMR90|chr5:141703952-141704004,chr5,141703952,141704004,0,35505319
IMR90|chr5:177558474-177558568,chr5,177558474,177558568,IMR90|chr5:17219105-17219155,chr5,17219105,17219155,0,160339369
IMR90|chr5:177606352-177606442,chr5,177606352,177606442,IMR90|chr5:133560094-133560164,chr5,133560094,133560164,0,44046258
IMR90|chr5:177655936-177656050,chr5,177655936,177656050,IMR90|chr5:176904892-176904915,chr5,176904892,176904915,0,751044
IMR90|chr5:177830914-177830991,chr5,177830914,177830991,IMR90|chr5:141701926-141701968,chr5,141701926,141701968,0,36128988
IMR90|chr5:177936800-177936836,chr5,177936800,177936836,IMR90|chr5:178053406-178053495,chr5,178053406,178053495,0,116606
IMR90|chr5:177940953-177941011,chr5,177940953,177941011,IMR90|chr5:40835716-40835765,chr5,40835716,40835765,0,137105237
IMR90|chr5:178440979-178441056,chr5,178440979,178441056,IMR90|chr5:119801601-119801635,chr5,119801601,119801635,0,58639378
IMR90|chr5:178710535-178710606,chr5,178710535,178710606,IMR90|chr5:172196766-172196845,chr5,172196766,172196845,0,6513769
IMR90|chr5:178771298-178771369,chr5,178771298,178771369,IMR90|chr5:141702553-141702606,chr5,141702553,141702606,0,37068745
IMR90|chr5:178802227-178802330,chr5,178802227,178802330,IMR90|chr5:137879988-137880034,chr5,137879988,137880034,0,40922239
IMR90|chr5:178964279-178964395,chr5,178964279,178964395,IMR90|chr5:98107499-98107538,chr5,98107499,98107538,0,80856780
IMR90|chr5:179715863-179715903,chr5,179715863,179715903,IMR90|chr5:172751953-172752012,chr5,172751953,172752012,0,6963910
IMR90|chr5:179974875-179974927,chr5,179974875,179974927,IMR90|chr5:133703552-133703605,chr5,133703552,133703605,0,46271323
IMR90|chr5:180014215-180014275,chr5,180014215,180014275,IMR90|chr5:14148737-14148827,chr5,14148737,14148827,0,165865478
IMR90|chr5:180279767-180279917,chr5,180279767,180279917,IMR90|chr5:172197026-172197044,chr5,172197026,172197044,0,8082741
IMR90|chr5:180585887-180585970,chr5,180585887,180585970,IMR90|chr5:172752436-172752493,chr5,172752436,172752493,0,7833451
IMR90|chr5:180824939-180825036,chr5,180824939,180825036,IMR90|chr5:141702914-141702941,chr5,141702914,141702941,0,39122025
IMR90|chr6:116065-116171,chr6,116065,116171,IMR90|chr6:1389253-1389293,chr6,1389253,1389293,0,1273188
IMR90|chr6:676461-676501,chr6,676461,676501,IMR90|chr6:31794979-31795069,chr6,31794979,31795069,0,31118518
IMR90|chr6:2021143-2021191,chr6,2021143,2021191,IMR90|chr6:153324115-153324190,chr6,153324115,153324190,0,151302972
IMR90|chr6:2334404-2334474,chr6,2334404,2334474,IMR90|chr6:43398574-43398625,chr6,43398574,43398625,0,41064170
IMR90|chr6:2466275-2466346,chr6,2466275,2466346,IMR90|chr6:43398574-43398625,chr6,43398574,43398625,0,40932299
IMR90|chr6:3070712-3070757,chr6,3070712,3070757,IMR90|chr6:34205706-34205799,chr6,34205706,34205799,0,31134994
IMR90|chr6:3397388-3397430,chr6,3397388,3397430,IMR90|chr6:52441459-52441546,chr6,52441459,52441546,0,49044071
IMR90|chr6:4256589-4256641,chr6,4256589,4256641,IMR90|chr6:150182431-150182501,chr6,150182431,150182501,0,145925842
IMR90|chr6:4494475-4494497,chr6,4494475,4494497,IMR90|chr6:143267096-143267246,chr6,143267096,143267246,0,138772621
IMR90|chr6:4571545-4571585,chr6,4571545,4571585,IMR90|chr6:30180909-30181007,chr6,30180909,30181007,0,25609364
IMR90|chr6:4849585-4849701,chr6,4849585,4849701,IMR90|chr6:48037574-48037662,chr6,48037574,48037662,0,43187989
IMR90|chr6:5336326-5336446,chr6,5336326,5336446,IMR90|chr6:692736-692766,chr6,692736,692766,0,4643590
IMR90|chr6:5420795-5420873,chr6,5420795,5420873,IMR90|chr6:34234602-34234648,chr6,34234602,34234648,0,28813807
IMR90|chr6:5720474-5720495,chr6,5720474,5720495,IMR90|chr6:42983365-42983509,chr6,42983365,42983509,0,37262891
IMR90|chr6:5963378-5963457,chr6,5963378,5963457,IMR90|chr6:42533204-42533243,chr6,42533204,42533243,0,36569826
IMR90|chr6:5993616-5993695,chr6,5993616,5993695,IMR90|chr6:26458905-26458989,chr6,26458905,26458989,0,20465289
IMR90|chr6:6233757-6233799,chr6,6233757,6233799,IMR90|chr6:48037521-48037664,chr6,48037521,48037664,0,41803764
IMR90|chr6:6235059-6235127,chr6,6235059,6235127,IMR90|chr6:116893815-116893867,chr6,116893815,116893867,0,110658756
IMR90|chr6:6441530-6441571,chr6,6441530,6441571,IMR90|chr6:1389415-1389476,chr6,1389415,1389476,0,5052115
IMR90|chr6:7015198-7015263,chr6,7015198,7015263,IMR90|chr6:71997715-71997752,chr6,71997715,71997752,0,64982517
IMR90|chr6:7132290-7132344,chr6,7132290,7132344,IMR90|chr6:26458905-26459001,chr6,26458905,26459001,0,19326615
IMR90|chr6:7453494-7453524,chr6,7453494,7453524,IMR90|chr6:86301503-86301570,chr6,86301503,86301570,0,78848009
IMR90|chr6:7738809-7738875,chr6,7738809,7738875,IMR90|chr6:692682-692766,chr6,692682,692766,0,7046127
IMR90|chr6:7890448-7890488,chr6,7890448,7890488,IMR90|chr6:31794979-31795069,chr6,31794979,31795069,0,23904531
IMR90|chr6:8150134-8150193,chr6,8150134,8150193,IMR90|chr6:1388988-1389038,chr6,1388988,1389038,0,6761146
IMR90|chr6:8850607-8850710,chr6,8850607,8850710,IMR90|chr6:43397787-43397830,chr6,43397787,43397830,0,34547180
IMR90|chr6:8889492-8889594,chr6,8889492,8889594,IMR90|chr6:26102544-26102588,chr6,26102544,26102588,0,17213052
IMR90|chr6:9057044-9057072,chr6,9057044,9057072,IMR90|chr6:1393869-1394019,chr6,1393869,1394019,0,7663175
IMR90|chr6:9897891-9897931,chr6,9897891,9897931,IMR90|chr6:1389253-1389351,chr6,1389253,1389351,0,8508638
IMR90|chr6:10348168-10348248,chr6,10348168,10348248,IMR90|chr6:34234602-34234650,chr6,34234602,34234650,0,23886434
IMR90|chr6:10597051-10597102,chr6,10597051,10597102,IMR90|chr6:3159143-3159241,chr6,3159143,3159241,0,7437908
IMR90|chr6:11267582-11267602,chr6,11267582,11267602,IMR90|chr6:35438179-35438260,chr6,35438179,35438260,0,24170597
IMR90|chr6:11293509-11293557,chr6,11293509,11293557,IMR90|chr6:111302682-111302763,chr6,111302682,111302763,0,100009173
IMR90|chr6:11459204-11459240,chr6,11459204,11459240,IMR90|chr6:87865736-87865885,chr6,87865736,87865885,0,76406532
IMR90|chr6:11555538-11555572,chr6,11555538,11555572,IMR90|chr6:86156191-86156281,chr6,86156191,86156281,0,74600653
IMR90|chr6:12021576-12021644,chr6,12021576,12021644,IMR90|chr6:158588483-158588559,chr6,158588483,158588559,0,146566907
IMR90|chr6:12214419-12214457,chr6,12214419,12214457,IMR90|chr6:30180909-30181007,chr6,30180909,30181007,0,17966490
IMR90|chr6:12267661-12267729,chr6,12267661,12267729,IMR90|chr6:1389258-1389304,chr6,1389258,1389304,0,10878403
IMR90|chr6:12285680-12285702,chr6,12285680,12285702,IMR90|chr6:36647915-36647995,chr6,36647915,36647995,0,24362235
IMR90|chr6:12821895-12821973,chr6,12821895,12821973,IMR90|chr6:83779472-83779544,chr6,83779472,83779544,0,70957577
IMR90|chr6:13301225-13301253,chr6,13301225,13301253,IMR90|chr6:26273766-26273897,chr6,26273766,26273897,0,12972541
IMR90|chr6:13690787-13690883,chr6,13690787,13690883,IMR90|chr6:16130736-16130758,chr6,16130736,16130758,0,2439949
IMR90|chr6:13725944-13725995,chr6,13725944,13725995,IMR90|chr6:151716600-151716651,chr6,151716600,151716651,0,137990656
IMR90|chr6:13858093-13858182,chr6,13858093,13858182,IMR90|chr6:30651929-30651990,chr6,30651929,30651990,0,16793836
IMR90|chr6:14319849-14319919,chr6,14319849,14319919,IMR90|chr6:43021259-43021334,chr6,43021259,43021334,0,28701410
IMR90|chr6:14582042-14582093,chr6,14582042,14582093,IMR90|chr6:150182431-150182498,chr6,150182431,150182498,0,135600389
IMR90|chr6:14602784-14602809,chr6,14602784,14602809,IMR90|chr6:26273766-26273897,chr6,26273766,26273897,0,11670982
IMR90|chr6:14635134-14635231,chr6,14635134,14635231,IMR90|chr6:48041176-48041196,chr6,48041176,48041196,0,33406042
IMR90|chr6:14861842-14861910,chr6,14861842,14861910,IMR90|chr6:158588483-158588559,chr6,158588483,158588559,0,143726641
IMR90|chr6:15027582-15027619,chr6,15027582,15027619,IMR90|chr6:107779767-107779838,chr6,107779767,107779838,0,92752185
IMR90|chr6:15057571-15057650,chr6,15057571,15057650,IMR90|chr6:42533204-42533243,chr6,42533204,42533243,0,27475633
IMR90|chr6:15249355-15249373,chr6,15249355,15249373,IMR90|chr6:42417514-42417609,chr6,42417514,42417609,0,27168159
IMR90|chr6:15326774-15326853,chr6,15326774,15326853,IMR90|chr6:26458905-26458989,chr6,26458905,26458989,0,11132131
IMR90|chr6:15597913-15597986,chr6,15597913,15597986,IMR90|chr6:1393630-1393699,chr6,1393630,1393699,0,14204283
IMR90|chr6:16064407-16064485,chr6,16064407,16064485,IMR90|chr6:86158135-86158179,chr6,86158135,86158179,0,70093728
IMR90|chr6:16349522-16349549,chr6,16349522,16349549,IMR90|chr6:144606742-144606779,chr6,144606742,144606779,0,128257220
IMR90|chr6:16428869-16428934,chr6,16428869,16428934,IMR90|chr6:42927776-42927828,chr6,42927776,42927828,0,26498907
IMR90|chr6:16566827-16566859,chr6,16566827,16566859,IMR90|chr6:143267080-143267196,chr6,143267080,143267196,0,126700253
IMR90|chr6:16705580-16705647,chr6,16705580,16705647,IMR90|chr6:696633-696730,chr6,696633,696730,0,16008947
IMR90|chr6:17493857-17493927,chr6,17493857,17493927,IMR90|chr6:43021259-43021334,chr6,43021259,43021334,0,25527402
IMR90|chr6:17902317-17902446,chr6,17902317,17902446,IMR90|chr6:122792608-122792627,chr6,122792608,122792627,0,104890291
IMR90|chr6:18616261-18616373,chr6,18616261,18616373,IMR90|chr6:138190215-138190274,chr6,138190215,138190274,0,119573954
IMR90|chr6:18712252-18712318,chr6,18712252,18712318,IMR90|chr6:692682-692766,chr6,692682,692766,0,18019570
IMR90|chr6:19336422-19336518,chr6,19336422,19336518,IMR90|chr6:26458905-26458988,chr6,26458905,26458988,0,7122483
IMR90|chr6:19654079-19654131,chr6,19654079,19654131,IMR90|chr6:133136311-133136383,chr6,133136311,133136383,0,113482232
IMR90|chr6:19739174-19739203,chr6,19739174,19739203,IMR90|chr6:30293463-30293600,chr6,30293463,30293600,0,10554289
IMR90|chr6:20854865-20854899,chr6,20854865,20854899,IMR90|chr6:48037548-48037662,chr6,48037548,48037662,0,27182683
IMR90|chr6:21249347-21249375,chr6,21249347,21249375,IMR90|chr6:1393869-1394019,chr6,1393869,1394019,0,19855478
IMR90|chr6:21497740-21497848,chr6,21497740,21497848,IMR90|chr6:34854784-34854852,chr6,34854784,34854852,0,13357044
IMR90|chr6:21661629-21661748,chr6,21661629,21661748,IMR90|chr6:34854784-34854852,chr6,34854784,34854852,0,13193155
IMR90|chr6:23084764-23084870,chr6,23084764,23084870,IMR90|chr6:32142754-32142785,chr6,32142754,32142785,0,9057990
IMR90|chr6:23572368-23572435,chr6,23572368,23572435,IMR90|chr6:26458905-26458988,chr6,26458905,26458988,0,2886537
IMR90|chr6:23963463-23963506,chr6,23963463,23963506,IMR90|chr6:144606663-144606765,chr6,144606663,144606765,0,120643200
IMR90|chr6:24022369-24022469,chr6,24022369,24022469,IMR90|chr6:86155797-86155869,chr6,86155797,86155869,0,62133428
IMR90|chr6:24517890-24517924,chr6,24517890,24517924,IMR90|chr6:99844600-99844630,chr6,99844600,99844630,0,75326710
IMR90|chr6:24594734-24594837,chr6,24594734,24594837,IMR90|chr6:26102544-26102588,chr6,26102544,26102588,0,1507810
IMR90|chr6:25795832-25795910,chr6,25795832,25795910,IMR90|chr6:34854784-34854852,chr6,34854784,34854852,0,9058952
IMR90|chr6:26748216-26748234,chr6,26748216,26748234,IMR90|chr6:111284162-111284280,chr6,111284162,111284280,0,84535946
IMR90|chr6:26762940-26762988,chr6,26762940,26762988,IMR90|chr6:1393630-1393699,chr6,1393630,1393699,0,25369310
IMR90|chr6:26923573-26923626,chr6,26923573,26923626,IMR90|chr6:52439511-52439598,chr6,52439511,52439598,0,25515938
IMR90|chr6:27044984-27045041,chr6,27044984,27045041,IMR90|chr6:135817422-135817466,chr6,135817422,135817466,0,108772438
IMR90|chr6:27486560-27486629,chr6,27486560,27486629,IMR90|chr6:692682-692766,chr6,692682,692766,0,26793878
IMR90|chr6:27618878-27618939,chr6,27618878,27618939,IMR90|chr6:86162713-86162836,chr6,86162713,86162836,0,58543835
IMR90|chr6:27968257-27968329,chr6,27968257,27968329,IMR90|chr6:1392487-1392513,chr6,1392487,1392513,0,26575770
IMR90|chr6:28625234-28625272,chr6,28625234,28625272,IMR90|chr6:2843215-2843259,chr6,2843215,2843259,0,25782019
IMR90|chr6:29718995-29719069,chr6,29718995,29719069,IMR90|chr6:42533397-42533473,chr6,42533397,42533473,0,12814402
IMR90|chr6:30117939-30118044,chr6,30117939,30118044,IMR90|chr6:32142754-32142785,chr6,32142754,32142785,0,2024815
IMR90|chr6:30257024-30257081,chr6,30257024,30257081,IMR90|chr6:143266635-143266706,chr6,143266635,143266706,0,113009611
IMR90|chr6:30525065-30525091,chr6,30525065,30525091,IMR90|chr6:1389347-1389451,chr6,1389347,1389451,0,29135718
IMR90|chr6:30886523-30886584,chr6,30886523,30886584,IMR90|chr6:86162713-86162836,chr6,86162713,86162836,0,55276190
IMR90|chr6:31282018-31282053,chr6,31282018,31282053,IMR90|chr6:2843215-2843259,chr6,2843215,2843259,0,28438803
IMR90|chr6:31851846-31851900,chr6,31851846,31851900,IMR90|chr6:84139850-84139960,chr6,84139850,84139960,0,52288004
IMR90|chr6:32041254-32041320,chr6,32041254,32041320,IMR90|chr6:151715165-151715205,chr6,151715165,151715205,0,119673911
IMR90|chr6:32319579-32319617,chr6,32319579,32319617,IMR90|chr6:48037521-48037664,chr6,48037521,48037664,0,15717942
IMR90|chr6:32588154-32588174,chr6,32588154,32588174,IMR90|chr6:42417514-42417609,chr6,42417514,42417609,0,9829360
IMR90|chr6:34186250-34186284,chr6,34186250,34186284,IMR90|chr6:52439733-52439796,chr6,52439733,52439796,0,18253483
IMR90|chr6:34693430-34693550,chr6,34693430,34693550,IMR90|chr6:692736-692766,chr6,692736,692766,0,34000694
IMR90|chr6:34693598-34693714,chr6,34693598,34693714,IMR90|chr6:48037574-48037662,chr6,48037574,48037662,0,13343976
IMR90|chr6:35403262-35403292,chr6,35403262,35403292,IMR90|chr6:1389253-1389374,chr6,1389253,1389374,0,34014009
IMR90|chr6:35757525-35757568,chr6,35757525,35757568,IMR90|chr6:31794979-31795076,chr6,31794979,31795076,0,3962546
IMR90|chr6:35904282-35904303,chr6,35904282,35904303,IMR90|chr6:35438179-35438260,chr6,35438179,35438260,0,466103
IMR90|chr6:35959879-35959921,chr6,35959879,35959921,IMR90|chr6:109774215-109774286,chr6,109774215,109774286,0,73814336
IMR90|chr6:36450080-36450169,chr6,36450080,36450169,IMR90|chr6:83779472-83779544,chr6,83779472,83779544,0,47329392
IMR90|chr6:36515567-36515594,chr6,36515567,36515594,IMR90|chr6:30614721-30614844,chr6,30614721,30614844,0,5900846
IMR90|chr6:36583929-36583964,chr6,36583929,36583964,IMR90|chr6:86162366-86162404,chr6,86162366,86162404,0,49578437
IMR90|chr6:36728336-36728416,chr6,36728336,36728416,IMR90|chr6:34234602-34234650,chr6,34234602,34234650,0,2493734
IMR90|chr6:36737589-36737639,chr6,36737589,36737639,IMR90|chr6:133136853-133136944,chr6,133136853,133136944,0,96399264
IMR90|chr6:37393152-37393249,chr6,37393152,37393249,IMR90|chr6:48041176-48041196,chr6,48041176,48041196,0,10648024
IMR90|chr6:39268297-39268402,chr6,39268297,39268402,IMR90|chr6:42533204-42533243,chr6,42533204,42533243,0,3264907
IMR90|chr6:39664096-39664114,chr6,39664096,39664114,IMR90|chr6:42417514-42417609,chr6,42417514,42417609,0,2753418
IMR90|chr6:39879156-39879183,chr6,39879156,39879183,IMR90|chr6:30614721-30614844,chr6,30614721,30614844,0,9264435
IMR90|chr6:39886540-39886668,chr6,39886540,39886668,IMR90|chr6:42847887-42847946,chr6,42847887,42847946,0,2961347
IMR90|chr6:39919305-39919347,chr6,39919305,39919347,IMR90|chr6:109774215-109774286,chr6,109774215,109774286,0,69854910
IMR90|chr6:40095601-40095693,chr6,40095601,40095693,IMR90|chr6:2841514-2841574,chr6,2841514,2841574,0,37254087
IMR90|chr6:40278231-40278251,chr6,40278231,40278251,IMR90|chr6:42417514-42417609,chr6,42417514,42417609,0,2139283
IMR90|chr6:41660783-41660814,chr6,41660783,41660814,IMR90|chr6:144606642-144606761,chr6,144606642,144606761,0,102945859
IMR90|chr6:41697173-41697193,chr6,41697173,41697193,IMR90|chr6:35438179-35438260,chr6,35438179,35438260,0,6258994
IMR90|chr6:43090630-43090733,chr6,43090630,43090733,IMR90|chr6:2841548-2841574,chr6,2841548,2841574,0,40249082
IMR90|chr6:44483121-44483162,chr6,44483121,44483162,IMR90|chr6:48037536-48037662,chr6,48037536,48037662,0,3554415
IMR90|chr6:45192592-45192618,chr6,45192592,45192618,IMR90|chr6:147525419-147525513,chr6,147525419,147525513,0,102332827
IMR90|chr6:45573870-45573963,chr6,45573870,45573963,IMR90|chr6:15246307-15246353,chr6,15246307,15246353,0,30327563
IMR90|chr6:45700709-45700776,chr6,45700709,45700776,IMR90|chr6:36649319-36649360,chr6,36649319,36649360,0,9051390
IMR90|chr6:46035948-46035983,chr6,46035948,46035983,IMR90|chr6:71999616-71999691,chr6,71999616,71999691,0,25963668
IMR90|chr6:46393566-46393602,chr6,46393566,46393602,IMR90|chr6:48041001-48041063,chr6,48041001,48041063,0,1647435
IMR90|chr6:47235195-47235258,chr6,47235195,47235258,IMR90|chr6:693214-693231,chr6,693214,693231,0,46541981
IMR90|chr6:47274824-47274869,chr6,47274824,47274869,IMR90|chr6:144606663-144606765,chr6,144606663,144606765,0,97331839
IMR90|chr6:47306737-47306845,chr6,47306737,47306845,IMR90|chr6:34854784-34854852,chr6,34854784,34854852,0,12451953
IMR90|chr6:47515419-47515452,chr6,47515419,47515452,IMR90|chr6:4022743-4022824,chr6,4022743,4022824,0,43492676
IMR90|chr6:47904312-47904424,chr6,47904312,47904424,IMR90|chr6:17394672-17394724,chr6,17394672,17394724,0,30509640
IMR90|chr6:48467621-48467665,chr6,48467621,48467665,IMR90|chr6:133137162-133137224,chr6,133137162,133137224,0,84669541
IMR90|chr6:48520461-48520539,chr6,48520461,48520539,IMR90|chr6:36952678-36952730,chr6,36952678,36952730,0,11567783
IMR90|chr6:51170485-51170581,chr6,51170485,51170581,IMR90|chr6:48041176-48041196,chr6,48041176,48041196,0,3129309
IMR90|chr6:51271616-51271694,chr6,51271616,51271694,IMR90|chr6:86158135-86158179,chr6,86158135,86158179,0,34886519
IMR90|chr6:51681637-51681715,chr6,51681637,51681715,IMR90|chr6:34854784-34854852,chr6,34854784,34854852,0,16826853
IMR90|chr6:52150888-52150938,chr6,52150888,52150938,IMR90|chr6:696633-696730,chr6,696633,696730,0,51454255
IMR90|chr6:52678484-52678574,chr6,52678484,52678574,IMR90|chr6:2971009-2971034,chr6,2971009,2971034,0,49707475
IMR90|chr6:55126018-55126074,chr6,55126018,55126074,IMR90|chr6:149866212-149866235,chr6,149866212,149866235,0,94740194
IMR90|chr6:55179241-55179304,chr6,55179241,55179304,IMR90|chr6:36647195-36647248,chr6,36647195,36647248,0,18532046
IMR90|chr6:55311303-55311352,chr6,55311303,55311352,IMR90|chr6:138190215-138190274,chr6,138190215,138190274,0,82878912
IMR90|chr6:55317358-55317419,chr6,55317358,55317419,IMR90|chr6:42895444-42895482,chr6,42895444,42895482,0,12421914
IMR90|chr6:56961170-56961254,chr6,56961170,56961254,IMR90|chr6:698018-698168,chr6,698018,698168,0,56263152
IMR90|chr6:57005829-57005879,chr6,57005829,57005879,IMR90|chr6:17988626-17988667,chr6,17988626,17988667,0,39017203
IMR90|chr6:57031741-57031779,chr6,57031741,57031779,IMR90|chr6:2843215-2843259,chr6,2843215,2843259,0,54188526
IMR90|chr6:57176406-57176437,chr6,57176406,57176437,IMR90|chr6:42190068-42190187,chr6,42190068,42190187,0,14986338
IMR90|chr6:57663783-57663889,chr6,57663783,57663889,IMR90|chr6:1389253-1389293,chr6,1389253,1389293,0,56274530
IMR90|chr6:57986828-57986863,chr6,57986828,57986863,IMR90|chr6:2843215-2843259,chr6,2843215,2843259,0,55143613
IMR90|chr6:58071088-58071153,chr6,58071088,58071153,IMR90|chr6:144606642-144606761,chr6,144606642,144606761,0,86535554
IMR90|chr6:58127609-58127646,chr6,58127609,58127646,IMR90|chr6:107779767-107779838,chr6,107779767,107779838,0,49652158
IMR90|chr6:58248451-58248535,chr6,58248451,58248535,IMR90|chr6:698018-698168,chr6,698018,698168,0,57550433
IMR90|chr6:58350153-58350180,chr6,58350153,58350180,IMR90|chr6:144606742-144606779,chr6,144606742,144606779,0,86256589
IMR90|chr6:58482044-58482086,chr6,58482044,58482086,IMR90|chr6:48037521-48037664,chr6,48037521,48037664,0,10444523
IMR90|chr6:59038019-59038089,chr6,59038019,59038089,IMR90|chr6:163843019-163843061,chr6,163843019,163843061,0,104805000
IMR90|chr6:59362697-59362764,chr6,59362697,59362764,IMR90|chr6:36649319-36649360,chr6,36649319,36649360,0,22713378
IMR90|chr6:59834025-59834086,chr6,59834025,59834086,IMR90|chr6:2845965-2846054,chr6,2845965,2846054,0,56988060
IMR90|chr6:59914737-59914775,chr6,59914737,59914775,IMR90|chr6:48037521-48037664,chr6,48037521,48037664,0,11877216
IMR90|chr6:60060856-60060946,chr6,60060856,60060946,IMR90|chr6:2971009-2971034,chr6,2971009,2971034,0,57089847
IMR90|chr6:60554614-60554725,chr6,60554614,60554725,IMR90|chr6:151716600-151716651,chr6,151716600,151716651,0,91161986
IMR90|chr6:60976510-60976531,chr6,60976510,60976531,IMR90|chr6:35438179-35438260,chr6,35438179,35438260,0,25538331
IMR90|chr6:61207497-61207546,chr6,61207497,61207546,IMR90|chr6:133136853-133136944,chr6,133136853,133136944,0,71929356
IMR90|chr6:61528074-61528136,chr6,61528074,61528136,IMR90|chr6:32142754-32142785,chr6,32142754,32142785,0,29385320
IMR90|chr6:62443725-62443812,chr6,62443725,62443812,IMR90|chr6:36952678-36952730,chr6,36952678,36952730,0,25491047
IMR90|chr6:62614380-62614411,chr6,62614380,62614411,IMR90|chr6:42190068-42190187,chr6,42190068,42190187,0,20424312
IMR90|chr6:62885697-62885742,chr6,62885697,62885742,IMR90|chr6:52438801-52438829,chr6,52438801,52438829,0,10446896
IMR90|chr6:63497541-63497605,chr6,63497541,63497605,IMR90|chr6:151773079-151773142,chr6,151773079,151773142,0,88275538
IMR90|chr6:63532494-63532581,chr6,63532494,63532581,IMR90|chr6:36646814-36646833,chr6,36646814,36646833,0,26885680
IMR90|chr6:63838480-63838588,chr6,63838480,63838588,IMR90|chr6:133136957-133136999,chr6,133136957,133136999,0,69298477
IMR90|chr6:64063445-64063510,chr6,64063445,64063510,IMR90|chr6:144606642-144606761,chr6,144606642,144606761,0,80543197
IMR90|chr6:64232260-64232327,chr6,64232260,64232327,IMR90|chr6:696633-696730,chr6,696633,696730,0,63535627
IMR90|chr6:64308697-64308734,chr6,64308697,64308734,IMR90|chr6:52441433-52441546,chr6,52441433,52441546,0,11867264
IMR90|chr6:64844589-64844617,chr6,64844589,64844617,IMR90|chr6:26273766-26273897,chr6,26273766,26273897,0,38570823
IMR90|chr6:65028578-65028646,chr6,65028578,65028646,IMR90|chr6:116893815-116893867,chr6,116893815,116893867,0,51865237
IMR90|chr6:65053884-65053987,chr6,65053884,65053987,IMR90|chr6:26102544-26102588,chr6,26102544,26102588,0,38951340
IMR90|chr6:65182267-65182303,chr6,65182267,65182303,IMR90|chr6:87865736-87865885,chr6,87865736,87865885,0,22683469
IMR90|chr6:65380151-65380251,chr6,65380151,65380251,IMR90|chr6:86155715-86155821,chr6,86155715,86155821,0,20775564
IMR90|chr6:65637765-65637803,chr6,65637765,65637803,IMR90|chr6:30180909-30181007,chr6,30180909,30181007,0,35456856
IMR90|chr6:65754404-65754467,chr6,65754404,65754467,IMR90|chr6:36647195-36647248,chr6,36647195,36647248,0,29107209
IMR90|chr6:66795124-66795176,chr6,66795124,66795176,IMR90|chr6:125286210-125286306,chr6,125286210,125286306,0,58491086
IMR90|chr6:67216451-67216516,chr6,67216451,67216516,IMR90|chr6:71997715-71997752,chr6,71997715,71997752,0,4781264
IMR90|chr6:67645462-67645492,chr6,67645462,67645492,IMR90|chr6:42190068-42190187,chr6,42190068,42190187,0,25455394
IMR90|chr6:67708028-67708178,chr6,67708028,67708178,IMR90|chr6:692736-692766,chr6,692736,692766,0,67015292
IMR90|chr6:68031623-68031745,chr6,68031623,68031745,IMR90|chr6:42533397-42533473,chr6,42533397,42533473,0,25498226
IMR90|chr6:68538360-68538412,chr6,68538360,68538412,IMR90|chr6:125286210-125286306,chr6,125286210,125286306,0,56747850
IMR90|chr6:68651363-68651394,chr6,68651363,68651394,IMR90|chr6:144606642-144606761,chr6,144606642,144606761,0,75955279
IMR90|chr6:68836339-68836368,chr6,68836339,68836368,IMR90|chr6:30293463-30293600,chr6,30293463,30293600,0,38542876
IMR90|chr6:69177560-69177608,chr6,69177560,69177608,IMR90|chr6:48037608-48037662,chr6,48037608,48037662,0,21139952
IMR90|chr6:69327073-69327100,chr6,69327073,69327100,IMR90|chr6:143266627-143266698,chr6,143266627,143266698,0,73939554
IMR90|chr6:69361550-69361569,chr6,69361550,69361569,IMR90|chr6:35438178-35438260,chr6,35438178,35438260,0,33923372
IMR90|chr6:69508425-69508467,chr6,69508425,69508467,IMR90|chr6:52441459-52441546,chr6,52441459,52441546,0,17066966
IMR90|chr6:70083902-70083988,chr6,70083902,70083988,IMR90|chr6:48037212-48037238,chr6,48037212,48037238,0,22046690
IMR90|chr6:70580801-70580846,chr6,70580801,70580846,IMR90|chr6:144606663-144606765,chr6,144606663,144606765,0,74025862
IMR90|chr6:71396968-71397051,chr6,71396968,71397051,IMR90|chr6:107782303-107782334,chr6,107782303,107782334,0,36385335
IMR90|chr6:71986924-71986988,chr6,71986924,71986988,IMR90|chr6:26458905-26458989,chr6,26458905,26458989,0,45528019
IMR90|chr6:72009641-72009698,chr6,72009641,72009698,IMR90|chr6:135817422-135817466,chr6,135817422,135817466,0,63807781
IMR90|chr6:72215919-72215961,chr6,72215919,72215961,IMR90|chr6:122792632-122792687,chr6,122792632,122792687,0,50576713
IMR90|chr6:72308552-72308579,chr6,72308552,72308579,IMR90|chr6:86162713-86162836,chr6,86162713,86162836,0,13854161
IMR90|chr6:72342185-72342235,chr6,72342185,72342235,IMR90|chr6:696633-696730,chr6,696633,696730,0,71645552
IMR90|chr6:72628134-72628239,chr6,72628134,72628239,IMR90|chr6:1389591-1389633,chr6,1389591,1389633,0,71238543
IMR90|chr6:72828349-72828379,chr6,72828349,72828379,IMR90|chr6:1389253-1389374,chr6,1389253,1389374,0,71439096
IMR90|chr6:73210321-73210399,chr6,73210321,73210399,IMR90|chr6:34234602-34234648,chr6,34234602,34234648,0,38975719
IMR90|chr6:73234456-73234539,chr6,73234456,73234539,IMR90|chr6:107782303-107782334,chr6,107782303,107782334,0,34547847
IMR90|chr6:73985851-73985959,chr6,73985851,73985959,IMR90|chr6:2841501-2841574,chr6,2841501,2841574,0,71144350
IMR90|chr6:74271088-74271123,chr6,74271088,74271123,IMR90|chr6:48041001-48041063,chr6,48041001,48041063,0,26230087
IMR90|chr6:74612009-74612134,chr6,74612009,74612134,IMR90|chr6:122792632-122792687,chr6,122792632,122792687,0,48180623
IMR90|chr6:74827885-74827939,chr6,74827885,74827939,IMR90|chr6:86303099-86303180,chr6,86303099,86303180,0,11475214
IMR90|chr6:75403534-75403578,chr6,75403534,75403578,IMR90|chr6:86155715-86155821,chr6,86155715,86155821,0,10752181
IMR90|chr6:75694178-75694256,chr6,75694178,75694256,IMR90|chr6:83779472-83779544,chr6,83779472,83779544,0,8085294
IMR90|chr6:77735277-77735342,chr6,77735277,77735342,IMR90|chr6:2845965-2846054,chr6,2845965,2846054,0,74889312
IMR90|chr6:77952500-77952600,chr6,77952500,77952600,IMR90|chr6:86155715-86155821,chr6,86155715,86155821,0,8203215
IMR90|chr6:77978984-77979096,chr6,77978984,77979096,IMR90|chr6:3161373-3161412,chr6,3161373,3161412,0,74817611
IMR90|chr6:78692257-78692297,chr6,78692257,78692297,IMR90|chr6:86305289-86305423,chr6,86305289,86305423,0,7613032
IMR90|chr6:78843913-78843983,chr6,78843913,78843983,IMR90|chr6:163843019-163843061,chr6,163843019,163843061,0,84999106
IMR90|chr6:79087835-79087924,chr6,79087835,79087924,IMR90|chr6:83779472-83779544,chr6,83779472,83779544,0,4691637
IMR90|chr6:79568817-79568841,chr6,79568817,79568841,IMR90|chr6:48037541-48037662,chr6,48037541,48037662,0,31531276
IMR90|chr6:79621941-79621999,chr6,79621941,79621999,IMR90|chr6:143267080-143267196,chr6,143267080,143267196,0,63645139
IMR90|chr6:79707992-79708039,chr6,79707992,79708039,IMR90|chr6:153324115-153324190,chr6,153324115,153324190,0,73616123
IMR90|chr6:80060761-80060813,chr6,80060761,80060813,IMR90|chr6:86303099-86303180,chr6,86303099,86303180,0,6242338
IMR90|chr6:80314680-80314734,chr6,80314680,80314734,IMR90|chr6:26458905-26459001,chr6,26458905,26459001,0,53855775
IMR90|chr6:80954010-80954067,chr6,80954010,80954067,IMR90|chr6:143266635-143266706,chr6,143266635,143266706,0,62312625
IMR90|chr6:82252507-82252581,chr6,82252507,82252581,IMR90|chr6:42533397-42533473,chr6,42533397,42533473,0,39719110
IMR90|chr6:82475907-82475956,chr6,82475907,82475956,IMR90|chr6:125286210-125286306,chr6,125286210,125286306,0,42810303
IMR90|chr6:82521085-82521193,chr6,82521085,82521193,IMR90|chr6:2841501-2841574,chr6,2841501,2841574,0,79679584
IMR90|chr6:82669078-82669112,chr6,82669078,82669112,IMR90|chr6:99844600-99844630,chr6,99844600,99844630,0,17175522
IMR90|chr6:82783758-82783821,chr6,82783758,82783821,IMR90|chr6:151714942-151715016,chr6,151714942,151715016,0,68931184
IMR90|chr6:83182361-83182444,chr6,83182361,83182444,IMR90|chr6:122792632-122792687,chr6,122792632,122792687,0,39610271
IMR90|chr6:83189109-83189175,chr6,83189109,83189175,IMR90|chr6:41749968-41750030,chr6,41749968,41750030,0,41439141
IMR90|chr6:83403633-83403749,chr6,83403633,83403749,IMR90|chr6:4022741-4022823,chr6,4022741,4022823,0,79380892
IMR90|chr6:83419701-83419719,chr6,83419701,83419719,IMR90|chr6:35438178-35438260,chr6,35438178,35438260,0,47981523
IMR90|chr6:83422762-83422912,chr6,83422762,83422912,IMR90|chr6:692736-692766,chr6,692736,692766,0,82730026
IMR90|chr6:83469245-83469265,chr6,83469245,83469265,IMR90|chr6:48037546-48037662,chr6,48037546,48037662,0,35431699
IMR90|chr6:84255207-84255306,chr6,84255207,84255306,IMR90|chr6:151716600-151716651,chr6,151716600,151716651,0,67461393
IMR90|chr6:84576983-84577049,chr6,84576983,84577049,IMR90|chr6:151715165-151715205,chr6,151715165,151715205,0,67138182
IMR90|chr6:84917701-84917775,chr6,84917701,84917775,IMR90|chr6:143267080-143267108,chr6,143267080,143267108,0,58349379
IMR90|chr6:85203790-85203827,chr6,85203790,85203827,IMR90|chr6:52439733-52439796,chr6,52439733,52439796,0,32764057
IMR90|chr6:85586404-85586527,chr6,85586404,85586527,IMR90|chr6:3159143-3159241,chr6,3159143,3159241,0,82427261
IMR90|chr6:86037132-86037154,chr6,86037132,86037154,IMR90|chr6:86155797-86155869,chr6,86155797,86155869,0,118665
IMR90|chr6:86311613-86311668,chr6,86311613,86311668,IMR90|chr6:1389253-1389348,chr6,1389253,1389348,0,84922360
IMR90|chr6:86439022-86439094,chr6,86439022,86439094,IMR90|chr6:1392487-1392513,chr6,1392487,1392513,0,85046535
IMR90|chr6:86639701-86639794,chr6,86639701,86639794,IMR90|chr6:30651929-30651990,chr6,30651929,30651990,0,55987772
IMR90|chr6:86748565-86748668,chr6,86748565,86748668,IMR90|chr6:2841548-2841574,chr6,2841548,2841574,0,83907017
IMR90|chr6:87482023-87482072,chr6,87482023,87482072,IMR90|chr6:143267080-143267148,chr6,143267080,143267148,0,55785057
IMR90|chr6:87607932-87607984,chr6,87607932,87607984,IMR90|chr6:52439511-52439598,chr6,52439511,52439598,0,35168421
IMR90|chr6:87857422-87857471,chr6,87857422,87857471,IMR90|chr6:133136853-133136944,chr6,133136853,133136944,0,45279431
IMR90|chr6:88285735-88285780,chr6,88285735,88285780,IMR90|chr6:34205706-34205799,chr6,34205706,34205799,0,54080029
IMR90|chr6:88488803-88488887,chr6,88488803,88488887,IMR90|chr6:111302682-111302763,chr6,111302682,111302763,0,22813879
IMR90|chr6:89324950-89325004,chr6,89324950,89325004,IMR90|chr6:86303099-86303180,chr6,86303099,86303180,0,3021851
IMR90|chr6:90691431-90691521,chr6,90691431,90691521,IMR90|chr6:2841514-2841574,chr6,2841514,2841574,0,87849917
IMR90|chr6:92173406-92173490,chr6,92173406,92173490,IMR90|chr6:111302682-111302763,chr6,111302682,111302763,0,19129276
IMR90|chr6:92298488-92298607,chr6,92298488,92298607,IMR90|chr6:34854784-34854852,chr6,34854784,34854852,0,57443704
IMR90|chr6:92457081-92457131,chr6,92457081,92457131,IMR90|chr6:133136853-133136944,chr6,133136853,133136944,0,40679772
IMR90|chr6:93230070-93230133,chr6,93230070,93230133,IMR90|chr6:151714942-151715016,chr6,151714942,151715016,0,58484872
IMR90|chr6:93319192-93319287,chr6,93319192,93319287,IMR90|chr6:4016392-4016437,chr6,4016392,4016437,0,89302800
IMR90|chr6:93722661-93722694,chr6,93722661,93722694,IMR90|chr6:4022743-4022824,chr6,4022743,4022824,0,89699918
IMR90|chr6:93789518-93789570,chr6,93789518,93789570,IMR90|chr6:150182431-150182501,chr6,150182431,150182501,0,56392913
IMR90|chr6:93812543-93812630,chr6,93812543,93812630,IMR90|chr6:30644096-30644129,chr6,30644096,30644129,0,63168447
IMR90|chr6:94029187-94029227,chr6,94029187,94029227,IMR90|chr6:1389591-1389633,chr6,1389591,1389633,0,92639596
IMR90|chr6:94312139-94312187,chr6,94312139,94312187,IMR90|chr6:111302682-111302763,chr6,111302682,111302763,0,16990543
IMR90|chr6:94417646-94417733,chr6,94417646,94417733,IMR90|chr6:36646814-36646833,chr6,36646814,36646833,0,57770832
IMR90|chr6:94544816-94544907,chr6,94544816,94544907,IMR90|chr6:42847887-42847946,chr6,42847887,42847946,0,51696929
IMR90|chr6:94809298-94809375,chr6,94809298,94809375,IMR90|chr6:34234602-34234648,chr6,34234602,34234648,0,60574696
IMR90|chr6:95241518-95241599,chr6,95241518,95241599,IMR90|chr6:2841524-2841574,chr6,2841524,2841574,0,92399994
IMR90|chr6:95346507-95346606,chr6,95346507,95346606,IMR90|chr6:1389253-1389348,chr6,1389253,1389348,0,93957254
IMR90|chr6:95665912-95665946,chr6,95665912,95665946,IMR90|chr6:48037548-48037662,chr6,48037548,48037662,0,47628364
IMR90|chr6:96369583-96369685,chr6,96369583,96369685,IMR90|chr6:26102544-26102588,chr6,26102544,26102588,0,70267039
IMR90|chr6:97398010-97398074,chr6,97398010,97398074,IMR90|chr6:26458905-26458989,chr6,26458905,26458989,0,70939105
IMR90|chr6:98183131-98183231,chr6,98183131,98183231,IMR90|chr6:86155797-86155869,chr6,86155797,86155869,0,12027334
IMR90|chr6:98392127-98392226,chr6,98392127,98392226,IMR90|chr6:151716600-151716651,chr6,151716600,151716651,0,53324473
IMR90|chr6:99161294-99161421,chr6,99161294,99161421,IMR90|chr6:122792608-122792627,chr6,122792608,122792627,0,23631314
IMR90|chr6:99693276-99693326,chr6,99693276,99693326,IMR90|chr6:17988626-17988667,chr6,17988626,17988667,0,81704650
IMR90|chr6:100319615-100319684,chr6,100319615,100319684,IMR90|chr6:151715165-151715205,chr6,151715165,151715205,0,51395550
IMR90|chr6:100510379-100510451,chr6,100510379,100510451,IMR90|chr6:116892810-116892950,chr6,116892810,116892950,0,16382431
IMR90|chr6:100809423-100809519,chr6,100809423,100809519,IMR90|chr6:26458905-26458988,chr6,26458905,26458988,0,74350518
IMR90|chr6:101169010-101169118,chr6,101169010,101169118,IMR90|chr6:48037598-48037662,chr6,48037598,48037662,0,53131412
IMR90|chr6:101274835-101274870,chr6,101274835,101274870,IMR90|chr6:48041001-48041063,chr6,48041001,48041063,0,53233834
IMR90|chr6:101377773-101377832,chr6,101377773,101377832,IMR90|chr6:1388988-1389038,chr6,1388988,1389038,0,99988785
IMR90|chr6:101647023-101647054,chr6,101647023,101647054,IMR90|chr6:30614721-30614844,chr6,30614721,30614844,0,71032302
IMR90|chr6:102525531-102525582,chr6,102525531,102525582,IMR90|chr6:133136311-133136383,chr6,133136311,133136383,0,30610780
IMR90|chr6:102963672-102963721,chr6,102963672,102963721,IMR90|chr6:138190215-138190274,chr6,138190215,138190274,0,35226543
IMR90|chr6:102985154-102985240,chr6,102985154,102985240,IMR90|chr6:48037598-48037662,chr6,48037598,48037662,0,54947556
IMR90|chr6:103733133-103733173,chr6,103733133,103733173,IMR90|chr6:1389591-1389633,chr6,1389591,1389633,0,102343542
IMR90|chr6:103795387-103795409,chr6,103795387,103795409,IMR90|chr6:36647915-36647995,chr6,36647915,36647995,0,67147472
IMR90|chr6:103853767-103853815,chr6,103853767,103853815,IMR90|chr6:1393630-1393699,chr6,1393630,1393699,0,102460137
IMR90|chr6:104085610-104085715,chr6,104085610,104085715,IMR90|chr6:42533204-42533243,chr6,42533204,42533243,0,61552406
IMR90|chr6:104875610-104875631,chr6,104875610,104875631,IMR90|chr6:42983365-42983509,chr6,42983365,42983509,0,61892245
IMR90|chr6:104973189-104973300,chr6,104973189,104973300,IMR90|chr6:151716600-151716651,chr6,151716600,151716651,0,46743411
IMR90|chr6:106133243-106133272,chr6,106133243,106133272,IMR90|chr6:1389253-1389374,chr6,1389253,1389374,0,104743990
IMR90|chr6:106693553-106693639,chr6,106693553,106693639,IMR90|chr6:48037212-48037238,chr6,48037212,48037238,0,58656341
IMR90|chr6:106739371-106739458,chr6,106739371,106739458,IMR90|chr6:30644096-30644129,chr6,30644096,30644129,0,76095275
IMR90|chr6:106965564-106965630,chr6,106965564,106965630,IMR90|chr6:136575632-136575697,chr6,136575632,136575697,0,29610068
IMR90|chr6:107035248-107035320,chr6,107035248,107035320,IMR90|chr6:116892810-116892950,chr6,116892810,116892950,0,9857562
IMR90|chr6:107125116-107125138,chr6,107125116,107125138,IMR90|chr6:86155797-86155869,chr6,86155797,86155869,0,20969319
IMR90|chr6:107349445-107349512,chr6,107349445,107349512,IMR90|chr6:26457131-26457174,chr6,26457131,26457174,0,80892314
IMR90|chr6:107930403-107930454,chr6,107930403,107930454,IMR90|chr6:17988626-17988667,chr6,17988626,17988667,0,89941777
IMR90|chr6:108309854-108309908,chr6,108309854,108309908,IMR90|chr6:84139850-84139960,chr6,84139850,84139960,0,24170004
IMR90|chr6:108690133-108690221,chr6,108690133,108690221,IMR90|chr6:36646814-36646833,chr6,36646814,36646833,0,72043319
IMR90|chr6:108732904-108732957,chr6,108732904,108732957,IMR90|chr6:52439511-52439598,chr6,52439511,52439598,0,56293393
IMR90|chr6:109272282-109272327,chr6,109272282,109272327,IMR90|chr6:52438801-52438829,chr6,52438801,52438829,0,56833481
IMR90|chr6:109354428-109354533,chr6,109354428,109354533,IMR90|chr6:32142754-32142785,chr6,32142754,32142785,0,77211674
IMR90|chr6:109676576-109676598,chr6,109676576,109676598,IMR90|chr6:143267096-143267246,chr6,143267096,143267246,0,33590520
IMR90|chr6:109695331-109695350,chr6,109695331,109695350,IMR90|chr6:35438178-35438260,chr6,35438178,35438260,0,74257153
IMR90|chr6:110540655-110540689,chr6,110540655,110540689,IMR90|chr6:86156191-86156281,chr6,86156191,86156281,0,24384464
IMR90|chr6:111952357-111952455,chr6,111952357,111952455,IMR90|chr6:17394672-17394724,chr6,17394672,17394724,0,94557685
IMR90|chr6:113546310-113546378,chr6,113546310,113546378,IMR90|chr6:4022741-4022823,chr6,4022741,4022823,0,109523569
IMR90|chr6:114104468-114104494,chr6,114104468,114104494,IMR90|chr6:1389347-1389451,chr6,1389347,1389451,0,112715121
IMR90|chr6:114574586-114574651,chr6,114574586,114574651,IMR90|chr6:2845965-2846054,chr6,2845965,2846054,0,111728621
IMR90|chr6:114704780-114704891,chr6,114704780,114704891,IMR90|chr6:3161373-3161412,chr6,3161373,3161412,0,111543407
IMR90|chr6:115280192-115280315,chr6,115280192,115280315,IMR90|chr6:3159143-3159241,chr6,3159143,3159241,0,112121049
IMR90|chr6:116060843-116060911,chr6,116060843,116060911,IMR90|chr6:4022741-4022823,chr6,4022741,4022823,0,112038102
IMR90|chr6:116127926-116128014,chr6,116127926,116128014,IMR90|chr6:36646814-36646833,chr6,36646814,36646833,0,79481112
IMR90|chr6:116415186-116415227,chr6,116415186,116415227,IMR90|chr6:1389415-1389476,chr6,1389415,1389476,0,115025771
IMR90|chr6:116666518-116666574,chr6,116666518,116666574,IMR90|chr6:149866212-149866235,chr6,149866212,149866235,0,33199694
IMR90|chr6:116761498-116761546,chr6,116761498,116761546,IMR90|chr6:48037608-48037662,chr6,48037608,48037662,0,68723890
IMR90|chr6:116951102-116951194,chr6,116951102,116951194,IMR90|chr6:2841514-2841574,chr6,2841514,2841574,0,114109588
IMR90|chr6:117400779-117400819,chr6,117400779,117400819,IMR90|chr6:1389253-1389351,chr6,1389253,1389351,0,116011526
IMR90|chr6:117797695-117797730,chr6,117797695,117797730,IMR90|chr6:86162366-86162404,chr6,86162366,86162404,0,31635329
IMR90|chr6:118275602-118275669,chr6,118275602,118275669,IMR90|chr6:144606742-144606779,chr6,144606742,144606779,0,26331140
IMR90|chr6:118629614-118629650,chr6,118629614,118629650,IMR90|chr6:2845923-2846012,chr6,2845923,2846012,0,115783691
IMR90|chr6:118793915-118793991,chr6,118793915,118793991,IMR90|chr6:2971009-2971034,chr6,2971009,2971034,0,115822906
IMR90|chr6:119274694-119274743,chr6,119274694,119274743,IMR90|chr6:125286210-125286306,chr6,125286210,125286306,0,6011516
IMR90|chr6:119865393-119865460,chr6,119865393,119865460,IMR90|chr6:136575625-136575696,chr6,136575625,136575696,0,16710232
IMR90|chr6:120386826-120386890,chr6,120386826,120386890,IMR90|chr6:1389253-1389287,chr6,1389253,1389287,0,118997573
IMR90|chr6:120886770-120886828,chr6,120886770,120886828,IMR90|chr6:143267080-143267196,chr6,143267080,143267196,0,22380310
IMR90|chr6:120926415-120926466,chr6,120926415,120926466,IMR90|chr6:17988626-17988667,chr6,17988626,17988667,0,102937789
IMR90|chr6:121343929-121343992,chr6,121343929,121343992,IMR90|chr6:31589809-31589879,chr6,31589809,31589879,0,89754120
IMR90|chr6:121916604-121916691,chr6,121916604,121916691,IMR90|chr6:52441405-52441468,chr6,52441405,52441468,0,69475199
IMR90|chr6:121980573-121980660,chr6,121980573,121980660,IMR90|chr6:52441405-52441468,chr6,52441405,52441468,0,69539168
IMR90|chr6:123386404-123386531,chr6,123386404,123386531,IMR90|chr6:122792608-122792627,chr6,122792608,122792627,0,593796
IMR90|chr6:123852365-123852408,chr6,123852365,123852408,IMR90|chr6:144606663-144606765,chr6,144606663,144606765,0,20754298
IMR90|chr6:124067540-124067617,chr6,124067540,124067617,IMR90|chr6:34234602-34234648,chr6,34234602,34234648,0,89832938
IMR90|chr6:124658239-124658308,chr6,124658239,124658308,IMR90|chr6:43021262-43021274,chr6,43021262,43021274,0,81636977
IMR90|chr6:124808477-124808540,chr6,124808477,124808540,IMR90|chr6:693214-693231,chr6,693214,693231,0,124115263
IMR90|chr6:125694856-125694967,chr6,125694856,125694967,IMR90|chr6:3161373-3161412,chr6,3161373,3161412,0,122533483
IMR90|chr6:126192379-126192485,chr6,126192379,126192485,IMR90|chr6:32142754-32142785,chr6,32142754,32142785,0,94049625
IMR90|chr6:126340103-126340167,chr6,126340103,126340167,IMR90|chr6:151773079-151773142,chr6,151773079,151773142,0,25432976
IMR90|chr6:126796654-126796750,chr6,126796654,126796750,IMR90|chr6:16130736-16130758,chr6,16130736,16130758,0,110665918
IMR90|chr6:127307307-127307378,chr6,127307307,127307378,IMR90|chr6:43398574-43398625,chr6,43398574,43398625,0,83908733
IMR90|chr6:127318383-127318469,chr6,127318383,127318469,IMR90|chr6:48037598-48037662,chr6,48037598,48037662,0,79280785
IMR90|chr6:127361179-127361230,chr6,127361179,127361230,IMR90|chr6:150182431-150182498,chr6,150182431,150182498,0,22821252
IMR90|chr6:127656042-127656104,chr6,127656042,127656104,IMR90|chr6:2971009-2971034,chr6,2971009,2971034,0,124685033
IMR90|chr6:127995861-127995952,chr6,127995861,127995952,IMR90|chr6:42847887-42847946,chr6,42847887,42847946,0,85147974
IMR90|chr6:128203969-128204074,chr6,128203969,128204074,IMR90|chr6:1389591-1389633,chr6,1389591,1389633,0,126814378
IMR90|chr6:128527679-128527775,chr6,128527679,128527775,IMR90|chr6:48041176-48041196,chr6,48041176,48041196,0,80486503
IMR90|chr6:128680028-128680077,chr6,128680028,128680077,IMR90|chr6:30644096-30644129,chr6,30644096,30644129,0,98035932
IMR90|chr6:129011549-129011588,chr6,129011549,129011588,IMR90|chr6:84139850-84139960,chr6,84139850,84139960,0,44871699
IMR90|chr6:129358787-129358839,chr6,129358787,129358839,IMR90|chr6:86303099-86303180,chr6,86303099,86303180,0,43055688
IMR90|chr6:129393500-129393576,chr6,129393500,129393576,IMR90|chr6:149867637-149867684,chr6,149867637,149867684,0,20474137
IMR90|chr6:129973752-129973801,chr6,129973752,129973801,IMR90|chr6:30644096-30644129,chr6,30644096,30644129,0,99329656
IMR90|chr6:130197703-130197770,chr6,130197703,130197770,IMR90|chr6:26458905-26458988,chr6,26458905,26458988,0,103738798
IMR90|chr6:130621395-130621463,chr6,130621395,130621463,IMR90|chr6:1389258-1389304,chr6,1389258,1389304,0,129232137
IMR90|chr6:130980780-130980873,chr6,130980780,130980873,IMR90|chr6:30651929-30651990,chr6,30651929,30651990,0,100328851
IMR90|chr6:131287972-131287994,chr6,131287972,131287994,IMR90|chr6:48037541-48037662,chr6,48037541,48037662,0,83250431
IMR90|chr6:131926345-131926423,chr6,131926345,131926423,IMR90|chr6:36952678-36952730,chr6,36952678,36952730,0,94973667
IMR90|chr6:132295462-132295497,chr6,132295462,132295497,IMR90|chr6:71999616-71999691,chr6,71999616,71999691,0,60295846
IMR90|chr6:132661515-132661570,chr6,132661515,132661570,IMR90|chr6:1389253-1389348,chr6,1389253,1389348,0,131272262
IMR90|chr6:135145874-135145941,chr6,135145874,135145941,IMR90|chr6:144606742-144606779,chr6,144606742,144606779,0,9460868
IMR90|chr6:135317755-135317773,chr6,135317755,135317773,IMR90|chr6:48037541-48037662,chr6,48037541,48037662,0,87280214
IMR90|chr6:135474059-135474090,chr6,135474059,135474090,IMR90|chr6:30614721-30614844,chr6,30614721,30614844,0,104859338
IMR90|chr6:135853698-135853796,chr6,135853698,135853796,IMR90|chr6:17394672-17394724,chr6,17394672,17394724,0,118459026
IMR90|chr6:136102645-136102693,chr6,136102645,136102693,IMR90|chr6:153324115-153324190,chr6,153324115,153324190,0,17221470
IMR90|chr6:136156019-136156049,chr6,136156019,136156049,IMR90|chr6:86301503-86301570,chr6,86301503,86301570,0,49854516
IMR90|chr6:136518903-136518969,chr6,136518903,136518969,IMR90|chr6:41749968-41750030,chr6,41749968,41750030,0,94768935
IMR90|chr6:137346422-137346465,chr6,137346422,137346465,IMR90|chr6:31794979-31795076,chr6,31794979,31795076,0,105551443
IMR90|chr6:138091150-138091175,chr6,138091150,138091175,IMR90|chr6:26273766-26273897,chr6,26273766,26273897,0,111817384
IMR90|chr6:138175938-138175990,chr6,138175938,138175990,IMR90|chr6:133136311-133136383,chr6,133136311,133136383,0,5039627
IMR90|chr6:138613419-138613489,chr6,138613419,138613489,IMR90|chr6:36952678-36952730,chr6,36952678,36952730,0,101660741
IMR90|chr6:139223471-139223523,chr6,139223471,139223523,IMR90|chr6:52439511-52439598,chr6,52439511,52439598,0,86783960
IMR90|chr6:139852533-139852594,chr6,139852533,139852594,IMR90|chr6:42895444-42895482,chr6,42895444,42895482,0,96957089
IMR90|chr6:140589871-140589907,chr6,140589871,140589907,IMR90|chr6:2845923-2846012,chr6,2845923,2846012,0,137743948
IMR90|chr6:141390449-141390534,chr6,141390449,141390534,IMR90|chr6:41751965-41752030,chr6,41751965,41752030,0,99638484
IMR90|chr6:141748681-141748723,chr6,141748681,141748723,IMR90|chr6:122792632-122792687,chr6,122792632,122792687,0,18956049
IMR90|chr6:142171162-142171202,chr6,142171162,142171202,IMR90|chr6:30180909-30181007,chr6,30180909,30181007,0,111990253
IMR90|chr6:142392501-142392568,chr6,142392501,142392568,IMR90|chr6:136575625-136575696,chr6,136575625,136575696,0,5816876
IMR90|chr6:142566343-142566416,chr6,142566343,142566416,IMR90|chr6:1393630-1393699,chr6,1393630,1393699,0,141172713
IMR90|chr6:142838318-142838376,chr6,142838318,142838376,IMR90|chr6:48037606-48037662,chr6,48037606,48037662,0,94800712
IMR90|chr6:142925290-142925379,chr6,142925290,142925379,IMR90|chr6:30651929-30651990,chr6,30651929,30651990,0,112273361
IMR90|chr6:142929060-142929097,chr6,142929060,142929097,IMR90|chr6:52441433-52441546,chr6,52441433,52441546,0,90487627
IMR90|chr6:143018270-143018288,chr6,143018270,143018288,IMR90|chr6:111284162-111284280,chr6,111284162,111284280,0,31734108
IMR90|chr6:143225482-143225533,chr6,143225482,143225533,IMR90|chr6:133136311-133136383,chr6,133136311,133136383,0,10089171
IMR90|chr6:143693900-143694025,chr6,143693900,143694025,IMR90|chr6:122792632-122792687,chr6,122792632,122792687,0,20901268
IMR90|chr6:144038136-144038154,chr6,144038136,144038154,IMR90|chr6:48037541-48037662,chr6,48037541,48037662,0,96000595
IMR90|chr6:144251868-144251980,chr6,144251868,144251980,IMR90|chr6:138190215-138190274,chr6,138190215,138190274,0,6061653
IMR90|chr6:144272749-144272844,chr6,144272749,144272844,IMR90|chr6:4016392-4016437,chr6,4016392,4016437,0,140256357
IMR90|chr6:144682327-144682368,chr6,144682327,144682368,IMR90|chr6:48037536-48037662,chr6,48037536,48037662,0,96644791
IMR90|chr6:145101448-145101547,chr6,145101448,145101547,IMR90|chr6:1389253-1389348,chr6,1389253,1389348,0,143712195
IMR90|chr6:145273057-145273084,chr6,145273057,145273084,IMR90|chr6:86162713-86162836,chr6,86162713,86162836,0,59110344
IMR90|chr6:145285634-145285719,chr6,145285634,145285719,IMR90|chr6:41751965-41752030,chr6,41751965,41752030,0,103533669
IMR90|chr6:146753346-146753436,chr6,146753346,146753436,IMR90|chr6:2841514-2841574,chr6,2841514,2841574,0,143911832
IMR90|chr6:147353033-147353072,chr6,147353033,147353072,IMR90|chr6:84139850-84139960,chr6,84139850,84139960,0,63213183
IMR90|chr6:147610103-147610161,chr6,147610103,147610161,IMR90|chr6:48037606-48037662,chr6,48037606,48037662,0,99572497
IMR90|chr6:147656735-147656812,chr6,147656735,147656812,IMR90|chr6:2841501-2841574,chr6,2841501,2841574,0,144815234
IMR90|chr6:148160301-148160333,chr6,148160301,148160333,IMR90|chr6:143267080-143267196,chr6,143267080,143267196,0,4893221
IMR90|chr6:149181542-149181591,chr6,149181542,149181591,IMR90|chr6:143267080-143267148,chr6,143267080,143267148,0,5914462
IMR90|chr6:149218392-149218431,chr6,149218392,149218431,IMR90|chr6:86305289-86305423,chr6,86305289,86305423,0,62913103
IMR90|chr6:149239391-149239474,chr6,149239391,149239474,IMR90|chr6:122792632-122792687,chr6,122792632,122792687,0,26446759
IMR90|chr6:149281964-149282028,chr6,149281964,149282028,IMR90|chr6:31589809-31589879,chr6,31589809,31589879,0,117692155
IMR90|chr6:149531718-149531745,chr6,149531718,149531745,IMR90|chr6:143266627-143266698,chr6,143266627,143266698,0,6265091
IMR90|chr6:149663743-149663812,chr6,149663743,149663812,IMR90|chr6:151715165-151715205,chr6,151715165,151715205,0,2051422
IMR90|chr6:149790152-149790216,chr6,149790152,149790216,IMR90|chr6:1389253-1389287,chr6,1389253,1389287,0,148400899
IMR90|chr6:149819308-149819345,chr6,149819308,149819345,IMR90|chr6:52439733-52439796,chr6,52439733,52439796,0,97379575
IMR90|chr6:149851782-149851812,chr6,149851782,149851812,IMR90|chr6:42190068-42190187,chr6,42190068,42190187,0,107661714
IMR90|chr6:150595886-150595925,chr6,150595886,150595925,IMR90|chr6:86305289-86305423,chr6,86305289,86305423,0,64290597
IMR90|chr6:151083982-151084033,chr6,151083982,151084033,IMR90|chr6:151716600-151716651,chr6,151716600,151716651,0,632618
IMR90|chr6:151451611-151451727,chr6,151451611,151451727,IMR90|chr6:4022741-4022823,chr6,4022741,4022823,0,147428870
IMR90|chr6:151631526-151631600,chr6,151631526,151631600,IMR90|chr6:143267080-143267108,chr6,143267080,143267108,0,8364446
IMR90|chr6:151707113-151707225,chr6,151707113,151707225,IMR90|chr6:17394672-17394724,chr6,17394672,17394724,0,134312441
IMR90|chr6:152040886-152040926,chr6,152040886,152040926,IMR90|chr6:86305289-86305423,chr6,86305289,86305423,0,65735597
IMR90|chr6:152366670-152366706,chr6,152366670,152366706,IMR90|chr6:48037548-48037662,chr6,48037548,48037662,0,104329122
IMR90|chr6:152391488-152391575,chr6,152391488,152391575,IMR90|chr6:36952678-36952730,chr6,36952678,36952730,0,115438810
IMR90|chr6:152509434-152509496,chr6,152509434,152509496,IMR90|chr6:2971009-2971034,chr6,2971009,2971034,0,149538425
IMR90|chr6:152842318-152842338,chr6,152842318,152842338,IMR90|chr6:48037546-48037662,chr6,48037546,48037662,0,104804772
IMR90|chr6:153528064-153528157,chr6,153528064,153528157,IMR90|chr6:15246307-15246353,chr6,15246307,15246353,0,138281757
IMR90|chr6:153649475-153649578,chr6,153649475,153649578,IMR90|chr6:43397787-43397830,chr6,43397787,43397830,0,110251688
IMR90|chr6:154591833-154591900,chr6,154591833,154591900,IMR90|chr6:26457131-26457174,chr6,26457131,26457174,0,128134702
IMR90|chr6:154699172-154699190,chr6,154699172,154699190,IMR90|chr6:35438178-35438260,chr6,35438178,35438260,0,119260994
IMR90|chr6:154725892-154725961,chr6,154725892,154725961,IMR90|chr6:43021262-43021274,chr6,43021262,43021274,0,111704630
IMR90|chr6:154859895-154859938,chr6,154859895,154859938,IMR90|chr6:109774215-109774286,chr6,109774215,109774286,0,45085680
IMR90|chr6:154972016-154972077,chr6,154972016,154972077,IMR90|chr6:2845965-2846054,chr6,2845965,2846054,0,152126051
IMR90|chr6:156317358-156317428,chr6,156317358,156317428,IMR90|chr6:43398574-43398625,chr6,43398574,43398625,0,112918784
IMR90|chr6:157261878-157261948,chr6,157261878,157261948,IMR90|chr6:36952678-36952730,chr6,36952678,36952730,0,120309200
IMR90|chr6:157934073-157934132,chr6,157934073,157934132,IMR90|chr6:127841638-127841713,chr6,127841638,127841713,0,30092435
IMR90|chr6:158329034-158329163,chr6,158329034,158329163,IMR90|chr6:122792608-122792627,chr6,122792608,122792627,0,35536426
IMR90|chr6:158366684-158366750,chr6,158366684,158366750,IMR90|chr6:136575632-136575697,chr6,136575632,136575697,0,21791052
IMR90|chr6:158523770-158523833,chr6,158523770,158523833,IMR90|chr6:31589809-31589879,chr6,31589809,31589879,0,126933961
IMR90|chr6:158524571-158524633,chr6,158524571,158524633,IMR90|chr6:32142754-32142785,chr6,32142754,32142785,0,126381817
IMR90|chr6:159090750-159090831,chr6,159090750,159090831,IMR90|chr6:2841524-2841574,chr6,2841524,2841574,0,156249226
IMR90|chr6:159177557-159177593,chr6,159177557,159177593,IMR90|chr6:48037548-48037662,chr6,48037548,48037662,0,111140009
IMR90|chr6:159594158-159594187,chr6,159594158,159594187,IMR90|chr6:1389253-1389374,chr6,1389253,1389374,0,158204905
IMR90|chr6:160201926-160201973,chr6,160201926,160201973,IMR90|chr6:153324115-153324190,chr6,153324115,153324190,0,6877811
IMR90|chr6:160789357-160789379,chr6,160789357,160789379,IMR90|chr6:48037541-48037662,chr6,48037541,48037662,0,112751816
IMR90|chr6:160902889-160902915,chr6,160902889,160902915,IMR90|chr6:147525419-147525513,chr6,147525419,147525513,0,13377470
IMR90|chr6:161458006-161458046,chr6,161458006,161458046,IMR90|chr6:42185340-42185490,chr6,42185340,42185490,0,119272666
IMR90|chr6:161507919-161508047,chr6,161507919,161508047,IMR90|chr6:42847887-42847946,chr6,42847887,42847946,0,118660032
IMR90|chr6:161565765-161565829,chr6,161565765,161565829,IMR90|chr6:31589809-31589879,chr6,31589809,31589879,0,129975956
IMR90|chr6:162471945-162471988,chr6,162471945,162471988,IMR90|chr6:109774215-109774286,chr6,109774215,109774286,0,52697730
IMR90|chr6:162488310-162488350,chr6,162488310,162488350,IMR90|chr6:42185340-42185490,chr6,42185340,42185490,0,120302970
IMR90|chr6:163158902-163158971,chr6,163158902,163158971,IMR90|chr6:692682-692766,chr6,692682,692766,0,162466220
IMR90|chr6:163399123-163399207,chr6,163399123,163399207,IMR90|chr6:16130736-16130758,chr6,16130736,16130758,0,147268387
IMR90|chr6:164054003-164054041,chr6,164054003,164054041,IMR90|chr6:43485728-43485875,chr6,43485728,43485875,0,120568275
IMR90|chr6:164343019-164343096,chr6,164343019,164343096,IMR90|chr6:2841501-2841574,chr6,2841501,2841574,0,161501518
IMR90|chr6:165401775-165401851,chr6,165401775,165401851,IMR90|chr6:149867637-149867684,chr6,149867637,149867684,0,15534138
IMR90|chr6:165794969-165795045,chr6,165794969,165795045,IMR90|chr6:2971009-2971034,chr6,2971009,2971034,0,162823960
IMR90|chr6:165864591-165864635,chr6,165864591,165864635,IMR90|chr6:86155715-86155821,chr6,86155715,86155821,0,79708876
IMR90|chr6:166295331-166295382,chr6,166295331,166295382,IMR90|chr6:3159143-3159241,chr6,3159143,3159241,0,163136188
IMR90|chr6:166368988-166369100,chr6,166368988,166369100,IMR90|chr6:3161373-3161412,chr6,3161373,3161412,0,163207615
IMR90|chr6:166646535-166646579,chr6,166646535,166646579,IMR90|chr6:133137162-133137224,chr6,133137162,133137224,0,33509373
IMR90|chr6:167373165-167373249,chr6,167373165,167373249,IMR90|chr6:16130736-16130758,chr6,16130736,16130758,0,151242429
IMR90|chr6:167901051-167901159,chr6,167901051,167901159,IMR90|chr6:133136957-133136999,chr6,133136957,133136999,0,34764094
IMR90|chr6:168348155-168348214,chr6,168348155,168348214,IMR90|chr6:127841638-127841713,chr6,127841638,127841713,0,40506517
IMR90|chr6:169895330-169895395,chr6,169895330,169895395,IMR90|chr6:42927776-42927828,chr6,42927776,42927828,0,126967554
IMR90|chr6:170250988-170251026,chr6,170250988,170251026,IMR90|chr6:43485728-43485875,chr6,43485728,43485875,0,126765260
IMR90|chr6:170378758-170378880,chr6,170378758,170378880,IMR90|chr6:42533397-42533473,chr6,42533397,42533473,0,127845361
IMR90|chr6:170495518-170495542,chr6,170495518,170495542,IMR90|chr6:48037541-48037662,chr6,48037541,48037662,0,122457977
IMR90|chr6:170524368-170524402,chr6,170524368,170524402,IMR90|chr6:52439733-52439796,chr6,52439733,52439796,0,118084635
IMR90|chr6:170601784-170601820,chr6,170601784,170601820,IMR90|chr6:48041001-48041063,chr6,48041001,48041063,0,122560783
IMR90|chr6:170931077-170931185,chr6,170931077,170931185,IMR90|chr6:48037598-48037662,chr6,48037598,48037662,0,122893479
IMR90|chr7:6428-6494,chr7,6428,6494,IMR90|chr7:6774136-6774214,chr7,6774136,6774214,0,6767708
IMR90|chr7:414122-414172,chr7,414122,414172,IMR90|chr7:102252202-102252259,chr7,102252202,102252259,0,101838080
IMR90|chr7:470625-470677,chr7,470625,470677,IMR90|chr7:24796174-24796251,chr7,24796174,24796251,0,24325549
IMR90|chr7:624800-624829,chr7,624800,624829,IMR90|chr7:72821054-72821200,chr7,72821054,72821200,0,72196254
IMR90|chr7:643877-644027,chr7,643877,644027,IMR90|chr7:64364487-64364622,chr7,64364487,64364622,0,63720610
IMR90|chr7:931994-932020,chr7,931994,932020,IMR90|chr7:92219052-92219151,chr7,92219052,92219151,0,91287058
IMR90|chr7:1033244-1033389,chr7,1033244,1033389,IMR90|chr7:56121549-56121594,chr7,56121549,56121594,0,55088305
IMR90|chr7:1667942-1667999,chr7,1667942,1667999,IMR90|chr7:93630132-93630282,chr7,93630132,93630282,0,91962190
IMR90|chr7:1716748-1716784,chr7,1716748,1716784,IMR90|chr7:100466797-100466931,chr7,100466797,100466931,0,98750049
IMR90|chr7:2335189-2335279,chr7,2335189,2335279,IMR90|chr7:148937439-148937499,chr7,148937439,148937499,0,146602250
IMR90|chr7:2745447-2745515,chr7,2745447,2745515,IMR90|chr7:157131126-157131197,chr7,157131126,157131197,0,154385679
IMR90|chr7:3339246-3339295,chr7,3339246,3339295,IMR90|chr7:92219056-92219153,chr7,92219056,92219153,0,88879810
IMR90|chr7:3404339-3404489,chr7,3404339,3404489,IMR90|chr7:74491079-74491226,chr7,74491079,74491226,0,71086740
IMR90|chr7:3420836-3420879,chr7,3420836,3420879,IMR90|chr7:44837868-44837896,chr7,44837868,44837896,0,41417032
IMR90|chr7:3950694-3950743,chr7,3950694,3950743,IMR90|chr7:192590-192659,chr7,192590,192659,0,3758104
IMR90|chr7:4312464-4312485,chr7,4312464,4312485,IMR90|chr7:156687411-156687494,chr7,156687411,156687494,0,152374947
IMR90|chr7:4363860-4363896,chr7,4363860,4363896,IMR90|chr7:195985-196063,chr7,195985,196063,0,4167875
IMR90|chr7:4485595-4485644,chr7,4485595,4485644,IMR90|chr7:102252136-102252260,chr7,102252136,102252260,0,97766541
IMR90|chr7:4583650-4583733,chr7,4583650,4583733,IMR90|chr7:100181367-100181462,chr7,100181367,100181462,0,95597717
IMR90|chr7:4849323-4849423,chr7,4849323,4849423,IMR90|chr7:137535416-137535441,chr7,137535416,137535441,0,132686093
IMR90|chr7:5119616-5119744,chr7,5119616,5119744,IMR90|chr7:120965322-120965355,chr7,120965322,120965355,0,115845706
IMR90|chr7:5176816-5176885,chr7,5176816,5176885,IMR90|chr7:94025358-94025382,chr7,94025358,94025382,0,88848542
IMR90|chr7:5583853-5583990,chr7,5583853,5583990,IMR90|chr7:94025050-94025121,chr7,94025050,94025121,0,88441197
IMR90|chr7:5889191-5889223,chr7,5889191,5889223,IMR90|chr7:104649817-104649967,chr7,104649817,104649967,0,98760626
IMR90|chr7:6200217-6200248,chr7,6200217,6200248,IMR90|chr7:90224759-90224870,chr7,90224759,90224870,0,84024542
IMR90|chr7:6226910-6226937,chr7,6226910,6226937,IMR90|chr7:149413630-149413686,chr7,149413630,149413686,0,143186720
IMR90|chr7:6640748-6640810,chr7,6640748,6640810,IMR90|chr7:192709-192805,chr7,192709,192805,0,6448039
IMR90|chr7:6699049-6699093,chr7,6699049,6699093,IMR90|chr7:97914670-97914771,chr7,97914670,97914771,0,91215621
IMR90|chr7:6911306-6911395,chr7,6911306,6911395,IMR90|chr7:130795596-130795644,chr7,130795596,130795644,0,123884290
IMR90|chr7:7049680-7049763,chr7,7049680,7049763,IMR90|chr7:137683702-137683768,chr7,137683702,137683768,0,130634022
IMR90|chr7:7206907-7206922,chr7,7206907,7206922,IMR90|chr7:98972915-98972996,chr7,98972915,98972996,0,91766008
IMR90|chr7:7272179-7272247,chr7,7272179,7272247,IMR90|chr7:157131126-157131197,chr7,157131126,157131197,0,149858947
IMR90|chr7:7561367-7561424,chr7,7561367,7561424,IMR90|chr7:100773128-100773169,chr7,100773128,100773169,0,93211761
IMR90|chr7:7617580-7617682,chr7,7617580,7617682,IMR90|chr7:100773127-100773157,chr7,100773127,100773157,0,93155547
IMR90|chr7:7709632-7709673,chr7,7709632,7709673,IMR90|chr7:100771385-100771476,chr7,100771385,100771476,0,93061753
IMR90|chr7:7801002-7801023,chr7,7801002,7801023,IMR90|chr7:100772819-100772879,chr7,100772819,100772879,0,92971817
IMR90|chr7:7944570-7944611,chr7,7944570,7944611,IMR90|chr7:140399531-140399587,chr7,140399531,140399587,0,132454961
IMR90|chr7:7980349-7980454,chr7,7980349,7980454,IMR90|chr7:100074444-100074467,chr7,100074444,100074467,0,92094095
IMR90|chr7:8043117-8043174,chr7,8043117,8043174,IMR90|chr7:116165879-116165912,chr7,116165879,116165912,0,108122762
IMR90|chr7:8115388-8115460,chr7,8115388,8115460,IMR90|chr7:65956840-65956949,chr7,65956840,65956949,0,57841452
IMR90|chr7:8395084-8395133,chr7,8395084,8395133,IMR90|chr7:23531640-23531683,chr7,23531640,23531683,0,15136556
IMR90|chr7:8763110-8763198,chr7,8763110,8763198,IMR90|chr7:2673292-2673350,chr7,2673292,2673350,0,6089818
IMR90|chr7:8824641-8824730,chr7,8824641,8824730,IMR90|chr7:137684173-137684260,chr7,137684173,137684260,0,128859532
IMR90|chr7:9021583-9021657,chr7,9021583,9021657,IMR90|chr7:158496424-158496487,chr7,158496424,158496487,0,149474841
IMR90|chr7:9093691-9093749,chr7,9093691,9093749,IMR90|chr7:102252179-102252260,chr7,102252179,102252260,0,93158488
IMR90|chr7:9204882-9204915,chr7,9204882,9204915,IMR90|chr7:73153921-73154035,chr7,73153921,73154035,0,63949039
IMR90|chr7:9777186-9777231,chr7,9777186,9777231,IMR90|chr7:100773024-100773129,chr7,100773024,100773129,0,90995838
IMR90|chr7:9988146-9988253,chr7,9988146,9988253,IMR90|chr7:100771995-100772069,chr7,100771995,100772069,0,90783849
IMR90|chr7:10002282-10002327,chr7,10002282,10002327,IMR90|chr7:150077581-150077630,chr7,150077581,150077630,0,140075299
IMR90|chr7:10111357-10111392,chr7,10111357,10111392,IMR90|chr7:100771558-100771610,chr7,100771558,100771610,0,90660201
IMR90|chr7:10335903-10335989,chr7,10335903,10335989,IMR90|chr7:104650826-104650870,chr7,104650826,104650870,0,94314923
IMR90|chr7:10455043-10455092,chr7,10455043,10455092,IMR90|chr7:100181367-100181462,chr7,100181367,100181462,0,89726324
IMR90|chr7:10613434-10613461,chr7,10613434,10613461,IMR90|chr7:100772082-100772197,chr7,100772082,100772197,0,90158648
IMR90|chr7:10860707-10860762,chr7,10860707,10860762,IMR90|chr7:143080627-143080719,chr7,143080627,143080719,0,132219920
IMR90|chr7:10956672-10956718,chr7,10956672,10956718,IMR90|chr7:97906359-97906459,chr7,97906359,97906459,0,86949687
IMR90|chr7:11107709-11107814,chr7,11107709,11107814,IMR90|chr7:100074444-100074467,chr7,100074444,100074467,0,88966735
IMR90|chr7:12144028-12144083,chr7,12144028,12144083,IMR90|chr7:100728969-100729054,chr7,100728969,100729054,0,88584941
IMR90|chr7:12172054-12172081,chr7,12172054,12172081,IMR90|chr7:65956454-65956529,chr7,65956454,65956529,0,53784400
IMR90|chr7:12352352-12352419,chr7,12352352,12352419,IMR90|chr7:55432042-55432103,chr7,55432042,55432103,0,43079690
IMR90|chr7:12360696-12360752,chr7,12360696,12360752,IMR90|chr7:100771132-100771219,chr7,100771132,100771219,0,88410436
IMR90|chr7:12586057-12586117,chr7,12586057,12586117,IMR90|chr7:6681749-6681828,chr7,6681749,6681828,0,5904308
IMR90|chr7:12629807-12629913,chr7,12629807,12629913,IMR90|chr7:100074444-100074467,chr7,100074444,100074467,0,87444637
IMR90|chr7:12693341-12693443,chr7,12693341,12693443,IMR90|chr7:75986804-75986823,chr7,75986804,75986823,0,63293463
IMR90|chr7:12720403-12720424,chr7,12720403,12720424,IMR90|chr7:135193550-135193680,chr7,135193550,135193680,0,122473147
IMR90|chr7:13544175-13544211,chr7,13544175,13544211,IMR90|chr7:100466797-100466931,chr7,100466797,100466931,0,86922622
IMR90|chr7:13637873-13637944,chr7,13637873,13637944,IMR90|chr7:99519436-99519490,chr7,99519436,99519490,0,85881563
IMR90|chr7:13740624-13740689,chr7,13740624,13740689,IMR90|chr7:156687411-156687494,chr7,156687411,156687494,0,142946787
IMR90|chr7:13807292-13807418,chr7,13807292,13807418,IMR90|chr7:100772615-100772714,chr7,100772615,100772714,0,86965323
IMR90|chr7:14088898-14088935,chr7,14088898,14088935,IMR90|chr7:100772201-100772281,chr7,100772201,100772281,0,86683303
IMR90|chr7:14213249-14213301,chr7,14213249,14213301,IMR90|chr7:100728969-100729054,chr7,100728969,100729054,0,86515720
IMR90|chr7:14305926-14306060,chr7,14305926,14306060,IMR90|chr7:75931178-75931277,chr7,75931178,75931277,0,61625252
IMR90|chr7:14325727-14325814,chr7,14325727,14325814,IMR90|chr7:55088271-55088299,chr7,55088271,55088299,0,40762544
IMR90|chr7:14614415-14614549,chr7,14614415,14614549,IMR90|chr7:75931178-75931277,chr7,75931178,75931277,0,61316763
IMR90|chr7:14692871-14692961,chr7,14692871,14692961,IMR90|chr7:75114379-75114439,chr7,75114379,75114439,0,60421508
IMR90|chr7:14701377-14701437,chr7,14701377,14701437,IMR90|chr7:149194039-149194121,chr7,149194039,149194121,0,134492662
IMR90|chr7:15282228-15282304,chr7,15282228,15282304,IMR90|chr7:75155456-75155521,chr7,75155456,75155521,0,59873228
IMR90|chr7:15305151-15305301,chr7,15305151,15305301,IMR90|chr7:129590865-129590900,chr7,129590865,129590900,0,114285714
IMR90|chr7:15319906-15319938,chr7,15319906,15319938,IMR90|chr7:100773025-100773129,chr7,100773025,100773129,0,85453119
IMR90|chr7:15454730-15454772,chr7,15454730,15454772,IMR90|chr7:100771385-100771476,chr7,100771385,100771476,0,85316655
IMR90|chr7:15455520-15455595,chr7,15455520,15455595,IMR90|chr7:111845698-111845802,chr7,111845698,111845802,0,96390178
IMR90|chr7:15634327-15634369,chr7,15634327,15634369,IMR90|chr7:104653476-104653549,chr7,104653476,104653549,0,89019149
IMR90|chr7:15877740-15877765,chr7,15877740,15877765,IMR90|chr7:77167112-77167262,chr7,77167112,77167262,0,61289372
IMR90|chr7:15979309-15979391,chr7,15979309,15979391,IMR90|chr7:100771055-100771123,chr7,100771055,100771123,0,84791746
IMR90|chr7:16015386-16015419,chr7,16015386,16015419,IMR90|chr7:100427061-100427125,chr7,100427061,100427125,0,84411675
IMR90|chr7:16037945-16037966,chr7,16037945,16037966,IMR90|chr7:97885518-97885622,chr7,97885518,97885622,0,81847573
IMR90|chr7:16054278-16054309,chr7,16054278,16054309,IMR90|chr7:100771423-100771536,chr7,100771423,100771536,0,84717145
IMR90|chr7:16242061-16242133,chr7,16242061,16242133,IMR90|chr7:94024772-94024848,chr7,94024772,94024848,0,77782711
IMR90|chr7:16286236-16286338,chr7,16286236,16286338,IMR90|chr7:75986804-75986823,chr7,75986804,75986823,0,59700568
IMR90|chr7:16557679-16557756,chr7,16557679,16557756,IMR90|chr7:120968644-120968717,chr7,120968644,120968717,0,104410965
IMR90|chr7:16840965-16841016,chr7,16840965,16841016,IMR90|chr7:135195067-135195163,chr7,135195067,135195163,0,118354102
IMR90|chr7:16893723-16893779,chr7,16893723,16893779,IMR90|chr7:5636144-5636227,chr7,5636144,5636227,0,11257579
IMR90|chr7:17112146-17112238,chr7,17112146,17112238,IMR90|chr7:66206388-66206446,chr7,66206388,66206446,0,49094242
IMR90|chr7:17186322-17186379,chr7,17186322,17186379,IMR90|chr7:75550362-75550435,chr7,75550362,75550435,0,58364040
IMR90|chr7:17212914-17212957,chr7,17212914,17212957,IMR90|chr7:99931286-99931351,chr7,99931286,99931351,0,82718372
IMR90|chr7:17563518-17563563,chr7,17563518,17563563,IMR90|chr7:41740807-41740908,chr7,41740807,41740908,0,24177289
IMR90|chr7:17628619-17628711,chr7,17628619,17628711,IMR90|chr7:97911863-97911912,chr7,97911863,97911912,0,80283244
IMR90|chr7:17711279-17711303,chr7,17711279,17711303,IMR90|chr7:116168858-116168955,chr7,116168858,116168955,0,98457579
IMR90|chr7:17797349-17797424,chr7,17797349,17797424,IMR90|chr7:135341415-135341435,chr7,135341415,135341435,0,117544066
IMR90|chr7:17952707-17952771,chr7,17952707,17952771,IMR90|chr7:74491151-74491233,chr7,74491151,74491233,0,56538444
IMR90|chr7:18131460-18131518,chr7,18131460,18131518,IMR90|chr7:100773128-100773169,chr7,100773128,100773169,0,82641668
IMR90|chr7:18401024-18401099,chr7,18401024,18401099,IMR90|chr7:135341415-135341435,chr7,135341415,135341435,0,116940391
IMR90|chr7:18497374-18497428,chr7,18497374,18497428,IMR90|chr7:100772488-100772571,chr7,100772488,100772571,0,82275114
IMR90|chr7:18681632-18681713,chr7,18681632,18681713,IMR90|chr7:42274896-42274935,chr7,42274896,42274935,0,23593264
IMR90|chr7:18684472-18684566,chr7,18684472,18684566,IMR90|chr7:129708683-129708763,chr7,129708683,129708763,0,111024211
IMR90|chr7:18769975-18770044,chr7,18769975,18770044,IMR90|chr7:100770981-100771062,chr7,100770981,100771062,0,82001006
IMR90|chr7:19123284-19123414,chr7,19123284,19123414,IMR90|chr7:98739825-98739878,chr7,98739825,98739878,0,79616541
IMR90|chr7:19500111-19500215,chr7,19500111,19500215,IMR90|chr7:140339371-140339411,chr7,140339371,140339411,0,120839260
IMR90|chr7:19633567-19633658,chr7,19633567,19633658,IMR90|chr7:104651179-104651227,chr7,104651179,104651227,0,85017612
IMR90|chr7:19710215-19710266,chr7,19710215,19710266,IMR90|chr7:94024776-94024875,chr7,94024776,94024875,0,74314561
IMR90|chr7:19977427-19977476,chr7,19977427,19977476,IMR90|chr7:102252120-102252260,chr7,102252120,102252260,0,82274693
IMR90|chr7:20047454-20047498,chr7,20047454,20047498,IMR90|chr7:128504146-128504199,chr7,128504146,128504199,0,108456692
IMR90|chr7:20296355-20296465,chr7,20296355,20296465,IMR90|chr7:97598352-97598376,chr7,97598352,97598376,0,77301997
IMR90|chr7:20416509-20416569,chr7,20416509,20416569,IMR90|chr7:192582-192675,chr7,192582,192675,0,20223927
IMR90|chr7:20620074-20620163,chr7,20620074,20620163,IMR90|chr7:148937439-148937499,chr7,148937439,148937499,0,128317365
IMR90|chr7:20623875-20623977,chr7,20623875,20623977,IMR90|chr7:134467016-134467051,chr7,134467016,134467051,0,113843141
IMR90|chr7:20999546-20999649,chr7,20999546,20999649,IMR90|chr7:75114379-75114439,chr7,75114379,75114439,0,54114833
IMR90|chr7:21031636-21031725,chr7,21031636,21031725,IMR90|chr7:148937439-148937499,chr7,148937439,148937499,0,127905803
IMR90|chr7:21384908-21384976,chr7,21384908,21384976,IMR90|chr7:120968643-120968717,chr7,120968643,120968717,0,99583735
IMR90|chr7:21563259-21563369,chr7,21563259,21563369,IMR90|chr7:100857709-100857730,chr7,100857709,100857730,0,79294450
IMR90|chr7:21588463-21588523,chr7,21588463,21588523,IMR90|chr7:97596955-97597030,chr7,97596955,97597030,0,76008492
IMR90|chr7:21597767-21597792,chr7,21597767,21597792,IMR90|chr7:131012237-131012326,chr7,131012237,131012326,0,109414470
IMR90|chr7:21639483-21639549,chr7,21639483,21639549,IMR90|chr7:100771015-100771073,chr7,100771015,100771073,0,79131532
IMR90|chr7:21687183-21687239,chr7,21687183,21687239,IMR90|chr7:120965198-120965240,chr7,120965198,120965240,0,99278015
IMR90|chr7:22413621-22413648,chr7,22413621,22413648,IMR90|chr7:100770931-100771027,chr7,100770931,100771027,0,78357310
IMR90|chr7:23026066-23026124,chr7,23026066,23026124,IMR90|chr7:56132295-56132368,chr7,56132295,56132368,0,33106229
IMR90|chr7:23157675-23157727,chr7,23157675,23157727,IMR90|chr7:97915386-97915511,chr7,97915386,97915511,0,74757711
IMR90|chr7:23544878-23544917,chr7,23544878,23544917,IMR90|chr7:157130897-157130973,chr7,157130897,157130973,0,133586019
IMR90|chr7:23664907-23664981,chr7,23664907,23664981,IMR90|chr7:158496424-158496487,chr7,158496424,158496487,0,134831517
IMR90|chr7:23688950-23689010,chr7,23688950,23689010,IMR90|chr7:149194039-149194121,chr7,149194039,149194121,0,125505089
IMR90|chr7:23855221-23855371,chr7,23855221,23855371,IMR90|chr7:130134298-130134349,chr7,130134298,130134349,0,106279077
IMR90|chr7:24121384-24121409,chr7,24121384,24121409,IMR90|chr7:77167112-77167262,chr7,77167112,77167262,0,53045728
IMR90|chr7:24325149-24325213,chr7,24325149,24325213,IMR90|chr7:79081996-79082074,chr7,79081996,79082074,0,54756847
IMR90|chr7:24729576-24729607,chr7,24729576,24729607,IMR90|chr7:73866010-73866079,chr7,73866010,73866079,0,49136434
IMR90|chr7:24820302-24820359,chr7,24820302,24820359,IMR90|chr7:192582-192675,chr7,192582,192675,0,24627720
IMR90|chr7:25054107-25054161,chr7,25054107,25054161,IMR90|chr7:100798361-100798414,chr7,100798361,100798414,0,75744254
IMR90|chr7:25056752-25056794,chr7,25056752,25056794,IMR90|chr7:115849670-115849778,chr7,115849670,115849778,0,90792918
IMR90|chr7:25191909-25191963,chr7,25191909,25191963,IMR90|chr7:100074675-100074750,chr7,100074675,100074750,0,74882766
IMR90|chr7:25267817-25267912,chr7,25267817,25267912,IMR90|chr7:41738875-41738930,chr7,41738875,41738930,0,16471058
IMR90|chr7:25661929-25662028,chr7,25661929,25662028,IMR90|chr7:130134298-130134349,chr7,130134298,130134349,0,104472369
IMR90|chr7:25752178-25752252,chr7,25752178,25752252,IMR90|chr7:135341415-135341435,chr7,135341415,135341435,0,109589237
IMR90|chr7:25893408-25893453,chr7,25893408,25893453,IMR90|chr7:74067704-74067773,chr7,74067704,74067773,0,48174296
IMR90|chr7:25938084-25938168,chr7,25938084,25938168,IMR90|chr7:1573947-1573969,chr7,1573947,1573969,0,24364137
IMR90|chr7:26038453-26038603,chr7,26038453,26038603,IMR90|chr7:129588762-129588808,chr7,129588762,129588808,0,103550309
IMR90|chr7:26147330-26147402,chr7,26147330,26147402,IMR90|chr7:65956840-65956949,chr7,65956840,65956949,0,39809510
IMR90|chr7:26260850-26260898,chr7,26260850,26260898,IMR90|chr7:74491305-74491407,chr7,74491305,74491407,0,48230455
IMR90|chr7:26325097-26325151,chr7,26325097,26325151,IMR90|chr7:137532953-137533040,chr7,137532953,137533040,0,111207856
IMR90|chr7:26444054-26444111,chr7,26444054,26444111,IMR90|chr7:135341415-135341435,chr7,135341415,135341435,0,108897361
IMR90|chr7:26982070-26982163,chr7,26982070,26982163,IMR90|chr7:120962856-120962922,chr7,120962856,120962922,0,93980786
IMR90|chr7:27202699-27202735,chr7,27202699,27202735,IMR90|chr7:139523991-139524053,chr7,139523991,139524053,0,112321292
IMR90|chr7:27225665-27225718,chr7,27225665,27225718,IMR90|chr7:44084863-44084991,chr7,44084863,44084991,0,16859198
IMR90|chr7:27281444-27281561,chr7,27281444,27281561,IMR90|chr7:128375059-128375086,chr7,128375059,128375086,0,101093615
IMR90|chr7:27997475-27997512,chr7,27997475,27997512,IMR90|chr7:100772201-100772281,chr7,100772201,100772281,0,72774726
IMR90|chr7:28215729-28215827,chr7,28215729,28215827,IMR90|chr7:104652034-104652086,chr7,104652034,104652086,0,76436305
IMR90|chr7:28684941-28685091,chr7,28684941,28685091,IMR90|chr7:74491241-74491390,chr7,74491241,74491390,0,45806300
IMR90|chr7:28793172-28793239,chr7,28793172,28793239,IMR90|chr7:41737447-41737487,chr7,41737447,41737487,0,12944275
IMR90|chr7:29065177-29065216,chr7,29065177,29065216,IMR90|chr7:98740386-98740524,chr7,98740386,98740524,0,69675209
IMR90|chr7:29640292-29640373,chr7,29640292,29640373,IMR90|chr7:100773094-100773133,chr7,100773094,100773133,0,71132802
IMR90|chr7:30022738-30022809,chr7,30022738,30022809,IMR90|chr7:157131126-157131197,chr7,157131126,157131197,0,127108388
IMR90|chr7:30349465-30349582,chr7,30349465,30349582,IMR90|chr7:100770981-100771062,chr7,100770981,100771062,0,70421516
IMR90|chr7:30650306-30650355,chr7,30650306,30650355,IMR90|chr7:102252189-102252282,chr7,102252189,102252282,0,71601883
IMR90|chr7:30717517-30717571,chr7,30717517,30717571,IMR90|chr7:100771132-100771219,chr7,100771132,100771219,0,70053615
IMR90|chr7:30819636-30819691,chr7,30819636,30819691,IMR90|chr7:111844011-111844101,chr7,111844011,111844101,0,81024375
IMR90|chr7:30862102-30862135,chr7,30862102,30862135,IMR90|chr7:75986805-75986823,chr7,75986805,75986823,0,45124703
IMR90|chr7:30996653-30996711,chr7,30996653,30996711,IMR90|chr7:65956497-65956617,chr7,65956497,65956617,0,34959844
IMR90|chr7:31039128-31039185,chr7,31039128,31039185,IMR90|chr7:75550362-75550435,chr7,75550362,75550435,0,44511234
IMR90|chr7:31100645-31100790,chr7,31100645,31100790,IMR90|chr7:75510126-75510149,chr7,75510126,75510149,0,44409481
IMR90|chr7:31312772-31312916,chr7,31312772,31312916,IMR90|chr7:74491069-74491219,chr7,74491069,74491219,0,43178297
IMR90|chr7:31503511-31503556,chr7,31503511,31503556,IMR90|chr7:120960735-120960814,chr7,120960735,120960814,0,89457224
IMR90|chr7:32205192-32205226,chr7,32205192,32205226,IMR90|chr7:100074675-100074750,chr7,100074675,100074750,0,67869483
IMR90|chr7:32307461-32307604,chr7,32307461,32307604,IMR90|chr7:56121549-56121594,chr7,56121549,56121594,0,23814088
IMR90|chr7:32568180-32568250,chr7,32568180,32568250,IMR90|chr7:111844817-111844855,chr7,111844817,111844855,0,79276637
IMR90|chr7:33431605-33431659,chr7,33431605,33431659,IMR90|chr7:137535909-137536005,chr7,137535909,137536005,0,104104304
IMR90|chr7:33635383-33635456,chr7,33635383,33635456,IMR90|chr7:137533649-137533726,chr7,137533649,137533726,0,103898266
IMR90|chr7:33773844-33773870,chr7,33773844,33773870,IMR90|chr7:92219052-92219151,chr7,92219052,92219151,0,58445208
IMR90|chr7:33916098-33916188,chr7,33916098,33916188,IMR90|chr7:75986805-75986823,chr7,75986805,75986823,0,42070707
IMR90|chr7:33998846-33998935,chr7,33998846,33998935,IMR90|chr7:130795596-130795644,chr7,130795596,130795644,0,96796750
IMR90|chr7:34088359-34088451,chr7,34088359,34088451,IMR90|chr7:97911863-97911912,chr7,97911863,97911912,0,63823504
IMR90|chr7:34347780-34347836,chr7,34347780,34347836,IMR90|chr7:100771132-100771219,chr7,100771132,100771219,0,66423352
IMR90|chr7:34462429-34462471,chr7,34462429,34462471,IMR90|chr7:56120233-56120350,chr7,56120233,56120350,0,21657804
IMR90|chr7:34875221-34875260,chr7,34875221,34875260,IMR90|chr7:140339371-140339411,chr7,140339371,140339411,0,105464150
IMR90|chr7:34974932-34974959,chr7,34974932,34974959,IMR90|chr7:100771554-100771648,chr7,100771554,100771648,0,65796622
IMR90|chr7:35020159-35020219,chr7,35020159,35020219,IMR90|chr7:97596955-97597030,chr7,97596955,97597030,0,62576796
IMR90|chr7:35509441-35509493,chr7,35509441,35509493,IMR90|chr7:26244816-26244893,chr7,26244816,26244893,0,9264625
IMR90|chr7:35556077-35556100,chr7,35556077,35556100,IMR90|chr7:23508398-23508487,chr7,23508398,23508487,0,12047679
IMR90|chr7:35609332-35609369,chr7,35609332,35609369,IMR90|chr7:195985-196063,chr7,195985,196063,0,35413347
IMR90|chr7:35815245-35815395,chr7,35815245,35815395,IMR90|chr7:26237870-26237887,chr7,26237870,26237887,0,9577375
IMR90|chr7:36171681-36171745,chr7,36171681,36171745,IMR90|chr7:5185581-5185609,chr7,5185581,5185609,0,30986100
IMR90|chr7:36222955-36223063,chr7,36222955,36223063,IMR90|chr7:44615859-44615885,chr7,44615859,44615885,0,8392904
IMR90|chr7:36243597-36243650,chr7,36243597,36243650,IMR90|chr7:137535909-137536005,chr7,137535909,137536005,0,101292312
IMR90|chr7:36544826-36544938,chr7,36544826,36544938,IMR90|chr7:94025358-94025382,chr7,94025358,94025382,0,57480532
IMR90|chr7:36620411-36620493,chr7,36620411,36620493,IMR90|chr7:104655533-104655612,chr7,104655533,104655612,0,68035122
IMR90|chr7:37241607-37241629,chr7,37241607,37241629,IMR90|chr7:26245486-26245551,chr7,26245486,26245551,0,10996121
IMR90|chr7:37502432-37502503,chr7,37502432,37502503,IMR90|chr7:100771007-100771085,chr7,100771007,100771085,0,63268575
IMR90|chr7:37901136-37901263,chr7,37901136,37901263,IMR90|chr7:140339438-140339477,chr7,140339438,140339477,0,102438302
IMR90|chr7:37993671-37993731,chr7,37993671,37993731,IMR90|chr7:72819514-72819565,chr7,72819514,72819565,0,34825843
IMR90|chr7:38833538-38833587,chr7,38833538,38833587,IMR90|chr7:149413587-149413632,chr7,149413587,149413632,0,110580049
IMR90|chr7:38878792-38878835,chr7,38878792,38878835,IMR90|chr7:44086828-44086885,chr7,44086828,44086885,0,5208036
IMR90|chr7:39021828-39021888,chr7,39021828,39021888,IMR90|chr7:6681749-6681828,chr7,6681749,6681828,0,32340079
IMR90|chr7:39179307-39179358,chr7,39179307,39179358,IMR90|chr7:97915386-97915511,chr7,97915386,97915511,0,58736079
IMR90|chr7:39224083-39224185,chr7,39224083,39224185,IMR90|chr7:56121549-56121594,chr7,56121549,56121594,0,16897466
IMR90|chr7:39734858-39734969,chr7,39734858,39734969,IMR90|chr7:143082006-143082023,chr7,143082006,143082023,0,103347148
IMR90|chr7:39842567-39842625,chr7,39842567,39842625,IMR90|chr7:137533649-137533726,chr7,137533649,137533726,0,97691082
IMR90|chr7:39900482-39900535,chr7,39900482,39900535,IMR90|chr7:137532953-137533040,chr7,137532953,137533040,0,97632471
IMR90|chr7:40069380-40069460,chr7,40069380,40069460,IMR90|chr7:130794996-130795049,chr7,130794996,130795049,0,90725616
IMR90|chr7:40193321-40193363,chr7,40193321,40193363,IMR90|chr7:104653476-104653549,chr7,104653476,104653549,0,64460155
IMR90|chr7:40395292-40395348,chr7,40395292,40395348,IMR90|chr7:120965198-120965240,chr7,120965198,120965240,0,80569906
IMR90|chr7:40746103-40746126,chr7,40746103,40746126,IMR90|chr7:87847549-87847648,chr7,87847549,87847648,0,47101446
IMR90|chr7:40762768-40762855,chr7,40762768,40762855,IMR90|chr7:55088271-55088299,chr7,55088271,55088299,0,14325503
IMR90|chr7:41057038-41057106,chr7,41057038,41057106,IMR90|chr7:128379977-128380019,chr7,128379977,128380019,0,87322939
IMR90|chr7:41429558-41429708,chr7,41429558,41429708,IMR90|chr7:100770799-100770855,chr7,100770799,100770855,0,59341241
IMR90|chr7:41472835-41472919,chr7,41472835,41472919,IMR90|chr7:137683702-137683768,chr7,137683702,137683768,0,96210867
IMR90|chr7:41478145-41478274,chr7,41478145,41478274,IMR90|chr7:143081665-143081686,chr7,143081665,143081686,0,101603520
IMR90|chr7:41638105-41638193,chr7,41638105,41638193,IMR90|chr7:100799676-100799705,chr7,100799676,100799705,0,59161571
IMR90|chr7:41918081-41918146,chr7,41918081,41918146,IMR90|chr7:65580897-65580944,chr7,65580897,65580944,0,23662816
IMR90|chr7:41925333-41925385,chr7,41925333,41925385,IMR90|chr7:100728969-100729054,chr7,100728969,100729054,0,58803636
IMR90|chr7:42140171-42140225,chr7,42140171,42140225,IMR90|chr7:100771132-100771219,chr7,100771132,100771219,0,58630961
IMR90|chr7:42166935-42166978,chr7,42166935,42166978,IMR90|chr7:115849670-115849778,chr7,115849670,115849778,0,73682735
IMR90|chr7:42401814-42401835,chr7,42401814,42401835,IMR90|chr7:100772819-100772879,chr7,100772819,100772879,0,58371005
IMR90|chr7:42973303-42973359,chr7,42973303,42973359,IMR90|chr7:102252108-102252256,chr7,102252108,102252256,0,59278805
IMR90|chr7:43630345-43630495,chr7,43630345,43630495,IMR90|chr7:100770799-100770855,chr7,100770799,100770855,0,57140454
IMR90|chr7:44471853-44471893,chr7,44471853,44471893,IMR90|chr7:100074678-100074785,chr7,100074678,100074785,0,55602825
IMR90|chr7:44504892-44504983,chr7,44504892,44504983,IMR90|chr7:104651179-104651227,chr7,104651179,104651227,0,60146287
IMR90|chr7:44710014-44710051,chr7,44710014,44710051,IMR90|chr7:195985-196063,chr7,195985,196063,0,44514029
IMR90|chr7:44768805-44768866,chr7,44768805,44768866,IMR90|chr7:98740406-98740492,chr7,98740406,98740492,0,53971601
IMR90|chr7:44786550-44786598,chr7,44786550,44786598,IMR90|chr7:74491125-74491234,chr7,74491125,74491234,0,29704575
IMR90|chr7:44876136-44876203,chr7,44876136,44876203,IMR90|chr7:105518785-105518844,chr7,105518785,105518844,0,60642649
IMR90|chr7:44948128-44948177,chr7,44948128,44948177,IMR90|chr7:100773130-100773194,chr7,100773130,100773194,0,55825002
IMR90|chr7:44977125-44977177,chr7,44977125,44977177,IMR90|chr7:107642780-107642927,chr7,107642780,107642927,0,62665655
IMR90|chr7:44983928-44983973,chr7,44983928,44983973,IMR90|chr7:120963791-120963820,chr7,120963791,120963820,0,75979863
IMR90|chr7:45007087-45007172,chr7,45007087,45007172,IMR90|chr7:142986450-142986511,chr7,142986450,142986511,0,97979363
IMR90|chr7:45027567-45027631,chr7,45027567,45027631,IMR90|chr7:130794326-130794377,chr7,130794326,130794377,0,85766759
IMR90|chr7:45205006-45205059,chr7,45205006,45205059,IMR90|chr7:102252147-102252260,chr7,102252147,102252260,0,57047141
IMR90|chr7:45274198-45274226,chr7,45274198,45274226,IMR90|chr7:100466603-100466678,chr7,100466603,100466678,0,55192405
IMR90|chr7:45469175-45469245,chr7,45469175,45469245,IMR90|chr7:129708683-129708763,chr7,129708683,129708763,0,84239508
IMR90|chr7:45471655-45471720,chr7,45471655,45471720,IMR90|chr7:65580897-65580944,chr7,65580897,65580944,0,20109242
IMR90|chr7:45487228-45487260,chr7,45487228,45487260,IMR90|chr7:100771423-100771536,chr7,100771423,100771536,0,55284195
IMR90|chr7:45672865-45672914,chr7,45672865,45672914,IMR90|chr7:102252136-102252260,chr7,102252136,102252260,0,56579271
IMR90|chr7:46221824-46221862,chr7,46221824,46221862,IMR90|chr7:143081662-143081722,chr7,143081662,143081722,0,96859838
IMR90|chr7:46563573-46563639,chr7,46563573,46563639,IMR90|chr7:105518785-105518844,chr7,105518785,105518844,0,58955212
IMR90|chr7:46636251-46636297,chr7,46636251,46636297,IMR90|chr7:97906359-97906459,chr7,97906359,97906459,0,51270108
IMR90|chr7:46719331-46719377,chr7,46719331,46719377,IMR90|chr7:111845698-111845802,chr7,111845698,111845802,0,65126367
IMR90|chr7:46811356-46811402,chr7,46811356,46811402,IMR90|chr7:192590-192659,chr7,192590,192659,0,46618766
IMR90|chr7:46814153-46814303,chr7,46814153,46814303,IMR90|chr7:128375059-128375086,chr7,128375059,128375086,0,81560906
IMR90|chr7:46937423-46937462,chr7,46937423,46937462,IMR90|chr7:100772400-100772501,chr7,100772400,100772501,0,53834977
IMR90|chr7:47844600-47844725,chr7,47844600,47844725,IMR90|chr7:35841705-35841722,chr7,35841705,35841722,0,12002895
IMR90|chr7:47943022-47943076,chr7,47943022,47943076,IMR90|chr7:2668690-2668766,chr7,2668690,2668766,0,45274332
IMR90|chr7:47985667-47985728,chr7,47985667,47985728,IMR90|chr7:35841363-35841431,chr7,35841363,35841431,0,12144304
IMR90|chr7:48043670-48043750,chr7,48043670,48043750,IMR90|chr7:77426781-77426842,chr7,77426781,77426842,0,29383111
IMR90|chr7:48111612-48111633,chr7,48111612,48111633,IMR90|chr7:156687411-156687494,chr7,156687411,156687494,0,108575799
IMR90|chr7:48301748-48301782,chr7,48301748,48301782,IMR90|chr7:94026377-94026408,chr7,94026377,94026408,0,45724629
IMR90|chr7:48551655-48551697,chr7,48551655,48551697,IMR90|chr7:100771385-100771476,chr7,100771385,100771476,0,52219730
IMR90|chr7:48803499-48803574,chr7,48803499,48803574,IMR90|chr7:111845698-111845802,chr7,111845698,111845802,0,63042199
IMR90|chr7:48835696-48835743,chr7,48835696,48835743,IMR90|chr7:102252280-102252314,chr7,102252280,102252314,0,53416584
IMR90|chr7:48874989-48875009,chr7,48874989,48875009,IMR90|chr7:135193550-135193680,chr7,135193550,135193680,0,86318561
IMR90|chr7:49022338-49022363,chr7,49022338,49022363,IMR90|chr7:137684889-137685010,chr7,137684889,137685010,0,88662551
IMR90|chr7:49181873-49181927,chr7,49181873,49181927,IMR90|chr7:100798361-100798414,chr7,100798361,100798414,0,51616488
IMR90|chr7:49556735-49556846,chr7,49556735,49556846,IMR90|chr7:140339438-140339477,chr7,140339438,140339477,0,90782703
IMR90|chr7:49669772-49669861,chr7,49669772,49669861,IMR90|chr7:137684173-137684260,chr7,137684173,137684260,0,88014401
IMR90|chr7:49679870-49679928,chr7,49679870,49679928,IMR90|chr7:56132295-56132368,chr7,56132295,56132368,0,6452425
IMR90|chr7:49710295-49710382,chr7,49710295,49710382,IMR90|chr7:2673292-2673350,chr7,2673292,2673350,0,47037003
IMR90|chr7:49918923-49919033,chr7,49918923,49919033,IMR90|chr7:97598352-97598376,chr7,97598352,97598376,0,47679429
IMR90|chr7:49984148-49984172,chr7,49984148,49984172,IMR90|chr7:44837600-44837682,chr7,44837600,44837682,0,5146548
IMR90|chr7:50065890-50066019,chr7,50065890,50066019,IMR90|chr7:143081665-143081686,chr7,143081665,143081686,0,93015775
IMR90|chr7:50474890-50474948,chr7,50474890,50474948,IMR90|chr7:131012237-131012326,chr7,131012237,131012326,0,80537347
IMR90|chr7:50533753-50533838,chr7,50533753,50533838,IMR90|chr7:142986450-142986511,chr7,142986450,142986511,0,92452697
IMR90|chr7:50560936-50560973,chr7,50560936,50560973,IMR90|chr7:116169357-116169430,chr7,116169357,116169430,0,65608421
IMR90|chr7:50636937-50637070,chr7,50636937,50637070,IMR90|chr7:26237870-26237887,chr7,26237870,26237887,0,24399067
IMR90|chr7:50638664-50638750,chr7,50638664,50638750,IMR90|chr7:130127278-130127300,chr7,130127278,130127300,0,79488614
IMR90|chr7:50785782-50785870,chr7,50785782,50785870,IMR90|chr7:100799676-100799705,chr7,100799676,100799705,0,50013894
IMR90|chr7:51165214-51165283,chr7,51165214,51165283,IMR90|chr7:65956468-65956504,chr7,65956468,65956504,0,14791254
IMR90|chr7:51695694-51695728,chr7,51695694,51695728,IMR90|chr7:94026377-94026408,chr7,94026377,94026408,0,42330683
IMR90|chr7:51713431-51713455,chr7,51713431,51713455,IMR90|chr7:35841126-35841251,chr7,35841126,35841251,0,15872305
IMR90|chr7:51995013-51995093,chr7,51995013,51995093,IMR90|chr7:42274896-42274935,chr7,42274896,42274935,0,9720117
IMR90|chr7:52045176-52045217,chr7,52045176,52045217,IMR90|chr7:6774534-6774594,chr7,6774534,6774594,0,45270642
IMR90|chr7:52169420-52169482,chr7,52169420,52169482,IMR90|chr7:35841363-35841431,chr7,35841363,35841431,0,16328057
IMR90|chr7:52271218-52271318,chr7,52271218,52271318,IMR90|chr7:97911863-97911912,chr7,97911863,97911912,0,45640645
IMR90|chr7:52349497-52349561,chr7,52349497,52349561,IMR90|chr7:130794326-130794377,chr7,130794326,130794377,0,78444829
IMR90|chr7:52467774-52467818,chr7,52467774,52467818,IMR90|chr7:128504146-128504199,chr7,128504146,128504199,0,76036372
IMR90|chr7:52882005-52882087,chr7,52882005,52882087,IMR90|chr7:100728213-100728229,chr7,100728213,100728229,0,47846208
IMR90|chr7:53427245-53427376,chr7,53427245,53427376,IMR90|chr7:44837868-44837896,chr7,44837868,44837896,0,8589377
IMR90|chr7:53594661-53594715,chr7,53594661,53594715,IMR90|chr7:99062953-99062982,chr7,99062953,99062982,0,45468292
IMR90|chr7:53748933-53748964,chr7,53748933,53748964,IMR90|chr7:127230233-127230296,chr7,127230233,127230296,0,73481300
IMR90|chr7:54005028-54005170,chr7,54005028,54005170,IMR90|chr7:26238697-26238723,chr7,26238697,26238723,0,27766331
IMR90|chr7:54057372-54057424,chr7,54057372,54057424,IMR90|chr7:105517778-105517837,chr7,105517778,105517837,0,51460406
IMR90|chr7:54073746-54073784,chr7,54073746,54073784,IMR90|chr7:143081662-143081722,chr7,143081662,143081722,0,89007916
IMR90|chr7:54367889-54367936,chr7,54367889,54367936,IMR90|chr7:102252280-102252314,chr7,102252280,102252314,0,47884391
IMR90|chr7:54687795-54687817,chr7,54687795,54687817,IMR90|chr7:97915386-97915511,chr7,97915386,97915511,0,43227591
IMR90|chr7:54863789-54863843,chr7,54863789,54863843,IMR90|chr7:111844011-111844101,chr7,111844011,111844101,0,56980222
IMR90|chr7:54887338-54887398,chr7,54887338,54887398,IMR90|chr7:152130919-152131004,chr7,152130919,152131004,0,97243581
IMR90|chr7:54936129-54936172,chr7,54936129,54936172,IMR90|chr7:99931286-99931351,chr7,99931286,99931351,0,44995157
IMR90|chr7:54947948-54948027,chr7,54947948,54948027,IMR90|chr7:94025853-94025886,chr7,94025853,94025886,0,39077905
IMR90|chr7:55058092-55058154,chr7,55058092,55058154,IMR90|chr7:192709-192805,chr7,192709,192805,0,54865383
IMR90|chr7:55177669-55177711,chr7,55177669,55177711,IMR90|chr7:115849670-115849778,chr7,115849670,115849778,0,60672001
IMR90|chr7:55237654-55237716,chr7,55237654,55237716,IMR90|chr7:100770782-100770828,chr7,100770782,100770828,0,45533128
IMR90|chr7:55335381-55335475,chr7,55335381,55335475,IMR90|chr7:143082006-143082023,chr7,143082006,143082023,0,87746625
IMR90|chr7:55611168-55611224,chr7,55611168,55611224,IMR90|chr7:23532641-23532730,chr7,23532641,23532730,0,32078527
IMR90|chr7:56138825-56138975,chr7,56138825,56138975,IMR90|chr7:130134298-130134349,chr7,130134298,130134349,0,73995473
IMR90|chr7:56504760-56504786,chr7,56504760,56504786,IMR90|chr7:100771557-100771655,chr7,100771557,100771655,0,44266797
IMR90|chr7:56899615-56899678,chr7,56899615,56899678,IMR90|chr7:65580897-65580944,chr7,65580897,65580944,0,8681282
IMR90|chr7:57054442-57054480,chr7,57054442,57054480,IMR90|chr7:72820423-72820552,chr7,72820423,72820552,0,15765981
IMR90|chr7:57225295-57225371,chr7,57225295,57225371,IMR90|chr7:111845720-111845767,chr7,111845720,111845767,0,54620425
IMR90|chr7:57316478-57316531,chr7,57316478,57316531,IMR90|chr7:100772529-100772572,chr7,100772529,100772572,0,43456051
IMR90|chr7:57378121-57378146,chr7,57378121,57378146,IMR90|chr7:116168858-116168955,chr7,116168858,116168955,0,58790737
IMR90|chr7:57615994-57616137,chr7,57615994,57616137,IMR90|chr7:56121549-56121594,chr7,56121549,56121594,0,1494445
IMR90|chr7:57636894-57636932,chr7,57636894,57636932,IMR90|chr7:97880951-97881023,chr7,97880951,97881023,0,40244057
IMR90|chr7:57716301-57716381,chr7,57716301,57716381,IMR90|chr7:137533649-137533726,chr7,137533649,137533726,0,79817348
IMR90|chr7:57739710-57739774,chr7,57739710,57739774,IMR90|chr7:79081996-79082074,chr7,79081996,79082074,0,21342286
IMR90|chr7:57973497-57973569,chr7,57973497,57973569,IMR90|chr7:137686093-137686158,chr7,137686093,137686158,0,79712596
IMR90|chr7:58076239-58076300,chr7,58076239,58076300,IMR90|chr7:72819514-72819564,chr7,72819514,72819564,0,14743275
IMR90|chr7:58305469-58305533,chr7,58305469,58305533,IMR90|chr7:23571266-23571367,chr7,23571266,23571367,0,34734203
IMR90|chr7:58599484-58599511,chr7,58599484,58599511,IMR90|chr7:87847549-87847648,chr7,87847549,87847648,0,29248065
IMR90|chr7:58736189-58736247,chr7,58736189,58736247,IMR90|chr7:6681749-6681828,chr7,6681749,6681828,0,52054440
IMR90|chr7:58805340-58805472,chr7,58805340,58805472,IMR90|chr7:64364487-64364560,chr7,64364487,64364560,0,5559147
IMR90|chr7:59103755-59103781,chr7,59103755,59103781,IMR90|chr7:100771557-100771655,chr7,100771557,100771655,0,41667802
IMR90|chr7:59176987-59177070,chr7,59176987,59177070,IMR90|chr7:100181367-100181462,chr7,100181367,100181462,0,41004380
IMR90|chr7:59191701-59191730,chr7,59191701,59191730,IMR90|chr7:129592069-129592153,chr7,129592069,129592153,0,70400368
IMR90|chr7:59392854-59392933,chr7,59392854,59392933,IMR90|chr7:65580875-65580946,chr7,65580875,65580946,0,6188021
IMR90|chr7:59698441-59698538,chr7,59698441,59698538,IMR90|chr7:130134298-130134349,chr7,130134298,130134349,0,70435857
IMR90|chr7:59735340-59735372,chr7,59735340,59735372,IMR90|chr7:100772405-100772498,chr7,100772405,100772498,0,41037065
IMR90|chr7:59861090-59861240,chr7,59861090,59861240,IMR90|chr7:128375059-128375086,chr7,128375059,128375086,0,68513969
IMR90|chr7:59903536-59903651,chr7,59903536,59903651,IMR90|chr7:100729417-100729510,chr7,100729417,100729510,0,40825881
IMR90|chr7:59932426-59932507,chr7,59932426,59932507,IMR90|chr7:42274896-42274935,chr7,42274896,42274935,0,17657530
IMR90|chr7:60326097-60326133,chr7,60326097,60326133,IMR90|chr7:100772201-100772281,chr7,100772201,100772281,0,40446104
IMR90|chr7:60889217-60889315,chr7,60889217,60889315,IMR90|chr7:100772493-100772537,chr7,100772493,100772537,0,39883276
IMR90|chr7:61131788-61131860,chr7,61131788,61131860,IMR90|chr7:41735751-41735785,chr7,41735751,41735785,0,19396037
IMR90|chr7:61206032-61206091,chr7,61206032,61206091,IMR90|chr7:26244816-26244893,chr7,26244816,26244893,0,34961216
IMR90|chr7:61547416-61547488,chr7,61547416,61547488,IMR90|chr7:100772590-100772636,chr7,100772590,100772636,0,39225174
IMR90|chr7:61691751-61691776,chr7,61691751,61691776,IMR90|chr7:116168858-116168955,chr7,116168858,116168955,0,54477107
IMR90|chr7:61946220-61946276,chr7,61946220,61946276,IMR90|chr7:137686093-137686158,chr7,137686093,137686158,0,75739873
IMR90|chr7:62070696-62070779,chr7,62070696,62070779,IMR90|chr7:137683702-137683768,chr7,137683702,137683768,0,75613006
IMR90|chr7:62147470-62147503,chr7,62147470,62147503,IMR90|chr7:128472194-128472272,chr7,128472194,128472272,0,66324724
IMR90|chr7:62408959-62409004,chr7,62408959,62409004,IMR90|chr7:41740807-41740908,chr7,41740807,41740908,0,20668152
IMR90|chr7:62607639-62607662,chr7,62607639,62607662,IMR90|chr7:130791009-130791133,chr7,130791009,130791133,0,68183370
IMR90|chr7:62910277-62910369,chr7,62910277,62910369,IMR90|chr7:100770921-100770962,chr7,100770921,100770962,0,37860644
IMR90|chr7:63384144-63384169,chr7,63384144,63384169,IMR90|chr7:116166854-116166937,chr7,116166854,116166937,0,52782710
IMR90|chr7:63419541-63419571,chr7,63419541,63419571,IMR90|chr7:129592069-129592153,chr7,129592069,129592153,0,66172528
IMR90|chr7:63544779-63544843,chr7,63544779,63544843,IMR90|chr7:192741-192763,chr7,192741,192763,0,63352038
IMR90|chr7:63614179-63614232,chr7,63614179,63614232,IMR90|chr7:100771926-100772064,chr7,100771926,100772064,0,37157747
IMR90|chr7:63788276-63788314,chr7,63788276,63788314,IMR90|chr7:116165353-116165434,chr7,116165353,116165434,0,52377077
IMR90|chr7:63797064-63797109,chr7,63797064,63797109,IMR90|chr7:150077581-150077630,chr7,150077581,150077630,0,86280517
IMR90|chr7:63887617-63887645,chr7,63887617,63887645,IMR90|chr7:137684889-137685010,chr7,137684889,137685010,0,73797272
IMR90|chr7:63913917-63913959,chr7,63913917,63913959,IMR90|chr7:100074678-100074785,chr7,100074678,100074785,0,36160761
IMR90|chr7:64092751-64092870,chr7,64092751,64092870,IMR90|chr7:129590532-129590555,chr7,129590532,129590555,0,65497781
IMR90|chr7:64327490-64327523,chr7,64327490,64327523,IMR90|chr7:100427061-100427125,chr7,100427061,100427125,0,36099571
IMR90|chr7:64336685-64336759,chr7,64336685,64336759,IMR90|chr7:2668690-2668766,chr7,2668690,2668766,0,61667995
IMR90|chr7:64362055-64362075,chr7,64362055,64362075,IMR90|chr7:135193550-135193680,chr7,135193550,135193680,0,70831495
IMR90|chr7:64468539-64468571,chr7,64468539,64468571,IMR90|chr7:104649817-104649967,chr7,104649817,104649967,0,40181278
IMR90|chr7:65128371-65128433,chr7,65128371,65128433,IMR90|chr7:100770782-100770828,chr7,100770782,100770828,0,35642411
IMR90|chr7:65171586-65171670,chr7,65171586,65171670,IMR90|chr7:137683702-137683768,chr7,137683702,137683768,0,72512116
IMR90|chr7:65579164-65579232,chr7,65579164,65579232,IMR90|chr7:45040985-45041055,chr7,45040985,45041055,0,20538179
IMR90|chr7:66142386-66142480,chr7,66142386,66142480,IMR90|chr7:143082006-143082023,chr7,143082006,143082023,0,76939620
IMR90|chr7:66374417-66374501,chr7,66374417,66374501,IMR90|chr7:120965322-120965355,chr7,120965322,120965355,0,54590905
IMR90|chr7:66471496-66471525,chr7,66471496,66471525,IMR90|chr7:72821054-72821200,chr7,72821054,72821200,0,6349558
IMR90|chr7:66488249-66488268,chr7,66488249,66488268,IMR90|chr7:100772819-100772879,chr7,100772819,100772879,0,34284570
IMR90|chr7:66704930-66704970,chr7,66704930,66704970,IMR90|chr7:100772201-100772281,chr7,100772201,100772281,0,34067271
IMR90|chr7:66738047-66738111,chr7,66738047,66738111,IMR90|chr7:90891171-90891301,chr7,90891171,90891301,0,24153124
IMR90|chr7:66866435-66866512,chr7,66866435,66866512,IMR90|chr7:75156805-75156867,chr7,75156805,75156867,0,8290370
IMR90|chr7:67303079-67303122,chr7,67303079,67303122,IMR90|chr7:44837868-44837896,chr7,44837868,44837896,0,22465211
IMR90|chr7:67470715-67470789,chr7,67470715,67470789,IMR90|chr7:135341415-135341435,chr7,135341415,135341435,0,67870700
IMR90|chr7:67497672-67497789,chr7,67497672,67497789,IMR90|chr7:30808541-30808574,chr7,30808541,30808574,0,36689131
IMR90|chr7:67726952-67727102,chr7,67726952,67727102,IMR90|chr7:129588762-129588808,chr7,129588762,129588808,0,61861810
IMR90|chr7:67740547-67740653,chr7,67740547,67740653,IMR90|chr7:66385499-66385534,chr7,66385499,66385534,0,1355048
IMR90|chr7:68449809-68449899,chr7,68449809,68449899,IMR90|chr7:148937439-148937499,chr7,148937439,148937499,0,80487630
IMR90|chr7:68465251-68465287,chr7,68465251,68465287,IMR90|chr7:139523991-139524053,chr7,139523991,139524053,0,71058740
IMR90|chr7:68473715-68473753,chr7,68473715,68473753,IMR90|chr7:2668690-2668766,chr7,2668690,2668766,0,65805025
IMR90|chr7:68579266-68579315,chr7,68579266,68579315,IMR90|chr7:100773024-100773125,chr7,100773024,100773125,0,32193758
IMR90|chr7:68672426-68672451,chr7,68672426,68672451,IMR90|chr7:131012237-131012326,chr7,131012237,131012326,0,62339811
IMR90|chr7:68935156-68935293,chr7,68935156,68935293,IMR90|chr7:94025050-94025121,chr7,94025050,94025121,0,25089894
IMR90|chr7:69016387-69016468,chr7,69016387,69016468,IMR90|chr7:100773094-100773133,chr7,100773094,100773133,0,31756707
IMR90|chr7:69063291-69063353,chr7,69063291,69063353,IMR90|chr7:138719685-138719759,chr7,138719685,138719759,0,69656394
IMR90|chr7:70023081-70023180,chr7,70023081,70023180,IMR90|chr7:100772584-100772608,chr7,100772584,100772608,0,30749503
IMR90|chr7:70090092-70090190,chr7,70090092,70090190,IMR90|chr7:104652034-104652086,chr7,104652034,104652086,0,34561942
IMR90|chr7:70292373-70292422,chr7,70292373,70292422,IMR90|chr7:192709-192805,chr7,192709,192805,0,70099664
IMR90|chr7:70439714-70439779,chr7,70439714,70439779,IMR90|chr7:23507187-23507337,chr7,23507187,23507337,0,46932527
IMR90|chr7:70510306-70510408,chr7,70510306,70510408,IMR90|chr7:130795596-130795644,chr7,130795596,130795644,0,60285290
IMR90|chr7:70798923-70798978,chr7,70798923,70798978,IMR90|chr7:111844011-111844101,chr7,111844011,111844101,0,41045088
IMR90|chr7:70803384-70803462,chr7,70803384,70803462,IMR90|chr7:97880951-97881023,chr7,97880951,97881023,0,27077567
IMR90|chr7:70864285-70864383,chr7,70864285,70864383,IMR90|chr7:74491392-74491542,chr7,74491392,74491542,0,3627107
IMR90|chr7:70875477-70875534,chr7,70875477,70875534,IMR90|chr7:135341415-135341435,chr7,135341415,135341435,0,64465938
IMR90|chr7:70879175-70879267,chr7,70879175,70879267,IMR90|chr7:137536556-137536604,chr7,137536556,137536604,0,66657381
IMR90|chr7:70955340-70955467,chr7,70955340,70955467,IMR90|chr7:75510126-75510149,chr7,75510126,75510149,0,4554786
IMR90|chr7:71036807-71036878,chr7,71036807,71036878,IMR90|chr7:66093208-66093256,chr7,66093208,66093256,0,4943599
IMR90|chr7:71535338-71535399,chr7,71535338,71535399,IMR90|chr7:98740406-98740492,chr7,98740406,98740492,0,27205068
IMR90|chr7:71594529-71594571,chr7,71594529,71594571,IMR90|chr7:100074678-100074785,chr7,100074678,100074785,0,28480149
IMR90|chr7:71681506-71681563,chr7,71681506,71681563,IMR90|chr7:192582-192675,chr7,192582,192675,0,71488924
IMR90|chr7:72182742-72182814,chr7,72182742,72182814,IMR90|chr7:41735751-41735785,chr7,41735751,41735785,0,30446991
IMR90|chr7:72248391-72248449,chr7,72248391,72248449,IMR90|chr7:65956497-65956617,chr7,65956497,65956617,0,6291894
IMR90|chr7:72356989-72357022,chr7,72356989,72357022,IMR90|chr7:104649786-104649871,chr7,104649786,104649871,0,32292797
IMR90|chr7:72379112-72379140,chr7,72379112,72379140,IMR90|chr7:100770931-100771027,chr7,100770931,100771027,0,28391819
IMR90|chr7:72387899-72387978,chr7,72387899,72387978,IMR90|chr7:94025050-94025121,chr7,94025050,94025121,0,21637151
IMR90|chr7:72450420-72450469,chr7,72450420,72450469,IMR90|chr7:149413587-149413632,chr7,149413587,149413632,0,76963167
IMR90|chr7:72760904-72760956,chr7,72760904,72760956,IMR90|chr7:105517778-105517837,chr7,105517778,105517837,0,32756874
IMR90|chr7:72938897-72938984,chr7,72938897,72938984,IMR90|chr7:2673292-2673350,chr7,2673292,2673350,0,70265605
IMR90|chr7:73015224-73015262,chr7,73015224,73015262,IMR90|chr7:192786-192858,chr7,192786,192858,0,72822438
IMR90|chr7:73053692-73053762,chr7,73053692,73053762,IMR90|chr7:98972916-98972995,chr7,98972916,98972995,0,25919224
IMR90|chr7:73098703-73098736,chr7,73098703,73098736,IMR90|chr7:73153921-73154035,chr7,73153921,73154035,0,55218
IMR90|chr7:73213655-73213676,chr7,73213655,73213676,IMR90|chr7:55088128-55088216,chr7,55088128,55088216,0,18125527
IMR90|chr7:73337854-73337878,chr7,73337854,73337878,IMR90|chr7:44837600-44837682,chr7,44837600,44837682,0,28500254
IMR90|chr7:73362305-73362375,chr7,73362305,73362375,IMR90|chr7:129708683-129708763,chr7,129708683,129708763,0,56346378
IMR90|chr7:73457364-73457431,chr7,73457364,73457431,IMR90|chr7:105518785-105518844,chr7,105518785,105518844,0,32061421
IMR90|chr7:73458181-73458249,chr7,73458181,73458249,IMR90|chr7:100771007-100771085,chr7,100771007,100771085,0,27312826
IMR90|chr7:73462034-73462079,chr7,73462034,73462079,IMR90|chr7:120960735-120960814,chr7,120960735,120960814,0,47498701
IMR90|chr7:73539081-73539135,chr7,73539081,73539135,IMR90|chr7:149536187-149536220,chr7,149536187,149536220,0,75997106
IMR90|chr7:73542627-73542777,chr7,73542627,73542777,IMR90|chr7:74491336-74491486,chr7,74491336,74491486,0,948709
IMR90|chr7:73560468-73560522,chr7,73560468,73560522,IMR90|chr7:135195067-135195163,chr7,135195067,135195163,0,61634599
IMR90|chr7:73630843-73630914,chr7,73630843,73630914,IMR90|chr7:157131126-157131197,chr7,157131126,157131197,0,83500283
IMR90|chr7:73671003-73671065,chr7,73671003,73671065,IMR90|chr7:35841363-35841431,chr7,35841363,35841431,0,37829640
IMR90|chr7:74235381-74235423,chr7,74235381,74235423,IMR90|chr7:120966485-120966575,chr7,120966485,120966575,0,46731104
IMR90|chr7:74434362-74434422,chr7,74434362,74434422,IMR90|chr7:152130919-152131004,chr7,152130919,152131004,0,77696557
IMR90|chr7:74729686-74729831,chr7,74729686,74729831,IMR90|chr7:56121549-56121594,chr7,56121549,56121594,0,18608137
IMR90|chr7:75208972-75209029,chr7,75208972,75209029,IMR90|chr7:93630132-93630282,chr7,93630132,93630282,0,18421160
IMR90|chr7:75319765-75319820,chr7,75319765,75319820,IMR90|chr7:120966482-120966532,chr7,120966482,120966532,0,45646717
IMR90|chr7:75551751-75551821,chr7,75551751,75551821,IMR90|chr7:99519436-99519490,chr7,99519436,99519490,0,23967685
IMR90|chr7:76355235-76355296,chr7,76355235,76355296,IMR90|chr7:97596955-97597030,chr7,97596955,97597030,0,21241720
IMR90|chr7:76581408-76581478,chr7,76581408,76581478,IMR90|chr7:23339309-23339333,chr7,23339309,23339333,0,53242099
IMR90|chr7:76736158-76736219,chr7,76736158,76736219,IMR90|chr7:35841363-35841431,chr7,35841363,35841431,0,40894795
IMR90|chr7:76786971-76787019,chr7,76786971,76787019,IMR90|chr7:104652848-104652884,chr7,104652848,104652884,0,27865877
IMR90|chr7:76934148-76934230,chr7,76934148,76934230,IMR90|chr7:100770883-100770971,chr7,100770883,100770971,0,23836735
IMR90|chr7:77486766-77486886,chr7,77486766,77486886,IMR90|chr7:26238697-26238723,chr7,26238697,26238723,0,51248069
IMR90|chr7:77970225-77970248,chr7,77970225,77970248,IMR90|chr7:23508398-23508487,chr7,23508398,23508487,0,54461827
IMR90|chr7:78066198-78066283,chr7,78066198,78066283,IMR90|chr7:100771285-100771326,chr7,100771285,100771326,0,22705087
IMR90|chr7:78126300-78126363,chr7,78126300,78126363,IMR90|chr7:131012237-131012326,chr7,131012237,131012326,0,52885937
IMR90|chr7:78150549-78150628,chr7,78150549,78150628,IMR90|chr7:65580875-65580946,chr7,65580875,65580946,0,12569674
IMR90|chr7:78371762-78371786,chr7,78371762,78371786,IMR90|chr7:116166854-116166937,chr7,116166854,116166937,0,37795092
IMR90|chr7:78385361-78385462,chr7,78385361,78385462,IMR90|chr7:104652034-104652086,chr7,104652034,104652086,0,26266673
IMR90|chr7:78587660-78587691,chr7,78587660,78587691,IMR90|chr7:90224759-90224870,chr7,90224759,90224870,0,11637099
IMR90|chr7:78707904-78708008,chr7,78707904,78708008,IMR90|chr7:140339371-140339411,chr7,140339371,140339411,0,61631467
IMR90|chr7:78738944-78739008,chr7,78738944,78739008,IMR90|chr7:5185581-5185609,chr7,5185581,5185609,0,73553363
IMR90|chr7:79209515-79209640,chr7,79209515,79209640,IMR90|chr7:35841705-35841722,chr7,35841705,35841722,0,43367810
IMR90|chr7:79386591-79386621,chr7,79386591,79386621,IMR90|chr7:100771554-100771648,chr7,100771554,100771648,0,21384963
IMR90|chr7:80048394-80048434,chr7,80048394,80048434,IMR90|chr7:100771448-100771478,chr7,100771448,100771478,0,20723054
IMR90|chr7:80452094-80452157,chr7,80452094,80452157,IMR90|chr7:137684173-137684260,chr7,137684173,137684260,0,57232079
IMR90|chr7:80930932-80930955,chr7,80930932,80930955,IMR90|chr7:100771557-100771655,chr7,100771557,100771655,0,19840625
IMR90|chr7:80933864-80933894,chr7,80933864,80933894,IMR90|chr7:66205963-66206024,chr7,66205963,66206024,0,14727901
IMR90|chr7:80985771-80985833,chr7,80985771,80985833,IMR90|chr7:26239955-26240040,chr7,26239955,26240040,0,54745816
IMR90|chr7:81039442-81039478,chr7,81039442,81039478,IMR90|chr7:120965815-120965958,chr7,120965815,120965958,0,39926373
IMR90|chr7:81264047-81264176,chr7,81264047,81264176,IMR90|chr7:143081665-143081686,chr7,143081665,143081686,0,61817618
IMR90|chr7:81374565-81374584,chr7,81374565,81374584,IMR90|chr7:100772819-100772879,chr7,100772819,100772879,0,19398254
IMR90|chr7:81444659-81444770,chr7,81444659,81444770,IMR90|chr7:143082006-143082023,chr7,143082006,143082023,0,61637347
IMR90|chr7:81795865-81795949,chr7,81795865,81795949,IMR90|chr7:120965322-120965355,chr7,120965322,120965355,0,39169457
IMR90|chr7:81799372-81799430,chr7,81799372,81799430,IMR90|chr7:100773128-100773169,chr7,100773128,100773169,0,18973756
IMR90|chr7:82264392-82264504,chr7,82264392,82264504,IMR90|chr7:94025358-94025382,chr7,94025358,94025382,0,11760966
IMR90|chr7:82274712-82274775,chr7,82274712,82274775,IMR90|chr7:102252134-102252260,chr7,102252134,102252260,0,19977422
IMR90|chr7:82423153-82423250,chr7,82423153,82423250,IMR90|chr7:130795596-130795644,chr7,130795596,130795644,0,48372443
IMR90|chr7:82529999-82530022,chr7,82529999,82530022,IMR90|chr7:130791009-130791133,chr7,130791009,130791133,0,48261010
IMR90|chr7:82791380-82791420,chr7,82791380,82791420,IMR90|chr7:140399531-140399587,chr7,140399531,140399587,0,57608151
IMR90|chr7:82804367-82804457,chr7,82804367,82804457,IMR90|chr7:75114379-75114439,chr7,75114379,75114439,0,7689988
IMR90|chr7:83160858-83160904,chr7,83160858,83160904,IMR90|chr7:192590-192659,chr7,192590,192659,0,82968268
IMR90|chr7:83174329-83174418,chr7,83174329,83174418,IMR90|chr7:150077581-150077630,chr7,150077581,150077630,0,66903252
IMR90|chr7:83216638-83216695,chr7,83216638,83216695,IMR90|chr7:74490080-74490173,chr7,74490080,74490173,0,8726558
IMR90|chr7:83988869-83988966,chr7,83988869,83988966,IMR90|chr7:130795596-130795644,chr7,130795596,130795644,0,46806727
IMR90|chr7:84223499-84223549,chr7,84223499,84223549,IMR90|chr7:98740406-98740492,chr7,98740406,98740492,0,14516907
IMR90|chr7:84728973-84729022,chr7,84728973,84729022,IMR90|chr7:65956840-65956972,chr7,65956840,65956972,0,18772133
IMR90|chr7:84736648-84736752,chr7,84736648,84736752,IMR90|chr7:129588762-129588808,chr7,129588762,129588808,0,44852114
IMR90|chr7:84920576-84920682,chr7,84920576,84920682,IMR90|chr7:66385499-66385534,chr7,66385499,66385534,0,18535077
IMR90|chr7:85271428-85271512,chr7,85271428,85271512,IMR90|chr7:120962856-120962922,chr7,120962856,120962922,0,35691428
IMR90|chr7:85291346-85291394,chr7,85291346,85291394,IMR90|chr7:79086849-79086951,chr7,79086849,79086951,0,6204497
IMR90|chr7:85307911-85308030,chr7,85307911,85308030,IMR90|chr7:129590532-129590555,chr7,129590532,129590555,0,44282621
IMR90|chr7:85346650-85346701,chr7,85346650,85346701,IMR90|chr7:72820800-72820874,chr7,72820800,72820874,0,12525850
IMR90|chr7:85477176-85477247,chr7,85477176,85477247,IMR90|chr7:98739825-98739878,chr7,98739825,98739878,0,13262649
IMR90|chr7:85552165-85552210,chr7,85552165,85552210,IMR90|chr7:128504146-128504199,chr7,128504146,128504199,0,42951981
IMR90|chr7:86151074-86151133,chr7,86151074,86151133,IMR90|chr7:149194039-149194121,chr7,149194039,149194121,0,63042965
IMR90|chr7:86312489-86312551,chr7,86312489,86312551,IMR90|chr7:26239955-26240040,chr7,26239955,26240040,0,60072534
IMR90|chr7:86447597-86447657,chr7,86447597,86447657,IMR90|chr7:192582-192675,chr7,192582,192675,0,86255015
IMR90|chr7:86493793-86493921,chr7,86493793,86493921,IMR90|chr7:120965322-120965355,chr7,120965322,120965355,0,34471529
IMR90|chr7:86514428-86514476,chr7,86514428,86514476,IMR90|chr7:102252174-102252260,chr7,102252174,102252260,0,15737746
IMR90|chr7:86640946-86641005,chr7,86640946,86641005,IMR90|chr7:26244816-26244893,chr7,26244816,26244893,0,60396130
IMR90|chr7:86752499-86752587,chr7,86752499,86752587,IMR90|chr7:98972915-98972996,chr7,98972915,98972996,0,12220416
IMR90|chr7:87130339-87130383,chr7,87130339,87130383,IMR90|chr7:102252160-102252260,chr7,102252160,102252260,0,15121821
IMR90|chr7:87349241-87349267,chr7,87349241,87349267,IMR90|chr7:100772082-100772197,chr7,100772082,100772197,0,13422841
IMR90|chr7:87560531-87560552,chr7,87560531,87560552,IMR90|chr7:135193550-135193680,chr7,135193550,135193680,0,47633019
IMR90|chr7:87806646-87806790,chr7,87806646,87806790,IMR90|chr7:74491069-74491219,chr7,74491069,74491219,0,13315577
IMR90|chr7:87981874-87981965,chr7,87981874,87981965,IMR90|chr7:137683702-137683768,chr7,137683702,137683768,0,49701828
IMR90|chr7:88523212-88523273,chr7,88523212,88523273,IMR90|chr7:100772875-100772943,chr7,100772875,100772943,0,12249663
IMR90|chr7:88541481-88541626,chr7,88541481,88541626,IMR90|chr7:75510126-75510149,chr7,75510126,75510149,0,13031355
IMR90|chr7:88558189-88558256,chr7,88558189,88558256,IMR90|chr7:41737447-41737487,chr7,41737447,41737487,0,46820742
IMR90|chr7:88916024-88916131,chr7,88916024,88916131,IMR90|chr7:41738875-41738930,chr7,41738875,41738930,0,47177149
IMR90|chr7:88939170-88939241,chr7,88939170,88939241,IMR90|chr7:100771007-100771085,chr7,100771007,100771085,0,11831837
IMR90|chr7:89115368-89115433,chr7,89115368,89115433,IMR90|chr7:23507187-23507337,chr7,23507187,23507337,0,65608181
IMR90|chr7:89245197-89245255,chr7,89245197,89245255,IMR90|chr7:105331746-105331826,chr7,105331746,105331826,0,16086549
IMR90|chr7:89334227-89334297,chr7,89334227,89334297,IMR90|chr7:98972916-98972995,chr7,98972916,98972995,0,9638689
IMR90|chr7:89584812-89584858,chr7,89584812,89584858,IMR90|chr7:134467325-134467379,chr7,134467325,134467379,0,44882513
IMR90|chr7:89599144-89599161,chr7,89599144,89599161,IMR90|chr7:128380407-128380511,chr7,128380407,128380511,0,38781263
IMR90|chr7:90869242-90869281,chr7,90869242,90869281,IMR90|chr7:100181367-100181462,chr7,100181367,100181462,0,9312125
IMR90|chr7:90901026-90901075,chr7,90901026,90901075,IMR90|chr7:134467325-134467379,chr7,134467325,134467379,0,43566299
IMR90|chr7:90943512-90943609,chr7,90943512,90943609,IMR90|chr7:130134298-130134349,chr7,130134298,130134349,0,39190786
IMR90|chr7:90988173-90988217,chr7,90988173,90988217,IMR90|chr7:97914670-97914771,chr7,97914670,97914771,0,6926497
IMR90|chr7:91032695-91032722,chr7,91032695,91032722,IMR90|chr7:104655685-104655761,chr7,104655685,104655761,0,13622990
IMR90|chr7:91219844-91219894,chr7,91219844,91219894,IMR90|chr7:102252202-102252259,chr7,102252202,102252259,0,11032358
IMR90|chr7:91393000-91393053,chr7,91393000,91393053,IMR90|chr7:102252147-102252260,chr7,102252147,102252260,0,10859147
IMR90|chr7:91852638-91852665,chr7,91852638,91852665,IMR90|chr7:149413630-149413686,chr7,149413630,149413686,0,57560992
IMR90|chr7:92104192-92104210,chr7,92104192,92104210,IMR90|chr7:97911317-97911356,chr7,97911317,97911356,0,5807125
IMR90|chr7:92320363-92320411,chr7,92320363,92320411,IMR90|chr7:74491305-74491407,chr7,74491305,74491407,0,17829058
IMR90|chr7:92473906-92474008,chr7,92473906,92474008,IMR90|chr7:56121549-56121594,chr7,56121549,56121594,0,36352357
IMR90|chr7:92546761-92546782,chr7,92546761,92546782,IMR90|chr7:192821-192888,chr7,192821,192888,0,92353940
IMR90|chr7:92618683-92618706,chr7,92618683,92618706,IMR90|chr7:100771557-100771655,chr7,100771557,100771655,0,8152874
IMR90|chr7:92749099-92749170,chr7,92749099,92749170,IMR90|chr7:100771565-100771628,chr7,100771565,100771628,0,8022466
IMR90|chr7:93204221-93204241,chr7,93204221,93204241,IMR90|chr7:90891171-90891301,chr7,90891171,90891301,0,2313050
IMR90|chr7:93223229-93223249,chr7,93223229,93223249,IMR90|chr7:102252169-102252260,chr7,102252169,102252260,0,9028940
IMR90|chr7:93590081-93590130,chr7,93590081,93590130,IMR90|chr7:100773130-100773194,chr7,100773130,100773194,0,7183049
IMR90|chr7:93754536-93754602,chr7,93754536,93754602,IMR90|chr7:100771015-100771073,chr7,100771015,100771073,0,7016479
IMR90|chr7:93761039-93761064,chr7,93761039,93761064,IMR90|chr7:100772405-100772498,chr7,100772405,100772498,0,7011366
IMR90|chr7:93773140-93773179,chr7,93773140,93773179,IMR90|chr7:120966485-120966575,chr7,120966485,120966575,0,27193345
IMR90|chr7:93793480-93793601,chr7,93793480,93793601,IMR90|chr7:44837868-44837896,chr7,44837868,44837896,0,48955612
IMR90|chr7:94030124-94030166,chr7,94030124,94030166,IMR90|chr7:56120233-56120350,chr7,56120233,56120350,0,37909891
IMR90|chr7:94150279-94150313,chr7,94150279,94150313,IMR90|chr7:100074675-100074750,chr7,100074675,100074750,0,5924396
IMR90|chr7:94182794-94182897,chr7,94182794,94182897,IMR90|chr7:100773127-100773157,chr7,100773127,100773157,0,6590333
IMR90|chr7:94246166-94246220,chr7,94246166,94246220,IMR90|chr7:99062953-99062982,chr7,99062953,99062982,0,4816787
IMR90|chr7:94377131-94377248,chr7,94377131,94377248,IMR90|chr7:128375059-128375086,chr7,128375059,128375086,0,33997928
IMR90|chr7:95013899-95013970,chr7,95013899,95013970,IMR90|chr7:100771565-100771628,chr7,100771565,100771628,0,5757666
IMR90|chr7:95074028-95074117,chr7,95074028,95074117,IMR90|chr7:120968641-120968702,chr7,120968641,120968702,0,25894613
IMR90|chr7:95144547-95144631,chr7,95144547,95144631,IMR90|chr7:120962856-120962922,chr7,120962856,120962922,0,25818309
IMR90|chr7:95171776-95171893,chr7,95171776,95171893,IMR90|chr7:30808541-30808574,chr7,30808541,30808574,0,64363235
IMR90|chr7:95181691-95181794,chr7,95181691,95181794,IMR90|chr7:111845720-111845767,chr7,111845720,111845767,0,16664029
IMR90|chr7:95326292-95326333,chr7,95326292,95326333,IMR90|chr7:99645846-99645880,chr7,99645846,99645880,0,4319554
IMR90|chr7:95488150-95488181,chr7,95488150,95488181,IMR90|chr7:127230233-127230296,chr7,127230233,127230296,0,31742083
IMR90|chr7:95507429-95507511,chr7,95507429,95507511,IMR90|chr7:100770883-100770971,chr7,100770883,100770971,0,5263454
IMR90|chr7:95745037-95745115,chr7,95745037,95745115,IMR90|chr7:97880951-97881023,chr7,97880951,97881023,0,2135914
IMR90|chr7:95852240-95852289,chr7,95852240,95852289,IMR90|chr7:35841810-35841839,chr7,35841810,35841839,0,60010430
IMR90|chr7:95882132-95882171,chr7,95882132,95882171,IMR90|chr7:5633798-5633875,chr7,5633798,5633875,0,90248334
IMR90|chr7:95962054-95962076,chr7,95962054,95962076,IMR90|chr7:87847549-87847648,chr7,87847549,87847648,0,8114505
IMR90|chr7:96106060-96106181,chr7,96106060,96106181,IMR90|chr7:44837868-44837896,chr7,44837868,44837896,0,51268192
IMR90|chr7:96124012-96124061,chr7,96124012,96124061,IMR90|chr7:100181367-100181462,chr7,100181367,100181462,0,4057355
IMR90|chr7:96219750-96219782,chr7,96219750,96219782,IMR90|chr7:127230233-127230296,chr7,127230233,127230296,0,31010483
IMR90|chr7:96235369-96235430,chr7,96235369,96235430,IMR90|chr7:100772875-100772943,chr7,100772875,100772943,0,4537506
IMR90|chr7:96505254-96505381,chr7,96505254,96505381,IMR90|chr7:140339438-140339477,chr7,140339438,140339477,0,43834184
IMR90|chr7:96685644-96685751,chr7,96685644,96685751,IMR90|chr7:100771995-100772069,chr7,100771995,100772069,0,4086351
IMR90|chr7:96924407-96924432,chr7,96924407,96924432,IMR90|chr7:137684889-137685010,chr7,137684889,137685010,0,40760482
IMR90|chr7:96938264-96938279,chr7,96938264,96938279,IMR90|chr7:98972915-98972996,chr7,98972915,98972996,0,2034651
IMR90|chr7:97201482-97201546,chr7,97201482,97201546,IMR90|chr7:97914670-97914771,chr7,97914670,97914771,0,713188
IMR90|chr7:97584718-97584789,chr7,97584718,97584789,IMR90|chr7:98739825-98739878,chr7,98739825,98739878,0,1155107
IMR90|chr7:98763583-98763656,chr7,98763583,98763656,IMR90|chr7:137533649-137533726,chr7,137533649,137533726,0,38770066
IMR90|chr7:98908769-98908851,chr7,98908769,98908851,IMR90|chr7:104655533-104655612,chr7,104655533,104655612,0,5746764
IMR90|chr7:99270796-99270888,chr7,99270796,99270888,IMR90|chr7:26238516-26238554,chr7,26238516,26238554,0,73032280
IMR90|chr7:99451373-99451496,chr7,99451373,99451496,IMR90|chr7:129707728-129707774,chr7,129707728,129707774,0,30256355
IMR90|chr7:99624393-99624415,chr7,99624393,99624415,IMR90|chr7:97885518-97885622,chr7,97885518,97885622,0,1738875
IMR90|chr7:99626025-99626081,chr7,99626025,99626081,IMR90|chr7:23532641-23532730,chr7,23532641,23532730,0,76093384
IMR90|chr7:100605450-100605503,chr7,100605450,100605503,IMR90|chr7:137532953-137533040,chr7,137532953,137533040,0,36927503
IMR90|chr7:101101987-101102027,chr7,101101987,101102027,IMR90|chr7:100772201-100772281,chr7,100772201,100772281,0,329786
IMR90|chr7:101219393-101219429,chr7,101219393,101219429,IMR90|chr7:195985-196063,chr7,195985,196063,0,101023408
IMR90|chr7:101577123-101577273,chr7,101577123,101577273,IMR90|chr7:26237870-26237887,chr7,26237870,26237887,0,75339253
IMR90|chr7:102050805-102050947,chr7,102050805,102050947,IMR90|chr7:26238697-26238723,chr7,26238697,26238723,0,75812108
IMR90|chr7:102127376-102127425,chr7,102127376,102127425,IMR90|chr7:192590-192659,chr7,192590,192659,0,101934786
IMR90|chr7:102151809-102151843,chr7,102151809,102151843,IMR90|chr7:102252159-102252259,chr7,102252159,102252259,0,100350
IMR90|chr7:102572372-102572424,chr7,102572372,102572424,IMR90|chr7:97915386-97915511,chr7,97915386,97915511,0,4656986
IMR90|chr7:102718111-102718141,chr7,102718111,102718141,IMR90|chr7:100771554-100771648,chr7,100771554,100771648,0,1946557
IMR90|chr7:102947431-102947485,chr7,102947431,102947485,IMR90|chr7:137535909-137536005,chr7,137535909,137536005,0,34588478
IMR90|chr7:103383328-103383355,chr7,103383328,103383355,IMR90|chr7:195078-195149,chr7,195078,195149,0,103188250
IMR90|chr7:103447477-103447580,chr7,103447477,103447580,IMR90|chr7:100773127-100773157,chr7,100773127,100773157,0,2674350
IMR90|chr7:104292405-104292432,chr7,104292405,104292432,IMR90|chr7:100770931-100771027,chr7,100770931,100771027,0,3521474
IMR90|chr7:104671218-104671328,chr7,104671218,104671328,IMR90|chr7:100857709-100857730,chr7,100857709,100857730,0,3813509
IMR90|chr7:104991486-104991544,chr7,104991486,104991544,IMR90|chr7:105331746-105331826,chr7,105331746,105331826,0,340260
IMR90|chr7:105125167-105125212,chr7,105125167,105125212,IMR90|chr7:100773024-100773129,chr7,100773024,100773129,0,4352143
IMR90|chr7:105384328-105384371,chr7,105384328,105384371,IMR90|chr7:44086828-44086885,chr7,44086828,44086885,0,61297500
IMR90|chr7:105559712-105559798,chr7,105559712,105559798,IMR90|chr7:142986450-142986511,chr7,142986450,142986511,0,37426738
IMR90|chr7:105606249-105606293,chr7,105606249,105606293,IMR90|chr7:102252160-102252260,chr7,102252160,102252260,0,3354089
IMR90|chr7:105656824-105656893,chr7,105656824,105656893,IMR90|chr7:23339309-23339333,chr7,23339309,23339333,0,82317515
IMR90|chr7:105780783-105780854,chr7,105780783,105780854,IMR90|chr7:99519436-99519490,chr7,99519436,99519490,0,6261347
IMR90|chr7:105928448-105928580,chr7,105928448,105928580,IMR90|chr7:64364487-64364560,chr7,64364487,64364560,0,41563961
IMR90|chr7:106109004-106109036,chr7,106109004,106109036,IMR90|chr7:127230233-127230296,chr7,127230233,127230296,0,21121229
IMR90|chr7:106164470-106164542,chr7,106164470,106164542,IMR90|chr7:137686093-137686158,chr7,137686093,137686158,0,31521623
IMR90|chr7:106204272-106204299,chr7,106204272,106204299,IMR90|chr7:87847549-87847648,chr7,87847549,87847648,0,18356723
IMR90|chr7:106206177-106206266,chr7,106206177,106206266,IMR90|chr7:2673292-2673350,chr7,2673292,2673350,0,103532885
IMR90|chr7:106266773-106266840,chr7,106266773,106266840,IMR90|chr7:45040984-45041055,chr7,45040984,45041055,0,61225789
IMR90|chr7:106386066-106386157,chr7,106386066,106386157,IMR90|chr7:137683702-137683768,chr7,137683702,137683768,0,31297636
IMR90|chr7:106540399-106540444,chr7,106540399,106540444,IMR90|chr7:128504146-128504199,chr7,128504146,128504199,0,21963747
IMR90|chr7:106586022-106586071,chr7,106586022,106586071,IMR90|chr7:92219056-92219153,chr7,92219056,92219153,0,14366966
IMR90|chr7:106768852-106768890,chr7,106768852,106768890,IMR90|chr7:116165353-116165434,chr7,116165353,116165434,0,9396501
IMR90|chr7:106787472-106787560,chr7,106787472,106787560,IMR90|chr7:65580875-65580946,chr7,65580875,65580946,0,41206597
IMR90|chr7:106813710-106813742,chr7,106813710,106813742,IMR90|chr7:90224759-90224870,chr7,90224759,90224870,0,16588951
IMR90|chr7:106910377-106910469,chr7,106910377,106910469,IMR90|chr7:26238516-26238554,chr7,26238516,26238554,0,80671861
IMR90|chr7:106935615-106935741,chr7,106935615,106935741,IMR90|chr7:100772615-100772714,chr7,100772615,100772714,0,6163000
IMR90|chr7:106973237-106973322,chr7,106973237,106973322,IMR90|chr7:66205876-66205924,chr7,66205876,66205924,0,40767361
IMR90|chr7:107079492-107079580,chr7,107079492,107079580,IMR90|chr7:55088271-55088299,chr7,55088271,55088299,0,51991221
IMR90|chr7:107175962-107176003,chr7,107175962,107176003,IMR90|chr7:100771385-100771476,chr7,100771385,100771476,0,6404577
IMR90|chr7:107194098-107194174,chr7,107194098,107194174,IMR90|chr7:111845720-111845767,chr7,111845720,111845767,0,4651622
IMR90|chr7:107204844-107204964,chr7,107204844,107204964,IMR90|chr7:26238697-26238723,chr7,26238697,26238723,0,80966147
IMR90|chr7:107278633-107278657,chr7,107278633,107278657,IMR90|chr7:116166854-116166937,chr7,116166854,116166937,0,8888221
IMR90|chr7:107346166-107346193,chr7,107346166,107346193,IMR90|chr7:195078-195149,chr7,195078,195149,0,107151088
IMR90|chr7:107403903-107403970,chr7,107403903,107403970,IMR90|chr7:94027362-94027423,chr7,94027362,94027423,0,13376541
IMR90|chr7:107574300-107574349,chr7,107574300,107574349,IMR90|chr7:102252120-102252260,chr7,102252120,102252260,0,5322180
IMR90|chr7:107592525-107592628,chr7,107592525,107592628,IMR90|chr7:129707728-129707774,chr7,129707728,129707774,0,22115203
IMR90|chr7:107680210-107680283,chr7,107680210,107680283,IMR90|chr7:100771046-100771084,chr7,100771046,100771084,0,6909164
IMR90|chr7:107694602-107694671,chr7,107694602,107694671,IMR90|chr7:65956468-65956504,chr7,65956468,65956504,0,41738134
IMR90|chr7:107990437-107990520,chr7,107990437,107990520,IMR90|chr7:26243607-26243630,chr7,26243607,26243630,0,81746830
IMR90|chr7:108125591-108125619,chr7,108125591,108125619,IMR90|chr7:100770931-100771027,chr7,100770931,100771027,0,7354660
IMR90|chr7:108719567-108719623,chr7,108719567,108719623,IMR90|chr7:102252108-102252256,chr7,102252108,102252256,0,6467459
IMR90|chr7:108726717-108726763,chr7,108726717,108726763,IMR90|chr7:92218880-92218917,chr7,92218880,92218917,0,16507837
IMR90|chr7:108733046-108733074,chr7,108733046,108733074,IMR90|chr7:104655685-104655761,chr7,104655685,104655761,0,4077361
IMR90|chr7:108917213-108917311,chr7,108917213,108917311,IMR90|chr7:100772493-100772537,chr7,100772493,100772537,0,8144720
IMR90|chr7:109013865-109013891,chr7,109013865,109013891,IMR90|chr7:100772082-100772197,chr7,100772082,100772197,0,8241783
IMR90|chr7:109613201-109613351,chr7,109613201,109613351,IMR90|chr7:74491079-74491226,chr7,74491079,74491226,0,35122122
IMR90|chr7:109651067-109651165,chr7,109651067,109651165,IMR90|chr7:74491392-74491542,chr7,74491392,74491542,0,35159675
IMR90|chr7:109747932-109747994,chr7,109747932,109747994,IMR90|chr7:102252111-102252195,chr7,102252111,102252195,0,7495821
IMR90|chr7:110272187-110272235,chr7,110272187,110272235,IMR90|chr7:102252174-102252260,chr7,102252174,102252260,0,8020013
IMR90|chr7:110370912-110370954,chr7,110370912,110370954,IMR90|chr7:102252144-102252260,chr7,102252144,102252260,0,8118768
IMR90|chr7:110455773-110455831,chr7,110455773,110455831,IMR90|chr7:6681749-6681828,chr7,6681749,6681828,0,103774024
IMR90|chr7:110655542-110655594,chr7,110655542,110655594,IMR90|chr7:24796174-24796251,chr7,24796174,24796251,0,85859368
IMR90|chr7:110669260-110669327,chr7,110669260,110669327,IMR90|chr7:45040984-45041055,chr7,45040984,45041055,0,65628276
IMR90|chr7:111441495-111441597,chr7,111441495,111441597,IMR90|chr7:134467016-134467051,chr7,134467016,134467051,0,23025521
IMR90|chr7:111817039-111817134,chr7,111817039,111817134,IMR90|chr7:41738875-41738930,chr7,41738875,41738930,0,70078164
IMR90|chr7:111878784-111878887,chr7,111878784,111878887,IMR90|chr7:66385499-66385534,chr7,66385499,66385534,0,45493285
IMR90|chr7:111883037-111883102,chr7,111883037,111883102,IMR90|chr7:79081996-79082074,chr7,79081996,79082074,0,32801041
IMR90|chr7:111885212-111885279,chr7,111885212,111885279,IMR90|chr7:55432042-55432103,chr7,55432042,55432103,0,56453170
IMR90|chr7:112727354-112727372,chr7,112727354,112727372,IMR90|chr7:97911317-97911356,chr7,97911317,97911356,0,14816037
IMR90|chr7:113045511-113045552,chr7,113045511,113045552,IMR90|chr7:140399531-140399587,chr7,140399531,140399587,0,27354020
IMR90|chr7:113987342-113987402,chr7,113987342,113987402,IMR90|chr7:72819514-72819565,chr7,72819514,72819565,0,41167828
IMR90|chr7:114056067-114056114,chr7,114056067,114056114,IMR90|chr7:100771388-100771446,chr7,100771388,100771446,0,13284679
IMR90|chr7:114195986-114196062,chr7,114195986,114196062,IMR90|chr7:75155456-75155521,chr7,75155456,75155521,0,39040530
IMR90|chr7:114212670-114212763,chr7,114212670,114212763,IMR90|chr7:120966028-120966075,chr7,120966028,120966075,0,6753358
IMR90|chr7:114377911-114377962,chr7,114377911,114377962,IMR90|chr7:135195067-135195163,chr7,135195067,135195163,0,20817156
IMR90|chr7:114516139-114516171,chr7,114516139,114516171,IMR90|chr7:100772405-100772498,chr7,100772405,100772498,0,13743734
IMR90|chr7:114643372-114643402,chr7,114643372,114643402,IMR90|chr7:129592069-129592153,chr7,129592069,129592153,0,14948697
IMR90|chr7:115083573-115083591,chr7,115083573,115083591,IMR90|chr7:128380407-128380511,chr7,128380407,128380511,0,13296834
IMR90|chr7:115262628-115262655,chr7,115262628,115262655,IMR90|chr7:104655685-104655761,chr7,104655685,104655761,0,10606943
IMR90|chr7:115346068-115346145,chr7,115346068,115346145,IMR90|chr7:120968644-120968717,chr7,120968644,120968717,0,5622576
IMR90|chr7:115392931-115392953,chr7,115392931,115392953,IMR90|chr7:87847549-87847648,chr7,87847549,87847648,0,27545382
IMR90|chr7:115878737-115878795,chr7,115878737,115878795,IMR90|chr7:75550362-75550435,chr7,75550362,75550435,0,40328375
IMR90|chr7:116053578-116053632,chr7,116053578,116053632,IMR90|chr7:100074675-100074750,chr7,100074675,100074750,0,15978903
IMR90|chr7:116312824-116312974,chr7,116312824,116312974,IMR90|chr7:30808541-30808574,chr7,30808541,30808574,0,85504283
IMR90|chr7:116347189-116347252,chr7,116347189,116347252,IMR90|chr7:192741-192763,chr7,192741,192763,0,116154448
IMR90|chr7:116710849-116710910,chr7,116710849,116710910,IMR90|chr7:26239955-26240040,chr7,26239955,26240040,0,90470894
IMR90|chr7:116908808-116908849,chr7,116908808,116908849,IMR90|chr7:99645846-99645880,chr7,99645846,99645880,0,17262962
IMR90|chr7:117154899-117155002,chr7,117154899,117155002,IMR90|chr7:129707728-129707774,chr7,129707728,129707774,0,12552829
IMR90|chr7:117493965-117494037,chr7,117493965,117494037,IMR90|chr7:100772590-100772636,chr7,100772590,100772636,0,16721375
IMR90|chr7:117717596-117717684,chr7,117717596,117717684,IMR90|chr7:65580875-65580946,chr7,65580875,65580946,0,52136721
IMR90|chr7:117718002-117718069,chr7,117718002,117718069,IMR90|chr7:94027362-94027423,chr7,94027362,94027423,0,23690640
IMR90|chr7:117839642-117839664,chr7,117839642,117839664,IMR90|chr7:97915386-97915511,chr7,97915386,97915511,0,19924256
IMR90|chr7:118084042-118084074,chr7,118084042,118084074,IMR90|chr7:100773025-100773129,chr7,100773025,100773129,0,17311017
IMR90|chr7:118378188-118378251,chr7,118378188,118378251,IMR90|chr7:192741-192763,chr7,192741,192763,0,118185447
IMR90|chr7:118602386-118602408,chr7,118602386,118602408,IMR90|chr7:26245486-26245551,chr7,26245486,26245551,0,92356900
IMR90|chr7:118705971-118706028,chr7,118705971,118706028,IMR90|chr7:100773128-100773169,chr7,100773128,100773169,0,17932843
IMR90|chr7:118971621-118971649,chr7,118971621,118971649,IMR90|chr7:104655685-104655761,chr7,104655685,104655761,0,14315936
IMR90|chr7:119539724-119539779,chr7,119539724,119539779,IMR90|chr7:152130919-152131004,chr7,152130919,152131004,0,32591195
IMR90|chr7:119553175-119553219,chr7,119553175,119553219,IMR90|chr7:192586-192627,chr7,192586,192627,0,119360589
IMR90|chr7:119673913-119674016,chr7,119673913,119674016,IMR90|chr7:111845720-111845767,chr7,111845720,111845767,0,7828193
IMR90|chr7:119676179-119676248,chr7,119676179,119676248,IMR90|chr7:94025358-94025382,chr7,94025358,94025382,0,25650821
IMR90|chr7:120145503-120145636,chr7,120145503,120145636,IMR90|chr7:26237870-26237887,chr7,26237870,26237887,0,93907633
IMR90|chr7:120584876-120584914,chr7,120584876,120584914,IMR90|chr7:2668690-2668766,chr7,2668690,2668766,0,117916186
IMR90|chr7:120591304-120591454,chr7,120591304,120591454,IMR90|chr7:30808541-30808574,chr7,30808541,30808574,0,89782763
IMR90|chr7:120942657-120942733,chr7,120942657,120942733,IMR90|chr7:74491275-74491341,chr7,74491275,74491341,0,46451382
IMR90|chr7:120997722-120997783,chr7,120997722,120997783,IMR90|chr7:26239955-26240040,chr7,26239955,26240040,0,94757767
IMR90|chr7:121116465-121116509,chr7,121116465,121116509,IMR90|chr7:192586-192627,chr7,192586,192627,0,120923879
IMR90|chr7:121118475-121118509,chr7,121118475,121118509,IMR90|chr7:102252159-102252259,chr7,102252159,102252259,0,18866316
IMR90|chr7:121296129-121296175,chr7,121296129,121296175,IMR90|chr7:92218880-92218917,chr7,92218880,92218917,0,29077249
IMR90|chr7:121448368-121448454,chr7,121448368,121448454,IMR90|chr7:104650826-104650870,chr7,104650826,104650870,0,16797542
IMR90|chr7:121667752-121667841,chr7,121667752,121667841,IMR90|chr7:120968641-120968702,chr7,120968641,120968702,0,699111
IMR90|chr7:121782396-121782488,chr7,121782396,121782488,IMR90|chr7:100770921-100770962,chr7,100770921,100770962,0,21011475
IMR90|chr7:121883338-121883431,chr7,121883338,121883431,IMR90|chr7:120966028-120966075,chr7,120966028,120966075,0,917310
IMR90|chr7:122158011-122158099,chr7,122158011,122158099,IMR90|chr7:98972915-98972996,chr7,98972915,98972996,0,23185096
IMR90|chr7:122279375-122279470,chr7,122279375,122279470,IMR90|chr7:75155456-75155521,chr7,75155456,75155521,0,47123919
IMR90|chr7:122292876-122292915,chr7,122292876,122292915,IMR90|chr7:5633798-5633875,chr7,5633798,5633875,0,116659078
IMR90|chr7:122356418-122356441,chr7,122356418,122356441,IMR90|chr7:87847549-87847648,chr7,87847549,87847648,0,34508869
IMR90|chr7:122427445-122427515,chr7,122427445,122427515,IMR90|chr7:99519436-99519490,chr7,99519436,99519490,0,22908009
IMR90|chr7:122809854-122809905,chr7,122809854,122809905,IMR90|chr7:72820800-72820874,chr7,72820800,72820874,0,49989054
IMR90|chr7:122951519-122951536,chr7,122951519,122951536,IMR90|chr7:128380407-128380511,chr7,128380407,128380511,0,5428888
IMR90|chr7:123032644-123032791,chr7,123032644,123032791,IMR90|chr7:98740406-98740492,chr7,98740406,98740492,0,24292238
IMR90|chr7:123054801-123054881,chr7,123054801,123054881,IMR90|chr7:137533649-137533726,chr7,137533649,137533726,0,14478848
IMR90|chr7:123497721-123497810,chr7,123497721,123497810,IMR90|chr7:150077581-150077630,chr7,150077581,150077630,0,26579860
IMR90|chr7:123569376-123569434,chr7,123569376,123569434,IMR90|chr7:79086859-79086951,chr7,79086859,79086951,0,44482517
IMR90|chr7:123651906-123652009,chr7,123651906,123652009,IMR90|chr7:66385499-66385534,chr7,66385499,66385534,0,57266407
IMR90|chr7:123676454-123676581,chr7,123676454,123676581,IMR90|chr7:75510126-75510149,chr7,75510126,75510149,0,48166328
IMR90|chr7:124267757-124267789,chr7,124267757,124267789,IMR90|chr7:104653483-104653601,chr7,104653483,104653601,0,19614274
IMR90|chr7:124289233-124289274,chr7,124289233,124289274,IMR90|chr7:97906359-97906459,chr7,97906359,97906459,0,26382874
IMR90|chr7:124382335-124382374,chr7,124382335,124382374,IMR90|chr7:98740386-98740524,chr7,98740386,98740524,0,25641949
IMR90|chr7:125218594-125218673,chr7,125218594,125218673,IMR90|chr7:94025050-94025121,chr7,94025050,94025121,0,31193544
IMR90|chr7:125696967-125697007,chr7,125696967,125697007,IMR90|chr7:140399531-140399587,chr7,140399531,140399587,0,14702564
IMR90|chr7:125734838-125734884,chr7,125734838,125734884,IMR90|chr7:134467325-134467379,chr7,134467325,134467379,0,8732487
IMR90|chr7:125982560-125982596,chr7,125982560,125982596,IMR90|chr7:100772201-100772281,chr7,100772201,100772281,0,25210359
IMR90|chr7:126138457-126138503,chr7,126138457,126138503,IMR90|chr7:111845698-111845802,chr7,111845698,111845802,0,14292759
IMR90|chr7:126253419-126253462,chr7,126253419,126253462,IMR90|chr7:23571266-23571367,chr7,23571266,23571367,0,102682153
IMR90|chr7:126520138-126520204,chr7,126520138,126520204,IMR90|chr7:6774136-6774214,chr7,6774136,6774214,0,119746002
IMR90|chr7:126545770-126545825,chr7,126545770,126545825,IMR90|chr7:120966482-120966532,chr7,120966482,120966532,0,5579288
IMR90|chr7:126563174-126563195,chr7,126563174,126563195,IMR90|chr7:55088128-55088216,chr7,55088128,55088216,0,71475046
IMR90|chr7:127251837-127251874,chr7,127251837,127251874,IMR90|chr7:116169357-116169430,chr7,116169357,116169430,0,11082480
IMR90|chr7:127253185-127253268,chr7,127253185,127253268,IMR90|chr7:26243607-26243630,chr7,26243607,26243630,0,101009578
IMR90|chr7:127594757-127594820,chr7,127594757,127594820,IMR90|chr7:65580897-65580944,chr7,65580897,65580944,0,62013860
IMR90|chr7:127600047-127600170,chr7,127600047,127600170,IMR90|chr7:129707728-129707774,chr7,129707728,129707774,0,2107681
IMR90|chr7:127727967-127728032,chr7,127727967,127728032,IMR90|chr7:79081996-79082074,chr7,79081996,79082074,0,48645971
IMR90|chr7:127744749-127744800,chr7,127744749,127744800,IMR90|chr7:94024776-94024875,chr7,94024776,94024875,0,33719973
IMR90|chr7:127832762-127832811,chr7,127832762,127832811,IMR90|chr7:35841810-35841839,chr7,35841810,35841839,0,91990952
IMR90|chr7:127895714-127895782,chr7,127895714,127895782,IMR90|chr7:128379977-128380019,chr7,128379977,128380019,0,484263
IMR90|chr7:127979051-127979121,chr7,127979051,127979121,IMR90|chr7:23339309-23339333,chr7,23339309,23339333,0,104639742
IMR90|chr7:128209371-128209398,chr7,128209371,128209398,IMR90|chr7:100771554-100771648,chr7,100771554,100771648,0,27437817
IMR90|chr7:128343024-128343062,chr7,128343024,128343062,IMR90|chr7:97880951-97881023,chr7,97880951,97881023,0,30462073
IMR90|chr7:128510221-128510243,chr7,128510221,128510243,IMR90|chr7:97885518-97885622,chr7,97885518,97885622,0,30624703
IMR90|chr7:128542003-128542062,chr7,128542003,128542062,IMR90|chr7:105331746-105331826,chr7,105331746,105331826,0,23210257
IMR90|chr7:129029666-129029769,chr7,129029666,129029769,IMR90|chr7:75114379-75114439,chr7,75114379,75114439,0,53915287
IMR90|chr7:129130684-129130774,chr7,129130684,129130774,IMR90|chr7:100770799-100770855,chr7,100770799,100770855,0,28359885
IMR90|chr7:129689379-129689415,chr7,129689379,129689415,IMR90|chr7:120965815-120965958,chr7,120965815,120965958,0,8723564
IMR90|chr7:129725159-129725219,chr7,129725159,129725219,IMR90|chr7:65541435-65541483,chr7,65541435,65541483,0,64183724
IMR90|chr7:129792608-129792685,chr7,129792608,129792685,IMR90|chr7:75156805-75156867,chr7,75156805,75156867,0,54635803
IMR90|chr7:129818528-129818630,chr7,129818528,129818630,IMR90|chr7:130795596-130795644,chr7,130795596,130795644,0,977068
IMR90|chr7:129843774-129843833,chr7,129843774,129843833,IMR90|chr7:149194039-149194121,chr7,149194039,149194121,0,19350265
IMR90|chr7:130101404-130101434,chr7,130101404,130101434,IMR90|chr7:66205963-66206024,chr7,66205963,66206024,0,63895441
IMR90|chr7:130358589-130358668,chr7,130358589,130358668,IMR90|chr7:94025853-94025886,chr7,94025853,94025886,0,36332736
IMR90|chr7:130568489-130568639,chr7,130568489,130568639,IMR90|chr7:74491241-74491390,chr7,74491241,74491390,0,56077248
IMR90|chr7:130676191-130676248,chr7,130676191,130676248,IMR90|chr7:77166521-77166584,chr7,77166521,77166584,0,53509670
IMR90|chr7:130843359-130843397,chr7,130843359,130843397,IMR90|chr7:130794454-130794527,chr7,130794454,130794527,0,48905
IMR90|chr7:130859223-130859291,chr7,130859223,130859291,IMR90|chr7:100771007-100771085,chr7,100771007,100771085,0,30088216
IMR90|chr7:131120578-131120668,chr7,131120578,131120668,IMR90|chr7:75986805-75986823,chr7,75986805,75986823,0,55133773
IMR90|chr7:131374928-131375039,chr7,131374928,131375039,IMR90|chr7:140339438-140339477,chr7,140339438,140339477,0,8964510
IMR90|chr7:131474054-131474078,chr7,131474054,131474078,IMR90|chr7:116168858-116168955,chr7,116168858,116168955,0,15305196
IMR90|chr7:131483557-131483611,chr7,131483557,131483611,IMR90|chr7:2668690-2668766,chr7,2668690,2668766,0,128814867
IMR90|chr7:131487236-131487289,chr7,131487236,131487289,IMR90|chr7:100771926-100772064,chr7,100771926,100772064,0,30715310
IMR90|chr7:131657810-131657879,chr7,131657810,131657879,IMR90|chr7:100770981-100771062,chr7,100770981,100771062,0,30886829
IMR90|chr7:131934421-131934482,chr7,131934421,131934482,IMR90|chr7:72819514-72819564,chr7,72819514,72819564,0,59114907
IMR90|chr7:132415667-132415720,chr7,132415667,132415720,IMR90|chr7:100772529-100772572,chr7,100772529,100772572,0,31643138
IMR90|chr7:132949872-132949928,chr7,132949872,132949928,IMR90|chr7:137686093-137686158,chr7,137686093,137686158,0,4736221
IMR90|chr7:133005736-133005785,chr7,133005736,133005785,IMR90|chr7:192709-192805,chr7,192709,192805,0,132813027
IMR90|chr7:133047458-133047501,chr7,133047458,133047501,IMR90|chr7:23571266-23571367,chr7,23571266,23571367,0,109476192
IMR90|chr7:133183020-133183067,chr7,133183020,133183067,IMR90|chr7:100771388-100771446,chr7,100771388,100771446,0,32411632
IMR90|chr7:133200786-133200824,chr7,133200786,133200824,IMR90|chr7:72820423-72820552,chr7,72820423,72820552,0,60380363
IMR90|chr7:133289796-133289924,chr7,133289796,133289924,IMR90|chr7:66206388-66206446,chr7,66206388,66206446,0,67083408
IMR90|chr7:133368418-133368451,chr7,133368418,133368451,IMR90|chr7:104649786-104649871,chr7,104649786,104649871,0,28718632
IMR90|chr7:133502613-133502741,chr7,133502613,133502741,IMR90|chr7:66206388-66206446,chr7,66206388,66206446,0,67296225
IMR90|chr7:133577569-133577661,chr7,133577569,133577661,IMR90|chr7:137536556-137536604,chr7,137536556,137536604,0,3958987
IMR90|chr7:134168432-134168472,chr7,134168432,134168472,IMR90|chr7:100771448-100771478,chr7,100771448,100771478,0,33396984
IMR90|chr7:134427931-134428016,chr7,134427931,134428016,IMR90|chr7:100771285-100771326,chr7,100771285,100771326,0,33656646
IMR90|chr7:134899136-134899232,chr7,134899136,134899232,IMR90|chr7:137686093-137686158,chr7,137686093,137686158,0,2786957
IMR90|chr7:135239897-135239931,chr7,135239897,135239931,IMR90|chr7:100857413-100857510,chr7,100857413,100857510,0,34382484
IMR90|chr7:135352200-135352331,chr7,135352200,135352331,IMR90|chr7:44837868-44837896,chr7,44837868,44837896,0,90514332
IMR90|chr7:135407035-135407137,chr7,135407035,135407137,IMR90|chr7:100773127-100773157,chr7,100773127,100773157,0,34633908
IMR90|chr7:135573652-135573705,chr7,135573652,135573705,IMR90|chr7:143080627-143080719,chr7,143080627,143080719,0,7506975
IMR90|chr7:135609504-135609597,chr7,135609504,135609597,IMR90|chr7:120962856-120962922,chr7,120962856,120962922,0,14646648
IMR90|chr7:135759855-135759889,chr7,135759855,135759889,IMR90|chr7:100857413-100857510,chr7,100857413,100857510,0,34902442
IMR90|chr7:135910544-135910691,chr7,135910544,135910691,IMR90|chr7:98740406-98740492,chr7,98740406,98740492,0,37170138
IMR90|chr7:135951842-135951881,chr7,135951842,135951881,IMR90|chr7:157130897-157130973,chr7,157130897,157130973,0,21179055
IMR90|chr7:135959649-135959674,chr7,135959649,135959674,IMR90|chr7:116166854-116166937,chr7,116166854,116166937,0,19792795
IMR90|chr7:135969627-135969684,chr7,135969627,135969684,IMR90|chr7:77166521-77166584,chr7,77166521,77166584,0,58803106
IMR90|chr7:136040387-136040440,chr7,136040387,136040440,IMR90|chr7:137535909-137536005,chr7,137535909,137536005,0,1495522
IMR90|chr7:136071588-136071617,chr7,136071588,136071617,IMR90|chr7:129592069-129592153,chr7,129592069,129592153,0,6479519
IMR90|chr7:136135122-136135185,chr7,136135122,136135185,IMR90|chr7:131012237-131012326,chr7,131012237,131012326,0,5122885
IMR90|chr7:136187219-136187255,chr7,136187219,136187255,IMR90|chr7:131014107-131014201,chr7,131014107,131014201,0,5173112
IMR90|chr7:136494718-136494767,chr7,136494718,136494767,IMR90|chr7:100773024-100773125,chr7,100773024,100773125,0,35721694
IMR90|chr7:136797117-136797233,chr7,136797117,136797233,IMR90|chr7:100771055-100771123,chr7,100771055,100771123,0,36026062
IMR90|chr7:136842325-136842398,chr7,136842325,136842398,IMR90|chr7:100771046-100771084,chr7,100771046,100771084,0,36071279
IMR90|chr7:137038223-137038299,chr7,137038223,137038299,IMR90|chr7:74491275-74491341,chr7,74491275,74491341,0,62546948
IMR90|chr7:137042240-137042279,chr7,137042240,137042279,IMR90|chr7:120966485-120966575,chr7,120966485,120966575,0,16075755
IMR90|chr7:137075364-137075465,chr7,137075364,137075465,IMR90|chr7:104652034-104652086,chr7,104652034,104652086,0,32423330
IMR90|chr7:137079996-137080028,chr7,137079996,137080028,IMR90|chr7:100771423-100771536,chr7,100771423,100771536,0,36308573
IMR90|chr7:137259842-137259869,chr7,137259842,137259869,IMR90|chr7:100772082-100772197,chr7,100772082,100772197,0,36487760
IMR90|chr7:137274069-137274121,chr7,137274069,137274121,IMR90|chr7:107642780-107642927,chr7,107642780,107642927,0,29631289
IMR90|chr7:137399145-137399199,chr7,137399145,137399199,IMR90|chr7:149536187-149536220,chr7,149536187,149536220,0,12137042
IMR90|chr7:137793621-137793701,chr7,137793621,137793701,IMR90|chr7:42274896-42274935,chr7,42274896,42274935,0,95518725
IMR90|chr7:137880067-137880136,chr7,137880067,137880136,IMR90|chr7:23339309-23339333,chr7,23339309,23339333,0,114540758
IMR90|chr7:138054803-138054851,chr7,138054803,138054851,IMR90|chr7:74491125-74491234,chr7,74491125,74491234,0,63563678
IMR90|chr7:138545274-138545306,chr7,138545274,138545306,IMR90|chr7:104649786-104649871,chr7,104649786,104649871,0,33895488
IMR90|chr7:138826865-138826945,chr7,138826865,138826945,IMR90|chr7:77426781-77426842,chr7,77426781,77426842,0,61400084
IMR90|chr7:139300426-139300481,chr7,139300426,139300481,IMR90|chr7:143080627-143080719,chr7,143080627,143080719,0,3780201
IMR90|chr7:139438410-139438431,chr7,139438410,139438431,IMR90|chr7:97885518-97885622,chr7,97885518,97885622,0,41552892
IMR90|chr7:139643823-139643877,chr7,139643823,139643877,IMR90|chr7:135195067-135195163,chr7,135195067,135195163,0,4448756
IMR90|chr7:139728136-139728167,chr7,139728136,139728167,IMR90|chr7:73866010-73866079,chr7,73866010,73866079,0,65862126
IMR90|chr7:140012344-140012402,chr7,140012344,140012402,IMR90|chr7:102252179-102252260,chr7,102252179,102252260,0,37760165
IMR90|chr7:140758832-140758863,chr7,140758832,140758863,IMR90|chr7:100771423-100771536,chr7,100771423,100771536,0,39987409
IMR90|chr7:140772604-140772644,chr7,140772604,140772644,IMR90|chr7:100074678-100074785,chr7,100074678,100074785,0,40697926
IMR90|chr7:141307134-141307216,chr7,141307134,141307216,IMR90|chr7:100728213-100728229,chr7,100728213,100728229,0,40578921
IMR90|chr7:141451164-141451223,chr7,141451164,141451223,IMR90|chr7:105331746-105331826,chr7,105331746,105331826,0,36119418
IMR90|chr7:141786756-141786781,chr7,141786756,141786781,IMR90|chr7:100772405-100772498,chr7,100772405,100772498,0,41014351
IMR90|chr7:141800927-141800947,chr7,141800927,141800947,IMR90|chr7:90891171-90891301,chr7,90891171,90891301,0,50909756
IMR90|chr7:141980897-141981001,chr7,141980897,141981001,IMR90|chr7:129588762-129588808,chr7,129588762,129588808,0,12392135
IMR90|chr7:142194370-142194421,chr7,142194370,142194421,IMR90|chr7:97915386-97915511,chr7,97915386,97915511,0,44278984
IMR90|chr7:142408067-142408106,chr7,142408067,142408106,IMR90|chr7:140339371-140339411,chr7,140339371,140339411,0,2068696
IMR90|chr7:142814032-142814132,chr7,142814032,142814132,IMR90|chr7:137535416-137535441,chr7,137535416,137535441,0,5278616
IMR90|chr7:142855251-142855308,chr7,142855251,142855308,IMR90|chr7:74490080-74490173,chr7,74490080,74490173,0,68365171
IMR90|chr7:142880176-142880214,chr7,142880176,142880214,IMR90|chr7:192786-192858,chr7,192786,192858,0,142687390
IMR90|chr7:143114798-143114856,chr7,143114798,143114856,IMR90|chr7:137533649-137533726,chr7,137533649,137533726,0,5581149
IMR90|chr7:143315883-143315957,chr7,143315883,143315957,IMR90|chr7:2668690-2668766,chr7,2668690,2668766,0,140647193
IMR90|chr7:143379076-143379191,chr7,143379076,143379191,IMR90|chr7:100729417-100729510,chr7,100729417,100729510,0,42649659
IMR90|chr7:143524928-143525057,chr7,143524928,143525057,IMR90|chr7:143081665-143081686,chr7,143081665,143081686,0,443263
IMR90|chr7:143622489-143622530,chr7,143622489,143622530,IMR90|chr7:97906359-97906459,chr7,97906359,97906459,0,45716130
IMR90|chr7:143789914-143789934,chr7,143789914,143789934,IMR90|chr7:102252169-102252260,chr7,102252169,102252260,0,41537745
IMR90|chr7:144108082-144108118,chr7,144108082,144108118,IMR90|chr7:100771558-100771610,chr7,100771558,100771610,0,43336524
IMR90|chr7:144126035-144126118,chr7,144126035,144126118,IMR90|chr7:130127278-130127300,chr7,130127278,130127300,0,13998757
IMR90|chr7:144621575-144621663,chr7,144621575,144621663,IMR90|chr7:55088271-55088299,chr7,55088271,55088299,0,89533304
IMR90|chr7:144624701-144624765,chr7,144624701,144624765,IMR90|chr7:23571266-23571367,chr7,23571266,23571367,0,121053435
IMR90|chr7:144739504-144739599,chr7,144739504,144739599,IMR90|chr7:75155456-75155521,chr7,75155456,75155521,0,69584048
IMR90|chr7:144846766-144846808,chr7,144846766,144846808,IMR90|chr7:102252144-102252260,chr7,102252144,102252260,0,42594622
IMR90|chr7:144904539-144904638,chr7,144904539,144904638,IMR90|chr7:130134298-130134349,chr7,130134298,130134349,0,14770241
IMR90|chr7:145006353-145006414,chr7,145006353,145006414,IMR90|chr7:97596955-97597030,chr7,97596955,97597030,0,47409398
IMR90|chr7:145207169-145207265,chr7,145207169,145207265,IMR90|chr7:137686093-137686158,chr7,137686093,137686158,0,7521076
IMR90|chr7:145360889-145360975,chr7,145360889,145360975,IMR90|chr7:142986450-142986511,chr7,142986450,142986511,0,2374439
IMR90|chr7:145568018-145568110,chr7,145568018,145568110,IMR90|chr7:66206388-66206446,chr7,66206388,66206446,0,79361630
IMR90|chr7:145584435-145584483,chr7,145584435,145584483,IMR90|chr7:79086849-79086951,chr7,79086849,79086951,0,66497586
IMR90|chr7:145837990-145838052,chr7,145837990,145838052,IMR90|chr7:138719685-138719759,chr7,138719685,138719759,0,7118305
IMR90|chr7:146012494-146012537,chr7,146012494,146012537,IMR90|chr7:115849670-115849778,chr7,115849670,115849778,0,30162824
IMR90|chr7:146222294-146222377,chr7,146222294,146222377,IMR90|chr7:130127278-130127300,chr7,130127278,130127300,0,16095016
IMR90|chr7:146252430-146252463,chr7,146252430,146252463,IMR90|chr7:75986805-75986823,chr7,75986805,75986823,0,70265625
IMR90|chr7:146643044-146643072,chr7,146643044,146643072,IMR90|chr7:100466603-100466678,chr7,100466603,100466678,0,46176441
IMR90|chr7:146749178-146749213,chr7,146749178,146749213,IMR90|chr7:137534569-137534658,chr7,137534569,137534658,0,9214609
IMR90|chr7:146755190-146755289,chr7,146755190,146755289,IMR90|chr7:100772584-100772608,chr7,100772584,100772608,0,45982606
IMR90|chr7:146775067-146775147,chr7,146775067,146775147,IMR90|chr7:130794996-130795049,chr7,130794996,130795049,0,15980071
IMR90|chr7:146805563-146805629,chr7,146805563,146805629,IMR90|chr7:105518785-105518844,chr7,105518785,105518844,0,41286778
IMR90|chr7:146811403-146811460,chr7,146811403,146811460,IMR90|chr7:116165879-116165912,chr7,116165879,116165912,0,30645524
IMR90|chr7:147091402-147091445,chr7,147091402,147091445,IMR90|chr7:5633798-5633875,chr7,5633798,5633875,0,141457604
IMR90|chr7:147405360-147405401,chr7,147405360,147405401,IMR90|chr7:6774534-6774594,chr7,6774534,6774594,0,140630826
IMR90|chr7:147505959-147505998,chr7,147505959,147505998,IMR90|chr7:100181367-100181462,chr7,100181367,100181462,0,47324592
IMR90|chr7:147924755-147924808,chr7,147924755,147924808,IMR90|chr7:44084863-44084991,chr7,44084863,44084991,0,103839892
IMR90|chr7:147931108-147931162,chr7,147931108,147931162,IMR90|chr7:111844011-111844101,chr7,111844011,111844101,0,36087097
IMR90|chr7:148031353-148031396,chr7,148031353,148031396,IMR90|chr7:5633798-5633875,chr7,5633798,5633875,0,142397555
IMR90|chr7:148043666-148043718,chr7,148043666,148043718,IMR90|chr7:26244816-26244893,chr7,26244816,26244893,0,121798850
IMR90|chr7:148647244-148647279,chr7,148647244,148647279,IMR90|chr7:100771558-100771610,chr7,100771558,100771610,0,47875686
IMR90|chr7:148711383-148711455,chr7,148711383,148711455,IMR90|chr7:94024772-94024848,chr7,94024772,94024848,0,54686611
IMR90|chr7:148747731-148747816,chr7,148747731,148747816,IMR90|chr7:66205876-66205924,chr7,66205876,66205924,0,82541855
IMR90|chr7:148897797-148897861,chr7,148897797,148897861,IMR90|chr7:192741-192763,chr7,192741,192763,0,148705056
IMR90|chr7:148916560-148916623,chr7,148916560,148916623,IMR90|chr7:5185581-5185609,chr7,5185581,5185609,0,143730979
IMR90|chr7:149010687-149010751,chr7,149010687,149010751,IMR90|chr7:97914670-97914771,chr7,97914670,97914771,0,51096017
IMR90|chr7:149162329-149162446,chr7,149162329,149162446,IMR90|chr7:100770981-100771062,chr7,100770981,100771062,0,48391348
IMR90|chr7:149163306-149163351,chr7,149163306,149163351,IMR90|chr7:120963791-120963820,chr7,120963791,120963820,0,28199515
IMR90|chr7:149350187-149350276,chr7,149350187,149350276,IMR90|chr7:2673292-2673350,chr7,2673292,2673350,0,146676895
IMR90|chr7:149365568-149365623,chr7,149365568,149365623,IMR90|chr7:100771086-100771181,chr7,100771086,100771181,0,48594482
IMR90|chr7:149634765-149634915,chr7,149634765,149634915,IMR90|chr7:64364487-64364622,chr7,64364487,64364622,0,85270278
IMR90|chr7:149716079-149716147,chr7,149716079,149716147,IMR90|chr7:120968643-120968717,chr7,120968643,120968717,0,28747436
IMR90|chr7:150174823-150174841,chr7,150174823,150174841,IMR90|chr7:128380407-128380511,chr7,128380407,128380511,0,21794416
IMR90|chr7:150267432-150267495,chr7,150267432,150267495,IMR90|chr7:137684173-137684260,chr7,137684173,137684260,0,12583259
IMR90|chr7:150597752-150597810,chr7,150597752,150597810,IMR90|chr7:131012237-131012326,chr7,131012237,131012326,0,19585515
IMR90|chr7:150656253-150656292,chr7,150656253,150656292,IMR90|chr7:100772400-100772501,chr7,100772400,100772501,0,49883853
IMR90|chr7:150666933-150666962,chr7,150666933,150666962,IMR90|chr7:5634920-5634952,chr7,5634920,5634952,0,145032013
IMR90|chr7:150804832-150804864,chr7,150804832,150804864,IMR90|chr7:104653483-104653601,chr7,104653483,104653601,0,46151349
IMR90|chr7:151093600-151093648,chr7,151093600,151093648,IMR90|chr7:104652848-104652884,chr7,104652848,104652884,0,46440752
IMR90|chr7:151106558-151106621,chr7,151106558,151106621,IMR90|chr7:102252134-102252260,chr7,102252134,102252260,0,48854424
IMR90|chr7:151287230-151287301,chr7,151287230,151287301,IMR90|chr7:66093208-66093256,chr7,66093208,66093256,0,85194022
IMR90|chr7:151464980-151465064,chr7,151464980,151465064,IMR90|chr7:1573947-1573969,chr7,1573947,1573969,0,149891033
IMR90|chr7:151528698-151528762,chr7,151528698,151528762,IMR90|chr7:90891171-90891301,chr7,90891171,90891301,0,60637527
IMR90|chr7:151574022-151574086,chr7,151574022,151574086,IMR90|chr7:74491151-74491233,chr7,74491151,74491233,0,77082871
IMR90|chr7:151578179-151578228,chr7,151578179,151578228,IMR90|chr7:134467325-134467379,chr7,134467325,134467379,0,17110854
IMR90|chr7:151595408-151595498,chr7,151595408,151595498,IMR90|chr7:100770799-100770855,chr7,100770799,100770855,0,50824609
IMR90|chr7:151619017-151619167,chr7,151619017,151619167,IMR90|chr7:74491336-74491486,chr7,74491336,74491486,0,77127681
IMR90|chr7:151799106-151799144,chr7,151799106,151799144,IMR90|chr7:130794454-130794527,chr7,130794454,130794527,0,21004652
IMR90|chr7:151915832-151915918,chr7,151915832,151915918,IMR90|chr7:130127278-130127300,chr7,130127278,130127300,0,21788554
IMR90|chr7:152109061-152109110,chr7,152109061,152109110,IMR90|chr7:102252189-102252282,chr7,102252189,102252282,0,49856872
IMR90|chr7:152218503-152218611,chr7,152218503,152218611,IMR90|chr7:44615859-44615885,chr7,44615859,44615885,0,107602644
IMR90|chr7:152527402-152527452,chr7,152527402,152527452,IMR90|chr7:98740406-98740492,chr7,98740406,98740492,0,53786996
IMR90|chr7:152570395-152570460,chr7,152570395,152570460,IMR90|chr7:156687411-156687494,chr7,156687411,156687494,0,4117016
IMR90|chr7:152653065-152653114,chr7,152653065,152653114,IMR90|chr7:23531640-23531683,chr7,23531640,23531683,0,129121425
IMR90|chr7:152669610-152669646,chr7,152669610,152669646,IMR90|chr7:100771558-100771610,chr7,100771558,100771610,0,51898052
IMR90|chr7:152883845-152883903,chr7,152883845,152883903,IMR90|chr7:75550362-75550435,chr7,75550362,75550435,0,77333483
IMR90|chr7:152939561-152939615,chr7,152939561,152939615,IMR90|chr7:100772488-100772571,chr7,100772488,100772571,0,52167073
IMR90|chr7:153037578-153037634,chr7,153037578,153037634,IMR90|chr7:5636144-5636227,chr7,5636144,5636227,0,147401434
IMR90|chr7:153235324-153235353,chr7,153235324,153235353,IMR90|chr7:5634920-5634952,chr7,5634920,5634952,0,147600404
IMR90|chr7:153762464-153762534,chr7,153762464,153762534,IMR90|chr7:111844817-111844855,chr7,111844817,111844855,0,41917647
IMR90|chr7:153871555-153871655,chr7,153871555,153871655,IMR90|chr7:97911863-97911912,chr7,97911863,97911912,0,55959692
IMR90|chr7:153932543-153932598,chr7,153932543,153932598,IMR90|chr7:100771086-100771181,chr7,100771086,100771181,0,53161457
IMR90|chr7:154113089-154113171,chr7,154113089,154113171,IMR90|chr7:100771055-100771123,chr7,100771055,100771123,0,53342034
IMR90|chr7:154389376-154389431,chr7,154389376,154389431,IMR90|chr7:152130919-152131004,chr7,152130919,152131004,0,2258457
IMR90|chr7:154467341-154467448,chr7,154467341,154467448,IMR90|chr7:41738875-41738930,chr7,41738875,41738930,0,112728466
IMR90|chr7:154617222-154617255,chr7,154617222,154617255,IMR90|chr7:128472194-128472272,chr7,128472194,128472272,0,26145028
IMR90|chr7:154874141-154874209,chr7,154874141,154874209,IMR90|chr7:45040985-45041055,chr7,45040985,45041055,0,109833156
IMR90|chr7:154932366-154932482,chr7,154932366,154932482,IMR90|chr7:100771055-100771123,chr7,100771055,100771123,0,54161311
IMR90|chr7:155571272-155571296,chr7,155571272,155571296,IMR90|chr7:35841126-35841251,chr7,35841126,35841251,0,119730146
IMR90|chr7:155737454-155737508,chr7,155737454,155737508,IMR90|chr7:137532953-137533040,chr7,137532953,137533040,0,18204501
IMR90|chr7:155846673-155846726,chr7,155846673,155846726,IMR90|chr7:143080627-143080719,chr7,143080627,143080719,0,12766046
IMR90|chr7:155959453-155959481,chr7,155959453,155959481,IMR90|chr7:137684889-137685010,chr7,137684889,137685010,0,18274564
IMR90|chr7:156197651-156197745,chr7,156197651,156197745,IMR90|chr7:129708683-129708763,chr7,129708683,129708763,0,26488968
IMR90|chr7:156423300-156423332,chr7,156423300,156423332,IMR90|chr7:104649786-104649871,chr7,104649786,104649871,0,51773514
IMR90|chr7:156440776-156440831,chr7,156440776,156440831,IMR90|chr7:100728969-100729054,chr7,100728969,100729054,0,55711807
IMR90|chr7:156458423-156458481,chr7,156458423,156458481,IMR90|chr7:79086859-79086951,chr7,79086859,79086951,0,77371564
IMR90|chr7:156490300-156490406,chr7,156490300,156490406,IMR90|chr7:100074444-100074467,chr7,100074444,100074467,0,56415856
IMR90|chr7:156603925-156603988,chr7,156603925,156603988,IMR90|chr7:5185581-5185609,chr7,5185581,5185609,0,151418344
IMR90|chr7:156815798-156815830,chr7,156815798,156815830,IMR90|chr7:90224759-90224870,chr7,90224759,90224870,0,66591039
IMR90|chr7:156910670-156910820,chr7,156910670,156910820,IMR90|chr7:129590865-129590900,chr7,129590865,129590900,0,27319805
IMR90|chr7:156910946-156910991,chr7,156910946,156910991,IMR90|chr7:74067704-74067773,chr7,74067704,74067773,0,82843242
IMR90|chr7:156916277-156916365,chr7,156916277,156916365,IMR90|chr7:2673292-2673350,chr7,2673292,2673350,0,154242985
IMR90|chr7:157042138-157042200,chr7,157042138,157042200,IMR90|chr7:102252111-102252195,chr7,102252111,102252195,0,54790027
IMR90|chr7:157168157-157168217,chr7,157168157,157168217,IMR90|chr7:65541435-65541483,chr7,65541435,65541483,0,91626722
IMR90|chr7:157275443-157275485,chr7,157275443,157275485,IMR90|chr7:120966485-120966575,chr7,120966485,120966575,0,36308958
IMR90|chr7:157563719-157563754,chr7,157563719,157563754,IMR90|chr7:137534569-137534658,chr7,137534569,137534658,0,20029150
IMR90|chr7:158023654-158023690,chr7,158023654,158023690,IMR90|chr7:131014107-131014201,chr7,131014107,131014201,0,27009547
IMR90|chr7:158331540-158331567,chr7,158331540,158331567,IMR90|chr7:65956454-65956529,chr7,65956454,65956529,0,92375086
IMR90|chr7:158390883-158391013,chr7,158390883,158391013,IMR90|chr7:98739825-98739878,chr7,98739825,98739878,0,59651058
IMR90|chr7:158441532-158441553,chr7,158441532,158441553,IMR90|chr7:192821-192888,chr7,192821,192888,0,158248711
IMR90|chr7:158476739-158476788,chr7,158476739,158476788,IMR90|chr7:65956840-65956972,chr7,65956840,65956972,0,92519899
IMR90|chr8:68911-69004,chr8,68911,69004,IMR90|chr8:42395335-42395394,chr8,42395335,42395394,0,42326424
IMR90|chr8:137945-137965,chr8,137945,137965,IMR90|chr8:38857331-38857369,chr8,38857331,38857369,0,38719386
IMR90|chr8:474330-474442,chr8,474330,474442,IMR90|chr8:11724120-11724144,chr8,11724120,11724144,0,11249790
IMR90|chr8:617824-617942,chr8,617824,617942,IMR90|chr8:49296845-49296874,chr8,49296845,49296874,0,48679021
IMR90|chr8:676377-676398,chr8,676377,676398,IMR90|chr8:104384332-104384432,chr8,104384332,104384432,0,103707955
IMR90|chr8:812449-812499,chr8,812449,812499,IMR90|chr8:23146692-23146842,chr8,23146692,23146842,0,22334243
IMR90|chr8:889632-889700,chr8,889632,889700,IMR90|chr8:11720751-11720821,chr8,11720751,11720821,0,10831119
IMR90|chr8:943052-943111,chr8,943052,943111,IMR90|chr8:124086055-124086205,chr8,124086055,124086205,0,123143003
IMR90|chr8:1188339-1188361,chr8,1188339,1188361,IMR90|chr8:104384332-104384432,chr8,104384332,104384432,0,103195993
IMR90|chr8:1195501-1195651,chr8,1195501,1195651,IMR90|chr8:11722756-11722814,chr8,11722756,11722814,0,10527255
IMR90|chr8:1272143-1272190,chr8,1272143,1272190,IMR90|chr8:90770863-90770931,chr8,90770863,90770931,0,89498720
IMR90|chr8:1707136-1707184,chr8,1707136,1707184,IMR90|chr8:119122183-119122231,chr8,119122183,119122231,0,117415047
IMR90|chr8:1732723-1732745,chr8,1732723,1732745,IMR90|chr8:49294643-49294771,chr8,49294643,49294771,0,47561920
IMR90|chr8:1966737-1966828,chr8,1966737,1966828,IMR90|chr8:104385851-104385872,chr8,104385851,104385872,0,102419114
IMR90|chr8:2498411-2498516,chr8,2498411,2498516,IMR90|chr8:94750991-94751018,chr8,94750991,94751018,0,92252580
IMR90|chr8:2579888-2579940,chr8,2579888,2579940,IMR90|chr8:107077706-107077777,chr8,107077706,107077777,0,104497818
IMR90|chr8:2657564-2657641,chr8,2657564,2657641,IMR90|chr8:131455068-131455115,chr8,131455068,131455115,0,128797504
IMR90|chr8:2722372-2722454,chr8,2722372,2722454,IMR90|chr8:145021384-145021424,chr8,145021384,145021424,0,142299012
IMR90|chr8:3065457-3065502,chr8,3065457,3065502,IMR90|chr8:18871935-18872040,chr8,18871935,18872040,0,15806478
IMR90|chr8:3370417-3370522,chr8,3370417,3370522,IMR90|chr8:117781305-117781350,chr8,117781305,117781350,0,114410888
IMR90|chr8:3435374-3435428,chr8,3435374,3435428,IMR90|chr8:116679859-116679953,chr8,116679859,116679953,0,113244485
IMR90|chr8:3637740-3637801,chr8,3637740,3637801,IMR90|chr8:101732566-101732609,chr8,101732566,101732609,0,98094826
IMR90|chr8:3928404-3928438,chr8,3928404,3928438,IMR90|chr8:55012769-55012828,chr8,55012769,55012828,0,51084365
IMR90|chr8:4425731-4425836,chr8,4425731,4425836,IMR90|chr8:117781305-117781350,chr8,117781305,117781350,0,113355574
IMR90|chr8:4818776-4818829,chr8,4818776,4818829,IMR90|chr8:62625800-62625862,chr8,62625800,62625862,0,57807024
IMR90|chr8:4836861-4836919,chr8,4836861,4836919,IMR90|chr8:128752070-128752131,chr8,128752070,128752131,0,123915209
IMR90|chr8:5069219-5069283,chr8,5069219,5069283,IMR90|chr8:116677372-116677416,chr8,116677372,116677416,0,111608153
IMR90|chr8:5705953-5705973,chr8,5705953,5705973,IMR90|chr8:38857331-38857369,chr8,38857331,38857369,0,33151378
IMR90|chr8:5732512-5732549,chr8,5732512,5732549,IMR90|chr8:119120476-119120575,chr8,119120476,119120575,0,113387964
IMR90|chr8:6669984-6670046,chr8,6669984,6670046,IMR90|chr8:119118645-119118708,chr8,119118645,119118708,0,112448661
IMR90|chr8:6817334-6817395,chr8,6817334,6817395,IMR90|chr8:11323190-11323256,chr8,11323190,11323256,0,4505856
IMR90|chr8:7333206-7333234,chr8,7333206,7333234,IMR90|chr8:11724505-11724548,chr8,11724505,11724548,0,4391299
IMR90|chr8:7482433-7482448,chr8,7482433,7482448,IMR90|chr8:25315326-25315430,chr8,25315326,25315430,0,17832893
IMR90|chr8:7621026-7621083,chr8,7621026,7621083,IMR90|chr8:62626023-62626064,chr8,62626023,62626064,0,55004997
IMR90|chr8:7685390-7685448,chr8,7685390,7685448,IMR90|chr8:128752070-128752131,chr8,128752070,128752131,0,121066680
IMR90|chr8:8052476-8052555,chr8,8052476,8052555,IMR90|chr8:128749536-128749588,chr8,128749536,128749588,0,120697060
IMR90|chr8:8165263-8165407,chr8,8165263,8165407,IMR90|chr8:119119067-119119104,chr8,119119067,119119104,0,110953804
IMR90|chr8:8524470-8524559,chr8,8524470,8524559,IMR90|chr8:11722756-11722814,chr8,11722756,11722814,0,3198286
IMR90|chr8:8666508-8666548,chr8,8666508,8666548,IMR90|chr8:128750209-128750291,chr8,128750209,128750291,0,120083701
IMR90|chr8:8777689-8777756,chr8,8777689,8777756,IMR90|chr8:144677146-144677229,chr8,144677146,144677229,0,135899457
IMR90|chr8:9041800-9041848,chr8,9041800,9041848,IMR90|chr8:145154317-145154452,chr8,145154317,145154452,0,136112517
IMR90|chr8:9132031-9132081,chr8,9132031,9132081,IMR90|chr8:23146692-23146842,chr8,23146692,23146842,0,14014661
IMR90|chr8:9285129-9285180,chr8,9285129,9285180,IMR90|chr8:124290586-124290631,chr8,124290586,124290631,0,115005457
IMR90|chr8:9321420-9321567,chr8,9321420,9321567,IMR90|chr8:37656476-37656515,chr8,37656476,37656515,0,28335056
IMR90|chr8:9404327-9404371,chr8,9404327,9404371,IMR90|chr8:17017991-17018072,chr8,17017991,17018072,0,7613664
IMR90|chr8:10187346-10187396,chr8,10187346,10187396,IMR90|chr8:134582012-134582091,chr8,134582012,134582091,0,124394666
IMR90|chr8:10405038-10405123,chr8,10405038,10405123,IMR90|chr8:144677257-144677303,chr8,144677257,144677303,0,134272219
IMR90|chr8:10648616-10648685,chr8,10648616,10648685,IMR90|chr8:62624548-62624616,chr8,62624548,62624616,0,51975932
IMR90|chr8:10753931-10754020,chr8,10753931,10754020,IMR90|chr8:99055769-99055830,chr8,99055769,99055830,0,88301838
IMR90|chr8:10761394-10761426,chr8,10761394,10761426,IMR90|chr8:126444064-126444140,chr8,126444064,126444140,0,115682670
IMR90|chr8:11460489-11460523,chr8,11460489,11460523,IMR90|chr8:145046285-145046418,chr8,145046285,145046418,0,133585796
IMR90|chr8:12569704-12569776,chr8,12569704,12569776,IMR90|chr8:141646071-141646142,chr8,141646071,141646142,0,129076367
IMR90|chr8:13050235-13050266,chr8,13050235,13050266,IMR90|chr8:1918808-1918849,chr8,1918808,1918849,0,11131427
IMR90|chr8:13117377-13117430,chr8,13117377,13117430,IMR90|chr8:104387833-104387888,chr8,104387833,104387888,0,91270456
IMR90|chr8:13314890-13314944,chr8,13314890,13314944,IMR90|chr8:128749201-128749273,chr8,128749201,128749273,0,115434311
IMR90|chr8:13678413-13678453,chr8,13678413,13678453,IMR90|chr8:62625842-62625866,chr8,62625842,62625866,0,48947429
IMR90|chr8:14445247-14445333,chr8,14445247,14445333,IMR90|chr8:61430593-61430651,chr8,61430593,61430651,0,46985346
IMR90|chr8:14598060-14598154,chr8,14598060,14598154,IMR90|chr8:128752276-128752359,chr8,128752276,128752359,0,114154216
IMR90|chr8:15079514-15079564,chr8,15079514,15079564,IMR90|chr8:49294643-49294771,chr8,49294643,49294771,0,34215129
IMR90|chr8:15377577-15377642,chr8,15377577,15377642,IMR90|chr8:74884138-74884216,chr8,74884138,74884216,0,59506561
IMR90|chr8:15602082-15602195,chr8,15602082,15602195,IMR90|chr8:119119067-119119104,chr8,119119067,119119104,0,103516985
IMR90|chr8:16361174-16361256,chr8,16361174,16361256,IMR90|chr8:11720117-11720161,chr8,11720117,11720161,0,4641057
IMR90|chr8:16700732-16700770,chr8,16700732,16700770,IMR90|chr8:11327949-11328009,chr8,11327949,11328009,0,5372783
IMR90|chr8:16857224-16857342,chr8,16857224,16857342,IMR90|chr8:142140408-142140496,chr8,142140408,142140496,0,125283184
IMR90|chr8:17438692-17438825,chr8,17438692,17438825,IMR90|chr8:48922044-48922096,chr8,48922044,48922096,0,31483352
IMR90|chr8:17502295-17502335,chr8,17502295,17502335,IMR90|chr8:107077706-107077792,chr8,107077706,107077792,0,89575411
IMR90|chr8:17974292-17974396,chr8,17974292,17974396,IMR90|chr8:20082508-20082554,chr8,20082508,20082554,0,2108216
IMR90|chr8:18421171-18421248,chr8,18421171,18421248,IMR90|chr8:131455068-131455115,chr8,131455068,131455115,0,113033897
IMR90|chr8:18784433-18784514,chr8,18784433,18784514,IMR90|chr8:66751025-66751080,chr8,66751025,66751080,0,47966592
IMR90|chr8:19022416-19022458,chr8,19022416,19022458,IMR90|chr8:42051767-42051860,chr8,42051767,42051860,0,23029351
IMR90|chr8:19488645-19488733,chr8,19488645,19488733,IMR90|chr8:61430593-61430651,chr8,61430593,61430651,0,41941948
IMR90|chr8:19494638-19494656,chr8,19494638,19494656,IMR90|chr8:125552253-125552335,chr8,125552253,125552335,0,106057615
IMR90|chr8:19562549-19562605,chr8,19562549,19562605,IMR90|chr8:23147057-23147144,chr8,23147057,23147144,0,3584508
IMR90|chr8:20135860-20135882,chr8,20135860,20135882,IMR90|chr8:145155392-145155433,chr8,145155392,145155433,0,125019532
IMR90|chr8:20348061-20348094,chr8,20348061,20348094,IMR90|chr8:90770608-90770754,chr8,90770608,90770754,0,70422547
IMR90|chr8:21409666-21409816,chr8,21409666,21409816,IMR90|chr8:49296845-49296874,chr8,49296845,49296874,0,27887179
IMR90|chr8:21700268-21700297,chr8,21700268,21700297,IMR90|chr8:145134262-145134359,chr8,145134262,145134359,0,123433994
IMR90|chr8:21868916-21868962,chr8,21868916,21868962,IMR90|chr8:120844350-120844427,chr8,120844350,120844427,0,98975434
IMR90|chr8:22116614-22116637,chr8,22116614,22116637,IMR90|chr8:107077706-107077792,chr8,107077706,107077792,0,84961092
IMR90|chr8:22406685-22406799,chr8,22406685,22406799,IMR90|chr8:38645536-38645572,chr8,38645536,38645572,0,16238851
IMR90|chr8:22450377-22450420,chr8,22450377,22450420,IMR90|chr8:141645800-141645881,chr8,141645800,141645881,0,119195423
IMR90|chr8:22562809-22562861,chr8,22562809,22562861,IMR90|chr8:134582012-134582091,chr8,134582012,134582091,0,112019203
IMR90|chr8:22944724-22944770,chr8,22944724,22944770,IMR90|chr8:25311907-25311967,chr8,25311907,25311967,0,2367183
IMR90|chr8:22948348-22948403,chr8,22948348,22948403,IMR90|chr8:122652485-122652572,chr8,122652485,122652572,0,99704137
IMR90|chr8:23385613-23385732,chr8,23385613,23385732,IMR90|chr8:57123507-57123574,chr8,57123507,57123574,0,33737894
IMR90|chr8:23870486-23870610,chr8,23870486,23870610,IMR90|chr8:49296745-49296793,chr8,49296745,49296793,0,25426259
IMR90|chr8:23979456-23979532,chr8,23979456,23979532,IMR90|chr8:90770863-90770931,chr8,90770863,90770931,0,66791407
IMR90|chr8:25137826-25137874,chr8,25137826,25137874,IMR90|chr8:128750375-128750511,chr8,128750375,128750511,0,103612549
IMR90|chr8:26023003-26023087,chr8,26023003,26023087,IMR90|chr8:57122314-57122365,chr8,57122314,57122365,0,31099311
IMR90|chr8:26093617-26093707,chr8,26093617,26093707,IMR90|chr8:66753173-66753231,chr8,66753173,66753231,0,40659556
IMR90|chr8:26204354-26204444,chr8,26204354,26204444,IMR90|chr8:66753173-66753231,chr8,66753173,66753231,0,40548819
IMR90|chr8:26504849-26504896,chr8,26504849,26504896,IMR90|chr8:131454443-131454546,chr8,131454443,131454546,0,104949594
IMR90|chr8:27730139-27730191,chr8,27730139,27730191,IMR90|chr8:134582012-134582091,chr8,134582012,134582091,0,106851873
IMR90|chr8:28182779-28182819,chr8,28182779,28182819,IMR90|chr8:120844350-120844427,chr8,120844350,120844427,0,92661571
IMR90|chr8:28366547-28366586,chr8,28366547,28366586,IMR90|chr8:106332348-106332404,chr8,106332348,106332404,0,77965801
IMR90|chr8:28495811-28495893,chr8,28495811,28495893,IMR90|chr8:134581069-134581219,chr8,134581069,134581219,0,106085258
IMR90|chr8:28844791-28844885,chr8,28844791,28844885,IMR90|chr8:57123445-57123490,chr8,57123445,57123490,0,28278654
IMR90|chr8:29310230-29310279,chr8,29310230,29310279,IMR90|chr8:128749155-128749256,chr8,128749155,128749256,0,99438925
IMR90|chr8:29514128-29514150,chr8,29514128,29514150,IMR90|chr8:49294643-49294771,chr8,49294643,49294771,0,19780515
IMR90|chr8:29526006-29526053,chr8,29526006,29526053,IMR90|chr8:90770863-90770931,chr8,90770863,90770931,0,61244857
IMR90|chr8:30378715-30378774,chr8,30378715,30378774,IMR90|chr8:145687091-145687158,chr8,145687091,145687158,0,115308376
IMR90|chr8:30483372-30483453,chr8,30483372,30483453,IMR90|chr8:57122314-57122365,chr8,57122314,57122365,0,26638942
IMR90|chr8:30550528-30550611,chr8,30550528,30550611,IMR90|chr8:66751025-66751080,chr8,66751025,66751080,0,36200497
IMR90|chr8:30571778-30571841,chr8,30571778,30571841,IMR90|chr8:145687091-145687160,chr8,145687091,145687160,0,115115313
IMR90|chr8:30612375-30612392,chr8,30612375,30612392,IMR90|chr8:128750209-128750291,chr8,128750209,128750291,0,98137834
IMR90|chr8:30919238-30919276,chr8,30919238,30919276,IMR90|chr8:11327949-11328009,chr8,11327949,11328009,0,19591289
IMR90|chr8:31057183-31057297,chr8,31057183,31057297,IMR90|chr8:38645536-38645572,chr8,38645536,38645572,0,7588353
IMR90|chr8:31075518-31075609,chr8,31075518,31075609,IMR90|chr8:25313763-25313786,chr8,25313763,25313786,0,5761755
IMR90|chr8:31268247-31268266,chr8,31268247,31268266,IMR90|chr8:38035864-38035987,chr8,38035864,38035987,0,6767617
IMR90|chr8:31415638-31415672,chr8,31415638,31415672,IMR90|chr8:55012769-55012828,chr8,55012769,55012828,0,23597131
IMR90|chr8:31617187-31617215,chr8,31617187,31617215,IMR90|chr8:128749052-128749084,chr8,128749052,128749084,0,97131865
IMR90|chr8:31944769-31944841,chr8,31944769,31944841,IMR90|chr8:107283278-107283346,chr8,107283278,107283346,0,75338509
IMR90|chr8:32554249-32554282,chr8,32554249,32554282,IMR90|chr8:90770608-90770754,chr8,90770608,90770754,0,58216359
IMR90|chr8:33281895-33281923,chr8,33281895,33281923,IMR90|chr8:128749052-128749084,chr8,128749052,128749084,0,95467157
IMR90|chr8:33464539-33464647,chr8,33464539,33464647,IMR90|chr8:144674754-144674796,chr8,144674754,144674796,0,111210215
IMR90|chr8:33877018-33877126,chr8,33877018,33877126,IMR90|chr8:38857331-38857369,chr8,38857331,38857369,0,4980313
IMR90|chr8:33904296-33904389,chr8,33904296,33904389,IMR90|chr8:42395335-42395394,chr8,42395335,42395394,0,8491039
IMR90|chr8:34387450-34387496,chr8,34387450,34387496,IMR90|chr8:25311907-25311967,chr8,25311907,25311967,0,9075543
IMR90|chr8:34530072-34530120,chr8,34530072,34530120,IMR90|chr8:119122183-119122231,chr8,119122183,119122231,0,84592111
IMR90|chr8:34742780-34742826,chr8,34742780,34742826,IMR90|chr8:48876657-48876752,chr8,48876657,48876752,0,14133877
IMR90|chr8:34758122-34758222,chr8,34758122,34758222,IMR90|chr8:99056493-99056550,chr8,99056493,99056550,0,64298371
IMR90|chr8:35139548-35139615,chr8,35139548,35139615,IMR90|chr8:62624546-62624616,chr8,62624546,62624616,0,27484998
IMR90|chr8:36254609-36254670,chr8,36254609,36254670,IMR90|chr8:145015745-145015819,chr8,145015745,145015819,0,108761136
IMR90|chr8:36285984-36286040,chr8,36285984,36286040,IMR90|chr8:23147057-23147144,chr8,23147057,23147144,0,13138927
IMR90|chr8:36637334-36637377,chr8,36637334,36637377,IMR90|chr8:1918808-1918849,chr8,1918808,1918849,0,34718526
IMR90|chr8:36903809-36903911,chr8,36903809,36903911,IMR90|chr8:49296745-49296793,chr8,49296745,49296793,0,12392936
IMR90|chr8:36964981-36965044,chr8,36964981,36965044,IMR90|chr8:11323190-11323255,chr8,11323190,11323255,0,25641791
IMR90|chr8:36967970-36968046,chr8,36967970,36968046,IMR90|chr8:90770863-90770931,chr8,90770863,90770931,0,53802893
IMR90|chr8:36989794-36989858,chr8,36989794,36989858,IMR90|chr8:61430830-61430899,chr8,61430830,61430899,0,24441036
IMR90|chr8:37309823-37309841,chr8,37309823,37309841,IMR90|chr8:125552253-125552335,chr8,125552253,125552335,0,88242430
IMR90|chr8:37647285-37647340,chr8,37647285,37647340,IMR90|chr8:11722629-11722724,chr8,11722629,11722724,0,25924656
IMR90|chr8:37719436-37719474,chr8,37719436,37719474,IMR90|chr8:107077706-107077792,chr8,107077706,107077792,0,69358270
IMR90|chr8:37917876-37917922,chr8,37917876,37917922,IMR90|chr8:48876657-48876752,chr8,48876657,48876752,0,10958781
IMR90|chr8:38128539-38128677,chr8,38128539,38128677,IMR90|chr8:145012797-145012928,chr8,145012797,145012928,0,106884258
IMR90|chr8:38511062-38511143,chr8,38511062,38511143,IMR90|chr8:57122314-57122365,chr8,57122314,57122365,0,18611252
IMR90|chr8:38795088-38795184,chr8,38795088,38795184,IMR90|chr8:145032639-145032683,chr8,145032639,145032683,0,106237551
IMR90|chr8:38797778-38797830,chr8,38797778,38797830,IMR90|chr8:62623249-62623311,chr8,62623249,62623311,0,23825471
IMR90|chr8:38804916-38804943,chr8,38804916,38804943,IMR90|chr8:11724505-11724548,chr8,11724505,11724548,0,27080411
IMR90|chr8:39089646-39089688,chr8,39089646,39089688,IMR90|chr8:104384912-104384989,chr8,104384912,104384989,0,65295266
IMR90|chr8:39176793-39176837,chr8,39176793,39176837,IMR90|chr8:66752834-66752923,chr8,66752834,66752923,0,27576041
IMR90|chr8:39502495-39502574,chr8,39502495,39502574,IMR90|chr8:18871935-18872040,chr8,18871935,18872040,0,20630560
IMR90|chr8:39622545-39622577,chr8,39622545,39622577,IMR90|chr8:145021384-145021424,chr8,145021384,145021424,0,105398839
IMR90|chr8:40130512-40130563,chr8,40130512,40130563,IMR90|chr8:90770714-90770797,chr8,90770714,90770797,0,50640202
IMR90|chr8:40327724-40327776,chr8,40327724,40327776,IMR90|chr8:107077706-107077777,chr8,107077706,107077777,0,66749982
IMR90|chr8:40379948-40380067,chr8,40379948,40380067,IMR90|chr8:57123507-57123574,chr8,57123507,57123574,0,16743559
IMR90|chr8:41315749-41315831,chr8,41315749,41315831,IMR90|chr8:11720117-11720161,chr8,11720117,11720161,0,29595632
IMR90|chr8:41429245-41429300,chr8,41429245,41429300,IMR90|chr8:11722629-11722724,chr8,11722629,11722724,0,29706616
IMR90|chr8:41519308-41519356,chr8,41519308,41519356,IMR90|chr8:145154317-145154452,chr8,145154317,145154452,0,103635009
IMR90|chr8:41790393-41790427,chr8,41790393,41790427,IMR90|chr8:37656597-37656684,chr8,37656597,37656684,0,4133796
IMR90|chr8:42073311-42073340,chr8,42073311,42073340,IMR90|chr8:145134262-145134359,chr8,145134262,145134359,0,103060951
IMR90|chr8:42725454-42725471,chr8,42725454,42725471,IMR90|chr8:128750209-128750291,chr8,128750209,128750291,0,86024755
IMR90|chr8:42784372-42784454,chr8,42784372,42784454,IMR90|chr8:145021384-145021424,chr8,145021384,145021424,0,102237012
IMR90|chr8:42810353-42810380,chr8,42810353,42810380,IMR90|chr8:11724505-11724548,chr8,11724505,11724548,0,31085848
IMR90|chr8:42869263-42869326,chr8,42869263,42869326,IMR90|chr8:145687091-145687160,chr8,145687091,145687160,0,102817828
IMR90|chr8:43270523-43270667,chr8,43270523,43270667,IMR90|chr8:20082508-20082556,chr8,20082508,20082556,0,23188015
IMR90|chr8:43895637-43895674,chr8,43895637,43895674,IMR90|chr8:66752023-66752058,chr8,66752023,66752058,0,22856386
IMR90|chr8:43996413-43996454,chr8,43996413,43996454,IMR90|chr8:37656476-37656515,chr8,37656476,37656515,0,6339937
IMR90|chr8:44123970-44124032,chr8,44123970,44124032,IMR90|chr8:119118645-119118708,chr8,119118645,119118708,0,74994675
IMR90|chr8:44319134-44319173,chr8,44319134,44319173,IMR90|chr8:106332348-106332404,chr8,106332348,106332404,0,62013214
IMR90|chr8:44867857-44867889,chr8,44867857,44867889,IMR90|chr8:126444064-126444140,chr8,126444064,126444140,0,81576207
IMR90|chr8:44930126-44930219,chr8,44930126,44930219,IMR90|chr8:99056493-99056550,chr8,99056493,99056550,0,54126367
IMR90|chr8:45634478-45634550,chr8,45634478,45634550,IMR90|chr8:62625926-62626015,chr8,62625926,62626015,0,16991448
IMR90|chr8:46040129-46040219,chr8,46040129,46040219,IMR90|chr8:42395335-42395394,chr8,42395335,42395394,0,3644794
IMR90|chr8:46296816-46296851,chr8,46296816,46296851,IMR90|chr8:90913067-90913217,chr8,90913067,90913217,0,44616251
IMR90|chr8:47319124-47319203,chr8,47319124,47319203,IMR90|chr8:106334385-106334435,chr8,106334385,106334435,0,59015261
IMR90|chr8:47507808-47507914,chr8,47507808,47507914,IMR90|chr8:94750990-94751018,chr8,94750990,94751018,0,47243182
IMR90|chr8:47536499-47536603,chr8,47536499,47536603,IMR90|chr8:20082508-20082554,chr8,20082508,20082554,0,27453991
IMR90|chr8:47586369-47586431,chr8,47586369,47586431,IMR90|chr8:72757311-72757362,chr8,72757311,72757362,0,25170942
IMR90|chr8:48347647-48347738,chr8,48347647,48347738,IMR90|chr8:104385851-104385872,chr8,104385851,104385872,0,56038204
IMR90|chr8:48985510-48985539,chr8,48985510,48985539,IMR90|chr8:25313800-25313896,chr8,25313800,25313896,0,23671710
IMR90|chr8:49220212-49220306,chr8,49220212,49220306,IMR90|chr8:128752276-128752359,chr8,128752276,128752359,0,79532064
IMR90|chr8:49558847-49558898,chr8,49558847,49558898,IMR90|chr8:124290586-124290631,chr8,124290586,124290631,0,74731739
IMR90|chr8:49756225-49756259,chr8,49756225,49756259,IMR90|chr8:11722815-11722890,chr8,11722815,11722890,0,38033410
IMR90|chr8:49948777-49948797,chr8,49948777,49948797,IMR90|chr8:23146795-23146875,chr8,23146795,23146875,0,26801982
IMR90|chr8:50528300-50528373,chr8,50528300,50528373,IMR90|chr8:107283278-107283347,chr8,107283278,107283347,0,56754978
IMR90|chr8:50771629-50771701,chr8,50771629,50771701,IMR90|chr8:141646071-141646142,chr8,141646071,141646142,0,90874442
IMR90|chr8:50967381-50967477,chr8,50967381,50967477,IMR90|chr8:100907519-100907562,chr8,100907519,100907562,0,49940138
IMR90|chr8:51301214-51301268,chr8,51301214,51301268,IMR90|chr8:116679859-116679953,chr8,116679859,116679953,0,65378645
IMR90|chr8:51374184-51374228,chr8,51374184,51374228,IMR90|chr8:17017991-17018072,chr8,17017991,17018072,0,34356193
IMR90|chr8:51653404-51653440,chr8,51653404,51653440,IMR90|chr8:145687091-145687160,chr8,145687091,145687160,0,94033687
IMR90|chr8:52271229-52271307,chr8,52271229,52271307,IMR90|chr8:104379164-104379213,chr8,104379164,104379213,0,52107935
IMR90|chr8:52489553-52489612,chr8,52489553,52489612,IMR90|chr8:145687091-145687158,chr8,145687091,145687158,0,93197538
IMR90|chr8:52573718-52573814,chr8,52573718,52573814,IMR90|chr8:57123445-57123490,chr8,57123445,57123490,0,4549727
IMR90|chr8:52939927-52939987,chr8,52939927,52939987,IMR90|chr8:101732566-101732609,chr8,101732566,101732609,0,48792639
IMR90|chr8:53256001-53256016,chr8,53256001,53256016,IMR90|chr8:25315326-25315430,chr8,25315326,25315430,0,27940675
IMR90|chr8:53374800-53374858,chr8,53374800,53374858,IMR90|chr8:119120054-119120089,chr8,119120054,119120089,0,65745254
IMR90|chr8:53900499-53900560,chr8,53900499,53900560,IMR90|chr8:17016705-17016747,chr8,17016705,17016747,0,36883794
IMR90|chr8:54220605-54220662,chr8,54220605,54220662,IMR90|chr8:62622780-62622828,chr8,62622780,62622828,0,8402175
IMR90|chr8:54711674-54711704,chr8,54711674,54711704,IMR90|chr8:37656597-37656684,chr8,37656597,37656684,0,17055077
IMR90|chr8:54870609-54870663,chr8,54870609,54870663,IMR90|chr8:62625800-62625862,chr8,62625800,62625862,0,7755191
IMR90|chr8:55257040-55257097,chr8,55257040,55257097,IMR90|chr8:62626023-62626064,chr8,62626023,62626064,0,7368983
IMR90|chr8:56123650-56123752,chr8,56123650,56123752,IMR90|chr8:49296745-49296793,chr8,49296745,49296793,0,6826905
IMR90|chr8:56328346-56328403,chr8,56328346,56328403,IMR90|chr8:128749047-128749117,chr8,128749047,128749117,0,72420701
IMR90|chr8:56798468-56798525,chr8,56798468,56798525,IMR90|chr8:119121842-119121922,chr8,119121842,119121922,0,62323374
IMR90|chr8:58013929-58013988,chr8,58013929,58013988,IMR90|chr8:124086055-124086205,chr8,124086055,124086205,0,66072126
IMR90|chr8:58403151-58403254,chr8,58403151,58403254,IMR90|chr8:128748976-128748998,chr8,128748976,128748998,0,70345825
IMR90|chr8:58596675-58596763,chr8,58596675,58596763,IMR90|chr8:61430593-61430651,chr8,61430593,61430651,0,2833918
IMR90|chr8:58946842-58946880,chr8,58946842,58946880,IMR90|chr8:25315102-25315139,chr8,25315102,25315139,0,33631740
IMR90|chr8:58991796-58991841,chr8,58991796,58991841,IMR90|chr8:128749485-128749534,chr8,128749485,128749534,0,69757689
IMR90|chr8:59289719-59289751,chr8,59289719,59289751,IMR90|chr8:145021384-145021424,chr8,145021384,145021424,0,85731665
IMR90|chr8:59570101-59570159,chr8,59570101,59570159,IMR90|chr8:142140923-142141012,chr8,142140923,142141012,0,82570822
IMR90|chr8:59630317-59630351,chr8,59630317,59630351,IMR90|chr8:11722815-11722890,chr8,11722815,11722890,0,47907502
IMR90|chr8:59936183-59936320,chr8,59936183,59936320,IMR90|chr8:38645536-38645572,chr8,38645536,38645572,0,21290647
IMR90|chr8:60468261-60468326,chr8,60468261,60468326,IMR90|chr8:74884138-74884216,chr8,74884138,74884216,0,14415877
IMR90|chr8:60529369-60529400,chr8,60529369,60529400,IMR90|chr8:142010133-142010211,chr8,142010133,142010211,0,81480764
IMR90|chr8:60535304-60535351,chr8,60535304,60535351,IMR90|chr8:131454443-131454546,chr8,131454443,131454546,0,70919139
IMR90|chr8:60536561-60536669,chr8,60536561,60536669,IMR90|chr8:38857331-38857369,chr8,38857331,38857369,0,21679230
IMR90|chr8:61670306-61670395,chr8,61670306,61670395,IMR90|chr8:11722756-11722814,chr8,11722756,11722814,0,49947550
IMR90|chr8:61790434-61790484,chr8,61790434,61790484,IMR90|chr8:49294643-49294771,chr8,49294643,49294771,0,12495791
IMR90|chr8:62500633-62500733,chr8,62500633,62500733,IMR90|chr8:99056493-99056550,chr8,99056493,99056550,0,36555860
IMR90|chr8:62850201-62850257,chr8,62850201,62850257,IMR90|chr8:11720751-11720832,chr8,11720751,11720832,0,51129450
IMR90|chr8:63732120-63732216,chr8,63732120,63732216,IMR90|chr8:57123445-57123490,chr8,57123445,57123490,0,6608675
IMR90|chr8:63889582-63889643,chr8,63889582,63889643,IMR90|chr8:142140923-142141012,chr8,142140923,142141012,0,78251341
IMR90|chr8:64358939-64359001,chr8,64358939,64359001,IMR90|chr8:145015745-145015819,chr8,145015745,145015819,0,80656806
IMR90|chr8:64523688-64523760,chr8,64523688,64523760,IMR90|chr8:107283278-107283346,chr8,107283278,107283346,0,42759590
IMR90|chr8:64830568-64830671,chr8,64830568,64830671,IMR90|chr8:122652485-122652572,chr8,122652485,122652572,0,57821917
IMR90|chr8:64862116-64862205,chr8,64862116,64862205,IMR90|chr8:99055769-99055830,chr8,99055769,99055830,0,34193653
IMR90|chr8:65079493-65079557,chr8,65079493,65079557,IMR90|chr8:116677372-116677416,chr8,116677372,116677416,0,51597879
IMR90|chr8:65537481-65537504,chr8,65537481,65537504,IMR90|chr8:145013738-145013832,chr8,145013738,145013832,0,79476257
IMR90|chr8:65898474-65898521,chr8,65898474,65898521,IMR90|chr8:11720117-11720161,chr8,11720117,11720161,0,54178357
IMR90|chr8:66033558-66033695,chr8,66033558,66033695,IMR90|chr8:38645536-38645572,chr8,38645536,38645572,0,27388022
IMR90|chr8:66836267-66836380,chr8,66836267,66836380,IMR90|chr8:119119067-119119104,chr8,119119067,119119104,0,52282800
IMR90|chr8:66934414-66934473,chr8,66934414,66934473,IMR90|chr8:49294713-49294746,chr8,49294713,49294746,0,17639701
IMR90|chr8:67161635-67161733,chr8,67161635,67161733,IMR90|chr8:99055789-99055830,chr8,99055789,99055830,0,31894154
IMR90|chr8:67288628-67288682,chr8,67288628,67288682,IMR90|chr8:62625800-62625862,chr8,62625800,62625862,0,4662828
IMR90|chr8:68415626-68415718,chr8,68415626,68415718,IMR90|chr8:144677146-144677229,chr8,144677146,144677229,0,76261520
IMR90|chr8:68418967-68419041,chr8,68418967,68419041,IMR90|chr8:141646071-141646142,chr8,141646071,141646142,0,73227104
IMR90|chr8:68464547-68464579,chr8,68464547,68464579,IMR90|chr8:128749485-128749534,chr8,128749485,128749534,0,60284938
IMR90|chr8:68962865-68962912,chr8,68962865,68962912,IMR90|chr8:11720117-11720161,chr8,11720117,11720161,0,57242748
IMR90|chr8:70572690-70572818,chr8,70572690,70572818,IMR90|chr8:11724120-11724144,chr8,11724120,11724144,0,58848570
IMR90|chr8:70765530-70765613,chr8,70765530,70765613,IMR90|chr8:38857331-38857369,chr8,38857331,38857369,0,31908199
IMR90|chr8:71012731-71012816,chr8,71012731,71012816,IMR90|chr8:116680064-116680122,chr8,116680064,116680122,0,45667333
IMR90|chr8:71453302-71453349,chr8,71453302,71453349,IMR90|chr8:17433646-17433697,chr8,17433646,17433697,0,54019656
IMR90|chr8:71736454-71736547,chr8,71736454,71736547,IMR90|chr8:128752406-128752429,chr8,128752406,128752429,0,57015952
IMR90|chr8:72164937-72164966,chr8,72164937,72164966,IMR90|chr8:25313800-25313896,chr8,25313800,25313896,0,46851137
IMR90|chr8:72215995-72216090,chr8,72215995,72216090,IMR90|chr8:23710197-23710216,chr8,23710197,23710216,0,48505798
IMR90|chr8:72251460-72251521,chr8,72251460,72251521,IMR90|chr8:62625926-62626015,chr8,62625926,62626015,0,9625534
IMR90|chr8:72576164-72576209,chr8,72576164,72576209,IMR90|chr8:103432963-103433020,chr8,103432963,103433020,0,30856799
IMR90|chr8:72673673-72673778,chr8,72673673,72673778,IMR90|chr8:94750991-94751018,chr8,94750991,94751018,0,22077318
IMR90|chr8:73973449-73973567,chr8,73973449,73973567,IMR90|chr8:142140408-142140496,chr8,142140408,142140496,0,68166959
IMR90|chr8:74271329-74271350,chr8,74271329,74271350,IMR90|chr8:104384332-104384432,chr8,104384332,104384432,0,30113003
IMR90|chr8:74521657-74521749,chr8,74521657,74521749,IMR90|chr8:144677146-144677229,chr8,144677146,144677229,0,70155489
IMR90|chr8:75553568-75553679,chr8,75553568,75553679,IMR90|chr8:37656476-37656515,chr8,37656476,37656515,0,37897092
IMR90|chr8:75828214-75828312,chr8,75828214,75828312,IMR90|chr8:99055789-99055830,chr8,99055789,99055830,0,23227575
IMR90|chr8:75850855-75850937,chr8,75850855,75850937,IMR90|chr8:131454443-131454546,chr8,131454443,131454546,0,55603588
IMR90|chr8:75860243-75860294,chr8,75860243,75860294,IMR90|chr8:90770714-90770797,chr8,90770714,90770797,0,14910471
IMR90|chr8:76255834-76255903,chr8,76255834,76255903,IMR90|chr8:62624548-62624616,chr8,62624548,62624616,0,13631286
IMR90|chr8:76708863-76708895,chr8,76708863,76708895,IMR90|chr8:125552252-125552336,chr8,125552252,125552336,0,48843389
IMR90|chr8:76754930-76755023,chr8,76754930,76755023,IMR90|chr8:48922044-48922096,chr8,48922044,48922096,0,27832886
IMR90|chr8:77168993-77169028,chr8,77168993,77169028,IMR90|chr8:90913067-90913217,chr8,90913067,90913217,0,13744074
IMR90|chr8:77725791-77725853,chr8,77725791,77725853,IMR90|chr8:142140408-142140496,chr8,142140408,142140496,0,64414617
IMR90|chr8:77792693-77792754,chr8,77792693,77792754,IMR90|chr8:142140923-142141012,chr8,142140923,142141012,0,64348230
IMR90|chr8:77890902-77890965,chr8,77890902,77890965,IMR90|chr8:72757311-72757362,chr8,72757311,72757362,0,5133591
IMR90|chr8:77963590-77963632,chr8,77963590,77963632,IMR90|chr8:25315102-25315144,chr8,25315102,25315144,0,52648488
IMR90|chr8:77979445-77979537,chr8,77979445,77979537,IMR90|chr8:128752406-128752429,chr8,128752406,128752429,0,50772961
IMR90|chr8:78091314-78091371,chr8,78091314,78091371,IMR90|chr8:119121842-119121922,chr8,119121842,119121922,0,41030528
IMR90|chr8:78278720-78278772,chr8,78278720,78278772,IMR90|chr8:11720751-11720832,chr8,11720751,11720832,0,66557969
IMR90|chr8:78771737-78771830,chr8,78771737,78771830,IMR90|chr8:1773287-1773344,chr8,1773287,1773344,0,76998450
IMR90|chr8:78928290-78928354,chr8,78928290,78928354,IMR90|chr8:61430830-61430899,chr8,61430830,61430899,0,17497460
IMR90|chr8:79339857-79339918,chr8,79339857,79339918,IMR90|chr8:145135839-145135910,chr8,145135839,145135910,0,65795982
IMR90|chr8:79861201-79861262,chr8,79861201,79861262,IMR90|chr8:62625926-62626015,chr8,62625926,62626015,0,17235275
IMR90|chr8:79973452-79973493,chr8,79973452,79973493,IMR90|chr8:134581140-134581223,chr8,134581140,134581223,0,54607688
IMR90|chr8:80457071-80457094,chr8,80457071,80457094,IMR90|chr8:145013738-145013832,chr8,145013738,145013832,0,64556667
IMR90|chr8:80813686-80813836,chr8,80813686,80813836,IMR90|chr8:11722756-11722814,chr8,11722756,11722814,0,69090930
IMR90|chr8:80934440-80934523,chr8,80934440,80934523,IMR90|chr8:116680064-116680122,chr8,116680064,116680122,0,35745624
IMR90|chr8:81528643-81528733,chr8,81528643,81528733,IMR90|chr8:66753173-66753231,chr8,66753173,66753231,0,14775470
IMR90|chr8:81615074-81615138,chr8,81615074,81615138,IMR90|chr8:11323190-11323255,chr8,11323190,11323255,0,70291884
IMR90|chr8:82009320-82009380,chr8,82009320,82009380,IMR90|chr8:23711327-23711383,chr8,23711327,23711383,0,58297993
IMR90|chr8:82209138-82209171,chr8,82209138,82209171,IMR90|chr8:11722815-11722890,chr8,11722815,11722890,0,70486323
IMR90|chr8:82283468-82283547,chr8,82283468,82283547,IMR90|chr8:106334385-106334435,chr8,106334385,106334435,0,24050917
IMR90|chr8:82287529-82287582,chr8,82287529,82287582,IMR90|chr8:62625800-62625862,chr8,62625800,62625862,0,19661729
IMR90|chr8:82783369-82783462,chr8,82783369,82783462,IMR90|chr8:1773287-1773344,chr8,1773287,1773344,0,81010082
IMR90|chr8:82816748-82816841,chr8,82816748,82816841,IMR90|chr8:99056493-99056550,chr8,99056493,99056550,0,16239745
IMR90|chr8:82873867-82873910,chr8,82873867,82873910,IMR90|chr8:1918808-1918849,chr8,1918808,1918849,0,80955059
IMR90|chr8:82979672-82979716,chr8,82979672,82979716,IMR90|chr8:103432963-103433020,chr8,103432963,103433020,0,20453291
IMR90|chr8:83075463-83075523,chr8,83075463,83075523,IMR90|chr8:23711327-23711383,chr8,23711327,23711383,0,59364136
IMR90|chr8:83322825-83322870,chr8,83322825,83322870,IMR90|chr8:128749485-128749534,chr8,128749485,128749534,0,45426660
IMR90|chr8:83609494-83609556,chr8,83609494,83609556,IMR90|chr8:142140408-142140496,chr8,142140408,142140496,0,58530914
IMR90|chr8:83991162-83991204,chr8,83991162,83991204,IMR90|chr8:141645800-141645881,chr8,141645800,141645881,0,57654638
IMR90|chr8:84732519-84732603,chr8,84732519,84732603,IMR90|chr8:144677083-144677170,chr8,144677083,144677170,0,59944564
IMR90|chr8:84999664-84999714,chr8,84999664,84999714,IMR90|chr8:116679918-116679953,chr8,116679918,116679953,0,31680254
IMR90|chr8:85035388-85035474,chr8,85035388,85035474,IMR90|chr8:61430593-61430651,chr8,61430593,61430651,0,23604795
IMR90|chr8:85369126-85369199,chr8,85369126,85369199,IMR90|chr8:23711327-23711383,chr8,23711327,23711383,0,61657799
IMR90|chr8:85520500-85520583,chr8,85520500,85520583,IMR90|chr8:116680064-116680122,chr8,116680064,116680122,0,31159564
IMR90|chr8:85676041-85676077,chr8,85676041,85676077,IMR90|chr8:145687091-145687160,chr8,145687091,145687160,0,60011050
IMR90|chr8:85688604-85688666,chr8,85688604,85688666,IMR90|chr8:72757311-72757362,chr8,72757311,72757362,0,12931293
IMR90|chr8:87298413-87298501,chr8,87298413,87298501,IMR90|chr8:104385851-104385872,chr8,104385851,104385872,0,17087438
IMR90|chr8:87693704-87693765,chr8,87693704,87693765,IMR90|chr8:17016705-17016747,chr8,17016705,17016747,0,70676999
IMR90|chr8:89175038-89175079,chr8,89175038,89175079,IMR90|chr8:134581140-134581223,chr8,134581140,134581223,0,45406102
IMR90|chr8:90153092-90153185,chr8,90153092,90153185,IMR90|chr8:128752406-128752429,chr8,128752406,128752429,0,38599314
IMR90|chr8:90347800-90347824,chr8,90347800,90347824,IMR90|chr8:124086297-124086336,chr8,124086297,124086336,0,33738497
IMR90|chr8:90665062-90665130,chr8,90665062,90665130,IMR90|chr8:11720751-11720821,chr8,11720751,11720821,0,78944311
IMR90|chr8:91040682-91040734,chr8,91040682,91040734,IMR90|chr8:11720751-11720832,chr8,11720751,11720832,0,79319931
IMR90|chr8:91455981-91456054,chr8,91455981,91456054,IMR90|chr8:23711327-23711383,chr8,23711327,23711383,0,67744654
IMR90|chr8:91595959-91596048,chr8,91595959,91596048,IMR90|chr8:12988548-12988585,chr8,12988548,12988585,0,78607411
IMR90|chr8:92999675-92999694,chr8,92999675,92999694,IMR90|chr8:38035864-38035987,chr8,38035864,38035987,0,54963811
IMR90|chr8:93056566-93056620,chr8,93056566,93056620,IMR90|chr8:128749201-128749273,chr8,128749201,128749273,0,35692635
IMR90|chr8:93424508-93424588,chr8,93424508,93424588,IMR90|chr8:131454436-131454491,chr8,131454436,131454491,0,38029928
IMR90|chr8:93484155-93484183,chr8,93484155,93484183,IMR90|chr8:11724505-11724548,chr8,11724505,11724548,0,81759650
IMR90|chr8:94109309-94109365,chr8,94109309,94109365,IMR90|chr8:11720751-11720832,chr8,11720751,11720832,0,82388558
IMR90|chr8:94440110-94440154,chr8,94440110,94440154,IMR90|chr8:103432963-103433020,chr8,103432963,103433020,0,8992853
IMR90|chr8:94463758-94463848,chr8,94463758,94463848,IMR90|chr8:66753173-66753231,chr8,66753173,66753231,0,27710585
IMR90|chr8:95693300-95693346,chr8,95693300,95693346,IMR90|chr8:120844350-120844427,chr8,120844350,120844427,0,25151050
IMR90|chr8:96268138-96268183,chr8,96268138,96268183,IMR90|chr8:18871935-18872040,chr8,18871935,18872040,0,77396203
IMR90|chr8:96323091-96323176,chr8,96323091,96323176,IMR90|chr8:116680064-116680122,chr8,116680064,116680122,0,20356973
IMR90|chr8:96470906-96470939,chr8,96470906,96470939,IMR90|chr8:11722815-11722890,chr8,11722815,11722890,0,84748091
IMR90|chr8:97477049-97477133,chr8,97477049,97477133,IMR90|chr8:62623145-62623179,chr8,62623145,62623179,0,34853904
IMR90|chr8:98837713-98837863,chr8,98837713,98837863,IMR90|chr8:49296845-49296874,chr8,49296845,49296874,0,49540868
IMR90|chr8:99319670-99319723,chr8,99319670,99319723,IMR90|chr8:55012775-55012828,chr8,55012775,55012828,0,44306895
IMR90|chr8:99765064-99765124,chr8,99765064,99765124,IMR90|chr8:101732566-101732609,chr8,101732566,101732609,0,1967502
IMR90|chr8:100526296-100526338,chr8,100526296,100526338,IMR90|chr8:104384912-104384989,chr8,104384912,104384989,0,3858616
IMR90|chr8:100776338-100776438,chr8,100776338,100776438,IMR90|chr8:117781305-117781345,chr8,117781305,117781345,0,17004967
IMR90|chr8:100848159-100848218,chr8,100848159,100848218,IMR90|chr8:23147057-23147144,chr8,23147057,23147144,0,77701102
IMR90|chr8:101024730-101024820,chr8,101024730,101024820,IMR90|chr8:42395335-42395394,chr8,42395335,42395394,0,58629395
IMR90|chr8:102429441-102429536,chr8,102429441,102429536,IMR90|chr8:23710197-23710216,chr8,23710197,23710216,0,78719244
IMR90|chr8:102646748-102646820,chr8,102646748,102646820,IMR90|chr8:11327949-11328009,chr8,11327949,11328009,0,91318799
IMR90|chr8:102917505-102917578,chr8,102917505,102917578,IMR90|chr8:107283278-107283347,chr8,107283278,107283347,0,4365773
IMR90|chr8:102933722-102933769,chr8,102933722,102933769,IMR90|chr8:17433646-17433697,chr8,17433646,17433697,0,85500076
IMR90|chr8:103536967-103537051,chr8,103536967,103537051,IMR90|chr8:144677083-144677170,chr8,144677083,144677170,0,41140116
IMR90|chr8:103574318-103574401,chr8,103574318,103574401,IMR90|chr8:66751025-66751080,chr8,66751025,66751080,0,36823293
IMR90|chr8:103748887-103748994,chr8,103748887,103748994,IMR90|chr8:94750990-94751018,chr8,94750990,94751018,0,8997897
IMR90|chr8:103861889-103861953,chr8,103861889,103861953,IMR90|chr8:11323190-11323255,chr8,11323190,11323255,0,92538699
IMR90|chr8:103873770-103873812,chr8,103873770,103873812,IMR90|chr8:141645800-141645881,chr8,141645800,141645881,0,37772030
IMR90|chr8:104252297-104252390,chr8,104252297,104252390,IMR90|chr8:48922044-48922096,chr8,48922044,48922096,0,55330253
IMR90|chr8:104665580-104665617,chr8,104665580,104665617,IMR90|chr8:66752023-66752058,chr8,66752023,66752058,0,37913557
IMR90|chr8:104702039-104702101,chr8,104702039,104702101,IMR90|chr8:145015745-145015819,chr8,145015745,145015819,0,40313706
IMR90|chr8:105232606-105232673,chr8,105232606,105232673,IMR90|chr8:62624546-62624616,chr8,62624546,62624616,0,42608060
IMR90|chr8:105241019-105241058,chr8,105241019,105241058,IMR90|chr8:134581140-134581223,chr8,134581140,134581223,0,29340121
IMR90|chr8:105415323-105415387,chr8,105415323,105415387,IMR90|chr8:74884138-74884216,chr8,74884138,74884216,0,30531185
IMR90|chr8:105782723-105782763,chr8,105782723,105782763,IMR90|chr8:128750209-128750291,chr8,128750209,128750291,0,22967486
IMR90|chr8:105896968-105897008,chr8,105896968,105897008,IMR90|chr8:107077706-107077792,chr8,107077706,107077792,0,1180738
IMR90|chr8:106711387-106711531,chr8,106711387,106711531,IMR90|chr8:119119067-119119104,chr8,119119067,119119104,0,12407680
IMR90|chr8:107021477-107021565,chr8,107021477,107021565,IMR90|chr8:104385851-104385872,chr8,104385851,104385872,0,2635626
IMR90|chr8:107474402-107474450,chr8,107474402,107474450,IMR90|chr8:128750375-128750511,chr8,128750375,128750511,0,21275973
IMR90|chr8:107493573-107493625,chr8,107493573,107493625,IMR90|chr8:62623249-62623311,chr8,62623249,62623311,0,44870324
IMR90|chr8:107507861-107508005,chr8,107507861,107508005,IMR90|chr8:20082508-20082556,chr8,20082508,20082556,0,87425353
IMR90|chr8:108509932-108509989,chr8,108509932,108509989,IMR90|chr8:62622780-62622828,chr8,62622780,62622828,0,45887152
IMR90|chr8:108631841-108631884,chr8,108631841,108631884,IMR90|chr8:141645800-141645881,chr8,141645800,141645881,0,33013959
IMR90|chr8:109750832-109750863,chr8,109750832,109750863,IMR90|chr8:142010133-142010211,chr8,142010133,142010211,0,32259301
IMR90|chr8:109772787-109772874,chr8,109772787,109772874,IMR90|chr8:12988548-12988585,chr8,12988548,12988585,0,96784239
IMR90|chr8:110851929-110852079,chr8,110851929,110852079,IMR90|chr8:38645536-38645572,chr8,38645536,38645572,0,72206393
IMR90|chr8:111290817-111290855,chr8,111290817,111290855,IMR90|chr8:25315102-25315139,chr8,25315102,25315139,0,85975715
IMR90|chr8:112343187-112343276,chr8,112343187,112343276,IMR90|chr8:12988548-12988585,chr8,12988548,12988585,0,99354639
IMR90|chr8:112363234-112363254,chr8,112363234,112363254,IMR90|chr8:38035864-38035987,chr8,38035864,38035987,0,74327370
IMR90|chr8:112600057-112600124,chr8,112600057,112600124,IMR90|chr8:128752276-128752359,chr8,128752276,128752359,0,16152219
IMR90|chr8:112790688-112790769,chr8,112790688,112790769,IMR90|chr8:66751025-66751080,chr8,66751025,66751080,0,46039663
IMR90|chr8:112980400-112980467,chr8,112980400,112980467,IMR90|chr8:144677146-144677229,chr8,144677146,144677229,0,31696746
IMR90|chr8:113216691-113216749,chr8,113216691,113216749,IMR90|chr8:119120054-119120089,chr8,119120054,119120089,0,5903363
IMR90|chr8:113235707-113235741,chr8,113235707,113235741,IMR90|chr8:145046285-145046418,chr8,145046285,145046418,0,31810578
IMR90|chr8:113296227-113296306,chr8,113296227,113296306,IMR90|chr8:128749536-128749588,chr8,128749536,128749588,0,15453309
IMR90|chr8:113330762-113330847,chr8,113330762,113330847,IMR90|chr8:144677257-144677303,chr8,144677257,144677303,0,31346495
IMR90|chr8:114273815-114273889,chr8,114273815,114273889,IMR90|chr8:141646071-141646142,chr8,141646071,141646142,0,27372256
IMR90|chr8:114903046-114903184,chr8,114903046,114903184,IMR90|chr8:145012797-145012928,chr8,145012797,145012928,0,30109751
IMR90|chr8:115877074-115877135,chr8,115877074,115877135,IMR90|chr8:145135839-145135910,chr8,145135839,145135910,0,29258765
IMR90|chr8:115977794-115977825,chr8,115977794,115977825,IMR90|chr8:1918808-1918849,chr8,1918808,1918849,0,114058986
IMR90|chr8:116081369-116081392,chr8,116081369,116081392,IMR90|chr8:128751419-128751477,chr8,128751419,128751477,0,12670050
IMR90|chr8:117175917-117175938,chr8,117175917,117175938,IMR90|chr8:74904163-74904199,chr8,74904163,74904199,0,42271754
IMR90|chr8:117800313-117800419,chr8,117800313,117800419,IMR90|chr8:94750990-94751018,chr8,94750990,94751018,0,23049323
IMR90|chr8:118250718-118250760,chr8,118250718,118250760,IMR90|chr8:42051767-42051860,chr8,42051767,42051860,0,76198951
IMR90|chr8:118511399-118511486,chr8,118511399,118511486,IMR90|chr8:12988548-12988585,chr8,12988548,12988585,0,105522851
IMR90|chr8:118689166-118689203,chr8,118689166,118689203,IMR90|chr8:107077706-107077792,chr8,107077706,107077792,0,11611460
IMR90|chr8:119650561-119650640,chr8,119650561,119650640,IMR90|chr8:18871935-18872040,chr8,18871935,18872040,0,100778626
IMR90|chr8:120242433-120242473,chr8,120242433,120242473,IMR90|chr8:62625842-62625866,chr8,62625842,62625866,0,57616591
IMR90|chr8:120686622-120686654,chr8,120686622,120686654,IMR90|chr8:128749485-128749534,chr8,128749485,128749534,0,8062863
IMR90|chr8:121124527-121124611,chr8,121124527,121124611,IMR90|chr8:62623145-62623179,chr8,62623145,62623179,0,58501382
IMR90|chr8:121373430-121373510,chr8,121373430,121373510,IMR90|chr8:131454436-131454491,chr8,131454436,131454491,0,10081006
IMR90|chr8:121623089-121623109,chr8,121623089,121623109,IMR90|chr8:23146795-23146875,chr8,23146795,23146875,0,98476294
IMR90|chr8:121727984-121728117,chr8,121727984,121728117,IMR90|chr8:48922044-48922096,chr8,48922044,48922096,0,72805940
IMR90|chr8:121796895-121796948,chr8,121796895,121796948,IMR90|chr8:55012775-55012828,chr8,55012775,55012828,0,66784120
IMR90|chr8:122040419-122040468,chr8,122040419,122040468,IMR90|chr8:128749155-128749256,chr8,128749155,128749256,0,6708736
IMR90|chr8:122237142-122237220,chr8,122237142,122237220,IMR90|chr8:104379164-104379213,chr8,104379164,104379213,0,17857978
IMR90|chr8:122471523-122471578,chr8,122471523,122471578,IMR90|chr8:122652485-122652572,chr8,122652485,122652572,0,180962
IMR90|chr8:122568931-122569013,chr8,122568931,122569013,IMR90|chr8:131454443-131454546,chr8,131454443,131454546,0,8885512
IMR90|chr8:122821204-122821234,chr8,122821204,122821234,IMR90|chr8:37656597-37656684,chr8,37656597,37656684,0,85164607
IMR90|chr8:123011850-123011871,chr8,123011850,123011871,IMR90|chr8:74904163-74904199,chr8,74904163,74904199,0,48107687
IMR90|chr8:123629147-123629254,chr8,123629147,123629254,IMR90|chr8:94750990-94751018,chr8,94750990,94751018,0,28878157
IMR90|chr8:123635550-123635594,chr8,123635550,123635594,IMR90|chr8:66752834-66752923,chr8,66752834,66752923,0,56882716
IMR90|chr8:123746097-123746147,chr8,123746097,123746147,IMR90|chr8:116679918-116679953,chr8,116679918,116679953,0,7066179
IMR90|chr8:123880174-123880227,chr8,123880174,123880227,IMR90|chr8:104387833-104387888,chr8,104387833,104387888,0,19492341
IMR90|chr8:123997101-123997158,chr8,123997101,123997158,IMR90|chr8:128749047-128749117,chr8,128749047,128749117,0,4751946
IMR90|chr8:125152731-125152794,chr8,125152731,125152794,IMR90|chr8:72757311-72757362,chr8,72757311,72757362,0,52395420
IMR90|chr8:125330681-125330703,chr8,125330681,125330703,IMR90|chr8:104384332-104384432,chr8,104384332,104384432,0,20946349
IMR90|chr8:125527574-125527635,chr8,125527574,125527635,IMR90|chr8:11323190-11323256,chr8,11323190,11323256,0,114204384
IMR90|chr8:125595884-125595921,chr8,125595884,125595921,IMR90|chr8:119120476-119120575,chr8,119120476,119120575,0,6475408
IMR90|chr8:127281869-127281952,chr8,127281869,127281952,IMR90|chr8:38857331-38857369,chr8,38857331,38857369,0,88424538
IMR90|chr8:127675111-127675258,chr8,127675111,127675258,IMR90|chr8:37656476-37656515,chr8,37656476,37656515,0,90018635
IMR90|chr8:127724867-127724926,chr8,127724867,127724926,IMR90|chr8:49294713-49294746,chr8,49294713,49294746,0,78430154
IMR90|chr8:127739153-127739247,chr8,127739153,127739247,IMR90|chr8:57123445-57123490,chr8,57123445,57123490,0,70615708
IMR90|chr8:127795399-127795422,chr8,127795399,127795422,IMR90|chr8:107077706-107077792,chr8,107077706,107077792,0,20717693
IMR90|chr8:128028473-128028512,chr8,128028473,128028512,IMR90|chr8:134581140-134581223,chr8,134581140,134581223,0,6552667
IMR90|chr8:128139224-128139290,chr8,128139224,128139290,IMR90|chr8:61430830-61430899,chr8,61430830,61430899,0,66708394
IMR90|chr8:128672031-128672143,chr8,128672031,128672143,IMR90|chr8:11724120-11724144,chr8,11724120,11724144,0,116947911
IMR90|chr8:129682857-129682894,chr8,129682857,129682894,IMR90|chr8:107077706-107077792,chr8,107077706,107077792,0,22605151
IMR90|chr8:129762179-129762251,chr8,129762179,129762251,IMR90|chr8:62625926-62626015,chr8,62625926,62626015,0,67136253
IMR90|chr8:129896420-129896516,chr8,129896420,129896516,IMR90|chr8:145032639-145032683,chr8,145032639,145032683,0,15136219
IMR90|chr8:129916871-129916951,chr8,129916871,129916951,IMR90|chr8:11720117-11720161,chr8,11720117,11720161,0,118196754
IMR90|chr8:131377451-131377533,chr8,131377451,131377533,IMR90|chr8:134581069-134581219,chr8,134581069,134581219,0,3203618
IMR90|chr8:132150515-132150574,chr8,132150515,132150574,IMR90|chr8:23147057-23147144,chr8,23147057,23147144,0,109003458
IMR90|chr8:132209798-132209859,chr8,132209798,132209859,IMR90|chr8:145015745-145015819,chr8,145015745,145015819,0,12805947
IMR90|chr8:132600888-132601012,chr8,132600888,132601012,IMR90|chr8:49296745-49296793,chr8,49296745,49296793,0,83304143
IMR90|chr8:132839625-132839728,chr8,132839625,132839728,IMR90|chr8:122652485-122652572,chr8,122652485,122652572,0,10187140
IMR90|chr8:133842143-133842166,chr8,133842143,133842166,IMR90|chr8:128751419-128751477,chr8,128751419,128751477,0,5090724
IMR90|chr8:134194083-134194150,chr8,134194083,134194150,IMR90|chr8:128752276-128752359,chr8,128752276,128752359,0,5441807
IMR90|chr8:134396759-134396843,chr8,134396759,134396843,IMR90|chr8:57122314-57122365,chr8,57122314,57122365,0,77274445
IMR90|chr8:134948441-134948559,chr8,134948441,134948559,IMR90|chr8:49296845-49296874,chr8,49296845,49296874,0,85651596
IMR90|chr8:135112231-135112265,chr8,135112231,135112265,IMR90|chr8:37656597-37656684,chr8,37656597,37656684,0,97455634
IMR90|chr8:135452395-135452487,chr8,135452395,135452487,IMR90|chr8:128752406-128752429,chr8,128752406,128752429,0,6699989
IMR90|chr8:136500854-136500920,chr8,136500854,136500920,IMR90|chr8:61430830-61430899,chr8,61430830,61430899,0,75070024
IMR90|chr8:137522685-137522765,chr8,137522685,137522765,IMR90|chr8:11720117-11720161,chr8,11720117,11720161,0,125802568
IMR90|chr8:137573050-137573161,chr8,137573050,137573161,IMR90|chr8:37656476-37656515,chr8,37656476,37656515,0,99916574
IMR90|chr8:138325164-138325228,chr8,138325164,138325228,IMR90|chr8:74884138-74884216,chr8,74884138,74884216,0,63441026
IMR90|chr8:138974341-138974382,chr8,138974341,138974382,IMR90|chr8:37656476-37656515,chr8,37656476,37656515,0,101317865
IMR90|chr8:138977714-138977811,chr8,138977714,138977811,IMR90|chr8:145032639-145032683,chr8,145032639,145032683,0,6054925
IMR90|chr8:139255888-139255951,chr8,139255888,139255951,IMR90|chr8:11323190-11323255,chr8,11323190,11323255,0,127932698
IMR90|chr8:139307422-139307442,chr8,139307422,139307442,IMR90|chr8:38035864-38035987,chr8,38035864,38035987,0,101271558
IMR90|chr8:139655198-139655240,chr8,139655198,139655240,IMR90|chr8:25315102-25315144,chr8,25315102,25315144,0,114340096
IMR90|chr8:140137806-140137934,chr8,140137806,140137934,IMR90|chr8:11724120-11724144,chr8,11724120,11724144,0,128413686
IMR90|chr8:140165553-140165656,chr8,140165553,140165656,IMR90|chr8:128748976-128748998,chr8,128748976,128748998,0,11416577
IMR90|chr8:140514145-140514177,chr8,140514145,140514177,IMR90|chr8:125552252-125552336,chr8,125552252,125552336,0,14961893
IMR90|chr8:141789883-141789923,chr8,141789883,141789923,IMR90|chr8:120844350-120844427,chr8,120844350,120844427,0,20945533
IMR90|chr8:142546908-142547004,chr8,142546908,142547004,IMR90|chr8:100907519-100907562,chr8,100907519,100907562,0,41639389
IMR90|chr8:142706455-142706605,chr8,142706455,142706605,IMR90|chr8:38645536-38645572,chr8,38645536,38645572,0,104060919
IMR90|chr8:143139483-143139574,chr8,143139483,143139574,IMR90|chr8:25313763-25313786,chr8,25313763,25313786,0,117825720
IMR90|chr8:143286212-143286262,chr8,143286212,143286262,IMR90|chr8:134582012-134582091,chr8,134582012,134582091,0,8704200
IMR90|chr8:143974896-143975004,chr8,143974896,143975004,IMR90|chr8:144674754-144674796,chr8,144674754,144674796,0,699858
IMR90|chr8:144380317-144380339,chr8,144380317,144380339,IMR90|chr8:145155392-145155433,chr8,145155392,145155433,0,775075
IMR90|chr8:144436813-144436871,chr8,144436813,144436871,IMR90|chr8:142140923-142141012,chr8,142140923,142141012,0,2295890
IMR90|chr8:144481713-144481810,chr8,144481713,144481810,IMR90|chr8:145032639-145032683,chr8,145032639,145032683,0,550926
IMR90|chr8:145240997-145241042,chr8,145240997,145241042,IMR90|chr8:103432963-103433020,chr8,103432963,103433020,0,41808034
IMR90|chr8:145560331-145560369,chr8,145560331,145560369,IMR90|chr8:107077706-107077792,chr8,107077706,107077792,0,38482625
IMR90|chr8:145770836-145770908,chr8,145770836,145770908,IMR90|chr8:11327949-11328009,chr8,11327949,11328009,0,134442887
IMR90|chr8:145802985-145803046,chr8,145802985,145803046,IMR90|chr8:101732566-101732609,chr8,101732566,101732609,0,44070419
IMR90|chr8:145830741-145830841,chr8,145830741,145830841,IMR90|chr8:117781305-117781345,chr8,117781305,117781345,0,28049436
IMR90|chr8:146120693-146120717,chr8,146120693,146120717,IMR90|chr8:124086297-124086336,chr8,124086297,124086336,0,22034396
IMR90|chr9:19872-19912,chr9,19872,19912,IMR90|chr9:130342513-130342605,chr9,130342513,130342605,0,130322641
IMR90|chr9:23229-23255,chr9,23229,23255,IMR90|chr9:66455441-66455578,chr9,66455441,66455578,0,66432212
IMR90|chr9:127312-127462,chr9,127312,127462,IMR90|chr9:66454677-66454827,chr9,66454677,66454827,0,66327365
IMR90|chr9:498335-498484,chr9,498335,498484,IMR90|chr9:66454708-66454858,chr9,66454708,66454858,0,65956373
IMR90|chr9:889632-889782,chr9,889632,889782,IMR90|chr9:66454682-66454832,chr9,66454682,66454832,0,65565050
IMR90|chr9:917737-917839,chr9,917737,917839,IMR90|chr9:45442310-45442394,chr9,45442310,45442394,0,44524573
IMR90|chr9:1202978-1203021,chr9,1202978,1203021,IMR90|chr9:91146231-91146318,chr9,91146231,91146318,0,89943253
IMR90|chr9:1658951-1659029,chr9,1658951,1659029,IMR90|chr9:35731829-35731864,chr9,35731829,35731864,0,34072878
IMR90|chr9:1797577-1797715,chr9,1797577,1797715,IMR90|chr9:66454723-66454853,chr9,66454723,66454853,0,64657146
IMR90|chr9:2246814-2246882,chr9,2246814,2246882,IMR90|chr9:91149241-91149284,chr9,91149241,91149284,0,88902427
IMR90|chr9:2366127-2366242,chr9,2366127,2366242,IMR90|chr9:86576003-86576035,chr9,86576003,86576035,0,84209876
IMR90|chr9:2433680-2433810,chr9,2433680,2433810,IMR90|chr9:134613130-134613280,chr9,134613130,134613280,0,132179450
IMR90|chr9:2492409-2492485,chr9,2492409,2492485,IMR90|chr9:131643377-131643448,chr9,131643377,131643448,0,129150968
IMR90|chr9:2784552-2784615,chr9,2784552,2784615,IMR90|chr9:91146223-91146298,chr9,91146223,91146298,0,88361671
IMR90|chr9:3199108-3199171,chr9,3199108,3199171,IMR90|chr9:130859185-130859254,chr9,130859185,130859254,0,127660077
IMR90|chr9:3275555-3275628,chr9,3275555,3275628,IMR90|chr9:33474814-33474862,chr9,33474814,33474862,0,30199259
IMR90|chr9:3396874-3396912,chr9,3396874,3396912,IMR90|chr9:130345050-130345162,chr9,130345050,130345162,0,126948176
IMR90|chr9:3546348-3546423,chr9,3546348,3546423,IMR90|chr9:33474814-33474862,chr9,33474814,33474862,0,29928466
IMR90|chr9:3608425-3608492,chr9,3608425,3608492,IMR90|chr9:131873294-131873356,chr9,131873294,131873356,0,128264869
IMR90|chr9:3679491-3679641,chr9,3679491,3679641,IMR90|chr9:125129156-125129193,chr9,125129156,125129193,0,121449665
IMR90|chr9:3900740-3900773,chr9,3900740,3900773,IMR90|chr9:80646786-80646875,chr9,80646786,80646875,0,76746046
IMR90|chr9:3973152-3973242,chr9,3973152,3973242,IMR90|chr9:5625286-5625350,chr9,5625286,5625350,0,1652134
IMR90|chr9:4144097-4144173,chr9,4144097,4144173,IMR90|chr9:16726467-16726498,chr9,16726467,16726498,0,12582370
IMR90|chr9:4383372-4383428,chr9,4383372,4383428,IMR90|chr9:127022903-127023033,chr9,127022903,127023033,0,122639531
IMR90|chr9:4679992-4680023,chr9,4679992,4680023,IMR90|chr9:88357071-88357097,chr9,88357071,88357097,0,83677079
IMR90|chr9:5352804-5352865,chr9,5352804,5352865,IMR90|chr9:79793964-79794030,chr9,79793964,79794030,0,74441160
IMR90|chr9:5519480-5519574,chr9,5519480,5519574,IMR90|chr9:91145674-91145766,chr9,91145674,91145766,0,85626194
IMR90|chr9:5569701-5569851,chr9,5569701,5569851,IMR90|chr9:86576821-86576845,chr9,86576821,86576845,0,81007120
IMR90|chr9:5592590-5592652,chr9,5592590,5592652,IMR90|chr9:113801149-113801192,chr9,113801149,113801192,0,108208559
IMR90|chr9:5626981-5627130,chr9,5626981,5627130,IMR90|chr9:66454672-66454706,chr9,66454672,66454706,0,60827691
IMR90|chr9:5834988-5835087,chr9,5834988,5835087,IMR90|chr9:91146929-91146979,chr9,91146929,91146979,0,85311941
IMR90|chr9:6090438-6090527,chr9,6090438,6090527,IMR90|chr9:130346128-130346175,chr9,130346128,130346175,0,124255690
IMR90|chr9:6122920-6123029,chr9,6122920,6123029,IMR90|chr9:91145718-91145868,chr9,91145718,91145868,0,85022798
IMR90|chr9:6320331-6320481,chr9,6320331,6320481,IMR90|chr9:66454706-66454855,chr9,66454706,66454855,0,60134375
IMR90|chr9:6452164-6452274,chr9,6452164,6452274,IMR90|chr9:66454730-66454869,chr9,66454730,66454869,0,60002566
IMR90|chr9:6522484-6522591,chr9,6522484,6522591,IMR90|chr9:130375291-130375315,chr9,130375291,130375315,0,123852807
IMR90|chr9:6790396-6790546,chr9,6790396,6790546,IMR90|chr9:66454693-66454843,chr9,66454693,66454843,0,59664297
IMR90|chr9:7411859-7412009,chr9,7411859,7412009,IMR90|chr9:91145703-91145772,chr9,91145703,91145772,0,83733844
IMR90|chr9:7419652-7419697,chr9,7419652,7419697,IMR90|chr9:33478139-33478184,chr9,33478139,33478184,0,26058487
IMR90|chr9:7568750-7568828,chr9,7568750,7568828,IMR90|chr9:113016614-113016671,chr9,113016614,113016671,0,105447864
IMR90|chr9:7586741-7586787,chr9,7586741,7586787,IMR90|chr9:130345584-130345689,chr9,130345584,130345689,0,122758843
IMR90|chr9:7598903-7598968,chr9,7598903,7598968,IMR90|chr9:101015787-101015833,chr9,101015787,101015833,0,93416884
IMR90|chr9:8082005-8082118,chr9,8082005,8082118,IMR90|chr9:125129156-125129193,chr9,125129156,125129193,0,117047151
IMR90|chr9:8097022-8097046,chr9,8097022,8097046,IMR90|chr9:130328735-130328861,chr9,130328735,130328861,0,122231713
IMR90|chr9:8101571-8101644,chr9,8101571,8101644,IMR90|chr9:75768744-75768772,chr9,75768744,75768772,0,67667173
IMR90|chr9:8248431-8248581,chr9,8248431,8248581,IMR90|chr9:66454663-66454813,chr9,66454663,66454813,0,58206232
IMR90|chr9:8656888-8656931,chr9,8656888,8656931,IMR90|chr9:131445173-131445238,chr9,131445173,131445238,0,122788285
IMR90|chr9:8759837-8759924,chr9,8759837,8759924,IMR90|chr9:113796582-113796627,chr9,113796582,113796627,0,105036745
IMR90|chr9:9011459-9011506,chr9,9011459,9011506,IMR90|chr9:15422139-15422200,chr9,15422139,15422200,0,6410680
IMR90|chr9:9019439-9019504,chr9,9019439,9019504,IMR90|chr9:67336493-67336600,chr9,67336493,67336600,0,58317054
IMR90|chr9:9135285-9135338,chr9,9135285,9135338,IMR90|chr9:114662539-114662583,chr9,114662539,114662583,0,105527254
IMR90|chr9:9223156-9223222,chr9,9223156,9223222,IMR90|chr9:101015787-101015833,chr9,101015787,101015833,0,91792631
IMR90|chr9:9300389-9300434,chr9,9300389,9300434,IMR90|chr9:66454852-66454923,chr9,66454852,66454923,0,57154463
IMR90|chr9:9498744-9498894,chr9,9498744,9498894,IMR90|chr9:125129156-125129193,chr9,125129156,125129193,0,115630412
IMR90|chr9:9524362-9524436,chr9,9524362,9524436,IMR90|chr9:130345701-130345747,chr9,130345701,130345747,0,120821339
IMR90|chr9:9544292-9544367,chr9,9544292,9544367,IMR90|chr9:130855182-130855222,chr9,130855182,130855222,0,121310890
IMR90|chr9:9617623-9617705,chr9,9617623,9617705,IMR90|chr9:68409076-68409109,chr9,68409076,68409109,0,58791453
IMR90|chr9:9643679-9643722,chr9,9643679,9643722,IMR90|chr9:113798986-113799074,chr9,113798986,113799074,0,104155307
IMR90|chr9:10289982-10290096,chr9,10289982,10290096,IMR90|chr9:113796747-113796776,chr9,113796747,113796776,0,103506765
IMR90|chr9:10340988-10341104,chr9,10340988,10341104,IMR90|chr9:130345277-130345421,chr9,130345277,130345421,0,120004289
IMR90|chr9:10649576-10649656,chr9,10649576,10649656,IMR90|chr9:124034029-124034097,chr9,124034029,124034097,0,113384453
IMR90|chr9:10670860-10670878,chr9,10670860,10670878,IMR90|chr9:130211324-130211442,chr9,130211324,130211442,0,119540464
IMR90|chr9:10760488-10760533,chr9,10760488,10760533,IMR90|chr9:130345584-130345689,chr9,130345584,130345689,0,119585096
IMR90|chr9:10949325-10949436,chr9,10949325,10949436,IMR90|chr9:35961713-35961858,chr9,35961713,35961858,0,25012388
IMR90|chr9:11052764-11052784,chr9,11052764,11052784,IMR90|chr9:127022253-127022336,chr9,127022253,127022336,0,115969489
IMR90|chr9:11148978-11149043,chr9,11148978,11149043,IMR90|chr9:100956454-100956516,chr9,100956454,100956516,0,89807476
IMR90|chr9:11181751-11181826,chr9,11181751,11181826,IMR90|chr9:73025538-73025570,chr9,73025538,73025570,0,61843787
IMR90|chr9:11251113-11251217,chr9,11251113,11251217,IMR90|chr9:91148582-91148668,chr9,91148582,91148668,0,79897469
IMR90|chr9:11475443-11475537,chr9,11475443,11475537,IMR90|chr9:91795652-91795708,chr9,91795652,91795708,0,80320209
IMR90|chr9:11654287-11654362,chr9,11654287,11654362,IMR90|chr9:5437369-5437450,chr9,5437369,5437450,0,6216918
IMR90|chr9:11669773-11669870,chr9,11669773,11669870,IMR90|chr9:35729200-35729267,chr9,35729200,35729267,0,24059427
IMR90|chr9:11699427-11699507,chr9,11699427,11699507,IMR90|chr9:91791916-91792066,chr9,91791916,91792066,0,80092489
IMR90|chr9:11730795-11730856,chr9,11730795,11730856,IMR90|chr9:79793964-79794030,chr9,79793964,79794030,0,68063169
IMR90|chr9:11761184-11761260,chr9,11761184,11761260,IMR90|chr9:101471471-101471492,chr9,101471471,101471492,0,89710287
IMR90|chr9:11776004-11776037,chr9,11776004,11776037,IMR90|chr9:91146268-91146293,chr9,91146268,91146293,0,79370264
IMR90|chr9:12110032-12110147,chr9,12110032,12110147,IMR90|chr9:66454843-66454878,chr9,66454843,66454878,0,54344811
IMR90|chr9:12312066-12312137,chr9,12312066,12312137,IMR90|chr9:91146192-91146271,chr9,91146192,91146271,0,78834126
IMR90|chr9:12563693-12563709,chr9,12563693,12563709,IMR90|chr9:113799743-113799797,chr9,113799743,113799797,0,101236050
IMR90|chr9:12644860-12644880,chr9,12644860,12644880,IMR90|chr9:114657733-114657883,chr9,114657733,114657883,0,102012873
IMR90|chr9:12792529-12792572,chr9,12792529,12792572,IMR90|chr9:35730327-35730390,chr9,35730327,35730390,0,22937798
IMR90|chr9:12966547-12966632,chr9,12966547,12966632,IMR90|chr9:66455766-66455806,chr9,66455766,66455806,0,53489219
IMR90|chr9:13254319-13254341,chr9,13254319,13254341,IMR90|chr9:66454826-66454913,chr9,66454826,66454913,0,53200507
IMR90|chr9:13255959-13256038,chr9,13255959,13256038,IMR90|chr9:114663585-114663656,chr9,114663585,114663656,0,101407626
IMR90|chr9:13265167-13265290,chr9,13265167,13265290,IMR90|chr9:130330288-130330374,chr9,130330288,130330374,0,117065121
IMR90|chr9:13332464-13332592,chr9,13332464,13332592,IMR90|chr9:134613139-134613285,chr9,134613139,134613285,0,121280675
IMR90|chr9:13864187-13864270,chr9,13864187,13864270,IMR90|chr9:130344727-130344794,chr9,130344727,130344794,0,116480540
IMR90|chr9:14078761-14078817,chr9,14078761,14078817,IMR90|chr9:130345055-130345140,chr9,130345055,130345140,0,116266294
IMR90|chr9:14088082-14088129,chr9,14088082,14088129,IMR90|chr9:130344837-130344907,chr9,130344837,130344907,0,116256755
IMR90|chr9:14463784-14463831,chr9,14463784,14463831,IMR90|chr9:130342891-130342946,chr9,130342891,130342946,0,115879107
IMR90|chr9:14534396-14534500,chr9,14534396,14534500,IMR90|chr9:33474622-33474769,chr9,33474622,33474769,0,18940226
IMR90|chr9:14544926-14545035,chr9,14544926,14545035,IMR90|chr9:19375413-19375454,chr9,19375413,19375454,0,4830487
IMR90|chr9:14981059-14981197,chr9,14981059,14981197,IMR90|chr9:66454723-66454853,chr9,66454723,66454853,0,51473664
IMR90|chr9:15091434-15091492,chr9,15091434,15091492,IMR90|chr9:35083670-35083751,chr9,35083670,35083751,0,19992236
IMR90|chr9:15446916-15446991,chr9,15446916,15446991,IMR90|chr9:33474814-33474862,chr9,33474814,33474862,0,18027898
IMR90|chr9:15497362-15497402,chr9,15497362,15497402,IMR90|chr9:112888729-112888774,chr9,112888729,112888774,0,97391367
IMR90|chr9:15521752-15521855,chr9,15521752,15521855,IMR90|chr9:130344720-130344785,chr9,130344720,130344785,0,114822968
IMR90|chr9:15770668-15770764,chr9,15770668,15770764,IMR90|chr9:115094949-115095045,chr9,115094949,115095045,0,99324281
IMR90|chr9:15891970-15892053,chr9,15891970,15892053,IMR90|chr9:130344727-130344794,chr9,130344727,130344794,0,114452757
IMR90|chr9:15897664-15897733,chr9,15897664,15897733,IMR90|chr9:101016525-101016624,chr9,101016525,101016624,0,85118861
IMR90|chr9:15919464-15919503,chr9,15919464,15919503,IMR90|chr9:130342513-130342605,chr9,130342513,130342605,0,114423049
IMR90|chr9:16108761-16108823,chr9,16108761,16108823,IMR90|chr9:130344733-130344817,chr9,130344733,130344817,0,114235972
IMR90|chr9:16214160-16214197,chr9,16214160,16214197,IMR90|chr9:130341831-130341888,chr9,130341831,130341888,0,114127671
IMR90|chr9:16471302-16471361,chr9,16471302,16471361,IMR90|chr9:130345270-130345361,chr9,130345270,130345361,0,113873968
IMR90|chr9:16694397-16694440,chr9,16694397,16694440,IMR90|chr9:91148283-91148348,chr9,91148283,91148348,0,74453886
IMR90|chr9:17195380-17195453,chr9,17195380,17195453,IMR90|chr9:33474814-33474862,chr9,33474814,33474862,0,16279434
IMR90|chr9:17462742-17462787,chr9,17462742,17462787,IMR90|chr9:97769440-97769526,chr9,97769440,97769526,0,80306698
IMR90|chr9:17557146-17557221,chr9,17557146,17557221,IMR90|chr9:35070299-35070374,chr9,35070299,35070374,0,17513153
IMR90|chr9:17672845-17672872,chr9,17672845,17672872,IMR90|chr9:130342627-130342671,chr9,130342627,130342671,0,112669782
IMR90|chr9:17841101-17841159,chr9,17841101,17841159,IMR90|chr9:130344539-130344631,chr9,130344539,130344631,0,112503438
IMR90|chr9:17929190-17929268,chr9,17929190,17929268,IMR90|chr9:101017331-101017398,chr9,101017331,101017398,0,83088141
IMR90|chr9:18224151-18224228,chr9,18224151,18224228,IMR90|chr9:100958516-100958582,chr9,100958516,100958582,0,82734365
IMR90|chr9:18300335-18300362,chr9,18300335,18300362,IMR90|chr9:130342627-130342671,chr9,130342627,130342671,0,112042292
IMR90|chr9:18323106-18323160,chr9,18323106,18323160,IMR90|chr9:35729200-35729267,chr9,35729200,35729267,0,17406094
IMR90|chr9:18461543-18461660,chr9,18461543,18461660,IMR90|chr9:86576003-86576035,chr9,86576003,86576035,0,68114460
IMR90|chr9:18662973-18663059,chr9,18662973,18663059,IMR90|chr9:140019898-140019970,chr9,140019898,140019970,0,121356925
IMR90|chr9:18842109-18842187,chr9,18842109,18842187,IMR90|chr9:35731829-35731864,chr9,35731829,35731864,0,16889720
IMR90|chr9:18887568-18887657,chr9,18887568,18887657,IMR90|chr9:130344727-130344787,chr9,130344727,130344787,0,111457159
IMR90|chr9:19296119-19296158,chr9,19296119,19296158,IMR90|chr9:113799743-113799797,chr9,113799743,113799797,0,94503624
IMR90|chr9:19373140-19373222,chr9,19373140,19373222,IMR90|chr9:2843437-2843502,chr9,2843437,2843502,0,16529703
IMR90|chr9:19474040-19474094,chr9,19474040,19474094,IMR90|chr9:91145539-91145685,chr9,91145539,91145685,0,71671499
IMR90|chr9:19586749-19586826,chr9,19586749,19586826,IMR90|chr9:140019897-140019970,chr9,140019897,140019970,0,120433148
IMR90|chr9:20494757-20494809,chr9,20494757,20494809,IMR90|chr9:66454718-66454770,chr9,66454718,66454770,0,45959961
IMR90|chr9:20677018-20677057,chr9,20677018,20677057,IMR90|chr9:91145501-91145576,chr9,91145501,91145576,0,70468483
IMR90|chr9:21318473-21318605,chr9,21318473,21318605,IMR90|chr9:91145608-91145704,chr9,91145608,91145704,0,69827135
IMR90|chr9:21337209-21337295,chr9,21337209,21337295,IMR90|chr9:5625286-5625350,chr9,5625286,5625350,0,15711923
IMR90|chr9:21385471-21385586,chr9,21385471,21385586,IMR90|chr9:45442431-45442580,chr9,45442431,45442580,0,24056960
IMR90|chr9:21653421-21653471,chr9,21653421,21653471,IMR90|chr9:123881807-123881904,chr9,123881807,123881904,0,102228386
IMR90|chr9:21674102-21674129,chr9,21674102,21674129,IMR90|chr9:128511344-128511415,chr9,128511344,128511415,0,106837242
IMR90|chr9:21952942-21953023,chr9,21952942,21953023,IMR90|chr9:139688585-139688654,chr9,139688585,139688654,0,117735643
IMR90|chr9:22094000-22094150,chr9,22094000,22094150,IMR90|chr9:66454677-66454827,chr9,66454677,66454827,0,44360677
IMR90|chr9:22162315-22162372,chr9,22162315,22162372,IMR90|chr9:66455305-66455382,chr9,66455305,66455382,0,44292990
IMR90|chr9:22497416-22497470,chr9,22497416,22497470,IMR90|chr9:91145539-91145685,chr9,91145539,91145685,0,68648123
IMR90|chr9:22591144-22591195,chr9,22591144,22591195,IMR90|chr9:66454827-66454926,chr9,66454827,66454926,0,43863683
IMR90|chr9:22819871-22819928,chr9,22819871,22819928,IMR90|chr9:130328735-130328861,chr9,130328735,130328861,0,107508864
IMR90|chr9:22849358-22849392,chr9,22849358,22849392,IMR90|chr9:16726467-16726498,chr9,16726467,16726498,0,6122891
IMR90|chr9:23034607-23034659,chr9,23034607,23034659,IMR90|chr9:127020854-127020922,chr9,127020854,127020922,0,103986247
IMR90|chr9:23051762-23051795,chr9,23051762,23051795,IMR90|chr9:74979085-74979186,chr9,74979085,74979186,0,51927323
IMR90|chr9:23054480-23054585,chr9,23054480,23054585,IMR90|chr9:130345270-130345361,chr9,130345270,130345361,0,107290790
IMR90|chr9:23129479-23129554,chr9,23129479,23129554,IMR90|chr9:66455277-66455337,chr9,66455277,66455337,0,43325798
IMR90|chr9:23468792-23468941,chr9,23468792,23468941,IMR90|chr9:66454687-66454837,chr9,66454687,66454837,0,42985895
IMR90|chr9:23557224-23557297,chr9,23557224,23557297,IMR90|chr9:75768744-75768772,chr9,75768744,75768772,0,52211520
IMR90|chr9:23670132-23670172,chr9,23670132,23670172,IMR90|chr9:66454755-66454825,chr9,66454755,66454825,0,42784623
IMR90|chr9:23978020-23978136,chr9,23978020,23978136,IMR90|chr9:91149130-91149213,chr9,91149130,91149213,0,67171110
IMR90|chr9:24163400-24163447,chr9,24163400,24163447,IMR90|chr9:15422139-15422200,chr9,15422139,15422200,0,8741261
IMR90|chr9:24291180-24291234,chr9,24291180,24291234,IMR90|chr9:91145342-91145438,chr9,91145342,91145438,0,66854162
IMR90|chr9:24399640-24399729,chr9,24399640,24399729,IMR90|chr9:130344727-130344787,chr9,130344727,130344787,0,105945087
IMR90|chr9:24483013-24483053,chr9,24483013,24483053,IMR90|chr9:113799743-113799797,chr9,113799743,113799797,0,89316730
IMR90|chr9:24936371-24936408,chr9,24936371,24936408,IMR90|chr9:86594048-86594142,chr9,86594048,86594142,0,61657677
IMR90|chr9:25145421-25145494,chr9,25145421,25145494,IMR90|chr9:130344666-130344743,chr9,130344666,130344743,0,105199245
IMR90|chr9:25456507-25456652,chr9,25456507,25456652,IMR90|chr9:101017331-101017398,chr9,101017331,101017398,0,75560824
IMR90|chr9:25489267-25489285,chr9,25489267,25489285,IMR90|chr9:127960597-127960646,chr9,127960597,127960646,0,102471330
IMR90|chr9:25783478-25783604,chr9,25783478,25783604,IMR90|chr9:86576821-86576845,chr9,86576821,86576845,0,60793343
IMR90|chr9:25816782-25816857,chr9,25816782,25816857,IMR90|chr9:91146100-91146175,chr9,91146100,91146175,0,65329318
IMR90|chr9:25880170-25880233,chr9,25880170,25880233,IMR90|chr9:114661284-114661312,chr9,114661284,114661312,0,88781114
IMR90|chr9:26177524-26177595,chr9,26177524,26177595,IMR90|chr9:75768744-75768772,chr9,75768744,75768772,0,49591220
IMR90|chr9:26499475-26499580,chr9,26499475,26499580,IMR90|chr9:130345270-130345361,chr9,130345270,130345361,0,103845795
IMR90|chr9:26592566-26592609,chr9,26592566,26592609,IMR90|chr9:91146084-91146157,chr9,91146084,91146157,0,64553518
IMR90|chr9:27169893-27169921,chr9,27169893,27169921,IMR90|chr9:91146268-91146293,chr9,91146268,91146293,0,63976375
IMR90|chr9:27289899-27290044,chr9,27289899,27290044,IMR90|chr9:91145727-91145772,chr9,91145727,91145772,0,63855828
IMR90|chr9:27474213-27474281,chr9,27474213,27474281,IMR90|chr9:91145677-91145754,chr9,91145677,91145754,0,63671464
IMR90|chr9:27491488-27491526,chr9,27491488,27491526,IMR90|chr9:114660155-114660230,chr9,114660155,114660230,0,87168667
IMR90|chr9:27500943-27501093,chr9,27500943,27501093,IMR90|chr9:66454746-66454896,chr9,66454746,66454896,0,38953803
IMR90|chr9:27779861-27780011,chr9,27779861,27780011,IMR90|chr9:66454677-66454827,chr9,66454677,66454827,0,38674816
IMR90|chr9:27860961-27861067,chr9,27860961,27861067,IMR90|chr9:124032754-124032797,chr9,124032754,124032797,0,96171793
IMR90|chr9:28127486-28127573,chr9,28127486,28127573,IMR90|chr9:140019898-140019961,chr9,140019898,140019961,0,111892412
IMR90|chr9:28235379-28235430,chr9,28235379,28235430,IMR90|chr9:66455429-66455526,chr9,66455429,66455526,0,38220050
IMR90|chr9:28458171-28458213,chr9,28458171,28458213,IMR90|chr9:130660466-130660527,chr9,130660466,130660527,0,102202295
IMR90|chr9:28658961-28659038,chr9,28658961,28659038,IMR90|chr9:91145779-91145834,chr9,91145779,91145834,0,62486818
IMR90|chr9:28678743-28678843,chr9,28678743,28678843,IMR90|chr9:73029877-73029901,chr9,73029877,73029901,0,44351134
IMR90|chr9:28699180-28699306,chr9,28699180,28699306,IMR90|chr9:86576821-86576845,chr9,86576821,86576845,0,57877641
IMR90|chr9:28741530-28741678,chr9,28741530,28741678,IMR90|chr9:66454703-66454853,chr9,66454703,66454853,0,37713173
IMR90|chr9:28934256-28934406,chr9,28934256,28934406,IMR90|chr9:66454663-66454813,chr9,66454663,66454813,0,37520407
IMR90|chr9:28962553-28962694,chr9,28962553,28962694,IMR90|chr9:66454677-66454827,chr9,66454677,66454827,0,37492124
IMR90|chr9:28978606-28978672,chr9,28978606,28978672,IMR90|chr9:91146199-91146318,chr9,91146199,91146318,0,62167593
IMR90|chr9:29359520-29359551,chr9,29359520,29359551,IMR90|chr9:19101781-19101913,chr9,19101781,19101913,0,10257739
IMR90|chr9:30002631-30002700,chr9,30002631,30002700,IMR90|chr9:15423590-15423636,chr9,15423590,15423636,0,14579041
IMR90|chr9:30228854-30228878,chr9,30228854,30228878,IMR90|chr9:127021118-127021175,chr9,127021118,127021175,0,96792264
IMR90|chr9:30284269-30284294,chr9,30284269,30284294,IMR90|chr9:91147157-91147241,chr9,91147157,91147241,0,60862888
IMR90|chr9:30299510-30299584,chr9,30299510,30299584,IMR90|chr9:130345701-130345747,chr9,130345701,130345747,0,100046191
IMR90|chr9:30332217-30332234,chr9,30332217,30332234,IMR90|chr9:19101781-19101913,chr9,19101781,19101913,0,11230436
IMR90|chr9:30669059-30669102,chr9,30669059,30669102,IMR90|chr9:91146084-91146157,chr9,91146084,91146157,0,60477025
IMR90|chr9:31385080-31385133,chr9,31385080,31385133,IMR90|chr9:127023840-127023910,chr9,127023840,127023910,0,95638760
IMR90|chr9:31538768-31538870,chr9,31538768,31538870,IMR90|chr9:130344661-130344791,chr9,130344661,130344791,0,98805893
IMR90|chr9:31587368-31587419,chr9,31587368,31587419,IMR90|chr9:130694628-130694721,chr9,130694628,130694721,0,99107260
IMR90|chr9:31611044-31611092,chr9,31611044,31611092,IMR90|chr9:101016525-101016624,chr9,101016525,101016624,0,69405481
IMR90|chr9:31926404-31926492,chr9,31926404,31926492,IMR90|chr9:127178912-127178974,chr9,127178912,127178974,0,95252508
IMR90|chr9:31949109-31949176,chr9,31949109,31949176,IMR90|chr9:91146242-91146323,chr9,91146242,91146323,0,59197133
IMR90|chr9:32024530-32024679,chr9,32024530,32024679,IMR90|chr9:66454672-66454706,chr9,66454672,66454706,0,34430142
IMR90|chr9:32120789-32120851,chr9,32120789,32120851,IMR90|chr9:35688097-35688176,chr9,35688097,35688176,0,3567308
IMR90|chr9:32262968-32263045,chr9,32262968,32263045,IMR90|chr9:100958516-100958582,chr9,100958516,100958582,0,68695548
IMR90|chr9:32644115-32644163,chr9,32644115,32644163,IMR90|chr9:66455429-66455526,chr9,66455429,66455526,0,33811314
IMR90|chr9:32769181-32769208,chr9,32769181,32769208,IMR90|chr9:66454699-66454822,chr9,66454699,66454822,0,33685518
IMR90|chr9:32810397-32810473,chr9,32810397,32810473,IMR90|chr9:127025079-127025118,chr9,127025079,127025118,0,94214682
IMR90|chr9:33205174-33205254,chr9,33205174,33205254,IMR90|chr9:100958516-100958582,chr9,100958516,100958582,0,67753342
IMR90|chr9:33414074-33414108,chr9,33414074,33414108,IMR90|chr9:113017098-113017153,chr9,113017098,113017153,0,79603024
IMR90|chr9:33520187-33520272,chr9,33520187,33520272,IMR90|chr9:130344720-130344785,chr9,130344720,130344785,0,96824533
IMR90|chr9:33646966-33647043,chr9,33646966,33647043,IMR90|chr9:140019897-140019970,chr9,140019897,140019970,0,106372931
IMR90|chr9:33714757-33714808,chr9,33714757,33714808,IMR90|chr9:66455429-66455526,chr9,66455429,66455526,0,32740672
IMR90|chr9:33780492-33780571,chr9,33780492,33780571,IMR90|chr9:66454827-66454926,chr9,66454827,66454926,0,32674335
IMR90|chr9:34047848-34047951,chr9,34047848,34047951,IMR90|chr9:130344720-130344785,chr9,130344720,130344785,0,96296872
IMR90|chr9:34303956-34304049,chr9,34303956,34304049,IMR90|chr9:130345559-130345709,chr9,130345559,130345709,0,96041603
IMR90|chr9:34395563-34395648,chr9,34395563,34395648,IMR90|chr9:91145576-91145638,chr9,91145576,91145638,0,56750013
IMR90|chr9:34596403-34596484,chr9,34596403,34596484,IMR90|chr9:91145703-91145772,chr9,91145703,91145772,0,56549300
IMR90|chr9:34777336-34777407,chr9,34777336,34777407,IMR90|chr9:91146202-91146281,chr9,91146202,91146281,0,56368866
IMR90|chr9:35277426-35277477,chr9,35277426,35277477,IMR90|chr9:130694628-130694721,chr9,130694628,130694721,0,95417202
IMR90|chr9:35341857-35341908,chr9,35341857,35341908,IMR90|chr9:114659873-114659905,chr9,114659873,114659905,0,79318016
IMR90|chr9:35475343-35475392,chr9,35475343,35475392,IMR90|chr9:130699977-130700084,chr9,130699977,130700084,0,95224634
IMR90|chr9:35623899-35623937,chr9,35623899,35623937,IMR90|chr9:114659873-114659905,chr9,114659873,114659905,0,79035974
IMR90|chr9:35795717-35795761,chr9,35795717,35795761,IMR90|chr9:66454852-66454923,chr9,66454852,66454923,0,30659135
IMR90|chr9:36547890-36547924,chr9,36547890,36547924,IMR90|chr9:127021188-127021243,chr9,127021188,127021243,0,90473298
IMR90|chr9:36550938-36551018,chr9,36550938,36551018,IMR90|chr9:130371914-130371972,chr9,130371914,130371972,0,93820976
IMR90|chr9:36638927-36639077,chr9,36638927,36639077,IMR90|chr9:66454670-66454820,chr9,66454670,66454820,0,29815743
IMR90|chr9:37248438-37248588,chr9,37248438,37248588,IMR90|chr9:91145703-91145772,chr9,91145703,91145772,0,53897265
IMR90|chr9:37302392-37302496,chr9,37302392,37302496,IMR90|chr9:35962460-35962533,chr9,35962460,35962533,0,1339932
IMR90|chr9:37376348-37376413,chr9,37376348,37376413,IMR90|chr9:100956454-100956516,chr9,100956454,100956516,0,63580106
IMR90|chr9:37393617-37393764,chr9,37393617,37393764,IMR90|chr9:68409252-68409315,chr9,68409252,68409315,0,31015635
IMR90|chr9:37572475-37572554,chr9,37572475,37572554,IMR90|chr9:35731829-35731864,chr9,35731829,35731864,0,1840646
IMR90|chr9:37620226-37620282,chr9,37620226,37620282,IMR90|chr9:127022903-127023033,chr9,127022903,127023033,0,89402677
IMR90|chr9:37649496-37649538,chr9,37649496,37649538,IMR90|chr9:91145592-91145700,chr9,91145592,91145700,0,53496096
IMR90|chr9:38038201-38038347,chr9,38038201,38038347,IMR90|chr9:127024653-127024699,chr9,127024653,127024699,0,88986452
IMR90|chr9:38051588-38051638,chr9,38051588,38051638,IMR90|chr9:130212520-130212564,chr9,130212520,130212564,0,92160932
IMR90|chr9:38077467-38077517,chr9,38077467,38077517,IMR90|chr9:127020854-127020922,chr9,127020854,127020922,0,88943387
IMR90|chr9:38096872-38096968,chr9,38096872,38096968,IMR90|chr9:130344658-130344808,chr9,130344658,130344808,0,92247786
IMR90|chr9:38306582-38306619,chr9,38306582,38306619,IMR90|chr9:113017098-113017153,chr9,113017098,113017153,0,74710516
IMR90|chr9:38604170-38604201,chr9,38604170,38604201,IMR90|chr9:91146199-91146318,chr9,91146199,91146318,0,52542029
IMR90|chr9:38781693-38781801,chr9,38781693,38781801,IMR90|chr9:130375291-130375315,chr9,130375291,130375315,0,91593598
IMR90|chr9:39507425-39507490,chr9,39507425,39507490,IMR90|chr9:72658163-72658243,chr9,72658163,72658243,0,33150738
IMR90|chr9:40242330-40242408,chr9,40242330,40242408,IMR90|chr9:131643377-131643448,chr9,131643377,131643448,0,91401047
IMR90|chr9:40295347-40295381,chr9,40295347,40295381,IMR90|chr9:74979085-74979186,chr9,74979085,74979186,0,34683738
IMR90|chr9:40658713-40658810,chr9,40658713,40658810,IMR90|chr9:130344733-130344817,chr9,130344733,130344817,0,89686020
IMR90|chr9:40694125-40694189,chr9,40694125,40694189,IMR90|chr9:130330288-130330374,chr9,130330288,130330374,0,89636163
IMR90|chr9:40848470-40848553,chr9,40848470,40848553,IMR90|chr9:114660351-114660383,chr9,114660351,114660383,0,73811881
IMR90|chr9:41161200-41161349,chr9,41161200,41161349,IMR90|chr9:66454687-66454836,chr9,66454687,66454836,0,25293487
IMR90|chr9:41371681-41371744,chr9,41371681,41371744,IMR90|chr9:130343653-130343740,chr9,130343653,130343740,0,88971972
IMR90|chr9:41566415-41566463,chr9,41566415,41566463,IMR90|chr9:127960671-127960714,chr9,127960671,127960714,0,86394256
IMR90|chr9:41600533-41600651,chr9,41600533,41600651,IMR90|chr9:139688585-139688654,chr9,139688585,139688654,0,98088052
IMR90|chr9:41629770-41629869,chr9,41629770,41629869,IMR90|chr9:130344727-130344787,chr9,130344727,130344787,0,88714957
IMR90|chr9:42200014-42200095,chr9,42200014,42200095,IMR90|chr9:114660351-114660383,chr9,114660351,114660383,0,72460337
IMR90|chr9:42610378-42610484,chr9,42610378,42610484,IMR90|chr9:66454704-66454788,chr9,66454704,66454788,0,23844326
IMR90|chr9:42673452-42673523,chr9,42673452,42673523,IMR90|chr9:110046160-110046186,chr9,110046160,110046186,0,67372708
IMR90|chr9:42782252-42782295,chr9,42782252,42782295,IMR90|chr9:113798986-113799074,chr9,113798986,113799074,0,71016734
IMR90|chr9:43303837-43303888,chr9,43303837,43303888,IMR90|chr9:127022740-127022839,chr9,127022740,127022839,0,83718903
IMR90|chr9:43547358-43547404,chr9,43547358,43547404,IMR90|chr9:130345584-130345689,chr9,130345584,130345689,0,86798226
IMR90|chr9:43566922-43567018,chr9,43566922,43567018,IMR90|chr9:130344658-130344808,chr9,130344658,130344808,0,86777736
IMR90|chr9:43578514-43578664,chr9,43578514,43578664,IMR90|chr9:66454705-66454851,chr9,66454705,66454851,0,22876191
IMR90|chr9:44010740-44010868,chr9,44010740,44010868,IMR90|chr9:134613139-134613285,chr9,134613139,134613285,0,90602399
IMR90|chr9:44104781-44104849,chr9,44104781,44104849,IMR90|chr9:33474422-33474487,chr9,33474422,33474487,0,10630359
IMR90|chr9:44112094-44112201,chr9,44112094,44112201,IMR90|chr9:127178912-127178974,chr9,127178912,127178974,0,83066818
IMR90|chr9:45378216-45378296,chr9,45378216,45378296,IMR90|chr9:100958516-100958582,chr9,100958516,100958582,0,55580300
IMR90|chr9:45493174-45493219,chr9,45493174,45493219,IMR90|chr9:130345584-130345689,chr9,130345584,130345689,0,84852410
IMR90|chr9:45535391-45535469,chr9,45535391,45535469,IMR90|chr9:140019898-140019970,chr9,140019898,140019970,0,94484507
IMR90|chr9:45729172-45729250,chr9,45729172,45729250,IMR90|chr9:124034029-124034097,chr9,124034029,124034097,0,78304857
IMR90|chr9:46015133-46015191,chr9,46015133,46015191,IMR90|chr9:130696675-130696764,chr9,130696675,130696764,0,84681542
IMR90|chr9:46300020-46300054,chr9,46300020,46300054,IMR90|chr9:74979085-74979186,chr9,74979085,74979186,0,28679065
IMR90|chr9:46429531-46429595,chr9,46429531,46429595,IMR90|chr9:80646786-80646875,chr9,80646786,80646875,0,34217255
IMR90|chr9:46910400-46910481,chr9,46910400,46910481,IMR90|chr9:130696745-130696764,chr9,130696745,130696764,0,83786345
IMR90|chr9:46957258-46957331,chr9,46957258,46957331,IMR90|chr9:110046160-110046186,chr9,110046160,110046186,0,63088902
IMR90|chr9:47221186-47221225,chr9,47221186,47221225,IMR90|chr9:130343323-130343426,chr9,130343323,130343426,0,83122137
IMR90|chr9:47283897-47283939,chr9,47283897,47283939,IMR90|chr9:113798986-113799074,chr9,113798986,113799074,0,66515089
IMR90|chr9:47448930-47448952,chr9,47448930,47448952,IMR90|chr9:130635276-130635404,chr9,130635276,130635404,0,83186346
IMR90|chr9:47527675-47527739,chr9,47527675,47527739,IMR90|chr9:91148582-91148668,chr9,91148582,91148668,0,43620907
IMR90|chr9:47529738-47529832,chr9,47529738,47529832,IMR90|chr9:79793971-79794027,chr9,79793971,79794027,0,32264233
IMR90|chr9:47945793-47945925,chr9,47945793,47945925,IMR90|chr9:91145608-91145704,chr9,91145608,91145704,0,43199815
IMR90|chr9:48155657-48155735,chr9,48155657,48155735,IMR90|chr9:140019898-140019970,chr9,140019898,140019970,0,91864241
IMR90|chr9:48254613-48254728,chr9,48254613,48254728,IMR90|chr9:45442431-45442580,chr9,45442431,45442580,0,2812182
IMR90|chr9:48334460-48334504,chr9,48334460,48334504,IMR90|chr9:66454703-66454853,chr9,66454703,66454853,0,18120243
IMR90|chr9:48456666-48456752,chr9,48456666,48456752,IMR90|chr9:127178912-127178974,chr9,127178912,127178974,0,78722246
IMR90|chr9:48509673-48509736,chr9,48509673,48509736,IMR90|chr9:125132357-125132414,chr9,125132357,125132414,0,76622684
IMR90|chr9:48662194-48662272,chr9,48662194,48662272,IMR90|chr9:33020686-33020712,chr9,33020686,33020712,0,15641508
IMR90|chr9:48832795-48832871,chr9,48832795,48832871,IMR90|chr9:66455277-66455337,chr9,66455277,66455337,0,17622482
IMR90|chr9:48996756-48996848,chr9,48996756,48996848,IMR90|chr9:73034261-73034293,chr9,73034261,73034293,0,24037505
IMR90|chr9:49610152-49610209,chr9,49610152,49610209,IMR90|chr9:130328735-130328861,chr9,130328735,130328861,0,80718583
IMR90|chr9:49724986-49725132,chr9,49724986,49725132,IMR90|chr9:127024653-127024699,chr9,127024653,127024699,0,77299667
IMR90|chr9:50194218-50194368,chr9,50194218,50194368,IMR90|chr9:66454720-66454870,chr9,66454720,66454870,0,16260502
IMR90|chr9:50251556-50251635,chr9,50251556,50251635,IMR90|chr9:91148791-91148856,chr9,91148791,91148856,0,40897235
IMR90|chr9:50430432-50430582,chr9,50430432,50430582,IMR90|chr9:114659877-114659902,chr9,114659877,114659902,0,64229445
IMR90|chr9:50465281-50465344,chr9,50465281,50465344,IMR90|chr9:130343653-130343740,chr9,130343653,130343740,0,79878372
IMR90|chr9:50521378-50521412,chr9,50521378,50521412,IMR90|chr9:113017098-113017153,chr9,113017098,113017153,0,62495720
IMR90|chr9:50877848-50877945,chr9,50877848,50877945,IMR90|chr9:35729200-35729267,chr9,35729200,35729267,0,15148648
IMR90|chr9:50945774-50945832,chr9,50945774,50945832,IMR90|chr9:130696675-130696764,chr9,130696675,130696764,0,79750901
IMR90|chr9:51115918-51115991,chr9,51115918,51115991,IMR90|chr9:124032561-124032644,chr9,124032561,124032644,0,72916643
IMR90|chr9:51286749-51286789,chr9,51286749,51286789,IMR90|chr9:91148863-91148923,chr9,91148863,91148923,0,39862114
IMR90|chr9:52024041-52024072,chr9,52024041,52024072,IMR90|chr9:88357071-88357097,chr9,88357071,88357097,0,36333030
IMR90|chr9:52131649-52131768,chr9,52131649,52131768,IMR90|chr9:66454782-66454813,chr9,66454782,66454813,0,14323133
IMR90|chr9:52148362-52148420,chr9,52148362,52148420,IMR90|chr9:113798230-113798289,chr9,113798230,113798289,0,61649868
IMR90|chr9:52566025-52566045,chr9,52566025,52566045,IMR90|chr9:127022253-127022336,chr9,127022253,127022336,0,74456228
IMR90|chr9:52753702-52753849,chr9,52753702,52753849,IMR90|chr9:66454714-66454864,chr9,66454714,66454864,0,13701012
IMR90|chr9:52842159-52842249,chr9,52842159,52842249,IMR90|chr9:66454699-66454822,chr9,66454699,66454822,0,13612540
IMR90|chr9:53112593-53112632,chr9,53112593,53112632,IMR90|chr9:91145501-91145576,chr9,91145501,91145576,0,38032908
IMR90|chr9:53298877-53299027,chr9,53298877,53299027,IMR90|chr9:66454705-66454851,chr9,66454705,66454851,0,13155828
IMR90|chr9:53684513-53684532,chr9,53684513,53684532,IMR90|chr9:33022477-33022608,chr9,33022477,33022608,0,20662036
IMR90|chr9:53983320-53983406,chr9,53983320,53983406,IMR90|chr9:5625286-5625350,chr9,5625286,5625350,0,48358034
IMR90|chr9:54066779-54066837,chr9,54066779,54066837,IMR90|chr9:91145608-91145700,chr9,91145608,91145700,0,37078829
IMR90|chr9:54182561-54182655,chr9,54182561,54182655,IMR90|chr9:130345277-130345371,chr9,130345277,130345371,0,76162716
IMR90|chr9:54183152-54183302,chr9,54183152,54183302,IMR90|chr9:91795652-91795708,chr9,91795652,91795708,0,37612500
IMR90|chr9:54515226-54515240,chr9,54515226,54515240,IMR90|chr9:91146202-91146281,chr9,91146202,91146281,0,36630976
IMR90|chr9:54850731-54850784,chr9,54850731,54850784,IMR90|chr9:95054963-95055004,chr9,95054963,95055004,0,40204232
IMR90|chr9:55054280-55054347,chr9,55054280,55054347,IMR90|chr9:124032561-124032644,chr9,124032561,124032644,0,68978281
IMR90|chr9:55120544-55120648,chr9,55120544,55120648,IMR90|chr9:35962460-35962533,chr9,35962460,35962533,0,19158084
IMR90|chr9:55372851-55372948,chr9,55372851,55372948,IMR90|chr9:91792180-91792240,chr9,91792180,91792240,0,36419329
IMR90|chr9:55454255-55454282,chr9,55454255,55454282,IMR90|chr9:128511344-128511415,chr9,128511344,128511415,0,73057089
IMR90|chr9:55656420-55656507,chr9,55656420,55656507,IMR90|chr9:35730251-35730286,chr9,35730251,35730286,0,19926169
IMR90|chr9:55813136-55813212,chr9,55813136,55813212,IMR90|chr9:114663765-114663833,chr9,114663765,114663833,0,58850629
IMR90|chr9:55927569-55927661,chr9,55927569,55927661,IMR90|chr9:33022477-33022608,chr9,33022477,33022608,0,22905092
IMR90|chr9:56377802-56377876,chr9,56377802,56377876,IMR90|chr9:127025079-127025118,chr9,127025079,127025118,0,70647277
IMR90|chr9:56781900-56781938,chr9,56781900,56781938,IMR90|chr9:91145501-91145576,chr9,91145501,91145576,0,34363601
IMR90|chr9:57361888-57361992,chr9,57361888,57361992,IMR90|chr9:33474622-33474769,chr9,33474622,33474769,0,23887266
IMR90|chr9:57459321-57459388,chr9,57459321,57459388,IMR90|chr9:131873294-131873356,chr9,131873294,131873356,0,74413973
IMR90|chr9:57716708-57716798,chr9,57716708,57716798,IMR90|chr9:35730251-35730286,chr9,35730251,35730286,0,21986457
IMR90|chr9:57883921-57884071,chr9,57883921,57884071,IMR90|chr9:66454705-66454851,chr9,66454705,66454851,0,8570784
IMR90|chr9:58030467-58030491,chr9,58030467,58030491,IMR90|chr9:127021118-127021175,chr9,127021118,127021175,0,68990651
IMR90|chr9:58097679-58097763,chr9,58097679,58097763,IMR90|chr9:113017274-113017324,chr9,113017274,113017324,0,54919595
IMR90|chr9:58114704-58114798,chr9,58114704,58114798,IMR90|chr9:33478139-33478195,chr9,33478139,33478195,0,24636565
IMR90|chr9:58225203-58225293,chr9,58225203,58225293,IMR90|chr9:5627773-5627879,chr9,5627773,5627879,0,52597430
IMR90|chr9:58553516-58553596,chr9,58553516,58553596,IMR90|chr9:2843347-2843391,chr9,2843347,2843391,0,55710169
IMR90|chr9:58656464-58656566,chr9,58656464,58656566,IMR90|chr9:73034261-73034293,chr9,73034261,73034293,0,14377797
IMR90|chr9:58773553-58773699,chr9,58773553,58773699,IMR90|chr9:66454705-66454791,chr9,66454705,66454791,0,7681152
IMR90|chr9:58788401-58788550,chr9,58788401,58788550,IMR90|chr9:66454729-66454793,chr9,66454729,66454793,0,7666328
IMR90|chr9:59309872-59309903,chr9,59309872,59309903,IMR90|chr9:130371670-130371816,chr9,130371670,130371816,0,71061798
IMR90|chr9:59353242-59353391,chr9,59353242,59353391,IMR90|chr9:66454687-66454836,chr9,66454687,66454836,0,7101445
IMR90|chr9:59465120-59465191,chr9,59465120,59465191,IMR90|chr9:75768744-75768772,chr9,75768744,75768772,0,16303624
IMR90|chr9:59495605-59495673,chr9,59495605,59495673,IMR90|chr9:130696593-130696675,chr9,130696593,130696675,0,71200988
IMR90|chr9:59792297-59792367,chr9,59792297,59792367,IMR90|chr9:113800989-113801019,chr9,113800989,113801019,0,54008692
IMR90|chr9:59897359-59897402,chr9,59897359,59897402,IMR90|chr9:91146231-91146318,chr9,91146231,91146318,0,31248872
IMR90|chr9:60281012-60281109,chr9,60281012,60281109,IMR90|chr9:130213364-130213411,chr9,130213364,130213411,0,69932352
IMR90|chr9:60416495-60416645,chr9,60416495,60416645,IMR90|chr9:100958650-100958676,chr9,100958650,100958676,0,40542155
IMR90|chr9:60577673-60577787,chr9,60577673,60577787,IMR90|chr9:15423590-15423626,chr9,15423590,15423626,0,45154083
IMR90|chr9:60702217-60702276,chr9,60702217,60702276,IMR90|chr9:130345055-130345140,chr9,130345055,130345140,0,69642838
IMR90|chr9:61047142-61047244,chr9,61047142,61047244,IMR90|chr9:45442310-45442394,chr9,45442310,45442394,0,15604832
IMR90|chr9:61162735-61162789,chr9,61162735,61162789,IMR90|chr9:33022676-33022768,chr9,33022676,33022768,0,28140059
IMR90|chr9:61199363-61199385,chr9,61199363,61199385,IMR90|chr9:66454826-66454913,chr9,66454826,66454913,0,5255463
IMR90|chr9:61283255-61283320,chr9,61283255,61283320,IMR90|chr9:72658163-72658243,chr9,72658163,72658243,0,11374908
IMR90|chr9:61306059-61306134,chr9,61306059,61306134,IMR90|chr9:114663765-114663838,chr9,114663765,114663838,0,53357706
IMR90|chr9:61398997-61399114,chr9,61398997,61399114,IMR90|chr9:45442274-45442394,chr9,45442274,45442394,0,15956723
IMR90|chr9:61405726-61405799,chr9,61405726,61405799,IMR90|chr9:110046160-110046186,chr9,110046160,110046186,0,48640434
IMR90|chr9:61523551-61523594,chr9,61523551,61523594,IMR90|chr9:130699977-130700084,chr9,130699977,130700084,0,69176426
IMR90|chr9:61868240-61868271,chr9,61868240,61868271,IMR90|chr9:19101781-19101913,chr9,19101781,19101913,0,42766459
IMR90|chr9:62465271-62465343,chr9,62465271,62465343,IMR90|chr9:124032560-124032638,chr9,124032560,124032638,0,61567289
IMR90|chr9:62511799-62511874,chr9,62511799,62511874,IMR90|chr9:35070299-35070374,chr9,35070299,35070374,0,27441500
IMR90|chr9:62643031-62643052,chr9,62643031,62643052,IMR90|chr9:130344667-130344817,chr9,130344667,130344817,0,67701636
IMR90|chr9:62786805-62786874,chr9,62786805,62786874,IMR90|chr9:35728149-35728174,chr9,35728149,35728174,0,27058656
IMR90|chr9:63076958-63077108,chr9,63076958,63077108,IMR90|chr9:66454693-66454843,chr9,66454693,66454843,0,3377735
IMR90|chr9:63826831-63826847,chr9,63826831,63826847,IMR90|chr9:113799743-113799797,chr9,113799743,113799797,0,49972912
IMR90|chr9:64125089-64125106,chr9,64125089,64125106,IMR90|chr9:19101781-19101913,chr9,19101781,19101913,0,45023308
IMR90|chr9:64241681-64241823,chr9,64241681,64241823,IMR90|chr9:66454782-66454813,chr9,66454782,66454813,0,2213101
IMR90|chr9:64264911-64265061,chr9,64264911,64265061,IMR90|chr9:66454705-66454851,chr9,66454705,66454851,0,2189794
IMR90|chr9:64570200-64570287,chr9,64570200,64570287,IMR90|chr9:101015793-101015828,chr9,101015793,101015828,0,36445593
IMR90|chr9:64608491-64608593,chr9,64608491,64608593,IMR90|chr9:130344661-130344791,chr9,130344661,130344791,0,65736170
IMR90|chr9:64647330-64647480,chr9,64647330,64647480,IMR90|chr9:66454714-66454864,chr9,66454714,66454864,0,1807384
IMR90|chr9:65201522-65201566,chr9,65201522,65201566,IMR90|chr9:66454852-66454923,chr9,66454852,66454923,0,1253330
IMR90|chr9:65252616-65252690,chr9,65252616,65252690,IMR90|chr9:130855182-130855222,chr9,130855182,130855222,0,65602566
IMR90|chr9:65910260-65910410,chr9,65910260,65910410,IMR90|chr9:66454714-66454864,chr9,66454714,66454864,0,544454
IMR90|chr9:65934317-65934397,chr9,65934317,65934397,IMR90|chr9:124034029-124034097,chr9,124034029,124034097,0,58099712
IMR90|chr9:66710284-66710322,chr9,66710284,66710322,IMR90|chr9:91148626-91148701,chr9,91148626,91148701,0,24438342
IMR90|chr9:66779792-66779855,chr9,66779792,66779855,IMR90|chr9:130859185-130859254,chr9,130859185,130859254,0,64079393
IMR90|chr9:66990251-66990309,chr9,66990251,66990309,IMR90|chr9:66455305-66455382,chr9,66455305,66455382,0,534946
IMR90|chr9:67062513-67062558,chr9,67062513,67062558,IMR90|chr9:66454852-66454923,chr9,66454852,66454923,0,607661
IMR90|chr9:67288579-67288621,chr9,67288579,67288621,IMR90|chr9:113798986-113799074,chr9,113798986,113799074,0,46510407
IMR90|chr9:67465240-67465360,chr9,67465240,67465360,IMR90|chr9:91145785-91145864,chr9,91145785,91145864,0,23680545
IMR90|chr9:67757735-67757794,chr9,67757735,67757794,IMR90|chr9:91145342-91145438,chr9,91145342,91145438,0,23387607
IMR90|chr9:67905588-67905648,chr9,67905588,67905648,IMR90|chr9:35688097-35688176,chr9,35688097,35688176,0,32217491
IMR90|chr9:68116511-68116556,chr9,68116511,68116556,IMR90|chr9:97769440-97769526,chr9,97769440,97769526,0,29652929
IMR90|chr9:68215591-68215634,chr9,68215591,68215634,IMR90|chr9:91148998-91149091,chr9,91148998,91149091,0,22933407
IMR90|chr9:68494504-68494613,chr9,68494504,68494613,IMR90|chr9:91146192-91146271,chr9,91146192,91146271,0,22651688
IMR90|chr9:68597882-68597936,chr9,68597882,68597936,IMR90|chr9:35729200-35729267,chr9,35729200,35729267,0,32868682
IMR90|chr9:68616576-68616726,chr9,68616576,68616726,IMR90|chr9:66454677-66454827,chr9,66454677,66454827,0,2161899
IMR90|chr9:68654583-68654729,chr9,68654583,68654729,IMR90|chr9:113016614-113016671,chr9,113016614,113016671,0,44362031
IMR90|chr9:68879908-68879935,chr9,68879908,68879935,IMR90|chr9:127021908-127021981,chr9,127021908,127021981,0,58142000
IMR90|chr9:68927582-68927660,chr9,68927582,68927660,IMR90|chr9:124034029-124034097,chr9,124034029,124034097,0,55106447
IMR90|chr9:69342336-69342449,chr9,69342336,69342449,IMR90|chr9:125129156-125129193,chr9,125129156,125129193,0,55786820
IMR90|chr9:69744866-69745016,chr9,69744866,69745016,IMR90|chr9:66454682-66454832,chr9,66454682,66454832,0,3290184
IMR90|chr9:70134060-70134092,chr9,70134060,70134092,IMR90|chr9:88357046-88357128,chr9,88357046,88357128,0,18222986
IMR90|chr9:70579139-70579248,chr9,70579139,70579248,IMR90|chr9:91146192-91146271,chr9,91146192,91146271,0,20567053
IMR90|chr9:70926796-70926854,chr9,70926796,70926854,IMR90|chr9:66455305-66455382,chr9,66455305,66455382,0,4471491
IMR90|chr9:71051974-71052020,chr9,71051974,71052020,IMR90|chr9:91145592-91145700,chr9,91145592,91145700,0,20093618
IMR90|chr9:71272092-71272242,chr9,71272092,71272242,IMR90|chr9:130213364-130213411,chr9,130213364,130213411,0,58941272
IMR90|chr9:71671387-71671431,chr9,71671387,71671431,IMR90|chr9:131445173-131445237,chr9,131445173,131445237,0,59773786
IMR90|chr9:71796209-71796358,chr9,71796209,71796358,IMR90|chr9:66454687-66454837,chr9,66454687,66454837,0,5341522
IMR90|chr9:71949970-71950039,chr9,71949970,71950039,IMR90|chr9:33472794-33472845,chr9,33472794,33472845,0,38477176
IMR90|chr9:72519287-72519428,chr9,72519287,72519428,IMR90|chr9:66454677-66454827,chr9,66454677,66454827,0,6064610
IMR90|chr9:72852445-72852485,chr9,72852445,72852485,IMR90|chr9:113799743-113799797,chr9,113799743,113799797,0,40947298
IMR90|chr9:73058857-73058908,chr9,73058857,73058908,IMR90|chr9:114659873-114659905,chr9,114659873,114659905,0,41601016
IMR90|chr9:73107514-73107601,chr9,73107514,73107601,IMR90|chr9:101015793-101015828,chr9,101015793,101015828,0,27908279
IMR90|chr9:73290773-73290832,chr9,73290773,73290832,IMR90|chr9:80646786-80646875,chr9,80646786,80646875,0,7356013
IMR90|chr9:73327881-73327979,chr9,73327881,73327979,IMR90|chr9:130344727-130344794,chr9,130344727,130344794,0,57016846
IMR90|chr9:73388138-73388252,chr9,73388138,73388252,IMR90|chr9:113796747-113796776,chr9,113796747,113796776,0,40408609
IMR90|chr9:73427510-73427594,chr9,73427510,73427594,IMR90|chr9:113017274-113017324,chr9,113017274,113017324,0,39589764
IMR90|chr9:73809367-73809448,chr9,73809367,73809448,IMR90|chr9:114660351-114660383,chr9,114660351,114660383,0,40850984
IMR90|chr9:74055218-74055296,chr9,74055218,74055296,IMR90|chr9:113016614-113016671,chr9,113016614,113016671,0,38961396
IMR90|chr9:74225919-74226068,chr9,74225919,74226068,IMR90|chr9:66454729-66454793,chr9,66454729,66454793,0,7771190
IMR90|chr9:74469408-74469487,chr9,74469408,74469487,IMR90|chr9:91148791-91148856,chr9,91148791,91148856,0,16679383
IMR90|chr9:74821467-74821535,chr9,74821467,74821535,IMR90|chr9:130696593-130696675,chr9,130696593,130696675,0,55875126
IMR90|chr9:74866830-74866906,chr9,74866830,74866906,IMR90|chr9:131643377-131643448,chr9,131643377,131643448,0,56776547
IMR90|chr9:75172355-75172503,chr9,75172355,75172503,IMR90|chr9:66454725-66454792,chr9,66454725,66454792,0,8717630
IMR90|chr9:75323006-75323028,chr9,75323006,75323028,IMR90|chr9:130635276-130635404,chr9,130635276,130635404,0,55312270
IMR90|chr9:75356638-75356684,chr9,75356638,75356684,IMR90|chr9:97769440-97769526,chr9,97769440,97769526,0,22412802
IMR90|chr9:75491985-75492070,chr9,75491985,75492070,IMR90|chr9:66455766-66455806,chr9,66455766,66455806,0,9036219
IMR90|chr9:75572127-75572277,chr9,75572127,75572277,IMR90|chr9:131440739-131440790,chr9,131440739,131440790,0,55868612
IMR90|chr9:75595551-75595701,chr9,75595551,75595701,IMR90|chr9:66454698-66454848,chr9,66454698,66454848,0,9140853
IMR90|chr9:75694485-75694522,chr9,75694485,75694522,IMR90|chr9:86594048-86594142,chr9,86594048,86594142,0,10899563
IMR90|chr9:75781908-75781997,chr9,75781908,75781997,IMR90|chr9:130344666-130344743,chr9,130344666,130344743,0,54562758
IMR90|chr9:75788726-75788847,chr9,75788726,75788847,IMR90|chr9:130344539-130344631,chr9,130344539,130344631,0,54555813
IMR90|chr9:75896318-75896357,chr9,75896318,75896357,IMR90|chr9:130343323-130343426,chr9,130343323,130343426,0,54447005
IMR90|chr9:76170856-76170890,chr9,76170856,76170890,IMR90|chr9:127021188-127021243,chr9,127021188,127021243,0,50850332
IMR90|chr9:76328559-76328701,chr9,76328559,76328701,IMR90|chr9:66454782-66454813,chr9,66454782,66454813,0,9873777
IMR90|chr9:76460870-76460995,chr9,76460870,76460995,IMR90|chr9:114659877-114659902,chr9,114659877,114659902,0,38199007
IMR90|chr9:77166764-77166862,chr9,77166764,77166862,IMR90|chr9:127024653-127024699,chr9,127024653,127024699,0,49857889
IMR90|chr9:77216475-77216553,chr9,77216475,77216553,IMR90|chr9:101017331-101017398,chr9,101017331,101017398,0,23800856
IMR90|chr9:77231079-77231189,chr9,77231079,77231189,IMR90|chr9:45442431-45442555,chr9,45442431,45442555,0,31788648
IMR90|chr9:77873725-77873765,chr9,77873725,77873765,IMR90|chr9:35730327-35730390,chr9,35730327,35730390,0,42143398
IMR90|chr9:78055985-78056065,chr9,78055985,78056065,IMR90|chr9:91791916-91792066,chr9,91791916,91792066,0,13735931
IMR90|chr9:78283540-78283588,chr9,78283540,78283588,IMR90|chr9:66455429-66455526,chr9,66455429,66455526,0,11828111
IMR90|chr9:78784498-78784581,chr9,78784498,78784581,IMR90|chr9:114660351-114660383,chr9,114660351,114660383,0,35875853
IMR90|chr9:78868965-78869019,chr9,78868965,78869019,IMR90|chr9:33022676-33022768,chr9,33022676,33022768,0,45846289
IMR90|chr9:79020101-79020125,chr9,79020101,79020125,IMR90|chr9:130328735-130328861,chr9,130328735,130328861,0,51308634
IMR90|chr9:80588598-80588650,chr9,80588598,80588650,IMR90|chr9:127020854-127020922,chr9,127020854,127020922,0,46432256
IMR90|chr9:81012857-81012938,chr9,81012857,81012938,IMR90|chr9:139688585-139688654,chr9,139688585,139688654,0,58675728
IMR90|chr9:81515557-81515636,chr9,81515557,81515636,IMR90|chr9:66454827-66454926,chr9,66454827,66454926,0,15060730
IMR90|chr9:81657365-81657487,chr9,81657365,81657487,IMR90|chr9:124032754-124032797,chr9,124032754,124032797,0,42375389
IMR90|chr9:81942335-81942460,chr9,81942335,81942460,IMR90|chr9:114659877-114659902,chr9,114659877,114659902,0,32717542
IMR90|chr9:82091199-82091225,chr9,82091199,82091225,IMR90|chr9:91147157-91147241,chr9,91147157,91147241,0,9055958
IMR90|chr9:82241384-82241430,chr9,82241384,82241430,IMR90|chr9:97769440-97769526,chr9,97769440,97769526,0,15528056
IMR90|chr9:82427651-82427748,chr9,82427651,82427748,IMR90|chr9:91792180-91792240,chr9,91792180,91792240,0,9364529
IMR90|chr9:82519568-82519651,chr9,82519568,82519651,IMR90|chr9:101017331-101017398,chr9,101017331,101017398,0,18497763
IMR90|chr9:83081577-83081673,chr9,83081577,83081673,IMR90|chr9:115094949-115095045,chr9,115094949,115095045,0,32013372
IMR90|chr9:83443158-83443250,chr9,83443158,83443250,IMR90|chr9:33022477-33022608,chr9,33022477,33022608,0,50420681
IMR90|chr9:83704594-83704744,chr9,83704594,83704744,IMR90|chr9:66454663-66454813,chr9,66454663,66454813,0,17249931
IMR90|chr9:83707017-83707081,chr9,83707017,83707081,IMR90|chr9:80646786-80646875,chr9,80646786,80646875,0,3060231
IMR90|chr9:83905589-83905653,chr9,83905589,83905653,IMR90|chr9:91148582-91148668,chr9,91148582,91148668,0,7242993
IMR90|chr9:84774151-84774245,chr9,84774151,84774245,IMR90|chr9:33478139-33478195,chr9,33478139,33478195,0,51296012
IMR90|chr9:84799495-84799538,chr9,84799495,84799538,IMR90|chr9:91148998-91149091,chr9,91148998,91149091,0,6349503
IMR90|chr9:84954425-84954495,chr9,84954425,84954495,IMR90|chr9:113800989-113801019,chr9,113800989,113801019,0,28846564
IMR90|chr9:85249730-85249785,chr9,85249730,85249785,IMR90|chr9:130345050-130345162,chr9,130345050,130345162,0,45095320
IMR90|chr9:85485834-85485982,chr9,85485834,85485982,IMR90|chr9:66454725-66454792,chr9,66454725,66454792,0,19031109
IMR90|chr9:85816402-85816450,chr9,85816402,85816450,IMR90|chr9:100744638-100744704,chr9,100744638,100744704,0,14928236
IMR90|chr9:85865326-85865419,chr9,85865326,85865419,IMR90|chr9:113016614-113016671,chr9,113016614,113016671,0,27151288
IMR90|chr9:86249253-86249363,chr9,86249253,86249363,IMR90|chr9:45442431-45442555,chr9,45442431,45442555,0,40806822
IMR90|chr9:86781475-86781579,chr9,86781475,86781579,IMR90|chr9:91148582-91148668,chr9,91148582,91148668,0,4367107
IMR90|chr9:87037163-87037220,chr9,87037163,87037220,IMR90|chr9:114660155-114660230,chr9,114660155,114660230,0,27622992
IMR90|chr9:87087433-87087511,chr9,87087433,87087511,IMR90|chr9:137534391-137534463,chr9,137534391,137534463,0,50446958
IMR90|chr9:87164406-87164493,chr9,87164406,87164493,IMR90|chr9:140019898-140019961,chr9,140019898,140019961,0,52855492
IMR90|chr9:87365898-87365984,chr9,87365898,87365984,IMR90|chr9:127178912-127178974,chr9,127178912,127178974,0,39813014
IMR90|chr9:87555644-87555759,chr9,87555644,87555759,IMR90|chr9:86576003-86576035,chr9,86576003,86576035,0,979641
IMR90|chr9:87575050-87575148,chr9,87575050,87575148,IMR90|chr9:127024653-127024699,chr9,127024653,127024699,0,39449603
IMR90|chr9:87594188-87594266,chr9,87594188,87594266,IMR90|chr9:137534391-137534463,chr9,137534391,137534463,0,49940203
IMR90|chr9:87772261-87772339,chr9,87772261,87772339,IMR90|chr9:33020686-33020712,chr9,33020686,33020712,0,54751575
IMR90|chr9:87780193-87780287,chr9,87780193,87780287,IMR90|chr9:79793971-79794027,chr9,79793971,79794027,0,7986222
IMR90|chr9:87999126-87999179,chr9,87999126,87999179,IMR90|chr9:127023840-127023910,chr9,127023840,127023910,0,39024714
IMR90|chr9:88042049-88042128,chr9,88042049,88042128,IMR90|chr9:114663585-114663656,chr9,114663585,114663656,0,26621536
IMR90|chr9:88562153-88562240,chr9,88562153,88562240,IMR90|chr9:35730251-35730286,chr9,35730251,35730286,0,52831902
IMR90|chr9:88778461-88778520,chr9,88778461,88778520,IMR90|chr9:130345270-130345361,chr9,130345270,130345361,0,41566809
IMR90|chr9:88800927-88800954,chr9,88800927,88800954,IMR90|chr9:127021908-127021981,chr9,127021908,127021981,0,38220981
IMR90|chr9:88885366-88885448,chr9,88885366,88885448,IMR90|chr9:68409076-68409109,chr9,68409076,68409109,0,20476290
IMR90|chr9:89086200-89086244,chr9,89086200,89086244,IMR90|chr9:5627773-5627879,chr9,5627773,5627879,0,83458427
IMR90|chr9:89302331-89302401,chr9,89302331,89302401,IMR90|chr9:91145683-91145754,chr9,91145683,91145754,0,1843352
IMR90|chr9:89731695-89731815,chr9,89731695,89731815,IMR90|chr9:91145576-91145638,chr9,91145576,91145638,0,1413881
IMR90|chr9:89917499-89917572,chr9,89917499,89917572,IMR90|chr9:114660736-114660782,chr9,114660736,114660782,0,24743237
IMR90|chr9:90024925-90025074,chr9,90024925,90025074,IMR90|chr9:66454668-66454809,chr9,66454668,66454809,0,23570257
IMR90|chr9:90436983-90437057,chr9,90436983,90437057,IMR90|chr9:130855182-130855222,chr9,130855182,130855222,0,40418199
IMR90|chr9:90531842-90531916,chr9,90531842,90531916,IMR90|chr9:127025079-127025118,chr9,127025079,127025118,0,36493237
IMR90|chr9:90648294-90648322,chr9,90648294,90648322,IMR90|chr9:113017130-113017205,chr9,113017130,113017205,0,22368836
IMR90|chr9:90984656-90984708,chr9,90984656,90984708,IMR90|chr9:130858637-130858723,chr9,130858637,130858723,0,39873981
IMR90|chr9:91172156-91172305,chr9,91172156,91172305,IMR90|chr9:66454670-66454820,chr9,66454670,66454820,0,24717486
IMR90|chr9:91488205-91488355,chr9,91488205,91488355,IMR90|chr9:66454685-66454832,chr9,66454685,66454832,0,25033520
IMR90|chr9:91614112-91614169,chr9,91614112,91614169,IMR90|chr9:130212187-130212337,chr9,130212187,130212337,0,38598075
IMR90|chr9:91971930-91971967,chr9,91971930,91971967,IMR90|chr9:130635276-130635404,chr9,130635276,130635404,0,38663346
IMR90|chr9:92801036-92801107,chr9,92801036,92801107,IMR90|chr9:91145785-91145864,chr9,91145785,91145864,0,1655251
IMR90|chr9:92925693-92925711,chr9,92925693,92925711,IMR90|chr9:127960597-127960646,chr9,127960597,127960646,0,35034904
IMR90|chr9:93012097-93012140,chr9,93012097,93012140,IMR90|chr9:91148283-91148348,chr9,91148283,91148348,0,1863814
IMR90|chr9:93654687-93654707,chr9,93654687,93654707,IMR90|chr9:114657733-114657883,chr9,114657733,114657883,0,21003046
IMR90|chr9:93863983-93864058,chr9,93863983,93864058,IMR90|chr9:5437369-5437450,chr9,5437369,5437450,0,88426614
IMR90|chr9:94241155-94241245,chr9,94241155,94241245,IMR90|chr9:114663585-114663656,chr9,114663585,114663656,0,20422430
IMR90|chr9:94381531-94381629,chr9,94381531,94381629,IMR90|chr9:130344727-130344794,chr9,130344727,130344794,0,35963196
IMR90|chr9:94793320-94793470,chr9,94793320,94793470,IMR90|chr9:86576821-86576845,chr9,86576821,86576845,0,8216499
IMR90|chr9:94823436-94823586,chr9,94823436,94823586,IMR90|chr9:66454663-66454813,chr9,66454663,66454813,0,28368773
IMR90|chr9:94991344-94991417,chr9,94991344,94991417,IMR90|chr9:114660736-114660782,chr9,114660736,114660782,0,19669392
IMR90|chr9:95339324-95339396,chr9,95339324,95339396,IMR90|chr9:124032560-124032638,chr9,124032560,124032638,0,28693236
IMR90|chr9:95341012-95341052,chr9,95341012,95341052,IMR90|chr9:127021388-127021454,chr9,127021388,127021454,0,31680376
IMR90|chr9:95608000-95608071,chr9,95608000,95608071,IMR90|chr9:137534388-137534460,chr9,137534388,137534460,0,41926388
IMR90|chr9:96125992-96126109,chr9,96125992,96126109,IMR90|chr9:45442274-45442394,chr9,45442274,45442394,0,50683718
IMR90|chr9:96145121-96145197,chr9,96145121,96145197,IMR90|chr9:66455277-66455337,chr9,66455277,66455337,0,29689844
IMR90|chr9:96689327-96689477,chr9,96689327,96689477,IMR90|chr9:131440739-131440790,chr9,131440739,131440790,0,34751412
IMR90|chr9:96957915-96957991,chr9,96957915,96957991,IMR90|chr9:114663765-114663833,chr9,114663765,114663833,0,17705850
IMR90|chr9:96981022-96981128,chr9,96981022,96981128,IMR90|chr9:66454704-66454788,chr9,66454704,66454788,0,30526318
IMR90|chr9:97010107-97010133,chr9,97010107,97010133,IMR90|chr9:91147157-91147241,chr9,91147157,91147241,0,5862950
IMR90|chr9:97291445-97291473,chr9,97291445,97291473,IMR90|chr9:66455272-66455336,chr9,66455272,66455336,0,30836173
IMR90|chr9:97535180-97535242,chr9,97535180,97535242,IMR90|chr9:91146223-91146298,chr9,91146223,91146298,0,6388957
IMR90|chr9:97846731-97846881,chr9,97846731,97846881,IMR90|chr9:66454706-66454855,chr9,66454706,66454855,0,31392025
IMR90|chr9:98127775-98127834,chr9,98127775,98127834,IMR90|chr9:91145342-91145438,chr9,91145342,91145438,0,6982433
IMR90|chr9:98670836-98670868,chr9,98670836,98670868,IMR90|chr9:88357046-88357128,chr9,88357046,88357128,0,10313790
IMR90|chr9:98731446-98731553,chr9,98731446,98731553,IMR90|chr9:130375291-130375315,chr9,130375291,130375315,0,31643845
IMR90|chr9:98993465-98993545,chr9,98993465,98993545,IMR90|chr9:2843347-2843391,chr9,2843347,2843391,0,96150118
IMR90|chr9:99143439-99143545,chr9,99143439,99143545,IMR90|chr9:124032754-124032797,chr9,124032754,124032797,0,24889315
IMR90|chr9:99226058-99226091,chr9,99226058,99226091,IMR90|chr9:80646786-80646875,chr9,80646786,80646875,0,18579272
IMR90|chr9:99305845-99305928,chr9,99305845,99305928,IMR90|chr9:101017331-101017398,chr9,101017331,101017398,0,1711486
IMR90|chr9:99424317-99424380,chr9,99424317,99424380,IMR90|chr9:130213364-130213411,chr9,130213364,130213411,0,30789047
IMR90|chr9:100179168-100179243,chr9,100179168,100179243,IMR90|chr9:91146100-91146175,chr9,91146100,91146175,0,9033068
IMR90|chr9:100264887-100264945,chr9,100264887,100264945,IMR90|chr9:91145674-91145766,chr9,91145674,91145766,0,9119213
IMR90|chr9:100588848-100588964,chr9,100588848,100588964,IMR90|chr9:130345277-130345421,chr9,130345277,130345421,0,29756429
IMR90|chr9:100876287-100876406,chr9,100876287,100876406,IMR90|chr9:130345357-130345385,chr9,130345357,130345385,0,29469070
IMR90|chr9:101038089-101038164,chr9,101038089,101038164,IMR90|chr9:73025538-73025570,chr9,73025538,73025570,0,28012551
IMR90|chr9:101485772-101485847,chr9,101485772,101485847,IMR90|chr9:66455277-66455337,chr9,66455277,66455337,0,35030495
IMR90|chr9:101555090-101555134,chr9,101555090,101555134,IMR90|chr9:91148863-91148923,chr9,91148863,91148923,0,10406227
IMR90|chr9:101559408-101559500,chr9,101559408,101559500,IMR90|chr9:67336770-67336920,chr9,67336770,67336920,0,34222638
IMR90|chr9:101955051-101955126,chr9,101955051,101955126,IMR90|chr9:114663765-114663838,chr9,114663765,114663838,0,12708714
IMR90|chr9:102141179-102141229,chr9,102141179,102141229,IMR90|chr9:127020854-127020922,chr9,127020854,127020922,0,24879675
IMR90|chr9:102174060-102174177,chr9,102174060,102174177,IMR90|chr9:86576003-86576035,chr9,86576003,86576035,0,15598057
IMR90|chr9:102212988-102213059,chr9,102212988,102213059,IMR90|chr9:91146192-91146271,chr9,91146192,91146271,0,11066796
IMR90|chr9:102278837-102278874,chr9,102278837,102278874,IMR90|chr9:113797821-113797917,chr9,113797821,113797917,0,11518984
IMR90|chr9:102281384-102281456,chr9,102281384,102281456,IMR90|chr9:130343653-130343740,chr9,130343653,130343740,0,28062269
IMR90|chr9:102281854-102281956,chr9,102281854,102281956,IMR90|chr9:73034261-73034293,chr9,73034261,73034293,0,29247593
IMR90|chr9:102486487-102486571,chr9,102486487,102486571,IMR90|chr9:91145608-91145700,chr9,91145608,91145700,0,11340879
IMR90|chr9:102665419-102665497,chr9,102665419,102665497,IMR90|chr9:131643377-131643448,chr9,131643377,131643448,0,28977958
IMR90|chr9:102900251-102900345,chr9,102900251,102900345,IMR90|chr9:130345277-130345371,chr9,130345277,130345371,0,27445026
IMR90|chr9:102917957-102918051,chr9,102917957,102918051,IMR90|chr9:91145674-91145766,chr9,91145674,91145766,0,11772283
IMR90|chr9:103080157-103080200,chr9,103080157,103080200,IMR90|chr9:131445173-131445238,chr9,131445173,131445238,0,28365016
IMR90|chr9:103305852-103305885,chr9,103305852,103305885,IMR90|chr9:74979085-74979186,chr9,74979085,74979186,0,28326767
IMR90|chr9:103460469-103460542,chr9,103460469,103460542,IMR90|chr9:124032561-124032644,chr9,124032561,124032644,0,20572092
IMR90|chr9:103571690-103571840,chr9,103571690,103571840,IMR90|chr9:66454746-66454896,chr9,66454746,66454896,0,37116944
IMR90|chr9:103618963-103619042,chr9,103618963,103619042,IMR90|chr9:35731829-35731864,chr9,35731829,35731864,0,67887134
IMR90|chr9:103657521-103657671,chr9,103657521,103657671,IMR90|chr9:66454677-66454827,chr9,66454677,66454827,0,37202844
IMR90|chr9:103751182-103751220,chr9,103751182,103751220,IMR90|chr9:114659873-114659905,chr9,114659873,114659905,0,10908691
IMR90|chr9:103842876-103843026,chr9,103842876,103843026,IMR90|chr9:66454677-66454827,chr9,66454677,66454827,0,37388199
IMR90|chr9:104223173-104223246,chr9,104223173,104223246,IMR90|chr9:130344666-130344743,chr9,130344666,130344743,0,26121493
IMR90|chr9:104241005-104241042,chr9,104241005,104241042,IMR90|chr9:113016716-113016821,chr9,113016716,113016821,0,8775711
IMR90|chr9:104412293-104412377,chr9,104412293,104412377,IMR90|chr9:66454887-66454937,chr9,66454887,66454937,0,37957406
IMR90|chr9:104415993-104416107,chr9,104415993,104416107,IMR90|chr9:15423590-15423626,chr9,15423590,15423626,0,88992403
IMR90|chr9:104524750-104524777,chr9,104524750,104524777,IMR90|chr9:91145744-91145848,chr9,91145744,91145848,0,13379006
IMR90|chr9:104880509-104880562,chr9,104880509,104880562,IMR90|chr9:127022740-127022839,chr9,127022740,127022839,0,22142231
IMR90|chr9:104915249-104915273,chr9,104915249,104915273,IMR90|chr9:101015651-101015691,chr9,101015651,101015691,0,3899598
IMR90|chr9:105314762-105314912,chr9,105314762,105314912,IMR90|chr9:66454737-66454887,chr9,66454737,66454887,0,38860025
IMR90|chr9:105463498-105463643,chr9,105463498,105463643,IMR90|chr9:91145727-91145772,chr9,91145727,91145772,0,14317771
IMR90|chr9:105615271-105615337,chr9,105615271,105615337,IMR90|chr9:91146199-91146318,chr9,91146199,91146318,0,14469072
IMR90|chr9:105757960-105758048,chr9,105757960,105758048,IMR90|chr9:127178912-127178974,chr9,127178912,127178974,0,21420952
IMR90|chr9:105915048-105915076,chr9,105915048,105915076,IMR90|chr9:33478333-33478417,chr9,33478333,33478417,0,72436715
IMR90|chr9:106095162-106095311,chr9,106095162,106095311,IMR90|chr9:66454668-66454809,chr9,66454668,66454809,0,39640494
IMR90|chr9:106322606-106322637,chr9,106322606,106322637,IMR90|chr9:91146199-91146318,chr9,91146199,91146318,0,15176407
IMR90|chr9:106432511-106432548,chr9,106432511,106432548,IMR90|chr9:130341831-130341888,chr9,130341831,130341888,0,23909320
IMR90|chr9:106441962-106442086,chr9,106441962,106442086,IMR90|chr9:100958650-100958676,chr9,100958650,100958676,0,5483312
IMR90|chr9:106452256-106452346,chr9,106452256,106452346,IMR90|chr9:66454699-66454822,chr9,66454699,66454822,0,39997557
IMR90|chr9:106546093-106546121,chr9,106546093,106546121,IMR90|chr9:91146268-91146293,chr9,91146268,91146293,0,15399825
IMR90|chr9:106867295-106867445,chr9,106867295,106867445,IMR90|chr9:66454670-66454820,chr9,66454670,66454820,0,40412625
IMR90|chr9:107210432-107210525,chr9,107210432,107210525,IMR90|chr9:130345559-130345709,chr9,130345559,130345709,0,23135127
IMR90|chr9:107269539-107269558,chr9,107269539,107269558,IMR90|chr9:111881159-111881230,chr9,111881159,111881230,0,4611620
IMR90|chr9:107408767-107408801,chr9,107408767,107408801,IMR90|chr9:16726467-16726498,chr9,16726467,16726498,0,90682300
IMR90|chr9:107422281-107422302,chr9,107422281,107422302,IMR90|chr9:130344667-130344817,chr9,130344667,130344817,0,22922386
IMR90|chr9:107577125-107577162,chr9,107577125,107577162,IMR90|chr9:113797821-113797917,chr9,113797821,113797917,0,6220696
IMR90|chr9:107592420-107592488,chr9,107592420,107592488,IMR90|chr9:5437369-5437450,chr9,5437369,5437450,0,102155051
IMR90|chr9:107916990-107917101,chr9,107916990,107917101,IMR90|chr9:35961713-35961858,chr9,35961713,35961858,0,71955277
IMR90|chr9:107965942-107966026,chr9,107965942,107966026,IMR90|chr9:91145608-91145700,chr9,91145608,91145700,0,16820334
IMR90|chr9:107987008-107987033,chr9,107987008,107987033,IMR90|chr9:91147157-91147241,chr9,91147157,91147241,0,16839851
IMR90|chr9:108057109-108057159,chr9,108057109,108057159,IMR90|chr9:66454826-66454913,chr9,66454826,66454913,0,41602283
IMR90|chr9:108480075-108480195,chr9,108480075,108480195,IMR90|chr9:91145576-91145638,chr9,91145576,91145638,0,17334499
IMR90|chr9:108676229-108676272,chr9,108676229,108676272,IMR90|chr9:130699977-130700084,chr9,130699977,130700084,0,22023748
IMR90|chr9:109025053-109025110,chr9,109025053,109025110,IMR90|chr9:130212187-130212337,chr9,130212187,130212337,0,21187134
IMR90|chr9:109054244-109054335,chr9,109054244,109054335,IMR90|chr9:91795652-91795708,chr9,91795652,91795708,0,17258592
IMR90|chr9:109114156-109114203,chr9,109114156,109114203,IMR90|chr9:130344837-130344907,chr9,130344837,130344907,0,21230681
IMR90|chr9:109276251-109276341,chr9,109276251,109276341,IMR90|chr9:5625286-5625350,chr9,5625286,5625350,0,103650965
IMR90|chr9:109310308-109310359,chr9,109310308,109310359,IMR90|chr9:66454827-66454926,chr9,66454827,66454926,0,42855481
IMR90|chr9:109576539-109576566,chr9,109576539,109576566,IMR90|chr9:66454699-66454822,chr9,66454699,66454822,0,43121840
IMR90|chr9:109715431-109715523,chr9,109715431,109715523,IMR90|chr9:73034261-73034293,chr9,73034261,73034293,0,36681170
IMR90|chr9:109752908-109753027,chr9,109752908,109753027,IMR90|chr9:130345357-130345385,chr9,130345357,130345385,0,20592449
IMR90|chr9:110450197-110450267,chr9,110450197,110450267,IMR90|chr9:91145683-91145754,chr9,91145683,91145754,0,19304514
IMR90|chr9:110509986-110510055,chr9,110509986,110510055,IMR90|chr9:33472794-33472845,chr9,33472794,33472845,0,77037192
IMR90|chr9:110652788-110652911,chr9,110652788,110652911,IMR90|chr9:130330288-130330374,chr9,130330288,130330374,0,19677500
IMR90|chr9:110703244-110703393,chr9,110703244,110703393,IMR90|chr9:66454670-66454820,chr9,66454670,66454820,0,44248574
IMR90|chr9:111033199-111033270,chr9,111033199,111033270,IMR90|chr9:91145785-91145864,chr9,91145785,91145864,0,19887414
IMR90|chr9:111143644-111143711,chr9,111143644,111143711,IMR90|chr9:124032561-124032644,chr9,124032561,124032644,0,12888917
IMR90|chr9:111147001-111147039,chr9,111147001,111147039,IMR90|chr9:91145501-91145576,chr9,91145501,91145576,0,20001500
IMR90|chr9:111166560-111166629,chr9,111166560,111166629,IMR90|chr9:35728149-35728174,chr9,35728149,35728174,0,75438411
IMR90|chr9:111243897-111243982,chr9,111243897,111243982,IMR90|chr9:2843437-2843502,chr9,2843437,2843502,0,108400460
IMR90|chr9:111435986-111436054,chr9,111435986,111436054,IMR90|chr9:91149241-91149284,chr9,91149241,91149284,0,20286745
IMR90|chr9:111763239-111763279,chr9,111763239,111763279,IMR90|chr9:35730327-35730390,chr9,35730327,35730390,0,76032912
IMR90|chr9:112147916-112147947,chr9,112147916,112147947,IMR90|chr9:130371670-130371816,chr9,130371670,130371816,0,18223754
IMR90|chr9:112354159-112354278,chr9,112354159,112354278,IMR90|chr9:66454782-66454813,chr9,66454782,66454813,0,45899377
IMR90|chr9:112524942-112525049,chr9,112524942,112525049,IMR90|chr9:127178912-127178974,chr9,127178912,127178974,0,14653970
IMR90|chr9:112802184-112802246,chr9,112802184,112802246,IMR90|chr9:35688097-35688176,chr9,35688097,35688176,0,77114087
IMR90|chr9:113447847-113447997,chr9,113447847,113447997,IMR90|chr9:130213364-130213411,chr9,130213364,130213411,0,16765517
IMR90|chr9:113456472-113456541,chr9,113456472,113456541,IMR90|chr9:15423590-15423636,chr9,15423590,15423636,0,98032882
IMR90|chr9:113561357-113561437,chr9,113561357,113561437,IMR90|chr9:130343866-130343930,chr9,130343866,130343930,0,16782509
IMR90|chr9:113762270-113762319,chr9,113762270,113762319,IMR90|chr9:130699977-130700084,chr9,130699977,130700084,0,16937707
IMR90|chr9:113985842-113985880,chr9,113985842,113985880,IMR90|chr9:91148626-91148701,chr9,91148626,91148701,0,22837216
IMR90|chr9:114323201-114323227,chr9,114323201,114323227,IMR90|chr9:66455698-66455802,chr9,66455698,66455802,0,47867503
IMR90|chr9:114911617-114911645,chr9,114911617,114911645,IMR90|chr9:66455272-66455336,chr9,66455272,66455336,0,48456345
IMR90|chr9:115115492-115115591,chr9,115115492,115115591,IMR90|chr9:130344727-130344787,chr9,130344727,130344787,0,15229235
IMR90|chr9:115146008-115146076,chr9,115146008,115146076,IMR90|chr9:33474422-33474487,chr9,33474422,33474487,0,81671586
IMR90|chr9:115406626-115406684,chr9,115406626,115406684,IMR90|chr9:113798230-113798289,chr9,113798230,113798289,0,1608396
IMR90|chr9:115664255-115664335,chr9,115664255,115664335,IMR90|chr9:130371914-130371972,chr9,130371914,130371972,0,14707659
IMR90|chr9:115841157-115841209,chr9,115841157,115841209,IMR90|chr9:66454718-66454770,chr9,66454718,66454770,0,49386439
IMR90|chr9:115883038-115883188,chr9,115883038,115883188,IMR90|chr9:66454685-66454832,chr9,66454685,66454832,0,49428353
IMR90|chr9:116064406-116064478,chr9,116064406,116064478,IMR90|chr9:130343653-130343740,chr9,130343653,130343740,0,14279247
IMR90|chr9:116079076-116079138,chr9,116079076,116079138,IMR90|chr9:130344733-130344817,chr9,130344733,130344817,0,14265657
IMR90|chr9:116202014-116202101,chr9,116202014,116202101,IMR90|chr9:113796582-113796627,chr9,113796582,113796627,0,2405432
IMR90|chr9:116214605-116214632,chr9,116214605,116214632,IMR90|chr9:91145744-91145848,chr9,91145744,91145848,0,25068861
IMR90|chr9:116262970-116263091,chr9,116262970,116263091,IMR90|chr9:130344539-130344631,chr9,130344539,130344631,0,14081569
IMR90|chr9:116406491-116406531,chr9,116406491,116406531,IMR90|chr9:130342513-130342605,chr9,130342513,130342605,0,13936022
IMR90|chr9:116687615-116687643,chr9,116687615,116687643,IMR90|chr9:138986356-138986494,chr9,138986356,138986494,0,22298741
IMR90|chr9:116733327-116733477,chr9,116733327,116733477,IMR90|chr9:66454705-66454848,chr9,66454705,66454848,0,50278622
IMR90|chr9:116851739-116851802,chr9,116851739,116851802,IMR90|chr9:125132357-125132414,chr9,125132357,125132414,0,8280618
IMR90|chr9:116959284-116959330,chr9,116959284,116959330,IMR90|chr9:91145592-91145700,chr9,91145592,91145700,0,25813692
IMR90|chr9:117257342-117257427,chr9,117257342,117257427,IMR90|chr9:130344720-130344785,chr9,130344720,130344785,0,13087378
IMR90|chr9:117310838-117310914,chr9,117310838,117310914,IMR90|chr9:101471471-101471492,chr9,101471471,101471492,0,15839367
IMR90|chr9:117349041-117349191,chr9,117349041,117349191,IMR90|chr9:66454720-66454870,chr9,66454720,66454870,0,50894321
IMR90|chr9:117555064-117555097,chr9,117555064,117555097,IMR90|chr9:91146268-91146293,chr9,91146268,91146293,0,26408796
IMR90|chr9:117803904-117803932,chr9,117803904,117803932,IMR90|chr9:33478333-33478417,chr9,33478333,33478417,0,84325571
IMR90|chr9:118375619-118375695,chr9,118375619,118375695,IMR90|chr9:127025079-127025118,chr9,127025079,127025118,0,8649460
IMR90|chr9:119047426-119047506,chr9,119047426,119047506,IMR90|chr9:130343866-130343930,chr9,130343866,130343930,0,11296440
IMR90|chr9:119050703-119050793,chr9,119050703,119050793,IMR90|chr9:5627773-5627879,chr9,5627773,5627879,0,113422930
IMR90|chr9:119253307-119253365,chr9,119253307,119253365,IMR90|chr9:91145674-91145766,chr9,91145674,91145766,0,28107633
IMR90|chr9:119442285-119442382,chr9,119442285,119442382,IMR90|chr9:130213364-130213411,chr9,130213364,130213411,0,10771079
IMR90|chr9:119576831-119576871,chr9,119576831,119576871,IMR90|chr9:91148863-91148923,chr9,91148863,91148923,0,28427968
IMR90|chr9:119607266-119607305,chr9,119607266,119607305,IMR90|chr9:130342513-130342605,chr9,130342513,130342605,0,10735247
IMR90|chr9:119781265-119781322,chr9,119781265,119781322,IMR90|chr9:114660155-114660230,chr9,114660155,114660230,0,5121110
IMR90|chr9:120041967-120042018,chr9,120041967,120042018,IMR90|chr9:5627780-5627879,chr9,5627780,5627879,0,114414187
IMR90|chr9:120494957-120495019,chr9,120494957,120495019,IMR90|chr9:113801149-113801192,chr9,113801149,113801192,0,6693808
IMR90|chr9:120511272-120511361,chr9,120511272,120511361,IMR90|chr9:130346128-130346175,chr9,130346128,130346175,0,9834856
IMR90|chr9:120609478-120609530,chr9,120609478,120609530,IMR90|chr9:130858637-130858723,chr9,130858637,130858723,0,10249159
IMR90|chr9:120745697-120745740,chr9,120745697,120745740,IMR90|chr9:35730327-35730390,chr9,35730327,35730390,0,85015370
IMR90|chr9:120747158-120747203,chr9,120747158,120747203,IMR90|chr9:33478139-33478184,chr9,33478139,33478184,0,87269019
IMR90|chr9:120821595-120821689,chr9,120821595,120821689,IMR90|chr9:91795652-91795708,chr9,91795652,91795708,0,29025943
IMR90|chr9:121104420-121104458,chr9,121104420,121104458,IMR90|chr9:114660155-114660230,chr9,114660155,114660230,0,6444265
IMR90|chr9:121207183-121207202,chr9,121207183,121207202,IMR90|chr9:33022477-33022608,chr9,33022477,33022608,0,88184706
IMR90|chr9:121275865-121275909,chr9,121275865,121275909,IMR90|chr9:91148863-91148923,chr9,91148863,91148923,0,30127002
IMR90|chr9:121839086-121839179,chr9,121839086,121839179,IMR90|chr9:113016614-113016671,chr9,113016614,113016671,0,8822472
IMR90|chr9:122093076-122093123,chr9,122093076,122093123,IMR90|chr9:130342891-130342946,chr9,130342891,130342946,0,8249815
IMR90|chr9:122292109-122292198,chr9,122292109,122292198,IMR90|chr9:130344666-130344743,chr9,130344666,130344743,0,8052557
IMR90|chr9:122717412-122717452,chr9,122717412,122717452,IMR90|chr9:127021388-127021454,chr9,127021388,127021454,0,4303976
IMR90|chr9:122866109-122866159,chr9,122866109,122866159,IMR90|chr9:123881807-123881904,chr9,123881807,123881904,0,1015698
IMR90|chr9:123043743-123043889,chr9,123043743,123043889,IMR90|chr9:66454705-66454791,chr9,66454705,66454791,0,56589038
IMR90|chr9:123214017-123214055,chr9,123214017,123214055,IMR90|chr9:130345050-130345162,chr9,130345050,130345162,0,7131033
IMR90|chr9:123388155-123388209,chr9,123388155,123388209,IMR90|chr9:91145342-91145438,chr9,91145342,91145438,0,32242813
IMR90|chr9:123563930-123564050,chr9,123563930,123564050,IMR90|chr9:91145785-91145864,chr9,91145785,91145864,0,32418145
IMR90|chr9:123585054-123585199,chr9,123585054,123585199,IMR90|chr9:101017331-101017398,chr9,101017331,101017398,0,22567723
IMR90|chr9:123637868-123638015,chr9,123637868,123638015,IMR90|chr9:66454714-66454864,chr9,66454714,66454864,0,57183154
IMR90|chr9:123791861-123791927,chr9,123791861,123791927,IMR90|chr9:101015787-101015833,chr9,101015787,101015833,0,22776074
IMR90|chr9:123895136-123895199,chr9,123895136,123895199,IMR90|chr9:114661284-114661312,chr9,114661284,114661312,0,9233852
IMR90|chr9:123943382-123943437,chr9,123943382,123943437,IMR90|chr9:130345050-130345162,chr9,130345050,130345162,0,6401668
IMR90|chr9:124028946-124029045,chr9,124028946,124029045,IMR90|chr9:73029877-73029901,chr9,73029877,73029901,0,50999069
IMR90|chr9:124029913-124029999,chr9,124029913,124029999,IMR90|chr9:140019898-140019970,chr9,140019898,140019970,0,15989985
IMR90|chr9:124066171-124066276,chr9,124066171,124066276,IMR90|chr9:113801149-113801178,chr9,113801149,113801178,0,10265022
IMR90|chr9:124284589-124284660,chr9,124284589,124284660,IMR90|chr9:91146202-91146281,chr9,91146202,91146281,0,33138387
IMR90|chr9:124306920-124306961,chr9,124306920,124306961,IMR90|chr9:112888712-112888774,chr9,112888712,112888774,0,11418208
IMR90|chr9:124352392-124352445,chr9,124352392,124352445,IMR90|chr9:127022740-127022839,chr9,127022740,127022839,0,2670348
IMR90|chr9:124655045-124655130,chr9,124655045,124655130,IMR90|chr9:2843437-2843502,chr9,2843437,2843502,0,121811608
IMR90|chr9:124879588-124879636,chr9,124879588,124879636,IMR90|chr9:100744638-100744704,chr9,100744638,100744704,0,24134950
IMR90|chr9:125163144-125163206,chr9,125163144,125163206,IMR90|chr9:91146223-91146298,chr9,91146223,91146298,0,34016921
IMR90|chr9:125327040-125327105,chr9,125327040,125327105,IMR90|chr9:101015787-101015833,chr9,101015787,101015833,0,24311253
IMR90|chr9:125369250-125369400,chr9,125369250,125369400,IMR90|chr9:66454737-66454887,chr9,66454737,66454887,0,58914513
IMR90|chr9:125608195-125608235,chr9,125608195,125608235,IMR90|chr9:112888729-112888774,chr9,112888729,112888774,0,12719466
IMR90|chr9:125904597-125904615,chr9,125904597,125904615,IMR90|chr9:130211324-130211442,chr9,130211324,130211442,0,4306727
IMR90|chr9:125916002-125916089,chr9,125916002,125916089,IMR90|chr9:114661033-114661091,chr9,114661033,114661091,0,11254969
IMR90|chr9:126046327-126046477,chr9,126046327,126046477,IMR90|chr9:66454752-66454902,chr9,66454752,66454902,0,59591575
IMR90|chr9:126338153-126338217,chr9,126338153,126338217,IMR90|chr9:130330288-130330374,chr9,130330288,130330374,0,3992135
IMR90|chr9:126470933-126471030,chr9,126470933,126471030,IMR90|chr9:66454670-66454700,chr9,66454670,66454700,0,60016263
IMR90|chr9:126760386-126760536,chr9,126760386,126760536,IMR90|chr9:66454705-66454848,chr9,66454705,66454848,0,60305681
IMR90|chr9:127053159-127053218,chr9,127053159,127053218,IMR90|chr9:130345055-130345140,chr9,130345055,130345140,0,3291896
IMR90|chr9:127086367-127086417,chr9,127086367,127086417,IMR90|chr9:130212520-130212564,chr9,130212520,130212564,0,3126153
IMR90|chr9:127214169-127214217,chr9,127214169,127214217,IMR90|chr9:101016525-101016624,chr9,101016525,101016624,0,26197644
IMR90|chr9:127690048-127690101,chr9,127690048,127690101,IMR90|chr9:95054963-95055004,chr9,95054963,95055004,0,32635085
IMR90|chr9:128303269-128303311,chr9,128303269,128303311,IMR90|chr9:91145592-91145700,chr9,91145592,91145700,0,37157677
IMR90|chr9:128486417-128486445,chr9,128486417,128486445,IMR90|chr9:138986356-138986494,chr9,138986356,138986494,0,10499939
IMR90|chr9:128694305-128694395,chr9,128694305,128694395,IMR90|chr9:114663585-114663656,chr9,114663585,114663656,0,14030720
IMR90|chr9:129144205-129144292,chr9,129144205,129144292,IMR90|chr9:114661033-114661091,chr9,114661033,114661091,0,14483172
IMR90|chr9:129498846-129498887,chr9,129498846,129498887,IMR90|chr9:112888712-112888774,chr9,112888712,112888774,0,16610134
IMR90|chr9:129658957-129658981,chr9,129658957,129658981,IMR90|chr9:101015651-101015691,chr9,101015651,101015691,0,28643306
IMR90|chr9:129670970-129671119,chr9,129670970,129671119,IMR90|chr9:66454708-66454858,chr9,66454708,66454858,0,63216262
IMR90|chr9:129807914-129807972,chr9,129807914,129807972,IMR90|chr9:130344539-130344631,chr9,130344539,130344631,0,536625
IMR90|chr9:129906673-129906764,chr9,129906673,129906764,IMR90|chr9:91795652-91795708,chr9,91795652,91795708,0,38111021
IMR90|chr9:129923854-129923922,chr9,129923854,129923922,IMR90|chr9:5437369-5437450,chr9,5437369,5437450,0,124486485
IMR90|chr9:130107698-130107717,chr9,130107698,130107717,IMR90|chr9:111881159-111881230,chr9,111881159,111881230,0,18226539
IMR90|chr9:130179369-130179466,chr9,130179369,130179466,IMR90|chr9:66454670-66454700,chr9,66454670,66454700,0,63724699
IMR90|chr9:130724197-130724211,chr9,130724197,130724211,IMR90|chr9:91146202-91146281,chr9,91146202,91146281,0,39577995
IMR90|chr9:130923104-130923155,chr9,130923104,130923155,IMR90|chr9:127022740-127022839,chr9,127022740,127022839,0,3900364
IMR90|chr9:130996231-130996281,chr9,130996231,130996281,IMR90|chr9:66454826-66454913,chr9,66454826,66454913,0,64541405
IMR90|chr9:131089709-131089765,chr9,131089709,131089765,IMR90|chr9:130345055-130345140,chr9,130345055,130345140,0,744654
IMR90|chr9:131270361-131270414,chr9,131270361,131270414,IMR90|chr9:114662539-114662583,chr9,114662539,114662583,0,16607822
IMR90|chr9:131437284-131437344,chr9,131437284,131437344,IMR90|chr9:35688097-35688176,chr9,35688097,35688176,0,95749187
IMR90|chr9:131440805-131440882,chr9,131440805,131440882,IMR90|chr9:91145779-91145834,chr9,91145779,91145834,0,40295026
IMR90|chr9:132309073-132309163,chr9,132309073,132309163,IMR90|chr9:35730251-35730286,chr9,35730251,35730286,0,96578822
IMR90|chr9:132623954-132624053,chr9,132623954,132624053,IMR90|chr9:73029877-73029901,chr9,73029877,73029901,0,59594077
IMR90|chr9:132675338-132675419,chr9,132675338,132675419,IMR90|chr9:130696745-130696764,chr9,130696745,130696764,0,1978593
IMR90|chr9:132722971-132723053,chr9,132722971,132723053,IMR90|chr9:2843437-2843502,chr9,2843437,2843502,0,129879534
IMR90|chr9:132754069-132754219,chr9,132754069,132754219,IMR90|chr9:66454752-66454902,chr9,66454752,66454902,0,66299317
IMR90|chr9:132833961-132834037,chr9,132833961,132834037,IMR90|chr9:16726467-16726498,chr9,16726467,16726498,0,116107494
IMR90|chr9:133278420-133278528,chr9,133278420,133278528,IMR90|chr9:130375291-130375315,chr9,130375291,130375315,0,2903129
IMR90|chr9:133374847-133374965,chr9,133374847,133374965,IMR90|chr9:139688585-139688654,chr9,139688585,139688654,0,6313738
IMR90|chr9:133466913-133466972,chr9,133466913,133466972,IMR90|chr9:80646786-80646875,chr9,80646786,80646875,0,52820127
IMR90|chr9:133832723-133832780,chr9,133832723,133832780,IMR90|chr9:66455305-66455382,chr9,66455305,66455382,0,67377418
IMR90|chr9:134091240-134091370,chr9,134091240,134091370,IMR90|chr9:134613130-134613280,chr9,134613130,134613280,0,521890
IMR90|chr9:134138258-134138343,chr9,134138258,134138343,IMR90|chr9:91145576-91145638,chr9,91145576,91145638,0,42992682
IMR90|chr9:134270371-134270521,chr9,134270371,134270521,IMR90|chr9:114659877-114659902,chr9,114659877,114659902,0,19610494
IMR90|chr9:134470014-134470129,chr9,134470014,134470129,IMR90|chr9:66454843-66454878,chr9,66454843,66454878,0,68015171
IMR90|chr9:134483946-134483983,chr9,134483946,134483983,IMR90|chr9:113017098-113017153,chr9,113017098,113017153,0,21466848
IMR90|chr9:134614242-134614339,chr9,134614242,134614339,IMR90|chr9:130344733-130344817,chr9,130344733,130344817,0,4269509
IMR90|chr9:134773822-134773897,chr9,134773822,134773897,IMR90|chr9:130855182-130855222,chr9,130855182,130855222,0,3918640
IMR90|chr9:134968661-134968701,chr9,134968661,134968701,IMR90|chr9:66454755-66454825,chr9,66454755,66454825,0,68513906
IMR90|chr9:135151341-135151378,chr9,135151341,135151378,IMR90|chr9:113016716-113016821,chr9,113016716,113016821,0,22134625
IMR90|chr9:135330382-135330482,chr9,135330382,135330482,IMR90|chr9:73029877-73029901,chr9,73029877,73029901,0,62300505
IMR90|chr9:135386512-135386622,chr9,135386512,135386622,IMR90|chr9:66454730-66454869,chr9,66454730,66454869,0,68931782
IMR90|chr9:135569196-135569346,chr9,135569196,135569346,IMR90|chr9:66454698-66454848,chr9,66454698,66454848,0,69114498
IMR90|chr9:135826903-135827053,chr9,135826903,135827053,IMR90|chr9:100958650-100958676,chr9,100958650,100958676,0,34868253
IMR90|chr9:135836897-135836955,chr9,135836897,135836955,IMR90|chr9:35083670-35083751,chr9,35083670,35083751,0,100753227
IMR90|chr9:135902875-135902991,chr9,135902875,135902991,IMR90|chr9:91149130-91149213,chr9,91149130,91149213,0,44753745
IMR90|chr9:135912271-135912352,chr9,135912271,135912352,IMR90|chr9:91145703-91145772,chr9,91145703,91145772,0,44766568
IMR90|chr9:135928972-135929096,chr9,135928972,135929096,IMR90|chr9:100958650-100958676,chr9,100958650,100958676,0,34970322
IMR90|chr9:136022166-136022275,chr9,136022166,136022275,IMR90|chr9:19375413-19375454,chr9,19375413,19375454,0,116646753
IMR90|chr9:136092338-136092443,chr9,136092338,136092443,IMR90|chr9:113801149-113801178,chr9,113801149,113801178,0,22291189
IMR90|chr9:136328237-136328288,chr9,136328237,136328288,IMR90|chr9:5627780-5627879,chr9,5627780,5627879,0,130700457
IMR90|chr9:136397604-136397630,chr9,136397604,136397630,IMR90|chr9:66455698-66455802,chr9,66455698,66455802,0,69941906
IMR90|chr9:136969765-136969809,chr9,136969765,136969809,IMR90|chr9:66454703-66454853,chr9,66454703,66454853,0,70515062
IMR90|chr9:137012725-137012873,chr9,137012725,137012873,IMR90|chr9:66454703-66454853,chr9,66454703,66454853,0,70558022
IMR90|chr9:137162243-137162287,chr9,137162243,137162287,IMR90|chr9:5627773-5627879,chr9,5627773,5627879,0,131534470
IMR90|chr9:137251157-137251303,chr9,137251157,137251303,IMR90|chr9:113016614-113016671,chr9,113016614,113016671,0,24234543
IMR90|chr9:137409575-137409697,chr9,137409575,137409697,IMR90|chr9:124032754-124032797,chr9,124032754,124032797,0,13376821
IMR90|chr9:137545818-137545885,chr9,137545818,137545885,IMR90|chr9:91146242-91146323,chr9,91146242,91146323,0,46399576
IMR90|chr9:137745569-137745595,chr9,137745569,137745595,IMR90|chr9:66455441-66455578,chr9,66455441,66455578,0,71290128
IMR90|chr9:137959498-137959597,chr9,137959498,137959597,IMR90|chr9:91146929-91146979,chr9,91146929,91146979,0,46812569
IMR90|chr9:138053438-138053501,chr9,138053438,138053501,IMR90|chr9:91146223-91146298,chr9,91146223,91146298,0,46907215
IMR90|chr9:138083188-138083297,chr9,138083188,138083297,IMR90|chr9:91145718-91145868,chr9,91145718,91145868,0,46937470
IMR90|chr9:138187434-138187471,chr9,138187434,138187471,IMR90|chr9:130635276-130635404,chr9,130635276,130635404,0,7552158
IMR90|chr9:138345951-138346019,chr9,138345951,138346019,IMR90|chr9:91145677-91145754,chr9,91145677,91145754,0,47200274
IMR90|chr9:138567162-138567233,chr9,138567162,138567233,IMR90|chr9:137534388-137534460,chr9,137534388,137534460,0,1032774
IMR90|chr9:138607186-138607257,chr9,138607186,138607257,IMR90|chr9:110046160-110046186,chr9,110046160,110046186,0,28561026
IMR90|chr9:138676700-138676744,chr9,138676700,138676744,IMR90|chr9:131445173-131445237,chr9,131445173,131445237,0,7231527
IMR90|chr9:138738607-138738649,chr9,138738607,138738649,IMR90|chr9:130660466-130660527,chr9,130660466,130660527,0,8078141
IMR90|chr9:138818423-138818471,chr9,138818423,138818471,IMR90|chr9:127960671-127960714,chr9,127960671,127960714,0,10857752
IMR90|chr9:139272723-139272870,chr9,139272723,139272870,IMR90|chr9:68409252-68409315,chr9,68409252,68409315,0,70863471
IMR90|chr9:139357380-139357472,chr9,139357380,139357472,IMR90|chr9:67336770-67336920,chr9,67336770,67336920,0,72020610
IMR90|chr9:139576860-139576944,chr9,139576860,139576944,IMR90|chr9:66454887-66454937,chr9,66454887,66454937,0,73121973
IMR90|chr9:139656899-139656938,chr9,139656899,139656938,IMR90|chr9:113799743-113799797,chr9,113799743,113799797,0,25857156
IMR90|chr9:139732827-139732885,chr9,139732827,139732885,IMR90|chr9:91145608-91145700,chr9,91145608,91145700,0,48587219
IMR90|chr9:140059036-140059101,chr9,140059036,140059101,IMR90|chr9:67336493-67336600,chr9,67336493,67336600,0,72722543
IMR90|chr9:140277055-140277205,chr9,140277055,140277205,IMR90|chr9:91795652-91795708,chr9,91795652,91795708,0,48481403
IMR90|chr9:140722574-140722637,chr9,140722574,140722637,IMR90|chr9:130213364-130213411,chr9,130213364,130213411,0,10509210
IMR90|chr9:140831574-140831643,chr9,140831574,140831643,IMR90|chr9:101016525-101016624,chr9,101016525,101016624,0,39815049
IMR90|chr9:141078120-141078148,chr9,141078120,141078148,IMR90|chr9:113017130-113017205,chr9,113017130,113017205,0,28060990
IMR90|chr10:349994-350026,chr10,349994,350026,IMR90|chr10:65278270-65278384,chr10,65278270,65278384,0,64928276
IMR90|chr10:452501-452535,chr10,452501,452535,IMR90|chr10:98345769-98345885,chr10,98345769,98345885,0,97893268
IMR90|chr10:456535-456596,chr10,456535,456596,IMR90|chr10:101416353-101416456,chr10,101416353,101416456,0,100959818
IMR90|chr10:1115842-1115941,chr10,1115842,1115941,IMR90|chr10:75503921-75503939,chr10,75503921,75503939,0,74388079
IMR90|chr10:1158696-1158765,chr10,1158696,1158765,IMR90|chr10:121412203-121412259,chr10,121412203,121412259,0,120253507
IMR90|chr10:1319315-1319413,chr10,1319315,1319413,IMR90|chr10:17272238-17272288,chr10,17272238,17272288,0,15952923
IMR90|chr10:1405274-1405313,chr10,1405274,1405313,IMR90|chr10:65276461-65276509,chr10,65276461,65276509,0,63871187
IMR90|chr10:3006522-3006569,chr10,3006522,3006569,IMR90|chr10:101416353-101416456,chr10,101416353,101416456,0,98409831
IMR90|chr10:3437784-3437816,chr10,3437784,3437816,IMR90|chr10:99257504-99257654,chr10,99257504,99257654,0,95819720
IMR90|chr10:3489208-3489351,chr10,3489208,3489351,IMR90|chr10:65277638-65277704,chr10,65277638,65277704,0,61788430
IMR90|chr10:3522492-3522593,chr10,3522492,3522593,IMR90|chr10:28823229-28823289,chr10,28823229,28823289,0,25300737
IMR90|chr10:3535864-3535906,chr10,3535864,3535906,IMR90|chr10:65277711-65277817,chr10,65277711,65277817,0,61741847
IMR90|chr10:3570128-3570160,chr10,3570128,3570160,IMR90|chr10:98345769-98345885,chr10,98345769,98345885,0,94775641
IMR90|chr10:3583953-3584036,chr10,3583953,3584036,IMR90|chr10:89100222-89100258,chr10,89100222,89100258,0,85516269
IMR90|chr10:3778615-3778692,chr10,3778615,3778692,IMR90|chr10:33626283-33626318,chr10,33626283,33626318,0,29847668
IMR90|chr10:3817714-3817807,chr10,3817714,3817807,IMR90|chr10:65277722-65277776,chr10,65277722,65277776,0,61460008
IMR90|chr10:3853815-3853913,chr10,3853815,3853913,IMR90|chr10:69834107-69834140,chr10,69834107,69834140,0,65980292
IMR90|chr10:4641422-4641487,chr10,4641422,4641487,IMR90|chr10:69834853-69834938,chr10,69834853,69834938,0,65193431
IMR90|chr10:4945145-4945209,chr10,4945145,4945209,IMR90|chr10:31609120-31609206,chr10,31609120,31609206,0,26663975
IMR90|chr10:5045154-5045229,chr10,5045154,5045229,IMR90|chr10:134349283-134349304,chr10,134349283,134349304,0,129304129
IMR90|chr10:5075276-5075323,chr10,5075276,5075323,IMR90|chr10:101416353-101416456,chr10,101416353,101416456,0,96341077
IMR90|chr10:5286942-5287088,chr10,5286942,5287088,IMR90|chr10:65276837-65276951,chr10,65276837,65276951,0,59989895
IMR90|chr10:5886863-5886935,chr10,5886863,5886935,IMR90|chr10:31609120-31609206,chr10,31609120,31609206,0,25722257
IMR90|chr10:5977391-5977490,chr10,5977391,5977490,IMR90|chr10:75760295-75760334,chr10,75760295,75760334,0,69782904
IMR90|chr10:6211732-6211829,chr10,6211732,6211829,IMR90|chr10:69834107-69834140,chr10,69834107,69834140,0,63622375
IMR90|chr10:6667904-6668027,chr10,6667904,6668027,IMR90|chr10:76967149-76967201,chr10,76967149,76967201,0,70299245
IMR90|chr10:6669042-6669119,chr10,6669042,6669119,IMR90|chr10:116526288-116526343,chr10,116526288,116526343,0,109857246
IMR90|chr10:6680179-6680226,chr10,6680179,6680226,IMR90|chr10:70288107-70288174,chr10,70288107,70288174,0,63607928
IMR90|chr10:6684486-6684557,chr10,6684486,6684557,IMR90|chr10:75936711-75936790,chr10,75936711,75936790,0,69252225
IMR90|chr10:6724162-6724223,chr10,6724162,6724223,IMR90|chr10:103600210-103600296,chr10,103600210,103600296,0,96876048
IMR90|chr10:7143639-7143687,chr10,7143639,7143687,IMR90|chr10:94335595-94335660,chr10,94335595,94335660,0,87191956
IMR90|chr10:7189797-7189896,chr10,7189797,7189896,IMR90|chr10:3825382-3825433,chr10,3825382,3825433,0,3364415
IMR90|chr10:7462256-7462334,chr10,7462256,7462334,IMR90|chr10:63812533-63812558,chr10,63812533,63812558,0,56350277
IMR90|chr10:7737009-7737093,chr10,7737009,7737093,IMR90|chr10:95240827-95240944,chr10,95240827,95240944,0,87503818
IMR90|chr10:7918003-7918126,chr10,7918003,7918126,IMR90|chr10:116521039-116521143,chr10,116521039,116521143,0,108603036
IMR90|chr10:7928520-7928547,chr10,7928520,7928547,IMR90|chr10:3825407-3825477,chr10,3825407,3825477,0,4103113
IMR90|chr10:7946063-7946138,chr10,7946063,7946138,IMR90|chr10:95240498-95240560,chr10,95240498,95240560,0,87294435
IMR90|chr10:8132164-8132289,chr10,8132164,8132289,IMR90|chr10:43277665-43277751,chr10,43277665,43277751,0,35145501
IMR90|chr10:8449798-8449859,chr10,8449798,8449859,IMR90|chr10:43277665-43277751,chr10,43277665,43277751,0,34827867
IMR90|chr10:9458608-9458753,chr10,9458608,9458753,IMR90|chr10:3825529-3825552,chr10,3825529,3825552,0,5633079
IMR90|chr10:9559520-9559649,chr10,9559520,9559649,IMR90|chr10:121355813-121355834,chr10,121355813,121355834,0,111796293
IMR90|chr10:9952167-9952244,chr10,9952167,9952244,IMR90|chr10:116526288-116526343,chr10,116526288,116526343,0,106574121
IMR90|chr10:10083570-10083690,chr10,10083570,10083690,IMR90|chr10:133793768-133793808,chr10,133793768,133793808,0,123710198
IMR90|chr10:10149538-10149624,chr10,10149538,10149624,IMR90|chr10:75672459-75672589,chr10,75672459,75672589,0,65522921
IMR90|chr10:10641910-10642015,chr10,10641910,10642015,IMR90|chr10:133793768-133793808,chr10,133793768,133793808,0,123151858
IMR90|chr10:10742091-10742123,chr10,10742091,10742123,IMR90|chr10:75763530-75763602,chr10,75763530,75763602,0,65021439
IMR90|chr10:11128763-11128827,chr10,11128763,11128827,IMR90|chr10:112680432-112680518,chr10,112680432,112680518,0,101551669
IMR90|chr10:12231769-12231855,chr10,12231769,12231855,IMR90|chr10:65281497-65281603,chr10,65281497,65281603,0,53049728
IMR90|chr10:12490662-12490752,chr10,12490662,12490752,IMR90|chr10:89100222-89100258,chr10,89100222,89100258,0,76609560
IMR90|chr10:12687801-12687898,chr10,12687801,12687898,IMR90|chr10:103114510-103114567,chr10,103114510,103114567,0,90426709
IMR90|chr10:12810215-12810244,chr10,12810215,12810244,IMR90|chr10:89100222-89100258,chr10,89100222,89100258,0,76290007
IMR90|chr10:12949926-12950011,chr10,12949926,12950011,IMR90|chr10:92975350-92975450,chr10,92975350,92975450,0,80025424
IMR90|chr10:13548887-13548931,chr10,13548887,13548931,IMR90|chr10:92975350-92975450,chr10,92975350,92975450,0,79426463
IMR90|chr10:13786831-13786909,chr10,13786831,13786909,IMR90|chr10:114712252-114712279,chr10,114712252,114712279,0,100925421
IMR90|chr10:13841528-13841638,chr10,13841528,13841638,IMR90|chr10:82215037-82215065,chr10,82215037,82215065,0,68373509
IMR90|chr10:14144737-14144768,chr10,14144737,14144768,IMR90|chr10:99257595-99257654,chr10,99257595,99257654,0,85112858
IMR90|chr10:14591432-14591522,chr10,14591432,14591522,IMR90|chr10:89100222-89100258,chr10,89100222,89100258,0,74508790
IMR90|chr10:14856326-14856413,chr10,14856326,14856413,IMR90|chr10:104206244-104206304,chr10,104206244,104206304,0,89349918
IMR90|chr10:14930354-14930439,chr10,14930354,14930439,IMR90|chr10:92975350-92975450,chr10,92975350,92975450,0,78044996
IMR90|chr10:15368551-15368576,chr10,15368551,15368576,IMR90|chr10:65277233-65277278,chr10,65277233,65277278,0,49908682
IMR90|chr10:15652100-15652175,chr10,15652100,15652175,IMR90|chr10:65277728-65277782,chr10,65277728,65277782,0,49625628
IMR90|chr10:15694323-15694383,chr10,15694323,15694383,IMR90|chr10:103600210-103600296,chr10,103600210,103600296,0,87905887
IMR90|chr10:15860295-15860365,chr10,15860295,15860365,IMR90|chr10:116521332-116521394,chr10,116521332,116521394,0,100661037
IMR90|chr10:16202730-16202796,chr10,16202730,16202796,IMR90|chr10:103872927-103872968,chr10,103872927,103872968,0,87670197
IMR90|chr10:16241989-16242016,chr10,16241989,16242016,IMR90|chr10:3825407-3825477,chr10,3825407,3825477,0,12416582
IMR90|chr10:16407712-16407790,chr10,16407712,16407790,IMR90|chr10:65277231-65277278,chr10,65277231,65277278,0,48869519
IMR90|chr10:16734930-16735031,chr10,16734930,16735031,IMR90|chr10:28823229-28823289,chr10,28823229,28823289,0,12088299
IMR90|chr10:16928930-16928946,chr10,16928930,16928946,IMR90|chr10:104213330-104213348,chr10,104213330,104213348,0,87284400
IMR90|chr10:18159374-18159473,chr10,18159374,18159473,IMR90|chr10:76966758-76966826,chr10,76966758,76966826,0,58807384
IMR90|chr10:18237245-18237263,chr10,18237245,18237263,IMR90|chr10:43903223-43903314,chr10,43903223,43903314,0,25665978
IMR90|chr10:18465716-18465861,chr10,18465716,18465861,IMR90|chr10:65277643-65277702,chr10,65277643,65277702,0,46811927
IMR90|chr10:18684085-18684150,chr10,18684085,18684150,IMR90|chr10:69834853-69834938,chr10,69834853,69834938,0,51150768
IMR90|chr10:19296875-19296907,chr10,19296875,19296907,IMR90|chr10:65278270-65278384,chr10,65278270,65278384,0,45981395
IMR90|chr10:19568891-19568977,chr10,19568891,19568977,IMR90|chr10:75672459-75672589,chr10,75672459,75672589,0,56103568
IMR90|chr10:20014512-20014639,chr10,20014512,20014639,IMR90|chr10:3825529-3825552,chr10,3825529,3825552,0,16188983
IMR90|chr10:20321353-20321435,chr10,20321353,20321435,IMR90|chr10:95240827-95240944,chr10,95240827,95240944,0,74919474
IMR90|chr10:20420060-20420170,chr10,20420060,20420170,IMR90|chr10:124935125-124935165,chr10,124935125,124935165,0,104515065
IMR90|chr10:20464700-20464733,chr10,20464700,20464733,IMR90|chr10:134350281-134350420,chr10,134350281,134350420,0,113885581
IMR90|chr10:20873438-20873491,chr10,20873438,20873491,IMR90|chr10:15134765-15134797,chr10,15134765,15134797,0,5738673
IMR90|chr10:21124007-21124140,chr10,21124007,21124140,IMR90|chr10:33625498-33625515,chr10,33625498,33625515,0,12501491
IMR90|chr10:21230943-21231040,chr10,21230943,21231040,IMR90|chr10:3825382-3825433,chr10,3825382,3825433,0,17405561
IMR90|chr10:21247002-21247056,chr10,21247002,21247056,IMR90|chr10:71896212-71896264,chr10,71896212,71896264,0,50649210
IMR90|chr10:22216207-22216295,chr10,22216207,22216295,IMR90|chr10:3826840-3826865,chr10,3826840,3826865,0,18389367
IMR90|chr10:22290207-22290252,chr10,22290207,22290252,IMR90|chr10:112260076-112260149,chr10,112260076,112260149,0,89969869
IMR90|chr10:22810871-22810923,chr10,22810871,22810923,IMR90|chr10:134347496-134347581,chr10,134347496,134347581,0,111536625
IMR90|chr10:23343783-23343854,chr10,23343783,23343854,IMR90|chr10:75936711-75936790,chr10,75936711,75936790,0,52592928
IMR90|chr10:23495017-23495091,chr10,23495017,23495091,IMR90|chr10:74117563-74117612,chr10,74117563,74117612,0,50622546
IMR90|chr10:23958233-23958302,chr10,23958233,23958302,IMR90|chr10:65276981-65277036,chr10,65276981,65277036,0,41318748
IMR90|chr10:23970402-23970431,chr10,23970402,23970431,IMR90|chr10:69834808-69834908,chr10,69834808,69834908,0,45864406
IMR90|chr10:24041073-24041206,chr10,24041073,24041206,IMR90|chr10:33625498-33625515,chr10,33625498,33625515,0,9584425
IMR90|chr10:24242020-24242103,chr10,24242020,24242103,IMR90|chr10:65280290-65280339,chr10,65280290,65280339,0,41038270
IMR90|chr10:24610722-24610831,chr10,24610722,24610831,IMR90|chr10:82215037-82215065,chr10,82215037,82215065,0,57604315
IMR90|chr10:24801230-24801281,chr10,24801230,24801281,IMR90|chr10:94335595-94335660,chr10,94335595,94335660,0,69534365
IMR90|chr10:25492994-25493059,chr10,25492994,25493059,IMR90|chr10:111761693-111761723,chr10,111761693,111761723,0,86268699
IMR90|chr10:25668787-25668830,chr10,25668787,25668830,IMR90|chr10:80830630-80830733,chr10,80830630,80830733,0,55161843
IMR90|chr10:25932580-25932633,chr10,25932580,25932633,IMR90|chr10:71896212-71896264,chr10,71896212,71896264,0,45963632
IMR90|chr10:26194890-26194951,chr10,26194890,26194951,IMR90|chr10:112259338-112259371,chr10,112259338,112259371,0,86064448
IMR90|chr10:26363186-26363269,chr10,26363186,26363269,IMR90|chr10:75255752-75255857,chr10,75255752,75255857,0,48892566
IMR90|chr10:26493624-26493750,chr10,26493624,26493750,IMR90|chr10:89100222-89100258,chr10,89100222,89100258,0,62606598
IMR90|chr10:27176113-27176258,chr10,27176113,27176258,IMR90|chr10:65277643-65277702,chr10,65277643,65277702,0,38101530
IMR90|chr10:27428049-27428104,chr10,27428049,27428104,IMR90|chr10:112260361-112260456,chr10,112260361,112260456,0,84832312
IMR90|chr10:27563699-27563723,chr10,27563699,27563723,IMR90|chr10:134347496-134347582,chr10,134347496,134347582,0,106783797
IMR90|chr10:27945390-27945490,chr10,27945390,27945490,IMR90|chr10:65276458-65276483,chr10,65276458,65276483,0,37331068
IMR90|chr10:28386692-28386721,chr10,28386692,28386721,IMR90|chr10:69834808-69834908,chr10,69834808,69834908,0,41448116
IMR90|chr10:28403519-28403579,chr10,28403519,28403579,IMR90|chr10:121414915-121414978,chr10,121414915,121414978,0,93011396
IMR90|chr10:28540959-28541109,chr10,28540959,28541109,IMR90|chr10:6187204-6187232,chr10,6187204,6187232,0,22353755
IMR90|chr10:28555083-28555230,chr10,28555083,28555230,IMR90|chr10:80828753-80828780,chr10,80828753,80828780,0,52273670
IMR90|chr10:28670522-28670605,chr10,28670522,28670605,IMR90|chr10:75169701-75169762,chr10,75169701,75169762,0,46499179
IMR90|chr10:28686604-28686679,chr10,28686604,28686679,IMR90|chr10:95240498-95240560,chr10,95240498,95240560,0,66553894
IMR90|chr10:28792254-28792276,chr10,28792254,28792276,IMR90|chr10:82215768-82215825,chr10,82215768,82215825,0,53423514
IMR90|chr10:28843360-28843439,chr10,28843360,28843439,IMR90|chr10:63812533-63812558,chr10,63812533,63812558,0,34969173
IMR90|chr10:29381880-29382030,chr10,29381880,29382030,IMR90|chr10:111766802-111766886,chr10,111766802,111766886,0,82384922
IMR90|chr10:29539774-29539820,chr10,29539774,29539820,IMR90|chr10:103815779-103815877,chr10,103815779,103815877,0,74276005
IMR90|chr10:30011987-30012082,chr10,30011987,30012082,IMR90|chr10:76966520-76966575,chr10,76966520,76966575,0,46954533
IMR90|chr10:30468522-30468647,chr10,30468522,30468647,IMR90|chr10:43277665-43277751,chr10,43277665,43277751,0,12809143
IMR90|chr10:30571271-30571367,chr10,30571271,30571367,IMR90|chr10:103876442-103876496,chr10,103876442,103876496,0,73305171
IMR90|chr10:30734770-30734815,chr10,30734770,30734815,IMR90|chr10:112260076-112260149,chr10,112260076,112260149,0,81525306
IMR90|chr10:30763301-30763373,chr10,30763301,30763373,IMR90|chr10:121412203-121412259,chr10,121412203,121412259,0,90648902
IMR90|chr10:31167057-31167185,chr10,31167057,31167185,IMR90|chr10:32343473-32343534,chr10,32343473,32343534,0,1176416
IMR90|chr10:31229184-31229275,chr10,31229184,31229275,IMR90|chr10:17272238-17272288,chr10,17272238,17272288,0,13956946
IMR90|chr10:31621904-31621987,chr10,31621904,31621987,IMR90|chr10:89100222-89100258,chr10,89100222,89100258,0,57478318
IMR90|chr10:31680443-31680553,chr10,31680443,31680553,IMR90|chr10:82215037-82215065,chr10,82215037,82215065,0,50534594
IMR90|chr10:31944437-31944510,chr10,31944437,31944510,IMR90|chr10:102726079-102726152,chr10,102726079,102726152,0,70781642
IMR90|chr10:32652428-32652502,chr10,32652428,32652502,IMR90|chr10:5727489-5727565,chr10,5727489,5727565,0,26924939
IMR90|chr10:32688159-32688216,chr10,32688159,32688216,IMR90|chr10:82216233-82216310,chr10,82216233,82216310,0,49528074
IMR90|chr10:32866964-32867005,chr10,32866964,32867005,IMR90|chr10:92978501-92978651,chr10,92978501,92978651,0,60111537
IMR90|chr10:33144803-33144895,chr10,33144803,33144895,IMR90|chr10:104406586-104406639,chr10,104406586,104406639,0,71261783
IMR90|chr10:33161529-33161625,chr10,33161529,33161625,IMR90|chr10:103876442-103876496,chr10,103876442,103876496,0,70714913
IMR90|chr10:33346395-33346520,chr10,33346395,33346520,IMR90|chr10:134349635-134349784,chr10,134349635,134349784,0,101003240
IMR90|chr10:33418970-33419046,chr10,33418970,33419046,IMR90|chr10:116526288-116526343,chr10,116526288,116526343,0,83107318
IMR90|chr10:34645431-34645474,chr10,34645431,34645474,IMR90|chr10:112260076-112260149,chr10,112260076,112260149,0,77614645
IMR90|chr10:34826409-34826473,chr10,34826409,34826473,IMR90|chr10:100206126-100206212,chr10,100206126,100206212,0,65379717
IMR90|chr10:34967408-34967531,chr10,34967408,34967531,IMR90|chr10:116521039-116521143,chr10,116521039,116521143,0,81553631
IMR90|chr10:35019332-35019391,chr10,35019332,35019391,IMR90|chr10:121358736-121358886,chr10,121358736,121358886,0,86339404
IMR90|chr10:35919197-35919256,chr10,35919197,35919256,IMR90|chr10:121358736-121358886,chr10,121358736,121358886,0,85439539
IMR90|chr10:36638715-36638746,chr10,36638715,36638746,IMR90|chr10:105430457-105430534,chr10,105430457,105430534,0,68791742
IMR90|chr10:36937614-36937764,chr10,36937614,36937764,IMR90|chr10:111765169-111765231,chr10,111765169,111765231,0,74827555
IMR90|chr10:36945977-36946063,chr10,36945977,36946063,IMR90|chr10:75764177-75764222,chr10,75764177,75764222,0,38818200
IMR90|chr10:37015556-37015676,chr10,37015556,37015676,IMR90|chr10:127512503-127512533,chr10,127512503,127512533,0,90496947
IMR90|chr10:37449732-37449789,chr10,37449732,37449789,IMR90|chr10:65281497-65281578,chr10,65281497,65281578,0,27831765
IMR90|chr10:37594323-37594452,chr10,37594323,37594452,IMR90|chr10:121355813-121355834,chr10,121355813,121355834,0,83761490
IMR90|chr10:37818384-37818529,chr10,37818384,37818529,IMR90|chr10:3825529-3825552,chr10,3825529,3825552,0,33992855
IMR90|chr10:37974386-37974402,chr10,37974386,37974402,IMR90|chr10:17275134-17275252,chr10,17275134,17275252,0,20699252
IMR90|chr10:38536616-38536660,chr10,38536616,38536660,IMR90|chr10:116582551-116582602,chr10,116582551,116582602,0,78045935
IMR90|chr10:38548208-38548358,chr10,38548208,38548358,IMR90|chr10:111766802-111766886,chr10,111766802,111766886,0,73218594
IMR90|chr10:38602141-38602215,chr10,38602141,38602215,IMR90|chr10:5727489-5727565,chr10,5727489,5727565,0,32874652
IMR90|chr10:38714236-38714302,chr10,38714236,38714302,IMR90|chr10:116445941-116446080,chr10,116445941,116446080,0,77731705
IMR90|chr10:39516158-39516234,chr10,39516158,39516234,IMR90|chr10:65276967-65277030,chr10,65276967,65277030,0,25760809
IMR90|chr10:40204714-40204779,chr10,40204714,40204779,IMR90|chr10:75006179-75006236,chr10,75006179,75006236,0,34801465
IMR90|chr10:40797755-40797838,chr10,40797755,40797838,IMR90|chr10:75169701-75169762,chr10,75169701,75169762,0,34371946
IMR90|chr10:40959562-40959599,chr10,40959562,40959599,IMR90|chr10:17271966-17272007,chr10,17271966,17272007,0,23687596
IMR90|chr10:41226162-41226312,chr10,41226162,41226312,IMR90|chr10:111765169-111765231,chr10,111765169,111765231,0,70539007
IMR90|chr10:41611327-41611426,chr10,41611327,41611426,IMR90|chr10:120839489-120839547,chr10,120839489,120839547,0,79228162
IMR90|chr10:41879948-41880017,chr10,41879948,41880017,IMR90|chr10:116523080-116523100,chr10,116523080,116523100,0,74643132
IMR90|chr10:42076499-42076581,chr10,42076499,42076581,IMR90|chr10:65281341-65281409,chr10,65281341,65281409,0,23204842
IMR90|chr10:42170084-42170204,chr10,42170084,42170204,IMR90|chr10:127512503-127512533,chr10,127512503,127512533,0,85342419
IMR90|chr10:42238200-42238310,chr10,42238200,42238310,IMR90|chr10:43277665-43277751,chr10,43277665,43277751,0,1039465
IMR90|chr10:42352190-42352237,chr10,42352190,42352237,IMR90|chr10:104407518-104407563,chr10,104407518,104407563,0,62055328
IMR90|chr10:42815631-42815679,chr10,42815631,42815679,IMR90|chr10:75760593-75760677,chr10,75760593,75760677,0,32944962
IMR90|chr10:43038650-43038696,chr10,43038650,43038696,IMR90|chr10:75675434-75675538,chr10,75675434,75675538,0,32636784
IMR90|chr10:43241308-43241422,chr10,43241308,43241422,IMR90|chr10:106097673-106097726,chr10,106097673,106097726,0,62856365
IMR90|chr10:43365583-43365681,chr10,43365583,43365681,IMR90|chr10:49733216-49733267,chr10,49733216,49733267,0,6367633
IMR90|chr10:43381486-43381520,chr10,43381486,43381520,IMR90|chr10:75760593-75760677,chr10,75760593,75760677,0,32379107
IMR90|chr10:43460953-43460997,chr10,43460953,43460997,IMR90|chr10:65281497-65281603,chr10,65281497,65281603,0,21820544
IMR90|chr10:43539544-43539626,chr10,43539544,43539626,IMR90|chr10:65281341-65281409,chr10,65281341,65281409,0,21741797
IMR90|chr10:44253677-44253776,chr10,44253677,44253776,IMR90|chr10:76966758-76966826,chr10,76966758,76966826,0,32713081
IMR90|chr10:44443227-44443291,chr10,44443227,44443291,IMR90|chr10:65281497-65281583,chr10,65281497,65281583,0,20838270
IMR90|chr10:44524600-44524664,chr10,44524600,44524664,IMR90|chr10:31609120-31609206,chr10,31609120,31609206,0,12915480
IMR90|chr10:44526496-44526544,chr10,44526496,44526544,IMR90|chr10:103815779-103815877,chr10,103815779,103815877,0,59289283
IMR90|chr10:44603419-44603494,chr10,44603419,44603494,IMR90|chr10:103876442-103876517,chr10,103876442,103876517,0,59273023
IMR90|chr10:44642400-44642422,chr10,44642400,44642422,IMR90|chr10:65276789-65276850,chr10,65276789,65276850,0,20634389
IMR90|chr10:44642836-44642910,chr10,44642836,44642910,IMR90|chr10:75675434-75675538,chr10,75675434,75675538,0,31032598
IMR90|chr10:44693785-44693858,chr10,44693785,44693858,IMR90|chr10:75675434-75675538,chr10,75675434,75675538,0,30981649
IMR90|chr10:45104159-45104242,chr10,45104159,45104242,IMR90|chr10:103114510-103114566,chr10,103114510,103114566,0,58010351
IMR90|chr10:45560694-45560755,chr10,45560694,45560755,IMR90|chr10:103600210-103600296,chr10,103600210,103600296,0,58039516
IMR90|chr10:45811074-45811118,chr10,45811074,45811118,IMR90|chr10:65281497-65281603,chr10,65281497,65281603,0,19470423
IMR90|chr10:46487076-46487137,chr10,46487076,46487137,IMR90|chr10:43277665-43277751,chr10,43277665,43277751,0,3209411
IMR90|chr10:46734778-46734848,chr10,46734778,46734848,IMR90|chr10:116521332-116521394,chr10,116521332,116521394,0,69786554
IMR90|chr10:46792671-46792702,chr10,46792671,46792702,IMR90|chr10:75675850-75675928,chr10,75675850,75675928,0,28883179
IMR90|chr10:47048994-47049065,chr10,47048994,47049065,IMR90|chr10:75541118-75541181,chr10,75541118,75541181,0,28492124
IMR90|chr10:47462420-47462508,chr10,47462420,47462508,IMR90|chr10:111765169-111765231,chr10,111765169,111765231,0,64302749
IMR90|chr10:47560754-47560819,chr10,47560754,47560819,IMR90|chr10:111761693-111761723,chr10,111761693,111761723,0,64200939
IMR90|chr10:47953401-47953450,chr10,47953401,47953450,IMR90|chr10:94335595-94335660,chr10,94335595,94335660,0,46382194
IMR90|chr10:48132045-48132123,chr10,48132045,48132123,IMR90|chr10:65277231-65277278,chr10,65277231,65277278,0,17145186
IMR90|chr10:48743325-48743472,chr10,48743325,48743472,IMR90|chr10:75672563-75672607,chr10,75672563,75672607,0,26929238
IMR90|chr10:49328953-49329063,chr10,49328953,49329063,IMR90|chr10:43277665-43277751,chr10,43277665,43277751,0,6051288
IMR90|chr10:49589690-49589765,chr10,49589690,49589765,IMR90|chr10:65277728-65277782,chr10,65277728,65277782,0,15688038
IMR90|chr10:49596217-49596364,chr10,49596217,49596364,IMR90|chr10:75672563-75672607,chr10,75672563,75672607,0,26076346
IMR90|chr10:50281910-50281942,chr10,50281910,50281942,IMR90|chr10:99257504-99257654,chr10,99257504,99257654,0,48975594
IMR90|chr10:50770614-50770675,chr10,50770614,50770675,IMR90|chr10:101416353-101416456,chr10,101416353,101416456,0,50645739
IMR90|chr10:50803821-50803854,chr10,50803821,50803854,IMR90|chr10:65278270-65278384,chr10,65278270,65278384,0,14474449
IMR90|chr10:51239029-51239149,chr10,51239029,51239149,IMR90|chr10:133793768-133793808,chr10,133793768,133793808,0,82554739
IMR90|chr10:51565962-51566036,chr10,51565962,51566036,IMR90|chr10:95240498-95240560,chr10,95240498,95240560,0,43674536
IMR90|chr10:51619882-51619972,chr10,51619882,51619972,IMR90|chr10:28823229-28823289,chr10,28823229,28823289,0,22796653
IMR90|chr10:51703892-51703945,chr10,51703892,51703945,IMR90|chr10:15134765-15134797,chr10,15134765,15134797,0,36569127
IMR90|chr10:51844987-51845044,chr10,51844987,51845044,IMR90|chr10:65281497-65281578,chr10,65281497,65281578,0,13436510
IMR90|chr10:52158210-52158234,chr10,52158210,52158234,IMR90|chr10:134347496-134347582,chr10,134347496,134347582,0,82189286
IMR90|chr10:52340428-52340514,chr10,52340428,52340514,IMR90|chr10:75764177-75764222,chr10,75764177,75764222,0,23423749
IMR90|chr10:53125187-53125264,chr10,53125187,53125264,IMR90|chr10:46915557-46915629,chr10,46915557,46915629,0,6209630
IMR90|chr10:53169881-53169933,chr10,53169881,53169933,IMR90|chr10:134347496-134347581,chr10,134347496,134347581,0,81177615
IMR90|chr10:53385271-53385347,chr10,53385271,53385347,IMR90|chr10:65276205-65276256,chr10,65276205,65276256,0,11890934
IMR90|chr10:53923224-53923290,chr10,53923224,53923290,IMR90|chr10:116445941-116446080,chr10,116445941,116446080,0,62522717
IMR90|chr10:54567110-54567181,chr10,54567110,54567181,IMR90|chr10:106094503-106094539,chr10,106094503,106094539,0,51527393
IMR90|chr10:54603102-54603155,chr10,54603102,54603155,IMR90|chr10:65281497-65281566,chr10,65281497,65281566,0,10678395
IMR90|chr10:54712211-54712233,chr10,54712211,54712233,IMR90|chr10:65280776-65280878,chr10,65280776,65280878,0,10568565
IMR90|chr10:55095541-55095594,chr10,55095541,55095594,IMR90|chr10:75672562-75672619,chr10,75672562,75672619,0,20577021
IMR90|chr10:55210789-55210912,chr10,55210789,55210912,IMR90|chr10:76967149-76967201,chr10,76967149,76967201,0,21756360
IMR90|chr10:55287660-55287721,chr10,55287660,55287721,IMR90|chr10:121413336-121413407,chr10,121413336,121413407,0,66125676
IMR90|chr10:55337508-55337597,chr10,55337508,55337597,IMR90|chr10:65276789-65276850,chr10,65276789,65276850,0,9939281
IMR90|chr10:55372454-55372499,chr10,55372454,55372499,IMR90|chr10:65279165-65279199,chr10,65279165,65279199,0,9906711
IMR90|chr10:55419425-55419523,chr10,55419425,55419523,IMR90|chr10:49733216-49733267,chr10,49733216,49733267,0,5686209
IMR90|chr10:55424405-55424474,chr10,55424405,55424474,IMR90|chr10:65276981-65277036,chr10,65276981,65277036,0,9852576
IMR90|chr10:55743778-55743876,chr10,55743778,55743876,IMR90|chr10:17272238-17272288,chr10,17272238,17272288,0,38471540
IMR90|chr10:55841950-55841991,chr10,55841950,55841991,IMR90|chr10:92978501-92978651,chr10,92978501,92978651,0,37136551
IMR90|chr10:55914840-55914937,chr10,55914840,55914937,IMR90|chr10:103114510-103114567,chr10,103114510,103114567,0,47199670
IMR90|chr10:56293295-56293347,chr10,56293295,56293347,IMR90|chr10:105420480-105420569,chr10,105420480,105420569,0,49127185
IMR90|chr10:56554006-56554067,chr10,56554006,56554067,IMR90|chr10:134349283-134349304,chr10,134349283,134349304,0,77795277
IMR90|chr10:56595843-56595914,chr10,56595843,56595914,IMR90|chr10:111763815-111763853,chr10,111763815,111763853,0,55167972
IMR90|chr10:56616314-56616387,chr10,56616314,56616387,IMR90|chr10:111763815-111763853,chr10,111763815,111763853,0,55147501
IMR90|chr10:56818349-56818446,chr10,56818349,56818446,IMR90|chr10:106097673-106097726,chr10,106097673,106097726,0,49279324
IMR90|chr10:57039062-57039136,chr10,57039062,57039136,IMR90|chr10:74117563-74117612,chr10,74117563,74117612,0,17078501
IMR90|chr10:57053918-57054035,chr10,57053918,57054035,IMR90|chr10:127512500-127512533,chr10,127512500,127512533,0,70458582
IMR90|chr10:57648520-57648569,chr10,57648520,57648569,IMR90|chr10:112260430-112260580,chr10,112260430,112260580,0,54611910
IMR90|chr10:57981874-57981958,chr10,57981874,57981958,IMR90|chr10:65277638-65277704,chr10,65277638,65277704,0,7295764
IMR90|chr10:57993635-57993700,chr10,57993635,57993700,IMR90|chr10:102726079-102726151,chr10,102726079,102726151,0,44732444
IMR90|chr10:58027048-58027113,chr10,58027048,58027113,IMR90|chr10:86088988-86089049,chr10,86088988,86089049,0,28061940
IMR90|chr10:58533323-58533421,chr10,58533323,58533421,IMR90|chr10:69834107-69834140,chr10,69834107,69834140,0,11300784
IMR90|chr10:58668589-58668714,chr10,58668589,58668714,IMR90|chr10:134349635-134349784,chr10,134349635,134349784,0,75681046
IMR90|chr10:58669564-58669616,chr10,58669564,58669616,IMR90|chr10:75539602-75539661,chr10,75539602,75539661,0,16870038
IMR90|chr10:58921461-58921543,chr10,58921461,58921543,IMR90|chr10:95240827-95240944,chr10,95240827,95240944,0,36319366
IMR90|chr10:59273241-59273300,chr10,59273241,59273300,IMR90|chr10:82215081-82215166,chr10,82215081,82215166,0,22941840
IMR90|chr10:59721329-59721428,chr10,59721329,59721428,IMR90|chr10:75760295-75760334,chr10,75760295,75760334,0,16038966
IMR90|chr10:59775529-59775564,chr10,59775529,59775564,IMR90|chr10:103114510-103114567,chr10,103114510,103114567,0,43338981
IMR90|chr10:60014097-60014175,chr10,60014097,60014175,IMR90|chr10:114712252-114712279,chr10,114712252,114712279,0,54698155
IMR90|chr10:60886150-60886289,chr10,60886150,60886289,IMR90|chr10:124935125-124935165,chr10,124935125,124935165,0,64048975
IMR90|chr10:61053707-61053738,chr10,61053707,61053738,IMR90|chr10:99257595-99257654,chr10,99257595,99257654,0,38203888
IMR90|chr10:61406914-61406977,chr10,61406914,61406977,IMR90|chr10:3824555-3824589,chr10,3824555,3824589,0,57582359
IMR90|chr10:62022532-62022625,chr10,62022532,62022625,IMR90|chr10:76968473-76968525,chr10,76968473,76968525,0,14945941
IMR90|chr10:62079297-62079341,chr10,62079297,62079341,IMR90|chr10:116582551-116582602,chr10,116582551,116582602,0,54503254
IMR90|chr10:62114116-62114134,chr10,62114116,62114134,IMR90|chr10:43903223-43903314,chr10,43903223,43903314,0,18210893
IMR90|chr10:62422114-62422202,chr10,62422114,62422202,IMR90|chr10:32343473-32343534,chr10,32343473,32343534,0,30078641
IMR90|chr10:62471907-62471970,chr10,62471907,62471970,IMR90|chr10:3824555-3824589,chr10,3824555,3824589,0,58647352
IMR90|chr10:62577313-62577360,chr10,62577313,62577360,IMR90|chr10:70288107-70288174,chr10,70288107,70288174,0,7710794
IMR90|chr10:62579197-62579243,chr10,62579197,62579243,IMR90|chr10:82216730-82216817,chr10,82216730,82216817,0,19637533
IMR90|chr10:63288981-63289054,chr10,63288981,63289054,IMR90|chr10:75675434-75675538,chr10,75675434,75675538,0,12386453
IMR90|chr10:63806413-63806525,chr10,63806413,63806525,IMR90|chr10:114713859-114713906,chr10,114713859,114713906,0,50907446
IMR90|chr10:63835837-63835921,chr10,63835837,63835921,IMR90|chr10:75255752-75255831,chr10,75255752,75255831,0,11419915
IMR90|chr10:63883167-63883219,chr10,63883167,63883219,IMR90|chr10:33245401-33245551,chr10,33245401,33245551,0,30637766
IMR90|chr10:64534317-64534363,chr10,64534317,64534363,IMR90|chr10:103815779-103815877,chr10,103815779,103815877,0,39281462
IMR90|chr10:64569945-64569983,chr10,64569945,64569983,IMR90|chr10:111761693-111761723,chr10,111761693,111761723,0,47191748
IMR90|chr10:64694404-64694442,chr10,64694404,64694442,IMR90|chr10:111761693-111761723,chr10,111761693,111761723,0,47067289
IMR90|chr10:64875125-64875213,chr10,64875125,64875213,IMR90|chr10:3826840-3826865,chr10,3826840,3826865,0,61048285
IMR90|chr10:64891526-64891625,chr10,64891526,64891625,IMR90|chr10:3825382-3825433,chr10,3825382,3825433,0,61066144
IMR90|chr10:65407378-65407424,chr10,65407378,65407424,IMR90|chr10:75672539-75672605,chr10,75672539,75672605,0,10265161
IMR90|chr10:65438107-65438179,chr10,65438107,65438179,IMR90|chr10:106094503-106094539,chr10,106094503,106094539,0,40656396
IMR90|chr10:65741866-65741968,chr10,65741866,65741968,IMR90|chr10:5727489-5727565,chr10,5727489,5727565,0,60014377
IMR90|chr10:65946899-65946982,chr10,65946899,65946982,IMR90|chr10:65280290-65280339,chr10,65280290,65280339,0,666609
IMR90|chr10:65990692-65990778,chr10,65990692,65990778,IMR90|chr10:65281497-65281603,chr10,65281497,65281603,0,709195
IMR90|chr10:66277904-66277973,chr10,66277904,66277973,IMR90|chr10:121412203-121412259,chr10,121412203,121412259,0,55134299
IMR90|chr10:66364767-66364876,chr10,66364767,66364876,IMR90|chr10:3826174-3826224,chr10,3826174,3826224,0,62538593
IMR90|chr10:66810264-66810317,chr10,66810264,66810317,IMR90|chr10:71896212-71896264,chr10,71896212,71896264,0,5085948
IMR90|chr10:67099324-67099421,chr10,67099324,67099421,IMR90|chr10:106097673-106097726,chr10,106097673,106097726,0,38998349
IMR90|chr10:67726099-67726142,chr10,67726099,67726142,IMR90|chr10:51565404-51565511,chr10,51565404,51565511,0,16160695
IMR90|chr10:67961505-67961610,chr10,67961505,67961610,IMR90|chr10:133793768-133793808,chr10,133793768,133793808,0,65832263
IMR90|chr10:68071403-68071435,chr10,68071403,68071435,IMR90|chr10:98345769-98345885,chr10,98345769,98345885,0,30274366
IMR90|chr10:68225327-68225391,chr10,68225327,68225391,IMR90|chr10:112680432-112680518,chr10,112680432,112680518,0,44455105
IMR90|chr10:68243441-68243511,chr10,68243441,68243511,IMR90|chr10:111761693-111761723,chr10,111761693,111761723,0,43518252
IMR90|chr10:68462923-68463035,chr10,68462923,68463035,IMR90|chr10:114713859-114713906,chr10,114713859,114713906,0,46250936
IMR90|chr10:68564742-68564841,chr10,68564742,68564841,IMR90|chr10:65276804-65276855,chr10,65276804,65276855,0,3287938
IMR90|chr10:68575923-68575945,chr10,68575923,68575945,IMR90|chr10:65276789-65276850,chr10,65276789,65276850,0,3299134
IMR90|chr10:68843918-68844007,chr10,68843918,68844007,IMR90|chr10:32343473-32343534,chr10,32343473,32343534,0,36500445
IMR90|chr10:68955355-68955453,chr10,68955355,68955453,IMR90|chr10:112260361-112260456,chr10,112260361,112260456,0,43305006
IMR90|chr10:69125678-69125805,chr10,69125678,69125805,IMR90|chr10:3825529-3825552,chr10,3825529,3825552,0,65300149
IMR90|chr10:69266290-69266402,chr10,69266290,69266402,IMR90|chr10:75503921-75503959,chr10,75503921,75503959,0,6237631
IMR90|chr10:69301465-69301574,chr10,69301465,69301574,IMR90|chr10:82215037-82215065,chr10,82215037,82215065,0,12913572
IMR90|chr10:69619165-69619212,chr10,69619165,69619212,IMR90|chr10:134348707-134348857,chr10,134348707,134348857,0,64729542
IMR90|chr10:69897359-69897501,chr10,69897359,69897501,IMR90|chr10:121355813-121355834,chr10,121355813,121355834,0,51458454
IMR90|chr10:70414508-70414556,chr10,70414508,70414556,IMR90|chr10:103815779-103815877,chr10,103815779,103815877,0,33401271
IMR90|chr10:70415991-70416074,chr10,70415991,70416074,IMR90|chr10:103114510-103114566,chr10,103114510,103114566,0,32698519
IMR90|chr10:70660946-70661025,chr10,70660946,70661025,IMR90|chr10:63812533-63812558,chr10,63812533,63812558,0,6848413
IMR90|chr10:70765936-70765960,chr10,70765936,70765960,IMR90|chr10:80829992-80830104,chr10,80829992,80830104,0,10064056
IMR90|chr10:70842401-70842503,chr10,70842401,70842503,IMR90|chr10:5727489-5727565,chr10,5727489,5727565,0,65114912
IMR90|chr10:71094642-71094693,chr10,71094642,71094693,IMR90|chr10:111760927-111760985,chr10,111760927,111760985,0,40666285
IMR90|chr10:71267264-71267309,chr10,71267264,71267309,IMR90|chr10:65279165-65279199,chr10,65279165,65279199,0,5988099
IMR90|chr10:71650510-71650562,chr10,71650510,71650562,IMR90|chr10:33245401-33245551,chr10,33245401,33245551,0,38405109
IMR90|chr10:71823993-71824088,chr10,71823993,71824088,IMR90|chr10:76966520-76966575,chr10,76966520,76966575,0,5142527
IMR90|chr10:72286343-72286453,chr10,72286343,72286453,IMR90|chr10:124935125-124935165,chr10,124935125,124935165,0,52648782
IMR90|chr10:72380045-72380119,chr10,72380045,72380119,IMR90|chr10:95240498-95240560,chr10,95240498,95240560,0,22860453
IMR90|chr10:72598145-72598239,chr10,72598145,72598239,IMR90|chr10:3826174-3826226,chr10,3826174,3826226,0,68771971
IMR90|chr10:72980680-72980755,chr10,72980680,72980755,IMR90|chr10:74117563-74117612,chr10,74117563,74117612,0,1136883
IMR90|chr10:73088954-73089031,chr10,73088954,73089031,IMR90|chr10:75672527-75672589,chr10,75672527,75672589,0,2583573
IMR90|chr10:73611990-73612045,chr10,73611990,73612045,IMR90|chr10:33628806-33628880,chr10,33628806,33628880,0,39983184
IMR90|chr10:73836929-73836960,chr10,73836929,73836960,IMR90|chr10:33626831-33626927,chr10,33626831,33626927,0,40210098
IMR90|chr10:74506851-74506871,chr10,74506851,74506871,IMR90|chr10:29699410-29699505,chr10,29699410,29699505,0,44807441
IMR90|chr10:74738062-74738113,chr10,74738062,74738113,IMR90|chr10:69834103-69834140,chr10,69834103,69834140,0,4903959
IMR90|chr10:74849225-74849375,chr10,74849225,74849375,IMR90|chr10:6187204-6187232,chr10,6187204,6187232,0,68662021
IMR90|chr10:75071941-75072033,chr10,75071941,75072033,IMR90|chr10:120839489-120839547,chr10,120839489,120839547,0,45767548
IMR90|chr10:75305789-75305932,chr10,75305789,75305932,IMR90|chr10:65277638-65277704,chr10,65277638,65277704,0,10028151
IMR90|chr10:75691657-75691748,chr10,75691657,75691748,IMR90|chr10:82216730-82216817,chr10,82216730,82216817,0,6525073
IMR90|chr10:75875581-75875629,chr10,75875581,75875629,IMR90|chr10:75760593-75760677,chr10,75760593,75760677,0,114988
IMR90|chr10:76029217-76029304,chr10,76029217,76029304,IMR90|chr10:104206244-104206304,chr10,104206244,104206304,0,28177027
IMR90|chr10:76092493-76092639,chr10,76092493,76092639,IMR90|chr10:133793768-133793808,chr10,133793768,133793808,0,57701275
IMR90|chr10:76487947-76487968,chr10,76487947,76487968,IMR90|chr10:76968473-76968525,chr10,76968473,76968525,0,480526
IMR90|chr10:76539333-76539384,chr10,76539333,76539384,IMR90|chr10:69834103-69834140,chr10,69834103,69834140,0,6705230
IMR90|chr10:76624818-76624868,chr10,76624818,76624868,IMR90|chr10:75537840-75537926,chr10,75537840,75537926,0,1086978
IMR90|chr10:76636670-76636744,chr10,76636670,76636744,IMR90|chr10:75675434-75675538,chr10,75675434,75675538,0,961236
IMR90|chr10:76933657-76933733,chr10,76933657,76933733,IMR90|chr10:65276967-65277030,chr10,65276967,65277030,0,11656690
IMR90|chr10:77058348-77058447,chr10,77058348,77058447,IMR90|chr10:120839489-120839547,chr10,120839489,120839547,0,43781141
IMR90|chr10:77319509-77319597,chr10,77319509,77319597,IMR90|chr10:32343473-32343534,chr10,32343473,32343534,0,44976036
IMR90|chr10:77679499-77679571,chr10,77679499,77679571,IMR90|chr10:106094503-106094539,chr10,106094503,106094539,0,28415004
IMR90|chr10:77729128-77729192,chr10,77729128,77729192,IMR90|chr10:65281497-65281583,chr10,65281497,65281583,0,12447631
IMR90|chr10:77966439-77966511,chr10,77966439,77966511,IMR90|chr10:75541118-75541181,chr10,75541118,75541181,0,2425321
IMR90|chr10:78228444-78228489,chr10,78228444,78228489,IMR90|chr10:104405254-104405324,chr10,104405254,104405324,0,26176810
IMR90|chr10:78338611-78338640,chr10,78338611,78338640,IMR90|chr10:89100222-89100258,chr10,89100222,89100258,0,10761611
IMR90|chr10:78339060-78339125,chr10,78339060,78339125,IMR90|chr10:86088988-86089049,chr10,86088988,86089049,0,7749928
IMR90|chr10:78753284-78753326,chr10,78753284,78753326,IMR90|chr10:65277711-65277817,chr10,65277711,65277817,0,13475573
IMR90|chr10:79004828-79004844,chr10,79004828,79004844,IMR90|chr10:104213330-104213348,chr10,104213330,104213348,0,25208502
IMR90|chr10:79104130-79104165,chr10,79104130,79104165,IMR90|chr10:103114510-103114567,chr10,103114510,103114567,0,24010380
IMR90|chr10:79159604-79159697,chr10,79159604,79159697,IMR90|chr10:76968473-76968525,chr10,76968473,76968525,0,2191131
IMR90|chr10:79173325-79173442,chr10,79173325,79173442,IMR90|chr10:127512500-127512533,chr10,127512500,127512533,0,48339175
IMR90|chr10:79515324-79515385,chr10,79515324,79515385,IMR90|chr10:112259338-112259371,chr10,112259338,112259371,0,32744014
IMR90|chr10:79659694-79659710,chr10,79659694,79659710,IMR90|chr10:17275134-17275252,chr10,17275134,17275252,0,62384560
IMR90|chr10:80251241-80251288,chr10,80251241,80251288,IMR90|chr10:134348707-134348857,chr10,134348707,134348857,0,54097466
IMR90|chr10:80811532-80811584,chr10,80811532,80811584,IMR90|chr10:105420480-105420569,chr10,105420480,105420569,0,24608948
IMR90|chr10:80934040-80934106,chr10,80934040,80934106,IMR90|chr10:3824555-3824589,chr10,3824555,3824589,0,77109485
IMR90|chr10:81791278-81791322,chr10,81791278,81791322,IMR90|chr10:51565404-51565463,chr10,51565404,51565463,0,30225874
IMR90|chr10:82062420-82062480,chr10,82062420,82062480,IMR90|chr10:103600210-103600296,chr10,103600210,103600296,0,21537790
IMR90|chr10:82230819-82230840,chr10,82230819,82230840,IMR90|chr10:76966477-76966616,chr10,76966477,76966616,0,5264342
IMR90|chr10:82530922-82530995,chr10,82530922,82530995,IMR90|chr10:46915562-46915639,chr10,46915562,46915639,0,35615360
IMR90|chr10:82668689-82668817,chr10,82668689,82668817,IMR90|chr10:32343473-32343534,chr10,32343473,32343534,0,50325216
IMR90|chr10:82709480-82709505,chr10,82709480,82709505,IMR90|chr10:65277233-65277278,chr10,65277233,65277278,0,17432247
IMR90|chr10:82940089-82940171,chr10,82940089,82940171,IMR90|chr10:65281497-65281583,chr10,65281497,65281583,0,17658592
IMR90|chr10:83315914-83315990,chr10,83315914,83315990,IMR90|chr10:65279449-65279520,chr10,65279449,65279520,0,18036465
IMR90|chr10:83364517-83364595,chr10,83364517,83364595,IMR90|chr10:63812533-63812558,chr10,63812533,63812558,0,19551984
IMR90|chr10:83477408-83477558,chr10,83477408,83477558,IMR90|chr10:65277711-65277817,chr10,65277711,65277817,0,18199697
IMR90|chr10:83674559-83674648,chr10,83674559,83674648,IMR90|chr10:32343473-32343534,chr10,32343473,32343534,0,51331086
IMR90|chr10:84314655-84314730,chr10,84314655,84314730,IMR90|chr10:103876442-103876517,chr10,103876442,103876517,0,19561787
IMR90|chr10:84566864-84566964,chr10,84566864,84566964,IMR90|chr10:28823229-28823289,chr10,28823229,28823289,0,55743635
IMR90|chr10:85265911-85265932,chr10,85265911,85265932,IMR90|chr10:76966477-76966616,chr10,76966477,76966616,0,8299434
IMR90|chr10:85421684-85421733,chr10,85421684,85421733,IMR90|chr10:112260430-112260580,chr10,112260430,112260580,0,26838746
IMR90|chr10:85614210-85614298,chr10,85614210,85614298,IMR90|chr10:111765169-111765231,chr10,111765169,111765231,0,26150959
IMR90|chr10:85836885-85836984,chr10,85836885,85836984,IMR90|chr10:75503921-75503939,chr10,75503921,75503939,0,10332964
IMR90|chr10:86009397-86009441,chr10,86009397,86009441,IMR90|chr10:82215033-82215085,chr10,82215033,82215085,0,3794364
IMR90|chr10:86094676-86094710,chr10,86094676,86094710,IMR90|chr10:98345769-98345885,chr10,98345769,98345885,0,12251093
IMR90|chr10:86299410-86299510,chr10,86299410,86299510,IMR90|chr10:28823229-28823289,chr10,28823229,28823289,0,57476181
IMR90|chr10:87133639-87133747,chr10,87133639,87133747,IMR90|chr10:95240201-95240297,chr10,95240201,95240297,0,8106562
IMR90|chr10:87604120-87604160,chr10,87604120,87604160,IMR90|chr10:93169882-93169975,chr10,93169882,93169975,0,5565762
IMR90|chr10:87788688-87788779,chr10,87788688,87788779,IMR90|chr10:104406586-104406639,chr10,104406586,104406639,0,16617898
IMR90|chr10:87827842-87827907,chr10,87827842,87827907,IMR90|chr10:102726079-102726151,chr10,102726079,102726151,0,14898237
IMR90|chr10:88166069-88166153,chr10,88166069,88166153,IMR90|chr10:95240827-95240944,chr10,95240827,95240944,0,7074758
IMR90|chr10:88269343-88269393,chr10,88269343,88269393,IMR90|chr10:75537840-75537926,chr10,75537840,75537926,0,12731503
IMR90|chr10:88629901-88629947,chr10,88629901,88629947,IMR90|chr10:116521039-116521143,chr10,116521039,116521143,0,27891138
IMR90|chr10:88643681-88643804,chr10,88643681,88643804,IMR90|chr10:80828753-80828780,chr10,80828753,80828780,0,7814928
IMR90|chr10:89654599-89654698,chr10,89654599,89654698,IMR90|chr10:82216961-82217104,chr10,82216961,82217104,0,7437638
IMR90|chr10:89794512-89794549,chr10,89794512,89794549,IMR90|chr10:17271966-17272007,chr10,17271966,17272007,0,72522546
IMR90|chr10:89849591-89849690,chr10,89849591,89849690,IMR90|chr10:65276804-65276855,chr10,65276804,65276855,0,24572787
IMR90|chr10:90677098-90677210,chr10,90677098,90677210,IMR90|chr10:75503921-75503959,chr10,75503921,75503959,0,15173177
IMR90|chr10:91066066-91066132,chr10,91066066,91066132,IMR90|chr10:103872927-103872968,chr10,103872927,103872968,0,12806861
IMR90|chr10:91152430-91152513,chr10,91152430,91152513,IMR90|chr10:75255752-75255857,chr10,75255752,75255857,0,15896678
IMR90|chr10:91837681-91837734,chr10,91837681,91837734,IMR90|chr10:33245401-33245551,chr10,33245401,33245551,0,58592280
IMR90|chr10:92446819-92446911,chr10,92446819,92446911,IMR90|chr10:120839489-120839547,chr10,120839489,120839547,0,28392670
IMR90|chr10:92583492-92583589,chr10,92583492,92583589,IMR90|chr10:69834107-69834140,chr10,69834107,69834140,0,22749385
IMR90|chr10:92749360-92749400,chr10,92749360,92749400,IMR90|chr10:112260177-112260230,chr10,112260177,112260230,0,19510817
IMR90|chr10:93400786-93400830,chr10,93400786,93400830,IMR90|chr10:92975350-92975450,chr10,92975350,92975450,0,425436
IMR90|chr10:93492768-93492858,chr10,93492768,93492858,IMR90|chr10:28823229-28823289,chr10,28823229,28823289,0,64669539
IMR90|chr10:93668587-93668633,chr10,93668587,93668633,IMR90|chr10:75675434-75675538,chr10,75675434,75675538,0,17993153
IMR90|chr10:94282825-94282916,chr10,94282825,94282916,IMR90|chr10:17272238-17272288,chr10,17272238,17272288,0,77010587
IMR90|chr10:94472571-94472664,chr10,94472571,94472664,IMR90|chr10:65277722-65277776,chr10,65277722,65277776,0,29194849
IMR90|chr10:94827717-94827788,chr10,94827717,94827788,IMR90|chr10:106094503-106094539,chr10,106094503,106094539,0,11266786
IMR90|chr10:95049830-95049905,chr10,95049830,95049905,IMR90|chr10:134349283-134349304,chr10,134349283,134349304,0,39299453
IMR90|chr10:95293100-95293156,chr10,95293100,95293156,IMR90|chr10:17273594-17273620,chr10,17273594,17273620,0,78019506
IMR90|chr10:95562664-95562746,chr10,95562664,95562746,IMR90|chr10:65281497-65281583,chr10,65281497,65281583,0,30281167
IMR90|chr10:96284159-96284287,chr10,96284159,96284287,IMR90|chr10:106095127-106095148,chr10,106095127,106095148,0,9810968
IMR90|chr10:96313667-96313721,chr10,96313667,96313721,IMR90|chr10:71896212-71896264,chr10,71896212,71896264,0,24417455
IMR90|chr10:96526082-96526176,chr10,96526082,96526176,IMR90|chr10:3826174-3826226,chr10,3826174,3826226,0,92699908
IMR90|chr10:96696726-96696795,chr10,96696726,96696795,IMR90|chr10:116523080-116523100,chr10,116523080,116523100,0,19826354
IMR90|chr10:96874299-96874321,chr10,96874299,96874321,IMR90|chr10:65280776-65280878,chr10,65280776,65280878,0,31593523
IMR90|chr10:97356373-97356413,chr10,97356373,97356413,IMR90|chr10:93169882-93169975,chr10,93169882,93169975,0,4186491
IMR90|chr10:97481290-97481323,chr10,97481290,97481323,IMR90|chr10:95240685-95240766,chr10,95240685,95240766,0,2240605
IMR90|chr10:98763552-98763625,chr10,98763552,98763625,IMR90|chr10:102726079-102726152,chr10,102726079,102726152,0,3962527
IMR90|chr10:98960098-98960174,chr10,98960098,98960174,IMR90|chr10:116526288-116526343,chr10,116526288,116526343,0,17566190
IMR90|chr10:99068297-99068328,chr10,99068297,99068328,IMR90|chr10:75675850-75675928,chr10,75675850,75675928,0,23392447
IMR90|chr10:99873211-99873358,chr10,99873211,99873358,IMR90|chr10:75503921-75503959,chr10,75503921,75503959,0,24369290
IMR90|chr10:100440050-100440142,chr10,100440050,100440142,IMR90|chr10:104406586-104406639,chr10,104406586,104406639,0,3966536
IMR90|chr10:100899793-100899833,chr10,100899793,100899833,IMR90|chr10:112260177-112260230,chr10,112260177,112260230,0,11360384
IMR90|chr10:100998144-100998170,chr10,100998144,100998170,IMR90|chr10:3825703-3825813,chr10,3825703,3825813,0,97172441
IMR90|chr10:101039450-101039507,chr10,101039450,101039507,IMR90|chr10:82216233-82216310,chr10,82216233,82216310,0,18823217
IMR90|chr10:101097308-101097329,chr10,101097308,101097329,IMR90|chr10:76968473-76968525,chr10,76968473,76968525,0,24128835
IMR90|chr10:101463532-101463623,chr10,101463532,101463623,IMR90|chr10:104406586-104406639,chr10,104406586,104406639,0,2943054
IMR90|chr10:101644037-101644082,chr10,101644037,101644082,IMR90|chr10:75255752-75255857,chr10,75255752,75255857,0,26388285
IMR90|chr10:101737093-101737145,chr10,101737093,101737145,IMR90|chr10:99183811-99183873,chr10,99183811,99183873,0,2553282
IMR90|chr10:101852959-101853019,chr10,101852959,101853019,IMR90|chr10:121414915-121414978,chr10,121414915,121414978,0,19561956
IMR90|chr10:101898907-101898966,chr10,101898907,101898966,IMR90|chr10:82215081-82215166,chr10,82215081,82215166,0,19683826
IMR90|chr10:102192568-102192612,chr10,102192568,102192612,IMR90|chr10:51565404-51565463,chr10,51565404,51565463,0,50627164
IMR90|chr10:103161892-103161981,chr10,103161892,103161981,IMR90|chr10:65276789-65276850,chr10,65276789,65276850,0,37885103
IMR90|chr10:104109770-104109854,chr10,104109770,104109854,IMR90|chr10:65277638-65277704,chr10,65277638,65277704,0,38832132
IMR90|chr10:104161695-104161797,chr10,104161695,104161797,IMR90|chr10:114713859-114713906,chr10,114713859,114713906,0,10552164
IMR90|chr10:104911288-104911305,chr10,104911288,104911305,IMR90|chr10:43903223-43903314,chr10,43903223,43903314,0,61008065
IMR90|chr10:105051210-105051294,chr10,105051210,105051294,IMR90|chr10:75255752-75255831,chr10,75255752,75255831,0,29795458
IMR90|chr10:105355424-105355479,chr10,105355424,105355479,IMR90|chr10:112260361-112260456,chr10,112260361,112260456,0,6904937
IMR90|chr10:105437162-105437209,chr10,105437162,105437209,IMR90|chr10:104407518-104407563,chr10,104407518,104407563,0,1029644
IMR90|chr10:106126136-106126168,chr10,106126136,106126168,IMR90|chr10:75763530-75763602,chr10,75763530,75763602,0,30362606
IMR90|chr10:106156963-106156989,chr10,106156963,106156989,IMR90|chr10:3825703-3825813,chr10,3825703,3825813,0,102331260
IMR90|chr10:106212268-106212415,chr10,106212268,106212415,IMR90|chr10:80828753-80828780,chr10,80828753,80828780,0,25383515
IMR90|chr10:106746174-106746223,chr10,106746174,106746223,IMR90|chr10:94335595-94335660,chr10,94335595,94335660,0,12410579
IMR90|chr10:107139090-107139123,chr10,107139090,107139123,IMR90|chr10:65278270-65278384,chr10,65278270,65278384,0,41860820
IMR90|chr10:107585284-107585357,chr10,107585284,107585357,IMR90|chr10:46915562-46915639,chr10,46915562,46915639,0,60669722
IMR90|chr10:107608020-107608073,chr10,107608020,107608073,IMR90|chr10:65281497-65281566,chr10,65281497,65281566,0,42326523
IMR90|chr10:107725893-107725970,chr10,107725893,107725970,IMR90|chr10:33626283-33626318,chr10,33626283,33626318,0,74099610
IMR90|chr10:108197721-108197785,chr10,108197721,108197785,IMR90|chr10:100206126-100206212,chr10,100206126,100206212,0,7991595
IMR90|chr10:108197922-108197983,chr10,108197922,108197983,IMR90|chr10:134349283-134349304,chr10,134349283,134349304,0,26151361
IMR90|chr10:108586576-108586642,chr10,108586576,108586642,IMR90|chr10:3824555-3824589,chr10,3824555,3824589,0,104762021
IMR90|chr10:108680382-108680404,chr10,108680382,108680404,IMR90|chr10:82215768-82215825,chr10,82215768,82215825,0,26464614
IMR90|chr10:108686138-108686229,chr10,108686138,108686229,IMR90|chr10:82216730-82216817,chr10,82216730,82216817,0,26469408
IMR90|chr10:109034809-109034882,chr10,109034809,109034882,IMR90|chr10:111763815-111763853,chr10,111763815,111763853,0,2729006
IMR90|chr10:109259415-109259483,chr10,109259415,109259483,IMR90|chr10:105430457-105430534,chr10,105430457,105430534,0,3828958
IMR90|chr10:109307449-109307524,chr10,109307449,109307524,IMR90|chr10:74117563-74117612,chr10,74117563,74117612,0,35189886
IMR90|chr10:110125913-110126006,chr10,110125913,110126006,IMR90|chr10:104407227-104407251,chr10,104407227,104407251,0,5718686
IMR90|chr10:110154577-110154675,chr10,110154577,110154675,IMR90|chr10:76967149-76967201,chr10,76967149,76967201,0,33187428
IMR90|chr10:110325838-110325889,chr10,110325838,110325889,IMR90|chr10:111760927-111760985,chr10,111760927,111760985,0,1435089
IMR90|chr10:110392217-110392356,chr10,110392217,110392356,IMR90|chr10:124935125-124935165,chr10,124935125,124935165,0,14542908
IMR90|chr10:110895229-110895355,chr10,110895229,110895355,IMR90|chr10:89100222-89100258,chr10,89100222,89100258,0,21795007
IMR90|chr10:111327088-111327196,chr10,111327088,111327196,IMR90|chr10:95240201-95240297,chr10,95240201,95240297,0,16086887
IMR90|chr10:111642685-111642832,chr10,111642685,111642832,IMR90|chr10:75503921-75503959,chr10,75503921,75503959,0,36138764
IMR90|chr10:112876299-112876338,chr10,112876299,112876338,IMR90|chr10:65276461-65276509,chr10,65276461,65276509,0,47599838
IMR90|chr10:113005783-113005883,chr10,113005783,113005883,IMR90|chr10:65276458-65276483,chr10,65276458,65276483,0,47729325
IMR90|chr10:113025953-113026029,chr10,113025953,113026029,IMR90|chr10:65276205-65276256,chr10,65276205,65276256,0,47749748
IMR90|chr10:113565321-113565354,chr10,113565321,113565354,IMR90|chr10:95240685-95240766,chr10,95240685,95240766,0,18324636
IMR90|chr10:113572928-113572980,chr10,113572928,113572980,IMR90|chr10:75539602-75539661,chr10,75539602,75539661,0,38033326
IMR90|chr10:113616487-113616543,chr10,113616487,113616543,IMR90|chr10:17273594-17273620,chr10,17273594,17273620,0,96342893
IMR90|chr10:114145949-114145995,chr10,114145949,114145995,IMR90|chr10:82215033-82215085,chr10,82215033,82215085,0,31930916
IMR90|chr10:115236807-115236860,chr10,115236807,115236860,IMR90|chr10:75672562-75672619,chr10,75672562,75672619,0,39564245
IMR90|chr10:115406614-115406662,chr10,115406614,115406662,IMR90|chr10:94335595-94335660,chr10,94335595,94335660,0,21071019
IMR90|chr10:115704442-115704551,chr10,115704442,115704551,IMR90|chr10:3826174-3826224,chr10,3826174,3826224,0,111878268
IMR90|chr10:115728327-115728372,chr10,115728327,115728372,IMR90|chr10:75255752-75255857,chr10,75255752,75255857,0,40472575
IMR90|chr10:115856047-115856090,chr10,115856047,115856090,IMR90|chr10:51565404-51565511,chr10,51565404,51565511,0,64290643
IMR90|chr10:116244337-116244365,chr10,116244337,116244365,IMR90|chr10:69834808-69834908,chr10,69834808,69834908,0,46409529
IMR90|chr10:116377512-116377573,chr10,116377512,116377573,IMR90|chr10:121413336-121413407,chr10,121413336,121413407,0,5035824
IMR90|chr10:116639620-116639718,chr10,116639620,116639718,IMR90|chr10:76967149-76967201,chr10,76967149,76967201,0,39672471
IMR90|chr10:116660717-116660816,chr10,116660717,116660816,IMR90|chr10:82216961-82217104,chr10,82216961,82217104,0,34443756
IMR90|chr10:117043892-117043964,chr10,117043892,117043964,IMR90|chr10:31609120-31609206,chr10,31609120,31609206,0,85434772
IMR90|chr10:117157597-117157739,chr10,117157597,117157739,IMR90|chr10:121355813-121355834,chr10,121355813,121355834,0,4198216
IMR90|chr10:117269239-117269291,chr10,117269239,117269291,IMR90|chr10:99183811-99183873,chr10,99183811,99183873,0,18085428
IMR90|chr10:117623312-117623383,chr10,117623312,117623383,IMR90|chr10:75541118-75541181,chr10,75541118,75541181,0,42082194
IMR90|chr10:117683185-117683233,chr10,117683185,117683233,IMR90|chr10:104407518-104407563,chr10,104407518,104407563,0,13275667
IMR90|chr10:118500968-118501014,chr10,118500968,118501014,IMR90|chr10:82216730-82216817,chr10,82216730,82216817,0,36284238
IMR90|chr10:120285207-120285304,chr10,120285207,120285304,IMR90|chr10:3825382-3825433,chr10,3825382,3825433,0,116459825
IMR90|chr10:121253313-121253358,chr10,121253313,121253358,IMR90|chr10:104405254-104405324,chr10,104405254,104405324,0,16848059
IMR90|chr10:122092829-122092905,chr10,122092829,122092905,IMR90|chr10:65279449-65279520,chr10,65279449,65279520,0,56813380
IMR90|chr10:122287683-122287755,chr10,122287683,122287755,IMR90|chr10:121412203-121412259,chr10,121412203,121412259,0,875480
IMR90|chr10:122505401-122505503,chr10,122505401,122505503,IMR90|chr10:114713859-114713906,chr10,114713859,114713906,0,7791542
IMR90|chr10:122544235-122544259,chr10,122544235,122544259,IMR90|chr10:80829992-80830104,chr10,80829992,80830104,0,41714243
IMR90|chr10:122660605-122660675,chr10,122660605,122660675,IMR90|chr10:111761693-111761723,chr10,111761693,111761723,0,10898912
IMR90|chr10:122832874-122832939,chr10,122832874,122832939,IMR90|chr10:75006179-75006236,chr10,75006179,75006236,0,47826695
IMR90|chr10:123280763-123280809,chr10,123280763,123280809,IMR90|chr10:75672539-75672605,chr10,75672539,75672605,0,47608224
IMR90|chr10:123653247-123653361,chr10,123653247,123653361,IMR90|chr10:106097673-106097726,chr10,106097673,106097726,0,17555574
IMR90|chr10:123819301-123819360,chr10,123819301,123819360,IMR90|chr10:121413336-121413407,chr10,121413336,121413407,0,2405965
IMR90|chr10:123925239-123925362,chr10,123925239,123925362,IMR90|chr10:80828753-80828780,chr10,80828753,80828780,0,43096486
IMR90|chr10:123978502-123978579,chr10,123978502,123978579,IMR90|chr10:75672527-75672589,chr10,75672527,75672589,0,48305975
IMR90|chr10:124090826-124090879,chr10,124090826,124090879,IMR90|chr10:33245401-33245551,chr10,33245401,33245551,0,90845425
IMR90|chr10:124407347-124407390,chr10,124407347,124407390,IMR90|chr10:112260076-112260149,chr10,112260076,112260149,0,12147271
IMR90|chr10:124584170-124584216,chr10,124584170,124584216,IMR90|chr10:116521039-116521143,chr10,116521039,116521143,0,8063131
IMR90|chr10:124619483-124619531,chr10,124619483,124619531,IMR90|chr10:104407518-104407563,chr10,104407518,104407563,0,20211965
IMR90|chr10:124694478-124694522,chr10,124694478,124694522,IMR90|chr10:82215033-82215085,chr10,82215033,82215085,0,42479445
IMR90|chr10:125080152-125080172,chr10,125080152,125080172,IMR90|chr10:29699410-29699505,chr10,29699410,29699505,0,95380742
IMR90|chr10:126811034-126811062,chr10,126811034,126811062,IMR90|chr10:69834808-69834908,chr10,69834808,69834908,0,56976226
IMR90|chr10:126878443-126878460,chr10,126878443,126878460,IMR90|chr10:43903223-43903314,chr10,43903223,43903314,0,82975220
IMR90|chr10:128375449-128375480,chr10,128375449,128375480,IMR90|chr10:105430457-105430534,chr10,105430457,105430534,0,22944992
IMR90|chr10:128396653-128396708,chr10,128396653,128396708,IMR90|chr10:33628806-33628880,chr10,33628806,33628880,0,94767847
IMR90|chr10:129520555-129520653,chr10,129520555,129520653,IMR90|chr10:112260361-112260456,chr10,112260361,112260456,0,17260194
IMR90|chr10:129886570-129886608,chr10,129886570,129886608,IMR90|chr10:5727490-5727565,chr10,5727490,5727565,0,124159080
IMR90|chr10:130158384-130158417,chr10,130158384,130158417,IMR90|chr10:134350281-134350420,chr10,134350281,134350420,0,4191897
IMR90|chr10:130908959-130909027,chr10,130908959,130909027,IMR90|chr10:105430457-105430534,chr10,105430457,105430534,0,25478502
IMR90|chr10:130942246-130942289,chr10,130942246,130942289,IMR90|chr10:80830630-80830733,chr10,80830630,80830733,0,50111616
IMR90|chr10:131205886-131205917,chr10,131205886,131205917,IMR90|chr10:33626831-33626927,chr10,33626831,33626927,0,97579055
IMR90|chr10:131746952-131747003,chr10,131746952,131747003,IMR90|chr10:94335595-94335660,chr10,94335595,94335660,0,37411357
IMR90|chr10:132210756-132210902,chr10,132210756,132210902,IMR90|chr10:133793768-133793808,chr10,133793768,133793808,0,1583012
IMR90|chr10:132446957-132447107,chr10,132446957,132447107,IMR90|chr10:65277711-65277817,chr10,65277711,65277817,0,67169246
IMR90|chr10:132555594-132555632,chr10,132555594,132555632,IMR90|chr10:5727490-5727565,chr10,5727490,5727565,0,126828104
IMR90|chr10:132572444-132572478,chr10,132572444,132572478,IMR90|chr10:75760593-75760677,chr10,75760593,75760677,0,56811851
IMR90|chr10:132655909-132656037,chr10,132655909,132656037,IMR90|chr10:106095127-106095148,chr10,106095127,106095148,0,26560782
IMR90|chr10:133107878-133107924,chr10,133107878,133107924,IMR90|chr10:82215033-82215085,chr10,82215033,82215085,0,50892845
IMR90|chr10:133238259-133238330,chr10,133238259,133238330,IMR90|chr10:111763815-111763853,chr10,111763815,111763853,0,21474444
IMR90|chr10:133437495-133437572,chr10,133437495,133437572,IMR90|chr10:46915557-46915629,chr10,46915557,46915629,0,86521938
IMR90|chr10:133946179-133946272,chr10,133946179,133946272,IMR90|chr10:104407227-104407251,chr10,104407227,104407251,0,29538952
IMR90|chr10:134521345-134521404,chr10,134521345,134521404,IMR90|chr10:121413336-121413407,chr10,121413336,121413407,0,13108009
IMR90|chr10:134995226-134995298,chr10,134995226,134995298,IMR90|chr10:75541118-75541181,chr10,75541118,75541181,0,59454108
IMR90|chr10:135483361-135483507,chr10,135483361,135483507,IMR90|chr10:65276837-65276951,chr10,65276837,65276951,0,70206524
IMR90|chr11:85194-85337,chr11,85194,85337,IMR90|chr11:66513908-66513972,chr11,66513908,66513972,0,66428714
IMR90|chr11:250362-250398,chr11,250362,250398,IMR90|chr11:62652533-62652629,chr11,62652533,62652629,0,62402171
IMR90|chr11:286853-286903,chr11,286853,286903,IMR90|chr11:16760706-16760759,chr11,16760706,16760759,0,16473853
IMR90|chr11:302820-302839,chr11,302820,302839,IMR90|chr11:67157335-67157447,chr11,67157335,67157447,0,66854515
IMR90|chr11:427966-428006,chr11,427966,428006,IMR90|chr11:62308729-62308838,chr11,62308729,62308838,0,61880763
IMR90|chr11:584061-584101,chr11,584061,584101,IMR90|chr11:46613110-46613220,chr11,46613110,46613220,0,46029049
IMR90|chr11:656914-656978,chr11,656914,656978,IMR90|chr11:696501-696581,chr11,696501,696581,0,39587
IMR90|chr11:682858-682948,chr11,682858,682948,IMR90|chr11:46142097-46142143,chr11,46142097,46142143,0,45459239
IMR90|chr11:686604-686634,chr11,686604,686634,IMR90|chr11:65656909-65657007,chr11,65656909,65657007,0,64970305
IMR90|chr11:996747-996824,chr11,996747,996824,IMR90|chr11:65157052-65157089,chr11,65157052,65157089,0,64160305
IMR90|chr11:1091258-1091385,chr11,1091258,1091385,IMR90|chr11:117199879-117199902,chr11,117199879,117199902,0,116108621
IMR90|chr11:1119080-1119114,chr11,1119080,1119114,IMR90|chr11:65218252-65218402,chr11,65218252,65218402,0,64099172
IMR90|chr11:1192523-1192626,chr11,1192523,1192626,IMR90|chr11:63607073-63607114,chr11,63607073,63607114,0,62414550
IMR90|chr11:1267894-1268006,chr11,1267894,1268006,IMR90|chr11:65664574-65664628,chr11,65664574,65664628,0,64396680
IMR90|chr11:1535242-1535316,chr11,1535242,1535316,IMR90|chr11:850516-850551,chr11,850516,850551,0,684726
IMR90|chr11:1860148-1860234,chr11,1860148,1860234,IMR90|chr11:125461995-125462040,chr11,125461995,125462040,0,123601847
IMR90|chr11:2036458-2036522,chr11,2036458,2036522,IMR90|chr11:65664631-65664692,chr11,65664631,65664692,0,63628173
IMR90|chr11:2045947-2046032,chr11,2045947,2046032,IMR90|chr11:12030325-12030352,chr11,12030325,12030352,0,9984378
IMR90|chr11:2065987-2066043,chr11,2065987,2066043,IMR90|chr11:2403887-2403950,chr11,2403887,2403950,0,337900
IMR90|chr11:2170050-2170098,chr11,2170050,2170098,IMR90|chr11:46302529-46302650,chr11,46302529,46302650,0,44132479
IMR90|chr11:2205335-2205401,chr11,2205335,2205401,IMR90|chr11:60614871-60614897,chr11,60614871,60614897,0,58409536
IMR90|chr11:2205816-2205877,chr11,2205816,2205877,IMR90|chr11:120082245-120082320,chr11,120082245,120082320,0,117876429
IMR90|chr11:2261078-2261145,chr11,2261078,2261145,IMR90|chr11:3117054-3117135,chr11,3117054,3117135,0,855976
IMR90|chr11:2460417-2460521,chr11,2460417,2460521,IMR90|chr11:65664572-65664600,chr11,65664572,65664600,0,63204155
IMR90|chr11:2491953-2491986,chr11,2491953,2491986,IMR90|chr11:93464267-93464348,chr11,93464267,93464348,0,90972314
IMR90|chr11:2504592-2504687,chr11,2504592,2504687,IMR90|chr11:64853573-64853607,chr11,64853573,64853607,0,62348981
IMR90|chr11:2527954-2527993,chr11,2527954,2527993,IMR90|chr11:125036603-125036703,chr11,125036603,125036703,0,122508649
IMR90|chr11:2626899-2626933,chr11,2626899,2626933,IMR90|chr11:120207293-120207386,chr11,120207293,120207386,0,117580394
IMR90|chr11:2659037-2659107,chr11,2659037,2659107,IMR90|chr11:47195768-47195808,chr11,47195768,47195808,0,44536731
IMR90|chr11:2717223-2717250,chr11,2717223,2717250,IMR90|chr11:125461864-125461934,chr11,125461864,125461934,0,122744641
IMR90|chr11:2720389-2720467,chr11,2720389,2720467,IMR90|chr11:85779100-85779172,chr11,85779100,85779172,0,83058711
IMR90|chr11:2803101-2803155,chr11,2803101,2803155,IMR90|chr11:57547551-57547629,chr11,57547551,57547629,0,54744450
IMR90|chr11:2822801-2822848,chr11,2822801,2822848,IMR90|chr11:120207137-120207239,chr11,120207137,120207239,0,117384336
IMR90|chr11:2974639-2974665,chr11,2974639,2974665,IMR90|chr11:57091292-57091438,chr11,57091292,57091438,0,54116653
IMR90|chr11:3064121-3064190,chr11,3064121,3064190,IMR90|chr11:707944-707973,chr11,707944,707973,0,2356177
IMR90|chr11:3221346-3221435,chr11,3221346,3221435,IMR90|chr11:10878473-10878529,chr11,10878473,10878529,0,7657127
IMR90|chr11:3312369-3312439,chr11,3312369,3312439,IMR90|chr11:3183275-3183318,chr11,3183275,3183318,0,129094
IMR90|chr11:3352188-3352277,chr11,3352188,3352277,IMR90|chr11:10878473-10878529,chr11,10878473,10878529,0,7526285
IMR90|chr11:3404880-3404914,chr11,3404880,3404914,IMR90|chr11:126858717-126858792,chr11,126858717,126858792,0,123453837
IMR90|chr11:3500241-3500321,chr11,3500241,3500321,IMR90|chr11:66513908-66513972,chr11,66513908,66513972,0,63013667
IMR90|chr11:3840485-3840516,chr11,3840485,3840516,IMR90|chr11:64020090-64020149,chr11,64020090,64020149,0,60179605
IMR90|chr11:3943562-3943608,chr11,3943562,3943608,IMR90|chr11:12133870-12133972,chr11,12133870,12133972,0,8190308
IMR90|chr11:3989403-3989485,chr11,3989403,3989485,IMR90|chr11:65310984-65311064,chr11,65310984,65311064,0,61321581
IMR90|chr11:3997752-3997811,chr11,3997752,3997811,IMR90|chr11:65343909-65343955,chr11,65343909,65343955,0,61346157
IMR90|chr11:4029540-4029636,chr11,4029540,4029636,IMR90|chr11:62311246-62311332,chr11,62311246,62311332,0,58281706
IMR90|chr11:4229658-4229678,chr11,4229658,4229678,IMR90|chr11:95656535-95656619,chr11,95656535,95656619,0,91426877
IMR90|chr11:4343818-4343857,chr11,4343818,4343857,IMR90|chr11:125036603-125036703,chr11,125036603,125036703,0,120692785
IMR90|chr11:4360053-4360100,chr11,4360053,4360100,IMR90|chr11:93466588-93466646,chr11,93466588,93466646,0,89106535
IMR90|chr11:4431611-4431664,chr11,4431611,4431664,IMR90|chr11:64105810-64105839,chr11,64105810,64105839,0,59674199
IMR90|chr11:4481296-4481330,chr11,4481296,4481330,IMR90|chr11:65288851-65288931,chr11,65288851,65288931,0,60807555
IMR90|chr11:4485134-4485166,chr11,4485134,4485166,IMR90|chr11:65665269-65665349,chr11,65665269,65665349,0,61180135
IMR90|chr11:4585172-4585231,chr11,4585172,4585231,IMR90|chr11:65343909-65343955,chr11,65343909,65343955,0,60758737
IMR90|chr11:4635083-4635130,chr11,4635083,4635130,IMR90|chr11:35164947-35165048,chr11,35164947,35165048,0,30529864
IMR90|chr11:4697935-4697996,chr11,4697935,4697996,IMR90|chr11:46613883-46613933,chr11,46613883,46613933,0,41915948
IMR90|chr11:4719726-4719876,chr11,4719726,4719876,IMR90|chr11:69456904-69456928,chr11,69456904,69456928,0,64737178
IMR90|chr11:4729976-4730078,chr11,4729976,4730078,IMR90|chr11:85779367-85779390,chr11,85779367,85779390,0,81049391
IMR90|chr11:4836234-4836264,chr11,4836234,4836264,IMR90|chr11:775175-775228,chr11,775175,775228,0,4061059
IMR90|chr11:4839610-4839666,chr11,4839610,4839666,IMR90|chr11:2403887-2403950,chr11,2403887,2403950,0,2435723
IMR90|chr11:4844105-4844132,chr11,4844105,4844132,IMR90|chr11:779257-779371,chr11,779257,779371,0,4064848
IMR90|chr11:4860193-4860253,chr11,4860193,4860253,IMR90|chr11:46613883-46613933,chr11,46613883,46613933,0,41753690
IMR90|chr11:4948727-4948807,chr11,4948727,4948807,IMR90|chr11:71937872-71937963,chr11,71937872,71937963,0,66989145
IMR90|chr11:4964244-4964317,chr11,4964244,4964317,IMR90|chr11:120208360-120208393,chr11,120208360,120208393,0,115244116
IMR90|chr11:5000882-5000956,chr11,5000882,5000956,IMR90|chr11:122527589-122527628,chr11,122527589,122527628,0,117526707
IMR90|chr11:5065420-5065505,chr11,5065420,5065505,IMR90|chr11:35548097-35548124,chr11,35548097,35548124,0,30482677
IMR90|chr11:5106034-5106085,chr11,5106034,5106085,IMR90|chr11:821421-821475,chr11,821421,821475,0,4284613
IMR90|chr11:5107939-5108037,chr11,5107939,5108037,IMR90|chr11:34074831-34074870,chr11,34074831,34074870,0,28966892
IMR90|chr11:5144140-5144204,chr11,5144140,5144204,IMR90|chr11:65666797-65666829,chr11,65666797,65666829,0,60522657
IMR90|chr11:5204895-5204924,chr11,5204895,5204924,IMR90|chr11:46303185-46303302,chr11,46303185,46303302,0,41098290
IMR90|chr11:5241690-5241772,chr11,5241690,5241772,IMR90|chr11:64904641-64904709,chr11,64904641,64904709,0,59662951
IMR90|chr11:5373772-5373834,chr11,5373772,5373834,IMR90|chr11:46613883-46613933,chr11,46613883,46613933,0,41240111
IMR90|chr11:5502908-5502976,chr11,5502908,5502976,IMR90|chr11:46142097-46142143,chr11,46142097,46142143,0,40639189
IMR90|chr11:5557898-5558012,chr11,5557898,5558012,IMR90|chr11:123064667-123064697,chr11,123064667,123064697,0,117506769
IMR90|chr11:5660507-5660568,chr11,5660507,5660568,IMR90|chr11:72437273-72437309,chr11,72437273,72437309,0,66776766
IMR90|chr11:5681184-5681299,chr11,5681184,5681299,IMR90|chr11:796659-796694,chr11,796659,796694,0,4884525
IMR90|chr11:5761028-5761055,chr11,5761028,5761055,IMR90|chr11:62312151-62312255,chr11,62312151,62312255,0,56551123
IMR90|chr11:5764529-5764568,chr11,5764529,5764568,IMR90|chr11:8699020-8699128,chr11,8699020,8699128,0,2934491
IMR90|chr11:5853483-5853548,chr11,5853483,5853548,IMR90|chr11:27720367-27720414,chr11,27720367,27720414,0,21866884
IMR90|chr11:5918326-5918406,chr11,5918326,5918406,IMR90|chr11:62494832-62494873,chr11,62494832,62494873,0,56576506
IMR90|chr11:5947190-5947257,chr11,5947190,5947257,IMR90|chr11:63582528-63582590,chr11,63582528,63582590,0,57635338
IMR90|chr11:6005491-6005531,chr11,6005491,6005531,IMR90|chr11:17230538-17230648,chr11,17230538,17230648,0,11225047
IMR90|chr11:6555087-6555140,chr11,6555087,6555140,IMR90|chr11:821421-821475,chr11,821421,821475,0,5733666
IMR90|chr11:6580130-6580177,chr11,6580130,6580177,IMR90|chr11:10878692-10878728,chr11,10878692,10878728,0,4298562
IMR90|chr11:6714801-6714856,chr11,6714801,6714856,IMR90|chr11:71936772-71936826,chr11,71936772,71936826,0,65221971
IMR90|chr11:6750302-6750354,chr11,6750302,6750354,IMR90|chr11:47618216-47618332,chr11,47618216,47618332,0,40867914
IMR90|chr11:6814413-6814489,chr11,6814413,6814489,IMR90|chr11:57508696-57508737,chr11,57508696,57508737,0,50694283
IMR90|chr11:6971855-6971908,chr11,6971855,6971908,IMR90|chr11:65102625-65102670,chr11,65102625,65102670,0,58130770
IMR90|chr11:7016847-7016932,chr11,7016847,7016932,IMR90|chr11:75276611-75276664,chr11,75276611,75276664,0,68259764
IMR90|chr11:7085126-7085159,chr11,7085126,7085159,IMR90|chr11:65082439-65082528,chr11,65082439,65082528,0,57997313
IMR90|chr11:7140391-7140428,chr11,7140391,7140428,IMR90|chr11:810468-810562,chr11,810468,810562,0,6329923
IMR90|chr11:7154111-7154138,chr11,7154111,7154138,IMR90|chr11:779257-779371,chr11,779257,779371,0,6374854
IMR90|chr11:7209294-7209339,chr11,7209294,7209339,IMR90|chr11:93467033-93467086,chr11,93467033,93467086,0,86257739
IMR90|chr11:7270602-7270664,chr11,7270602,7270664,IMR90|chr11:65665959-65666047,chr11,65665959,65666047,0,58395357
IMR90|chr11:7287746-7287769,chr11,7287746,7287769,IMR90|chr11:65217978-65218095,chr11,65217978,65218095,0,57930232
IMR90|chr11:7434305-7434382,chr11,7434305,7434382,IMR90|chr11:85779367-85779390,chr11,85779367,85779390,0,78345062
IMR90|chr11:7447100-7447147,chr11,7447100,7447147,IMR90|chr11:64945745-64945772,chr11,64945745,64945772,0,57498645
IMR90|chr11:7572851-7572875,chr11,7572851,7572875,IMR90|chr11:808403-808520,chr11,808403,808520,0,6764448
IMR90|chr11:7674571-7674647,chr11,7674571,7674647,IMR90|chr11:67809881-67809964,chr11,67809881,67809964,0,60135310
IMR90|chr11:7790881-7790949,chr11,7790881,7790949,IMR90|chr11:120208534-120208616,chr11,120208534,120208616,0,112417653
IMR90|chr11:7928425-7928525,chr11,7928425,7928525,IMR90|chr11:6627485-6627514,chr11,6627485,6627514,0,1300940
IMR90|chr11:8065834-8065875,chr11,8065834,8065875,IMR90|chr11:62477556-62477665,chr11,62477556,62477665,0,54411722
IMR90|chr11:8220694-8220742,chr11,8220694,8220742,IMR90|chr11:17097490-17097531,chr11,17097490,17097531,0,8876796
IMR90|chr11:8537454-8537556,chr11,8537454,8537556,IMR90|chr11:71937960-71937999,chr11,71937960,71937999,0,63400506
IMR90|chr11:8672297-8672339,chr11,8672297,8672339,IMR90|chr11:122938779-122938862,chr11,122938779,122938862,0,114266482
IMR90|chr11:8709130-8709185,chr11,8709130,8709185,IMR90|chr11:63608074-63608104,chr11,63608074,63608104,0,54898944
IMR90|chr11:9010988-9011050,chr11,9010988,9011050,IMR90|chr11:65664544-65664595,chr11,65664544,65664595,0,56653556
IMR90|chr11:9083903-9083964,chr11,9083903,9083964,IMR90|chr11:57546592-57546648,chr11,57546592,57546648,0,48462689
IMR90|chr11:9250576-9250594,chr11,9250576,9250594,IMR90|chr11:93469807-93469869,chr11,93469807,93469869,0,84219231
IMR90|chr11:9358889-9358937,chr11,9358889,9358937,IMR90|chr11:17097490-17097531,chr11,17097490,17097531,0,7738601
IMR90|chr11:9385987-9386007,chr11,9385987,9386007,IMR90|chr11:72432329-72432426,chr11,72432329,72432426,0,63046342
IMR90|chr11:9515522-9515619,chr11,9515522,9515619,IMR90|chr11:13488009-13488062,chr11,13488009,13488062,0,3972487
IMR90|chr11:9668948-9669097,chr11,9668948,9669097,IMR90|chr11:65030176-65030196,chr11,65030176,65030196,0,55361228
IMR90|chr11:9827834-9827860,chr11,9827834,9827860,IMR90|chr11:62312151-62312255,chr11,62312151,62312255,0,52484317
IMR90|chr11:9834640-9834697,chr11,9834640,9834697,IMR90|chr11:10320406-10320484,chr11,10320406,10320484,0,485766
IMR90|chr11:9916563-9916626,chr11,9916563,9916626,IMR90|chr11:120208534-120208616,chr11,120208534,120208616,0,110291971
IMR90|chr11:10108347-10108386,chr11,10108347,10108386,IMR90|chr11:62649706-62649815,chr11,62649706,62649815,0,52541359
IMR90|chr11:10195834-10195928,chr11,10195834,10195928,IMR90|chr11:6627485-6627514,chr11,6627485,6627514,0,3568349
IMR90|chr11:10266480-10266520,chr11,10266480,10266520,IMR90|chr11:64110416-64110458,chr11,64110416,64110458,0,53843936
IMR90|chr11:10289948-10289999,chr11,10289948,10289999,IMR90|chr11:102218099-102218194,chr11,102218099,102218194,0,91928151
IMR90|chr11:10666917-10666990,chr11,10666917,10666990,IMR90|chr11:74694553-74694596,chr11,74694553,74694596,0,64027636
IMR90|chr11:10790098-10790126,chr11,10790098,10790126,IMR90|chr11:65637881-65637999,chr11,65637881,65637999,0,54847783
IMR90|chr11:10834168-10834213,chr11,10834168,10834213,IMR90|chr11:65220459-65220551,chr11,65220459,65220551,0,54386291
IMR90|chr11:10888937-10889029,chr11,10888937,10889029,IMR90|chr11:85779223-85779267,chr11,85779223,85779267,0,74890286
IMR90|chr11:11016415-11016448,chr11,11016415,11016448,IMR90|chr11:65336951-65337039,chr11,65336951,65337039,0,54320536
IMR90|chr11:11075593-11075716,chr11,11075593,11075716,IMR90|chr11:708444-708471,chr11,708444,708471,0,10367149
IMR90|chr11:11152814-11152932,chr11,11152814,11152932,IMR90|chr11:70054648-70054744,chr11,70054648,70054744,0,58901834
IMR90|chr11:11180798-11180835,chr11,11180798,11180835,IMR90|chr11:27720859-27720896,chr11,27720859,27720896,0,16540061
IMR90|chr11:11567107-11567165,chr11,11567107,11567165,IMR90|chr11:57091339-57091431,chr11,57091339,57091431,0,45524232
IMR90|chr11:11628228-11628325,chr11,11628228,11628325,IMR90|chr11:2403627-2403715,chr11,2403627,2403715,0,9224601
IMR90|chr11:11634771-11634856,chr11,11634771,11634856,IMR90|chr11:75276611-75276664,chr11,75276611,75276664,0,63641840
IMR90|chr11:11725563-11725606,chr11,11725563,11725606,IMR90|chr11:65665416-65665470,chr11,65665416,65665470,0,53939853
IMR90|chr11:11759041-11759099,chr11,11759041,11759099,IMR90|chr11:65664574-65664628,chr11,65664574,65664628,0,53905533
IMR90|chr11:11800090-11800133,chr11,11800090,11800133,IMR90|chr11:57530091-57530144,chr11,57530091,57530144,0,45730001
IMR90|chr11:11802237-11802280,chr11,11802237,11802280,IMR90|chr11:35551026-35551113,chr11,35551026,35551113,0,23748789
IMR90|chr11:11928740-11928791,chr11,11928740,11928791,IMR90|chr11:123064938-123065016,chr11,123064938,123065016,0,111136198
IMR90|chr11:11981349-11981403,chr11,11981349,11981403,IMR90|chr11:212049-212116,chr11,212049,212116,0,11769300
IMR90|chr11:12177221-12177283,chr11,12177221,12177283,IMR90|chr11:65664544-65664595,chr11,65664544,65664595,0,53487323
IMR90|chr11:12247496-12247525,chr11,12247496,12247525,IMR90|chr11:46302529-46302650,chr11,46302529,46302650,0,34055033
IMR90|chr11:12255045-12255084,chr11,12255045,12255084,IMR90|chr11:57529886-57529934,chr11,57529886,57529934,0,45274841
IMR90|chr11:12398506-12398524,chr11,12398506,12398524,IMR90|chr11:72432329-72432426,chr11,72432329,72432426,0,60033823
IMR90|chr11:12586545-12586608,chr11,12586545,12586608,IMR90|chr11:16761238-16761325,chr11,16761238,16761325,0,4174693
IMR90|chr11:12664602-12664716,chr11,12664602,12664716,IMR90|chr11:123064667-123064697,chr11,123064667,123064697,0,110400065
IMR90|chr11:12712660-12712700,chr11,12712660,12712700,IMR90|chr11:67799439-67799515,chr11,67799439,67799515,0,55086779
IMR90|chr11:12736533-12736585,chr11,12736533,12736585,IMR90|chr11:123064938-123065016,chr11,123064938,123065016,0,110328405
IMR90|chr11:12974524-12974615,chr11,12974524,12974615,IMR90|chr11:65032840-65032874,chr11,65032840,65032874,0,52058316
IMR90|chr11:13090184-13090212,chr11,13090184,13090212,IMR90|chr11:118888196-118888318,chr11,118888196,118888318,0,105798012
IMR90|chr11:13235619-13235639,chr11,13235619,13235639,IMR90|chr11:63934792-63934855,chr11,63934792,63934855,0,50699173
IMR90|chr11:13253834-13253891,chr11,13253834,13253891,IMR90|chr11:126858717-126858792,chr11,126858717,126858792,0,113604883
IMR90|chr11:13657829-13657911,chr11,13657829,13657911,IMR90|chr11:64103598-64103626,chr11,64103598,64103626,0,50445769
IMR90|chr11:13668930-13668961,chr11,13668930,13668961,IMR90|chr11:57548538-57548670,chr11,57548538,57548670,0,43879608
IMR90|chr11:13747018-13747129,chr11,13747018,13747129,IMR90|chr11:17098430-17098469,chr11,17098430,17098469,0,3351412
IMR90|chr11:13764678-13764732,chr11,13764678,13764732,IMR90|chr11:12029101-12029184,chr11,12029101,12029184,0,1735577
IMR90|chr11:13848428-13848489,chr11,13848428,13848489,IMR90|chr11:74695323-74695356,chr11,74695323,74695356,0,60846895
IMR90|chr11:13938806-13938891,chr11,13938806,13938891,IMR90|chr11:60611631-60611745,chr11,60611631,60611745,0,46672825
IMR90|chr11:13975732-13975775,chr11,13975732,13975775,IMR90|chr11:93474278-93474385,chr11,93474278,93474385,0,79498546
IMR90|chr11:14033967-14034059,chr11,14033967,14034059,IMR90|chr11:85779223-85779267,chr11,85779223,85779267,0,71745256
IMR90|chr11:14110720-14110801,chr11,14110720,14110801,IMR90|chr11:67138513-67138547,chr11,67138513,67138547,0,53027793
IMR90|chr11:14219022-14219107,chr11,14219022,14219107,IMR90|chr11:12030325-12030352,chr11,12030325,12030352,0,2188697
IMR90|chr11:14297052-14297074,chr11,14297052,14297074,IMR90|chr11:57089947-57090005,chr11,57089947,57090005,0,42792895
IMR90|chr11:14324423-14324532,chr11,14324423,14324532,IMR90|chr11:93474300-93474341,chr11,93474300,93474341,0,79149877
IMR90|chr11:14391967-14392044,chr11,14391967,14392044,IMR90|chr11:3181528-3181578,chr11,3181528,3181578,0,11210439
IMR90|chr11:14431780-14431810,chr11,14431780,14431810,IMR90|chr11:82869730-82869801,chr11,82869730,82869801,0,68437950
IMR90|chr11:14546292-14546341,chr11,14546292,14546341,IMR90|chr11:1782392-1782494,chr11,1782392,1782494,0,12763900
IMR90|chr11:14553733-14553771,chr11,14553733,14553771,IMR90|chr11:117050785-117050897,chr11,117050785,117050897,0,102497052
IMR90|chr11:14588418-14588524,chr11,14588418,14588524,IMR90|chr11:65664572-65664600,chr11,65664572,65664600,0,51076154
IMR90|chr11:14588863-14588922,chr11,14588863,14588922,IMR90|chr11:71937872-71937963,chr11,71937872,71937963,0,57349009
IMR90|chr11:14724217-14724251,chr11,14724217,14724251,IMR90|chr11:65218252-65218402,chr11,65218252,65218402,0,50494035
IMR90|chr11:14770649-14770693,chr11,14770649,14770693,IMR90|chr11:808581-808648,chr11,808581,808648,0,13962068
IMR90|chr11:14804317-14804384,chr11,14804317,14804384,IMR90|chr11:63582528-63582590,chr11,63582528,63582590,0,48778211
IMR90|chr11:14848828-14848880,chr11,14848828,14848880,IMR90|chr11:843952-844005,chr11,843952,844005,0,14004876
IMR90|chr11:14911870-14911964,chr11,14911870,14911964,IMR90|chr11:6627485-6627514,chr11,6627485,6627514,0,8284385
IMR90|chr11:15018527-15018599,chr11,15018527,15018599,IMR90|chr11:65406450-65406488,chr11,65406450,65406488,0,50387923
IMR90|chr11:15021186-15021258,chr11,15021186,15021258,IMR90|chr11:35551001-35551079,chr11,35551001,35551079,0,20529815
IMR90|chr11:15134565-15134585,chr11,15134565,15134585,IMR90|chr11:12028718-12028786,chr11,12028718,12028786,0,3105847
IMR90|chr11:15152950-15153010,chr11,15152950,15153010,IMR90|chr11:72433658-72433692,chr11,72433658,72433692,0,57280708
IMR90|chr11:15310497-15310524,chr11,15310497,15310524,IMR90|chr11:82869730-82869804,chr11,82869730,82869804,0,67559233
IMR90|chr11:15350677-15350788,chr11,15350677,15350788,IMR90|chr11:17098430-17098469,chr11,17098430,17098469,0,1747753
IMR90|chr11:15448190-15448245,chr11,15448190,15448245,IMR90|chr11:73882957-73882979,chr11,73882957,73882979,0,58434767
IMR90|chr11:15547920-15547992,chr11,15547920,15547992,IMR90|chr11:65665975-65666047,chr11,65665975,65666047,0,50118055
IMR90|chr11:15784105-15784177,chr11,15784105,15784177,IMR90|chr11:3396142-3396197,chr11,3396142,3396197,0,12387963
IMR90|chr11:15887702-15887757,chr11,15887702,15887757,IMR90|chr11:75276421-75276479,chr11,75276421,75276479,0,59388719
IMR90|chr11:16048944-16049003,chr11,16048944,16049003,IMR90|chr11:13483943-13483996,chr11,13483943,13483996,0,2565001
IMR90|chr11:16052482-16052563,chr11,16052482,16052563,IMR90|chr11:85779185-85779240,chr11,85779185,85779240,0,69726703
IMR90|chr11:16078444-16078474,chr11,16078444,16078474,IMR90|chr11:35162256-35162369,chr11,35162256,35162369,0,19083812
IMR90|chr11:16117279-16117336,chr11,16117279,16117336,IMR90|chr11:35548048-35548130,chr11,35548048,35548130,0,19430769
IMR90|chr11:16378388-16378435,chr11,16378388,16378435,IMR90|chr11:93466588-93466646,chr11,93466588,93466646,0,77088200
IMR90|chr11:16449366-16449426,chr11,16449366,16449426,IMR90|chr11:64847567-64847644,chr11,64847567,64847644,0,48398201
IMR90|chr11:16467447-16467509,chr11,16467447,16467509,IMR90|chr11:2399643-2399763,chr11,2399643,2399763,0,14067804
IMR90|chr11:16609366-16609418,chr11,16609366,16609418,IMR90|chr11:65667459-65667520,chr11,65667459,65667520,0,49058093
IMR90|chr11:16630403-16630440,chr11,16630403,16630440,IMR90|chr11:66054238-66054351,chr11,66054238,66054351,0,49423835
IMR90|chr11:16909984-16910087,chr11,16909984,16910087,IMR90|chr11:62311374-62311408,chr11,62311374,62311408,0,45401390
IMR90|chr11:16920062-16920083,chr11,16920062,16920083,IMR90|chr11:63934792-63934855,chr11,63934792,63934855,0,47014730
IMR90|chr11:16920967-16921002,chr11,16920967,16921002,IMR90|chr11:64879886-64879960,chr11,64879886,64879960,0,47958919
IMR90|chr11:16984104-16984127,chr11,16984104,16984127,IMR90|chr11:17095140-17095264,chr11,17095140,17095264,0,111036
IMR90|chr11:17218893-17218955,chr11,17218893,17218955,IMR90|chr11:64944530-64944603,chr11,64944530,64944603,0,47725637
IMR90|chr11:17324649-17324728,chr11,17324649,17324728,IMR90|chr11:65663807-65663844,chr11,65663807,65663844,0,48339158
IMR90|chr11:17383636-17383694,chr11,17383636,17383694,IMR90|chr11:67007042-67007134,chr11,67007042,67007134,0,49623406
IMR90|chr11:17393912-17393990,chr11,17393912,17393990,IMR90|chr11:66026929-66026974,chr11,66026929,66026974,0,48633017
IMR90|chr11:17684908-17684981,chr11,17684908,17684981,IMR90|chr11:117016722-117016774,chr11,117016722,117016774,0,99331814
IMR90|chr11:17720913-17720972,chr11,17720913,17720972,IMR90|chr11:12137365-12137422,chr11,12137365,12137422,0,5583548
IMR90|chr11:17895230-17895327,chr11,17895230,17895327,IMR90|chr11:34074831-34074870,chr11,34074831,34074870,0,16179601
IMR90|chr11:17906544-17906605,chr11,17906544,17906605,IMR90|chr11:64847567-64847644,chr11,64847567,64847644,0,46941023
IMR90|chr11:18013947-18013965,chr11,18013947,18013965,IMR90|chr11:66054390-66054474,chr11,66054390,66054474,0,48040443
IMR90|chr11:18036332-18036414,chr11,18036332,18036414,IMR90|chr11:18610090-18610117,chr11,18610090,18610117,0,573758
IMR90|chr11:18126653-18126732,chr11,18126653,18126732,IMR90|chr11:65663807-65663844,chr11,65663807,65663844,0,47537154
IMR90|chr11:18219558-18219608,chr11,18219558,18219608,IMR90|chr11:79148089-79148181,chr11,79148089,79148181,0,60928531
IMR90|chr11:18457004-18457112,chr11,18457004,18457112,IMR90|chr11:35550076-35550126,chr11,35550076,35550126,0,17093072
IMR90|chr11:18529170-18529208,chr11,18529170,18529208,IMR90|chr11:27720859-27720896,chr11,27720859,27720896,0,9191689
IMR90|chr11:18641366-18641443,chr11,18641366,18641443,IMR90|chr11:126222296-126222394,chr11,126222296,126222394,0,107580930
IMR90|chr11:18799448-18799541,chr11,18799448,18799541,IMR90|chr11:101786286-101786343,chr11,101786286,101786343,0,82986838
IMR90|chr11:19069434-19069486,chr11,19069434,19069486,IMR90|chr11:843952-844005,chr11,843952,844005,0,18225482
IMR90|chr11:19126245-19126307,chr11,19126245,19126307,IMR90|chr11:85778792-85778822,chr11,85778792,85778822,0,66652547
IMR90|chr11:19143870-19143968,chr11,19143870,19143968,IMR90|chr11:65152412-65152444,chr11,65152412,65152444,0,46008542
IMR90|chr11:19295492-19295571,chr11,19295492,19295571,IMR90|chr11:17230538-17230648,chr11,17230538,17230648,0,2064954
IMR90|chr11:19297340-19297377,chr11,19297340,19297377,IMR90|chr11:65478420-65478500,chr11,65478420,65478500,0,46181080
IMR90|chr11:19433595-19433696,chr11,19433595,19433696,IMR90|chr11:122928925-122928958,chr11,122928925,122928958,0,103495330
IMR90|chr11:19451321-19451376,chr11,19451321,19451376,IMR90|chr11:66610006-66610041,chr11,66610006,66610041,0,47158685
IMR90|chr11:19539938-19540048,chr11,19539938,19540048,IMR90|chr11:93472893-93472928,chr11,93472893,93472928,0,73932955
IMR90|chr11:19621401-19621458,chr11,19621401,19621458,IMR90|chr11:35550445-35550527,chr11,35550445,35550527,0,15929044
IMR90|chr11:19728711-19728738,chr11,19728711,19728738,IMR90|chr11:34124818-34124880,chr11,34124818,34124880,0,14396107
IMR90|chr11:19730945-19730985,chr11,19730945,19730985,IMR90|chr11:67799439-67799515,chr11,67799439,67799515,0,48068494
IMR90|chr11:19896411-19896503,chr11,19896411,19896503,IMR90|chr11:57090377-57090435,chr11,57090377,57090435,0,37193966
IMR90|chr11:19923308-19923369,chr11,19923308,19923369,IMR90|chr11:57546592-57546648,chr11,57546592,57546648,0,37623284
IMR90|chr11:19999546-19999613,chr11,19999546,19999613,IMR90|chr11:118779668-118779698,chr11,118779668,118779698,0,98780122
IMR90|chr11:20051938-20051967,chr11,20051938,20051967,IMR90|chr11:65656917-65657013,chr11,65656917,65657013,0,45604979
IMR90|chr11:20100792-20100827,chr11,20100792,20100827,IMR90|chr11:12699903-12699991,chr11,12699903,12699991,0,7400889
IMR90|chr11:20116765-20116836,chr11,20116765,20116836,IMR90|chr11:47195768-47195808,chr11,47195768,47195808,0,27079003
IMR90|chr11:20191237-20191294,chr11,20191237,20191294,IMR90|chr11:65157943-65158012,chr11,65157943,65158012,0,44966706
IMR90|chr11:20388019-20388121,chr11,20388019,20388121,IMR90|chr11:71937960-71937999,chr11,71937960,71937999,0,51549941
IMR90|chr11:20530907-20531017,chr11,20530907,20531017,IMR90|chr11:70050244-70050284,chr11,70050244,70050284,0,49519337
IMR90|chr11:20543543-20543582,chr11,20543543,20543582,IMR90|chr11:62304603-62304695,chr11,62304603,62304695,0,41761060
IMR90|chr11:20654896-20655011,chr11,20654896,20655011,IMR90|chr11:8699052-8699076,chr11,8699052,8699076,0,11955844
IMR90|chr11:20745215-20745298,chr11,20745215,20745298,IMR90|chr11:18610090-18610117,chr11,18610090,18610117,0,2135125
IMR90|chr11:20752943-20753033,chr11,20752943,20753033,IMR90|chr11:67799211-67799260,chr11,67799211,67799260,0,47046268
IMR90|chr11:20875031-20875090,chr11,20875031,20875090,IMR90|chr11:12132680-12132750,chr11,12132680,12132750,0,8742351
IMR90|chr11:21002732-21002750,chr11,21002732,21002750,IMR90|chr11:67157335-67157447,chr11,67157335,67157447,0,46154603
IMR90|chr11:21130726-21130821,chr11,21130726,21130821,IMR90|chr11:93474300-93474341,chr11,93474300,93474341,0,72343574
IMR90|chr11:21201318-21201381,chr11,21201318,21201381,IMR90|chr11:67798762-67798797,chr11,67798762,67798797,0,46597444
IMR90|chr11:21233619-21233657,chr11,21233619,21233657,IMR90|chr11:65030861-65030969,chr11,65030861,65030969,0,43797242
IMR90|chr11:21477236-21477252,chr11,21477236,21477252,IMR90|chr11:67135728-67135828,chr11,67135728,67135828,0,45658492
IMR90|chr11:21580429-21580473,chr11,21580429,21580473,IMR90|chr11:118790499-118790543,chr11,118790499,118790543,0,97210070
IMR90|chr11:21684276-21684313,chr11,21684276,21684313,IMR90|chr11:8699020-8699128,chr11,8699020,8699128,0,12985256
IMR90|chr11:21755491-21755546,chr11,21755491,21755546,IMR90|chr11:27721420-27721485,chr11,27721420,27721485,0,5965929
IMR90|chr11:21941182-21941259,chr11,21941182,21941259,IMR90|chr11:93470866-93470886,chr11,93470866,93470886,0,71529684
IMR90|chr11:21951652-21951686,chr11,21951652,21951686,IMR90|chr11:35164845-35164932,chr11,35164845,35164932,0,13213193
IMR90|chr11:21955131-21955227,chr11,21955131,21955227,IMR90|chr11:65102565-65102605,chr11,65102565,65102605,0,43147434
IMR90|chr11:21956157-21956190,chr11,21956157,21956190,IMR90|chr11:47619591-47619626,chr11,47619591,47619626,0,25663434
IMR90|chr11:22009740-22009796,chr11,22009740,22009796,IMR90|chr11:62494042-62494129,chr11,62494042,62494129,0,40484302
IMR90|chr11:22018197-22018256,chr11,22018197,22018256,IMR90|chr11:117048265-117048410,chr11,117048265,117048410,0,95030068
IMR90|chr11:22046806-22046940,chr11,22046806,22046940,IMR90|chr11:8699052-8699076,chr11,8699052,8699076,0,13347754
IMR90|chr11:22128559-22128603,chr11,22128559,22128603,IMR90|chr11:57530091-57530144,chr11,57530091,57530144,0,35401532
IMR90|chr11:22212829-22212939,chr11,22212829,22212939,IMR90|chr11:8704873-8704939,chr11,8704873,8704939,0,13507956
IMR90|chr11:22222650-22222713,chr11,22222650,22222713,IMR90|chr11:34125170-34125257,chr11,34125170,34125257,0,11902520
IMR90|chr11:22357876-22357909,chr11,22357876,22357909,IMR90|chr11:47619591-47619626,chr11,47619591,47619626,0,25261715
IMR90|chr11:22421358-22421391,chr11,22421358,22421391,IMR90|chr11:74695933-74696050,chr11,74695933,74696050,0,52274575
IMR90|chr11:22483693-22483753,chr11,22483693,22483753,IMR90|chr11:79151889-79151956,chr11,79151889,79151956,0,56668196
IMR90|chr11:22707271-22707367,chr11,22707271,22707367,IMR90|chr11:93473514-93473594,chr11,93473514,93473594,0,70766243
IMR90|chr11:22935535-22935611,chr11,22935535,22935611,IMR90|chr11:120207137-120207239,chr11,120207137,120207239,0,97271602
IMR90|chr11:23011277-23011342,chr11,23011277,23011342,IMR90|chr11:65404910-65404961,chr11,65404910,65404961,0,42393633
IMR90|chr11:23179850-23179945,chr11,23179850,23179945,IMR90|chr11:3398768-3398808,chr11,3398768,3398808,0,19781082
IMR90|chr11:23310123-23310171,chr11,23310123,23310171,IMR90|chr11:1782392-1782494,chr11,1782392,1782494,0,21527731
IMR90|chr11:23420179-23420214,chr11,23420179,23420214,IMR90|chr11:57546591-57546631,chr11,57546591,57546631,0,34126412
IMR90|chr11:23491569-23491619,chr11,23491569,23491619,IMR90|chr11:102962159-102962210,chr11,102962159,102962210,0,79470590
IMR90|chr11:23555115-23555157,chr11,23555115,23555157,IMR90|chr11:808581-808648,chr11,808581,808648,0,22746534
IMR90|chr11:23577080-23577147,chr11,23577080,23577147,IMR90|chr11:117050785-117050897,chr11,117050785,117050897,0,93473705
IMR90|chr11:23583216-23583243,chr11,23583216,23583243,IMR90|chr11:125461864-125461934,chr11,125461864,125461934,0,101878648
IMR90|chr11:23604298-23604393,chr11,23604298,23604393,IMR90|chr11:93474300-93474341,chr11,93474300,93474341,0,69870002
IMR90|chr11:23697152-23697184,chr11,23697152,23697184,IMR90|chr11:128389509-128389598,chr11,128389509,128389598,0,104692357
IMR90|chr11:23756731-23756778,chr11,23756731,23756778,IMR90|chr11:60611909-60611976,chr11,60611909,60611976,0,36855178
IMR90|chr11:23789203-23789298,chr11,23789203,23789298,IMR90|chr11:62651800-62651838,chr11,62651800,62651838,0,38862597
IMR90|chr11:23938275-23938390,chr11,23938275,23938390,IMR90|chr11:291357-291392,chr11,291357,291392,0,23646918
IMR90|chr11:24049402-24049498,chr11,24049402,24049498,IMR90|chr11:6501857-6501878,chr11,6501857,6501878,0,17547545
IMR90|chr11:24150157-24150235,chr11,24150157,24150235,IMR90|chr11:65330650-65330722,chr11,65330650,65330722,0,41180493
IMR90|chr11:24221894-24221920,chr11,24221894,24221920,IMR90|chr11:17095140-17095264,chr11,17095140,17095264,0,7126754
IMR90|chr11:24230581-24230634,chr11,24230581,24230634,IMR90|chr11:65097558-65097639,chr11,65097558,65097639,0,40866977
IMR90|chr11:24350404-24350459,chr11,24350404,24350459,IMR90|chr11:126858717-126858792,chr11,126858717,126858792,0,102508313
IMR90|chr11:24359284-24359310,chr11,24359284,24359310,IMR90|chr11:65155227-65155313,chr11,65155227,65155313,0,40795943
IMR90|chr11:24542116-24542161,chr11,24542116,24542161,IMR90|chr11:65478354-65478410,chr11,65478354,65478410,0,40936238
IMR90|chr11:24543224-24543247,chr11,24543224,24543247,IMR90|chr11:65665038-65665162,chr11,65665038,65665162,0,41121814
IMR90|chr11:24713722-24713745,chr11,24713722,24713745,IMR90|chr11:93466776-93466856,chr11,93466776,93466856,0,68753054
IMR90|chr11:24716448-24716529,chr11,24716448,24716529,IMR90|chr11:120209333-120209373,chr11,120209333,120209373,0,95492885
IMR90|chr11:24784252-24784290,chr11,24784252,24784290,IMR90|chr11:65345677-65345789,chr11,65345677,65345789,0,40561425
IMR90|chr11:24869244-24869286,chr11,24869244,24869286,IMR90|chr11:65665416-65665470,chr11,65665416,65665470,0,40796172
IMR90|chr11:24902077-24902185,chr11,24902077,24902185,IMR90|chr11:65033144-65033197,chr11,65033144,65033197,0,40131067
IMR90|chr11:25004377-25004434,chr11,25004377,25004434,IMR90|chr11:35550445-35550527,chr11,35550445,35550527,0,10546068
IMR90|chr11:25021036-25021116,chr11,25021036,25021116,IMR90|chr11:65321510-65321532,chr11,65321510,65321532,0,40300474
IMR90|chr11:25113340-25113392,chr11,25113340,25113392,IMR90|chr11:65097558-65097639,chr11,65097558,65097639,0,39984218
IMR90|chr11:25207806-25207899,chr11,25207806,25207899,IMR90|chr11:101786286-101786343,chr11,101786286,101786343,0,76578480
IMR90|chr11:25282162-25282307,chr11,25282162,25282307,IMR90|chr11:70054802-70054901,chr11,70054802,70054901,0,44772640
IMR90|chr11:25558189-25558256,chr11,25558189,25558256,IMR90|chr11:93477507-93477552,chr11,93477507,93477552,0,67919318
IMR90|chr11:25572513-25572576,chr11,25572513,25572576,IMR90|chr11:64886695-64886765,chr11,64886695,64886765,0,39314182
IMR90|chr11:25685898-25685960,chr11,25685898,25685960,IMR90|chr11:65338802-65338843,chr11,65338802,65338843,0,39652904
IMR90|chr11:25812127-25812145,chr11,25812127,25812145,IMR90|chr11:66054390-66054474,chr11,66054390,66054474,0,40242263
IMR90|chr11:25847391-25847427,chr11,25847391,25847427,IMR90|chr11:65033219-65033332,chr11,65033219,65033332,0,39185828
IMR90|chr11:25874643-25874706,chr11,25874643,25874706,IMR90|chr11:120208534-120208616,chr11,120208534,120208616,0,94333891
IMR90|chr11:26000057-26000107,chr11,26000057,26000107,IMR90|chr11:35550076-35550126,chr11,35550076,35550126,0,9550019
IMR90|chr11:26071076-26071093,chr11,26071076,26071093,IMR90|chr11:57548441-57548562,chr11,57548441,57548562,0,31477365
IMR90|chr11:26075430-26075447,chr11,26075430,26075447,IMR90|chr11:65217911-65218022,chr11,65217911,65218022,0,39142481
IMR90|chr11:26106681-26106728,chr11,26106681,26106728,IMR90|chr11:35164947-35165048,chr11,35164947,35165048,0,9058266
IMR90|chr11:26203737-26203781,chr11,26203737,26203781,IMR90|chr11:118790980-118791083,chr11,118790980,118791083,0,92587243
IMR90|chr11:26299971-26300081,chr11,26299971,26300081,IMR90|chr11:17098430-17098469,chr11,17098430,17098469,0,9201541
IMR90|chr11:26410050-26410076,chr11,26410050,26410076,IMR90|chr11:65155227-65155313,chr11,65155227,65155313,0,38745177
IMR90|chr11:26439315-26439359,chr11,26439315,26439359,IMR90|chr11:46614048-46614139,chr11,46614048,46614139,0,20174733
IMR90|chr11:26509635-26509679,chr11,26509635,26509679,IMR90|chr11:46303185-46303302,chr11,46303185,46303302,0,19793550
IMR90|chr11:26582239-26582323,chr11,26582239,26582323,IMR90|chr11:3399207-3399233,chr11,3399207,3399233,0,23183032
IMR90|chr11:26738636-26738705,chr11,26738636,26738705,IMR90|chr11:62496597-62496623,chr11,62496597,62496623,0,35757961
IMR90|chr11:26982063-26982124,chr11,26982063,26982124,IMR90|chr11:65082439-65082528,chr11,65082439,65082528,0,38100376
IMR90|chr11:27060714-27060781,chr11,27060714,27060781,IMR90|chr11:118779668-118779698,chr11,118779668,118779698,0,91718954
IMR90|chr11:27093161-27093258,chr11,27093161,27093258,IMR90|chr11:10878468-10878529,chr11,10878468,10878529,0,16214693
IMR90|chr11:27104540-27104629,chr11,27104540,27104629,IMR90|chr11:67206067-67206141,chr11,67206067,67206141,0,40101527
IMR90|chr11:27149405-27149472,chr11,27149405,27149472,IMR90|chr11:36531846-36531864,chr11,36531846,36531864,0,9382441
IMR90|chr11:27162875-27162931,chr11,27162875,27162931,IMR90|chr11:93475655-93475738,chr11,93475655,93475738,0,66312780
IMR90|chr11:27179969-27180074,chr11,27179969,27180074,IMR90|chr11:57090377-57090435,chr11,57090377,57090435,0,29910408
IMR90|chr11:27241214-27241250,chr11,27241214,27241250,IMR90|chr11:8700323-8700391,chr11,8700323,8700391,0,18540891
IMR90|chr11:27335693-27335728,chr11,27335693,27335728,IMR90|chr11:12136723-12136811,chr11,12136723,12136811,0,15198970
IMR90|chr11:27339135-27339184,chr11,27339135,27339184,IMR90|chr11:406539-406640,chr11,406539,406640,0,26932596
IMR90|chr11:27342534-27342622,chr11,27342534,27342622,IMR90|chr11:12030325-12030352,chr11,12030325,12030352,0,15312209
IMR90|chr11:27380363-27380413,chr11,27380363,27380413,IMR90|chr11:35550076-35550126,chr11,35550076,35550126,0,8169713
IMR90|chr11:27381614-27381696,chr11,27381614,27381696,IMR90|chr11:65310984-65311064,chr11,65310984,65311064,0,37929370
IMR90|chr11:27424098-27424234,chr11,27424098,27424234,IMR90|chr11:120208534-120208616,chr11,120208534,120208616,0,92784436
IMR90|chr11:27493521-27493566,chr11,27493521,27493566,IMR90|chr11:62538244-62538327,chr11,62538244,62538327,0,35044723
IMR90|chr11:27830222-27830279,chr11,27830222,27830279,IMR90|chr11:67007042-67007134,chr11,67007042,67007134,0,39176820
IMR90|chr11:27934953-27935079,chr11,27934953,27935079,IMR90|chr11:117199879-117199902,chr11,117199879,117199902,0,89264926
IMR90|chr11:27983678-27983781,chr11,27983678,27983781,IMR90|chr11:63607073-63607114,chr11,63607073,63607114,0,35623395
IMR90|chr11:28110406-28110444,chr11,28110406,28110444,IMR90|chr11:810468-810562,chr11,810468,810562,0,27299938
IMR90|chr11:28128205-28128305,chr11,28128205,28128305,IMR90|chr11:65100693-65100745,chr11,65100693,65100745,0,36972488
IMR90|chr11:28137233-28137325,chr11,28137233,28137325,IMR90|chr11:65156496-65156523,chr11,65156496,65156523,0,37019263
IMR90|chr11:28155720-28155786,chr11,28155720,28155786,IMR90|chr11:79151889-79151956,chr11,79151889,79151956,0,50996169
IMR90|chr11:28182994-28183048,chr11,28182994,28183048,IMR90|chr11:61351759-61351836,chr11,61351759,61351836,0,33168765
IMR90|chr11:28575653-28575700,chr11,28575653,28575700,IMR90|chr11:57547894-57547973,chr11,57547894,57547973,0,28972241
IMR90|chr11:28628843-28628897,chr11,28628843,28628897,IMR90|chr11:122937268-122937306,chr11,122937268,122937306,0,94308425
IMR90|chr11:28669718-28669833,chr11,28669718,28669833,IMR90|chr11:291357-291392,chr11,291357,291392,0,28378361
IMR90|chr11:28687336-28687404,chr11,28687336,28687404,IMR90|chr11:65217947-65218029,chr11,65217947,65218029,0,36530611
IMR90|chr11:28861605-28861716,chr11,28861605,28861716,IMR90|chr11:64692810-64692843,chr11,64692810,64692843,0,35831205
IMR90|chr11:28862394-28862544,chr11,28862394,28862544,IMR90|chr11:64691814-64691909,chr11,64691814,64691909,0,35829420
IMR90|chr11:28935758-28935832,chr11,28935758,28935832,IMR90|chr11:93478870-93478935,chr11,93478870,93478935,0,64543112
IMR90|chr11:28999482-28999577,chr11,28999482,28999577,IMR90|chr11:65345146-65345165,chr11,65345146,65345165,0,36345664
IMR90|chr11:29173883-29173953,chr11,29173883,29173953,IMR90|chr11:47619591-47619626,chr11,47619591,47619626,0,18445708
IMR90|chr11:29207929-29208047,chr11,29207929,29208047,IMR90|chr11:123064667-123064697,chr11,123064667,123064697,0,93856738
IMR90|chr11:29421275-29421347,chr11,29421275,29421347,IMR90|chr11:65406450-65406488,chr11,65406450,65406488,0,35985175
IMR90|chr11:29802284-29802335,chr11,29802284,29802335,IMR90|chr11:65665499-65665622,chr11,65665499,65665622,0,35863215
IMR90|chr11:29826233-29826276,chr11,29826233,29826276,IMR90|chr11:64944649-64944718,chr11,64944649,64944718,0,35118416
IMR90|chr11:29852899-29852973,chr11,29852899,29852973,IMR90|chr11:27912553-27912609,chr11,27912553,27912609,0,1940346
IMR90|chr11:29891582-29891668,chr11,29891582,29891668,IMR90|chr11:96073885-96073915,chr11,96073885,96073915,0,66182303
IMR90|chr11:30118876-30118984,chr11,30118876,30118984,IMR90|chr11:72432650-72432692,chr11,72432650,72432692,0,42313774
IMR90|chr11:30221707-30221764,chr11,30221707,30221764,IMR90|chr11:35548048-35548130,chr11,35548048,35548130,0,5326341
IMR90|chr11:30257331-30257358,chr11,30257331,30257358,IMR90|chr11:57532254-57532328,chr11,57532254,57532328,0,27274923
IMR90|chr11:30336458-30336484,chr11,30336458,30336484,IMR90|chr11:126222313-126222437,chr11,126222313,126222437,0,95885855
IMR90|chr11:30626008-30626062,chr11,30626008,30626062,IMR90|chr11:212049-212116,chr11,212049,212116,0,30413959
IMR90|chr11:30628390-30628468,chr11,30628390,30628468,IMR90|chr11:62494832-62494873,chr11,62494832,62494873,0,31866442
IMR90|chr11:30655561-30655589,chr11,30655561,30655589,IMR90|chr11:65637881-65637999,chr11,65637881,65637999,0,34982320
IMR90|chr11:30793834-30793923,chr11,30793834,30793923,IMR90|chr11:62304202-62304277,chr11,62304202,62304277,0,31510368
IMR90|chr11:30865776-30865922,chr11,30865776,30865922,IMR90|chr11:14382792-14382852,chr11,14382792,14382852,0,16482984
IMR90|chr11:30873270-30873359,chr11,30873270,30873359,IMR90|chr11:65664002-65664036,chr11,65664002,65664036,0,34790732
IMR90|chr11:30889926-30889956,chr11,30889926,30889956,IMR90|chr11:2399643-2399763,chr11,2399643,2399763,0,28490283
IMR90|chr11:31009806-31009869,chr11,31009806,31009869,IMR90|chr11:16761238-16761325,chr11,16761238,16761325,0,14248568
IMR90|chr11:31138597-31138650,chr11,31138597,31138650,IMR90|chr11:64105810-64105839,chr11,64105810,64105839,0,32967213
IMR90|chr11:31265653-31265686,chr11,31265653,31265686,IMR90|chr11:64886362-64886429,chr11,64886362,64886429,0,33620709
IMR90|chr11:31800000-31800049,chr11,31800000,31800049,IMR90|chr11:775131-775227,chr11,775131,775227,0,31024869
IMR90|chr11:31823711-31823743,chr11,31823711,31823743,IMR90|chr11:65342898-65342964,chr11,65342898,65342964,0,33519187
IMR90|chr11:31841717-31841781,chr11,31841717,31841781,IMR90|chr11:66026929-66026974,chr11,66026929,66026974,0,34185212
IMR90|chr11:31938668-31938776,chr11,31938668,31938776,IMR90|chr11:79149402-79149444,chr11,79149402,79149444,0,47210734
IMR90|chr11:31996655-31996675,chr11,31996655,31996675,IMR90|chr11:63934792-63934855,chr11,63934792,63934855,0,31938137
IMR90|chr11:32079485-32079534,chr11,32079485,32079534,IMR90|chr11:126222296-126222394,chr11,126222296,126222394,0,94142811
IMR90|chr11:32109019-32109058,chr11,32109019,32109058,IMR90|chr11:57547806-57547849,chr11,57547806,57547849,0,25438787
IMR90|chr11:32308075-32308115,chr11,32308075,32308115,IMR90|chr11:65345677-65345789,chr11,65345677,65345789,0,33037602
IMR90|chr11:32371557-32371576,chr11,32371557,32371576,IMR90|chr11:71937398-71937486,chr11,71937398,71937486,0,39565841
IMR90|chr11:32373418-32373498,chr11,32373418,32373498,IMR90|chr11:72520557-72520621,chr11,72520557,72520621,0,40147139
IMR90|chr11:32487676-32487720,chr11,32487676,32487720,IMR90|chr11:46303185-46303302,chr11,46303185,46303302,0,13815509
IMR90|chr11:32575698-32575731,chr11,32575698,32575731,IMR90|chr11:65082439-65082528,chr11,65082439,65082528,0,32506741
IMR90|chr11:32773653-32773713,chr11,32773653,32773713,IMR90|chr11:72433658-72433692,chr11,72433658,72433692,0,39660005
IMR90|chr11:32777122-32777180,chr11,32777122,32777180,IMR90|chr11:10878473-10878529,chr11,10878473,10878529,0,21898649
IMR90|chr11:33002503-33002555,chr11,33002503,33002555,IMR90|chr11:64945745-64945772,chr11,64945745,64945772,0,31943242
IMR90|chr11:33125471-33125557,chr11,33125471,33125557,IMR90|chr11:125461995-125462040,chr11,125461995,125462040,0,92336524
IMR90|chr11:33206971-33207051,chr11,33206971,33207051,IMR90|chr11:62494832-62494873,chr11,62494832,62494873,0,29287861
IMR90|chr11:33229843-33229924,chr11,33229843,33229924,IMR90|chr11:85779185-85779240,chr11,85779185,85779240,0,52549342
IMR90|chr11:33304477-33304569,chr11,33304477,33304569,IMR90|chr11:93470637-93470692,chr11,93470637,93470692,0,60166160
IMR90|chr11:33694254-33694369,chr11,33694254,33694369,IMR90|chr11:118661277-118661316,chr11,118661277,118661316,0,84967023
IMR90|chr11:33695363-33695455,chr11,33695363,33695455,IMR90|chr11:57090377-57090435,chr11,57090377,57090435,0,23395014
IMR90|chr11:33704329-33704387,chr11,33704329,33704387,IMR90|chr11:62311246-62311332,chr11,62311246,62311332,0,28606917
IMR90|chr11:33738274-33738318,chr11,33738274,33738318,IMR90|chr11:64905606-64905665,chr11,64905606,64905665,0,31167332
IMR90|chr11:33862389-33862508,chr11,33862389,33862508,IMR90|chr11:65157512-65157536,chr11,65157512,65157536,0,31295123
IMR90|chr11:33995875-33995914,chr11,33995875,33995914,IMR90|chr11:57529886-57529934,chr11,57529886,57529934,0,23534011
IMR90|chr11:33997015-33997063,chr11,33997015,33997063,IMR90|chr11:14376220-14376324,chr11,14376220,14376324,0,19620795
IMR90|chr11:34085706-34085769,chr11,34085706,34085769,IMR90|chr11:123063210-123063297,chr11,123063210,123063297,0,88977504
IMR90|chr11:34218358-34218427,chr11,34218358,34218427,IMR90|chr11:64886572-64886651,chr11,64886572,64886651,0,30668214
IMR90|chr11:34226591-34226634,chr11,34226591,34226634,IMR90|chr11:633992-634062,chr11,633992,634062,0,33592599
IMR90|chr11:34312188-34312230,chr11,34312188,34312230,IMR90|chr11:65665416-65665470,chr11,65665416,65665470,0,31353228
IMR90|chr11:34321914-34321972,chr11,34321914,34321972,IMR90|chr11:96122495-96122544,chr11,96122495,96122544,0,61800581
IMR90|chr11:34358744-34358820,chr11,34358744,34358820,IMR90|chr11:64944513-64944587,chr11,64944513,64944587,0,30585769
IMR90|chr11:34387085-34387182,chr11,34387085,34387182,IMR90|chr11:85779038-85779091,chr11,85779038,85779091,0,51391953
IMR90|chr11:34412785-34412846,chr11,34412785,34412846,IMR90|chr11:74695323-74695356,chr11,74695323,74695356,0,40282538
IMR90|chr11:34610823-34610871,chr11,34610823,34610871,IMR90|chr11:67798762-67798797,chr11,67798762,67798797,0,33187939
IMR90|chr11:34649572-34649629,chr11,34649572,34649629,IMR90|chr11:35548158-35548245,chr11,35548158,35548245,0,898586
IMR90|chr11:34666336-34666376,chr11,34666336,34666376,IMR90|chr11:93472013-93472119,chr11,93472013,93472119,0,58805677
IMR90|chr11:34696213-34696288,chr11,34696213,34696288,IMR90|chr11:65288555-65288630,chr11,65288555,65288630,0,30592342
IMR90|chr11:34803262-34803380,chr11,34803262,34803380,IMR90|chr11:123064667-123064697,chr11,123064667,123064697,0,88261405
IMR90|chr11:34850858-34850947,chr11,34850858,34850947,IMR90|chr11:93471936-93471997,chr11,93471936,93471997,0,58621078
IMR90|chr11:35138212-35138260,chr11,35138212,35138260,IMR90|chr11:12132502-12132572,chr11,12132502,12132572,0,23005710
IMR90|chr11:35145333-35145421,chr11,35145333,35145421,IMR90|chr11:96122495-96122535,chr11,96122495,96122535,0,60977162
IMR90|chr11:35318360-35318404,chr11,35318360,35318404,IMR90|chr11:67809675-67809795,chr11,67809675,67809795,0,32491315
IMR90|chr11:35354019-35354048,chr11,35354019,35354048,IMR90|chr11:46302529-46302650,chr11,46302529,46302650,0,10948510
IMR90|chr11:35379895-35379994,chr11,35379895,35379994,IMR90|chr11:69458854-69458890,chr11,69458854,69458890,0,34078959
IMR90|chr11:35413172-35413269,chr11,35413172,35413269,IMR90|chr11:13488009-13488062,chr11,13488009,13488062,0,21925163
IMR90|chr11:35457233-35457311,chr11,35457233,35457311,IMR90|chr11:65288481-65288510,chr11,65288481,65288510,0,29831248
IMR90|chr11:35477237-35477304,chr11,35477237,35477304,IMR90|chr11:117050785-117050897,chr11,117050785,117050897,0,81573548
IMR90|chr11:35532497-35532573,chr11,35532497,35532573,IMR90|chr11:66053727-66053776,chr11,66053727,66053776,0,30521230
IMR90|chr11:35571205-35571257,chr11,35571205,35571257,IMR90|chr11:834829-834887,chr11,834829,834887,0,34736376
IMR90|chr11:35594821-35594868,chr11,35594821,35594868,IMR90|chr11:117016803-117016826,chr11,117016803,117016826,0,81421982
IMR90|chr11:35618691-35618738,chr11,35618691,35618738,IMR90|chr11:93478272-93478417,chr11,93478272,93478417,0,57859581
IMR90|chr11:35637222-35637258,chr11,35637222,35637258,IMR90|chr11:27720581-27720655,chr11,27720581,27720655,0,7916641
IMR90|chr11:35733434-35733519,chr11,35733434,35733519,IMR90|chr11:60611631-60611745,chr11,60611631,60611745,0,24878197
IMR90|chr11:35882775-35882793,chr11,35882775,35882793,IMR90|chr11:65665007-65665115,chr11,65665007,65665115,0,29782232
IMR90|chr11:35904467-35904520,chr11,35904467,35904520,IMR90|chr11:70054648-70054744,chr11,70054648,70054744,0,34150181
IMR90|chr11:36166820-36166918,chr11,36166820,36166918,IMR90|chr11:65100693-65100745,chr11,65100693,65100745,0,28933873
IMR90|chr11:36343391-36343414,chr11,36343391,36343414,IMR90|chr11:65666583-65666710,chr11,65666583,65666710,0,29323192
IMR90|chr11:36352673-36352736,chr11,36352673,36352736,IMR90|chr11:123063210-123063297,chr11,123063210,123063297,0,86710537
IMR90|chr11:36467625-36467678,chr11,36467625,36467678,IMR90|chr11:844145-844259,chr11,844145,844259,0,35623480
IMR90|chr11:36565329-36565362,chr11,36565329,36565362,IMR90|chr11:67810345-67810419,chr11,67810345,67810419,0,31245016
IMR90|chr11:36676859-36676944,chr11,36676859,36676944,IMR90|chr11:65158152-65158203,chr11,65158152,65158203,0,28481293
IMR90|chr11:36966749-36966808,chr11,36966749,36966808,IMR90|chr11:291632-291713,chr11,291632,291713,0,36675117
IMR90|chr11:36986174-36986216,chr11,36986174,36986216,IMR90|chr11:47194655-47194693,chr11,47194655,47194693,0,10208481
IMR90|chr11:37056534-37056567,chr11,37056534,37056567,IMR90|chr11:93467188-93467257,chr11,93467188,93467257,0,56410654
IMR90|chr11:37229750-37229816,chr11,37229750,37229816,IMR90|chr11:65666488-65666572,chr11,65666488,65666572,0,28436738
IMR90|chr11:37272428-37272543,chr11,37272428,37272543,IMR90|chr11:93472893-93472928,chr11,93472893,93472928,0,56200465
IMR90|chr11:37370566-37370618,chr11,37370566,37370618,IMR90|chr11:72437455-72437485,chr11,72437455,72437485,0,35066889
IMR90|chr11:37402613-37402708,chr11,37402613,37402708,IMR90|chr11:65345146-65345165,chr11,65345146,65345165,0,27942533
IMR90|chr11:37412446-37412472,chr11,37412446,37412472,IMR90|chr11:823252-823351,chr11,823252,823351,0,36589194
IMR90|chr11:37538575-37538593,chr11,37538575,37538593,IMR90|chr11:65665007-65665115,chr11,65665007,65665115,0,28126432
IMR90|chr11:37580802-37580856,chr11,37580802,37580856,IMR90|chr11:66609771-66609829,chr11,66609771,66609829,0,29028969
IMR90|chr11:37636590-37636657,chr11,37636590,37636657,IMR90|chr11:62496597-62496623,chr11,62496597,62496623,0,24860007
IMR90|chr11:37671904-37671968,chr11,37671904,37671968,IMR90|chr11:65158146-65158169,chr11,65158146,65158169,0,27486242
IMR90|chr11:37755476-37755557,chr11,37755476,37755557,IMR90|chr11:67138513-67138547,chr11,67138513,67138547,0,29383037
IMR90|chr11:37887848-37887889,chr11,37887848,37887889,IMR90|chr11:821989-822085,chr11,821989,822085,0,37065859
IMR90|chr11:38019928-38019993,chr11,38019928,38019993,IMR90|chr11:66055004-66055078,chr11,66055004,66055078,0,28035076
IMR90|chr11:38153132-38153258,chr11,38153132,38153258,IMR90|chr11:65344422-65344442,chr11,65344422,65344442,0,27191290
IMR90|chr11:38251383-38251415,chr11,38251383,38251415,IMR90|chr11:65684205-65684323,chr11,65684205,65684323,0,27432822
IMR90|chr11:38256807-38256894,chr11,38256807,38256894,IMR90|chr11:65343946-65343962,chr11,65343946,65343962,0,27087139
IMR90|chr11:38363416-38363461,chr11,38363416,38363461,IMR90|chr11:65220459-65220551,chr11,65220459,65220551,0,26857043
IMR90|chr11:38369897-38370014,chr11,38369897,38370014,IMR90|chr11:70050244-70050284,chr11,70050244,70050284,0,31680347
IMR90|chr11:38427340-38427360,chr11,38427340,38427360,IMR90|chr11:12028718-12028786,chr11,12028718,12028786,0,26398622
IMR90|chr11:38429284-38429332,chr11,38429284,38429332,IMR90|chr11:74695683-74695740,chr11,74695683,74695740,0,36266399
IMR90|chr11:38743290-38743358,chr11,38743290,38743358,IMR90|chr11:66610194-66610273,chr11,66610194,66610273,0,27866904
IMR90|chr11:38962009-38962086,chr11,38962009,38962086,IMR90|chr11:57508696-57508737,chr11,57508696,57508737,0,18546687
IMR90|chr11:39088147-39088209,chr11,39088147,39088209,IMR90|chr11:65665959-65666047,chr11,65665959,65666047,0,26577812
IMR90|chr11:39241144-39241208,chr11,39241144,39241208,IMR90|chr11:102218645-102218708,chr11,102218645,102218708,0,62977501
IMR90|chr11:39295032-39295080,chr11,39295032,39295080,IMR90|chr11:1782392-1782494,chr11,1782392,1782494,0,37512640
IMR90|chr11:39322204-39322263,chr11,39322204,39322263,IMR90|chr11:74695323-74695356,chr11,74695323,74695356,0,35373119
IMR90|chr11:39591849-39591957,chr11,39591849,39591957,IMR90|chr11:72432650-72432692,chr11,72432650,72432692,0,32840801
IMR90|chr11:39621661-39621702,chr11,39621661,39621702,IMR90|chr11:821989-822085,chr11,821989,822085,0,38799672
IMR90|chr11:39630580-39630614,chr11,39630580,39630614,IMR90|chr11:65683775-65683819,chr11,65683775,65683819,0,26053195
IMR90|chr11:39651567-39651597,chr11,39651567,39651597,IMR90|chr11:775175-775228,chr11,775175,775228,0,38876392
IMR90|chr11:39855634-39855743,chr11,39855634,39855743,IMR90|chr11:93474300-93474341,chr11,93474300,93474341,0,53618666
IMR90|chr11:39916898-39917017,chr11,39916898,39917017,IMR90|chr11:93473399-93473424,chr11,93473399,93473424,0,53556501
IMR90|chr11:39964131-39964186,chr11,39964131,39964186,IMR90|chr11:93467543-93467595,chr11,93467543,93467595,0,53503412
IMR90|chr11:39965005-39965054,chr11,39965005,39965054,IMR90|chr11:6501900-6501953,chr11,6501900,6501953,0,33463105
IMR90|chr11:40014534-40014622,chr11,40014534,40014622,IMR90|chr11:846431-846482,chr11,846431,846482,0,39168103
IMR90|chr11:40160130-40160234,chr11,40160130,40160234,IMR90|chr11:211639-211685,chr11,211639,211685,0,39948491
IMR90|chr11:40200299-40200333,chr11,40200299,40200333,IMR90|chr11:118981051-118981126,chr11,118981051,118981126,0,78780752
IMR90|chr11:40272278-40272365,chr11,40272278,40272365,IMR90|chr11:34124818-34124880,chr11,34124818,34124880,0,6147460
IMR90|chr11:40365533-40365564,chr11,40365533,40365564,IMR90|chr11:65219633-65219752,chr11,65219633,65219752,0,24854100
IMR90|chr11:40396500-40396535,chr11,40396500,40396535,IMR90|chr11:65082439-65082528,chr11,65082439,65082528,0,24685939
IMR90|chr11:40414305-40414413,chr11,40414305,40414413,IMR90|chr11:35550076-35550126,chr11,35550076,35550126,0,4864229
IMR90|chr11:40416101-40416156,chr11,40416101,40416156,IMR90|chr11:27721420-27721485,chr11,27721420,27721485,0,12694681
IMR90|chr11:40538945-40538983,chr11,40538945,40538983,IMR90|chr11:810468-810562,chr11,810468,810562,0,39728477
IMR90|chr11:40574683-40574759,chr11,40574683,40574759,IMR90|chr11:72520557-72520621,chr11,72520557,72520621,0,31945874
IMR90|chr11:40576707-40576788,chr11,40576707,40576788,IMR90|chr11:3397448-3397508,chr11,3397448,3397508,0,37179259
IMR90|chr11:40609594-40609644,chr11,40609594,40609644,IMR90|chr11:16760706-16760759,chr11,16760706,16760759,0,23848888
IMR90|chr11:40610121-40610156,chr11,40610121,40610156,IMR90|chr11:57531875-57531979,chr11,57531875,57531979,0,16921754
IMR90|chr11:40671606-40671671,chr11,40671606,40671671,IMR90|chr11:65664632-65664699,chr11,65664632,65664699,0,24993026
IMR90|chr11:40691397-40691428,chr11,40691397,40691428,IMR90|chr11:65032977-65033096,chr11,65032977,65033096,0,24341580
IMR90|chr11:40776763-40776882,chr11,40776763,40776882,IMR90|chr11:65157512-65157536,chr11,65157512,65157536,0,24380749
IMR90|chr11:40841725-40841812,chr11,40841725,40841812,IMR90|chr11:65343946-65343962,chr11,65343946,65343962,0,24502221
IMR90|chr11:40864498-40864636,chr11,40864498,40864636,IMR90|chr11:120210021-120210060,chr11,120210021,120210060,0,79345523
IMR90|chr11:40950495-40950610,chr11,40950495,40950610,IMR90|chr11:126224095-126224130,chr11,126224095,126224130,0,85273600
IMR90|chr11:40967866-40967992,chr11,40967866,40967992,IMR90|chr11:65344422-65344442,chr11,65344422,65344442,0,24376556
IMR90|chr11:40999076-40999129,chr11,40999076,40999129,IMR90|chr11:844145-844259,chr11,844145,844259,0,40154931
IMR90|chr11:41022695-41022840,chr11,41022695,41022840,IMR90|chr11:70054802-70054901,chr11,70054802,70054901,0,29032107
IMR90|chr11:41273623-41273666,chr11,41273623,41273666,IMR90|chr11:12133870-12133972,chr11,12133870,12133972,0,29139753
IMR90|chr11:41341665-41341708,chr11,41341665,41341708,IMR90|chr11:707541-707642,chr11,707541,707642,0,40634124
IMR90|chr11:41410385-41410521,chr11,41410385,41410521,IMR90|chr11:120208534-120208616,chr11,120208534,120208616,0,78798149
IMR90|chr11:41506719-41506863,chr11,41506719,41506863,IMR90|chr11:70054802-70054901,chr11,70054802,70054901,0,28548083
IMR90|chr11:41564543-41564633,chr11,41564543,41564633,IMR90|chr11:65217947-65218029,chr11,65217947,65218029,0,23653404
IMR90|chr11:41569165-41569252,chr11,41569165,41569252,IMR90|chr11:120208142-120208165,chr11,120208142,120208165,0,78638977
IMR90|chr11:41616579-41616662,chr11,41616579,41616662,IMR90|chr11:35548097-35548124,chr11,35548097,35548124,0,6068482
IMR90|chr11:41691828-41691888,chr11,41691828,41691888,IMR90|chr11:85779163-85779223,chr11,85779163,85779223,0,44087335
IMR90|chr11:41701977-41702030,chr11,41701977,41702030,IMR90|chr11:57546153-57546250,chr11,57546153,57546250,0,15844176
IMR90|chr11:41771277-41771349,chr11,41771277,41771349,IMR90|chr11:93472013-93472119,chr11,93472013,93472119,0,51700736
IMR90|chr11:41785915-41786039,chr11,41785915,41786039,IMR90|chr11:1891017-1891038,chr11,1891017,1891038,0,39894898
IMR90|chr11:41830077-41830110,chr11,41830077,41830110,IMR90|chr11:93467188-93467257,chr11,93467188,93467257,0,51637111
IMR90|chr11:41949792-41949845,chr11,41949792,41949845,IMR90|chr11:128388071-128388119,chr11,128388071,128388119,0,86438279
IMR90|chr11:42159147-42159252,chr11,42159147,42159252,IMR90|chr11:57546803-57546844,chr11,57546803,57546844,0,15387656
IMR90|chr11:42399315-42399362,chr11,42399315,42399362,IMR90|chr11:93478272-93478417,chr11,93478272,93478417,0,51078957
IMR90|chr11:42480656-42480683,chr11,42480656,42480683,IMR90|chr11:77899267-77899343,chr11,77899267,77899343,0,35418611
IMR90|chr11:42487697-42487749,chr11,42487697,42487749,IMR90|chr11:35548148-35548237,chr11,35548148,35548237,0,6939549
IMR90|chr11:42510406-42510495,chr11,42510406,42510495,IMR90|chr11:62304202-62304277,chr11,62304202,62304277,0,19793796
IMR90|chr11:42575386-42575430,chr11,42575386,42575430,IMR90|chr11:122937216-122937319,chr11,122937216,122937319,0,80361830
IMR90|chr11:42593075-42593118,chr11,42593075,42593118,IMR90|chr11:57530091-57530144,chr11,57530091,57530144,0,14937016
IMR90|chr11:42609376-42609445,chr11,42609376,42609445,IMR90|chr11:64886572-64886651,chr11,64886572,64886651,0,22277196
IMR90|chr11:42727835-42727882,chr11,42727835,42727882,IMR90|chr11:64945745-64945772,chr11,64945745,64945772,0,22217910
IMR90|chr11:42731542-42731610,chr11,42731542,42731610,IMR90|chr11:66610194-66610273,chr11,66610194,66610273,0,23878652
IMR90|chr11:42735907-42736021,chr11,42735907,42736021,IMR90|chr11:62311374-62311408,chr11,62311374,62311408,0,19575467
IMR90|chr11:42764319-42764399,chr11,42764319,42764399,IMR90|chr11:65321510-65321532,chr11,65321510,65321532,0,22557191
IMR90|chr11:42850997-42851016,chr11,42850997,42851016,IMR90|chr11:12698840-12698931,chr11,12698840,12698931,0,30152157
IMR90|chr11:42932490-42932538,chr11,42932490,42932538,IMR90|chr11:65666583-65666710,chr11,65666583,65666710,0,22734093
IMR90|chr11:42982787-42982861,chr11,42982787,42982861,IMR90|chr11:120208360-120208393,chr11,120208360,120208393,0,77225573
IMR90|chr11:43025341-43025405,chr11,43025341,43025405,IMR90|chr11:66026929-66026974,chr11,66026929,66026974,0,23001588
IMR90|chr11:43095856-43095915,chr11,43095856,43095915,IMR90|chr11:13483943-13483996,chr11,13483943,13483996,0,29611913
IMR90|chr11:43383103-43383163,chr11,43383103,43383163,IMR90|chr11:12027864-12027978,chr11,12027864,12027978,0,31355239
IMR90|chr11:43574033-43574096,chr11,43574033,43574096,IMR90|chr11:64886695-64886765,chr11,64886695,64886765,0,21312662
IMR90|chr11:43575435-43575513,chr11,43575435,43575513,IMR90|chr11:65330650-65330722,chr11,65330650,65330722,0,21755215
IMR90|chr11:43617374-43617426,chr11,43617374,43617426,IMR90|chr11:65407764-65407853,chr11,65407764,65407853,0,21790390
IMR90|chr11:43678689-43678773,chr11,43678689,43678773,IMR90|chr11:12111718-12111759,chr11,12111718,12111759,0,31566971
IMR90|chr11:43700894-43700989,chr11,43700894,43700989,IMR90|chr11:709151-709199,chr11,709151,709199,0,42991743
IMR90|chr11:43768317-43768410,chr11,43768317,43768410,IMR90|chr11:64853573-64853607,chr11,64853573,64853607,0,21085256
IMR90|chr11:43772084-43772164,chr11,43772084,43772164,IMR90|chr11:66513908-66513972,chr11,66513908,66513972,0,22741824
IMR90|chr11:43945606-43945666,chr11,43945606,43945666,IMR90|chr11:85779163-85779223,chr11,85779163,85779223,0,41833557
IMR90|chr11:43951962-43952050,chr11,43951962,43952050,IMR90|chr11:34124818-34124880,chr11,34124818,34124880,0,9827144
IMR90|chr11:43972748-43972816,chr11,43972748,43972816,IMR90|chr11:79150527-79150572,chr11,79150527,79150572,0,35177779
IMR90|chr11:44001072-44001124,chr11,44001072,44001124,IMR90|chr11:72437455-72437485,chr11,72437455,72437485,0,28436383
IMR90|chr11:44016550-44016581,chr11,44016550,44016581,IMR90|chr11:64886362-64886429,chr11,64886362,64886429,0,20869812
IMR90|chr11:44048237-44048381,chr11,44048237,44048381,IMR90|chr11:93474276-93474390,chr11,93474276,93474390,0,49426039
IMR90|chr11:44170291-44170343,chr11,44170291,44170343,IMR90|chr11:65407764-65407853,chr11,65407764,65407853,0,21237473
IMR90|chr11:44605906-44605993,chr11,44605906,44605993,IMR90|chr11:126224854-126224978,chr11,126224854,126224978,0,81618948
IMR90|chr11:44655144-44655208,chr11,44655144,44655208,IMR90|chr11:12135501-12135612,chr11,12135501,12135612,0,32519643
IMR90|chr11:44739183-44739269,chr11,44739183,44739269,IMR90|chr11:65308303-65308323,chr11,65308303,65308323,0,20569120
IMR90|chr11:44927662-44927692,chr11,44927662,44927692,IMR90|chr11:2399643-2399763,chr11,2399643,2399763,0,42528019
IMR90|chr11:44979355-44979417,chr11,44979355,44979417,IMR90|chr11:2403627-2403715,chr11,2403627,2403715,0,42575728
IMR90|chr11:45181327-45181414,chr11,45181327,45181414,IMR90|chr11:14376327-14376384,chr11,14376327,14376384,0,30805000
IMR90|chr11:45295520-45295618,chr11,45295520,45295618,IMR90|chr11:65152412-65152444,chr11,65152412,65152444,0,19856892
IMR90|chr11:45368002-45368057,chr11,45368002,45368057,IMR90|chr11:64691814-64691909,chr11,64691814,64691909,0,19323812
IMR90|chr11:45440521-45440613,chr11,45440521,45440613,IMR90|chr11:6627485-6627514,chr11,6627485,6627514,0,38813036
IMR90|chr11:45864088-45864121,chr11,45864088,45864121,IMR90|chr11:64020065-64020149,chr11,64020065,64020149,0,18155977
IMR90|chr11:45876813-45876861,chr11,45876813,45876861,IMR90|chr11:67139054-67139132,chr11,67139054,67139132,0,21262241
IMR90|chr11:46038406-46038431,chr11,46038406,46038431,IMR90|chr11:65031589-65031665,chr11,65031589,65031665,0,18993183
IMR90|chr11:46280025-46280061,chr11,46280025,46280061,IMR90|chr11:65033219-65033332,chr11,65033219,65033332,0,18753194
IMR90|chr11:46335507-46335533,chr11,46335507,46335533,IMR90|chr11:65217978-65218095,chr11,65217978,65218095,0,18882471
IMR90|chr11:46381563-46381602,chr11,46381563,46381602,IMR90|chr11:12135501-12135612,chr11,12135501,12135612,0,34246062
IMR90|chr11:46418041-46418105,chr11,46418041,46418105,IMR90|chr11:65664631-65664692,chr11,65664631,65664692,0,19246590
IMR90|chr11:46429219-46429276,chr11,46429219,46429276,IMR90|chr11:12134412-12134496,chr11,12134412,12134496,0,34294807
IMR90|chr11:46531343-46531413,chr11,46531343,46531413,IMR90|chr11:93474278-93474385,chr11,93474278,93474385,0,46942935
IMR90|chr11:46642621-46642703,chr11,46642621,46642703,IMR90|chr11:130764333-130764366,chr11,130764333,130764366,0,84121712
IMR90|chr11:46717798-46717948,chr11,46717798,46717948,IMR90|chr11:69456904-69456928,chr11,69456904,69456928,0,22739106
IMR90|chr11:46769563-46769630,chr11,46769563,46769630,IMR90|chr11:122937216-122937319,chr11,122937216,122937319,0,76167653
IMR90|chr11:46865226-46865352,chr11,46865226,46865352,IMR90|chr11:69456904-69456928,chr11,69456904,69456928,0,22591678
IMR90|chr11:46875419-46875462,chr11,46875419,46875462,IMR90|chr11:12028946-12029016,chr11,12028946,12029016,0,34846473
IMR90|chr11:46934582-46934656,chr11,46934582,46934656,IMR90|chr11:118952716-118952760,chr11,118952716,118952760,0,72018134
IMR90|chr11:47193985-47194047,chr11,47193985,47194047,IMR90|chr11:46613883-46613933,chr11,46613883,46613933,0,580102
IMR90|chr11:47332759-47332906,chr11,47332759,47332906,IMR90|chr11:122931749-122931791,chr11,122931749,122931791,0,75598990
IMR90|chr11:47344825-47344913,chr11,47344825,47344913,IMR90|chr11:65221411-65221520,chr11,65221411,65221520,0,17876586
IMR90|chr11:47470419-47470457,chr11,47470419,47470457,IMR90|chr11:65097078-65097159,chr11,65097078,65097159,0,17626659
IMR90|chr11:47506323-47506407,chr11,47506323,47506407,IMR90|chr11:8704873-8704939,chr11,8704873,8704939,0,38801450
IMR90|chr11:47680578-47680595,chr11,47680578,47680595,IMR90|chr11:65217911-65218022,chr11,65217911,65218022,0,17537333
IMR90|chr11:47906365-47906433,chr11,47906365,47906433,IMR90|chr11:120208534-120208616,chr11,120208534,120208616,0,72302169
IMR90|chr11:47978051-47978082,chr11,47978051,47978082,IMR90|chr11:62493807-62493884,chr11,62493807,62493884,0,14515756
IMR90|chr11:48200756-48200775,chr11,48200756,48200775,IMR90|chr11:71937398-71937486,chr11,71937398,71937486,0,23736642
IMR90|chr11:48201485-48201560,chr11,48201485,48201560,IMR90|chr11:65156526-65156580,chr11,65156526,65156580,0,16955041
IMR90|chr11:48241037-48241101,chr11,48241037,48241101,IMR90|chr11:65310984-65311064,chr11,65310984,65311064,0,17069947
IMR90|chr11:48269624-48269689,chr11,48269624,48269689,IMR90|chr11:126081857-126081934,chr11,126081857,126081934,0,77812233
IMR90|chr11:48279800-48279820,chr11,48279800,48279820,IMR90|chr11:847700-847850,chr11,847700,847850,0,47432100
IMR90|chr11:48356823-48356896,chr11,48356823,48356896,IMR90|chr11:810857-810884,chr11,810857,810884,0,47545966
IMR90|chr11:48413897-48414011,chr11,48413897,48414011,IMR90|chr11:65839232-65839252,chr11,65839232,65839252,0,17425335
IMR90|chr11:48428889-48428979,chr11,48428889,48428979,IMR90|chr11:35551001-35551079,chr11,35551001,35551079,0,12877888
IMR90|chr11:48455738-48455788,chr11,48455738,48455788,IMR90|chr11:79148089-79148181,chr11,79148089,79148181,0,30692351
IMR90|chr11:48472153-48472196,chr11,48472153,48472196,IMR90|chr11:46614048-46614139,chr11,46614048,46614139,0,1858105
IMR90|chr11:48541933-48542009,chr11,48541933,48542009,IMR90|chr11:120208142-120208165,chr11,120208142,120208165,0,71666209
IMR90|chr11:48587045-48587117,chr11,48587045,48587117,IMR90|chr11:35551001-35551079,chr11,35551001,35551079,0,13036044
IMR90|chr11:48673586-48673647,chr11,48673586,48673647,IMR90|chr11:65664544-65664595,chr11,65664544,65664595,0,16990958
IMR90|chr11:48680135-48680168,chr11,48680135,48680168,IMR90|chr11:34125794-34125868,chr11,34125794,34125868,0,14554341
IMR90|chr11:48705455-48705524,chr11,48705455,48705524,IMR90|chr11:66610194-66610273,chr11,66610194,66610273,0,17904739
IMR90|chr11:48757647-48757710,chr11,48757647,48757710,IMR90|chr11:62304202-62304277,chr11,62304202,62304277,0,13546555
IMR90|chr11:48866425-48866449,chr11,48866425,48866449,IMR90|chr11:126224854-126225004,chr11,126224854,126225004,0,77358429
IMR90|chr11:48882217-48882253,chr11,48882217,48882253,IMR90|chr11:8711788-8711854,chr11,8711788,8711854,0,40170429
IMR90|chr11:48907776-48907837,chr11,48907776,48907837,IMR90|chr11:65664544-65664595,chr11,65664544,65664595,0,16756768
IMR90|chr11:48929937-48929975,chr11,48929937,48929975,IMR90|chr11:70962007-70962117,chr11,70962007,70962117,0,22032070
IMR90|chr11:48954954-48955030,chr11,48954954,48955030,IMR90|chr11:64944513-64944587,chr11,64944513,64944587,0,15989559
IMR90|chr11:49005133-49005162,chr11,49005133,49005162,IMR90|chr11:46303185-46303302,chr11,46303185,46303302,0,2701948
IMR90|chr11:49050733-49050810,chr11,49050733,49050810,IMR90|chr11:65221436-65221509,chr11,65221436,65221509,0,16170703
IMR90|chr11:49052534-49052575,chr11,49052534,49052575,IMR90|chr11:64110401-64110457,chr11,64110401,64110457,0,15057867
IMR90|chr11:49156844-49156872,chr11,49156844,49156872,IMR90|chr11:118888196-118888318,chr11,118888196,118888318,0,69731352
IMR90|chr11:49184022-49184083,chr11,49184022,49184083,IMR90|chr11:64847567-64847644,chr11,64847567,64847644,0,15663545
IMR90|chr11:49228316-49228409,chr11,49228316,49228409,IMR90|chr11:79149829-79149861,chr11,79149829,79149861,0,29921513
IMR90|chr11:49244980-49245008,chr11,49244980,49245008,IMR90|chr11:65656917-65657013,chr11,65656917,65657013,0,16411937
IMR90|chr11:49339845-49339882,chr11,49339845,49339882,IMR90|chr11:8699020-8699128,chr11,8699020,8699128,0,40640825
IMR90|chr11:49343924-49344011,chr11,49343924,49344011,IMR90|chr11:65099308-65099372,chr11,65099308,65099372,0,15755384
IMR90|chr11:49468301-49468358,chr11,49468301,49468358,IMR90|chr11:12136898-12136993,chr11,12136898,12136993,0,37331403
IMR90|chr11:49559508-49559548,chr11,49559508,49559548,IMR90|chr11:34127071-34127139,chr11,34127071,34127139,0,15432437
IMR90|chr11:49567588-49567635,chr11,49567588,49567635,IMR90|chr11:10878692-10878728,chr11,10878692,10878728,0,38688896
IMR90|chr11:49634950-49634968,chr11,49634950,49634968,IMR90|chr11:93469807-93469869,chr11,93469807,93469869,0,43834857
IMR90|chr11:49775088-49775154,chr11,49775088,49775154,IMR90|chr11:291445-291522,chr11,291445,291522,0,49483643
IMR90|chr11:49793022-49793062,chr11,49793022,49793062,IMR90|chr11:62308729-62308838,chr11,62308729,62308838,0,12515707
IMR90|chr11:49803931-49803981,chr11,49803931,49803981,IMR90|chr11:70054802-70054901,chr11,70054802,70054901,0,20250871
IMR90|chr11:49824330-49824393,chr11,49824330,49824393,IMR90|chr11:65663635-65663705,chr11,65663635,65663705,0,15839305
IMR90|chr11:49824915-49824943,chr11,49824915,49824943,IMR90|chr11:102218645-102218708,chr11,102218645,102218708,0,52393730
IMR90|chr11:49853829-49853913,chr11,49853829,49853913,IMR90|chr11:62325322-62325388,chr11,62325322,62325388,0,12471493
IMR90|chr11:49856244-49856304,chr11,49856244,49856304,IMR90|chr11:13483943-13483996,chr11,13483943,13483996,0,36372301
IMR90|chr11:49864854-49864923,chr11,49864854,49864923,IMR90|chr11:108094197-108094236,chr11,108094197,108094236,0,58229343
IMR90|chr11:50106061-50106085,chr11,50106061,50106085,IMR90|chr11:808403-808520,chr11,808403,808520,0,49297658
IMR90|chr11:50112001-50112121,chr11,50112001,50112121,IMR90|chr11:65157512-65157536,chr11,65157512,65157536,0,15045511
IMR90|chr11:50325213-50325256,chr11,50325213,50325256,IMR90|chr11:35551026-35551113,chr11,35551026,35551113,0,14774187
IMR90|chr11:50326443-50326517,chr11,50326443,50326517,IMR90|chr11:65098892-65098918,chr11,65098892,65098918,0,14772449
IMR90|chr11:50435060-50435155,chr11,50435060,50435155,IMR90|chr11:57548937-57548983,chr11,57548937,57548983,0,7113877
IMR90|chr11:50443430-50443489,chr11,50443430,50443489,IMR90|chr11:12132680-12132750,chr11,12132680,12132750,0,38310750
IMR90|chr11:50510674-50510743,chr11,50510674,50510743,IMR90|chr11:75276568-75276634,chr11,75276568,75276634,0,24765894
IMR90|chr11:50673890-50673963,chr11,50673890,50673963,IMR90|chr11:117016722-117016774,chr11,117016722,117016774,0,66342832
IMR90|chr11:50721357-50721441,chr11,50721357,50721441,IMR90|chr11:57091369-57091433,chr11,57091369,57091433,0,6370012
IMR90|chr11:50725378-50725478,chr11,50725378,50725478,IMR90|chr11:65100693-65100745,chr11,65100693,65100745,0,14375315
IMR90|chr11:51125536-51125615,chr11,51125536,51125615,IMR90|chr11:18547863-18547934,chr11,18547863,18547934,0,32577673
IMR90|chr11:51143940-51143963,chr11,51143940,51143963,IMR90|chr11:65666583-65666710,chr11,65666583,65666710,0,14522643
IMR90|chr11:51181769-51181863,chr11,51181769,51181863,IMR90|chr11:72462455-72462492,chr11,72462455,72462492,0,21280686
IMR90|chr11:51288901-51288959,chr11,51288901,51288959,IMR90|chr11:10318153-10318229,chr11,10318153,10318229,0,40970748
IMR90|chr11:51427850-51427889,chr11,51427850,51427889,IMR90|chr11:57547806-57547849,chr11,57547806,57547849,0,6119956
IMR90|chr11:51477255-51477342,chr11,51477255,51477342,IMR90|chr11:120208142-120208165,chr11,120208142,120208165,0,68730887
IMR90|chr11:51530126-51530230,chr11,51530126,51530230,IMR90|chr11:779257-779371,chr11,779257,779371,0,50750869
IMR90|chr11:51532989-51533116,chr11,51532989,51533116,IMR90|chr11:14378383-14378477,chr11,14378383,14378477,0,37154606
IMR90|chr11:51588607-51588719,chr11,51588607,51588719,IMR90|chr11:65664574-65664628,chr11,65664574,65664628,0,14075967
IMR90|chr11:51611022-51611047,chr11,51611022,51611047,IMR90|chr11:823252-823351,chr11,823252,823351,0,50787770
IMR90|chr11:51714551-51714681,chr11,51714551,51714681,IMR90|chr11:65030176-65030196,chr11,65030176,65030196,0,13315625
IMR90|chr11:51908308-51908359,chr11,51908308,51908359,IMR90|chr11:102218099-102218194,chr11,102218099,102218194,0,50309791
IMR90|chr11:51961842-51961892,chr11,51961842,51961892,IMR90|chr11:65667459-65667520,chr11,65667459,65667520,0,13705617
IMR90|chr11:52045353-52045370,chr11,52045353,52045370,IMR90|chr11:57548441-57548562,chr11,57548441,57548562,0,5503088
IMR90|chr11:52055216-52055249,chr11,52055216,52055249,IMR90|chr11:93467033-93467086,chr11,93467033,93467086,0,41411817
IMR90|chr11:52056857-52056889,chr11,52056857,52056889,IMR90|chr11:12027864-12027978,chr11,12027864,12027978,0,40028993
IMR90|chr11:52260364-52260393,chr11,52260364,52260393,IMR90|chr11:3396077-3396148,chr11,3396077,3396148,0,48864287
IMR90|chr11:52276931-52277006,chr11,52276931,52277006,IMR90|chr11:102961875-102961918,chr11,102961875,102961918,0,50684944
IMR90|chr11:52335438-52335478,chr11,52335438,52335478,IMR90|chr11:17230538-17230648,chr11,17230538,17230648,0,35104900
IMR90|chr11:52388573-52388669,chr11,52388573,52388669,IMR90|chr11:62311246-62311332,chr11,62311246,62311332,0,9922673
IMR90|chr11:52497847-52497923,chr11,52497847,52497923,IMR90|chr11:72520557-72520621,chr11,72520557,72520621,0,20022710
IMR90|chr11:52563784-52563842,chr11,52563784,52563842,IMR90|chr11:96122495-96122544,chr11,96122495,96122544,0,43558711
IMR90|chr11:52613522-52613565,chr11,52613522,52613565,IMR90|chr11:707541-707642,chr11,707541,707642,0,51905981
IMR90|chr11:52667698-52667721,chr11,52667698,52667721,IMR90|chr11:35546833-35546916,chr11,35546833,35546916,0,17120865
IMR90|chr11:52878218-52878299,chr11,52878218,52878299,IMR90|chr11:130764333-130764366,chr11,130764333,130764366,0,77886115
IMR90|chr11:52884097-52884192,chr11,52884097,52884192,IMR90|chr11:709151-709199,chr11,709151,709199,0,52174946
IMR90|chr11:52895734-52895849,chr11,52895734,52895849,IMR90|chr11:126224095-126224130,chr11,126224095,126224130,0,73328361
IMR90|chr11:52902806-52902866,chr11,52902806,52902866,IMR90|chr11:72524217-72524277,chr11,72524217,72524277,0,19621411
IMR90|chr11:52948648-52948686,chr11,52948648,52948686,IMR90|chr11:57546947-57546977,chr11,57546947,57546977,0,4598299
IMR90|chr11:52993081-52993116,chr11,52993081,52993116,IMR90|chr11:12699903-12699991,chr11,12699903,12699991,0,40293178
IMR90|chr11:53028145-53028201,chr11,53028145,53028201,IMR90|chr11:65839252-65839298,chr11,65839252,65839298,0,12811107
IMR90|chr11:53084018-53084075,chr11,53084018,53084075,IMR90|chr11:65157943-65158012,chr11,65157943,65158012,0,12073925
IMR90|chr11:53277880-53277945,chr11,53277880,53277945,IMR90|chr11:123063287-123063330,chr11,123063287,123063330,0,69785407
IMR90|chr11:53418688-53418765,chr11,53418688,53418765,IMR90|chr11:102961875-102961918,chr11,102961875,102961918,0,49543187
IMR90|chr11:53464698-53464790,chr11,53464698,53464790,IMR90|chr11:6627485-6627514,chr11,6627485,6627514,0,46837213
IMR90|chr11:53487518-53487622,chr11,53487518,53487622,IMR90|chr11:47663577-47663623,chr11,47663577,47663623,0,5823941
IMR90|chr11:53590118-53590182,chr11,53590118,53590182,IMR90|chr11:123063210-123063297,chr11,123063210,123063297,0,69473092
IMR90|chr11:53662412-53662454,chr11,53662412,53662454,IMR90|chr11:6501676-6501721,chr11,6501676,6501721,0,47160736
IMR90|chr11:53799345-53799459,chr11,53799345,53799459,IMR90|chr11:65839232-65839252,chr11,65839232,65839252,0,12039887
IMR90|chr11:53881815-53881840,chr11,53881815,53881840,IMR90|chr11:823252-823351,chr11,823252,823351,0,53058563
IMR90|chr11:54044215-54044266,chr11,54044215,54044266,IMR90|chr11:834829-834887,chr11,834829,834887,0,53209386
IMR90|chr11:54148096-54148137,chr11,54148096,54148137,IMR90|chr11:65078043-65078133,chr11,65078043,65078133,0,10929947
IMR90|chr11:54464656-54464689,chr11,54464656,54464689,IMR90|chr11:74695933-74696050,chr11,74695933,74696050,0,20231277
IMR90|chr11:54621198-54621254,chr11,54621198,54621254,IMR90|chr11:212049-212116,chr11,212049,212116,0,54409149
IMR90|chr11:54706628-54706691,chr11,54706628,54706691,IMR90|chr11:64945745-64945772,chr11,64945745,64945772,0,10239117
IMR90|chr11:54777647-54777703,chr11,54777647,54777703,IMR90|chr11:65839252-65839298,chr11,65839252,65839298,0,11061605
IMR90|chr11:54786514-54786608,chr11,54786514,54786608,IMR90|chr11:65221436-65221509,chr11,65221436,65221509,0,10434922
IMR90|chr11:54871107-54871145,chr11,54871107,54871145,IMR90|chr11:65097078-65097159,chr11,65097078,65097159,0,10225971
IMR90|chr11:54894046-54894062,chr11,54894046,54894062,IMR90|chr11:67135728-67135828,chr11,67135728,67135828,0,12241682
IMR90|chr11:54905487-54905517,chr11,54905487,54905517,IMR90|chr11:65656909-65657007,chr11,65656909,65657007,0,10751422
IMR90|chr11:54948323-54948440,chr11,54948323,54948440,IMR90|chr11:64946320-64946353,chr11,64946320,64946353,0,9997997
IMR90|chr11:55066791-55066855,chr11,55066791,55066855,IMR90|chr11:123063287-123063330,chr11,123063287,123063330,0,67996496
IMR90|chr11:55137990-55138018,chr11,55137990,55138018,IMR90|chr11:65347302-65347367,chr11,65347302,65347367,0,10209312
IMR90|chr11:55138762-55138820,chr11,55138762,55138820,IMR90|chr11:93467034-93467110,chr11,93467034,93467110,0,38328272
IMR90|chr11:55241452-55241527,chr11,55241452,55241527,IMR90|chr11:93470866-93470886,chr11,93470866,93470886,0,38229414
IMR90|chr11:55314734-55314852,chr11,55314734,55314852,IMR90|chr11:70054648-70054744,chr11,70054648,70054744,0,14739914
IMR90|chr11:55499024-55499071,chr11,55499024,55499071,IMR90|chr11:64850735-64850792,chr11,64850735,64850792,0,9351711
IMR90|chr11:55540175-55540216,chr11,55540175,55540216,IMR90|chr11:62477556-62477665,chr11,62477556,62477665,0,6937381
IMR90|chr11:55572678-55572710,chr11,55572678,55572710,IMR90|chr11:27719801-27719842,chr11,27719801,27719842,0,27852877
IMR90|chr11:55701933-55701991,chr11,55701933,55701991,IMR90|chr11:65666944-65667076,chr11,65666944,65667076,0,9965011
IMR90|chr11:55714567-55714613,chr11,55714567,55714613,IMR90|chr11:211867-211976,chr11,211867,211976,0,55502700
IMR90|chr11:55774258-55774353,chr11,55774258,55774353,IMR90|chr11:96073281-96073306,chr11,96073281,96073306,0,40299023
IMR90|chr11:55850891-55851001,chr11,55850891,55851001,IMR90|chr11:79149402-79149444,chr11,79149402,79149444,0,23298511
IMR90|chr11:55872419-55872518,chr11,55872419,55872518,IMR90|chr11:65030807-65030855,chr11,65030807,65030855,0,9158388
IMR90|chr11:55954775-55954839,chr11,55954775,55954839,IMR90|chr11:65158146-65158169,chr11,65158146,65158169,0,9203371
IMR90|chr11:56018583-56018696,chr11,56018583,56018696,IMR90|chr11:65405179-65405216,chr11,65405179,65405216,0,9386596
IMR90|chr11:56075719-56075752,chr11,56075719,56075752,IMR90|chr11:93464267-93464348,chr11,93464267,93464348,0,37388548
IMR90|chr11:56082285-56082307,chr11,56082285,56082307,IMR90|chr11:57089947-57090005,chr11,57089947,57090005,0,1007662
IMR90|chr11:56434014-56434105,chr11,56434014,56434105,IMR90|chr11:12113017-12113063,chr11,12113017,12113063,0,44320997
IMR90|chr11:56590353-56590390,chr11,56590353,56590390,IMR90|chr11:2402710-2402787,chr11,2402710,2402787,0,54187643
IMR90|chr11:56592019-56592111,chr11,56592019,56592111,IMR90|chr11:93470637-93470692,chr11,93470637,93470692,0,36878618
IMR90|chr11:56728995-56729049,chr11,56728995,56729049,IMR90|chr11:93475655-93475738,chr11,93475655,93475738,0,36746660
IMR90|chr11:56734944-56735093,chr11,56734944,56735093,IMR90|chr11:65030176-65030196,chr11,65030176,65030196,0,8295232
IMR90|chr11:56853622-56853689,chr11,56853622,56853689,IMR90|chr11:93477507-93477552,chr11,93477507,93477552,0,36623885
IMR90|chr11:56858610-56858646,chr11,56858610,56858646,IMR90|chr11:27720581-27720655,chr11,27720581,27720655,0,29138029
IMR90|chr11:56859355-56859412,chr11,56859355,56859412,IMR90|chr11:123062437-123062472,chr11,123062437,123062472,0,66203082
IMR90|chr11:56972800-56972861,chr11,56972800,56972861,IMR90|chr11:72524500-72524527,chr11,72524500,72524527,0,15551700
IMR90|chr11:57030330-57030374,chr11,57030330,57030374,IMR90|chr11:118790980-118791083,chr11,118790980,118791083,0,61760650
IMR90|chr11:57224530-57224611,chr11,57224530,57224611,IMR90|chr11:65663549-65663602,chr11,65663549,65663602,0,8439019
IMR90|chr11:57232431-57232480,chr11,57232431,57232480,IMR90|chr11:60611910-60612011,chr11,60611910,60612011,0,3379479
IMR90|chr11:57432896-57432930,chr11,57432896,57432930,IMR90|chr11:62479459-62479573,chr11,62479459,62479573,0,5046563
IMR90|chr11:57480125-57480193,chr11,57480125,57480193,IMR90|chr11:122938735-122938815,chr11,122938735,122938815,0,65458610
IMR90|chr11:57635854-57635936,chr11,57635854,57635936,IMR90|chr11:64849496-64849553,chr11,64849496,64849553,0,7213642
IMR90|chr11:57867585-57867735,chr11,57867585,57867735,IMR90|chr11:775131-775227,chr11,775131,775227,0,57092454
IMR90|chr11:57889896-57889958,chr11,57889896,57889958,IMR90|chr11:75110715-75110846,chr11,75110715,75110846,0,17220819
IMR90|chr11:57950997-57951107,chr11,57950997,57951107,IMR90|chr11:93472893-93472928,chr11,93472893,93472928,0,35521896
IMR90|chr11:58015842-58015972,chr11,58015842,58015972,IMR90|chr11:65344422-65344442,chr11,65344422,65344442,0,7328580
IMR90|chr11:58088705-58088769,chr11,58088705,58088769,IMR90|chr11:14378403-14378450,chr11,14378403,14378450,0,43710302
IMR90|chr11:58127271-58127353,chr11,58127271,58127353,IMR90|chr11:57530854-57530907,chr11,57530854,57530907,0,596417
IMR90|chr11:58174629-58174684,chr11,58174629,58174684,IMR90|chr11:66610006-66610041,chr11,66610006,66610041,0,8435377
IMR90|chr11:58413633-58413697,chr11,58413633,58413697,IMR90|chr11:14378403-14378450,chr11,14378403,14378450,0,44035230
IMR90|chr11:58418039-58418094,chr11,58418039,58418094,IMR90|chr11:67159728-67159810,chr11,67159728,67159810,0,8741689
IMR90|chr11:58485360-58485402,chr11,58485360,58485402,IMR90|chr11:71937200-71937350,chr11,71937200,71937350,0,13451840
IMR90|chr11:58704202-58704247,chr11,58704202,58704247,IMR90|chr11:67136781-67136845,chr11,67136781,67136845,0,8432579
IMR90|chr11:58837248-58837398,chr11,58837248,58837398,IMR90|chr11:775131-775227,chr11,775131,775227,0,58062117
IMR90|chr11:58904557-58904617,chr11,58904557,58904617,IMR90|chr11:13483943-13483996,chr11,13483943,13483996,0,45420614
IMR90|chr11:58962133-58962175,chr11,58962133,58962175,IMR90|chr11:118888196-118888318,chr11,118888196,118888318,0,59926063
IMR90|chr11:59025498-59025560,chr11,59025498,59025560,IMR90|chr11:64945341-64945408,chr11,64945341,64945408,0,5919843
IMR90|chr11:59025981-59026075,chr11,59025981,59026075,IMR90|chr11:57548937-57548983,chr11,57548937,57548983,0,1477044
IMR90|chr11:59200967-59201038,chr11,59200967,59201038,IMR90|chr11:47195768-47195808,chr11,47195768,47195808,0,12005199
IMR90|chr11:59215719-59215864,chr11,59215719,59215864,IMR90|chr11:62474293-62474311,chr11,62474293,62474311,0,3258574
IMR90|chr11:59256228-59256260,chr11,59256228,59256260,IMR90|chr11:12136524-12136604,chr11,12136524,12136604,0,47119704
IMR90|chr11:59399568-59399685,chr11,59399568,59399685,IMR90|chr11:70050244-70050284,chr11,70050244,70050284,0,10650676
IMR90|chr11:59453046-59453134,chr11,59453046,59453134,IMR90|chr11:65667438-65667491,chr11,65667438,65667491,0,6214392
IMR90|chr11:59594701-59594764,chr11,59594701,59594764,IMR90|chr11:64945745-64945772,chr11,64945745,64945772,0,5351044
IMR90|chr11:59655349-59655463,chr11,59655349,59655463,IMR90|chr11:64692810-64692843,chr11,64692810,64692843,0,5037461
IMR90|chr11:59737032-59737154,chr11,59737032,59737154,IMR90|chr11:75276567-75276590,chr11,75276567,75276590,0,15539535
IMR90|chr11:59784136-59784179,chr11,59784136,59784179,IMR90|chr11:46614048-46614139,chr11,46614048,46614139,0,13170088
IMR90|chr11:59897482-59897556,chr11,59897482,59897556,IMR90|chr11:118952716-118952760,chr11,118952716,118952760,0,59055234
IMR90|chr11:59910755-59910809,chr11,59910755,59910809,IMR90|chr11:71938026-71938093,chr11,71938026,71938093,0,12027271
IMR90|chr11:60026523-60026552,chr11,60026523,60026552,IMR90|chr11:3396076-3396148,chr11,3396076,3396148,0,56630447
IMR90|chr11:60400484-60400504,chr11,60400484,60400504,IMR90|chr11:12112181-12112288,chr11,12112181,12112288,0,48288303
IMR90|chr11:60425003-60425035,chr11,60425003,60425035,IMR90|chr11:64106440-64106524,chr11,64106440,64106524,0,3681437
IMR90|chr11:60571873-60571891,chr11,60571873,60571891,IMR90|chr11:72432329-72432426,chr11,72432329,72432426,0,11860456
IMR90|chr11:60590610-60590648,chr11,60590610,60590648,IMR90|chr11:93474028-93474128,chr11,93474028,93474128,0,32883418
IMR90|chr11:60649454-60649506,chr11,60649454,60649506,IMR90|chr11:12133037-12133097,chr11,12133037,12133097,0,48516417
IMR90|chr11:60730547-60730613,chr11,60730547,60730613,IMR90|chr11:65665691-65665779,chr11,65665691,65665779,0,4935144
IMR90|chr11:60750019-60750041,chr11,60750019,60750041,IMR90|chr11:95656535-95656619,chr11,95656535,95656619,0,34906516
IMR90|chr11:60762098-60762147,chr11,60762098,60762147,IMR90|chr11:65033547-65033608,chr11,65033547,65033608,0,4271449
IMR90|chr11:60799412-60799559,chr11,60799412,60799559,IMR90|chr11:122931749-122931791,chr11,122931749,122931791,0,62132337
IMR90|chr11:60898179-60898326,chr11,60898179,60898326,IMR90|chr11:101786286-101786343,chr11,101786286,101786343,0,40888107
IMR90|chr11:60962895-60962940,chr11,60962895,60962940,IMR90|chr11:93467033-93467086,chr11,93467033,93467086,0,32504138
IMR90|chr11:60966926-60966986,chr11,60966926,60966986,IMR90|chr11:67008331-67008400,chr11,67008331,67008400,0,6041405
IMR90|chr11:60977130-60977180,chr11,60977130,60977180,IMR90|chr11:6501900-6501953,chr11,6501900,6501953,0,54475230
IMR90|chr11:60989852-60989944,chr11,60989852,60989944,IMR90|chr11:67809534-67809592,chr11,67809534,67809592,0,6819682
IMR90|chr11:61161530-61161570,chr11,61161530,61161570,IMR90|chr11:93472013-93472119,chr11,93472013,93472119,0,32310483
IMR90|chr11:61263178-61263328,chr11,61263178,61263328,IMR90|chr11:93471936-93471997,chr11,93471936,93471997,0,32208758
IMR90|chr11:61336448-61336471,chr11,61336448,61336471,IMR90|chr11:65665038-65665162,chr11,65665038,65665162,0,4328590
IMR90|chr11:61346123-61346177,chr11,61346123,61346177,IMR90|chr11:61351759-61351836,chr11,61351759,61351836,0,5636
IMR90|chr11:61416041-61416174,chr11,61416041,61416174,IMR90|chr11:67809534-67809592,chr11,67809534,67809592,0,6393493
IMR90|chr11:61522115-61522188,chr11,61522115,61522188,IMR90|chr11:74694553-74694596,chr11,74694553,74694596,0,13172438
IMR90|chr11:61584648-61584698,chr11,61584648,61584698,IMR90|chr11:102962159-102962210,chr11,102962159,102962210,0,41377511
IMR90|chr11:61644201-61644231,chr11,61644201,61644231,IMR90|chr11:65345793-65345878,chr11,65345793,65345878,0,3701592
IMR90|chr11:61650001-61650114,chr11,61650001,61650114,IMR90|chr11:65405179-65405216,chr11,65405179,65405216,0,3755178
IMR90|chr11:61706324-61706474,chr11,61706324,61706474,IMR90|chr11:64691814-64691909,chr11,64691814,64691909,0,2985490
IMR90|chr11:62289031-62289137,chr11,62289031,62289137,IMR90|chr11:71937960-71937997,chr11,71937960,71937997,0,9648929
IMR90|chr11:62368998-62369024,chr11,62368998,62369024,IMR90|chr11:65099292-65099376,chr11,65099292,65099376,0,2730294
IMR90|chr11:62445320-62445371,chr11,62445320,62445371,IMR90|chr11:46300707-46300753,chr11,46300707,46300753,0,16144613
IMR90|chr11:62472070-62472129,chr11,62472070,62472129,IMR90|chr11:65033579-65033616,chr11,65033579,65033616,0,2561509
IMR90|chr11:62527272-62527324,chr11,62527272,62527324,IMR90|chr11:64945745-64945772,chr11,64945745,64945772,0,2418473
IMR90|chr11:62812561-62812610,chr11,62812561,62812610,IMR90|chr11:3399654-3399755,chr11,3399654,3399755,0,59412907
IMR90|chr11:62998669-62998695,chr11,62998669,62998695,IMR90|chr11:65099292-65099376,chr11,65099292,65099376,0,2100623
IMR90|chr11:63036031-63036178,chr11,63036031,63036178,IMR90|chr11:8699484-8699522,chr11,8699484,8699522,0,54336547
IMR90|chr11:63179269-63179346,chr11,63179269,63179346,IMR90|chr11:93470866-93470886,chr11,93470866,93470886,0,30291597
IMR90|chr11:63264879-63264960,chr11,63264879,63264960,IMR90|chr11:66513908-66513972,chr11,66513908,66513972,0,3249029
IMR90|chr11:63292780-63292807,chr11,63292780,63292807,IMR90|chr11:65656917-65657012,chr11,65656917,65657012,0,2364137
IMR90|chr11:63313934-63314056,chr11,63313934,63314056,IMR90|chr11:75276567-75276590,chr11,75276567,75276590,0,11962633
IMR90|chr11:63356225-63356253,chr11,63356225,63356253,IMR90|chr11:65336951-65337039,chr11,65336951,65337039,0,1980726
IMR90|chr11:63362686-63362773,chr11,63362686,63362773,IMR90|chr11:65099308-65099372,chr11,65099308,65099372,0,1736622
IMR90|chr11:63374201-63374247,chr11,63374201,63374247,IMR90|chr11:67809602-67809684,chr11,67809602,67809684,0,4435401
IMR90|chr11:63402924-63402958,chr11,63402924,63402958,IMR90|chr11:65838386-65838500,chr11,65838386,65838500,0,2435462
IMR90|chr11:63517000-63517055,chr11,63517000,63517055,IMR90|chr11:67159728-67159810,chr11,67159728,67159810,0,3642728
IMR90|chr11:63636569-63636631,chr11,63636569,63636631,IMR90|chr11:27719929-27719973,chr11,27719929,27719973,0,35916640
IMR90|chr11:63641967-63642012,chr11,63641967,63642012,IMR90|chr11:62538244-62538327,chr11,62538244,62538327,0,1103723
IMR90|chr11:63684315-63684383,chr11,63684315,63684383,IMR90|chr11:46142097-46142143,chr11,46142097,46142143,0,17542218
IMR90|chr11:63841137-63841209,chr11,63841137,63841209,IMR90|chr11:67137367-67137477,chr11,67137367,67137477,0,3296230
IMR90|chr11:63849854-63849966,chr11,63849854,63849966,IMR90|chr11:8699484-8699522,chr11,8699484,8699522,0,55150370
IMR90|chr11:63864695-63864757,chr11,63864695,63864757,IMR90|chr11:2399643-2399763,chr11,2399643,2399763,0,61465052
IMR90|chr11:64143496-64143537,chr11,64143496,64143537,IMR90|chr11:211867-211976,chr11,211867,211976,0,63931629
IMR90|chr11:64239472-64239509,chr11,64239472,64239509,IMR90|chr11:2402710-2402787,chr11,2402710,2402787,0,61836762
IMR90|chr11:64250982-64251086,chr11,64250982,64251086,IMR90|chr11:47663577-47663623,chr11,47663577,47663623,0,16587405
IMR90|chr11:64600343-64600393,chr11,64600343,64600393,IMR90|chr11:65407087-65407185,chr11,65407087,65407185,0,806744
IMR90|chr11:64601626-64601746,chr11,64601626,64601746,IMR90|chr11:72432650-72432692,chr11,72432650,72432692,0,7831024
IMR90|chr11:64602866-64602909,chr11,64602866,64602909,IMR90|chr11:12028946-12029016,chr11,12028946,12029016,0,52573920
IMR90|chr11:64902810-64902899,chr11,64902810,64902899,IMR90|chr11:67206067-67206141,chr11,67206067,67206141,0,2303257
IMR90|chr11:64905968-64906002,chr11,64905968,64906002,IMR90|chr11:65838386-65838500,chr11,65838386,65838500,0,932418
IMR90|chr11:65097372-65097403,chr11,65097372,65097403,IMR90|chr11:102218789-102218807,chr11,102218789,102218807,0,37121417
IMR90|chr11:65180778-65180801,chr11,65180778,65180801,IMR90|chr11:35546833-35546916,chr11,35546833,35546916,0,29633945
IMR90|chr11:65369515-65369546,chr11,65369515,65369546,IMR90|chr11:27720727-27720807,chr11,27720727,27720807,0,37648788
IMR90|chr11:65381574-65381629,chr11,65381574,65381629,IMR90|chr11:73882957-73882979,chr11,73882957,73882979,0,8501383
IMR90|chr11:65460170-65460226,chr11,65460170,65460226,IMR90|chr11:93475655-93475738,chr11,93475655,93475738,0,28015485
IMR90|chr11:65543354-65543427,chr11,65543354,65543427,IMR90|chr11:118309594-118309643,chr11,118309594,118309643,0,52766240
IMR90|chr11:65621850-65621947,chr11,65621850,65621947,IMR90|chr11:2403627-2403715,chr11,2403627,2403715,0,63218223
IMR90|chr11:65710278-65710340,chr11,65710278,65710340,IMR90|chr11:65664759-65664778,chr11,65664759,65664778,0,45519
IMR90|chr11:65752011-65752070,chr11,65752011,65752070,IMR90|chr11:16761238-16761325,chr11,16761238,16761325,0,48990773
IMR90|chr11:65816206-65816245,chr11,65816206,65816245,IMR90|chr11:33278891-33278995,chr11,33278891,33278995,0,32537315
IMR90|chr11:65893134-65893168,chr11,65893134,65893168,IMR90|chr11:65683775-65683819,chr11,65683775,65683819,0,209359
IMR90|chr11:66394465-66394547,chr11,66394465,66394547,IMR90|chr11:64849496-64849553,chr11,64849496,64849553,0,1544969
IMR90|chr11:66411564-66411594,chr11,66411564,66411594,IMR90|chr11:27720725-27720809,chr11,27720725,27720809,0,38690839
IMR90|chr11:66435664-66435705,chr11,66435664,66435705,IMR90|chr11:65221411-65221520,chr11,65221411,65221520,0,1214253
IMR90|chr11:66710986-66711049,chr11,66710986,66711049,IMR90|chr11:63608075-63608105,chr11,63608075,63608105,0,3102911
IMR90|chr11:66761105-66761142,chr11,66761105,66761142,IMR90|chr11:810468-810562,chr11,810468,810562,0,65950637
IMR90|chr11:66892102-66892161,chr11,66892102,66892161,IMR90|chr11:17098430-17098454,chr11,17098430,17098454,0,49793672
IMR90|chr11:67039615-67039645,chr11,67039615,67039645,IMR90|chr11:66054766-66054852,chr11,66054766,66054852,0,984849
IMR90|chr11:67089940-67090020,chr11,67089940,67090020,IMR90|chr11:14376327-14376384,chr11,14376327,14376384,0,52713613
IMR90|chr11:67168743-67168837,chr11,67168743,67168837,IMR90|chr11:65330650-65330722,chr11,65330650,65330722,0,1838093
IMR90|chr11:67514753-67514802,chr11,67514753,67514802,IMR90|chr11:71935067-71935170,chr11,71935067,71935170,0,4420314
IMR90|chr11:67547567-67547616,chr11,67547567,67547616,IMR90|chr11:406539-406640,chr11,406539,406640,0,67141028
IMR90|chr11:67575581-67575662,chr11,67575581,67575662,IMR90|chr11:65406716-65406748,chr11,65406716,65406748,0,2168865
IMR90|chr11:67589078-67589198,chr11,67589078,67589198,IMR90|chr11:64886908-64886938,chr11,64886908,64886938,0,2702170
IMR90|chr11:67780443-67780512,chr11,67780443,67780512,IMR90|chr11:118779668-118779698,chr11,118779668,118779698,0,50999225
IMR90|chr11:67879231-67879324,chr11,67879231,67879324,IMR90|chr11:72462455-72462492,chr11,72462455,72462492,0,4583224
IMR90|chr11:67914412-67914457,chr11,67914412,67914457,IMR90|chr11:67008387-67008439,chr11,67008387,67008439,0,906025
IMR90|chr11:68057661-68057731,chr11,68057661,68057731,IMR90|chr11:707944-707973,chr11,707944,707973,0,67349717
IMR90|chr11:68148876-68148943,chr11,68148876,68148943,IMR90|chr11:3117054-3117135,chr11,3117054,3117135,0,65031822
IMR90|chr11:68200821-68200935,chr11,68200821,68200935,IMR90|chr11:122938735-122938815,chr11,122938735,122938815,0,54737914
IMR90|chr11:68447642-68447686,chr11,68447642,68447686,IMR90|chr11:46614048-46614139,chr11,46614048,46614139,0,21833594
IMR90|chr11:68484694-68484782,chr11,68484694,68484782,IMR90|chr11:65667438-65667491,chr11,65667438,65667491,0,2817256
IMR90|chr11:68542079-68542115,chr11,68542079,68542115,IMR90|chr11:60611631-60611745,chr11,60611631,60611745,0,7930448
IMR90|chr11:68545724-68545758,chr11,68545724,68545758,IMR90|chr11:120207293-120207386,chr11,120207293,120207386,0,51661569
IMR90|chr11:68582292-68582345,chr11,68582292,68582345,IMR90|chr11:844036-844057,chr11,844036,844057,0,67738256
IMR90|chr11:68684012-68684076,chr11,68684012,68684076,IMR90|chr11:65310984-65311064,chr11,65310984,65311064,0,3373028
IMR90|chr11:68696413-68696451,chr11,68696413,68696451,IMR90|chr11:64886695-64886765,chr11,64886695,64886765,0,3809718
IMR90|chr11:68993962-68994007,chr11,68993962,68994007,IMR90|chr11:118781654-118781716,chr11,118781654,118781716,0,49787692
IMR90|chr11:69094240-69094289,chr11,69094240,69094289,IMR90|chr11:1782392-1782494,chr11,1782392,1782494,0,67311848
IMR90|chr11:69134247-69134265,chr11,69134247,69134265,IMR90|chr11:35165662-35165785,chr11,35165662,35165785,0,33968585
IMR90|chr11:69151613-69151677,chr11,69151613,69151677,IMR90|chr11:102218645-102218708,chr11,102218645,102218708,0,33067032
IMR90|chr11:69189872-69189944,chr11,69189872,69189944,IMR90|chr11:3396142-3396197,chr11,3396142,3396197,0,65793730
IMR90|chr11:69285428-69285513,chr11,69285428,69285513,IMR90|chr11:62493807-62493884,chr11,62493807,62493884,0,6791621
IMR90|chr11:69377842-69377962,chr11,69377842,69377962,IMR90|chr11:65157512-65157536,chr11,65157512,65157536,0,4220330
IMR90|chr11:69477955-69477997,chr11,69477955,69477997,IMR90|chr11:79150927-79151068,chr11,79150927,79151068,0,9672972
IMR90|chr11:69579820-69579862,chr11,69579820,69579862,IMR90|chr11:6501676-6501721,chr11,6501676,6501721,0,63078144
IMR90|chr11:69689608-69689640,chr11,69689608,69689640,IMR90|chr11:12027864-12027978,chr11,12027864,12027978,0,57661744
IMR90|chr11:69767320-69767340,chr11,69767320,69767340,IMR90|chr11:12112181-12112288,chr11,12112181,12112288,0,57655139
IMR90|chr11:70015063-70015137,chr11,70015063,70015137,IMR90|chr11:65098892-65098918,chr11,65098892,65098918,0,4916171
IMR90|chr11:70022177-70022269,chr11,70022177,70022269,IMR90|chr11:79149829-79149861,chr11,79149829,79149861,0,9127652
IMR90|chr11:70060669-70060753,chr11,70060669,70060753,IMR90|chr11:62325322-62325388,chr11,62325322,62325388,0,7735347
IMR90|chr11:70158106-70158158,chr11,70158106,70158158,IMR90|chr11:65667459-65667520,chr11,65667459,65667520,0,4490647
IMR90|chr11:70325224-70325255,chr11,70325224,70325255,IMR90|chr11:118480086-118480236,chr11,118480086,118480236,0,48154862
IMR90|chr11:70359453-70359543,chr11,70359453,70359543,IMR90|chr11:67799211-67799260,chr11,67799211,67799260,0,2560242
IMR90|chr11:70402152-70402226,chr11,70402152,70402226,IMR90|chr11:850516-850551,chr11,850516,850551,0,69551636
IMR90|chr11:70421120-70421172,chr11,70421120,70421172,IMR90|chr11:47618216-47618332,chr11,47618216,47618332,0,22802904
IMR90|chr11:70433502-70433564,chr11,70433502,70433564,IMR90|chr11:27719801-27719842,chr11,27719801,27719842,0,42713701
IMR90|chr11:70523490-70523615,chr11,70523490,70523615,IMR90|chr11:75276567-75276590,chr11,75276567,75276590,0,4753077
IMR90|chr11:70557247-70557302,chr11,70557247,70557302,IMR90|chr11:71936772-71936826,chr11,71936772,71936826,0,1379525
IMR90|chr11:70638807-70638900,chr11,70638807,70638900,IMR90|chr11:79149829-79149861,chr11,79149829,79149861,0,8511022
IMR90|chr11:70643955-70644059,chr11,70643955,70644059,IMR90|chr11:779257-779371,chr11,779257,779371,0,69864698
IMR90|chr11:70719677-70719753,chr11,70719677,70719753,IMR90|chr11:845127-845167,chr11,845127,845167,0,69874550
IMR90|chr11:70737904-70737934,chr11,70737904,70737934,IMR90|chr11:65345793-65345878,chr11,65345793,65345878,0,5392111
IMR90|chr11:70758857-70758900,chr11,70758857,70758900,IMR90|chr11:65665416-65665470,chr11,65665416,65665470,0,5093441
IMR90|chr11:70760878-70760957,chr11,70760878,70760957,IMR90|chr11:65156526-65156580,chr11,65156526,65156580,0,5604352
IMR90|chr11:70779105-70779200,chr11,70779105,70779200,IMR90|chr11:3398768-3398808,chr11,3398768,3398808,0,67380337
IMR90|chr11:70790641-70790677,chr11,70790641,70790677,IMR90|chr11:65220459-65220551,chr11,65220459,65220551,0,5570182
IMR90|chr11:70893778-70893835,chr11,70893778,70893835,IMR90|chr11:10320406-10320484,chr11,10320406,10320484,0,60573372
IMR90|chr11:71054339-71054429,chr11,71054339,71054429,IMR90|chr11:8705155-8705185,chr11,8705155,8705185,0,62349184
IMR90|chr11:71307075-71307110,chr11,71307075,71307110,IMR90|chr11:27720727-27720807,chr11,27720727,27720807,0,43586348
IMR90|chr11:71328553-71328602,chr11,71328553,71328602,IMR90|chr11:74695683-74695740,chr11,74695683,74695740,0,3367130
IMR90|chr11:71393062-71393151,chr11,71393062,71393151,IMR90|chr11:67799211-67799260,chr11,67799211,67799260,0,3593851
IMR90|chr11:71450433-71450519,chr11,71450433,71450519,IMR90|chr11:96073885-96073915,chr11,96073885,96073915,0,24623452
IMR90|chr11:71466851-71466905,chr11,71466851,71466905,IMR90|chr11:57547551-57547629,chr11,57547551,57547629,0,13919300
IMR90|chr11:71528540-71528590,chr11,71528540,71528590,IMR90|chr11:65407087-65407185,chr11,65407087,65407185,0,6121453
IMR90|chr11:71534174-71534260,chr11,71534174,71534260,IMR90|chr11:65308303-65308323,chr11,65308303,65308323,0,6225871
IMR90|chr11:71658740-71658832,chr11,71658740,71658832,IMR90|chr11:67809534-67809592,chr11,67809534,67809592,0,3849206
IMR90|chr11:71791507-71791567,chr11,71791507,71791567,IMR90|chr11:3117116-3117134,chr11,3117116,3117134,0,68674391
IMR90|chr11:71914913-71914946,chr11,71914913,71914946,IMR90|chr11:67810345-67810419,chr11,67810345,67810419,0,4104568
IMR90|chr11:72002064-72002126,chr11,72002064,72002126,IMR90|chr11:65033840-65033882,chr11,65033840,65033882,0,6968224
IMR90|chr11:72042016-72042131,chr11,72042016,72042131,IMR90|chr11:93472893-93472928,chr11,93472893,93472928,0,21430877
IMR90|chr11:72055678-72055726,chr11,72055678,72055726,IMR90|chr11:46302529-46302650,chr11,46302529,46302650,0,25753149
IMR90|chr11:72320219-72320267,chr11,72320219,72320267,IMR90|chr11:67139054-67139132,chr11,67139054,67139132,0,5181165
IMR90|chr11:72343970-72344005,chr11,72343970,72344005,IMR90|chr11:65838386-65838500,chr11,65838386,65838500,0,6505584
IMR90|chr11:72433665-72433809,chr11,72433665,72433809,IMR90|chr11:796659-796694,chr11,796659,796694,0,71637006
IMR90|chr11:72460902-72460954,chr11,72460902,72460954,IMR90|chr11:65097558-65097639,chr11,65097558,65097639,0,7363344
IMR90|chr11:72510541-72510617,chr11,72510541,72510617,IMR90|chr11:71938800-71938865,chr11,71938800,71938865,0,571741
IMR90|chr11:72577293-72577338,chr11,72577293,72577338,IMR90|chr11:8700302-8700437,chr11,8700302,8700437,0,63876991
IMR90|chr11:72699301-72699351,chr11,72699301,72699351,IMR90|chr11:406539-406640,chr11,406539,406640,0,72292762
IMR90|chr11:72858714-72858852,chr11,72858714,72858852,IMR90|chr11:120210021-120210060,chr11,120210021,120210060,0,47351307
IMR90|chr11:72859113-72859170,chr11,72859113,72859170,IMR90|chr11:8705459-8705492,chr11,8705459,8705492,0,64153654
IMR90|chr11:73105115-73105162,chr11,73105115,73105162,IMR90|chr11:46302529-46302650,chr11,46302529,46302650,0,26802586
IMR90|chr11:73152710-73152753,chr11,73152710,73152753,IMR90|chr11:93474278-93474385,chr11,93474278,93474385,0,20321568
IMR90|chr11:73211308-73211350,chr11,73211308,73211350,IMR90|chr11:79150927-79151068,chr11,79150927,79151068,0,5939619
IMR90|chr11:73369632-73369710,chr11,73369632,73369710,IMR90|chr11:3181528-3181578,chr11,3181528,3181578,0,70188104
IMR90|chr11:73415126-73415186,chr11,73415126,73415186,IMR90|chr11:67008331-67008400,chr11,67008331,67008400,0,6406795
IMR90|chr11:73463577-73463608,chr11,73463577,73463608,IMR90|chr11:65665269-65665349,chr11,65665269,65665349,0,7798308
IMR90|chr11:73570680-73570773,chr11,73570680,73570773,IMR90|chr11:36531129-36531178,chr11,36531129,36531178,0,37039551
IMR90|chr11:73850763-73850784,chr11,73850763,73850784,IMR90|chr11:126220891-126220952,chr11,126220891,126220952,0,52370128
IMR90|chr11:73974407-73974540,chr11,73974407,73974540,IMR90|chr11:67809534-67809592,chr11,67809534,67809592,0,6164873
IMR90|chr11:74067410-74067447,chr11,74067410,74067447,IMR90|chr11:65478420-65478500,chr11,65478420,65478500,0,8588990
IMR90|chr11:74089306-74089352,chr11,74089306,74089352,IMR90|chr11:65666160-65666264,chr11,65666160,65666264,0,8423146
IMR90|chr11:74099412-74099467,chr11,74099412,74099467,IMR90|chr11:63608074-63608104,chr11,63608074,63608104,0,10491338
IMR90|chr11:74115857-74115925,chr11,74115857,74115925,IMR90|chr11:79150527-79150572,chr11,79150527,79150572,0,5034670
IMR90|chr11:74179848-74179903,chr11,74179848,74179903,IMR90|chr11:64691814-64691909,chr11,64691814,64691909,0,9488034
IMR90|chr11:74469603-74469709,chr11,74469603,74469709,IMR90|chr11:12113017-12113063,chr11,12113017,12113063,0,62356586
IMR90|chr11:74550625-74550691,chr11,74550625,74550691,IMR90|chr11:65666488-65666572,chr11,65666488,65666572,0,8884137
IMR90|chr11:74574794-74574852,chr11,74574794,74574852,IMR90|chr11:46613110-46613220,chr11,46613110,46613220,0,27961684
IMR90|chr11:74714157-74714263,chr11,74714157,74714263,IMR90|chr11:63607073-63607114,chr11,63607073,63607114,0,11107084
IMR90|chr11:74728174-74728207,chr11,74728174,74728207,IMR90|chr11:62309250-62309355,chr11,62309250,62309355,0,12418924
IMR90|chr11:74872426-74872576,chr11,74872426,74872576,IMR90|chr11:93471936-93471997,chr11,93471936,93471997,0,18599510
IMR90|chr11:74880777-74880844,chr11,74880777,74880844,IMR90|chr11:36531846-36531864,chr11,36531846,36531864,0,38348931
IMR90|chr11:74898125-74898183,chr11,74898125,74898183,IMR90|chr11:65666944-65667076,chr11,65666944,65667076,0,9231181
IMR90|chr11:75273832-75273905,chr11,75273832,75273905,IMR90|chr11:67138101-67138178,chr11,67138101,67138178,0,8135731
IMR90|chr11:75282596-75282642,chr11,75282596,75282642,IMR90|chr11:821989-822085,chr11,821989,822085,0,74460607
IMR90|chr11:75305384-75305476,chr11,75305384,75305476,IMR90|chr11:79149829-79149861,chr11,79149829,79149861,0,3844445
IMR90|chr11:75390617-75390639,chr11,75390617,75390639,IMR90|chr11:35161901-35161975,chr11,35161901,35161975,0,40228716
IMR90|chr11:75399484-75399560,chr11,75399484,75399560,IMR90|chr11:57508696-57508737,chr11,57508696,57508737,0,17890788
IMR90|chr11:75566180-75566247,chr11,75566180,75566247,IMR90|chr11:122937216-122937319,chr11,122937216,122937319,0,47371036
IMR90|chr11:75623819-75623868,chr11,75623819,75623868,IMR90|chr11:71935067-71935170,chr11,71935067,71935170,0,3688752
IMR90|chr11:75975434-75975485,chr11,75975434,75975485,IMR90|chr11:65407508-65407608,chr11,65407508,65407608,0,10567926
IMR90|chr11:75989569-75989647,chr11,75989569,75989647,IMR90|chr11:65663807-65663844,chr11,65663807,65663844,0,10325762
IMR90|chr11:75991413-75991482,chr11,75991413,75991482,IMR90|chr11:122937141-122937190,chr11,122937141,122937190,0,46945728
IMR90|chr11:76279798-76279857,chr11,76279798,76279857,IMR90|chr11:17098430-17098454,chr11,17098430,17098454,0,59181368
IMR90|chr11:76280662-76280696,chr11,76280662,76280696,IMR90|chr11:66054023-66054173,chr11,66054023,66054173,0,10226639
IMR90|chr11:76440926-76441025,chr11,76440926,76441025,IMR90|chr11:65223068-65223089,chr11,65223068,65223089,0,11217858
IMR90|chr11:76533676-76533753,chr11,76533676,76533753,IMR90|chr11:85779367-85779390,chr11,85779367,85779390,0,9245691
IMR90|chr11:76535574-76535598,chr11,76535574,76535598,IMR90|chr11:126224854-126225004,chr11,126224854,126225004,0,49689280
IMR90|chr11:76563496-76563546,chr11,76563496,76563546,IMR90|chr11:406539-406640,chr11,406539,406640,0,76156957
IMR90|chr11:76668845-76668883,chr11,76668845,76668883,IMR90|chr11:8700323-8700391,chr11,8700323,8700391,0,67968522
IMR90|chr11:76839219-76839278,chr11,76839219,76839278,IMR90|chr11:3399654-3399755,chr11,3399654,3399755,0,73439565
IMR90|chr11:76952444-76952481,chr11,76952444,76952481,IMR90|chr11:27720859-27720896,chr11,27720859,27720896,0,49231585
IMR90|chr11:77011763-77011857,chr11,77011763,77011857,IMR90|chr11:65330650-65330722,chr11,65330650,65330722,0,11681113
IMR90|chr11:77202922-77202981,chr11,77202922,77202981,IMR90|chr11:74695323-74695356,chr11,74695323,74695356,0,2507599
IMR90|chr11:77427480-77427500,chr11,77427480,77427500,IMR90|chr11:847700-847850,chr11,847700,847850,0,76579780
IMR90|chr11:77444666-77444753,chr11,77444666,77444753,IMR90|chr11:846431-846482,chr11,846431,846482,0,76598235
IMR90|chr11:77556436-77556498,chr11,77556436,77556498,IMR90|chr11:65033840-65033882,chr11,65033840,65033882,0,12522596
IMR90|chr11:77564925-77564944,chr11,77564925,77564944,IMR90|chr11:67157335-67157447,chr11,67157335,67157447,0,10407590
IMR90|chr11:77643212-77643271,chr11,77643212,77643271,IMR90|chr11:117048265-117048410,chr11,117048265,117048410,0,39405053
IMR90|chr11:77646486-77646552,chr11,77646486,77646552,IMR90|chr11:291445-291522,chr11,291445,291522,0,77355041
IMR90|chr11:77654476-77654511,chr11,77654476,77654511,IMR90|chr11:57546591-57546631,chr11,57546591,57546631,0,20107885
IMR90|chr11:77724307-77724329,chr11,77724307,77724329,IMR90|chr11:95656535-95656619,chr11,95656535,95656619,0,17932228
IMR90|chr11:77996092-77996142,chr11,77996092,77996142,IMR90|chr11:17098436-17098493,chr11,17098436,17098493,0,60897656
IMR90|chr11:78001183-78001259,chr11,78001183,78001259,IMR90|chr11:120207137-120207239,chr11,120207137,120207239,0,42205954
IMR90|chr11:78020967-78021023,chr11,78020967,78021023,IMR90|chr11:14382792-14382852,chr11,14382792,14382852,0,63638175
IMR90|chr11:78117264-78117369,chr11,78117264,78117369,IMR90|chr11:57090377-57090435,chr11,57090377,57090435,0,21026887
IMR90|chr11:78305533-78305601,chr11,78305533,78305601,IMR90|chr11:65217947-65218029,chr11,65217947,65218029,0,13087586
IMR90|chr11:78382394-78382485,chr11,78382394,78382485,IMR90|chr11:65032840-65032874,chr11,65032840,65032874,0,13349554
IMR90|chr11:78433515-78433559,chr11,78433515,78433559,IMR90|chr11:122937216-122937319,chr11,122937216,122937319,0,44503701
IMR90|chr11:78460529-78460635,chr11,78460529,78460635,IMR90|chr11:63607073-63607114,chr11,63607073,63607114,0,14853456
IMR90|chr11:78506245-78506264,chr11,78506245,78506264,IMR90|chr11:12698840-12698931,chr11,12698840,12698931,0,65807405
IMR90|chr11:78779427-78779532,chr11,78779427,78779532,IMR90|chr11:6626300-6626326,chr11,6626300,6626326,0,72153127
IMR90|chr11:78825799-78825831,chr11,78825799,78825831,IMR90|chr11:65336951-65337039,chr11,65336951,65337039,0,13488848
IMR90|chr11:79054629-79054656,chr11,79054629,79054656,IMR90|chr11:34124818-34124880,chr11,34124818,34124880,0,44929811
IMR90|chr11:79082044-79082149,chr11,79082044,79082149,IMR90|chr11:124931611-124931712,chr11,124931611,124931712,0,45849567
IMR90|chr11:79117738-79117776,chr11,79117738,79117776,IMR90|chr11:93474028-93474128,chr11,93474028,93474128,0,14356290
IMR90|chr11:79157221-79157286,chr11,79157221,79157286,IMR90|chr11:65404910-65404961,chr11,65404910,65404961,0,13752311
IMR90|chr11:79178624-79178672,chr11,79178624,79178672,IMR90|chr11:65666583-65666710,chr11,65666583,65666710,0,13512041
IMR90|chr11:79280713-79280767,chr11,79280713,79280767,IMR90|chr11:122937268-122937306,chr11,122937268,122937306,0,43656555
IMR90|chr11:79288221-79288280,chr11,79288221,79288280,IMR90|chr11:65338802-65338843,chr11,65338802,65338843,0,13949419
IMR90|chr11:79337646-79337773,chr11,79337646,79337773,IMR90|chr11:117199879-117199902,chr11,117199879,117199902,0,37862233
IMR90|chr11:79410768-79410828,chr11,79410768,79410828,IMR90|chr11:72524217-72524277,chr11,72524217,72524277,0,6886551
IMR90|chr11:79452716-79452820,chr11,79452716,79452820,IMR90|chr11:211639-211685,chr11,211639,211685,0,79241077
IMR90|chr11:79727917-79728051,chr11,79727917,79728051,IMR90|chr11:8699052-8699076,chr11,8699052,8699076,0,71028865
IMR90|chr11:79745525-79745551,chr11,79745525,79745551,IMR90|chr11:17095140-17095264,chr11,17095140,17095264,0,62650385
IMR90|chr11:79934325-79934345,chr11,79934325,79934345,IMR90|chr11:72523914-72524001,chr11,72523914,72524001,0,7410411
IMR90|chr11:80160477-80160500,chr11,80160477,80160500,IMR90|chr11:2401534-2401622,chr11,2401534,2401622,0,77758943
IMR90|chr11:80257170-80257214,chr11,80257170,80257214,IMR90|chr11:64905606-64905665,chr11,64905606,64905665,0,15351564
IMR90|chr11:80399323-80399365,chr11,80399323,80399365,IMR90|chr11:71937200-71937350,chr11,71937200,71937350,0,8462123
IMR90|chr11:80405241-80405276,chr11,80405241,80405276,IMR90|chr11:12136723-12136811,chr11,12136723,12136811,0,68268518
IMR90|chr11:80450212-80450244,chr11,80450212,80450244,IMR90|chr11:845452-845559,chr11,845452,845559,0,79604760
IMR90|chr11:80613506-80613656,chr11,80613506,80613656,IMR90|chr11:93473206-93473327,chr11,93473206,93473327,0,12859700
IMR90|chr11:80647981-80648051,chr11,80647981,80648051,IMR90|chr11:3183275-3183318,chr11,3183275,3183318,0,77464706
IMR90|chr11:80931442-80931510,chr11,80931442,80931510,IMR90|chr11:64105810-64105846,chr11,64105810,64105846,0,16825632
IMR90|chr11:80981112-80981208,chr11,80981112,80981208,IMR90|chr11:65033144-65033197,chr11,65033144,65033197,0,15947968
IMR90|chr11:81170032-81170109,chr11,81170032,81170109,IMR90|chr11:66026929-66026974,chr11,66026929,66026974,0,15143103
IMR90|chr11:81192158-81192269,chr11,81192158,81192269,IMR90|chr11:64692810-64692843,chr11,64692810,64692843,0,16499348
IMR90|chr11:81274446-81274513,chr11,81274446,81274513,IMR90|chr11:65158146-65158169,chr11,65158146,65158169,0,16116300
IMR90|chr11:81344802-81344820,chr11,81344802,81344820,IMR90|chr11:35165662-35165785,chr11,35165662,35165785,0,46179140
IMR90|chr11:81374163-81374242,chr11,81374163,81374242,IMR90|chr11:65379576-65379664,chr11,65379576,65379664,0,15994587
IMR90|chr11:81486063-81486140,chr11,81486063,81486140,IMR90|chr11:3181528-3181578,chr11,3181528,3181578,0,78304535
IMR90|chr11:81616170-81616201,chr11,81616170,81616201,IMR90|chr11:64886362-64886429,chr11,64886362,64886429,0,16729808
IMR90|chr11:81731436-81731471,chr11,81731436,81731471,IMR90|chr11:65838386-65838500,chr11,65838386,65838500,0,15893050
IMR90|chr11:81775019-81775057,chr11,81775019,81775057,IMR90|chr11:27720859-27720896,chr11,27720859,27720896,0,54054160
IMR90|chr11:81776855-81776943,chr11,81776855,81776943,IMR90|chr11:12030325-12030352,chr11,12030325,12030352,0,69746530
IMR90|chr11:81862987-81863080,chr11,81862987,81863080,IMR90|chr11:72462455-72462492,chr11,72462455,72462492,0,9400532
IMR90|chr11:81895739-81895793,chr11,81895739,81895793,IMR90|chr11:93475655-93475738,chr11,93475655,93475738,0,11579916
IMR90|chr11:81952265-81952292,chr11,81952265,81952292,IMR90|chr11:118888196-118888318,chr11,118888196,118888318,0,36935931
IMR90|chr11:82034853-82034915,chr11,82034853,82034915,IMR90|chr11:64944530-64944603,chr11,64944530,64944603,0,17090323
IMR90|chr11:82101022-82101074,chr11,82101022,82101074,IMR90|chr11:834829-834887,chr11,834829,834887,0,81266193
IMR90|chr11:82213747-82213806,chr11,82213747,82213806,IMR90|chr11:65665691-65665779,chr11,65665691,65665779,0,16548056
IMR90|chr11:82313482-82313602,chr11,82313482,82313602,IMR90|chr11:72432650-72432692,chr11,72432650,72432692,0,9880832
IMR90|chr11:82320367-82320517,chr11,82320367,82320517,IMR90|chr11:65080649-65080715,chr11,65080649,65080715,0,17239718
IMR90|chr11:82567845-82567971,chr11,82567845,82567971,IMR90|chr11:69456904-69456928,chr11,69456904,69456928,0,13110941
IMR90|chr11:82667750-82667825,chr11,82667750,82667825,IMR90|chr11:93465431-93465578,chr11,93465431,93465578,0,10797681
IMR90|chr11:82826647-82826696,chr11,82826647,82826696,IMR90|chr11:60611910-60612011,chr11,60611910,60612011,0,22214737
IMR90|chr11:83017122-83017181,chr11,83017122,83017181,IMR90|chr11:71937872-71937963,chr11,71937872,71937963,0,11079250
IMR90|chr11:83165550-83165582,chr11,83165550,83165582,IMR90|chr11:117016306-117016400,chr11,117016306,117016400,0,33850756
IMR90|chr11:83281058-83281155,chr11,83281058,83281155,IMR90|chr11:93470637-93470692,chr11,93470637,93470692,0,10189579
IMR90|chr11:83337844-83337874,chr11,83337844,83337874,IMR90|chr11:66054766-66054852,chr11,66054766,66054852,0,17283078
IMR90|chr11:83371006-83371066,chr11,83371006,83371066,IMR90|chr11:12027864-12027978,chr11,12027864,12027978,0,71343142
IMR90|chr11:83446679-83446744,chr11,83446679,83446744,IMR90|chr11:65664632-65664699,chr11,65664632,65664699,0,17782047
IMR90|chr11:83581677-83581821,chr11,83581677,83581821,IMR90|chr11:796659-796694,chr11,796659,796694,0,82785018
IMR90|chr11:83651876-83651907,chr11,83651876,83651907,IMR90|chr11:65219633-65219752,chr11,65219633,65219752,0,18432243
IMR90|chr11:83658053-83658180,chr11,83658053,83658180,IMR90|chr11:14378383-14378477,chr11,14378383,14378477,0,69279670
IMR90|chr11:83848408-83848440,chr11,83848408,83848440,IMR90|chr11:3396077-3396148,chr11,3396077,3396148,0,80452331
IMR90|chr11:83975369-83975400,chr11,83975369,83975400,IMR90|chr11:35162255-35162369,chr11,35162255,35162369,0,48813114
IMR90|chr11:84035364-84035409,chr11,84035364,84035409,IMR90|chr11:65478354-65478410,chr11,65478354,65478410,0,18557010
IMR90|chr11:84213805-84213922,chr11,84213805,84213922,IMR90|chr11:64946320-64946353,chr11,64946320,64946353,0,19267485
IMR90|chr11:84224513-84224544,chr11,84224513,84224544,IMR90|chr11:65032977-65033096,chr11,65032977,65033096,0,19191536
IMR90|chr11:84233769-84233861,chr11,84233769,84233861,IMR90|chr11:57531236-57531297,chr11,57531236,57531297,0,26702533
IMR90|chr11:84245548-84245598,chr11,84245548,84245598,IMR90|chr11:6501900-6501953,chr11,6501900,6501953,0,77743648
IMR90|chr11:84414754-84414844,chr11,84414754,84414844,IMR90|chr11:46142097-46142143,chr11,46142097,46142143,0,38272657
IMR90|chr11:84508698-84508805,chr11,84508698,84508805,IMR90|chr11:67809400-67809443,chr11,67809400,67809443,0,16699298
IMR90|chr11:84511993-84512045,chr11,84511993,84512045,IMR90|chr11:35548148-35548237,chr11,35548148,35548237,0,48963845
IMR90|chr11:84579916-84580008,chr11,84579916,84580008,IMR90|chr11:57531236-57531297,chr11,57531236,57531297,0,27048680
IMR90|chr11:84784918-84785024,chr11,84784918,84785024,IMR90|chr11:71937960-71937997,chr11,71937960,71937997,0,12846958
IMR90|chr11:84877822-84877919,chr11,84877822,84877919,IMR90|chr11:93470637-93470692,chr11,93470637,93470692,0,8592815
IMR90|chr11:84900481-84900591,chr11,84900481,84900591,IMR90|chr11:8704873-8704939,chr11,8704873,8704939,0,76195608
IMR90|chr11:85147967-85148041,chr11,85147967,85148041,IMR90|chr11:27912553-27912609,chr11,27912553,27912609,0,57235414
IMR90|chr11:85300619-85300738,chr11,85300619,85300738,IMR90|chr11:93473399-93473424,chr11,93473399,93473424,0,8172780
IMR90|chr11:85344784-85344907,chr11,85344784,85344907,IMR90|chr11:708444-708471,chr11,708444,708471,0,84636340
IMR90|chr11:85665692-85665741,chr11,85665692,85665741,IMR90|chr11:65288818-65288919,chr11,65288818,65288919,0,20376874
IMR90|chr11:85679239-85679297,chr11,85679239,85679297,IMR90|chr11:65033579-65033616,chr11,65033579,65033616,0,20645660
IMR90|chr11:85704000-85704059,chr11,85704000,85704059,IMR90|chr11:16761238-16761325,chr11,16761238,16761325,0,68942762
IMR90|chr11:85706027-85706091,chr11,85706027,85706091,IMR90|chr11:696501-696581,chr11,696501,696581,0,85009526
IMR90|chr11:85765750-85765834,chr11,85765750,85765834,IMR90|chr11:57091369-57091433,chr11,57091369,57091433,0,28674381
IMR90|chr11:85831763-85831789,chr11,85831763,85831789,IMR90|chr11:62312151-62312255,chr11,62312151,62312255,0,23519612
IMR90|chr11:85864630-85864661,chr11,85864630,85864661,IMR90|chr11:12134175-12134252,chr11,12134175,12134252,0,73730455
IMR90|chr11:85875219-85875267,chr11,85875219,85875267,IMR90|chr11:74695683-74695740,chr11,74695683,74695740,0,11179536
IMR90|chr11:85981832-85981898,chr11,85981832,85981898,IMR90|chr11:65665691-65665779,chr11,65665691,65665779,0,20316141
IMR90|chr11:85994014-85994096,chr11,85994014,85994096,IMR90|chr11:130764333-130764366,chr11,130764333,130764366,0,44770319
IMR90|chr11:86008444-86008503,chr11,86008444,86008503,IMR90|chr11:10478587-10478643,chr11,10478587,10478643,0,75529857
IMR90|chr11:86184704-86184723,chr11,86184704,86184723,IMR90|chr11:72523914-72524001,chr11,72523914,72524001,0,13660790
IMR90|chr11:86239290-86239351,chr11,86239290,86239351,IMR90|chr11:120082245-120082320,chr11,120082245,120082320,0,33842955
IMR90|chr11:86313775-86313808,chr11,86313775,86313808,IMR90|chr11:64886362-64886429,chr11,64886362,64886429,0,21427413
IMR90|chr11:86350500-86350532,chr11,86350500,86350532,IMR90|chr11:64106440-64106524,chr11,64106440,64106524,0,22244060
IMR90|chr11:86375043-86375090,chr11,86375043,86375090,IMR90|chr11:64850735-64850792,chr11,64850735,64850792,0,21524308
IMR90|chr11:86440064-86440107,chr11,86440064,86440107,IMR90|chr11:772571-772647,chr11,772571,772647,0,85667493
IMR90|chr11:86529381-86529477,chr11,86529381,86529477,IMR90|chr11:6501857-6501878,chr11,6501857,6501878,0,80027524
IMR90|chr11:86601158-86601239,chr11,86601158,86601239,IMR90|chr11:120209333-120209373,chr11,120209333,120209373,0,33608175
IMR90|chr11:86608221-86608244,chr11,86608221,86608244,IMR90|chr11:2401534-2401622,chr11,2401534,2401622,0,84206687
IMR90|chr11:86766693-86766769,chr11,86766693,86766769,IMR90|chr11:845127-845167,chr11,845127,845167,0,85921566
IMR90|chr11:87019816-87019893,chr11,87019816,87019893,IMR90|chr11:120209795-120209836,chr11,120209795,120209836,0,33189979
IMR90|chr11:87140353-87140401,chr11,87140353,87140401,IMR90|chr11:12132502-12132572,chr11,12132502,12132572,0,75007851
IMR90|chr11:87142743-87142858,chr11,87142743,87142858,IMR90|chr11:8699052-8699076,chr11,8699052,8699076,0,78443691
IMR90|chr11:87151512-87151553,chr11,87151512,87151553,IMR90|chr11:65078043-65078133,chr11,65078043,65078133,0,22073469
IMR90|chr11:87153093-87153152,chr11,87153093,87153152,IMR90|chr11:65338802-65338843,chr11,65338802,65338843,0,21814291
IMR90|chr11:87349382-87349437,chr11,87349382,87349437,IMR90|chr11:75276421-75276479,chr11,75276421,75276479,0,12072961
IMR90|chr11:87384024-87384101,chr11,87384024,87384101,IMR90|chr11:126222296-126222394,chr11,126222296,126222394,0,38838272
IMR90|chr11:87388797-87388859,chr11,87388797,87388859,IMR90|chr11:65379576-65379664,chr11,65379576,65379664,0,22009221
IMR90|chr11:87516639-87516664,chr11,87516639,87516664,IMR90|chr11:65031589-65031665,chr11,65031589,65031665,0,22485050
IMR90|chr11:87589159-87589284,chr11,87589159,87589284,IMR90|chr11:126224095-126224130,chr11,126224095,126224130,0,38634936
IMR90|chr11:87725431-87725479,chr11,87725431,87725479,IMR90|chr11:776001-776115,chr11,776001,776115,0,86949430
IMR90|chr11:87732658-87732696,chr11,87732658,87732696,IMR90|chr11:125036592-125036703,chr11,125036592,125036703,0,37303934
IMR90|chr11:87808426-87808471,chr11,87808426,87808471,IMR90|chr11:118790980-118791083,chr11,118790980,118791083,0,30982554
IMR90|chr11:87944683-87944738,chr11,87944683,87944738,IMR90|chr11:126858717-126858792,chr11,126858717,126858792,0,38914034
IMR90|chr11:87995569-87995623,chr11,87995569,87995623,IMR90|chr11:66609771-66609829,chr11,66609771,66609829,0,21385798
IMR90|chr11:88034505-88034594,chr11,88034505,88034594,IMR90|chr11:8705155-8705184,chr11,8705155,8705184,0,79329350
IMR90|chr11:88370802-88370883,chr11,88370802,88370883,IMR90|chr11:3397448-3397508,chr11,3397448,3397508,0,84973354
IMR90|chr11:88373765-88373788,chr11,88373765,88373788,IMR90|chr11:3398569-3398658,chr11,3398569,3398658,0,84975196
IMR90|chr11:88396274-88396306,chr11,88396274,88396306,IMR90|chr11:3396077-3396148,chr11,3396077,3396148,0,85000197
IMR90|chr11:88400873-88400997,chr11,88400873,88400997,IMR90|chr11:1891017-1891038,chr11,1891017,1891038,0,86509856
IMR90|chr11:88407889-88407942,chr11,88407889,88407942,IMR90|chr11:128388071-128388119,chr11,128388071,128388119,0,39980182
IMR90|chr11:88425163-88425212,chr11,88425163,88425212,IMR90|chr11:126222296-126222394,chr11,126222296,126222394,0,37797133
IMR90|chr11:88478716-88478790,chr11,88478716,88478790,IMR90|chr11:120208360-120208393,chr11,120208360,120208393,0,31729644
IMR90|chr11:88561256-88561349,chr11,88561256,88561349,IMR90|chr11:64853573-64853607,chr11,64853573,64853607,0,23707683
IMR90|chr11:88563828-88563922,chr11,88563828,88563922,IMR90|chr11:64103598-64103626,chr11,64103598,64103626,0,24460230
IMR90|chr11:88602681-88602759,chr11,88602681,88602759,IMR90|chr11:66026929-66026974,chr11,66026929,66026974,0,22575752
IMR90|chr11:88630983-88631010,chr11,88630983,88631010,IMR90|chr11:57532254-57532328,chr11,57532254,57532328,0,31098729
IMR90|chr11:88956210-88956241,chr11,88956210,88956241,IMR90|chr11:64020090-64020149,chr11,64020090,64020149,0,24936120
IMR90|chr11:89045928-89045964,chr11,89045928,89045964,IMR90|chr11:8700323-8700391,chr11,8700323,8700391,0,80345605
IMR90|chr11:89089513-89089582,chr11,89089513,89089582,IMR90|chr11:67158984-67159064,chr11,67158984,67159064,0,21930529
IMR90|chr11:89251328-89251389,chr11,89251328,89251389,IMR90|chr11:65082439-65082528,chr11,65082439,65082528,0,24168889
IMR90|chr11:89519601-89519653,chr11,89519601,89519653,IMR90|chr11:123064938-123065016,chr11,123064938,123065016,0,33545337
IMR90|chr11:89575797-89575897,chr11,89575797,89575897,IMR90|chr11:101785444-101785490,chr11,101785444,101785490,0,12209647
IMR90|chr11:89613964-89614040,chr11,89613964,89614040,IMR90|chr11:65082439-65082528,chr11,65082439,65082528,0,24531525
IMR90|chr11:89717565-89717616,chr11,89717565,89717616,IMR90|chr11:65407508-65407608,chr11,65407508,65407608,0,24310057
IMR90|chr11:89810575-89810695,chr11,89810575,89810695,IMR90|chr11:93473399-93473424,chr11,93473399,93473424,0,3662824
IMR90|chr11:89905638-89905734,chr11,89905638,89905734,IMR90|chr11:93473514-93473594,chr11,93473514,93473594,0,3567876
IMR90|chr11:89943929-89943975,chr11,89943929,89943975,IMR90|chr11:211867-211976,chr11,211867,211976,0,89732062
IMR90|chr11:90025214-90025279,chr11,90025214,90025279,IMR90|chr11:65663763-65663790,chr11,65663763,65663790,0,24361451
IMR90|chr11:90050443-90050531,chr11,90050443,90050531,IMR90|chr11:96122495-96122535,chr11,96122495,96122535,0,6072052
IMR90|chr11:90209910-90209960,chr11,90209910,90209960,IMR90|chr11:65407508-65407608,chr11,65407508,65407608,0,24802402
IMR90|chr11:90370195-90370278,chr11,90370195,90370278,IMR90|chr11:18610090-18610117,chr11,18610090,18610117,0,71760105
IMR90|chr11:90439161-90439223,chr11,90439161,90439223,IMR90|chr11:2403627-2403715,chr11,2403627,2403715,0,88035534
IMR90|chr11:90553085-90553193,chr11,90553085,90553193,IMR90|chr11:79149402-79149444,chr11,79149402,79149444,0,11403683
IMR90|chr11:90596384-90596471,chr11,90596384,90596471,IMR90|chr11:126224854-126224978,chr11,126224854,126224978,0,35628470
IMR90|chr11:90701505-90701605,chr11,90701505,90701605,IMR90|chr11:6496454-6496530,chr11,6496454,6496530,0,84205051
IMR90|chr11:90777253-90777283,chr11,90777253,90777283,IMR90|chr11:82869730-82869801,chr11,82869730,82869801,0,7907523
IMR90|chr11:90780030-90780081,chr11,90780030,90780081,IMR90|chr11:123064938-123065016,chr11,123064938,123065016,0,32284908
IMR90|chr11:90786774-90786873,chr11,90786774,90786873,IMR90|chr11:65030807-65030855,chr11,65030807,65030855,0,25755967
IMR90|chr11:90953334-90953399,chr11,90953334,90953399,IMR90|chr11:85778792-85778822,chr11,85778792,85778822,0,5174542
IMR90|chr11:91049989-91050050,chr11,91049989,91050050,IMR90|chr11:696501-696581,chr11,696501,696581,0,90353488
IMR90|chr11:91128626-91128674,chr11,91128626,91128674,IMR90|chr11:64850735-64850792,chr11,64850735,64850792,0,26277891
IMR90|chr11:91311317-91311352,chr11,91311317,91311352,IMR90|chr11:57531875-57531979,chr11,57531875,57531979,0,33779442
IMR90|chr11:91451291-91451375,chr11,91451291,91451375,IMR90|chr11:12111718-12111759,chr11,12111718,12111759,0,79339573
IMR90|chr11:91607753-91607829,chr11,91607753,91607829,IMR90|chr11:66053727-66053776,chr11,66053727,66053776,0,25554026
IMR90|chr11:91639800-91639910,chr11,91639800,91639910,IMR90|chr11:70050244-70050284,chr11,70050244,70050284,0,21589556
IMR90|chr11:91725739-91725783,chr11,91725739,91725783,IMR90|chr11:67809675-67809795,chr11,67809675,67809795,0,23916064
IMR90|chr11:91751883-91751943,chr11,91751883,91751943,IMR90|chr11:57546591-57546648,chr11,57546591,57546648,0,34205292
IMR90|chr11:91787054-91787107,chr11,91787054,91787107,IMR90|chr11:844036-844057,chr11,844036,844057,0,90943018
IMR90|chr11:91811558-91811614,chr11,91811558,91811614,IMR90|chr11:79149075-79149164,chr11,79149075,79149164,0,12662483
IMR90|chr11:91929048-91929117,chr11,91929048,91929117,IMR90|chr11:118779668-118779698,chr11,118779668,118779698,0,26850620
IMR90|chr11:91999063-91999098,chr11,91999063,91999098,IMR90|chr11:118781605-118781639,chr11,118781605,118781639,0,26782542
IMR90|chr11:92023262-92023289,chr11,92023262,92023289,IMR90|chr11:118888196-118888318,chr11,118888196,118888318,0,26864934
IMR90|chr11:92115161-92115303,chr11,92115161,92115303,IMR90|chr11:35165826-35165869,chr11,35165826,35165869,0,56949335
IMR90|chr11:92154605-92154636,chr11,92154605,92154636,IMR90|chr11:12134175-12134252,chr11,12134175,12134252,0,80020430
IMR90|chr11:92192894-92192998,chr11,92192894,92192998,IMR90|chr11:65664572-65664600,chr11,65664572,65664600,0,26528322
IMR90|chr11:92225032-92225072,chr11,92225032,92225072,IMR90|chr11:34127071-34127139,chr11,34127071,34127139,0,58097961
IMR90|chr11:92423505-92423539,chr11,92423505,92423539,IMR90|chr11:93464267-93464348,chr11,93464267,93464348,0,1040762
IMR90|chr11:92479397-92479463,chr11,92479397,92479463,IMR90|chr11:67156202-67156265,chr11,67156202,67156265,0,25323195
IMR90|chr11:92583528-92583618,chr11,92583528,92583618,IMR90|chr11:8705155-8705185,chr11,8705155,8705185,0,83878373
IMR90|chr11:92585231-92585303,chr11,92585231,92585303,IMR90|chr11:67137367-67137477,chr11,67137367,67137477,0,25447864
IMR90|chr11:92587731-92587776,chr11,92587731,92587776,IMR90|chr11:66054238-66054351,chr11,66054238,66054351,0,26533493
IMR90|chr11:92729827-92729855,chr11,92729827,92729855,IMR90|chr11:65217693-65217778,chr11,65217693,65217778,0,27512134
IMR90|chr11:92775731-92775775,chr11,92775731,92775775,IMR90|chr11:67008387-67008439,chr11,67008387,67008439,0,25767344
IMR90|chr11:92799951-92800009,chr11,92799951,92800009,IMR90|chr11:10878473-10878529,chr11,10878473,10878529,0,81921478
IMR90|chr11:92800314-92800367,chr11,92800314,92800367,IMR90|chr11:65097558-65097639,chr11,65097558,65097639,0,27702756
IMR90|chr11:92884916-92884952,chr11,92884916,92884952,IMR90|chr11:65220459-65220551,chr11,65220459,65220551,0,27664457
IMR90|chr11:93121646-93121668,chr11,93121646,93121668,IMR90|chr11:57533204-57533241,chr11,57533204,57533241,0,35588442
IMR90|chr11:93191997-93192053,chr11,93191997,93192053,IMR90|chr11:62494042-62494129,chr11,62494042,62494129,0,30697955
IMR90|chr11:93285128-93285208,chr11,93285128,93285208,IMR90|chr11:57531236-57531306,chr11,57531236,57531306,0,35753892
IMR90|chr11:93392161-93392236,chr11,93392161,93392236,IMR90|chr11:93470866-93470886,chr11,93470866,93470886,0,78705
IMR90|chr11:93443598-93443704,chr11,93443598,93443704,IMR90|chr11:12113017-12113063,chr11,12113017,12113063,0,81330581
IMR90|chr11:93510861-93510937,chr11,93510861,93510937,IMR90|chr11:120208142-120208165,chr11,120208142,120208165,0,26697281
IMR90|chr11:93592299-93592330,chr11,93592299,93592330,IMR90|chr11:46613110-46613220,chr11,46613110,46613220,0,46979189
IMR90|chr11:93592403-93592476,chr11,93592403,93592476,IMR90|chr11:122527589-122527628,chr11,122527589,122527628,0,28935186
IMR90|chr11:93602828-93602860,chr11,93602828,93602860,IMR90|chr11:62477556-62477665,chr11,62477556,62477665,0,31125272
IMR90|chr11:93680709-93680730,chr11,93680709,93680730,IMR90|chr11:63934792-63934855,chr11,63934792,63934855,0,29745917
IMR90|chr11:93760011-93760092,chr11,93760011,93760092,IMR90|chr11:66513908-66513972,chr11,66513908,66513972,0,27246103
IMR90|chr11:93905142-93905226,chr11,93905142,93905226,IMR90|chr11:75276611-75276664,chr11,75276611,75276664,0,18628531
IMR90|chr11:93956073-93956094,chr11,93956073,93956094,IMR90|chr11:635688-635803,chr11,635688,635803,0,93320385
IMR90|chr11:94184088-94184161,chr11,94184088,94184161,IMR90|chr11:810857-810884,chr11,810857,810884,0,93373231
IMR90|chr11:94257711-94257860,chr11,94257711,94257860,IMR90|chr11:126222313-126222437,chr11,126222313,126222437,0,31964602
IMR90|chr11:94344073-94344148,chr11,94344073,94344148,IMR90|chr11:65156526-65156580,chr11,65156526,65156580,0,29187547
IMR90|chr11:94527331-94527399,chr11,94527331,94527399,IMR90|chr11:122938735-122938815,chr11,122938735,122938815,0,28411404
IMR90|chr11:94620341-94620403,chr11,94620341,94620403,IMR90|chr11:65338802-65338843,chr11,65338802,65338843,0,29281539
IMR90|chr11:94648972-94649005,chr11,94648972,94649005,IMR90|chr11:65336951-65337039,chr11,65336951,65337039,0,29312021
IMR90|chr11:94710371-94710471,chr11,94710371,94710471,IMR90|chr11:85779446-85779487,chr11,85779446,85779487,0,8930925
IMR90|chr11:94774355-94774393,chr11,94774355,94774393,IMR90|chr11:70962007-70962117,chr11,70962007,70962117,0,23812348
IMR90|chr11:94817018-94817133,chr11,94817018,94817133,IMR90|chr11:796659-796694,chr11,796659,796694,0,94020359
IMR90|chr11:94941326-94941416,chr11,94941326,94941416,IMR90|chr11:65478713-65478747,chr11,65478713,65478747,0,29462613
IMR90|chr11:94966950-94966980,chr11,94966950,94966980,IMR90|chr11:35162256-35162369,chr11,35162256,35162369,0,59804694
IMR90|chr11:95005071-95005093,chr11,95005071,95005093,IMR90|chr11:35161901-35161975,chr11,35161901,35161975,0,59843170
IMR90|chr11:95025170-95025230,chr11,95025170,95025230,IMR90|chr11:46613883-46613933,chr11,46613883,46613933,0,48411287
IMR90|chr11:95080660-95080692,chr11,95080660,95080692,IMR90|chr11:845452-845559,chr11,845452,845559,0,94235208
IMR90|chr11:95164687-95164795,chr11,95164687,95164795,IMR90|chr11:65033144-65033197,chr11,65033144,65033197,0,30131543
IMR90|chr11:95376784-95376830,chr11,95376784,95376830,IMR90|chr11:821989-822085,chr11,821989,822085,0,94554795
IMR90|chr11:95504167-95504257,chr11,95504167,95504257,IMR90|chr11:65096332-65096392,chr11,65096332,65096392,0,30407835
IMR90|chr11:95687667-95687742,chr11,95687667,95687742,IMR90|chr11:65288555-65288630,chr11,65288555,65288630,0,30399112
IMR90|chr11:95860134-95860229,chr11,95860134,95860229,IMR90|chr11:57548937-57548983,chr11,57548937,57548983,0,38311197
IMR90|chr11:95875221-95875244,chr11,95875221,95875244,IMR90|chr11:63934801-63934857,chr11,63934801,63934857,0,31940420
IMR90|chr11:96039613-96039714,chr11,96039613,96039714,IMR90|chr11:101785444-101785490,chr11,101785444,101785490,0,5745831
IMR90|chr11:96051760-96051786,chr11,96051760,96051786,IMR90|chr11:126222313-126222437,chr11,126222313,126222437,0,30170553
IMR90|chr11:96163987-96164039,chr11,96163987,96164039,IMR90|chr11:12133037-12133097,chr11,12133037,12133097,0,84030950
IMR90|chr11:96218665-96218777,chr11,96218665,96218777,IMR90|chr11:67138101-67138178,chr11,67138101,67138178,0,29080564
IMR90|chr11:96246914-96246998,chr11,96246914,96246998,IMR90|chr11:3399207-3399233,chr11,3399207,3399233,0,92847707
IMR90|chr11:96366192-96366228,chr11,96366192,96366228,IMR90|chr11:35164947-35165048,chr11,35164947,35165048,0,61201245
IMR90|chr11:96395559-96395580,chr11,96395559,96395580,IMR90|chr11:75276771-75276878,chr11,75276771,75276878,0,21118788
IMR90|chr11:96435032-96435081,chr11,96435032,96435081,IMR90|chr11:124931611-124931712,chr11,124931611,124931712,0,28496579
IMR90|chr11:96548183-96548259,chr11,96548183,96548259,IMR90|chr11:65082439-65082528,chr11,65082439,65082528,0,31465744
IMR90|chr11:96605828-96605917,chr11,96605828,96605917,IMR90|chr11:65664002-65664036,chr11,65664002,65664036,0,30941826
IMR90|chr11:96621233-96621295,chr11,96621233,96621295,IMR90|chr11:85778792-85778822,chr11,85778792,85778822,0,10842441
IMR90|chr11:96676116-96676258,chr11,96676116,96676258,IMR90|chr11:35165826-35165869,chr11,35165826,35165869,0,61510290
IMR90|chr11:96695339-96695377,chr11,96695339,96695377,IMR90|chr11:8700323-8700391,chr11,8700323,8700391,0,87995016
IMR90|chr11:96781861-96781993,chr11,96781861,96781993,IMR90|chr11:62474293-62474311,chr11,62474293,62474311,0,34307568
IMR90|chr11:96790310-96790339,chr11,96790310,96790339,IMR90|chr11:65656917-65657013,chr11,65656917,65657013,0,31133393
IMR90|chr11:96807376-96807439,chr11,96807376,96807439,IMR90|chr11:62304202-62304277,chr11,62304202,62304277,0,34503174
IMR90|chr11:97048294-97048366,chr11,97048294,97048366,IMR90|chr11:35162436-35162474,chr11,35162436,35162474,0,61885858
IMR90|chr11:97148079-97148102,chr11,97148079,97148102,IMR90|chr11:17095140-17095264,chr11,17095140,17095264,0,80052939
IMR90|chr11:97168908-97168977,chr11,97168908,97168977,IMR90|chr11:66610194-66610273,chr11,66610194,66610273,0,30558714
IMR90|chr11:97346774-97346863,chr11,97346774,97346863,IMR90|chr11:18547863-18547934,chr11,18547863,18547934,0,78798911
IMR90|chr11:97379678-97379743,chr11,97379678,97379743,IMR90|chr11:66055004-66055078,chr11,66055004,66055078,0,31324674
IMR90|chr11:97391438-97391553,chr11,97391438,97391553,IMR90|chr11:118661277-118661316,chr11,118661277,118661316,0,21269839
IMR90|chr11:97464829-97464902,chr11,97464829,97464902,IMR90|chr11:291632-291713,chr11,291632,291713,0,97173197
IMR90|chr11:97497592-97497613,chr11,97497592,97497613,IMR90|chr11:126220891-126220952,chr11,126220891,126220952,0,28723299
IMR90|chr11:97781857-97781939,chr11,97781857,97781939,IMR90|chr11:12111718-12111759,chr11,12111718,12111759,0,85670139
IMR90|chr11:97852459-97852518,chr11,97852459,97852518,IMR90|chr11:10478587-10478643,chr11,10478587,10478643,0,87373872
IMR90|chr11:97858608-97858753,chr11,97858608,97858753,IMR90|chr11:62474293-62474311,chr11,62474293,62474311,0,35384315
IMR90|chr11:97878342-97878389,chr11,97878342,97878389,IMR90|chr11:60611909-60611976,chr11,60611909,60611976,0,37266433
IMR90|chr11:97903461-97903497,chr11,97903461,97903497,IMR90|chr11:60611631-60611745,chr11,60611631,60611745,0,37291830
IMR90|chr11:97958350-97958400,chr11,97958350,97958400,IMR90|chr11:62479459-62479573,chr11,62479459,62479573,0,35478891
IMR90|chr11:98065428-98065475,chr11,98065428,98065475,IMR90|chr11:117016803-117016826,chr11,117016803,117016826,0,18951375
IMR90|chr11:98078323-98078354,chr11,98078323,98078354,IMR90|chr11:62493807-62493884,chr11,62493807,62493884,0,35584516
IMR90|chr11:98099746-98099803,chr11,98099746,98099803,IMR90|chr11:16761238-16761325,chr11,16761238,16761325,0,81338508
IMR90|chr11:98115053-98115127,chr11,98115053,98115127,IMR90|chr11:74695930-74696006,chr11,74695930,74696006,0,23419123
IMR90|chr11:98240980-98241069,chr11,98240980,98241069,IMR90|chr11:93471936-93471997,chr11,93471936,93471997,0,4769044
IMR90|chr11:98247440-98247534,chr11,98247440,98247534,IMR90|chr11:64103598-64103626,chr11,64103598,64103626,0,34143842
IMR90|chr11:98497089-98497187,chr11,98497089,98497187,IMR90|chr11:65100693-65100745,chr11,65100693,65100745,0,33396396
IMR90|chr11:98508043-98508090,chr11,98508043,98508090,IMR90|chr11:46302529-46302650,chr11,46302529,46302650,0,52205514
IMR90|chr11:98543416-98543465,chr11,98543416,98543465,IMR90|chr11:57547894-57547973,chr11,57547894,57547973,0,40995522
IMR90|chr11:98582144-98582192,chr11,98582144,98582192,IMR90|chr11:64850735-64850792,chr11,64850735,64850792,0,33731409
IMR90|chr11:98757712-98757752,chr11,98757712,98757752,IMR90|chr11:64110416-64110458,chr11,64110416,64110458,0,34647296
IMR90|chr11:98775389-98775475,chr11,98775389,98775475,IMR90|chr11:65099308-65099372,chr11,65099308,65099372,0,33676081
IMR90|chr11:98900290-98900395,chr11,98900290,98900395,IMR90|chr11:57546803-57546844,chr11,57546803,57546844,0,41353487
IMR90|chr11:98913129-98913170,chr11,98913129,98913170,IMR90|chr11:64110401-64110457,chr11,64110401,64110457,0,34802728
IMR90|chr11:98965403-98965440,chr11,98965403,98965440,IMR90|chr11:126225363-126225397,chr11,126225363,126225397,0,27259960
IMR90|chr11:98975823-98975890,chr11,98975823,98975890,IMR90|chr11:120208647-120208691,chr11,120208647,120208691,0,21232824
IMR90|chr11:98978531-98978577,chr11,98978531,98978577,IMR90|chr11:67809602-67809684,chr11,67809602,67809684,0,31168929
IMR90|chr11:98987354-98987434,chr11,98987354,98987434,IMR90|chr11:65666488-65666572,chr11,65666488,65666572,0,33320866
IMR90|chr11:99060576-99060650,chr11,99060576,99060650,IMR90|chr11:6496454-6496530,chr11,6496454,6496530,0,92564122
IMR90|chr11:99104713-99104744,chr11,99104713,99104744,IMR90|chr11:35162255-35162369,chr11,35162255,35162369,0,63942458
IMR90|chr11:99129628-99129681,chr11,99129628,99129681,IMR90|chr11:70054648-70054744,chr11,70054648,70054744,0,29074980
IMR90|chr11:99158148-99158188,chr11,99158148,99158188,IMR90|chr11:2402710-2402787,chr11,2402710,2402787,0,96755438
IMR90|chr11:99162549-99162598,chr11,99162549,99162598,IMR90|chr11:124931611-124931712,chr11,124931611,124931712,0,25769062
IMR90|chr11:99212752-99212829,chr11,99212752,99212829,IMR90|chr11:66026929-66026974,chr11,66026929,66026974,0,33185823
IMR90|chr11:99277412-99277439,chr11,99277412,99277439,IMR90|chr11:82869730-82869804,chr11,82869730,82869804,0,16407682
IMR90|chr11:99358693-99358757,chr11,99358693,99358757,IMR90|chr11:65406484-65406517,chr11,65406484,65406517,0,33952209
IMR90|chr11:99381276-99381352,chr11,99381276,99381352,IMR90|chr11:85779100-85779172,chr11,85779100,85779172,0,13602176
IMR90|chr11:99489658-99489788,chr11,99489658,99489788,IMR90|chr11:65030176-65030196,chr11,65030176,65030196,0,34459482
IMR90|chr11:99580243-99580305,chr11,99580243,99580305,IMR90|chr11:75110715-75110846,chr11,75110715,75110846,0,24469528
IMR90|chr11:99708491-99708535,chr11,99708491,99708535,IMR90|chr11:71935067-71935170,chr11,71935067,71935170,0,27773424
IMR90|chr11:99720890-99721002,chr11,99720890,99721002,IMR90|chr11:67138101-67138178,chr11,67138101,67138178,0,32582789
IMR90|chr11:99826631-99826658,chr11,99826631,99826658,IMR90|chr11:77899267-77899343,chr11,77899267,77899343,0,21927364
IMR90|chr11:99860189-99860240,chr11,99860189,99860240,IMR90|chr11:291445-291522,chr11,291445,291522,0,99568744
IMR90|chr11:99879142-99879197,chr11,99879142,99879197,IMR90|chr11:57546153-57546250,chr11,57546153,57546250,0,42332989
IMR90|chr11:99941602-99941647,chr11,99941602,99941647,IMR90|chr11:8700302-8700437,chr11,8700302,8700437,0,91241300
IMR90|chr11:99944032-99944076,chr11,99944032,99944076,IMR90|chr11:67008387-67008439,chr11,67008387,67008439,0,32935645
IMR90|chr11:99957075-99957162,chr11,99957075,99957162,IMR90|chr11:34124818-34124880,chr11,34124818,34124880,0,65832257
IMR90|chr11:100007957-100007995,chr11,100007957,100007995,IMR90|chr11:64886695-64886765,chr11,64886695,64886765,0,35121262
IMR90|chr11:100054123-100054205,chr11,100054123,100054205,IMR90|chr11:18610090-18610117,chr11,18610090,18610117,0,81444033
IMR90|chr11:100100301-100100366,chr11,100100301,100100366,IMR90|chr11:291445-291522,chr11,291445,291522,0,99808856
IMR90|chr11:100135525-100135643,chr11,100135525,100135643,IMR90|chr11:118794198-118794232,chr11,118794198,118794232,0,18658673
IMR90|chr11:100206736-100206773,chr11,100206736,100206773,IMR90|chr11:126225363-126225397,chr11,126225363,126225397,0,26018627
IMR90|chr11:100262268-100262342,chr11,100262268,100262342,IMR90|chr11:122527589-122527628,chr11,122527589,122527628,0,22265321
IMR90|chr11:100585320-100585385,chr11,100585320,100585385,IMR90|chr11:123063287-123063330,chr11,123063287,123063330,0,22477967
IMR90|chr11:100595914-100595964,chr11,100595914,100595964,IMR90|chr11:17098436-17098493,chr11,17098436,17098493,0,83497478
IMR90|chr11:100602617-100602704,chr11,100602617,100602704,IMR90|chr11:118793191-118793237,chr11,118793191,118793237,0,18190574
IMR90|chr11:100628445-100628501,chr11,100628445,100628501,IMR90|chr11:14382792-14382852,chr11,14382792,14382852,0,86245653
IMR90|chr11:100652358-100652393,chr11,100652358,100652393,IMR90|chr11:65082439-65082528,chr11,65082439,65082528,0,35569919
IMR90|chr11:100817462-100817612,chr11,100817462,100817612,IMR90|chr11:62325322-62325388,chr11,62325322,62325388,0,38492140
IMR90|chr11:100865413-100865449,chr11,100865413,100865449,IMR90|chr11:8711788-8711854,chr11,8711788,8711854,0,92153625
IMR90|chr11:100885920-100885961,chr11,100885920,100885961,IMR90|chr11:62649710-62649815,chr11,62649710,62649815,0,38236210
IMR90|chr11:101048008-101048074,chr11,101048008,101048074,IMR90|chr11:67156202-67156265,chr11,67156202,67156265,0,33891806
IMR90|chr11:101148268-101148299,chr11,101148268,101148299,IMR90|chr11:102218789-102218807,chr11,102218789,102218807,0,1070521
IMR90|chr11:101182372-101182415,chr11,101182372,101182415,IMR90|chr11:64944649-64944718,chr11,64944649,64944718,0,36237723
IMR90|chr11:101237559-101237589,chr11,101237559,101237589,IMR90|chr11:27720725-27720809,chr11,27720725,27720809,0,73516834
IMR90|chr11:101461694-101461789,chr11,101461694,101461789,IMR90|chr11:96073281-96073306,chr11,96073281,96073306,0,5388413
IMR90|chr11:101463082-101463169,chr11,101463082,101463169,IMR90|chr11:118793191-118793237,chr11,118793191,118793237,0,17330109
IMR90|chr11:101673863-101673914,chr11,101673863,101673914,IMR90|chr11:57089947-57090005,chr11,57089947,57090005,0,44583916
IMR90|chr11:101678395-101678446,chr11,101678395,101678446,IMR90|chr11:821421-821475,chr11,821421,821475,0,100856974
IMR90|chr11:101762182-101762289,chr11,101762182,101762289,IMR90|chr11:35165826-35165869,chr11,35165826,35165869,0,66596356
IMR90|chr11:101885545-101885605,chr11,101885545,101885605,IMR90|chr11:57546591-57546648,chr11,57546591,57546648,0,44338954
IMR90|chr11:101981857-101981915,chr11,101981857,101981915,IMR90|chr11:62311246-62311332,chr11,62311246,62311332,0,39670611
IMR90|chr11:101992073-101992142,chr11,101992073,101992142,IMR90|chr11:67158984-67159064,chr11,67158984,67159064,0,34833089
IMR90|chr11:101995824-101995869,chr11,101995824,101995869,IMR90|chr11:66054238-66054351,chr11,66054238,66054351,0,35941586
IMR90|chr11:102069331-102069396,chr11,102069331,102069396,IMR90|chr11:291445-291522,chr11,291445,291522,0,101777886
IMR90|chr11:102080507-102080565,chr11,102080507,102080565,IMR90|chr11:65287867-65287926,chr11,65287867,65287926,0,36792640
IMR90|chr11:102385908-102385988,chr11,102385908,102385988,IMR90|chr11:71937872-71937963,chr11,71937872,71937963,0,30448036
IMR90|chr11:102412764-102412805,chr11,102412764,102412805,IMR90|chr11:125036592-125036703,chr11,125036592,125036703,0,22623828
IMR90|chr11:102488971-102489033,chr11,102488971,102489033,IMR90|chr11:65664759-65664778,chr11,65664759,65664778,0,36824212
IMR90|chr11:102567564-102567613,chr11,102567564,102567613,IMR90|chr11:3399654-3399755,chr11,3399654,3399755,0,99167910
IMR90|chr11:102601033-102601145,chr11,102601033,102601145,IMR90|chr11:8699484-8699522,chr11,8699484,8699522,0,93901549
IMR90|chr11:102620823-102620855,chr11,102620823,102620855,IMR90|chr11:65336951-65337039,chr11,65336951,65337039,0,37283872
IMR90|chr11:102644017-102644071,chr11,102644017,102644071,IMR90|chr11:65032977-65033096,chr11,65032977,65033096,0,37611040
IMR90|chr11:103056154-103056193,chr11,103056154,103056193,IMR90|chr11:8699020-8699128,chr11,8699020,8699128,0,94357134
IMR90|chr11:103063115-103063194,chr11,103063115,103063194,IMR90|chr11:17230538-17230648,chr11,17230538,17230648,0,85832577
IMR90|chr11:103158799-103158844,chr11,103158799,103158844,IMR90|chr11:67136781-67136845,chr11,67136781,67136845,0,36022018
IMR90|chr11:103365468-103365546,chr11,103365468,103365546,IMR90|chr11:65288481-65288510,chr11,65288481,65288510,0,38076987
IMR90|chr11:103404482-103404528,chr11,103404482,103404528,IMR90|chr11:12133870-12133972,chr11,12133870,12133972,0,91270612
IMR90|chr11:103415033-103415100,chr11,103415033,103415100,IMR90|chr11:79150527-79150572,chr11,79150527,79150572,0,24264506
IMR90|chr11:103422553-103422571,chr11,103422553,103422571,IMR90|chr11:67157335-67157447,chr11,67157335,67157447,0,36265218
IMR90|chr11:103423225-103423339,chr11,103423225,103423339,IMR90|chr11:122938735-122938815,chr11,122938735,122938815,0,19515510
IMR90|chr11:103867151-103867240,chr11,103867151,103867240,IMR90|chr11:8705155-8705184,chr11,8705155,8705184,0,95161996
IMR90|chr11:103982007-103982072,chr11,103982007,103982072,IMR90|chr11:85778792-85778822,chr11,85778792,85778822,0,18203215
IMR90|chr11:104094720-104094743,chr11,104094720,104094743,IMR90|chr11:65217978-65218095,chr11,65217978,65218095,0,38876742
IMR90|chr11:104346026-104346093,chr11,104346026,104346093,IMR90|chr11:120208647-120208691,chr11,120208647,120208691,0,15862621
IMR90|chr11:104353361-104353447,chr11,104353361,104353447,IMR90|chr11:35164947-35165048,chr11,35164947,35165048,0,69188414
IMR90|chr11:104437555-104437613,chr11,104437555,104437613,IMR90|chr11:16761238-16761325,chr11,16761238,16761325,0,87676317
IMR90|chr11:104448523-104448582,chr11,104448523,104448582,IMR90|chr11:72433658-72433692,chr11,72433658,72433692,0,32014865
IMR90|chr11:104488266-104488297,chr11,104488266,104488297,IMR90|chr11:46613110-46613220,chr11,46613110,46613220,0,57875156
IMR90|chr11:104515155-104515197,chr11,104515155,104515197,IMR90|chr11:633992-634062,chr11,633992,634062,0,103881163
IMR90|chr11:104533511-104533555,chr11,104533511,104533555,IMR90|chr11:71935067-71935170,chr11,71935067,71935170,0,32598444
IMR90|chr11:104588032-104588143,chr11,104588032,104588143,IMR90|chr11:120210021-120210060,chr11,120210021,120210060,0,15621989
IMR90|chr11:104628458-104628500,chr11,104628458,104628500,IMR90|chr11:118888196-118888318,chr11,118888196,118888318,0,14259738
IMR90|chr11:104707589-104707611,chr11,104707589,104707611,IMR90|chr11:96122495-96122544,chr11,96122495,96122544,0,8585094
IMR90|chr11:104781487-104781578,chr11,104781487,104781578,IMR90|chr11:12113017-12113063,chr11,12113017,12113063,0,92668470
IMR90|chr11:104821757-104821847,chr11,104821757,104821847,IMR90|chr11:65478713-65478747,chr11,65478713,65478747,0,39343044
IMR90|chr11:105112178-105112200,chr11,105112178,105112200,IMR90|chr11:96122495-96122544,chr11,96122495,96122544,0,8989683
IMR90|chr11:105121072-105121107,chr11,105121072,105121107,IMR90|chr11:118781605-118781639,chr11,118781605,118781639,0,13660533
IMR90|chr11:105164260-105164282,chr11,105164260,105164282,IMR90|chr11:57533204-57533241,chr11,57533204,57533241,0,47631056
IMR90|chr11:105219434-105219462,chr11,105219434,105219462,IMR90|chr11:65336951-65337039,chr11,65336951,65337039,0,39882483
IMR90|chr11:105246424-105246463,chr11,105246424,105246463,IMR90|chr11:62304603-62304695,chr11,62304603,62304695,0,42941821
IMR90|chr11:105541242-105541280,chr11,105541242,105541280,IMR90|chr11:125036592-125036703,chr11,125036592,125036703,0,19495350
IMR90|chr11:105566665-105566710,chr11,105566665,105566710,IMR90|chr11:65407087-65407185,chr11,65407087,65407185,0,40159578
IMR90|chr11:105573811-105573845,chr11,105573811,105573845,IMR90|chr11:126858717-126858792,chr11,126858717,126858792,0,21284906
IMR90|chr11:105609934-105610040,chr11,105609934,105610040,IMR90|chr11:65664572-65664600,chr11,65664572,65664600,0,39945362
IMR90|chr11:105629041-105629142,chr11,105629041,105629142,IMR90|chr11:122928925-122928958,chr11,122928925,122928958,0,17299884
IMR90|chr11:105743552-105743630,chr11,105743552,105743630,IMR90|chr11:3181528-3181578,chr11,3181528,3181578,0,102562024
IMR90|chr11:105915036-105915112,chr11,105915036,105915112,IMR90|chr11:85779100-85779172,chr11,85779100,85779172,0,20135936
IMR90|chr11:106040871-106040912,chr11,106040871,106040912,IMR90|chr11:27718789-27718876,chr11,27718789,27718876,0,78322082
IMR90|chr11:106147961-106147998,chr11,106147961,106147998,IMR90|chr11:8700302-8700437,chr11,8700302,8700437,0,97447659
IMR90|chr11:106295946-106296096,chr11,106295946,106296096,IMR90|chr11:17098430-17098469,chr11,17098430,17098469,0,89197516
IMR90|chr11:106458086-106458200,chr11,106458086,106458200,IMR90|chr11:64692810-64692843,chr11,64692810,64692843,0,41765276
IMR90|chr11:106461253-106461302,chr11,106461253,106461302,IMR90|chr11:6501900-6501953,chr11,6501900,6501953,0,99959353
IMR90|chr11:106634324-106634384,chr11,106634324,106634384,IMR90|chr11:3117116-3117134,chr11,3117116,3117134,0,103517208
IMR90|chr11:106870121-106870203,chr11,106870121,106870203,IMR90|chr11:18610090-18610117,chr11,18610090,18610117,0,88260031
IMR90|chr11:106884678-106884758,chr11,106884678,106884758,IMR90|chr11:65083473-65083496,chr11,65083473,65083496,0,41801205
IMR90|chr11:106927618-106927674,chr11,106927618,106927674,IMR90|chr11:79149075-79149164,chr11,79149075,79149164,0,27778543
IMR90|chr11:106967077-106967110,chr11,106967077,106967110,IMR90|chr11:34125794-34125868,chr11,34125794,34125868,0,72841283
IMR90|chr11:107005816-107005882,chr11,107005816,107005882,IMR90|chr11:60614871-60614897,chr11,60614871,60614897,0,46390945
IMR90|chr11:107226078-107226189,chr11,107226078,107226189,IMR90|chr11:120210021-120210060,chr11,120210021,120210060,0,12983943
IMR90|chr11:107322514-107322554,chr11,107322514,107322554,IMR90|chr11:46613110-46613220,chr11,46613110,46613220,0,60709404
IMR90|chr11:107348144-107348175,chr11,107348144,107348175,IMR90|chr11:117016306-117016400,chr11,117016306,117016400,0,9668162
IMR90|chr11:107463513-107463606,chr11,107463513,107463606,IMR90|chr11:36531129-36531178,chr11,36531129,36531178,0,70932384
IMR90|chr11:107470449-107470508,chr11,107470449,107470508,IMR90|chr11:3399654-3399755,chr11,3399654,3399755,0,104070795
IMR90|chr11:107583686-107583776,chr11,107583686,107583776,IMR90|chr11:65217947-65218029,chr11,65217947,65218029,0,42365739
IMR90|chr11:107612359-107612428,chr11,107612359,107612428,IMR90|chr11:75276568-75276634,chr11,75276568,75276634,0,32335791
IMR90|chr11:107681595-107681646,chr11,107681595,107681646,IMR90|chr11:57089947-57090005,chr11,57089947,57090005,0,50591648
IMR90|chr11:107720382-107720433,chr11,107720382,107720433,IMR90|chr11:291445-291522,chr11,291445,291522,0,107428937
IMR90|chr11:107803118-107803159,chr11,107803118,107803159,IMR90|chr11:57529886-57529934,chr11,57529886,57529934,0,50273232
IMR90|chr11:107847281-107847310,chr11,107847281,107847310,IMR90|chr11:3396076-3396148,chr11,3396076,3396148,0,104451205
IMR90|chr11:108138050-108138150,chr11,108138050,108138150,IMR90|chr11:85779446-85779487,chr11,85779446,85779487,0,22358604
IMR90|chr11:108206118-108206195,chr11,108206118,108206195,IMR90|chr11:57508696-57508737,chr11,57508696,57508737,0,50697422
IMR90|chr11:108268977-108269015,chr11,108268977,108269015,IMR90|chr11:57546947-57546977,chr11,57546947,57546977,0,50722030
IMR90|chr11:108554291-108554341,chr11,108554291,108554341,IMR90|chr11:65667459-65667520,chr11,65667459,65667520,0,42886832
IMR90|chr11:108598010-108598065,chr11,108598010,108598065,IMR90|chr11:93467543-93467595,chr11,93467543,93467595,0,15130467
IMR90|chr11:108620822-108620899,chr11,108620822,108620899,IMR90|chr11:102961875-102961918,chr11,102961875,102961918,0,5658947
IMR90|chr11:108627884-108628023,chr11,108627884,108628023,IMR90|chr11:35548158-35548245,chr11,35548158,35548245,0,73079726
IMR90|chr11:108652839-108652936,chr11,108652839,108652936,IMR90|chr11:10878468-10878529,chr11,10878468,10878529,0,97774371
IMR90|chr11:108656647-108656726,chr11,108656647,108656726,IMR90|chr11:65347176-65347208,chr11,65347176,65347208,0,43309471
IMR90|chr11:108700993-108701072,chr11,108700993,108701072,IMR90|chr11:18547863-18547934,chr11,18547863,18547934,0,90153130
IMR90|chr11:108757167-108757237,chr11,108757167,108757237,IMR90|chr11:93474278-93474385,chr11,93474278,93474385,0,15282889
IMR90|chr11:108769834-108769904,chr11,108769834,108769904,IMR90|chr11:47619591-47619626,chr11,47619591,47619626,0,61150243
IMR90|chr11:108798454-108798546,chr11,108798454,108798546,IMR90|chr11:65156496-65156523,chr11,65156496,65156523,0,43641958
IMR90|chr11:108880089-108880209,chr11,108880089,108880209,IMR90|chr11:64886908-64886938,chr11,64886908,64886938,0,43993181
IMR90|chr11:108880353-108880391,chr11,108880353,108880391,IMR90|chr11:117050785-117050897,chr11,117050785,117050897,0,8170432
IMR90|chr11:109051742-109051770,chr11,109051742,109051770,IMR90|chr11:65217693-65217778,chr11,65217693,65217778,0,43834049
IMR90|chr11:109170703-109170760,chr11,109170703,109170760,IMR90|chr11:123062437-123062472,chr11,123062437,123062472,0,13891734
IMR90|chr11:109172005-109172040,chr11,109172005,109172040,IMR90|chr11:118479819-118479961,chr11,118479819,118479961,0,9307814
IMR90|chr11:109199105-109199144,chr11,109199105,109199144,IMR90|chr11:67137367-67137477,chr11,67137367,67137477,0,42061738
IMR90|chr11:109277379-109277437,chr11,109277379,109277437,IMR90|chr11:123061014-123061078,chr11,123061014,123061078,0,13783635
IMR90|chr11:109345750-109345776,chr11,109345750,109345776,IMR90|chr11:57091292-57091438,chr11,57091292,57091438,0,52254458
IMR90|chr11:109348434-109348507,chr11,109348434,109348507,IMR90|chr11:291632-291713,chr11,291632,291713,0,109056802
IMR90|chr11:109353437-109353533,chr11,109353437,109353533,IMR90|chr11:65033144-65033197,chr11,65033144,65033197,0,44320293
IMR90|chr11:109407690-109407710,chr11,109407690,109407710,IMR90|chr11:72523914-72524001,chr11,72523914,72524001,0,36883776
IMR90|chr11:109509929-109510004,chr11,109509929,109510004,IMR90|chr11:67809400-67809443,chr11,67809400,67809443,0,41700529
IMR90|chr11:109614934-109614992,chr11,109614934,109614992,IMR90|chr11:123061014-123061078,chr11,123061014,123061078,0,13446080
IMR90|chr11:109674534-109674571,chr11,109674534,109674571,IMR90|chr11:8700302-8700437,chr11,8700302,8700437,0,100974232
IMR90|chr11:109685318-109685381,chr11,109685318,109685381,IMR90|chr11:65663635-65663705,chr11,65663635,65663705,0,44021683
IMR90|chr11:109713148-109713205,chr11,109713148,109713205,IMR90|chr11:126858717-126858792,chr11,126858717,126858792,0,17145569
IMR90|chr11:109733202-109733260,chr11,109733202,109733260,IMR90|chr11:67007042-67007134,chr11,67007042,67007134,0,42726160
IMR90|chr11:109856410-109856477,chr11,109856410,109856477,IMR90|chr11:79150527-79150572,chr11,79150527,79150572,0,30705883
IMR90|chr11:109869190-109869222,chr11,109869190,109869222,IMR90|chr11:128389509-128389598,chr11,128389509,128389598,0,18520319
IMR90|chr11:110043269-110043419,chr11,110043269,110043419,IMR90|chr11:17098430-17098469,chr11,17098430,17098469,0,92944839
IMR90|chr11:110161686-110161753,chr11,110161686,110161753,IMR90|chr11:62496597-62496623,chr11,62496597,62496623,0,47665089
IMR90|chr11:110278391-110278424,chr11,110278391,110278424,IMR90|chr11:65079463-65079580,chr11,65079463,65079580,0,45198928
IMR90|chr11:110474975-110475043,chr11,110474975,110475043,IMR90|chr11:64105810-64105846,chr11,64105810,64105846,0,46369165
IMR90|chr11:110477775-110477822,chr11,110477775,110477822,IMR90|chr11:120207137-120207239,chr11,120207137,120207239,0,9729362
IMR90|chr11:110549513-110549571,chr11,110549513,110549571,IMR90|chr11:93467034-93467110,chr11,93467034,93467110,0,17082479
IMR90|chr11:110704732-110704806,chr11,110704732,110704806,IMR90|chr11:6496454-6496530,chr11,6496454,6496530,0,104208278
IMR90|chr11:110861347-110861424,chr11,110861347,110861424,IMR90|chr11:65157052-65157089,chr11,65157052,65157089,0,45704295
IMR90|chr11:110921079-110921138,chr11,110921079,110921138,IMR90|chr11:12137365-12137422,chr11,12137365,12137422,0,98783714
IMR90|chr11:110990044-110990164,chr11,110990044,110990164,IMR90|chr11:46142097-46142143,chr11,46142097,46142143,0,64847947
IMR90|chr11:111090052-111090110,chr11,111090052,111090110,IMR90|chr11:16761238-16761325,chr11,16761238,16761325,0,94328814
IMR90|chr11:111119776-111119900,chr11,111119776,111119900,IMR90|chr11:65321510-65321532,chr11,65321510,65321532,0,45798266
IMR90|chr11:111274906-111275002,chr11,111274906,111275002,IMR90|chr11:65102565-65102605,chr11,65102565,65102605,0,46172341
IMR90|chr11:111296653-111296700,chr11,111296653,111296700,IMR90|chr11:65666717-65666867,chr11,65666717,65666867,0,45629936
IMR90|chr11:111465102-111465140,chr11,111465102,111465140,IMR90|chr11:65030861-65030969,chr11,65030861,65030969,0,46434241
IMR90|chr11:111630872-111630998,chr11,111630872,111630998,IMR90|chr11:117199879-117199902,chr11,117199879,117199902,0,5569007
IMR90|chr11:111875483-111875523,chr11,111875483,111875523,IMR90|chr11:2402710-2402787,chr11,2402710,2402787,0,109472773
IMR90|chr11:112065238-112065321,chr11,112065238,112065321,IMR90|chr11:832473-832514,chr11,832473,832514,0,111232765
IMR90|chr11:112147960-112148059,chr11,112147960,112148059,IMR90|chr11:66053727-66053776,chr11,66053727,66053776,0,46094233
IMR90|chr11:112441879-112441924,chr11,112441879,112441924,IMR90|chr11:67008387-67008439,chr11,67008387,67008439,0,45433492
IMR90|chr11:112615416-112615442,chr11,112615416,112615442,IMR90|chr11:65217978-65218095,chr11,65217978,65218095,0,47397438
IMR90|chr11:112725545-112725578,chr11,112725545,112725578,IMR90|chr11:64020065-64020149,chr11,64020065,64020149,0,48705480
IMR90|chr11:112784330-112784358,chr11,112784330,112784358,IMR90|chr11:65347302-65347367,chr11,65347302,65347367,0,47437028
IMR90|chr11:112788553-112788643,chr11,112788553,112788643,IMR90|chr11:65096332-65096392,chr11,65096332,65096392,0,47692221
IMR90|chr11:112931714-112931765,chr11,112931714,112931765,IMR90|chr11:834829-834887,chr11,834829,834887,0,112096885
IMR90|chr11:113056610-113056641,chr11,113056610,113056641,IMR90|chr11:57548538-57548670,chr11,57548538,57548670,0,55508072
IMR90|chr11:113246911-113246960,chr11,113246911,113246960,IMR90|chr11:57547894-57547973,chr11,57547894,57547973,0,55699017
IMR90|chr11:113279479-113279625,chr11,113279479,113279625,IMR90|chr11:14382792-14382852,chr11,14382792,14382852,0,98896687
IMR90|chr11:113346000-113346076,chr11,113346000,113346076,IMR90|chr11:67206067-67206141,chr11,67206067,67206141,0,46139933
IMR90|chr11:113355499-113355586,chr11,113355499,113355586,IMR90|chr11:846431-846482,chr11,846431,846482,0,112509068
IMR90|chr11:113458516-113458636,chr11,113458516,113458636,IMR90|chr11:46142097-46142143,chr11,46142097,46142143,0,67316419
IMR90|chr11:113523455-113523534,chr11,113523455,113523534,IMR90|chr11:65379576-65379664,chr11,65379576,65379664,0,48143879
IMR90|chr11:113652825-113652869,chr11,113652825,113652869,IMR90|chr11:57530091-57530144,chr11,57530091,57530144,0,56122734
IMR90|chr11:113822391-113822455,chr11,113822391,113822455,IMR90|chr11:65406484-65406517,chr11,65406484,65406517,0,48415907
IMR90|chr11:113926078-113926119,chr11,113926078,113926119,IMR90|chr11:125036592-125036703,chr11,125036592,125036703,0,11110514
IMR90|chr11:114128833-114128914,chr11,114128833,114128914,IMR90|chr11:65406716-65406748,chr11,65406716,65406748,0,48722117
IMR90|chr11:114170989-114171023,chr11,114170989,114171023,IMR90|chr11:65288851-65288931,chr11,65288851,65288931,0,48882138
IMR90|chr11:114239002-114239097,chr11,114239002,114239097,IMR90|chr11:64853573-64853607,chr11,64853573,64853607,0,49385429
IMR90|chr11:114264674-114264818,chr11,114264674,114264818,IMR90|chr11:93474276-93474390,chr11,93474276,93474390,0,20790398
IMR90|chr11:114433686-114433717,chr11,114433686,114433717,IMR90|chr11:118480086-118480236,chr11,118480086,118480236,0,4046400
IMR90|chr11:114449161-114449218,chr11,114449161,114449218,IMR90|chr11:35548158-35548245,chr11,35548158,35548245,0,78901003
IMR90|chr11:114493557-114493661,chr11,114493557,114493661,IMR90|chr11:211639-211685,chr11,211639,211685,0,114281918
IMR90|chr11:114510456-114510500,chr11,114510456,114510500,IMR90|chr11:291266-291405,chr11,291266,291405,0,114219190
IMR90|chr11:114707496-114707558,chr11,114707496,114707558,IMR90|chr11:27719801-27719842,chr11,27719801,27719842,0,86987695
IMR90|chr11:114865877-114865938,chr11,114865877,114865938,IMR90|chr11:72524500-72524527,chr11,72524500,72524527,0,42341377
IMR90|chr11:114929954-114930023,chr11,114929954,114930023,IMR90|chr11:707944-707973,chr11,707944,707973,0,114222010
IMR90|chr11:114946318-114946421,chr11,114946318,114946421,IMR90|chr11:62311374-62311408,chr11,62311374,62311408,0,52634944
IMR90|chr11:114967414-114967455,chr11,114967414,114967455,IMR90|chr11:211867-211976,chr11,211867,211976,0,114755547
IMR90|chr11:115383754-115383843,chr11,115383754,115383843,IMR90|chr11:67799211-67799260,chr11,67799211,67799260,0,47584543
IMR90|chr11:115573109-115573203,chr11,115573109,115573203,IMR90|chr11:72462455-72462492,chr11,72462455,72462492,0,43110654
IMR90|chr11:115574789-115574838,chr11,115574789,115574838,IMR90|chr11:65637881-65637999,chr11,65637881,65637999,0,49936908
IMR90|chr11:115644814-115644884,chr11,115644814,115644884,IMR90|chr11:47195768-47195808,chr11,47195768,47195808,0,68449046
IMR90|chr11:115755794-115755944,chr11,115755794,115755944,IMR90|chr11:93473206-93473327,chr11,93473206,93473327,0,22282588
IMR90|chr11:115824893-115824954,chr11,115824893,115824954,IMR90|chr11:696501-696581,chr11,696501,696581,0,115128392
IMR90|chr11:115890980-115891055,chr11,115890980,115891055,IMR90|chr11:67809400-67809443,chr11,67809400,67809443,0,48081580
IMR90|chr11:116008410-116008507,chr11,116008410,116008507,IMR90|chr11:6501857-6501878,chr11,6501857,6501878,0,109506553
IMR90|chr11:116098228-116098303,chr11,116098228,116098303,IMR90|chr11:102961875-102961918,chr11,102961875,102961918,0,13136353
IMR90|chr11:116141421-116141486,chr11,116141421,116141486,IMR90|chr11:126081857-126081934,chr11,126081857,126081934,0,9940436
IMR90|chr11:116153276-116153360,chr11,116153276,116153360,IMR90|chr11:57530854-57530907,chr11,57530854,57530907,0,58622422
IMR90|chr11:116257111-116257160,chr11,116257111,116257160,IMR90|chr11:65033547-65033608,chr11,65033547,65033608,0,51223564
IMR90|chr11:116319770-116319818,chr11,116319770,116319818,IMR90|chr11:776001-776115,chr11,776001,776115,0,115543769
IMR90|chr11:116632995-116633029,chr11,116632995,116633029,IMR90|chr11:118981051-118981126,chr11,118981051,118981126,0,2348056
IMR90|chr11:116831517-116831586,chr11,116831517,116831586,IMR90|chr11:62496597-62496623,chr11,62496597,62496623,0,54334920
IMR90|chr11:116875131-116875182,chr11,116875131,116875182,IMR90|chr11:46300707-46300753,chr11,46300707,46300753,0,70574424
IMR90|chr11:117085200-117085274,chr11,117085200,117085274,IMR90|chr11:93478870-93478935,chr11,93478870,93478935,0,23606330
IMR90|chr11:117284207-117284332,chr11,117284207,117284332,IMR90|chr11:75276567-75276590,chr11,75276567,75276590,0,42007640
IMR90|chr11:117384462-117384544,chr11,117384462,117384544,IMR90|chr11:18610090-18610117,chr11,18610090,18610117,0,98774372
IMR90|chr11:117535895-117535972,chr11,117535895,117535972,IMR90|chr11:120209795-120209836,chr11,120209795,120209836,0,2673900
IMR90|chr11:117620100-117620157,chr11,117620100,117620157,IMR90|chr11:12134412-12134496,chr11,12134412,12134496,0,105485688
IMR90|chr11:117626113-117626145,chr11,117626113,117626145,IMR90|chr11:27719801-27719842,chr11,27719801,27719842,0,89906312
IMR90|chr11:117631764-117631864,chr11,117631764,117631864,IMR90|chr11:6627485-6627514,chr11,6627485,6627514,0,111004279
IMR90|chr11:117678216-117678264,chr11,117678216,117678264,IMR90|chr11:14376220-14376324,chr11,14376220,14376324,0,103301996
IMR90|chr11:117709460-117709558,chr11,117709460,117709558,IMR90|chr11:34074831-34074870,chr11,34074831,34074870,0,83634629
IMR90|chr11:117733633-117733698,chr11,117733633,117733698,IMR90|chr11:65663763-65663790,chr11,65663763,65663790,0,52069870
IMR90|chr11:117763534-117763566,chr11,117763534,117763566,IMR90|chr11:65684205-65684323,chr11,65684205,65684323,0,52079329
IMR90|chr11:117808030-117808087,chr11,117808030,117808087,IMR90|chr11:8705459-8705492,chr11,8705459,8705492,0,109102571
IMR90|chr11:117815006-117815051,chr11,117815006,117815051,IMR90|chr11:65407087-65407185,chr11,65407087,65407185,0,52407919
IMR90|chr11:117917616-117917649,chr11,117917616,117917649,IMR90|chr11:65079463-65079580,chr11,65079463,65079580,0,52838153
IMR90|chr11:117982958-117983014,chr11,117982958,117983014,IMR90|chr11:10320406-10320484,chr11,10320406,10320484,0,107662552
IMR90|chr11:118008012-118008053,chr11,118008012,118008053,IMR90|chr11:62649710-62649815,chr11,62649710,62649815,0,55358302
IMR90|chr11:118040542-118040615,chr11,118040542,118040615,IMR90|chr11:67138101-67138178,chr11,67138101,67138178,0,50902441
IMR90|chr11:118077007-118077038,chr11,118077007,118077038,IMR90|chr11:117016306-117016400,chr11,117016306,117016400,0,1060701
IMR90|chr11:118204716-118204755,chr11,118204716,118204755,IMR90|chr11:62649706-62649815,chr11,62649706,62649815,0,55555010
IMR90|chr11:118268982-118269081,chr11,118268982,118269081,IMR90|chr11:66053727-66053776,chr11,66053727,66053776,0,52215255
IMR90|chr11:118280925-118280964,chr11,118280925,118280964,IMR90|chr11:12135501-12135612,chr11,12135501,12135612,0,106145424
IMR90|chr11:118472158-118472225,chr11,118472158,118472225,IMR90|chr11:65158146-65158169,chr11,65158146,65158169,0,53314012
IMR90|chr11:118487227-118487327,chr11,118487227,118487327,IMR90|chr11:6496454-6496530,chr11,6496454,6496530,0,111990773
IMR90|chr11:118556261-118556349,chr11,118556261,118556349,IMR90|chr11:65221411-65221520,chr11,65221411,65221520,0,53334850
IMR90|chr11:118624797-118624832,chr11,118624797,118624832,IMR90|chr11:34125794-34125868,chr11,34125794,34125868,0,84499003
IMR90|chr11:118799278-118799336,chr11,118799278,118799336,IMR90|chr11:65033579-65033616,chr11,65033579,65033616,0,53765699
IMR90|chr11:119054064-119054136,chr11,119054064,119054136,IMR90|chr11:65665975-65666047,chr11,65665975,65666047,0,53388089
IMR90|chr11:119301039-119301076,chr11,119301039,119301076,IMR90|chr11:66054238-66054351,chr11,66054238,66054351,0,53246801
IMR90|chr11:119308106-119308236,chr11,119308106,119308236,IMR90|chr11:65344422-65344442,chr11,65344422,65344442,0,53963684
IMR90|chr11:119372842-119372905,chr11,119372842,119372905,IMR90|chr11:63608075-63608105,chr11,63608075,63608105,0,55764767
IMR90|chr11:119459278-119459310,chr11,119459278,119459310,IMR90|chr11:65665269-65665349,chr11,65665269,65665349,0,53794009
IMR90|chr11:119517347-119517400,chr11,119517347,119517400,IMR90|chr11:821421-821475,chr11,821421,821475,0,118695926
IMR90|chr11:119582106-119582153,chr11,119582106,119582153,IMR90|chr11:65666717-65666867,chr11,65666717,65666867,0,53915389
IMR90|chr11:119646061-119646084,chr11,119646061,119646084,IMR90|chr11:63934801-63934857,chr11,63934801,63934857,0,55711260
IMR90|chr11:119665146-119665232,chr11,119665146,119665232,IMR90|chr11:35164947-35165048,chr11,35164947,35165048,0,84500199
IMR90|chr11:119706674-119706754,chr11,119706674,119706754,IMR90|chr11:14376327-14376384,chr11,14376327,14376384,0,105330347
IMR90|chr11:119726436-119726471,chr11,119726436,119726471,IMR90|chr11:118479819-118479961,chr11,118479819,118479961,0,1246617
IMR90|chr11:119896102-119896134,chr11,119896102,119896134,IMR90|chr11:62477556-62477665,chr11,62477556,62477665,0,57418546
IMR90|chr11:120088109-120088164,chr11,120088109,120088164,IMR90|chr11:57546153-57546250,chr11,57546153,57546250,0,62541956
IMR90|chr11:120117634-120117744,chr11,120117634,120117744,IMR90|chr11:79149402-79149444,chr11,79149402,79149444,0,40968232
IMR90|chr11:120309750-120309825,chr11,120309750,120309825,IMR90|chr11:93465431-93465578,chr11,93465431,93465578,0,26844319
IMR90|chr11:120464439-120464533,chr11,120464439,120464533,IMR90|chr11:57548937-57548983,chr11,57548937,57548983,0,62915502
IMR90|chr11:120486499-120486548,chr11,120486499,120486548,IMR90|chr11:775131-775227,chr11,775131,775227,0,119711368
IMR90|chr11:120487966-120488042,chr11,120487966,120488042,IMR90|chr11:126223442-126223516,chr11,126223442,126223516,0,5735476
IMR90|chr11:120501710-120501771,chr11,120501710,120501771,IMR90|chr11:46613883-46613933,chr11,46613883,46613933,0,73887827
IMR90|chr11:120527831-120527889,chr11,120527831,120527889,IMR90|chr11:46613110-46613220,chr11,46613110,46613220,0,73914721
IMR90|chr11:120848989-120849038,chr11,120848989,120849038,IMR90|chr11:65288818-65288919,chr11,65288818,65288919,0,55560171
IMR90|chr11:120918401-120918481,chr11,120918401,120918481,IMR90|chr11:65083473-65083496,chr11,65083473,65083496,0,55834928
IMR90|chr11:120924263-120924295,chr11,120924263,120924295,IMR90|chr11:65342898-65342964,chr11,65342898,65342964,0,55581365
IMR90|chr11:120992682-120992736,chr11,120992682,120992736,IMR90|chr11:12029101-12029184,chr11,12029101,12029184,0,108963581
IMR90|chr11:121037240-121037309,chr11,121037240,121037309,IMR90|chr11:65155227-65155271,chr11,65155227,65155271,0,55882013
IMR90|chr11:121114201-121114237,chr11,121114201,121114237,IMR90|chr11:35164947-35165048,chr11,35164947,35165048,0,85949254
IMR90|chr11:121125958-121126016,chr11,121125958,121126016,IMR90|chr11:57091339-57091431,chr11,57091339,57091431,0,64034619
IMR90|chr11:121186367-121186445,chr11,121186367,121186445,IMR90|chr11:85779100-85779172,chr11,85779100,85779172,0,35407267
IMR90|chr11:121217969-121218013,chr11,121217969,121218013,IMR90|chr11:808581-808648,chr11,808581,808648,0,120409388
IMR90|chr11:121291390-121291478,chr11,121291390,121291478,IMR90|chr11:57531254-57531310,chr11,57531254,57531310,0,63760136
IMR90|chr11:121376380-121376444,chr11,121376380,121376444,IMR90|chr11:123063210-123063297,chr11,123063210,123063297,0,1686830
IMR90|chr11:121507855-121507908,chr11,121507855,121507908,IMR90|chr11:65102625-65102670,chr11,65102625,65102670,0,56405230
IMR90|chr11:121529977-121529996,chr11,121529977,121529996,IMR90|chr11:72523914-72524001,chr11,72523914,72524001,0,49006063
IMR90|chr11:121580679-121580743,chr11,121580679,121580743,IMR90|chr11:65666797-65666829,chr11,65666797,65666829,0,55913882
IMR90|chr11:121599401-121599435,chr11,121599401,121599435,IMR90|chr11:62479459-62479573,chr11,62479459,62479573,0,59119942
IMR90|chr11:121629312-121629451,chr11,121629312,121629451,IMR90|chr11:35548158-35548245,chr11,35548158,35548245,0,86081154
IMR90|chr11:121639254-121639386,chr11,121639254,121639386,IMR90|chr11:62474293-62474311,chr11,62474293,62474311,0,59164961
IMR90|chr11:121690728-121690809,chr11,121690728,121690809,IMR90|chr11:130764333-130764366,chr11,130764333,130764366,0,9073605
IMR90|chr11:122050360-122050394,chr11,122050360,122050394,IMR90|chr11:93464267-93464348,chr11,93464267,93464348,0,28586093
IMR90|chr11:122095096-122095180,chr11,122095096,122095180,IMR90|chr11:8704873-8704939,chr11,8704873,8704939,0,113390223
IMR90|chr11:122114601-122114691,chr11,122114601,122114691,IMR90|chr11:35551001-35551079,chr11,35551001,35551079,0,86563600
IMR90|chr11:122146865-122146891,chr11,122146865,122146891,IMR90|chr11:823252-823351,chr11,823252,823351,0,121323613
IMR90|chr11:122189324-122189366,chr11,122189324,122189366,IMR90|chr11:47194655-47194693,chr11,47194655,47194693,0,74994669
IMR90|chr11:122303374-122303424,chr11,122303374,122303424,IMR90|chr11:62479459-62479573,chr11,62479459,62479573,0,59823915
IMR90|chr11:122381520-122381541,chr11,122381520,122381541,IMR90|chr11:635688-635803,chr11,635688,635803,0,121745832
IMR90|chr11:122486491-122486509,chr11,122486491,122486509,IMR90|chr11:128390602-128390713,chr11,128390602,128390713,0,5904111
IMR90|chr11:122527009-122527081,chr11,122527009,122527081,IMR90|chr11:35162436-35162474,chr11,35162436,35162474,0,87364573
IMR90|chr11:122549274-122549306,chr11,122549274,122549306,IMR90|chr11:12136524-12136604,chr11,12136524,12136604,0,110412750
IMR90|chr11:122683752-122683808,chr11,122683752,122683808,IMR90|chr11:10320406-10320484,chr11,10320406,10320484,0,112363346
IMR90|chr11:122706236-122706294,chr11,122706236,122706294,IMR90|chr11:65287867-65287926,chr11,65287867,65287926,0,57418369
IMR90|chr11:122939192-122939274,chr11,122939192,122939274,IMR90|chr11:64103598-64103626,chr11,64103598,64103626,0,58835594
IMR90|chr11:122957373-122957416,chr11,122957373,122957416,IMR90|chr11:12133870-12133972,chr11,12133870,12133972,0,110823503
IMR90|chr11:123121577-123121684,chr11,123121577,123121684,IMR90|chr11:67809400-67809443,chr11,67809400,67809443,0,55312177
IMR90|chr11:123132249-123132278,chr11,123132249,123132278,IMR90|chr11:3396077-3396148,chr11,3396077,3396148,0,119736172
IMR90|chr11:123351830-123351850,chr11,123351830,123351850,IMR90|chr11:95656535-95656619,chr11,95656535,95656619,0,27695295
IMR90|chr11:123478627-123478661,chr11,123478627,123478661,IMR90|chr11:66054023-66054173,chr11,66054023,66054173,0,57424604
IMR90|chr11:123486546-123486574,chr11,123486546,123486574,IMR90|chr11:102218645-102218708,chr11,102218645,102218708,0,21267901
IMR90|chr11:123547294-123547381,chr11,123547294,123547381,IMR90|chr11:14376327-14376384,chr11,14376327,14376384,0,109170967
IMR90|chr11:123661631-123661662,chr11,123661631,123661662,IMR90|chr11:27720727-27720807,chr11,27720727,27720807,0,95940904
IMR90|chr11:123664640-123664689,chr11,123664640,123664689,IMR90|chr11:65637881-65637999,chr11,65637881,65637999,0,58026759
IMR90|chr11:123802748-123802826,chr11,123802748,123802826,IMR90|chr11:65663807-65663844,chr11,65663807,65663844,0,58138941
IMR90|chr11:123806981-123807040,chr11,123806981,123807040,IMR90|chr11:291632-291713,chr11,291632,291713,0,123515349
IMR90|chr11:123921020-123921108,chr11,123921020,123921108,IMR90|chr11:34124818-34124880,chr11,34124818,34124880,0,89796202
IMR90|chr11:123959420-123959532,chr11,123959420,123959532,IMR90|chr11:118794198-118794232,chr11,118794198,118794232,0,5165222
IMR90|chr11:124118169-124118229,chr11,124118169,124118229,IMR90|chr11:79151889-79151956,chr11,79151889,79151956,0,44966280
IMR90|chr11:124276017-124276099,chr11,124276017,124276099,IMR90|chr11:12111718-12111759,chr11,12111718,12111759,0,112164299
IMR90|chr11:124317115-124317193,chr11,124317115,124317193,IMR90|chr11:62494832-62494873,chr11,62494832,62494873,0,61822283
IMR90|chr11:124326618-124326658,chr11,124326618,124326658,IMR90|chr11:65345677-65345789,chr11,65345677,65345789,0,58980941
IMR90|chr11:124426398-124426479,chr11,124426398,124426479,IMR90|chr11:65663549-65663602,chr11,65663549,65663602,0,58762849
IMR90|chr11:124614943-124615038,chr11,124614943,124615038,IMR90|chr11:62651800-62651838,chr11,62651800,62651838,0,61963143
IMR90|chr11:124788344-124788424,chr11,124788344,124788424,IMR90|chr11:57531236-57531306,chr11,57531236,57531306,0,67257108
IMR90|chr11:124789750-124789826,chr11,124789750,124789826,IMR90|chr11:67809881-67809964,chr11,67809881,67809964,0,56979869
IMR90|chr11:124835363-124835468,chr11,124835363,124835468,IMR90|chr11:124931611-124931712,chr11,124931611,124931712,0,96248
IMR90|chr11:124965774-124965816,chr11,124965774,124965816,IMR90|chr11:633992-634062,chr11,633992,634062,0,124331782
IMR90|chr11:124994568-124994600,chr11,124994568,124994600,IMR90|chr11:35162256-35162369,chr11,35162256,35162369,0,89832312
IMR90|chr11:125068979-125069051,chr11,125068979,125069051,IMR90|chr11:118952716-118952760,chr11,118952716,118952760,0,6116263
IMR90|chr11:125135374-125135435,chr11,125135374,125135435,IMR90|chr11:72437273-72437309,chr11,72437273,72437309,0,52698101
IMR90|chr11:125193457-125193542,chr11,125193457,125193542,IMR90|chr11:35548097-35548124,chr11,35548097,35548124,0,89645360
IMR90|chr11:125203682-125203756,chr11,125203682,125203756,IMR90|chr11:74695930-74696006,chr11,74695930,74696006,0,50507752
IMR90|chr11:125223125-125223173,chr11,125223125,125223173,IMR90|chr11:67798762-67798797,chr11,67798762,67798797,0,57424363
IMR90|chr11:125391736-125391833,chr11,125391736,125391833,IMR90|chr11:34074831-34074870,chr11,34074831,34074870,0,91316905
IMR90|chr11:125534145-125534176,chr11,125534145,125534176,IMR90|chr11:65665269-65665349,chr11,65665269,65665349,0,59868876
IMR90|chr11:125787295-125787367,chr11,125787295,125787367,IMR90|chr11:118952716-118952760,chr11,118952716,118952760,0,6834579
IMR90|chr11:125902798-125902882,chr11,125902798,125902882,IMR90|chr11:75276611-75276664,chr11,75276611,75276664,0,50626187
IMR90|chr11:125921115-125921199,chr11,125921115,125921199,IMR90|chr11:57530854-57530907,chr11,57530854,57530907,0,68390261
IMR90|chr11:126053180-126053219,chr11,126053180,126053219,IMR90|chr11:33278891-33278995,chr11,33278891,33278995,0,92774289
IMR90|chr11:126137486-126137585,chr11,126137486,126137585,IMR90|chr11:65223068-65223089,chr11,65223068,65223089,0,60914418
IMR90|chr11:126144142-126144292,chr11,126144142,126144292,IMR90|chr11:62325322-62325388,chr11,62325322,62325388,0,63818820
IMR90|chr11:126259261-126259396,chr11,126259261,126259396,IMR90|chr11:291357-291392,chr11,291357,291392,0,125967904
IMR90|chr11:126294940-126295004,chr11,126294940,126295004,IMR90|chr11:123063287-123063330,chr11,123063287,123063330,0,3231653
IMR90|chr11:126367045-126367063,chr11,126367045,126367063,IMR90|chr11:128390602-128390713,chr11,128390602,128390713,0,2023557
IMR90|chr11:126367428-126367460,chr11,126367428,126367460,IMR90|chr11:117016306-117016400,chr11,117016306,117016400,0,9351122
IMR90|chr11:126476333-126476434,chr11,126476333,126476434,IMR90|chr11:101785444-101785490,chr11,101785444,101785490,0,24690889
IMR90|chr11:126537941-126538024,chr11,126537941,126538024,IMR90|chr11:35548097-35548124,chr11,35548097,35548124,0,90989844
IMR90|chr11:126756450-126756483,chr11,126756450,126756483,IMR90|chr11:62309250-62309355,chr11,62309250,62309355,0,64447200
IMR90|chr11:126817010-126817092,chr11,126817010,126817092,IMR90|chr11:64904641-64904709,chr11,64904641,64904709,0,61912369
IMR90|chr11:126823557-126823637,chr11,126823557,126823637,IMR90|chr11:65666488-65666572,chr11,65666488,65666572,0,61157069
IMR90|chr11:126843274-126843297,chr11,126843274,126843297,IMR90|chr11:3398569-3398658,chr11,3398569,3398658,0,123444705
IMR90|chr11:126913829-126913872,chr11,126913829,126913872,IMR90|chr11:633992-634062,chr11,633992,634062,0,126279837
IMR90|chr11:126984035-126984077,chr11,126984035,126984077,IMR90|chr11:808581-808648,chr11,808581,808648,0,126175454
IMR90|chr11:127117512-127117585,chr11,127117512,127117585,IMR90|chr11:120208360-120208393,chr11,120208360,120208393,0,6909152
IMR90|chr11:127343393-127343444,chr11,127343393,127343444,IMR90|chr11:65665499-65665622,chr11,65665499,65665622,0,61677894
IMR90|chr11:127490680-127490792,chr11,127490680,127490792,IMR90|chr11:118794198-118794232,chr11,118794198,118794232,0,8696482
IMR90|chr11:127642813-127642836,chr11,127642813,127642836,IMR90|chr11:93466776-93466856,chr11,93466776,93466856,0,34176037
IMR90|chr11:127728166-127728286,chr11,127728166,127728286,IMR90|chr11:93473399-93473424,chr11,93473399,93473424,0,34254767
IMR90|chr11:127734052-127734196,chr11,127734052,127734196,IMR90|chr11:70054802-70054901,chr11,70054802,70054901,0,57679250
IMR90|chr11:127796136-127796180,chr11,127796136,127796180,IMR90|chr11:118790499-118790543,chr11,118790499,118790543,0,9005637
IMR90|chr11:127858045-127858131,chr11,127858045,127858131,IMR90|chr11:57530854-57530907,chr11,57530854,57530907,0,70327191
IMR90|chr11:127870826-127870920,chr11,127870826,127870920,IMR90|chr11:65221436-65221509,chr11,65221436,65221509,0,62649390
IMR90|chr11:127978169-127978190,chr11,127978169,127978190,IMR90|chr11:75276771-75276878,chr11,75276771,75276878,0,52701398
IMR90|chr11:128054380-128054443,chr11,128054380,128054443,IMR90|chr11:67798762-67798797,chr11,67798762,67798797,0,60255618
IMR90|chr11:128066872-128066955,chr11,128066872,128066955,IMR90|chr11:832473-832514,chr11,832473,832514,0,127234399
IMR90|chr11:128120261-128120296,chr11,128120261,128120296,IMR90|chr11:27720727-27720807,chr11,27720727,27720807,0,100399534
IMR90|chr11:128169847-128169886,chr11,128169847,128169886,IMR90|chr11:62308729-62308838,chr11,62308729,62308838,0,65861118
IMR90|chr11:128176696-128176743,chr11,128176696,128176743,IMR90|chr11:57547894-57547973,chr11,57547894,57547973,0,70628802
IMR90|chr11:128228864-128228927,chr11,128228864,128228927,IMR90|chr11:34125170-34125257,chr11,34125170,34125257,0,94103694
IMR90|chr11:128432199-128432296,chr11,128432199,128432296,IMR90|chr11:6501857-6501878,chr11,6501857,6501878,0,121930342
IMR90|chr11:128515471-128515516,chr11,128515471,128515516,IMR90|chr11:118781654-118781716,chr11,118781654,118781716,0,9733817
IMR90|chr11:128566509-128566579,chr11,128566509,128566579,IMR90|chr11:707944-707973,chr11,707944,707973,0,127858565
IMR90|chr11:128638338-128638440,chr11,128638338,128638440,IMR90|chr11:85779367-85779390,chr11,85779367,85779390,0,42858971
IMR90|chr11:128656101-128656170,chr11,128656101,128656170,IMR90|chr11:65155227-65155271,chr11,65155227,65155271,0,63500874
IMR90|chr11:128676947-128677023,chr11,128676947,128677023,IMR90|chr11:126223442-126223516,chr11,126223442,126223516,0,2453505
IMR90|chr11:128700595-128700657,chr11,128700595,128700657,IMR90|chr11:27719929-27719973,chr11,27719929,27719973,0,100980666
IMR90|chr11:128785406-128785520,chr11,128785406,128785520,IMR90|chr11:62311374-62311408,chr11,62311374,62311408,0,66474032
IMR90|chr11:128940117-128940166,chr11,128940117,128940166,IMR90|chr11:74695683-74695740,chr11,74695683,74695740,0,54244434
IMR90|chr11:128952993-128953025,chr11,128952993,128953025,IMR90|chr11:35162256-35162369,chr11,35162256,35162369,0,93790737
IMR90|chr11:128957411-128957539,chr11,128957411,128957539,IMR90|chr11:47663577-47663623,chr11,47663577,47663623,0,81293834
IMR90|chr11:129000154-129000195,chr11,129000154,129000195,IMR90|chr11:65221411-65221520,chr11,65221411,65221520,0,63778743
IMR90|chr11:129022549-129022696,chr11,129022549,129022696,IMR90|chr11:8699484-8699522,chr11,8699484,8699522,0,120323065
IMR90|chr11:129080762-129080820,chr11,129080762,129080820,IMR90|chr11:65664574-65664628,chr11,65664574,65664628,0,63416188
IMR90|chr11:129097249-129097373,chr11,129097249,129097373,IMR90|chr11:65321510-65321532,chr11,65321510,65321532,0,63775739
IMR90|chr11:129141090-129141136,chr11,129141090,129141136,IMR90|chr11:65666160-65666264,chr11,65666160,65666264,0,63474930
IMR90|chr11:129152361-129152434,chr11,129152361,129152434,IMR90|chr11:122527589-122527628,chr11,122527589,122527628,0,6624772
IMR90|chr11:129163792-129163827,chr11,129163792,129163827,IMR90|chr11:34125794-34125868,chr11,34125794,34125868,0,95037998
IMR90|chr11:129222539-129222604,chr11,129222539,129222604,IMR90|chr11:27720367-27720414,chr11,27720367,27720414,0,101502172
IMR90|chr11:129380133-129380218,chr11,129380133,129380218,IMR90|chr11:65158152-65158203,chr11,65158152,65158203,0,64221981
IMR90|chr11:129446235-129446311,chr11,129446235,129446311,IMR90|chr11:71938800-71938865,chr11,71938800,71938865,0,57507435
IMR90|chr11:129455793-129455855,chr11,129455793,129455855,IMR90|chr11:64945341-64945408,chr11,64945341,64945408,0,64510452
IMR90|chr11:129716151-129716248,chr11,129716151,129716248,IMR90|chr11:85779038-85779091,chr11,85779038,85779091,0,43937113
IMR90|chr11:129813374-129813433,chr11,129813374,129813433,IMR90|chr11:65665691-65665779,chr11,65665691,65665779,0,64147683
IMR90|chr11:129825956-129826042,chr11,129825956,129826042,IMR90|chr11:57530854-57530907,chr11,57530854,57530907,0,72295102
IMR90|chr11:129948032-129948112,chr11,129948032,129948112,IMR90|chr11:72520557-72520621,chr11,72520557,72520621,0,57427475
IMR90|chr11:129979848-129979891,chr11,129979848,129979891,IMR90|chr11:772571-772647,chr11,772571,772647,0,129207277
IMR90|chr11:129983555-129983644,chr11,129983555,129983644,IMR90|chr11:18547863-18547934,chr11,18547863,18547934,0,111435692
IMR90|chr11:130140477-130140516,chr11,130140477,130140516,IMR90|chr11:67137367-67137477,chr11,67137367,67137477,0,63003110
IMR90|chr11:130148323-130148402,chr11,130148323,130148402,IMR90|chr11:65347176-65347208,chr11,65347176,65347208,0,64801147
IMR90|chr11:130204564-130204633,chr11,130204564,130204633,IMR90|chr11:122937141-122937190,chr11,122937141,122937190,0,7267423
IMR90|chr11:130249993-130250026,chr11,130249993,130250026,IMR90|chr11:93467033-93467086,chr11,93467033,93467086,0,36782960
IMR90|chr11:130356083-130356110,chr11,130356083,130356110,IMR90|chr11:62312151-62312255,chr11,62312151,62312255,0,68043932
IMR90|chr11:130395644-130395772,chr11,130395644,130395772,IMR90|chr11:47663577-47663623,chr11,47663577,47663623,0,82732067
IMR90|chr11:130609302-130609355,chr11,130609302,130609355,IMR90|chr11:57546153-57546250,chr11,57546153,57546250,0,73063149
IMR90|chr11:130656124-130656212,chr11,130656124,130656212,IMR90|chr11:846431-846482,chr11,846431,846482,0,129809693
IMR90|chr11:130770324-130770383,chr11,130770324,130770383,IMR90|chr11:65033579-65033616,chr11,65033579,65033616,0,65736745
IMR90|chr11:130803973-130804108,chr11,130803973,130804108,IMR90|chr11:291357-291392,chr11,291357,291392,0,130512616
IMR90|chr11:130808883-130808922,chr11,130808883,130808922,IMR90|chr11:62308729-62308838,chr11,62308729,62308838,0,68500154
IMR90|chr11:130830156-130830244,chr11,130830156,130830244,IMR90|chr11:57531254-57531310,chr11,57531254,57531310,0,73298902
IMR90|chr11:130833986-130834043,chr11,130833986,130834043,IMR90|chr11:12136898-12136993,chr11,12136898,12136993,0,118697088
IMR90|chr11:130913526-130913633,chr11,130913526,130913633,IMR90|chr11:65657082-65657114,chr11,65657082,65657114,0,65256444
IMR90|chr11:131030027-131030152,chr11,131030027,131030152,IMR90|chr11:126224095-126224130,chr11,126224095,126224130,0,4805932
IMR90|chr11:131071101-131071155,chr11,131071101,131071155,IMR90|chr11:71938026-71938093,chr11,71938026,71938093,0,59133075
IMR90|chr11:131192599-131192742,chr11,131192599,131192742,IMR90|chr11:66513908-66513972,chr11,66513908,66513972,0,64678691
IMR90|chr11:131200379-131200448,chr11,131200379,131200448,IMR90|chr11:108094197-108094236,chr11,108094197,108094236,0,23106182
IMR90|chr11:131293211-131293267,chr11,131293211,131293267,IMR90|chr11:212049-212116,chr11,212049,212116,0,131081162
IMR90|chr11:131341720-131341824,chr11,131341720,131341824,IMR90|chr11:211639-211685,chr11,211639,211685,0,131130081
IMR90|chr11:131458337-131458409,chr11,131458337,131458409,IMR90|chr11:93472013-93472119,chr11,93472013,93472119,0,37986324
IMR90|chr11:131497872-131497930,chr11,131497872,131497930,IMR90|chr11:10318153-10318229,chr11,10318153,10318229,0,121179719
IMR90|chr11:131641168-131641275,chr11,131641168,131641275,IMR90|chr11:65657082-65657114,chr11,65657082,65657114,0,65984086
IMR90|chr11:131797016-131797073,chr11,131797016,131797073,IMR90|chr11:67007042-67007134,chr11,67007042,67007134,0,64789974
IMR90|chr11:131807815-131807892,chr11,131807815,131807892,IMR90|chr11:65221436-65221509,chr11,65221436,65221509,0,66586379
IMR90|chr11:131992254-131992336,chr11,131992254,131992336,IMR90|chr11:57530854-57530907,chr11,57530854,57530907,0,74461400
IMR90|chr11:132189768-132189795,chr11,132189768,132189795,IMR90|chr11:65656917-65657012,chr11,65656917,65657012,0,66532851
IMR90|chr11:132293219-132293276,chr11,132293219,132293276,IMR90|chr11:16761238-16761325,chr11,16761238,16761325,0,115531981
IMR90|chr11:132293849-132293911,chr11,132293849,132293911,IMR90|chr11:65379576-65379664,chr11,65379576,65379664,0,66914273
IMR90|chr11:132339501-132339606,chr11,132339501,132339606,IMR90|chr11:6626300-6626326,chr11,6626300,6626326,0,125713201
IMR90|chr11:132369099-132369140,chr11,132369099,132369140,IMR90|chr11:27718789-27718876,chr11,27718789,27718876,0,104650310
IMR90|chr11:132406355-132406390,chr11,132406355,132406390,IMR90|chr11:64879886-64879960,chr11,64879886,64879960,0,67526469
IMR90|chr11:132504008-132504093,chr11,132504008,132504093,IMR90|chr11:62493807-62493884,chr11,62493807,62493884,0,70010201
IMR90|chr11:132538770-132538830,chr11,132538770,132538830,IMR90|chr11:64847567-64847644,chr11,64847567,64847644,0,67691203
IMR90|chr11:132581410-132581528,chr11,132581410,132581528,IMR90|chr11:118794198-118794232,chr11,118794198,118794232,0,13787212
IMR90|chr11:132625328-132625478,chr11,132625328,132625478,IMR90|chr11:65080649-65080715,chr11,65080649,65080715,0,67544679
IMR90|chr11:132644158-132644222,chr11,132644158,132644222,IMR90|chr11:12135501-12135612,chr11,12135501,12135612,0,120508657
IMR90|chr11:132852156-132852206,chr11,132852156,132852206,IMR90|chr11:70054802-70054901,chr11,70054802,70054901,0,62797354
IMR90|chr11:132853511-132853531,chr11,132853511,132853531,IMR90|chr11:72432329-72432426,chr11,72432329,72432426,0,60421182
IMR90|chr11:132943654-132943682,chr11,132943654,132943682,IMR90|chr11:65656917-65657013,chr11,65656917,65657013,0,67286737
IMR90|chr11:133009038-133009092,chr11,133009038,133009092,IMR90|chr11:65032977-65033096,chr11,65032977,65033096,0,67976061
IMR90|chr11:133142412-133142450,chr11,133142412,133142450,IMR90|chr11:65345677-65345789,chr11,65345677,65345789,0,67796735
IMR90|chr11:133233633-133233712,chr11,133233633,133233712,IMR90|chr11:65156526-65156580,chr11,65156526,65156580,0,68077107
IMR90|chr11:133351677-133351721,chr11,133351677,133351721,IMR90|chr11:291266-291405,chr11,291266,291405,0,133060411
IMR90|chr11:133607491-133607538,chr11,133607491,133607538,IMR90|chr11:67139054-67139132,chr11,67139054,67139132,0,66468437
IMR90|chr11:133615646-133615696,chr11,133615646,133615696,IMR90|chr11:65407508-65407608,chr11,65407508,65407608,0,68208138
IMR90|chr11:133647534-133647644,chr11,133647534,133647644,IMR90|chr11:17098430-17098469,chr11,17098430,17098469,0,116549104
IMR90|chr11:133663577-133663643,chr11,133663577,133663643,IMR90|chr11:79151889-79151956,chr11,79151889,79151956,0,54511688
IMR90|chr11:133718637-133718713,chr11,133718637,133718713,IMR90|chr11:67206067-67206141,chr11,67206067,67206141,0,66512570
IMR90|chr11:133785111-133785197,chr11,133785111,133785197,IMR90|chr11:65099308-65099372,chr11,65099308,65099372,0,68685803
IMR90|chr11:133785345-133785444,chr11,133785345,133785444,IMR90|chr11:69458854-69458890,chr11,69458854,69458890,0,64326491
IMR90|chr11:133819740-133819813,chr11,133819740,133819813,IMR90|chr11:118309594-118309643,chr11,118309594,118309643,0,15510146
IMR90|chr11:133837904-133837963,chr11,133837904,133837963,IMR90|chr11:72433658-72433692,chr11,72433658,72433692,0,61404246
IMR90|chr11:134062198-134062298,chr11,134062198,134062298,IMR90|chr11:101785444-101785490,chr11,101785444,101785490,0,32276754
IMR90|chr11:134113596-134113638,chr11,134113596,134113638,IMR90|chr11:122938779-122938862,chr11,122938779,122938862,0,11174817
IMR90|chr11:134203751-134203900,chr11,134203751,134203900,IMR90|chr11:126222313-126222437,chr11,126222313,126222437,0,7981438
IMR90|chr11:134444587-134444628,chr11,134444587,134444628,IMR90|chr11:57529886-57529934,chr11,57529886,57529934,0,76914701
IMR90|chr11:134520780-134520927,chr11,134520780,134520927,IMR90|chr11:101786286-101786343,chr11,101786286,101786343,0,32734494
IMR90|chr11:134536126-134536173,chr11,134536126,134536173,IMR90|chr11:67139054-67139132,chr11,67139054,67139132,0,67397072
IMR90|chr11:134681518-134681625,chr11,134681518,134681625,IMR90|chr11:35165826-35165869,chr11,35165826,35165869,0,99515692
IMR90|chr11:134937675-134937709,chr11,134937675,134937709,IMR90|chr11:35164845-35164932,chr11,35164845,35164932,0,99772830
IMR90|chr11:134951687-134951723,chr11,134951687,134951723,IMR90|chr11:62652533-62652629,chr11,62652533,62652629,0,72299154
IMR90|chr11:135005844-135005889,chr11,135005844,135005889,IMR90|chr11:118790980-118791083,chr11,118790980,118791083,0,16214864
IMR90|chr12:64727-64793,chr12,64727,64793,IMR90|chr12:122059708-122059773,chr12,122059708,122059773,0,121994981
IMR90|chr12:233106-233173,chr12,233106,233173,IMR90|chr12:51313870-51313953,chr12,51313870,51313953,0,51080764
IMR90|chr12:378089-378192,chr12,378089,378192,IMR90|chr12:13039289-13039359,chr12,13039289,13039359,0,12661200
IMR90|chr12:384913-385000,chr12,384913,385000,IMR90|chr12:56366661-56366687,chr12,56366661,56366687,0,55981748
IMR90|chr12:433663-433708,chr12,433663,433708,IMR90|chr12:122515565-122515666,chr12,122515565,122515666,0,122081902
IMR90|chr12:558319-558386,chr12,558319,558386,IMR90|chr12:49451427-49451464,chr12,49451427,49451464,0,48893108
IMR90|chr12:600181-600282,chr12,600181,600282,IMR90|chr12:133401302-133401341,chr12,133401302,133401341,0,132801121
IMR90|chr12:1309196-1309236,chr12,1309196,1309236,IMR90|chr12:122515562-122515626,chr12,122515562,122515626,0,121206366
IMR90|chr12:1390227-1390363,chr12,1390227,1390363,IMR90|chr12:96798383-96798440,chr12,96798383,96798440,0,95408156
IMR90|chr12:1523081-1523122,chr12,1523081,1523122,IMR90|chr12:109248562-109248611,chr12,109248562,109248611,0,107725481
IMR90|chr12:1726210-1726307,chr12,1726210,1726307,IMR90|chr12:133403973-133404021,chr12,133403973,133404021,0,131677763
IMR90|chr12:1952453-1952477,chr12,1952453,1952477,IMR90|chr12:79261793-79261877,chr12,79261793,79261877,0,77309340
IMR90|chr12:2251493-2251568,chr12,2251493,2251568,IMR90|chr12:69005405-69005476,chr12,69005405,69005476,0,66753912
IMR90|chr12:2753351-2753439,chr12,2753351,2753439,IMR90|chr12:13350952-13351014,chr12,13350952,13351014,0,10597601
IMR90|chr12:2800222-2800290,chr12,2800222,2800290,IMR90|chr12:13351331-13351472,chr12,13351331,13351472,0,10551109
IMR90|chr12:2912664-2912693,chr12,2912664,2912693,IMR90|chr12:46761702-46761769,chr12,46761702,46761769,0,43849038
IMR90|chr12:3028459-3028495,chr12,3028459,3028495,IMR90|chr12:66220032-66220152,chr12,66220032,66220152,0,63191573
IMR90|chr12:3119898-3119934,chr12,3119898,3119934,IMR90|chr12:98989156-98989227,chr12,98989156,98989227,0,95869258
IMR90|chr12:3196983-3197011,chr12,3196983,3197011,IMR90|chr12:50417701-50417823,chr12,50417701,50417823,0,47220718
IMR90|chr12:3201219-3201272,chr12,3201219,3201272,IMR90|chr12:125395982-125396035,chr12,125395982,125396035,0,122194763
IMR90|chr12:3266202-3266245,chr12,3266202,3266245,IMR90|chr12:76745317-76745419,chr12,76745317,76745419,0,73479115
IMR90|chr12:3940507-3940557,chr12,3940507,3940557,IMR90|chr12:122519391-122519413,chr12,122519391,122519413,0,118578884
IMR90|chr12:4701490-4701611,chr12,4701490,4701611,IMR90|chr12:69006281-69006374,chr12,69006281,69006374,0,64304791
IMR90|chr12:4727299-4727409,chr12,4727299,4727409,IMR90|chr12:49659163-49659203,chr12,49659163,49659203,0,44931864
IMR90|chr12:4744238-4744378,chr12,4744238,4744378,IMR90|chr12:46761261-46761289,chr12,46761261,46761289,0,42017023
IMR90|chr12:4821491-4821571,chr12,4821491,4821571,IMR90|chr12:13041449-13041524,chr12,13041449,13041524,0,8219958
IMR90|chr12:5086806-5086900,chr12,5086806,5086900,IMR90|chr12:133404526-133404576,chr12,133404526,133404576,0,128317720
IMR90|chr12:5456853-5456935,chr12,5456853,5456935,IMR90|chr12:13345332-13345452,chr12,13345332,13345452,0,7888479
IMR90|chr12:5728577-5728629,chr12,5728577,5728629,IMR90|chr12:863601-863699,chr12,863601,863699,0,4864976
IMR90|chr12:5738978-5739048,chr12,5738978,5739048,IMR90|chr12:46761471-46761522,chr12,46761471,46761522,0,41022493
IMR90|chr12:5860276-5860337,chr12,5860276,5860337,IMR90|chr12:96795291-96795335,chr12,96795291,96795335,0,90935015
IMR90|chr12:6017154-6017178,chr12,6017154,6017178,IMR90|chr12:4758380-4758517,chr12,4758380,4758517,0,1258774
IMR90|chr12:6260178-6260241,chr12,6260178,6260241,IMR90|chr12:46764030-46764117,chr12,46764030,46764117,0,40503852
IMR90|chr12:6728860-6728885,chr12,6728860,6728885,IMR90|chr12:114847023-114847148,chr12,114847023,114847148,0,108118163
IMR90|chr12:6877156-6877276,chr12,6877156,6877276,IMR90|chr12:125402610-125402636,chr12,125402610,125402636,0,118525454
IMR90|chr12:7005889-7005928,chr12,7005889,7005928,IMR90|chr12:122515603-122515704,chr12,122515603,122515704,0,115509714
IMR90|chr12:7201136-7201286,chr12,7201136,7201286,IMR90|chr12:120557640-120557777,chr12,120557640,120557777,0,113356504
IMR90|chr12:7501180-7501216,chr12,7501180,7501216,IMR90|chr12:76429583-76429621,chr12,76429583,76429621,0,68928403
IMR90|chr12:8073996-8074065,chr12,8073996,8074065,IMR90|chr12:46765734-46765776,chr12,46765734,46765776,0,38691738
IMR90|chr12:8201781-8201828,chr12,8201781,8201828,IMR90|chr12:133400720-133400776,chr12,133400720,133400776,0,125198939
IMR90|chr12:8287475-8287596,chr12,8287475,8287596,IMR90|chr12:69006281-69006374,chr12,69006281,69006374,0,60718806
IMR90|chr12:8299370-8299397,chr12,8299370,8299397,IMR90|chr12:111806441-111806557,chr12,111806441,111806557,0,103507071
IMR90|chr12:8443456-8443545,chr12,8443456,8443545,IMR90|chr12:72665169-72665207,chr12,72665169,72665207,0,64221713
IMR90|chr12:8468136-8468200,chr12,8468136,8468200,IMR90|chr12:89749593-89749655,chr12,89749593,89749655,0,81281457
IMR90|chr12:8700232-8700341,chr12,8700232,8700341,IMR90|chr12:114844239-114844280,chr12,114844239,114844280,0,106144007
IMR90|chr12:8813751-8813821,chr12,8813751,8813821,IMR90|chr12:66220313-66220393,chr12,66220313,66220393,0,57406562
IMR90|chr12:9026336-9026369,chr12,9026336,9026369,IMR90|chr12:53397783-53397821,chr12,53397783,53397821,0,44371447
IMR90|chr12:9508783-9508828,chr12,9508783,9508828,IMR90|chr12:66220947-66221053,chr12,66220947,66221053,0,56712164
IMR90|chr12:9606681-9606803,chr12,9606681,9606803,IMR90|chr12:122513678-122513812,chr12,122513678,122513812,0,112906997
IMR90|chr12:9864224-9864262,chr12,9864224,9864262,IMR90|chr12:64800263-64800375,chr12,64800263,64800375,0,54936039
IMR90|chr12:9978032-9978131,chr12,9978032,9978131,IMR90|chr12:133401302-133401341,chr12,133401302,133401341,0,123423270
IMR90|chr12:9997380-9997413,chr12,9997380,9997413,IMR90|chr12:53397783-53397821,chr12,53397783,53397821,0,43400403
IMR90|chr12:10063469-10063514,chr12,10063469,10063514,IMR90|chr12:89749138-89749243,chr12,89749138,89749243,0,79685669
IMR90|chr12:10628826-10628912,chr12,10628826,10628912,IMR90|chr12:49661657-49661705,chr12,49661657,49661705,0,39032831
IMR90|chr12:10792317-10792363,chr12,10792317,10792363,IMR90|chr12:1700929-1701020,chr12,1700929,1701020,0,9091388
IMR90|chr12:10980525-10980669,chr12,10980525,10980669,IMR90|chr12:120703025-120703123,chr12,120703025,120703123,0,109722500
IMR90|chr12:11150945-11150967,chr12,11150945,11150967,IMR90|chr12:93771099-93771131,chr12,93771099,93771131,0,82620154
IMR90|chr12:11254533-11254606,chr12,11254533,11254606,IMR90|chr12:13351887-13351934,chr12,13351887,13351934,0,2097354
IMR90|chr12:11608191-11608301,chr12,11608191,11608301,IMR90|chr12:42721930-42722009,chr12,42721930,42722009,0,31113739
IMR90|chr12:11802837-11802895,chr12,11802837,11802895,IMR90|chr12:863601-863699,chr12,863601,863699,0,10939236
IMR90|chr12:12486640-12486718,chr12,12486640,12486718,IMR90|chr12:46761484-46761527,chr12,46761484,46761527,0,34274844
IMR90|chr12:12580671-12580821,chr12,12580671,12580821,IMR90|chr12:122514281-122514360,chr12,122514281,122514360,0,109933610
IMR90|chr12:12764173-12764237,chr12,12764173,12764237,IMR90|chr12:122059708-122059775,chr12,122059708,122059775,0,109295535
IMR90|chr12:12940606-12940685,chr12,12940606,12940685,IMR90|chr12:30904867-30904963,chr12,30904867,30904963,0,17964261
IMR90|chr12:12946435-12946504,chr12,12946435,12946504,IMR90|chr12:122512393-122512446,chr12,122512393,122512446,0,109565958
IMR90|chr12:13046977-13047082,chr12,13046977,13047082,IMR90|chr12:105627747-105627779,chr12,105627747,105627779,0,92580770
IMR90|chr12:13323564-13323678,chr12,13323564,13323678,IMR90|chr12:25101280-25101306,chr12,25101280,25101306,0,11777716
IMR90|chr12:13507376-13507481,chr12,13507376,13507481,IMR90|chr12:105627747-105627779,chr12,105627747,105627779,0,92120371
IMR90|chr12:13631757-13631872,chr12,13631757,13631872,IMR90|chr12:112549450-112549478,chr12,112549450,112549478,0,98917693
IMR90|chr12:13739143-13739204,chr12,13739143,13739204,IMR90|chr12:122518225-122518260,chr12,122518225,122518260,0,108779082
IMR90|chr12:13761074-13761150,chr12,13761074,13761150,IMR90|chr12:76476747-76476813,chr12,76476747,76476813,0,62715673
IMR90|chr12:13934273-13934374,chr12,13934273,13934374,IMR90|chr12:56366661-56366687,chr12,56366661,56366687,0,42432388
IMR90|chr12:13946553-13946613,chr12,13946553,13946613,IMR90|chr12:46759694-46759767,chr12,46759694,46759767,0,32813141
IMR90|chr12:13955645-13955713,chr12,13955645,13955713,IMR90|chr12:110439274-110439356,chr12,110439274,110439356,0,96483629
IMR90|chr12:14077763-14077859,chr12,14077763,14077859,IMR90|chr12:49214902-49214982,chr12,49214902,49214982,0,35137139
IMR90|chr12:14267315-14267399,chr12,14267315,14267399,IMR90|chr12:104683975-104684041,chr12,104683975,104684041,0,90416660
IMR90|chr12:14300088-14300151,chr12,14300088,14300151,IMR90|chr12:89749138-89749243,chr12,89749138,89749243,0,75449050
IMR90|chr12:14323749-14323816,chr12,14323749,14323816,IMR90|chr12:66220438-66220511,chr12,66220438,66220511,0,51896689
IMR90|chr12:14419973-14420035,chr12,14419973,14420035,IMR90|chr12:1685938-1685977,chr12,1685938,1685977,0,12734035
IMR90|chr12:14549654-14549738,chr12,14549654,14549738,IMR90|chr12:104683975-104684041,chr12,104683975,104684041,0,90134321
IMR90|chr12:14824743-14824851,chr12,14824743,14824851,IMR90|chr12:42722886-42722919,chr12,42722886,42722919,0,27898143
IMR90|chr12:14955593-14955645,chr12,14955593,14955645,IMR90|chr12:50417701-50417823,chr12,50417701,50417823,0,35462108
IMR90|chr12:15036484-15036538,chr12,15036484,15036538,IMR90|chr12:16501528-16501624,chr12,16501528,16501624,0,1465044
IMR90|chr12:15107030-15107062,chr12,15107030,15107062,IMR90|chr12:122512349-122512419,chr12,122512349,122512419,0,107405319
IMR90|chr12:15227924-15227979,chr12,15227924,15227979,IMR90|chr12:57115548-57115596,chr12,57115548,57115596,0,41887624
IMR90|chr12:15392981-15393047,chr12,15392981,15393047,IMR90|chr12:46764030-46764117,chr12,46764030,46764117,0,31371049
IMR90|chr12:15558318-15558369,chr12,15558318,15558369,IMR90|chr12:13039809-13039908,chr12,13039809,13039908,0,2518509
IMR90|chr12:15744126-15744147,chr12,15744126,15744147,IMR90|chr12:54677002-54677067,chr12,54677002,54677067,0,38932876
IMR90|chr12:16133084-16133194,chr12,16133084,16133194,IMR90|chr12:42721930-42722009,chr12,42721930,42722009,0,26588846
IMR90|chr12:16252808-16252855,chr12,16252808,16252855,IMR90|chr12:56368582-56368669,chr12,56368582,56368669,0,40115774
IMR90|chr12:16458990-16459118,chr12,16458990,16459118,IMR90|chr12:118572471-118572575,chr12,118572471,118572575,0,102113481
IMR90|chr12:16756610-16756717,chr12,16756610,16756717,IMR90|chr12:6450208-6450226,chr12,6450208,6450226,0,10306402
IMR90|chr12:16760463-16760517,chr12,16760463,16760517,IMR90|chr12:16501528-16501624,chr12,16501528,16501624,0,258935
IMR90|chr12:17087420-17087453,chr12,17087420,17087453,IMR90|chr12:53892649-53892752,chr12,53892649,53892752,0,36805229
IMR90|chr12:17359287-17359393,chr12,17359287,17359393,IMR90|chr12:105627747-105627779,chr12,105627747,105627779,0,88268460
IMR90|chr12:17379615-17379644,chr12,17379615,17379644,IMR90|chr12:122512881-122512942,chr12,122512881,122512942,0,105133266
IMR90|chr12:17579898-17579943,chr12,17579898,17579943,IMR90|chr12:89749138-89749243,chr12,89749138,89749243,0,72169240
IMR90|chr12:17610621-17610694,chr12,17610621,17610694,IMR90|chr12:111845198-111845275,chr12,111845198,111845275,0,94234577
IMR90|chr12:17725566-17725595,chr12,17725566,17725595,IMR90|chr12:1641430-1641457,chr12,1641430,1641457,0,16084136
IMR90|chr12:18137025-18137115,chr12,18137025,18137115,IMR90|chr12:49659142-49659201,chr12,49659142,49659201,0,31522117
IMR90|chr12:18137466-18137525,chr12,18137466,18137525,IMR90|chr12:93771099-93771130,chr12,93771099,93771130,0,75633633
IMR90|chr12:18209437-18209529,chr12,18209437,18209529,IMR90|chr12:51480363-51480427,chr12,51480363,51480427,0,33270926
IMR90|chr12:18325441-18325514,chr12,18325441,18325514,IMR90|chr12:64799223-64799247,chr12,64799223,64799247,0,46473782
IMR90|chr12:18373263-18373346,chr12,18373263,18373346,IMR90|chr12:56620643-56620671,chr12,56620643,56620671,0,38247380
IMR90|chr12:18509671-18509694,chr12,18509671,18509694,IMR90|chr12:4758380-4758517,chr12,4758380,4758517,0,13751291
IMR90|chr12:18652177-18652248,chr12,18652177,18652248,IMR90|chr12:122513069-122513117,chr12,122513069,122513117,0,103860892
IMR90|chr12:18671251-18671283,chr12,18671251,18671283,IMR90|chr12:1701522-1701640,chr12,1701522,1701640,0,16969729
IMR90|chr12:18674091-18674138,chr12,18674091,18674138,IMR90|chr12:109899167-109899229,chr12,109899167,109899229,0,91225076
IMR90|chr12:18965833-18965910,chr12,18965833,18965910,IMR90|chr12:88536644-88536687,chr12,88536644,88536687,0,69570811
IMR90|chr12:19054204-19054321,chr12,19054204,19054321,IMR90|chr12:13345770-13345796,chr12,13345770,13345796,0,5708434
IMR90|chr12:19071690-19071711,chr12,19071690,19071711,IMR90|chr12:66220913-66221011,chr12,66220913,66221011,0,47149223
IMR90|chr12:19355933-19356066,chr12,19355933,19356066,IMR90|chr12:50679207-50679307,chr12,50679207,50679307,0,31323274
IMR90|chr12:19701588-19701619,chr12,19701588,19701619,IMR90|chr12:58236820-58236885,chr12,58236820,58236885,0,38535232
IMR90|chr12:19789121-19789174,chr12,19789121,19789174,IMR90|chr12:125395982-125396035,chr12,125395982,125396035,0,105606861
IMR90|chr12:19967796-19967832,chr12,19967796,19967832,IMR90|chr12:77458918-77458996,chr12,77458918,77458996,0,57491122
IMR90|chr12:20006293-20006320,chr12,20006293,20006320,IMR90|chr12:57116948-57117018,chr12,57116948,57117018,0,37110655
IMR90|chr12:20190639-20190721,chr12,20190639,20190721,IMR90|chr12:122515565-122515630,chr12,122515565,122515630,0,102324926
IMR90|chr12:20279373-20279435,chr12,20279373,20279435,IMR90|chr12:46764109-46764176,chr12,46764109,46764176,0,26484736
IMR90|chr12:20498704-20498773,chr12,20498704,20498773,IMR90|chr12:122515887-122515928,chr12,122515887,122515928,0,102017183
IMR90|chr12:20636198-20636281,chr12,20636198,20636281,IMR90|chr12:120665165-120665310,chr12,120665165,120665310,0,100028967
IMR90|chr12:20878465-20878526,chr12,20878465,20878526,IMR90|chr12:122512868-122512950,chr12,122512868,122512950,0,101634403
IMR90|chr12:21072511-21072658,chr12,21072511,21072658,IMR90|chr12:13042826-13042854,chr12,13042826,13042854,0,8029685
IMR90|chr12:21217384-21217486,chr12,21217384,21217486,IMR90|chr12:57116126-57116145,chr12,57116126,57116145,0,35898742
IMR90|chr12:21226684-21226793,chr12,21226684,21226793,IMR90|chr12:114844239-114844280,chr12,114844239,114844280,0,93617555
IMR90|chr12:21471310-21471364,chr12,21471310,21471364,IMR90|chr12:69005993-69006083,chr12,69005993,69006083,0,47534683
IMR90|chr12:21517110-21517182,chr12,21517110,21517182,IMR90|chr12:76429583-76429630,chr12,76429583,76429630,0,54912473
IMR90|chr12:21664362-21664417,chr12,21664362,21664417,IMR90|chr12:57115548-57115596,chr12,57115548,57115596,0,35451186
IMR90|chr12:21832982-21833068,chr12,21832982,21833068,IMR90|chr12:53835926-53836019,chr12,53835926,53836019,0,32002944
IMR90|chr12:21897816-21897849,chr12,21897816,21897849,IMR90|chr12:58236820-58236885,chr12,58236820,58236885,0,36339004
IMR90|chr12:21909407-21909519,chr12,21909407,21909519,IMR90|chr12:1773033-1773072,chr12,1773033,1773072,0,20136374
IMR90|chr12:22203545-22203575,chr12,22203545,22203575,IMR90|chr12:68043954-68044041,chr12,68043954,68044041,0,45840409
IMR90|chr12:22319698-22319775,chr12,22319698,22319775,IMR90|chr12:97304310-97304337,chr12,97304310,97304337,0,74984612
IMR90|chr12:22508117-22508160,chr12,22508117,22508160,IMR90|chr12:13345770-13345796,chr12,13345770,13345796,0,9162347
IMR90|chr12:22580400-22580433,chr12,22580400,22580433,IMR90|chr12:64238013-64238117,chr12,64238013,64238117,0,41657613
IMR90|chr12:22662748-22662785,chr12,22662748,22662785,IMR90|chr12:50100631-50100700,chr12,50100631,50100700,0,27437883
IMR90|chr12:22832535-22832599,chr12,22832535,22832599,IMR90|chr12:1642913-1642955,chr12,1642913,1642955,0,21189622
IMR90|chr12:22875503-22875569,chr12,22875503,22875569,IMR90|chr12:111841543-111841580,chr12,111841543,111841580,0,88966040
IMR90|chr12:22916268-22916349,chr12,22916268,22916349,IMR90|chr12:125052709-125052773,chr12,125052709,125052773,0,102136441
IMR90|chr12:23017626-23017759,chr12,23017626,23017759,IMR90|chr12:50679207-50679307,chr12,50679207,50679307,0,27661581
IMR90|chr12:23198047-23198089,chr12,23198047,23198089,IMR90|chr12:6447724-6447834,chr12,6447724,6447834,0,16750323
IMR90|chr12:23213850-23213941,chr12,23213850,23213941,IMR90|chr12:64801572-64801626,chr12,64801572,64801626,0,41587722
IMR90|chr12:23247188-23247242,chr12,23247188,23247242,IMR90|chr12:122515562-122515704,chr12,122515562,122515704,0,99268374
IMR90|chr12:23275910-23275957,chr12,23275910,23275957,IMR90|chr12:56368582-56368669,chr12,56368582,56368669,0,33092672
IMR90|chr12:23402516-23402585,chr12,23402516,23402585,IMR90|chr12:77458923-77459037,chr12,77458923,77459037,0,54056407
IMR90|chr12:23413311-23413405,chr12,23413311,23413405,IMR90|chr12:121784115-121784168,chr12,121784115,121784168,0,98370804
IMR90|chr12:23625681-23625736,chr12,23625681,23625736,IMR90|chr12:66220212-66220285,chr12,66220212,66220285,0,42594531
IMR90|chr12:23816924-23816966,chr12,23816924,23816966,IMR90|chr12:109251799-109251939,chr12,109251799,109251939,0,85434875
IMR90|chr12:23939158-23939264,chr12,23939158,23939264,IMR90|chr12:105627747-105627779,chr12,105627747,105627779,0,81688589
IMR90|chr12:24511267-24511353,chr12,24511267,24511353,IMR90|chr12:104681961-104682047,chr12,104681961,104682047,0,80170694
IMR90|chr12:24580877-24580966,chr12,24580877,24580966,IMR90|chr12:49659142-49659201,chr12,49659142,49659201,0,25078265
IMR90|chr12:24611756-24611812,chr12,24611756,24611812,IMR90|chr12:109247420-109247514,chr12,109247420,109247514,0,84635664
IMR90|chr12:24724909-24725029,chr12,24724909,24725029,IMR90|chr12:125402610-125402636,chr12,125402610,125402636,0,100677701
IMR90|chr12:24782365-24782400,chr12,24782365,24782400,IMR90|chr12:57039331-57039400,chr12,57039331,57039400,0,32256966
IMR90|chr12:24796665-24796786,chr12,24796665,24796786,IMR90|chr12:28124246-28124264,chr12,28124246,28124264,0,3327581
IMR90|chr12:24915252-24915297,chr12,24915252,24915297,IMR90|chr12:109899167-109899229,chr12,109899167,109899229,0,84983915
IMR90|chr12:25006005-25006035,chr12,25006005,25006035,IMR90|chr12:13345332-13345452,chr12,13345332,13345452,0,11660673
IMR90|chr12:25068411-25068482,chr12,25068411,25068482,IMR90|chr12:105626187-105626223,chr12,105626187,105626223,0,80557776
IMR90|chr12:25169379-25169452,chr12,25169379,25169452,IMR90|chr12:10874917-10874992,chr12,10874917,10874992,0,14294462
IMR90|chr12:25266365-25266388,chr12,25266365,25266388,IMR90|chr12:4758380-4758517,chr12,4758380,4758517,0,20507985
IMR90|chr12:25636440-25636571,chr12,25636440,25636571,IMR90|chr12:104683975-104684041,chr12,104683975,104684041,0,79047535
IMR90|chr12:25773386-25773447,chr12,25773386,25773447,IMR90|chr12:52346515-52346558,chr12,52346515,52346558,0,26573129
IMR90|chr12:26004580-26004666,chr12,26004580,26004666,IMR90|chr12:49661657-49661705,chr12,49661657,49661705,0,23657077
IMR90|chr12:26331612-26331645,chr12,26331612,26331645,IMR90|chr12:13351388-13351471,chr12,13351388,13351471,0,12980224
IMR90|chr12:26396284-26396364,chr12,26396284,26396364,IMR90|chr12:16502334-16502387,chr12,16502334,16502387,0,9893950
IMR90|chr12:26773866-26773896,chr12,26773866,26773896,IMR90|chr12:1641430-1641457,chr12,1641430,1641457,0,25132436
IMR90|chr12:26890454-26890574,chr12,26890454,26890574,IMR90|chr12:122514602-122514637,chr12,122514602,122514637,0,95624148
IMR90|chr12:27176679-27176768,chr12,27176679,27176768,IMR90|chr12:51313870-51313953,chr12,51313870,51313953,0,24137191
IMR90|chr12:27195729-27195772,chr12,27195729,27195772,IMR90|chr12:66220947-66221053,chr12,66220947,66221053,0,39025218
IMR90|chr12:27274487-27274575,chr12,27274487,27274575,IMR90|chr12:122515565-122515630,chr12,122515565,122515630,0,95241078
IMR90|chr12:27338603-27338680,chr12,27338603,27338680,IMR90|chr12:97304310-97304337,chr12,97304310,97304337,0,69965707
IMR90|chr12:27416769-27416888,chr12,27416769,27416888,IMR90|chr12:57118118-57118147,chr12,57118118,57118147,0,29701349
IMR90|chr12:27564839-27564900,chr12,27564839,27564900,IMR90|chr12:96795291-96795335,chr12,96795291,96795335,0,69230452
IMR90|chr12:27983356-27983376,chr12,27983356,27983376,IMR90|chr12:49452042-49452144,chr12,49452042,49452144,0,21468686
IMR90|chr12:28127254-28127283,chr12,28127254,28127283,IMR90|chr12:1641430-1641457,chr12,1641430,1641457,0,26485824
IMR90|chr12:28330247-28330329,chr12,28330247,28330329,IMR90|chr12:13345332-13345452,chr12,13345332,13345452,0,14984915
IMR90|chr12:28336454-28336536,chr12,28336454,28336536,IMR90|chr12:57524331-57524368,chr12,57524331,57524368,0,29187877
IMR90|chr12:28666458-28666502,chr12,28666458,28666502,IMR90|chr12:57117832-57117893,chr12,57117832,57117893,0,28451374
IMR90|chr12:28807134-28807225,chr12,28807134,28807225,IMR90|chr12:57526099-57526148,chr12,57526099,57526148,0,28718965
IMR90|chr12:28994063-28994125,chr12,28994063,28994125,IMR90|chr12:122514281-122514360,chr12,122514281,122514360,0,93520218
IMR90|chr12:29052256-29052318,chr12,29052256,29052318,IMR90|chr12:89749593-89749655,chr12,89749593,89749655,0,60697337
IMR90|chr12:29079586-29079636,chr12,29079586,29079636,IMR90|chr12:1699954-1700043,chr12,1699954,1700043,0,27379632
IMR90|chr12:29202590-29202627,chr12,29202590,29202627,IMR90|chr12:42724049-42724111,chr12,42724049,42724111,0,13521459
IMR90|chr12:29390091-29390241,chr12,29390091,29390241,IMR90|chr12:120703025-120703123,chr12,120703025,120703123,0,91312934
IMR90|chr12:29494342-29494427,chr12,29494342,29494427,IMR90|chr12:133531800-133531852,chr12,133531800,133531852,0,104037458
IMR90|chr12:29542809-29542936,chr12,29542809,29542936,IMR90|chr12:65005255-65005281,chr12,65005255,65005281,0,35462446
IMR90|chr12:29607536-29607587,chr12,29607536,29607587,IMR90|chr12:66220212-66220285,chr12,66220212,66220285,0,36612676
IMR90|chr12:29752407-29752474,chr12,29752407,29752474,IMR90|chr12:122512326-122512370,chr12,122512326,122512370,0,92759919
IMR90|chr12:29824696-29824769,chr12,29824696,29824769,IMR90|chr12:13351887-13351934,chr12,13351887,13351934,0,16472809
IMR90|chr12:29828640-29828741,chr12,29828640,29828741,IMR90|chr12:133401302-133401341,chr12,133401302,133401341,0,103572662
IMR90|chr12:29965598-29965641,chr12,29965598,29965641,IMR90|chr12:13345770-13345796,chr12,13345770,13345796,0,16619828
IMR90|chr12:30248292-30248373,chr12,30248292,30248373,IMR90|chr12:122512838-122512907,chr12,122512838,122512907,0,92264546
IMR90|chr12:30339969-30340065,chr12,30339969,30340065,IMR90|chr12:49214902-49214982,chr12,49214902,49214982,0,18874933
IMR90|chr12:30481244-30481293,chr12,30481244,30481293,IMR90|chr12:49451427-49451464,chr12,49451427,49451464,0,18970183
IMR90|chr12:30595685-30595765,chr12,30595685,30595765,IMR90|chr12:122512963-122513032,chr12,122512963,122513032,0,91917278
IMR90|chr12:30601281-30601367,chr12,30601281,30601367,IMR90|chr12:104681961-104682047,chr12,104681961,104682047,0,74080680
IMR90|chr12:30665884-30665963,chr12,30665884,30665963,IMR90|chr12:16502334-16502387,chr12,16502334,16502387,0,14163550
IMR90|chr12:30674650-30674717,chr12,30674650,30674717,IMR90|chr12:49451427-49451464,chr12,49451427,49451464,0,18776777
IMR90|chr12:30742132-30742151,chr12,30742132,30742151,IMR90|chr12:133399711-133399733,chr12,133399711,133399733,0,102657579
IMR90|chr12:30806491-30806612,chr12,30806491,30806612,IMR90|chr12:28124246-28124264,chr12,28124246,28124264,0,2682245
IMR90|chr12:30812081-30812112,chr12,30812081,30812112,IMR90|chr12:98988421-98988443,chr12,98988421,98988443,0,68176340
IMR90|chr12:31351394-31351426,chr12,31351394,31351426,IMR90|chr12:114847023-114847148,chr12,114847023,114847148,0,83495629
IMR90|chr12:31399181-31399233,chr12,31399181,31399233,IMR90|chr12:50417701-50417823,chr12,50417701,50417823,0,19018520
IMR90|chr12:31713098-31713158,chr12,31713098,31713158,IMR90|chr12:111806441-111806557,chr12,111806441,111806557,0,80093343
IMR90|chr12:31811700-31811813,chr12,31811700,31811813,IMR90|chr12:49659163-49659199,chr12,49659163,49659199,0,17847463
IMR90|chr12:31848493-31848605,chr12,31848493,31848605,IMR90|chr12:122519391-122519413,chr12,122519391,122519413,0,90670898
IMR90|chr12:31892174-31892250,chr12,31892174,31892250,IMR90|chr12:98992721-98992776,chr12,98992721,98992776,0,67100547
IMR90|chr12:31998419-31998457,chr12,31998419,31998457,IMR90|chr12:121128000-121128105,chr12,121128000,121128105,0,89129581
IMR90|chr12:32390443-32390512,chr12,32390443,32390512,IMR90|chr12:46765734-46765776,chr12,46765734,46765776,0,14375291
IMR90|chr12:32574296-32574347,chr12,32574296,32574347,IMR90|chr12:54671874-54671931,chr12,54671874,54671931,0,22097578
IMR90|chr12:33173491-33173526,chr12,33173491,33173526,IMR90|chr12:57039331-57039400,chr12,57039331,57039400,0,23865840
IMR90|chr12:33558543-33558594,chr12,33558543,33558594,IMR90|chr12:69204608-69204642,chr12,69204608,69204642,0,35646065
IMR90|chr12:33625256-33625336,chr12,33625256,33625336,IMR90|chr12:13039289-13039359,chr12,13039289,13039359,0,20585967
IMR90|chr12:33744698-33744731,chr12,33744698,33744731,IMR90|chr12:13351388-13351471,chr12,13351388,13351471,0,20393310
IMR90|chr12:33986320-33986470,chr12,33986320,33986470,IMR90|chr12:120557640-120557777,chr12,120557640,120557777,0,86571320
IMR90|chr12:34090689-34090730,chr12,34090689,34090730,IMR90|chr12:110317479-110317585,chr12,110317479,110317585,0,76226790
IMR90|chr12:34750807-34750833,chr12,34750807,34750833,IMR90|chr12:51612939-51612966,chr12,51612939,51612966,0,16862132
IMR90|chr12:34784434-34784542,chr12,34784434,34784542,IMR90|chr12:133403741-133403769,chr12,133403741,133403769,0,98619307
IMR90|chr12:35051016-35051059,chr12,35051016,35051059,IMR90|chr12:66220947-66221053,chr12,66220947,66221053,0,31169931
IMR90|chr12:35208347-35208367,chr12,35208347,35208367,IMR90|chr12:1771621-1771738,chr12,1771621,1771738,0,33436726
IMR90|chr12:35509289-35509376,chr12,35509289,35509376,IMR90|chr12:56366661-56366687,chr12,56366661,56366687,0,20857372
IMR90|chr12:36526959-36527013,chr12,36526959,36527013,IMR90|chr12:69005993-69006083,chr12,69005993,69006083,0,32479034
IMR90|chr12:36657472-36657562,chr12,36657472,36657562,IMR90|chr12:49659142-49659201,chr12,49659142,49659201,0,13001670
IMR90|chr12:36661127-36661215,chr12,36661127,36661215,IMR90|chr12:64801572-64801626,chr12,64801572,64801626,0,28140445
IMR90|chr12:36830585-36830620,chr12,36830585,36830620,IMR90|chr12:50100631-50100700,chr12,50100631,50100700,0,13270046
IMR90|chr12:36897631-36897666,chr12,36897631,36897666,IMR90|chr12:122512354-122512383,chr12,122512354,122512383,0,85614723
IMR90|chr12:36937409-36937430,chr12,36937409,36937430,IMR90|chr12:98988417-98988443,chr12,98988417,98988443,0,62051008
IMR90|chr12:36984556-36984666,chr12,36984556,36984666,IMR90|chr12:122514602-122514637,chr12,122514602,122514637,0,85530046
IMR90|chr12:37037696-37037846,chr12,37037696,37037846,IMR90|chr12:89750300-89750319,chr12,89750300,89750319,0,52712604
IMR90|chr12:37287473-37287540,chr12,37287473,37287540,IMR90|chr12:66220438-66220511,chr12,66220438,66220511,0,28932965
IMR90|chr12:37392498-37392566,chr12,37392498,37392566,IMR90|chr12:110439274-110439356,chr12,110439274,110439356,0,73046776
IMR90|chr12:37575328-37575478,chr12,37575328,37575478,IMR90|chr12:120703025-120703123,chr12,120703025,120703123,0,83127697
IMR90|chr12:37606181-37606209,chr12,37606181,37606209,IMR90|chr12:50417701-50417823,chr12,50417701,50417823,0,12811520
IMR90|chr12:37679680-37679700,chr12,37679680,37679700,IMR90|chr12:49452042-49452144,chr12,49452042,49452144,0,11772362
IMR90|chr12:37852238-37852258,chr12,37852238,37852258,IMR90|chr12:1771621-1771738,chr12,1771621,1771738,0,36080617
IMR90|chr12:37962229-37962278,chr12,37962229,37962278,IMR90|chr12:69204608-69204709,chr12,69204608,69204709,0,31242379
IMR90|chr12:37966386-37966431,chr12,37966386,37966431,IMR90|chr12:69675603-69675651,chr12,69675603,69675651,0,31709217
IMR90|chr12:38320302-38320383,chr12,38320302,38320383,IMR90|chr12:122514415-122514479,chr12,122514415,122514479,0,84194113
IMR90|chr12:38379599-38379670,chr12,38379599,38379670,IMR90|chr12:27237498-27237530,chr12,27237498,27237530,0,11142101
IMR90|chr12:38423570-38423640,chr12,38423570,38423640,IMR90|chr12:66220313-66220393,chr12,66220313,66220393,0,27796743
IMR90|chr12:38691484-38691545,chr12,38691484,38691545,IMR90|chr12:79261789-79261877,chr12,79261789,79261877,0,40570305
IMR90|chr12:39066814-39066865,chr12,39066814,39066865,IMR90|chr12:46761261-46761289,chr12,46761261,46761289,0,7694447
IMR90|chr12:39098405-39098494,chr12,39098405,39098494,IMR90|chr12:13350952-13351014,chr12,13350952,13351014,0,25747453
IMR90|chr12:39167666-39167762,chr12,39167666,39167762,IMR90|chr12:64800490-64800588,chr12,64800490,64800588,0,25632824
IMR90|chr12:39962660-39962684,chr12,39962660,39962684,IMR90|chr12:4758380-4758517,chr12,4758380,4758517,0,35204280
IMR90|chr12:39973119-39973166,chr12,39973119,39973166,IMR90|chr12:109899167-109899229,chr12,109899167,109899229,0,69926048
IMR90|chr12:40007306-40007359,chr12,40007306,40007359,IMR90|chr12:132339867-132339896,chr12,132339867,132339896,0,92332561
IMR90|chr12:40159859-40159921,chr12,40159859,40159921,IMR90|chr12:89749593-89749655,chr12,89749593,89749655,0,49589734
IMR90|chr12:40221959-40222000,chr12,40221959,40222000,IMR90|chr12:21655942-21656041,chr12,21655942,21656041,0,18566017
IMR90|chr12:40427648-40427747,chr12,40427648,40427747,IMR90|chr12:120885014-120885041,chr12,120885014,120885041,0,80457366
IMR90|chr12:40581194-40581216,chr12,40581194,40581216,IMR90|chr12:93771099-93771131,chr12,93771099,93771131,0,53189905
IMR90|chr12:40622127-40622159,chr12,40622127,40622159,IMR90|chr12:114847023-114847148,chr12,114847023,114847148,0,74224896
IMR90|chr12:40635132-40635199,chr12,40635132,40635199,IMR90|chr12:57523931-57523976,chr12,57523931,57523976,0,16888799
IMR90|chr12:40797279-40797348,chr12,40797279,40797348,IMR90|chr12:122513068-122513160,chr12,122513068,122513160,0,81715789
IMR90|chr12:40828711-40828735,chr12,40828711,40828735,IMR90|chr12:57029284-57029332,chr12,57029284,57029332,0,16200573
IMR90|chr12:40966624-40966710,chr12,40966624,40966710,IMR90|chr12:51480363-51480427,chr12,51480363,51480427,0,10513739
IMR90|chr12:41107822-41107851,chr12,41107822,41107851,IMR90|chr12:89748113-89748156,chr12,89748113,89748156,0,48640291
IMR90|chr12:41146223-41146309,chr12,41146223,41146309,IMR90|chr12:8091484-8091546,chr12,8091484,8091546,0,33054739
IMR90|chr12:41530318-41530352,chr12,41530318,41530352,IMR90|chr12:69005399-69005470,chr12,69005399,69005470,0,27475081
IMR90|chr12:42014922-42015024,chr12,42014922,42015024,IMR90|chr12:57116126-57116145,chr12,57116126,57116145,0,15101204
IMR90|chr12:42274492-42274521,chr12,42274492,42274521,IMR90|chr12:46761702-46761769,chr12,46761702,46761769,0,4487210
IMR90|chr12:42407706-42407769,chr12,42407706,42407769,IMR90|chr12:46764030-46764117,chr12,46764030,46764117,0,4356324
IMR90|chr12:42571676-42571797,chr12,42571676,42571797,IMR90|chr12:72233991-72234012,chr12,72233991,72234012,0,29662315
IMR90|chr12:42613249-42613298,chr12,42613249,42613298,IMR90|chr12:69204606-69204663,chr12,69204606,69204663,0,26591357
IMR90|chr12:42742928-42742966,chr12,42742928,42742966,IMR90|chr12:69005703-69005806,chr12,69005703,69005806,0,26262775
IMR90|chr12:43051074-43051114,chr12,43051074,43051114,IMR90|chr12:110317479-110317585,chr12,110317479,110317585,0,67266405
IMR90|chr12:43134349-43134376,chr12,43134349,43134376,IMR90|chr12:111806441-111806557,chr12,111806441,111806557,0,68672092
IMR90|chr12:43259100-43259129,chr12,43259100,43259129,IMR90|chr12:120885300-120885418,chr12,120885300,120885418,0,77626200
IMR90|chr12:43510377-43510410,chr12,43510377,43510410,IMR90|chr12:69005399-69005470,chr12,69005399,69005470,0,25495022
IMR90|chr12:43550196-43550292,chr12,43550196,43550292,IMR90|chr12:64800490-64800588,chr12,64800490,64800588,0,21250294
IMR90|chr12:43567783-43567847,chr12,43567783,43567847,IMR90|chr12:122512868-122512950,chr12,122512868,122512950,0,78945085
IMR90|chr12:43932691-43932743,chr12,43932691,43932743,IMR90|chr12:863601-863699,chr12,863601,863699,0,43069090
IMR90|chr12:43982175-43982236,chr12,43982175,43982236,IMR90|chr12:52346515-52346558,chr12,52346515,52346558,0,8364340
IMR90|chr12:44055524-44055565,chr12,44055524,44055565,IMR90|chr12:21655942-21656041,chr12,21655942,21656041,0,22399582
IMR90|chr12:44095788-44095902,chr12,44095788,44095902,IMR90|chr12:121129820-121129964,chr12,121129820,121129964,0,77034032
IMR90|chr12:44146333-44146363,chr12,44146333,44146363,IMR90|chr12:68043954-68044041,chr12,68043954,68044041,0,23897621
IMR90|chr12:44162645-44162733,chr12,44162645,44162733,IMR90|chr12:111805014-111805051,chr12,111805014,111805051,0,67642369
IMR90|chr12:44170433-44170504,chr12,44170433,44170504,IMR90|chr12:42721930-42722009,chr12,42721930,42722009,0,1448503
IMR90|chr12:44342897-44343003,chr12,44342897,44343003,IMR90|chr12:121127712-121127741,chr12,121127712,121127741,0,76784815
IMR90|chr12:44367089-44367194,chr12,44367089,44367194,IMR90|chr12:121127712-121127741,chr12,121127712,121127741,0,76760623
IMR90|chr12:44459119-44459234,chr12,44459119,44459234,IMR90|chr12:6450208-6450226,chr12,6450208,6450226,0,38008911
IMR90|chr12:44483103-44483165,chr12,44483103,44483165,IMR90|chr12:110438753-110438836,chr12,110438753,110438836,0,65955650
IMR90|chr12:44494368-44494448,chr12,44494368,44494448,IMR90|chr12:133402960-133402995,chr12,133402960,133402995,0,88908592
IMR90|chr12:44789869-44789962,chr12,44789869,44789962,IMR90|chr12:96798383-96798440,chr12,96798383,96798440,0,52008514
IMR90|chr12:44997822-44997868,chr12,44997822,44997868,IMR90|chr12:57117832-57117893,chr12,57117832,57117893,0,12120010
IMR90|chr12:45319077-45319149,chr12,45319077,45319149,IMR90|chr12:105626187-105626223,chr12,105626187,105626223,0,60307110
IMR90|chr12:45432693-45432738,chr12,45432693,45432738,IMR90|chr12:76424085-76424167,chr12,76424085,76424167,0,30991392
IMR90|chr12:45665599-45665743,chr12,45665599,45665743,IMR90|chr12:120703025-120703123,chr12,120703025,120703123,0,75037426
IMR90|chr12:45874132-45874241,chr12,45874132,45874241,IMR90|chr12:76428698-76428797,chr12,76428698,76428797,0,30554566
IMR90|chr12:45895983-45896041,chr12,45895983,45896041,IMR90|chr12:46759694-46759767,chr12,46759694,46759767,0,863711
IMR90|chr12:46032028-46032057,chr12,46032028,46032057,IMR90|chr12:122512881-122512942,chr12,122512881,122512942,0,76480853
IMR90|chr12:46162671-46162696,chr12,46162671,46162696,IMR90|chr12:56918089-56918161,chr12,56918089,56918161,0,10755418
IMR90|chr12:46631363-46631513,chr12,46631363,46631513,IMR90|chr12:122514281-122514360,chr12,122514281,122514360,0,75882918
IMR90|chr12:46678046-46678084,chr12,46678046,46678084,IMR90|chr12:95949716-95949794,chr12,95949716,95949794,0,49271670
IMR90|chr12:46742325-46742445,chr12,46742325,46742445,IMR90|chr12:122514602-122514637,chr12,122514602,122514637,0,75772277
IMR90|chr12:46972989-46973014,chr12,46972989,46973014,IMR90|chr12:51612939-51612966,chr12,51612939,51612966,0,4639950
IMR90|chr12:47025079-47025103,chr12,47025079,47025103,IMR90|chr12:57116948-57117018,chr12,57116948,57117018,0,10091869
IMR90|chr12:47317213-47317328,chr12,47317213,47317328,IMR90|chr12:6450208-6450226,chr12,6450208,6450226,0,40867005
IMR90|chr12:47384452-47384511,chr12,47384452,47384511,IMR90|chr12:46659771-46659842,chr12,46659771,46659842,0,724681
IMR90|chr12:47433077-47433122,chr12,47433077,47433122,IMR90|chr12:6304160-6304235,chr12,6304160,6304235,0,41128917
IMR90|chr12:47514123-47514200,chr12,47514123,47514200,IMR90|chr12:51610576-51610637,chr12,51610576,51610637,0,4096453
IMR90|chr12:47565054-47565106,chr12,47565054,47565106,IMR90|chr12:125395982-125396036,chr12,125395982,125396036,0,77830928
IMR90|chr12:47639835-47639917,chr12,47639835,47639917,IMR90|chr12:64799533-64799563,chr12,64799533,64799563,0,17159698
IMR90|chr12:47940690-47940766,chr12,47940690,47940766,IMR90|chr12:98992721-98992776,chr12,98992721,98992776,0,51052031
IMR90|chr12:48215561-48215625,chr12,48215561,48215625,IMR90|chr12:64800263-64800375,chr12,64800263,64800375,0,16584702
IMR90|chr12:48597378-48597450,chr12,48597378,48597450,IMR90|chr12:64800648-64800691,chr12,64800648,64800691,0,16203270
IMR90|chr12:48654972-48655084,chr12,48654972,48655084,IMR90|chr12:122519391-122519413,chr12,122519391,122519413,0,73864419
IMR90|chr12:48691902-48691990,chr12,48691902,48691990,IMR90|chr12:111805014-111805051,chr12,111805014,111805051,0,63113112
IMR90|chr12:48786796-48786868,chr12,48786796,48786868,IMR90|chr12:46765971-46766049,chr12,46765971,46766049,0,2020825
IMR90|chr12:48812831-48812922,chr12,48812831,48812922,IMR90|chr12:64801572-64801626,chr12,64801572,64801626,0,15988741
IMR90|chr12:49253458-49253508,chr12,49253458,49253508,IMR90|chr12:122519391-122519413,chr12,122519391,122519413,0,73265933
IMR90|chr12:49407192-49407256,chr12,49407192,49407256,IMR90|chr12:89749593-89749655,chr12,89749593,89749655,0,40342401
IMR90|chr12:49827103-49827147,chr12,49827103,49827147,IMR90|chr12:42631171-42631253,chr12,42631171,42631253,0,7195932
IMR90|chr12:49949658-49949722,chr12,49949658,49949722,IMR90|chr12:1642913-1642955,chr12,1642913,1642955,0,48306745
IMR90|chr12:49970341-49970400,chr12,49970341,49970400,IMR90|chr12:93771099-93771130,chr12,93771099,93771130,0,43800758
IMR90|chr12:50109823-50109868,chr12,50109823,50109868,IMR90|chr12:66220947-66221053,chr12,66220947,66221053,0,16111124
IMR90|chr12:50417694-50417765,chr12,50417694,50417765,IMR90|chr12:27092541-27092569,chr12,27092541,27092569,0,23325153
IMR90|chr12:50443736-50443795,chr12,50443736,50443795,IMR90|chr12:122518225-122518260,chr12,122518225,122518260,0,72074489
IMR90|chr12:50643028-50643079,chr12,50643028,50643079,IMR90|chr12:64240414-64240513,chr12,64240414,64240513,0,13597386
IMR90|chr12:50718287-50718382,chr12,50718287,50718382,IMR90|chr12:122512838-122512907,chr12,122512838,122512907,0,71794551
IMR90|chr12:51118216-51118262,chr12,51118216,51118262,IMR90|chr12:56368582-56368669,chr12,56368582,56368669,0,5250366
IMR90|chr12:51321867-51321911,chr12,51321867,51321911,IMR90|chr12:122511898-122511954,chr12,122511898,122511954,0,71190031
IMR90|chr12:51343193-51343276,chr12,51343193,51343276,IMR90|chr12:64240414-64240513,chr12,64240414,64240513,0,12897221
IMR90|chr12:51602059-51602205,chr12,51602059,51602205,IMR90|chr12:13039809-13039908,chr12,13039809,13039908,0,38562250
IMR90|chr12:51787541-51787626,chr12,51787541,51787626,IMR90|chr12:1700848-1700913,chr12,1700848,1700913,0,50086693
IMR90|chr12:51884737-51884813,chr12,51884737,51884813,IMR90|chr12:49109428-49109480,chr12,49109428,49109480,0,2775309
IMR90|chr12:52008015-52008075,chr12,52008015,52008075,IMR90|chr12:46659771-46659842,chr12,46659771,46659842,0,5348244
IMR90|chr12:52013227-52013279,chr12,52013227,52013279,IMR90|chr12:125395982-125396036,chr12,125395982,125396036,0,73382755
IMR90|chr12:52234577-52234685,chr12,52234577,52234685,IMR90|chr12:133403741-133403769,chr12,133403741,133403769,0,81169164
IMR90|chr12:52235079-52235150,chr12,52235079,52235150,IMR90|chr12:46765971-46766049,chr12,46765971,46766049,0,5469108
IMR90|chr12:52373482-52373520,chr12,52373482,52373520,IMR90|chr12:42724049-42724111,chr12,42724049,42724111,0,9649433
IMR90|chr12:52440441-52440462,chr12,52440441,52440462,IMR90|chr12:98988417-98988443,chr12,98988417,98988443,0,46547976
IMR90|chr12:52713705-52713823,chr12,52713705,52713823,IMR90|chr12:111803726-111803746,chr12,111803726,111803746,0,59090021
IMR90|chr12:53060749-53060809,chr12,53060749,53060809,IMR90|chr12:46759694-46759767,chr12,46759694,46759767,0,6301055
IMR90|chr12:53199603-53199653,chr12,53199603,53199653,IMR90|chr12:133403124-133403199,chr12,133403124,133403199,0,80203521
IMR90|chr12:53551415-53551477,chr12,53551415,53551477,IMR90|chr12:118572463-118572573,chr12,118572463,118572573,0,65021048
IMR90|chr12:53752261-53752283,chr12,53752261,53752283,IMR90|chr12:109250723-109250780,chr12,109250723,109250780,0,55498462
IMR90|chr12:53827453-53827603,chr12,53827453,53827603,IMR90|chr12:112455740-112455852,chr12,112455740,112455852,0,58628287
IMR90|chr12:53868503-53868581,chr12,53868503,53868581,IMR90|chr12:13039230-13039302,chr12,13039230,13039302,0,40829273
IMR90|chr12:53901195-53901312,chr12,53901195,53901312,IMR90|chr12:13345770-13345796,chr12,13345770,13345796,0,40555425
IMR90|chr12:54003152-54003203,chr12,54003152,54003203,IMR90|chr12:114839183-114839256,chr12,114839183,114839256,0,60836031
IMR90|chr12:54020341-54020436,chr12,54020341,54020436,IMR90|chr12:58002052-58002081,chr12,58002052,58002081,0,3981711
IMR90|chr12:54245715-54245788,chr12,54245715,54245788,IMR90|chr12:111845198-111845275,chr12,111845198,111845275,0,57599483
IMR90|chr12:54256766-54256854,chr12,54256766,54256854,IMR90|chr12:13350952-13351014,chr12,13350952,13351014,0,40905814
IMR90|chr12:54258403-54258503,chr12,54258403,54258503,IMR90|chr12:6447814-6447863,chr12,6447814,6447863,0,47810589
IMR90|chr12:54459863-54459932,chr12,54459863,54459932,IMR90|chr12:122513068-122513160,chr12,122513068,122513160,0,68053205
IMR90|chr12:54500230-54500287,chr12,54500230,54500287,IMR90|chr12:125053061-125053106,chr12,125053061,125053106,0,70552831
IMR90|chr12:54666905-54666976,chr12,54666905,54666976,IMR90|chr12:27092541-27092569,chr12,27092541,27092569,0,27574364
IMR90|chr12:54714277-54714317,chr12,54714277,54714317,IMR90|chr12:122515562-122515626,chr12,122515562,122515626,0,67801285
IMR90|chr12:54933416-54933480,chr12,54933416,54933480,IMR90|chr12:122059708-122059775,chr12,122059708,122059775,0,67126292
IMR90|chr12:54993177-54993262,chr12,54993177,54993262,IMR90|chr12:133531800-133531852,chr12,133531800,133531852,0,78538623
IMR90|chr12:55061120-55061198,chr12,55061120,55061198,IMR90|chr12:13039230-13039302,chr12,13039230,13039302,0,42021890
IMR90|chr12:55066215-55066271,chr12,55066215,55066271,IMR90|chr12:49659629-49659683,chr12,49659629,49659683,0,5406586
IMR90|chr12:55228869-55228949,chr12,55228869,55228949,IMR90|chr12:16502334-16502387,chr12,16502334,16502387,0,38726535
IMR90|chr12:55297109-55297142,chr12,55297109,55297142,IMR90|chr12:121784115-121784208,chr12,121784115,121784208,0,66487006
IMR90|chr12:55493785-55493907,chr12,55493785,55493907,IMR90|chr12:122513678-122513812,chr12,122513678,122513812,0,67019893
IMR90|chr12:55526302-55526395,chr12,55526302,55526395,IMR90|chr12:46763086-46763143,chr12,46763086,46763143,0,8763216
IMR90|chr12:55656618-55656703,chr12,55656618,55656703,IMR90|chr12:1700848-1700913,chr12,1700848,1700913,0,53955770
IMR90|chr12:56220938-56220994,chr12,56220938,56220994,IMR90|chr12:132339867-132339896,chr12,132339867,132339896,0,76118929
IMR90|chr12:56275774-56275829,chr12,56275774,56275829,IMR90|chr12:66220212-66220285,chr12,66220212,66220285,0,9944438
IMR90|chr12:56329296-56329366,chr12,56329296,56329366,IMR90|chr12:10874917-10874992,chr12,10874917,10874992,0,45454379
IMR90|chr12:56375138-56375213,chr12,56375138,56375213,IMR90|chr12:49109428-49109480,chr12,49109428,49109480,0,7265710
IMR90|chr12:56524130-56524174,chr12,56524130,56524174,IMR90|chr12:27240139-27240266,chr12,27240139,27240266,0,29283991
IMR90|chr12:56666221-56666240,chr12,56666221,56666240,IMR90|chr12:133399711-133399733,chr12,133399711,133399733,0,76733490
IMR90|chr12:57127055-57127082,chr12,57127055,57127082,IMR90|chr12:122512264-122512365,chr12,122512264,122512365,0,65385209
IMR90|chr12:57332406-57332455,chr12,57332406,57332455,IMR90|chr12:69204606-69204663,chr12,69204606,69204663,0,11872200
IMR90|chr12:57509510-57509563,chr12,57509510,57509563,IMR90|chr12:132339867-132339896,chr12,132339867,132339896,0,74830357
IMR90|chr12:57675419-57675480,chr12,57675419,57675480,IMR90|chr12:1685938-1685977,chr12,1685938,1685977,0,55989481
IMR90|chr12:57690179-57690211,chr12,57690179,57690211,IMR90|chr12:1701522-1701640,chr12,1701522,1701640,0,55988657
IMR90|chr12:57856345-57856430,chr12,57856345,57856430,IMR90|chr12:97302660-97302725,chr12,97302660,97302725,0,39446315
IMR90|chr12:57866263-57866391,chr12,57866263,57866391,IMR90|chr12:118572471-118572575,chr12,118572471,118572575,0,60706208
IMR90|chr12:58179680-58179735,chr12,58179680,58179735,IMR90|chr12:49659629-49659683,chr12,49659629,49659683,0,8520051
IMR90|chr12:58686741-58686767,chr12,58686741,58686767,IMR90|chr12:66220032-66220152,chr12,66220032,66220152,0,7533291
IMR90|chr12:58830877-58830965,chr12,58830877,58830965,IMR90|chr12:97305253-97305290,chr12,97305253,97305290,0,38474376
IMR90|chr12:58987388-58987426,chr12,58987388,58987426,IMR90|chr12:57039331-57039400,chr12,57039331,57039400,0,1948057
IMR90|chr12:59358048-59358107,chr12,59358048,59358107,IMR90|chr12:46659771-46659842,chr12,46659771,46659842,0,12698277
IMR90|chr12:59901468-59901519,chr12,59901468,59901519,IMR90|chr12:64240414-64240513,chr12,64240414,64240513,0,4338946
IMR90|chr12:60110249-60110276,chr12,60110249,60110276,IMR90|chr12:6447724-6447834,chr12,6447724,6447834,0,53662525
IMR90|chr12:60308573-60308640,chr12,60308573,60308640,IMR90|chr12:27092541-27092569,chr12,27092541,27092569,0,33216032
IMR90|chr12:60320986-60321059,chr12,60320986,60321059,IMR90|chr12:64799223-64799247,chr12,64799223,64799247,0,4478237
IMR90|chr12:60740933-60740962,chr12,60740933,60740962,IMR90|chr12:133400611-133400715,chr12,133400611,133400715,0,72659678
IMR90|chr12:60812766-60812807,chr12,60812766,60812807,IMR90|chr12:122515562-122515626,chr12,122515562,122515626,0,61702796
IMR90|chr12:61224082-61224171,chr12,61224082,61224171,IMR90|chr12:72665169-72665207,chr12,72665169,72665207,0,11441087
IMR90|chr12:61272743-61272831,chr12,61272743,61272831,IMR90|chr12:72665169-72665207,chr12,72665169,72665207,0,11392426
IMR90|chr12:61282675-61282780,chr12,61282675,61282780,IMR90|chr12:121127712-121127741,chr12,121127712,121127741,0,59845037
IMR90|chr12:62101286-62101392,chr12,62101286,62101392,IMR90|chr12:121127712-121127741,chr12,121127712,121127741,0,59026426
IMR90|chr12:62176277-62176335,chr12,62176277,62176335,IMR90|chr12:76423846-76423900,chr12,76423846,76423900,0,14247569
IMR90|chr12:62242288-62242340,chr12,62242288,62242340,IMR90|chr12:64800490-64800588,chr12,64800490,64800588,0,2558202
IMR90|chr12:62343706-62343743,chr12,62343706,62343743,IMR90|chr12:6714515-6714561,chr12,6714515,6714561,0,55629191
IMR90|chr12:62935898-62935998,chr12,62935898,62935998,IMR90|chr12:6447814-6447863,chr12,6447814,6447863,0,56488084
IMR90|chr12:63016988-63017032,chr12,63016988,63017032,IMR90|chr12:76745317-76745419,chr12,76745317,76745419,0,13728329
IMR90|chr12:63201315-63201368,chr12,63201315,63201368,IMR90|chr12:106640027-106640091,chr12,106640027,106640091,0,43438712
IMR90|chr12:63240983-63241020,chr12,63240983,63241020,IMR90|chr12:42623982-42624092,chr12,42623982,42624092,0,20617001
IMR90|chr12:63317846-63317913,chr12,63317846,63317913,IMR90|chr12:122512326-122512370,chr12,122512326,122512370,0,59194480
IMR90|chr12:63631929-63632006,chr12,63631929,63632006,IMR90|chr12:111845198-111845275,chr12,111845198,111845275,0,48213269
IMR90|chr12:63771908-63771986,chr12,63771908,63771986,IMR90|chr12:46761484-46761527,chr12,46761484,46761527,0,17010424
IMR90|chr12:63984587-63984655,chr12,63984587,63984655,IMR90|chr12:13351331-13351472,chr12,13351331,13351472,0,50633256
IMR90|chr12:64315244-64315332,chr12,64315244,64315332,IMR90|chr12:72665169-72665207,chr12,72665169,72665207,0,8349925
IMR90|chr12:64419822-64419883,chr12,64419822,64419883,IMR90|chr12:57037461-57037522,chr12,57037461,57037522,0,7382361
IMR90|chr12:64442018-64442090,chr12,64442018,64442090,IMR90|chr12:64800648-64800691,chr12,64800648,64800691,0,358630
IMR90|chr12:64468221-64468301,chr12,64468221,64468301,IMR90|chr12:122512963-122513032,chr12,122512963,122513032,0,58044742
IMR90|chr12:64499867-64499921,chr12,64499867,64499921,IMR90|chr12:64800194-64800244,chr12,64800194,64800244,0,300327
IMR90|chr12:64787456-64787490,chr12,64787456,64787490,IMR90|chr12:69005399-69005470,chr12,69005399,69005470,0,4217943
IMR90|chr12:64806228-64806289,chr12,64806228,64806289,IMR90|chr12:46761685-46761734,chr12,46761685,46761734,0,18044543
IMR90|chr12:65001147-65001211,chr12,65001147,65001211,IMR90|chr12:104681961-104682047,chr12,104681961,104682047,0,39680814
IMR90|chr12:65369749-65369857,chr12,65369749,65369857,IMR90|chr12:42722886-42722919,chr12,42722886,42722919,0,22646863
IMR90|chr12:65426379-65426409,chr12,65426379,65426409,IMR90|chr12:1641430-1641457,chr12,1641430,1641457,0,63784949
IMR90|chr12:65522643-65522729,chr12,65522643,65522729,IMR90|chr12:66216760-66216805,chr12,66216760,66216805,0,694117
IMR90|chr12:65578043-65578113,chr12,65578043,65578113,IMR90|chr12:46761471-46761522,chr12,46761471,46761522,0,18816572
IMR90|chr12:65769130-65769193,chr12,65769130,65769193,IMR90|chr12:64238707-64238763,chr12,64238707,64238763,0,1530423
IMR90|chr12:65844642-65844675,chr12,65844642,65844675,IMR90|chr12:53892649-53892752,chr12,53892649,53892752,0,11951993
IMR90|chr12:65882683-65882711,chr12,65882683,65882711,IMR90|chr12:6449703-6449800,chr12,6449703,6449800,0,59432980
IMR90|chr12:65902884-65902949,chr12,65902884,65902949,IMR90|chr12:122512868-122512950,chr12,122512868,122512950,0,56609984
IMR90|chr12:66232989-66233069,chr12,66232989,66233069,IMR90|chr12:56884721-56884768,chr12,56884721,56884768,0,9348268
IMR90|chr12:66521510-66521555,chr12,66521510,66521555,IMR90|chr12:6877901-6877931,chr12,6877901,6877931,0,59643609
IMR90|chr12:66693511-66693571,chr12,66693511,66693571,IMR90|chr12:111806441-111806557,chr12,111806441,111806557,0,45112930
IMR90|chr12:66700503-66700528,chr12,66700503,66700528,IMR90|chr12:51612939-51612966,chr12,51612939,51612966,0,15087564
IMR90|chr12:66791425-66791445,chr12,66791425,66791445,IMR90|chr12:123009053-123009152,chr12,123009053,123009152,0,56217628
IMR90|chr12:66840990-66841069,chr12,66840990,66841069,IMR90|chr12:30904867-30904963,chr12,30904867,30904963,0,35936123
IMR90|chr12:66991754-66991780,chr12,66991754,66991780,IMR90|chr12:51612939-51612966,chr12,51612939,51612966,0,15378815
IMR90|chr12:67169347-67169392,chr12,67169347,67169392,IMR90|chr12:122515565-122515666,chr12,122515565,122515666,0,55346218
IMR90|chr12:67174877-67174944,chr12,67174877,67174944,IMR90|chr12:27092541-27092569,chr12,27092541,27092569,0,40082336
IMR90|chr12:67202520-67202585,chr12,67202520,67202585,IMR90|chr12:6659234-6659302,chr12,6659234,6659302,0,60543286
IMR90|chr12:67337017-67337081,chr12,67337017,67337081,IMR90|chr12:64800263-64800375,chr12,64800263,64800375,0,2536754
IMR90|chr12:67356100-67356214,chr12,67356100,67356214,IMR90|chr12:121129820-121129964,chr12,121129820,121129964,0,53773720
IMR90|chr12:67383201-67383304,chr12,67383201,67383304,IMR90|chr12:57116126-57116145,chr12,57116126,57116145,0,10267075
IMR90|chr12:67386894-67386918,chr12,67386894,67386918,IMR90|chr12:57029284-57029332,chr12,57029284,57029332,0,10357610
IMR90|chr12:67476277-67476337,chr12,67476277,67476337,IMR90|chr12:46764109-46764176,chr12,46764109,46764176,0,20712168
IMR90|chr12:67479121-67479176,chr12,67479121,67479176,IMR90|chr12:133402948-133403004,chr12,133402948,133403004,0,65923827
IMR90|chr12:68183357-68183381,chr12,68183357,68183381,IMR90|chr12:79261793-79261877,chr12,79261793,79261877,0,11078436
IMR90|chr12:68467331-68467367,chr12,68467331,68467367,IMR90|chr12:77458918-77458996,chr12,77458918,77458996,0,8991587
IMR90|chr12:68500105-68500176,chr12,68500105,68500176,IMR90|chr12:64800648-64800691,chr12,64800648,64800691,0,3699457
IMR90|chr12:68660455-68660492,chr12,68660455,68660492,IMR90|chr12:49932217-49932296,chr12,49932217,49932296,0,18728238
IMR90|chr12:68782285-68782336,chr12,68782285,68782336,IMR90|chr12:69204608-69204642,chr12,69204608,69204642,0,422323
IMR90|chr12:68881458-68881525,chr12,68881458,68881525,IMR90|chr12:57523931-57523976,chr12,57523931,57523976,0,11357527
IMR90|chr12:69215196-69215336,chr12,69215196,69215336,IMR90|chr12:122512354-122512383,chr12,122512354,122512383,0,53297158
IMR90|chr12:69492205-69492320,chr12,69492205,69492320,IMR90|chr12:112549450-112549478,chr12,112549450,112549478,0,43057245
IMR90|chr12:69607336-69607354,chr12,69607336,69607354,IMR90|chr12:13042389-13042430,chr12,13042389,13042430,0,56564947
IMR90|chr12:69683911-69683955,chr12,69683911,69683955,IMR90|chr12:76424085-76424167,chr12,76424085,76424167,0,6740174
IMR90|chr12:69871941-69872026,chr12,69871941,69872026,IMR90|chr12:97302660-97302725,chr12,97302660,97302725,0,27430719
IMR90|chr12:69922671-69922704,chr12,69922671,69922704,IMR90|chr12:57115418-57115442,chr12,57115418,57115442,0,12807253
IMR90|chr12:69952177-69952245,chr12,69952177,69952245,IMR90|chr12:66220438-66220511,chr12,66220438,66220511,0,3731739
IMR90|chr12:69970753-69970818,chr12,69970753,69970818,IMR90|chr12:69005405-69005479,chr12,69005405,69005479,0,965348
IMR90|chr12:70236420-70236537,chr12,70236420,70236537,IMR90|chr12:46763086-46763143,chr12,46763086,46763143,0,23473334
IMR90|chr12:70489578-70489709,chr12,70489578,70489709,IMR90|chr12:89750300-89750319,chr12,89750300,89750319,0,19260722
IMR90|chr12:70495935-70495962,chr12,70495935,70495962,IMR90|chr12:1771621-1771738,chr12,1771621,1771738,0,68724314
IMR90|chr12:70661658-70661699,chr12,70661658,70661699,IMR90|chr12:110317479-110317585,chr12,110317479,110317585,0,39655821
IMR90|chr12:70989970-70990028,chr12,70989970,70990028,IMR90|chr12:76423846-76423900,chr12,76423846,76423900,0,5433876
IMR90|chr12:71127302-71127353,chr12,71127302,71127353,IMR90|chr12:46761261-46761289,chr12,46761261,46761289,0,24366041
IMR90|chr12:71379995-71380047,chr12,71379995,71380047,IMR90|chr12:64800490-64800588,chr12,64800490,64800588,0,6579505
IMR90|chr12:71493365-71493416,chr12,71493365,71493416,IMR90|chr12:66220212-66220285,chr12,66220212,66220285,0,5273153
IMR90|chr12:71503244-71503325,chr12,71503244,71503325,IMR90|chr12:53397783-53397821,chr12,53397783,53397821,0,18105461
IMR90|chr12:71645140-71645223,chr12,71645140,71645223,IMR90|chr12:64240414-64240513,chr12,64240414,64240513,0,7404726
IMR90|chr12:71713871-71713948,chr12,71713871,71713948,IMR90|chr12:76477333-76477357,chr12,76477333,76477357,0,4763462
IMR90|chr12:72058711-72058789,chr12,72058711,72058789,IMR90|chr12:109247420-109247514,chr12,109247420,109247514,0,37188709
IMR90|chr12:72364744-72364781,chr12,72364744,72364781,IMR90|chr12:57039331-57039400,chr12,57039331,57039400,0,15325413
IMR90|chr12:72592711-72592802,chr12,72592711,72592802,IMR90|chr12:95949735-95949794,chr12,95949735,95949794,0,23357024
IMR90|chr12:72680187-72680272,chr12,72680187,72680272,IMR90|chr12:1700848-1700913,chr12,1700848,1700913,0,70979339
IMR90|chr12:72827003-72827139,chr12,72827003,72827139,IMR90|chr12:111803726-111803746,chr12,111803726,111803746,0,38976723
IMR90|chr12:72898109-72898168,chr12,72898109,72898168,IMR90|chr12:21809856-21809903,chr12,21809856,21809903,0,51088253
IMR90|chr12:73174377-73174445,chr12,73174377,73174445,IMR90|chr12:66220438-66220511,chr12,66220438,66220511,0,6953939
IMR90|chr12:73226137-73226191,chr12,73226137,73226191,IMR90|chr12:106640027-106640091,chr12,106640027,106640091,0,33413890
IMR90|chr12:73462412-73462521,chr12,73462412,73462521,IMR90|chr12:28127023-28127089,chr12,28127023,28127089,0,45335389
IMR90|chr12:73609496-73609591,chr12,73609496,73609591,IMR90|chr12:58002052-58002081,chr12,58002052,58002081,0,15607444
IMR90|chr12:73616622-73616719,chr12,73616622,73616719,IMR90|chr12:95949751-95949794,chr12,95949751,95949794,0,22333129
IMR90|chr12:73730810-73730902,chr12,73730810,73730902,IMR90|chr12:51480363-51480427,chr12,51480363,51480427,0,22250447
IMR90|chr12:73867886-73867919,chr12,73867886,73867919,IMR90|chr12:58236820-58236885,chr12,58236820,58236885,0,15631066
IMR90|chr12:74016812-74016881,chr12,74016812,74016881,IMR90|chr12:122512393-122512446,chr12,122512393,122512446,0,48495581
IMR90|chr12:74711626-74711671,chr12,74711626,74711671,IMR90|chr12:6304160-6304235,chr12,6304160,6304235,0,68407466
IMR90|chr12:74735172-74735209,chr12,74735172,74735209,IMR90|chr12:49932217-49932296,chr12,49932217,49932296,0,24802955
IMR90|chr12:75273081-75273170,chr12,75273081,75273170,IMR90|chr12:13350952-13351014,chr12,13350952,13351014,0,61922129
IMR90|chr12:75332296-75332334,chr12,75332296,75332334,IMR90|chr12:121128000-121128105,chr12,121128000,121128105,0,45795704
IMR90|chr12:75679947-75680048,chr12,75679947,75680048,IMR90|chr12:98990098-98990144,chr12,98990098,98990144,0,23310151
IMR90|chr12:75697900-75697969,chr12,75697900,75697969,IMR90|chr12:122511643-122511716,chr12,122511643,122511716,0,46813743
IMR90|chr12:76228337-76228412,chr12,76228337,76228412,IMR90|chr12:13041449-13041524,chr12,13041449,13041524,0,63186888
IMR90|chr12:76710147-76710211,chr12,76710147,76710211,IMR90|chr12:104681961-104682047,chr12,104681961,104682047,0,27971814
IMR90|chr12:77400004-77400064,chr12,77400004,77400064,IMR90|chr12:46764109-46764176,chr12,46764109,46764176,0,30635895
IMR90|chr12:77468322-77468368,chr12,77468322,77468368,IMR90|chr12:56368582-56368669,chr12,56368582,56368669,0,21099740
IMR90|chr12:77531010-77531053,chr12,77531010,77531053,IMR90|chr12:109248562-109248611,chr12,109248562,109248611,0,31717552
IMR90|chr12:77746466-77746563,chr12,77746466,77746563,IMR90|chr12:133403973-133404021,chr12,133403973,133404021,0,55657507
IMR90|chr12:77777946-77778008,chr12,77777946,77778008,IMR90|chr12:110438753-110438836,chr12,110438753,110438836,0,32660807
IMR90|chr12:78065726-78065771,chr12,78065726,78065771,IMR90|chr12:76424085-76424167,chr12,76424085,76424167,0,1641641
IMR90|chr12:78147257-78147393,chr12,78147257,78147393,IMR90|chr12:96798383-96798440,chr12,96798383,96798440,0,18651126
IMR90|chr12:78414799-78414857,chr12,78414799,78414857,IMR90|chr12:120557670-120557777,chr12,120557670,120557777,0,42142871
IMR90|chr12:78787572-78787616,chr12,78787572,78787616,IMR90|chr12:66220947-66221053,chr12,66220947,66221053,0,12566625
IMR90|chr12:78903389-78903442,chr12,78903389,78903442,IMR90|chr12:106640027-106640091,chr12,106640027,106640091,0,27736638
IMR90|chr12:79118992-79119056,chr12,79118992,79119056,IMR90|chr12:49452042-49452144,chr12,49452042,49452144,0,29666950
IMR90|chr12:79279114-79279179,chr12,79279114,79279179,IMR90|chr12:69005405-69005479,chr12,69005405,69005479,0,10273709
IMR90|chr12:79341139-79341179,chr12,79341139,79341179,IMR90|chr12:110317479-110317585,chr12,110317479,110317585,0,30976340
IMR90|chr12:79388701-79388772,chr12,79388701,79388772,IMR90|chr12:46765971-46766049,chr12,46765971,46766049,0,32622730
IMR90|chr12:79696524-79696599,chr12,79696524,79696599,IMR90|chr12:49109428-49109480,chr12,49109428,49109480,0,30587096
IMR90|chr12:80096768-80096800,chr12,80096768,80096800,IMR90|chr12:122512349-122512419,chr12,122512349,122512419,0,42415581
IMR90|chr12:80127697-80127724,chr12,80127697,80127724,IMR90|chr12:57116948-57117018,chr12,57116948,57117018,0,23010749
IMR90|chr12:80344600-80344643,chr12,80344600,80344643,IMR90|chr12:76745317-76745419,chr12,76745317,76745419,0,3599283
IMR90|chr12:80805614-80805675,chr12,80805614,80805675,IMR90|chr12:1701522-1701640,chr12,1701522,1701640,0,79104092
IMR90|chr12:80944333-80944415,chr12,80944333,80944415,IMR90|chr12:104682395-104682414,chr12,104682395,104682414,0,23738062
IMR90|chr12:81040264-81040325,chr12,81040264,81040325,IMR90|chr12:46761685-46761734,chr12,46761685,46761734,0,34278579
IMR90|chr12:81461040-81461171,chr12,81461040,81461171,IMR90|chr12:89750300-89750319,chr12,89750300,89750319,0,8289260
IMR90|chr12:81475141-81475228,chr12,81475141,81475228,IMR90|chr12:66216760-66216805,chr12,66216760,66216805,0,15258381
IMR90|chr12:82177477-82177561,chr12,82177477,82177561,IMR90|chr12:8089555-8089617,chr12,8089555,8089617,0,74087922
IMR90|chr12:82213521-82213630,chr12,82213521,82213630,IMR90|chr12:76428698-76428797,chr12,76428698,76428797,0,5784823
IMR90|chr12:82412944-82412988,chr12,82412944,82412988,IMR90|chr12:27240139-27240266,chr12,27240139,27240266,0,55172805
IMR90|chr12:82677695-82677763,chr12,82677695,82677763,IMR90|chr12:1642913-1642951,chr12,1642913,1642951,0,81034782
IMR90|chr12:82760838-82760897,chr12,82760838,82760897,IMR90|chr12:21809856-21809903,chr12,21809856,21809903,0,60950982
IMR90|chr12:82971408-82971497,chr12,82971408,82971497,IMR90|chr12:49659142-49659201,chr12,49659142,49659201,0,33312266
IMR90|chr12:83238502-83238588,chr12,83238502,83238588,IMR90|chr12:122516200-122516247,chr12,122516200,122516247,0,39277698
IMR90|chr12:83302631-83302715,chr12,83302631,83302715,IMR90|chr12:8089555-8089617,chr12,8089555,8089617,0,75213076
IMR90|chr12:83466457-83466507,chr12,83466457,83466507,IMR90|chr12:21655942-21656041,chr12,21655942,21656041,0,61810515
IMR90|chr12:83769705-83769738,chr12,83769705,83769738,IMR90|chr12:64238013-64238117,chr12,64238013,64238117,0,19531692
IMR90|chr12:83904382-83904454,chr12,83904382,83904454,IMR90|chr12:64799223-64799247,chr12,64799223,64799247,0,19105159
IMR90|chr12:84017978-84018047,chr12,84017978,84018047,IMR90|chr12:54671646-54671698,chr12,54671646,54671698,0,29346332
IMR90|chr12:84349616-84349745,chr12,84349616,84349745,IMR90|chr12:118572465-118572575,chr12,118572465,118572575,0,34222849
IMR90|chr12:84711869-84711955,chr12,84711869,84711955,IMR90|chr12:66216760-66216805,chr12,66216760,66216805,0,18495109
IMR90|chr12:84767605-84767685,chr12,84767605,84767685,IMR90|chr12:13041449-13041524,chr12,13041449,13041524,0,71726156
IMR90|chr12:84992279-84992333,chr12,84992279,84992333,IMR90|chr12:122515562-122515704,chr12,122515562,122515704,0,37523283
IMR90|chr12:84997175-84997286,chr12,84997175,84997286,IMR90|chr12:1773033-1773072,chr12,1773033,1773072,0,83224142
IMR90|chr12:85322119-85322173,chr12,85322119,85322173,IMR90|chr12:30904867-30904963,chr12,30904867,30904963,0,54417252
IMR90|chr12:85363998-85364103,chr12,85363998,85364103,IMR90|chr12:104683147-104683178,chr12,104683147,104683178,0,19319149
IMR90|chr12:85367889-85367941,chr12,85367889,85367941,IMR90|chr12:106640027-106640091,chr12,106640027,106640091,0,21272138
IMR90|chr12:85934068-85934178,chr12,85934068,85934178,IMR90|chr12:49659163-49659203,chr12,49659163,49659203,0,36274905
IMR90|chr12:86455326-86455408,chr12,86455326,86455408,IMR90|chr12:95949726-95949794,chr12,95949726,95949794,0,9494400
IMR90|chr12:86609149-86609289,chr12,86609149,86609289,IMR90|chr12:46761261-46761289,chr12,46761261,46761289,0,39847888
IMR90|chr12:86967426-86967451,chr12,86967426,86967451,IMR90|chr12:56918089-56918161,chr12,56918089,56918161,0,30049337
IMR90|chr12:87048770-87048830,chr12,87048770,87048830,IMR90|chr12:52346515-52346558,chr12,52346515,52346558,0,34702255
IMR90|chr12:87142365-87142427,chr12,87142365,87142427,IMR90|chr12:123378769-123378821,chr12,123378769,123378821,0,36236404
IMR90|chr12:88287948-88288013,chr12,88287948,88288013,IMR90|chr12:6659234-6659302,chr12,6659234,6659302,0,81628714
IMR90|chr12:88356063-88356157,chr12,88356063,88356157,IMR90|chr12:133404526-133404576,chr12,133404526,133404576,0,45048463
IMR90|chr12:88724950-88725021,chr12,88724950,88725021,IMR90|chr12:54671646-54671698,chr12,54671646,54671698,0,34053304
IMR90|chr12:88729334-88729378,chr12,88729334,88729378,IMR90|chr12:122511898-122511954,chr12,122511898,122511954,0,33782564
IMR90|chr12:88775265-88775315,chr12,88775265,88775315,IMR90|chr12:1699954-1700043,chr12,1699954,1700043,0,87075311
IMR90|chr12:88839691-88839773,chr12,88839691,88839773,IMR90|chr12:122515565-122515630,chr12,122515565,122515630,0,33675874
IMR90|chr12:88843886-88843977,chr12,88843886,88843977,IMR90|chr12:7245541-7245582,chr12,7245541,7245582,0,81598345
IMR90|chr12:88844547-88844634,chr12,88844547,88844634,IMR90|chr12:110887022-110887172,chr12,110887022,110887172,0,22042475
IMR90|chr12:88890291-88890317,chr12,88890291,88890317,IMR90|chr12:66220032-66220152,chr12,66220032,66220152,0,22670259
IMR90|chr12:88973436-88973533,chr12,88973436,88973533,IMR90|chr12:95949751-95949794,chr12,95949751,95949794,0,6976315
IMR90|chr12:88990241-88990292,chr12,88990241,88990292,IMR90|chr12:122515558-122515700,chr12,122515558,122515700,0,33525317
IMR90|chr12:89248007-89248087,chr12,89248007,89248087,IMR90|chr12:133402960-133402995,chr12,133402960,133402995,0,44154953
IMR90|chr12:89385858-89385892,chr12,89385858,89385892,IMR90|chr12:88536639-88536737,chr12,88536639,88536737,0,849219
IMR90|chr12:89458620-89458689,chr12,89458620,89458689,IMR90|chr12:54671646-54671698,chr12,54671646,54671698,0,34786974
IMR90|chr12:89697839-89697897,chr12,89697839,89697897,IMR90|chr12:120557670-120557777,chr12,120557670,120557777,0,30859831
IMR90|chr12:89861097-89861172,chr12,89861097,89861172,IMR90|chr12:13041449-13041524,chr12,13041449,13041524,0,76819648
IMR90|chr12:90018495-90018548,chr12,90018495,90018548,IMR90|chr12:88972333-88972430,chr12,88972333,88972430,0,1046162
IMR90|chr12:90067801-90067831,chr12,90067801,90067831,IMR90|chr12:13345332-13345452,chr12,13345332,13345452,0,76722469
IMR90|chr12:90550906-90550934,chr12,90550906,90550934,IMR90|chr12:6449703-6449800,chr12,6449703,6449800,0,84101203
IMR90|chr12:90949458-90949487,chr12,90949458,90949487,IMR90|chr12:133400611-133400715,chr12,133400611,133400715,0,42451153
IMR90|chr12:91008883-91008920,chr12,91008883,91008920,IMR90|chr12:42724049-42724111,chr12,42724049,42724111,0,48284834
IMR90|chr12:91032078-91032139,chr12,91032078,91032139,IMR90|chr12:57037461-57037522,chr12,57037461,57037522,0,33994617
IMR90|chr12:91265870-91265994,chr12,91265870,91265994,IMR90|chr12:133404895-133404921,chr12,133404895,133404921,0,42139025
IMR90|chr12:91278160-91278185,chr12,91278160,91278185,IMR90|chr12:1699905-1699932,chr12,1699905,1699932,0,89578255
IMR90|chr12:91316487-91316520,chr12,91316487,91316520,IMR90|chr12:69005399-69005470,chr12,69005399,69005470,0,22311088
IMR90|chr12:91331574-91331698,chr12,91331574,91331698,IMR90|chr12:133404895-133404921,chr12,133404895,133404921,0,42073321
IMR90|chr12:91410672-91410729,chr12,91410672,91410729,IMR90|chr12:122511888-122511950,chr12,122511888,122511950,0,31101216
IMR90|chr12:91439280-91439325,chr12,91439280,91439325,IMR90|chr12:6877901-6877931,chr12,6877901,6877931,0,84561379
IMR90|chr12:91556505-91556636,chr12,91556505,91556636,IMR90|chr12:104683975-104684041,chr12,104683975,104684041,0,13127470
IMR90|chr12:91928555-91928604,chr12,91928555,91928604,IMR90|chr12:49451427-49451464,chr12,49451427,49451464,0,42477128
IMR90|chr12:92085387-92085444,chr12,92085387,92085444,IMR90|chr12:122511888-122511950,chr12,122511888,122511950,0,30426501
IMR90|chr12:92353688-92353755,chr12,92353688,92353755,IMR90|chr12:51313870-51313953,chr12,51313870,51313953,0,41039818
IMR90|chr12:92710749-92710812,chr12,92710749,92710812,IMR90|chr12:64238707-64238763,chr12,64238707,64238763,0,28472042
IMR90|chr12:92784991-92785025,chr12,92784991,92785025,IMR90|chr12:88536639-88536737,chr12,88536639,88536737,0,4248352
IMR90|chr12:92826596-92826673,chr12,92826596,92826673,IMR90|chr12:76477333-76477357,chr12,76477333,76477357,0,16349263
IMR90|chr12:93110755-93110846,chr12,93110755,93110846,IMR90|chr12:49661657-49661705,chr12,49661657,49661705,0,43449098
IMR90|chr12:93149605-93149675,chr12,93149605,93149675,IMR90|chr12:64800648-64800691,chr12,64800648,64800691,0,28348957
IMR90|chr12:93182256-93182378,chr12,93182256,93182378,IMR90|chr12:112549450-112549478,chr12,112549450,112549478,0,19367194
IMR90|chr12:93276668-93276712,chr12,93276668,93276712,IMR90|chr12:42631171-42631253,chr12,42631171,42631253,0,50645497
IMR90|chr12:93364466-93364548,chr12,93364466,93364548,IMR90|chr12:95949726-95949794,chr12,95949726,95949794,0,2585260
IMR90|chr12:93457105-93457141,chr12,93457105,93457141,IMR90|chr12:66220032-66220152,chr12,66220032,66220152,0,27237073
IMR90|chr12:93458148-93458204,chr12,93458148,93458204,IMR90|chr12:132339867-132339896,chr12,132339867,132339896,0,38881719
IMR90|chr12:93946303-93946385,chr12,93946303,93946385,IMR90|chr12:104682395-104682414,chr12,104682395,104682414,0,10736092
IMR90|chr12:94096559-94096622,chr12,94096559,94096622,IMR90|chr12:21655942-21656041,chr12,21655942,21656041,0,72440617
IMR90|chr12:94244648-94244692,chr12,94244648,94244692,IMR90|chr12:66220947-66221053,chr12,66220947,66221053,0,28023701
IMR90|chr12:94530469-94530491,chr12,94530469,94530491,IMR90|chr12:109250723-109250780,chr12,109250723,109250780,0,14720254
IMR90|chr12:94560066-94560155,chr12,94560066,94560155,IMR90|chr12:51313870-51313953,chr12,51313870,51313953,0,43246196
IMR90|chr12:94665035-94665140,chr12,94665035,94665140,IMR90|chr12:104683147-104683178,chr12,104683147,104683178,0,10018112
IMR90|chr12:94688752-94688898,chr12,94688752,94688898,IMR90|chr12:13039809-13039908,chr12,13039809,13039908,0,81648943
IMR90|chr12:94735715-94735833,chr12,94735715,94735833,IMR90|chr12:111803726-111803746,chr12,111803726,111803746,0,17068011
IMR90|chr12:94839465-94839515,chr12,94839465,94839515,IMR90|chr12:133403124-133403199,chr12,133403124,133403199,0,38563659
IMR90|chr12:95014009-95014072,chr12,95014009,95014072,IMR90|chr12:21655942-21656041,chr12,21655942,21656041,0,73358067
IMR90|chr12:95100391-95100541,chr12,95100391,95100541,IMR90|chr12:72229783-72229830,chr12,72229783,72229830,0,22870608
IMR90|chr12:95197598-95197619,chr12,95197598,95197619,IMR90|chr12:54677002-54677067,chr12,54677002,54677067,0,40520596
IMR90|chr12:95427701-95427759,chr12,95427701,95427759,IMR90|chr12:46759694-46759767,chr12,46759694,46759767,0,48668007
IMR90|chr12:95785275-95785354,chr12,95785275,95785354,IMR90|chr12:88972333-88972429,chr12,88972333,88972429,0,6812942
IMR90|chr12:95902655-95902716,chr12,95902655,95902716,IMR90|chr12:1685938-1685977,chr12,1685938,1685977,0,94216717
IMR90|chr12:96128384-96128464,chr12,96128384,96128464,IMR90|chr12:46759466-46759607,chr12,46759466,46759607,0,49368918
IMR90|chr12:96226371-96226457,chr12,96226371,96226457,IMR90|chr12:122516200-122516247,chr12,122516200,122516247,0,26289829
IMR90|chr12:96425182-96425332,chr12,96425182,96425332,IMR90|chr12:122512264-122512365,chr12,122512264,122512365,0,26087082
IMR90|chr12:96990187-96990258,chr12,96990187,96990258,IMR90|chr12:27237498-27237530,chr12,27237498,27237530,0,69752689
IMR90|chr12:97388380-97388530,chr12,97388380,97388530,IMR90|chr12:72229783-72229830,chr12,72229783,72229830,0,25158597
IMR90|chr12:97670353-97670390,chr12,97670353,97670390,IMR90|chr12:6714515-6714561,chr12,6714515,6714561,0,90955838
IMR90|chr12:97755254-97755275,chr12,97755254,97755275,IMR90|chr12:66220913-66221011,chr12,66220913,66221011,0,31534341
IMR90|chr12:98163073-98163182,chr12,98163073,98163182,IMR90|chr12:28127023-28127089,chr12,28127023,28127089,0,70036050
IMR90|chr12:98219422-98219497,chr12,98219422,98219497,IMR90|chr12:98992721-98992776,chr12,98992721,98992776,0,773299
IMR90|chr12:98418389-98418428,chr12,98418389,98418428,IMR90|chr12:122515603-122515704,chr12,122515603,122515704,0,24097214
IMR90|chr12:98589174-98589208,chr12,98589174,98589208,IMR90|chr12:64238013-64238117,chr12,64238013,64238117,0,34351161
IMR90|chr12:98604336-98604381,chr12,98604336,98604381,IMR90|chr12:109899167-109899229,chr12,109899167,109899229,0,11294831
IMR90|chr12:98857830-98857892,chr12,98857830,98857892,IMR90|chr12:1685938-1685977,chr12,1685938,1685977,0,97171892
IMR90|chr12:98913125-98913218,chr12,98913125,98913218,IMR90|chr12:96798383-96798440,chr12,96798383,96798440,0,2114742
IMR90|chr12:98936298-98936336,chr12,98936298,98936336,IMR90|chr12:105634534-105634568,chr12,105634534,105634568,0,6698236
IMR90|chr12:99090638-99090767,chr12,99090638,99090767,IMR90|chr12:118572465-118572575,chr12,118572465,118572575,0,19481827
IMR90|chr12:99185682-99185711,chr12,99185682,99185711,IMR90|chr12:89748113-89748156,chr12,89748113,89748156,0,9437569
IMR90|chr12:99253063-99253101,chr12,99253063,99253101,IMR90|chr12:95949716-95949794,chr12,95949716,95949794,0,3303347
IMR90|chr12:99385719-99385753,chr12,99385719,99385753,IMR90|chr12:64238013-64238117,chr12,64238013,64238117,0,35147706
IMR90|chr12:99513831-99513876,chr12,99513831,99513876,IMR90|chr12:69006281-69006374,chr12,69006281,69006374,0,30507550
IMR90|chr12:99636322-99636384,chr12,99636322,99636384,IMR90|chr12:122511884-122511945,chr12,122511884,122511945,0,22875562
IMR90|chr12:99776910-99776941,chr12,99776910,99776941,IMR90|chr12:58236820-58236885,chr12,58236820,58236885,0,41540090
IMR90|chr12:99810882-99810917,chr12,99810882,99810917,IMR90|chr12:122512354-122512383,chr12,122512354,122512383,0,22701472
IMR90|chr12:99812474-99812624,chr12,99812474,99812624,IMR90|chr12:89750300-89750319,chr12,89750300,89750319,0,10062174
IMR90|chr12:100466955-100467021,chr12,100466955,100467021,IMR90|chr12:111841543-111841580,chr12,111841543,111841580,0,11374588
IMR90|chr12:100601620-100601747,chr12,100601620,100601747,IMR90|chr12:65005255-65005281,chr12,65005255,65005281,0,35596365
IMR90|chr12:100711921-100711964,chr12,100711921,100711964,IMR90|chr12:109248562-109248611,chr12,109248562,109248611,0,8536641
IMR90|chr12:101056310-101056352,chr12,101056310,101056352,IMR90|chr12:109251799-109251939,chr12,109251799,109251939,0,8195489
IMR90|chr12:101167835-101167895,chr12,101167835,101167895,IMR90|chr12:52346515-52346558,chr12,52346515,52346558,0,48821320
IMR90|chr12:101279475-101279517,chr12,101279475,101279517,IMR90|chr12:6447724-6447834,chr12,6447724,6447834,0,94831751
IMR90|chr12:101448975-101449020,chr12,101448975,101449020,IMR90|chr12:69675603-69675651,chr12,69675603,69675651,0,31773372
IMR90|chr12:101489449-101489517,chr12,101489449,101489517,IMR90|chr12:1642913-1642951,chr12,1642913,1642951,0,99846536
IMR90|chr12:101698366-101698473,chr12,101698366,101698473,IMR90|chr12:6450208-6450226,chr12,6450208,6450226,0,95248158
IMR90|chr12:101839721-101839801,chr12,101839721,101839801,IMR90|chr12:46759466-46759607,chr12,46759466,46759607,0,55080255
IMR90|chr12:102063967-102064030,chr12,102063967,102064030,IMR90|chr12:89749138-89749243,chr12,89749138,89749243,0,12314829
IMR90|chr12:102074405-102074449,chr12,102074405,102074449,IMR90|chr12:76745317-76745419,chr12,76745317,76745419,0,25329088
IMR90|chr12:102124913-102124984,chr12,102124913,102124984,IMR90|chr12:64800648-64800691,chr12,64800648,64800691,0,37324265
IMR90|chr12:102180115-102180175,chr12,102180115,102180175,IMR90|chr12:66220913-66221011,chr12,66220913,66221011,0,35959202
IMR90|chr12:102231007-102231079,chr12,102231007,102231079,IMR90|chr12:13351887-13351934,chr12,13351887,13351934,0,88879120
IMR90|chr12:102320995-102321119,chr12,102320995,102321119,IMR90|chr12:65005255-65005281,chr12,65005255,65005281,0,37315740
IMR90|chr12:102738551-102738607,chr12,102738551,102738607,IMR90|chr12:109247420-109247514,chr12,109247420,109247514,0,6508869
IMR90|chr12:102848894-102848954,chr12,102848894,102848954,IMR90|chr12:66220913-66221011,chr12,66220913,66221011,0,36627981
IMR90|chr12:103239859-103239960,chr12,103239859,103239960,IMR90|chr12:98990098-98990144,chr12,98990098,98990144,0,4249761
IMR90|chr12:103293355-103293399,chr12,103293355,103293399,IMR90|chr12:57117832-57117893,chr12,57117832,57117893,0,46175523
IMR90|chr12:103329596-103329643,chr12,103329596,103329643,IMR90|chr12:133400720-133400776,chr12,133400720,133400776,0,30071124
IMR90|chr12:103617884-103617945,chr12,103617884,103617945,IMR90|chr12:1701522-1701640,chr12,1701522,1701640,0,101916362
IMR90|chr12:103630922-103631005,chr12,103630922,103631005,IMR90|chr12:120665165-120665310,chr12,120665165,120665310,0,17034243
IMR90|chr12:104071902-104071931,chr12,104071902,104071931,IMR90|chr12:120885300-120885418,chr12,120885300,120885418,0,16813398
IMR90|chr12:104654023-104654109,chr12,104654023,104654109,IMR90|chr12:97305253-97305290,chr12,97305253,97305290,0,7348770
IMR90|chr12:104784470-104784557,chr12,104784470,104784557,IMR90|chr12:110887022-110887172,chr12,110887022,110887172,0,6102552
IMR90|chr12:105370654-105370765,chr12,105370654,105370765,IMR90|chr12:1773033-1773072,chr12,1773033,1773072,0,103597621
IMR90|chr12:105483634-105483688,chr12,105483634,105483688,IMR90|chr12:64800194-64800244,chr12,64800194,64800244,0,40683440
IMR90|chr12:105742286-105742324,chr12,105742286,105742324,IMR90|chr12:49932217-49932296,chr12,49932217,49932296,0,55810069
IMR90|chr12:105966718-105966772,chr12,105966718,105966772,IMR90|chr12:30904867-30904963,chr12,30904867,30904963,0,75061851
IMR90|chr12:106158304-106158337,chr12,106158304,106158337,IMR90|chr12:121784115-121784208,chr12,121784115,121784208,0,15625811
IMR90|chr12:106191279-106191317,chr12,106191279,106191317,IMR90|chr12:49932217-49932296,chr12,49932217,49932296,0,56259062
IMR90|chr12:106386519-106386583,chr12,106386519,106386583,IMR90|chr12:66220970-66221021,chr12,66220970,66221021,0,40165549
IMR90|chr12:106682836-106682922,chr12,106682836,106682922,IMR90|chr12:51480363-51480427,chr12,51480363,51480427,0,55202473
IMR90|chr12:106699718-106699796,chr12,106699718,106699796,IMR90|chr12:109247420-109247514,chr12,109247420,109247514,0,2547702
IMR90|chr12:106778710-106778813,chr12,106778710,106778813,IMR90|chr12:57116126-57116145,chr12,57116126,57116145,0,49662584
IMR90|chr12:108182806-108182842,chr12,108182806,108182842,IMR90|chr12:76429583-76429621,chr12,76429583,76429621,0,31753223
IMR90|chr12:108200293-108200435,chr12,108200293,108200435,IMR90|chr12:114844239-114844280,chr12,114844239,114844280,0,6643946
IMR90|chr12:108227247-108227369,chr12,108227247,108227369,IMR90|chr12:13042826-13042854,chr12,13042826,13042854,0,95184421
IMR90|chr12:109168602-109168636,chr12,109168602,109168636,IMR90|chr12:27237498-27237530,chr12,27237498,27237530,0,81931104
IMR90|chr12:109175675-109175787,chr12,109175675,109175787,IMR90|chr12:1773033-1773072,chr12,1773033,1773072,0,107402642
IMR90|chr12:109350564-109350617,chr12,109350564,109350617,IMR90|chr12:88972333-88972430,chr12,88972333,88972430,0,20378231
IMR90|chr12:109524586-109524675,chr12,109524586,109524675,IMR90|chr12:97302660-97302725,chr12,97302660,97302725,0,12221926
IMR90|chr12:109672922-109672957,chr12,109672922,109672957,IMR90|chr12:50100631-50100700,chr12,50100631,50100700,0,59572291
IMR90|chr12:109728045-109728106,chr12,109728045,109728106,IMR90|chr12:122518225-122518260,chr12,122518225,122518260,0,12790180
IMR90|chr12:109927776-109927858,chr12,109927776,109927858,IMR90|chr12:57524331-57524368,chr12,57524331,57524368,0,52403445
IMR90|chr12:110139952-110140051,chr12,110139952,110140051,IMR90|chr12:133401302-133401341,chr12,133401302,133401341,0,23261350
IMR90|chr12:110224090-110224181,chr12,110224090,110224181,IMR90|chr12:49661657-49661705,chr12,49661657,49661705,0,60562433
IMR90|chr12:110326742-110326884,chr12,110326742,110326884,IMR90|chr12:114844239-114844280,chr12,114844239,114844280,0,4517497
IMR90|chr12:110328125-110328195,chr12,110328125,110328195,IMR90|chr12:10874917-10874992,chr12,10874917,10874992,0,99453208
IMR90|chr12:110328226-110328290,chr12,110328226,110328290,IMR90|chr12:122512868-122512950,chr12,122512868,122512950,0,12184642
IMR90|chr12:110434231-110434320,chr12,110434231,110434320,IMR90|chr12:122513149-122513165,chr12,122513149,122513165,0,12078918
IMR90|chr12:110438624-110438725,chr12,110438624,110438725,IMR90|chr12:56366661-56366687,chr12,56366661,56366687,0,54071963
IMR90|chr12:110592517-110592623,chr12,110592517,110592623,IMR90|chr12:50681972-50682118,chr12,50681972,50682118,0,59910545
IMR90|chr12:110596968-110597034,chr12,110596968,110597034,IMR90|chr12:122059708-122059773,chr12,122059708,122059773,0,11462740
IMR90|chr12:110670418-110670540,chr12,110670418,110670540,IMR90|chr12:112549450-112549478,chr12,112549450,112549478,0,1879032
IMR90|chr12:110709210-110709292,chr12,110709210,110709292,IMR90|chr12:64799533-64799563,chr12,64799533,64799563,0,45909677
IMR90|chr12:110831426-110831545,chr12,110831426,110831545,IMR90|chr12:57118118-57118147,chr12,57118118,57118147,0,53713308
IMR90|chr12:110960040-110960086,chr12,110960040,110960086,IMR90|chr12:1700929-1701020,chr12,1700929,1701020,0,109259111
IMR90|chr12:111005700-111005781,chr12,111005700,111005781,IMR90|chr12:53397783-53397821,chr12,53397783,53397821,0,57607917
IMR90|chr12:111131406-111131470,chr12,111131406,111131470,IMR90|chr12:120665166-120665310,chr12,120665166,120665310,0,9533760
IMR90|chr12:111291890-111291981,chr12,111291890,111291981,IMR90|chr12:95949735-95949794,chr12,95949735,95949794,0,15342155
IMR90|chr12:111304454-111304511,chr12,111304454,111304511,IMR90|chr12:125053061-125053106,chr12,125053061,125053106,0,13748607
IMR90|chr12:111788183-111788216,chr12,111788183,111788216,IMR90|chr12:57115418-57115442,chr12,57115418,57115442,0,54672765
IMR90|chr12:111999762-111999822,chr12,111999762,111999822,IMR90|chr12:46659771-46659842,chr12,46659771,46659842,0,65339991
IMR90|chr12:112111712-112111761,chr12,112111712,112111761,IMR90|chr12:69204608-69204709,chr12,69204608,69204709,0,42907104
IMR90|chr12:112134633-112134773,chr12,112134633,112134773,IMR90|chr12:122512354-122512383,chr12,122512354,122512383,0,10377721
IMR90|chr12:112453501-112453590,chr12,112453501,112453590,IMR90|chr12:97302660-97302725,chr12,97302660,97302725,0,15150841
IMR90|chr12:112702602-112702666,chr12,112702602,112702666,IMR90|chr12:120665166-120665310,chr12,120665166,120665310,0,7962564
IMR90|chr12:112750384-112750443,chr12,112750384,112750443,IMR90|chr12:122518225-122518260,chr12,122518225,122518260,0,9767841
IMR90|chr12:112772421-112772535,chr12,112772421,112772535,IMR90|chr12:25101280-25101306,chr12,25101280,25101306,0,87671141
IMR90|chr12:113157472-113157538,chr12,113157472,113157538,IMR90|chr12:46764030-46764117,chr12,46764030,46764117,0,66393442
IMR90|chr12:113281135-113281206,chr12,113281135,113281206,IMR90|chr12:122513069-122513117,chr12,122513069,122513117,0,9231934
IMR90|chr12:113500378-113500422,chr12,113500378,113500422,IMR90|chr12:76424085-76424167,chr12,76424085,76424167,0,37076293
IMR90|chr12:113640565-113640592,chr12,113640565,113640592,IMR90|chr12:1771621-1771738,chr12,1771621,1771738,0,111868944
IMR90|chr12:113681733-113681839,chr12,113681733,113681839,IMR90|chr12:50681972-50682118,chr12,50681972,50682118,0,62999761
IMR90|chr12:113693470-113693553,chr12,113693470,113693553,IMR90|chr12:56620643-56620671,chr12,56620643,56620671,0,57072827
IMR90|chr12:113712999-113713085,chr12,113712999,113713085,IMR90|chr12:97305253-97305290,chr12,97305253,97305290,0,16407746
IMR90|chr12:113780107-113780178,chr12,113780107,113780178,IMR90|chr12:105626187-105626223,chr12,105626187,105626223,0,8153920
IMR90|chr12:113782657-113782743,chr12,113782657,113782743,IMR90|chr12:8091484-8091546,chr12,8091484,8091546,0,105691173
IMR90|chr12:113855163-113855232,chr12,113855163,113855232,IMR90|chr12:122511643-122511716,chr12,122511643,122511716,0,8656480
IMR90|chr12:113914839-113914876,chr12,113914839,113914876,IMR90|chr12:42623982-42624092,chr12,42623982,42624092,0,71290857
IMR90|chr12:113970314-113970352,chr12,113970314,113970352,IMR90|chr12:64800263-64800375,chr12,64800263,64800375,0,49170051
IMR90|chr12:114061651-114061689,chr12,114061651,114061689,IMR90|chr12:57039331-57039400,chr12,57039331,57039400,0,57022320
IMR90|chr12:114487426-114487506,chr12,114487426,114487506,IMR90|chr12:13039289-13039359,chr12,13039289,13039359,0,101448137
IMR90|chr12:114896303-114896402,chr12,114896303,114896402,IMR90|chr12:120885014-120885041,chr12,120885014,120885041,0,5988711
IMR90|chr12:114919553-114919604,chr12,114919553,114919604,IMR90|chr12:54671874-54671931,chr12,54671874,54671931,0,60247679
IMR90|chr12:114923969-114924007,chr12,114923969,114924007,IMR90|chr12:69005703-69005806,chr12,69005703,69005806,0,45918266
IMR90|chr12:115210840-115210948,chr12,115210840,115210948,IMR90|chr12:105627747-105627779,chr12,105627747,105627779,0,9583093
IMR90|chr12:115356398-115356475,chr12,115356398,115356475,IMR90|chr12:110439274-110439356,chr12,110439274,110439356,0,4917124
IMR90|chr12:115703691-115703751,chr12,115703691,115703751,IMR90|chr12:96795291-96795335,chr12,96795291,96795335,0,18908400
IMR90|chr12:115824015-115824091,chr12,115824015,115824091,IMR90|chr12:88536644-88536687,chr12,88536644,88536687,0,27287371
IMR90|chr12:115838262-115838300,chr12,115838262,115838300,IMR90|chr12:109247357-109247400,chr12,109247357,109247400,0,6590905
IMR90|chr12:116425624-116425676,chr12,116425624,116425676,IMR90|chr12:120703025-120703123,chr12,120703025,120703123,0,4277401
IMR90|chr12:116594687-116594778,chr12,116594687,116594778,IMR90|chr12:7245541-7245582,chr12,7245541,7245582,0,109349146
IMR90|chr12:116598159-116598306,chr12,116598159,116598306,IMR90|chr12:13042826-13042854,chr12,13042826,13042854,0,103555333
IMR90|chr12:116967615-116967690,chr12,116967615,116967690,IMR90|chr12:69005405-69005476,chr12,69005405,69005476,0,47962210
IMR90|chr12:117062138-117062214,chr12,117062138,117062214,IMR90|chr12:88536644-88536687,chr12,88536644,88536687,0,28525494
IMR90|chr12:117407154-117407192,chr12,117407154,117407192,IMR90|chr12:109247357-109247400,chr12,109247357,109247400,0,8159797
IMR90|chr12:117453996-117454091,chr12,117453996,117454091,IMR90|chr12:122512838-122512907,chr12,122512838,122512907,0,5058842
IMR90|chr12:117576078-117576169,chr12,117576078,117576169,IMR90|chr12:57526099-57526148,chr12,57526099,57526148,0,60049979
IMR90|chr12:117583334-117583442,chr12,117583334,117583442,IMR90|chr12:105627747-105627779,chr12,105627747,105627779,0,11955587
IMR90|chr12:117586366-117586403,chr12,117586366,117586403,IMR90|chr12:57039331-57039400,chr12,57039331,57039400,0,60547035
IMR90|chr12:117777999-117778044,chr12,117777999,117778044,IMR90|chr12:69006281-69006374,chr12,69006281,69006374,0,48771718
IMR90|chr12:117840353-117840503,chr12,117840353,117840503,IMR90|chr12:112455740-112455852,chr12,112455740,112455852,0,5384613
IMR90|chr12:117871554-117871650,chr12,117871554,117871650,IMR90|chr12:133403973-133404021,chr12,133403973,133404021,0,15532419
IMR90|chr12:118239566-118239597,chr12,118239566,118239597,IMR90|chr12:98988421-98988443,chr12,98988421,98988443,0,19251145
IMR90|chr12:118462056-118462107,chr12,118462056,118462107,IMR90|chr12:13039809-13039908,chr12,13039809,13039908,0,105422247
IMR90|chr12:118471373-118471454,chr12,118471373,118471454,IMR90|chr12:122512838-122512907,chr12,122512838,122512907,0,4041465
IMR90|chr12:118556367-118556446,chr12,118556367,118556446,IMR90|chr12:88972333-88972429,chr12,88972333,88972429,0,29584034
IMR90|chr12:119192835-119192985,chr12,119192835,119192985,IMR90|chr12:122512264-122512365,chr12,122512264,122512365,0,3319429
IMR90|chr12:119228583-119228621,chr12,119228583,119228621,IMR90|chr12:42724049-42724111,chr12,42724049,42724111,0,76504534
IMR90|chr12:119339179-119339259,chr12,119339179,119339259,IMR90|chr12:56884721-56884768,chr12,56884721,56884768,0,62454458
IMR90|chr12:119445828-119445912,chr12,119445828,119445912,IMR90|chr12:120665165-120665310,chr12,120665165,120665310,0,1219337
IMR90|chr12:119761252-119761308,chr12,119761252,119761308,IMR90|chr12:49659629-49659683,chr12,49659629,49659683,0,70101623
IMR90|chr12:119907876-119907964,chr12,119907876,119907964,IMR90|chr12:122515565-122515630,chr12,122515565,122515630,0,2607689
IMR90|chr12:119969104-119969158,chr12,119969104,119969158,IMR90|chr12:106640027-106640091,chr12,106640027,106640091,0,13329077
IMR90|chr12:120027563-120027640,chr12,120027563,120027640,IMR90|chr12:110439274-110439356,chr12,110439274,110439356,0,9588289
IMR90|chr12:120033399-120033476,chr12,120033399,120033476,IMR90|chr12:51610576-51610637,chr12,51610576,51610637,0,68422823
IMR90|chr12:120166792-120166816,chr12,120166792,120166816,IMR90|chr12:57116948-57117018,chr12,57116948,57117018,0,63049844
IMR90|chr12:120191085-120191126,chr12,120191085,120191126,IMR90|chr12:122515562-122515626,chr12,122515562,122515626,0,2324477
IMR90|chr12:120469769-120469845,chr12,120469769,120469845,IMR90|chr12:76476747-76476813,chr12,76476747,76476813,0,43993022
IMR90|chr12:120708570-120708632,chr12,120708570,120708632,IMR90|chr12:118572463-118572573,chr12,118572463,118572573,0,2136107
IMR90|chr12:120928972-120928990,chr12,120928972,120928990,IMR90|chr12:13042389-13042430,chr12,13042389,13042430,0,107886583
IMR90|chr12:121617105-121617167,chr12,121617105,121617167,IMR90|chr12:122511884-122511945,chr12,122511884,122511945,0,894779
IMR90|chr12:121863311-121863368,chr12,121863311,121863368,IMR90|chr12:57029309-57029386,chr12,57029309,57029386,0,64834002
IMR90|chr12:122140137-122140187,chr12,122140137,122140187,IMR90|chr12:21655942-21656041,chr12,21655942,21656041,0,100484195
IMR90|chr12:122676598-122676711,chr12,122676598,122676711,IMR90|chr12:49659163-49659199,chr12,49659163,49659199,0,73017435
IMR90|chr12:122728416-122728477,chr12,122728416,122728477,IMR90|chr12:122512868-122512950,chr12,122512868,122512950,0,215548
IMR90|chr12:122894602-122894674,chr12,122894602,122894674,IMR90|chr12:13351887-13351934,chr12,13351887,13351934,0,109542715
IMR90|chr12:122926301-122926370,chr12,122926301,122926370,IMR90|chr12:122515887-122515928,chr12,122515887,122515928,0,410414
IMR90|chr12:122929598-122929623,chr12,122929598,122929623,IMR90|chr12:1699905-1699932,chr12,1699905,1699932,0,121229693
IMR90|chr12:123257858-123257933,chr12,123257858,123257933,IMR90|chr12:98992721-98992776,chr12,98992721,98992776,0,24265137
IMR90|chr12:123320556-123320620,chr12,123320556,123320620,IMR90|chr12:66220970-66221021,chr12,66220970,66221021,0,57099586
IMR90|chr12:123359048-123359099,chr12,123359048,123359099,IMR90|chr12:122515558-122515700,chr12,122515558,122515700,0,843490
IMR90|chr12:123945889-123946010,chr12,123945889,123946010,IMR90|chr12:72233991-72234012,chr12,72233991,72234012,0,51711898
IMR90|chr12:124166379-124166466,chr12,124166379,124166466,IMR90|chr12:66216760-66216805,chr12,66216760,66216805,0,57949619
IMR90|chr12:124488013-124488085,chr12,124488013,124488085,IMR90|chr12:46765971-46766049,chr12,46765971,46766049,0,77722042
IMR90|chr12:124572318-124572373,chr12,124572318,124572373,IMR90|chr12:133402948-133403004,chr12,133402948,133403004,0,8830630
IMR90|chr12:124807423-124807511,chr12,124807423,124807511,IMR90|chr12:97305253-97305290,chr12,97305253,97305290,0,27502170
IMR90|chr12:125069444-125069566,chr12,125069444,125069566,IMR90|chr12:13042826-13042854,chr12,13042826,13042854,0,112026618
IMR90|chr12:125120628-125120699,chr12,125120628,125120699,IMR90|chr12:54671646-54671698,chr12,54671646,54671698,0,70448982
IMR90|chr12:125134171-125134235,chr12,125134171,125134235,IMR90|chr12:49452042-49452144,chr12,49452042,49452144,0,75682129
IMR90|chr12:125151540-125151609,chr12,125151540,125151609,IMR90|chr12:68044696-68044777,chr12,68044696,68044777,0,57106844
IMR90|chr12:125159007-125159027,chr12,125159007,125159027,IMR90|chr12:123009053-123009152,chr12,123009053,123009152,0,2149954
IMR90|chr12:125172336-125172396,chr12,125172336,125172396,IMR90|chr12:96795291-96795335,chr12,96795291,96795335,0,28377045
IMR90|chr12:125353978-125354102,chr12,125353978,125354102,IMR90|chr12:65005255-65005281,chr12,65005255,65005281,0,60348723
IMR90|chr12:125559205-125559267,chr12,125559205,125559267,IMR90|chr12:123378769-123378821,chr12,123378769,123378821,0,2180436
IMR90|chr12:125713933-125714013,chr12,125713933,125714013,IMR90|chr12:49663176-49663231,chr12,49663176,49663231,0,76050757
IMR90|chr12:125772140-125772217,chr12,125772140,125772217,IMR90|chr12:111845198-111845275,chr12,111845198,111845275,0,13926942
IMR90|chr12:125815274-125815355,chr12,125815274,125815355,IMR90|chr12:125052709-125052773,chr12,125052709,125052773,0,762565
IMR90|chr12:126120778-126120857,chr12,126120778,126120857,IMR90|chr12:16502334-16502387,chr12,16502334,16502387,0,109618444
IMR90|chr12:126242187-126242308,chr12,126242187,126242308,IMR90|chr12:57118118-57118147,chr12,57118118,57118147,0,69124069
IMR90|chr12:126270949-126270985,chr12,126270949,126270985,IMR90|chr12:98989156-98989227,chr12,98989156,98989227,0,27281793
IMR90|chr12:126467967-126468038,chr12,126467967,126468038,IMR90|chr12:42721930-42722009,chr12,42721930,42722009,0,83746037
IMR90|chr12:126521108-126521149,chr12,126521108,126521149,IMR90|chr12:109248562-109248611,chr12,109248562,109248611,0,17272546
IMR90|chr12:127036770-127036851,chr12,127036770,127036851,IMR90|chr12:122514415-122514479,chr12,122514415,122514479,0,4522355
IMR90|chr12:127168576-127168672,chr12,127168576,127168672,IMR90|chr12:133403973-133404021,chr12,133403973,133404021,0,6235397
IMR90|chr12:127250153-127250178,chr12,127250153,127250178,IMR90|chr12:114847023-114847148,chr12,114847023,114847148,0,12403130
IMR90|chr12:127320164-127320237,chr12,127320164,127320237,IMR90|chr12:10874917-10874992,chr12,10874917,10874992,0,116445247
IMR90|chr12:127382917-127382979,chr12,127382917,127382979,IMR90|chr12:122514281-122514360,chr12,122514281,122514360,0,4868636
IMR90|chr12:127394616-127394681,chr12,127394616,127394681,IMR90|chr12:122512868-122512950,chr12,122512868,122512950,0,4881748
IMR90|chr12:127772375-127772468,chr12,127772375,127772468,IMR90|chr12:46763086-46763143,chr12,46763086,46763143,0,81009289
IMR90|chr12:127939892-127939953,chr12,127939892,127939953,IMR90|chr12:79261789-79261877,chr12,79261789,79261877,0,48678103
IMR90|chr12:128250426-128250478,chr12,128250426,128250478,IMR90|chr12:106640027-106640091,chr12,106640027,106640091,0,21610399
IMR90|chr12:128683932-128684002,chr12,128683932,128684002,IMR90|chr12:64800648-64800691,chr12,64800648,64800691,0,63883284
IMR90|chr12:128730725-128730752,chr12,128730725,128730752,IMR90|chr12:122512264-122512365,chr12,122512264,122512365,0,6218461
IMR90|chr12:128817482-128817558,chr12,128817482,128817558,IMR90|chr12:49109428-49109480,chr12,49109428,49109480,0,79708054
IMR90|chr12:128856813-128856898,chr12,128856813,128856898,IMR90|chr12:1700848-1700913,chr12,1700848,1700913,0,127155965
IMR90|chr12:129295737-129295821,chr12,129295737,129295821,IMR90|chr12:120665165-120665310,chr12,120665165,120665310,0,8630572
IMR90|chr12:129529031-129529065,chr12,129529031,129529065,IMR90|chr12:27237498-27237530,chr12,27237498,27237530,0,102291533
IMR90|chr12:129535293-129535379,chr12,129535293,129535379,IMR90|chr12:53835926-53836019,chr12,53835926,53836019,0,75699367
IMR90|chr12:129824595-129824633,chr12,129824595,129824633,IMR90|chr12:105634534-105634568,chr12,105634534,105634568,0,24190061
IMR90|chr12:129870247-129870319,chr12,129870247,129870319,IMR90|chr12:105626187-105626223,chr12,105626187,105626223,0,24244060
IMR90|chr12:130059174-130059246,chr12,130059174,130059246,IMR90|chr12:76429583-76429630,chr12,76429583,76429630,0,53629591
IMR90|chr12:130187463-130187524,chr12,130187463,130187524,IMR90|chr12:79260141-79260209,chr12,79260141,79260209,0,50927322
IMR90|chr12:130310099-130310220,chr12,130310099,130310220,IMR90|chr12:57118118-57118147,chr12,57118118,57118147,0,73191981
IMR90|chr12:130346670-130346750,chr12,130346670,130346750,IMR90|chr12:49663176-49663231,chr12,49663176,49663231,0,80683494
IMR90|chr12:130649188-130649225,chr12,130649188,130649225,IMR90|chr12:50100631-50100700,chr12,50100631,50100700,0,80548557
IMR90|chr12:130691026-130691083,chr12,130691026,130691083,IMR90|chr12:57029309-57029386,chr12,57029309,57029386,0,73661717
IMR90|chr12:131215091-131215137,chr12,131215091,131215137,IMR90|chr12:57117832-57117893,chr12,57117832,57117893,0,74097259
IMR90|chr12:131225070-131225122,chr12,131225070,131225122,IMR90|chr12:120703025-120703123,chr12,120703025,120703123,0,10522045
IMR90|chr12:131277387-131277476,chr12,131277387,131277476,IMR90|chr12:122513149-122513165,chr12,122513149,122513165,0,8764238
IMR90|chr12:131802661-131802749,chr12,131802661,131802749,IMR90|chr12:64801572-64801626,chr12,64801572,64801626,0,67001089
IMR90|chr12:131991140-131991243,chr12,131991140,131991243,IMR90|chr12:13039289-13039359,chr12,13039289,13039359,0,118951851
IMR90|chr12:132085174-132085229,chr12,132085174,132085229,IMR90|chr12:49659629-49659683,chr12,49659629,49659683,0,82425545
IMR90|chr12:132264823-132264892,chr12,132264823,132264892,IMR90|chr12:77458923-77459037,chr12,77458923,77459037,0,54805900
IMR90|chr12:132275972-132276030,chr12,132275972,132276030,IMR90|chr12:863601-863699,chr12,863601,863699,0,131412371
IMR90|chr12:132288644-132288761,chr12,132288644,132288761,IMR90|chr12:46763086-46763143,chr12,46763086,46763143,0,85525558
IMR90|chr12:132331139-132331208,chr12,132331139,132331208,IMR90|chr12:68044696-68044777,chr12,68044696,68044777,0,64286443
IMR90|chr12:133121995-133122089,chr12,133121995,133122089,IMR90|chr12:121784115-121784168,chr12,121784115,121784168,0,11337880
IMR90|chr12:133130511-133130538,chr12,133130511,133130538,IMR90|chr12:6447724-6447834,chr12,6447724,6447834,0,126682787
IMR90|chr12:133395981-133396042,chr12,133395981,133396042,IMR90|chr12:79260141-79260209,chr12,79260141,79260209,0,54135840
IMR90|chr12:133504502-133504553,chr12,133504502,133504553,IMR90|chr12:114839183-114839256,chr12,114839183,114839256,0,18665319
IMR90|chr12:133579828-133579900,chr12,133579828,133579900,IMR90|chr12:64799223-64799247,chr12,64799223,64799247,0,68780605
IMR90|chr12:133603622-133603758,chr12,133603622,133603758,IMR90|chr12:111803726-111803746,chr12,111803726,111803746,0,21799896
IMR90|chr12:133614152-133614229,chr12,133614152,133614229,IMR90|chr12:88536644-88536687,chr12,88536644,88536687,0,45077508
IMR90|chr12:133741538-133741648,chr12,133741538,133741648,IMR90|chr12:122514602-122514637,chr12,122514602,122514637,0,11226936
IMR90|chr12:133757371-133757433,chr12,133757371,133757433,IMR90|chr12:46764109-46764176,chr12,46764109,46764176,0,86993262
IMR90|chr13:1095688-1095768,chr13,1095688,1095768,IMR90|chr13:53187240-53187319,chr13,53187240,53187319,0,52091552
IMR90|chr13:1122121-1122210,chr13,1122121,1122210,IMR90|chr13:115001479-115001556,chr13,115001479,115001556,0,113879358
IMR90|chr13:1140836-1140949,chr13,1140836,1140949,IMR90|chr13:108517607-108517660,chr13,108517607,108517660,0,107376771
IMR90|chr13:1747119-1747170,chr13,1747119,1747170,IMR90|chr13:114565317-114565384,chr13,114565317,114565384,0,112818198
IMR90|chr13:3186424-3186511,chr13,3186424,3186511,IMR90|chr13:108519598-108519627,chr13,108519598,108519627,0,105333174
IMR90|chr13:3638236-3638297,chr13,3638236,3638297,IMR90|chr13:108522584-108522637,chr13,108522584,108522637,0,104884348
IMR90|chr13:3727404-3727493,chr13,3727404,3727493,IMR90|chr13:111359321-111359378,chr13,111359321,111359378,0,107631917
IMR90|chr13:4613525-4613617,chr13,4613525,4613617,IMR90|chr13:41710898-41710960,chr13,41710898,41710960,0,37097373
IMR90|chr13:5061639-5061728,chr13,5061639,5061728,IMR90|chr13:114567666-114567765,chr13,114567666,114567765,0,109506027
IMR90|chr13:5402451-5402520,chr13,5402451,5402520,IMR90|chr13:114563525-114563575,chr13,114563525,114563575,0,109161074
IMR90|chr13:6127475-6127552,chr13,6127475,6127552,IMR90|chr13:20362001-20362061,chr13,20362001,20362061,0,14234526
IMR90|chr13:6280818-6280856,chr13,6280818,6280856,IMR90|chr13:108519243-108519336,chr13,108519243,108519336,0,102238425
IMR90|chr13:6954466-6954563,chr13,6954466,6954563,IMR90|chr13:108517607-108517660,chr13,108517607,108517660,0,101563141
IMR90|chr13:7101157-7101226,chr13,7101157,7101226,IMR90|chr13:114563525-114563575,chr13,114563525,114563575,0,107462368
IMR90|chr13:7735014-7735091,chr13,7735014,7735091,IMR90|chr13:20362001-20362061,chr13,20362001,20362061,0,12626987
IMR90|chr13:8395426-8395495,chr13,8395426,8395495,IMR90|chr13:23944001-23944070,chr13,23944001,23944070,0,15548575
IMR90|chr13:8752302-8752358,chr13,8752302,8752358,IMR90|chr13:23944849-23944943,chr13,23944849,23944943,0,15192547
IMR90|chr13:8754186-8754218,chr13,8754186,8754218,IMR90|chr13:114566045-114566118,chr13,114566045,114566118,0,105811859
IMR90|chr13:9219003-9219057,chr13,9219003,9219057,IMR90|chr13:114563268-114563333,chr13,114563268,114563333,0,105344265
IMR90|chr13:9232288-9232326,chr13,9232288,9232326,IMR90|chr13:108519243-108519336,chr13,108519243,108519336,0,99286955
IMR90|chr13:9665766-9665830,chr13,9665766,9665830,IMR90|chr13:98828455-98828496,chr13,98828455,98828496,0,89162689
IMR90|chr13:9676303-9676402,chr13,9676303,9676402,IMR90|chr13:108521969-108522019,chr13,108521969,108522019,0,98845666
IMR90|chr13:9817846-9817882,chr13,9817846,9817882,IMR90|chr13:52983212-52983250,chr13,52983212,52983250,0,43165366
IMR90|chr13:10739394-10739481,chr13,10739394,10739481,IMR90|chr13:33857031-33857080,chr13,33857031,33857080,0,23117637
IMR90|chr13:10879656-10879711,chr13,10879656,10879711,IMR90|chr13:114540663-114540721,chr13,114540663,114540721,0,103661007
IMR90|chr13:11104465-11104525,chr13,11104465,11104525,IMR90|chr13:23942907-23943006,chr13,23942907,23943006,0,12838442
IMR90|chr13:11544798-11544863,chr13,11544798,11544863,IMR90|chr13:76212102-76212186,chr13,76212102,76212186,0,64667304
IMR90|chr13:12065292-12065353,chr13,12065292,12065353,IMR90|chr13:50270249-50270335,chr13,50270249,50270335,0,38204957
IMR90|chr13:12779856-12779945,chr13,12779856,12779945,IMR90|chr13:111359321-111359378,chr13,111359321,111359378,0,98579465
IMR90|chr13:12983474-12983602,chr13,12983474,12983602,IMR90|chr13:108517607-108517660,chr13,108517607,108517660,0,95534133
IMR90|chr13:13534133-13534154,chr13,13534133,13534154,IMR90|chr13:114144609-114144698,chr13,114144609,114144698,0,100610476
IMR90|chr13:13594508-13594584,chr13,13594508,13594584,IMR90|chr13:67808508-67808582,chr13,67808508,67808582,0,54214000
IMR90|chr13:13719716-13719803,chr13,13719716,13719803,IMR90|chr13:108519598-108519627,chr13,108519598,108519627,0,94799882
IMR90|chr13:14461358-14461462,chr13,14461358,14461462,IMR90|chr13:108519722-108519768,chr13,108519722,108519768,0,94058364
IMR90|chr13:14747711-14747818,chr13,14747711,14747818,IMR90|chr13:114902628-114902658,chr13,114902628,114902658,0,100154917
IMR90|chr13:17514005-17514062,chr13,17514005,17514062,IMR90|chr13:114897694-114897738,chr13,114897694,114897738,0,97383689
IMR90|chr13:17552396-17552416,chr13,17552396,17552416,IMR90|chr13:67808452-67808582,chr13,67808452,67808582,0,50256056
IMR90|chr13:17893165-17893250,chr13,17893165,17893250,IMR90|chr13:45913819-45913863,chr13,45913819,45913863,0,28020654
IMR90|chr13:17925820-17925861,chr13,17925820,17925861,IMR90|chr13:45913530-45913604,chr13,45913530,45913604,0,27987710
IMR90|chr13:19725694-19725716,chr13,19725694,19725716,IMR90|chr13:52982105-52982225,chr13,52982105,52982225,0,33256411
IMR90|chr13:20193269-20193325,chr13,20193269,20193325,IMR90|chr13:23944849-23944943,chr13,23944849,23944943,0,3751580
IMR90|chr13:20308406-20308517,chr13,20308406,20308517,IMR90|chr13:21347814-21347841,chr13,21347814,21347841,0,1039408
IMR90|chr13:21080624-21080666,chr13,21080624,21080666,IMR90|chr13:97876354-97876455,chr13,97876354,97876455,0,76795730
IMR90|chr13:21362644-21362717,chr13,21362644,21362717,IMR90|chr13:31192838-31192886,chr13,31192838,31192886,0,9830194
IMR90|chr13:21584208-21584269,chr13,21584208,21584269,IMR90|chr13:108519451-108519494,chr13,108519451,108519494,0,86935243
IMR90|chr13:22431580-22431674,chr13,22431580,22431674,IMR90|chr13:76212870-76212901,chr13,76212870,76212901,0,53781290
IMR90|chr13:22860749-22860806,chr13,22860749,22860806,IMR90|chr13:52980990-52981114,chr13,52980990,52981114,0,30120241
IMR90|chr13:25635645-25635680,chr13,25635645,25635680,IMR90|chr13:52982229-52982379,chr13,52982229,52982379,0,27346584
IMR90|chr13:26045426-26045519,chr13,26045426,26045519,IMR90|chr13:50270249-50270335,chr13,50270249,50270335,0,24224823
IMR90|chr13:26845905-26845982,chr13,26845905,26845982,IMR90|chr13:31192838-31192886,chr13,31192838,31192886,0,4346933
IMR90|chr13:27404974-27405047,chr13,27404974,27405047,IMR90|chr13:76212102-76212186,chr13,76212102,76212186,0,48807128
IMR90|chr13:27557145-27557214,chr13,27557145,27557214,IMR90|chr13:23944001-23944070,chr13,23944001,23944070,0,3613144
IMR90|chr13:27698263-27698319,chr13,27698263,27698319,IMR90|chr13:114901147-114901211,chr13,114901147,114901211,0,87202884
IMR90|chr13:27799077-27799205,chr13,27799077,27799205,IMR90|chr13:108517607-108517660,chr13,108517607,108517660,0,80718530
IMR90|chr13:27847034-27847058,chr13,27847034,27847058,IMR90|chr13:114897065-114897172,chr13,114897065,114897172,0,87050031
IMR90|chr13:27957953-27958013,chr13,27957953,27958013,IMR90|chr13:23942907-23943006,chr13,23942907,23943006,0,4015046
IMR90|chr13:28571216-28571277,chr13,28571216,28571277,IMR90|chr13:50270249-50270335,chr13,50270249,50270335,0,21699033
IMR90|chr13:29379539-29379627,chr13,29379539,29379627,IMR90|chr13:41710898-41710960,chr13,41710898,41710960,0,12331359
IMR90|chr13:29422097-29422124,chr13,29422097,29422124,IMR90|chr13:114536842-114536940,chr13,114536842,114536940,0,85114745
IMR90|chr13:31708564-31708625,chr13,31708564,31708625,IMR90|chr13:108520894-108520941,chr13,108520894,108520941,0,76812330
IMR90|chr13:31821372-31821399,chr13,31821372,31821399,IMR90|chr13:108519249-108519301,chr13,108519249,108519301,0,76697877
IMR90|chr13:32750490-32750526,chr13,32750490,32750526,IMR90|chr13:114540078-114540187,chr13,114540078,114540187,0,81789588
IMR90|chr13:32758992-32759061,chr13,32758992,32759061,IMR90|chr13:97876354-97876455,chr13,97876354,97876455,0,65117362
IMR90|chr13:32891422-32891532,chr13,32891422,32891532,IMR90|chr13:52982846-52982921,chr13,52982846,52982921,0,20091424
IMR90|chr13:33200201-33200231,chr13,33200201,33200231,IMR90|chr13:108519203-108519347,chr13,108519203,108519347,0,75319002
IMR90|chr13:33868995-33869099,chr13,33868995,33869099,IMR90|chr13:108519722-108519768,chr13,108519722,108519768,0,74650727
IMR90|chr13:34688848-34688879,chr13,34688848,34688879,IMR90|chr13:111363509-111363544,chr13,111363509,111363544,0,76674661
IMR90|chr13:35117650-35117718,chr13,35117650,35117718,IMR90|chr13:103249975-103250005,chr13,103249975,103250005,0,68132325
IMR90|chr13:35277007-35277043,chr13,35277007,35277043,IMR90|chr13:114563011-114563063,chr13,114563011,114563063,0,79286004
IMR90|chr13:35673324-35673378,chr13,35673324,35673378,IMR90|chr13:114563268-114563333,chr13,114563268,114563333,0,78889944
IMR90|chr13:36281051-36281112,chr13,36281051,36281112,IMR90|chr13:108520894-108520941,chr13,108520894,108520941,0,72239843
IMR90|chr13:36289685-36289827,chr13,36289685,36289827,IMR90|chr13:114141152-114141186,chr13,114141152,114141186,0,77851467
IMR90|chr13:36543804-36543890,chr13,36543804,36543890,IMR90|chr13:45913819-45913863,chr13,45913819,45913863,0,9370015
IMR90|chr13:36814161-36814260,chr13,36814161,36814260,IMR90|chr13:108521969-108522019,chr13,108521969,108522019,0,71707808
IMR90|chr13:37098250-37098348,chr13,37098250,37098348,IMR90|chr13:114895267-114895318,chr13,114895267,114895318,0,77797017
IMR90|chr13:37237883-37237957,chr13,37237883,37237957,IMR90|chr13:115001480-115001556,chr13,115001480,115001556,0,77763597
IMR90|chr13:38654386-38654458,chr13,38654386,38654458,IMR90|chr13:115001479-115001556,chr13,115001479,115001556,0,76347093
IMR90|chr13:38961373-38961394,chr13,38961373,38961394,IMR90|chr13:114144609-114144698,chr13,114144609,114144698,0,75183236
IMR90|chr13:38992042-38992081,chr13,38992042,38992081,IMR90|chr13:45913530-45913604,chr13,45913530,45913604,0,6921488
IMR90|chr13:39838941-39838972,chr13,39838941,39838972,IMR90|chr13:111363509-111363544,chr13,111363509,111363544,0,71524568
IMR90|chr13:40341429-40341471,chr13,40341429,40341471,IMR90|chr13:41344713-41344741,chr13,41344713,41344741,0,1003284
IMR90|chr13:41241799-41241825,chr13,41241799,41241825,IMR90|chr13:33856530-33856599,chr13,33856530,33856599,0,7385269
IMR90|chr13:41333211-41333302,chr13,41333211,41333302,IMR90|chr13:98791304-98791363,chr13,98791304,98791363,0,57458093
IMR90|chr13:42140602-42140668,chr13,42140602,42140668,IMR90|chr13:114563011-114563059,chr13,114563011,114563059,0,72422409
IMR90|chr13:42893969-42894068,chr13,42893969,42894068,IMR90|chr13:108522655-108522698,chr13,108522655,108522698,0,65628686
IMR90|chr13:42943363-42943434,chr13,42943363,42943434,IMR90|chr13:53187240-53187319,chr13,53187240,53187319,0,10243877
IMR90|chr13:43049401-43049498,chr13,43049401,43049498,IMR90|chr13:108521969-108522019,chr13,108521969,108522019,0,65472568
IMR90|chr13:43253177-43253211,chr13,43253177,43253211,IMR90|chr13:24155245-24155373,chr13,24155245,24155373,0,19097932
IMR90|chr13:44432193-44432281,chr13,44432193,44432281,IMR90|chr13:20533952-20533985,chr13,20533952,20533985,0,23898241
IMR90|chr13:45361883-45361915,chr13,45361883,45361915,IMR90|chr13:41362562-41362625,chr13,41362562,41362625,0,3999321
IMR90|chr13:45554686-45554760,chr13,45554686,45554760,IMR90|chr13:20362002-20362061,chr13,20362002,20362061,0,25192684
IMR90|chr13:46507312-46507380,chr13,46507312,46507380,IMR90|chr13:103249975-103250005,chr13,103249975,103250005,0,56742663
IMR90|chr13:46890344-46890433,chr13,46890344,46890433,IMR90|chr13:115001479-115001556,chr13,115001479,115001556,0,68111135
IMR90|chr13:46963857-46963903,chr13,46963857,46963903,IMR90|chr13:114567666-114567765,chr13,114567666,114567765,0,67603809
IMR90|chr13:47527924-47527954,chr13,47527924,47527954,IMR90|chr13:111363509-111363544,chr13,111363509,111363544,0,63835585
IMR90|chr13:48342956-48343008,chr13,48342956,48343008,IMR90|chr13:114565317-114565384,chr13,114565317,114565384,0,66222361
IMR90|chr13:49057944-49058036,chr13,49057944,49058036,IMR90|chr13:20533952-20533985,chr13,20533952,20533985,0,28523992
IMR90|chr13:49972173-49972275,chr13,49972173,49972275,IMR90|chr13:114563011-114563059,chr13,114563011,114563059,0,64590838
IMR90|chr13:49996241-49996286,chr13,49996241,49996286,IMR90|chr13:23942907-23943006,chr13,23942907,23943006,0,26053334
IMR90|chr13:50150281-50150383,chr13,50150281,50150383,IMR90|chr13:114563011-114563059,chr13,114563011,114563059,0,64412730
IMR90|chr13:50360387-50360455,chr13,50360387,50360455,IMR90|chr13:98828455-98828496,chr13,98828455,98828496,0,48468068
IMR90|chr13:51144143-51144259,chr13,51144143,51144259,IMR90|chr13:114141152-114141186,chr13,114141152,114141186,0,62997009
IMR90|chr13:52101647-52101704,chr13,52101647,52101704,IMR90|chr13:52980990-52981114,chr13,52980990,52981114,0,879343
IMR90|chr13:52636669-52636755,chr13,52636669,52636755,IMR90|chr13:45913819-45913863,chr13,45913819,45913863,0,6722850
IMR90|chr13:52929480-52929510,chr13,52929480,52929510,IMR90|chr13:108519203-108519347,chr13,108519203,108519347,0,55589723
IMR90|chr13:52944188-52944214,chr13,52944188,52944214,IMR90|chr13:33856530-33856599,chr13,33856530,33856599,0,19087658
IMR90|chr13:53116083-53116225,chr13,53116083,53116225,IMR90|chr13:114141152-114141186,chr13,114141152,114141186,0,61025069
IMR90|chr13:53823165-53823243,chr13,53823165,53823243,IMR90|chr13:76441464-76441566,chr13,76441464,76441566,0,22618299
IMR90|chr13:54067797-54067849,chr13,54067797,54067849,IMR90|chr13:76212303-76212358,chr13,76212303,76212358,0,22144506
IMR90|chr13:54280825-54280917,chr13,54280825,54280917,IMR90|chr13:114898778-114898848,chr13,114898778,114898848,0,60617953
IMR90|chr13:54363320-54363398,chr13,54363320,54363398,IMR90|chr13:76441464-76441566,chr13,76441464,76441566,0,22078144
IMR90|chr13:54388935-54389016,chr13,54388935,54389016,IMR90|chr13:93875662-93875784,chr13,93875662,93875784,0,39486727
IMR90|chr13:54446195-54446280,chr13,54446195,54446280,IMR90|chr13:45913819-45913863,chr13,45913819,45913863,0,8532376
IMR90|chr13:55209380-55209412,chr13,55209380,55209412,IMR90|chr13:23944354-23944437,chr13,23944354,23944437,0,31265026
IMR90|chr13:55373411-55373474,chr13,55373411,55373474,IMR90|chr13:76444868-76445007,chr13,76444868,76445007,0,21071457
IMR90|chr13:56841794-56841863,chr13,56841794,56841863,IMR90|chr13:103249975-103250005,chr13,103249975,103250005,0,46408181
IMR90|chr13:57003009-57003129,chr13,57003009,57003129,IMR90|chr13:111359392-111359417,chr13,111359392,111359417,0,54356383
IMR90|chr13:57058677-57058706,chr13,57058677,57058706,IMR90|chr13:23943882-23943952,chr13,23943882,23943952,0,33114795
IMR90|chr13:57303309-57303385,chr13,57303309,57303385,IMR90|chr13:111212427-111212460,chr13,111212427,111212460,0,53909118
IMR90|chr13:57719059-57719151,chr13,57719059,57719151,IMR90|chr13:114898778-114898848,chr13,114898778,114898848,0,57179719
IMR90|chr13:58204678-58204739,chr13,58204678,58204739,IMR90|chr13:108522584-108522637,chr13,108522584,108522637,0,50317906
IMR90|chr13:58346639-58346691,chr13,58346639,58346691,IMR90|chr13:114565317-114565384,chr13,114565317,114565384,0,56218678
IMR90|chr13:58734247-58734283,chr13,58734247,58734283,IMR90|chr13:114540078-114540187,chr13,114540078,114540187,0,55805831
IMR90|chr13:59082350-59082380,chr13,59082350,59082380,IMR90|chr13:111363509-111363544,chr13,111363509,111363544,0,52281159
IMR90|chr13:59352739-59352883,chr13,59352739,59352883,IMR90|chr13:111359321-111359378,chr13,111359321,111359378,0,52006582
IMR90|chr13:59599499-59599526,chr13,59599499,59599526,IMR90|chr13:114536842-114536940,chr13,114536842,114536940,0,54937343
IMR90|chr13:60379951-60380054,chr13,60379951,60380054,IMR90|chr13:108519722-108519768,chr13,108519722,108519768,0,48139771
IMR90|chr13:60798540-60798628,chr13,60798540,60798628,IMR90|chr13:20533952-20533985,chr13,20533952,20533985,0,40264588
IMR90|chr13:61583049-61583167,chr13,61583049,61583167,IMR90|chr13:111359392-111359417,chr13,111359392,111359417,0,49776343
IMR90|chr13:61839397-61839452,chr13,61839397,61839452,IMR90|chr13:108519242-108519318,chr13,108519242,108519318,0,46679845
IMR90|chr13:62163846-62163884,chr13,62163846,62163884,IMR90|chr13:24155272-24155374,chr13,24155272,24155374,0,38008574
IMR90|chr13:62553677-62553729,chr13,62553677,62553729,IMR90|chr13:76212303-76212358,chr13,76212303,76212358,0,13658626
IMR90|chr13:63979314-63979349,chr13,63979314,63979349,IMR90|chr13:41362562-41362648,chr13,41362562,41362648,0,22616752
IMR90|chr13:64086774-64086835,chr13,64086774,64086835,IMR90|chr13:108519451-108519494,chr13,108519451,108519494,0,44432677
IMR90|chr13:64151034-64151141,chr13,64151034,64151141,IMR90|chr13:114902628-114902658,chr13,114902628,114902658,0,50751594
IMR90|chr13:64668308-64668389,chr13,64668308,64668389,IMR90|chr13:20533955-20534005,chr13,20533955,20534005,0,44134353
IMR90|chr13:65438617-65438683,chr13,65438617,65438683,IMR90|chr13:41344713-41344741,chr13,41344713,41344741,0,24093904
IMR90|chr13:65950691-65950765,chr13,65950691,65950765,IMR90|chr13:115001480-115001556,chr13,115001480,115001556,0,49050789
IMR90|chr13:66130842-66130905,chr13,66130842,66130905,IMR90|chr13:76444868-76445007,chr13,76444868,76445007,0,10314026
IMR90|chr13:66237843-66237936,chr13,66237843,66237936,IMR90|chr13:50270249-50270335,chr13,50270249,50270335,0,15967594
IMR90|chr13:66576105-66576147,chr13,66576105,66576147,IMR90|chr13:41344713-41344741,chr13,41344713,41344741,0,25231392
IMR90|chr13:66954867-66954908,chr13,66954867,66954908,IMR90|chr13:45913530-45913604,chr13,45913530,45913604,0,21041337
IMR90|chr13:67129796-67129877,chr13,67129796,67129877,IMR90|chr13:20533955-20534005,chr13,20533955,20534005,0,46595841
IMR90|chr13:67190252-67190287,chr13,67190252,67190287,IMR90|chr13:52982229-52982379,chr13,52982229,52982379,0,14208023
IMR90|chr13:67378444-67378482,chr13,67378444,67378482,IMR90|chr13:24155272-24155374,chr13,24155272,24155374,0,43223172
IMR90|chr13:67786518-67786561,chr13,67786518,67786561,IMR90|chr13:52982313-52982459,chr13,52982313,52982459,0,14804205
IMR90|chr13:68286207-68286310,chr13,68286207,68286310,IMR90|chr13:108519722-108519768,chr13,108519722,108519768,0,40233515
IMR90|chr13:68342531-68342559,chr13,68342531,68342559,IMR90|chr13:23943882-23943952,chr13,23943882,23943952,0,44398649
IMR90|chr13:68865149-68865269,chr13,68865149,68865269,IMR90|chr13:111359392-111359417,chr13,111359392,111359417,0,42494243
IMR90|chr13:68925108-68925137,chr13,68925108,68925137,IMR90|chr13:114141087-114141165,chr13,114141087,114141165,0,45215979
IMR90|chr13:69465297-69465387,chr13,69465297,69465387,IMR90|chr13:80055786-80055846,chr13,80055786,80055846,0,10590489
IMR90|chr13:69671048-69671079,chr13,69671048,69671079,IMR90|chr13:23944354-23944437,chr13,23944354,23944437,0,45726694
IMR90|chr13:69701702-69701754,chr13,69701702,69701754,IMR90|chr13:33857281-33857345,chr13,33857281,33857345,0,35844421
IMR90|chr13:70362173-70362265,chr13,70362173,70362265,IMR90|chr13:20533952-20533985,chr13,20533952,20533985,0,49828221
IMR90|chr13:70811884-70811918,chr13,70811884,70811918,IMR90|chr13:24155245-24155373,chr13,24155245,24155373,0,46656639
IMR90|chr13:71190332-71190403,chr13,71190332,71190403,IMR90|chr13:53187240-53187319,chr13,53187240,53187319,0,18003092
IMR90|chr13:71675241-71675277,chr13,71675241,71675277,IMR90|chr13:114563011-114563063,chr13,114563011,114563063,0,42887770
IMR90|chr13:72198975-72199044,chr13,72198975,72199044,IMR90|chr13:97876354-97876455,chr13,97876354,97876455,0,25677379
IMR90|chr13:72788894-72788969,chr13,72788894,72788969,IMR90|chr13:52983788-52983838,chr13,52983788,52983838,0,19805106
IMR90|chr13:72789420-72789556,chr13,72789420,72789556,IMR90|chr13:53188169-53188202,chr13,53188169,53188202,0,19601251
IMR90|chr13:72840960-72841026,chr13,72840960,72841026,IMR90|chr13:114563011-114563059,chr13,114563011,114563059,0,41722051
IMR90|chr13:74313035-74313108,chr13,74313035,74313108,IMR90|chr13:31192838-31192886,chr13,31192838,31192886,0,43120197
IMR90|chr13:74376203-74376255,chr13,74376203,74376255,IMR90|chr13:33857281-33857345,chr13,33857281,33857345,0,40518922
IMR90|chr13:74883144-74883257,chr13,74883144,74883257,IMR90|chr13:108517607-108517660,chr13,108517607,108517660,0,33634463
IMR90|chr13:75209164-75209234,chr13,75209164,75209234,IMR90|chr13:23944002-23944070,chr13,23944002,23944070,0,51265162
IMR90|chr13:76142034-76142079,chr13,76142034,76142079,IMR90|chr13:33857458-33857476,chr13,33857458,33857476,0,42284576
IMR90|chr13:76292810-76292866,chr13,76292810,76292866,IMR90|chr13:114901147-114901211,chr13,114901147,114901211,0,38608337
IMR90|chr13:77799453-77799482,chr13,77799453,77799482,IMR90|chr13:114141087-114141165,chr13,114141087,114141165,0,36341634
IMR90|chr13:78066142-78066207,chr13,78066142,78066207,IMR90|chr13:76212102-76212186,chr13,76212102,76212186,0,1854040
IMR90|chr13:78174975-78175037,chr13,78174975,78175037,IMR90|chr13:108520894-108520941,chr13,108520894,108520941,0,30345919
IMR90|chr13:78479793-78479870,chr13,78479793,78479870,IMR90|chr13:114898778-114898848,chr13,114898778,114898848,0,36418985
IMR90|chr13:78732606-78732683,chr13,78732606,78732683,IMR90|chr13:111212427-111212460,chr13,111212427,111212460,0,32479821
IMR90|chr13:79045541-79045573,chr13,79045541,79045573,IMR90|chr13:23944354-23944437,chr13,23944354,23944437,0,55101187
IMR90|chr13:79215423-79215465,chr13,79215423,79215465,IMR90|chr13:97876354-97876455,chr13,97876354,97876455,0,18660931
IMR90|chr13:79221436-79221475,chr13,79221436,79221475,IMR90|chr13:45913530-45913604,chr13,45913530,45913604,0,33307906
IMR90|chr13:79716242-79716325,chr13,79716242,79716325,IMR90|chr13:97876354-97876455,chr13,97876354,97876455,0,18160112
IMR90|chr13:81352765-81352784,chr13,81352765,81352784,IMR90|chr13:24155245-24155373,chr13,24155245,24155373,0,57197520
IMR90|chr13:81573869-81573980,chr13,81573869,81573980,IMR90|chr13:21347814-21347841,chr13,21347814,21347841,0,60226055
IMR90|chr13:81582215-81582258,chr13,81582215,81582258,IMR90|chr13:52982313-52982459,chr13,52982313,52982459,0,28599902
IMR90|chr13:81635686-81635769,chr13,81635686,81635769,IMR90|chr13:97876354-97876455,chr13,97876354,97876455,0,16240668
IMR90|chr13:82110977-82111083,chr13,82110977,82111083,IMR90|chr13:80055786-80055846,chr13,80055786,80055846,0,2055191
IMR90|chr13:82735315-82735392,chr13,82735315,82735392,IMR90|chr13:114898778-114898848,chr13,114898778,114898848,0,32163463
IMR90|chr13:83539911-83539942,chr13,83539911,83539942,IMR90|chr13:23944354-23944437,chr13,23944354,23944437,0,59595557
IMR90|chr13:83661927-83661964,chr13,83661927,83661964,IMR90|chr13:52983212-52983250,chr13,52983212,52983250,0,30678715
IMR90|chr13:83695861-83695930,chr13,83695861,83695930,IMR90|chr13:103249975-103250005,chr13,103249975,103250005,0,19554114
IMR90|chr13:84246769-84246864,chr13,84246769,84246864,IMR90|chr13:20534170-20534194,chr13,20534170,20534194,0,63712599
IMR90|chr13:84329767-84329893,chr13,84329767,84329893,IMR90|chr13:42614625-42614648,chr13,42614625,42614648,0,41715142
IMR90|chr13:85371932-85372005,chr13,85371932,85372005,IMR90|chr13:76212102-76212186,chr13,76212102,76212186,0,9159830
IMR90|chr13:85845801-85845830,chr13,85845801,85845830,IMR90|chr13:23943882-23943952,chr13,23943882,23943952,0,61901919
IMR90|chr13:87709690-87709770,chr13,87709690,87709770,IMR90|chr13:53187240-53187319,chr13,53187240,53187319,0,34522450
IMR90|chr13:88683086-88683106,chr13,88683086,88683106,IMR90|chr13:67808452-67808582,chr13,67808452,67808582,0,20874634
IMR90|chr13:89344251-89344278,chr13,89344251,89344278,IMR90|chr13:108519249-108519301,chr13,108519249,108519301,0,19174998
IMR90|chr13:89593150-89593247,chr13,89593150,89593247,IMR90|chr13:108521969-108522019,chr13,108521969,108522019,0,18928819
IMR90|chr13:90922989-90923063,chr13,90922989,90923063,IMR90|chr13:20362002-20362061,chr13,20362002,20362061,0,70560987
IMR90|chr13:92688881-92688972,chr13,92688881,92688972,IMR90|chr13:98791304-98791363,chr13,98791304,98791363,0,6102423
IMR90|chr13:94034931-94035026,chr13,94034931,94035026,IMR90|chr13:76212870-76212901,chr13,76212870,76212901,0,17822061
IMR90|chr13:94036157-94036233,chr13,94036157,94036233,IMR90|chr13:111212427-111212460,chr13,111212427,111212460,0,17176270
IMR90|chr13:94641949-94642044,chr13,94641949,94642044,IMR90|chr13:20534170-20534194,chr13,20534170,20534194,0,74107779
IMR90|chr13:94930426-94930481,chr13,94930426,94930481,IMR90|chr13:114540663-114540721,chr13,114540663,114540721,0,19610237
IMR90|chr13:94956942-94957031,chr13,94956942,94957031,IMR90|chr13:114567666-114567765,chr13,114567666,114567765,0,19610724
IMR90|chr13:94982238-94982270,chr13,94982238,94982270,IMR90|chr13:114566045-114566118,chr13,114566045,114566118,0,19583807
IMR90|chr13:95469791-95469848,chr13,95469791,95469848,IMR90|chr13:114897694-114897738,chr13,114897694,114897738,0,19427903
IMR90|chr13:96407810-96407902,chr13,96407810,96407902,IMR90|chr13:41710898-41710960,chr13,41710898,41710960,0,54696912
IMR90|chr13:96750780-96750861,chr13,96750780,96750861,IMR90|chr13:93875662-93875784,chr13,93875662,93875784,0,2875118
IMR90|chr13:97106215-97106237,chr13,97106215,97106237,IMR90|chr13:52982105-52982225,chr13,52982105,52982225,0,44124110
IMR90|chr13:97219023-97219098,chr13,97219023,97219098,IMR90|chr13:52983788-52983838,chr13,52983788,52983838,0,44235235
IMR90|chr13:97753868-97753896,chr13,97753868,97753896,IMR90|chr13:23943882-23943952,chr13,23943882,23943952,0,73809986
IMR90|chr13:98202500-98202555,chr13,98202500,98202555,IMR90|chr13:108519242-108519318,chr13,108519242,108519318,0,10316742
IMR90|chr13:98501576-98501674,chr13,98501576,98501674,IMR90|chr13:114895267-114895318,chr13,114895267,114895318,0,16393691
IMR90|chr13:98982397-98982503,chr13,98982397,98982503,IMR90|chr13:80055786-80055846,chr13,80055786,80055846,0,18926611
IMR90|chr13:101727156-101727226,chr13,101727156,101727226,IMR90|chr13:23944002-23944070,chr13,23944002,23944070,0,77783154
IMR90|chr13:102222932-102223031,chr13,102222932,102223031,IMR90|chr13:108522655-108522698,chr13,108522655,108522698,0,6299723
IMR90|chr13:102707589-102707651,chr13,102707589,102707651,IMR90|chr13:108520894-108520941,chr13,108520894,108520941,0,5813305
IMR90|chr13:103252350-103252387,chr13,103252350,103252387,IMR90|chr13:52983212-52983250,chr13,52983212,52983250,0,50269138
IMR90|chr13:103502781-103502878,chr13,103502781,103502878,IMR90|chr13:108517607-108517660,chr13,108517607,108517660,0,5014826
IMR90|chr13:103617652-103617778,chr13,103617652,103617778,IMR90|chr13:42614625-42614648,chr13,42614625,42614648,0,61003027
IMR90|chr13:103705607-103705695,chr13,103705607,103705695,IMR90|chr13:41710898-41710960,chr13,41710898,41710960,0,61994709
IMR90|chr13:104351163-104351250,chr13,104351163,104351250,IMR90|chr13:33857031-33857080,chr13,33857031,33857080,0,70494132
IMR90|chr13:104641212-104641328,chr13,104641212,104641328,IMR90|chr13:114141152-114141186,chr13,114141152,114141186,0,9499940
IMR90|chr13:105249900-105249930,chr13,105249900,105249930,IMR90|chr13:33858681-33858795,chr13,33858681,33858795,0,71391219
IMR90|chr13:105860051-105860141,chr13,105860051,105860141,IMR90|chr13:80055786-80055846,chr13,80055786,80055846,0,25804265
IMR90|chr13:106093507-106093584,chr13,106093507,106093584,IMR90|chr13:31192838-31192886,chr13,31192838,31192886,0,74900669
IMR90|chr13:106283390-106283409,chr13,106283390,106283409,IMR90|chr13:24155245-24155373,chr13,24155245,24155373,0,82128145
IMR90|chr13:106506878-106506988,chr13,106506878,106506988,IMR90|chr13:52982846-52982921,chr13,52982846,52982921,0,53524032
IMR90|chr13:106624352-106624424,chr13,106624352,106624424,IMR90|chr13:115001479-115001556,chr13,115001479,115001556,0,8377127
IMR90|chr13:107516873-107516897,chr13,107516873,107516897,IMR90|chr13:114897065-114897172,chr13,114897065,114897172,0,7380192
IMR90|chr13:107841322-107841350,chr13,107841322,107841350,IMR90|chr13:114896869-114896956,chr13,114896869,114896956,0,7055547
IMR90|chr13:107890962-107891013,chr13,107890962,107891013,IMR90|chr13:114565317-114565384,chr13,114565317,114565384,0,6674355
IMR90|chr13:108001374-108001409,chr13,108001374,108001409,IMR90|chr13:41362562-41362648,chr13,41362562,41362648,0,66638812
IMR90|chr13:108594962-108595030,chr13,108594962,108595030,IMR90|chr13:98828455-98828496,chr13,98828455,98828496,0,9766507
IMR90|chr13:108773491-108773635,chr13,108773491,108773635,IMR90|chr13:111359321-111359378,chr13,111359321,111359378,0,2585830
IMR90|chr13:108803322-108803440,chr13,108803322,108803440,IMR90|chr13:111359392-111359417,chr13,111359392,111359417,0,2556070
IMR90|chr13:108987189-108987266,chr13,108987189,108987266,IMR90|chr13:111212427-111212460,chr13,111212427,111212460,0,2225238
IMR90|chr13:109683430-109683525,chr13,109683430,109683525,IMR90|chr13:76212870-76212901,chr13,76212870,76212901,0,33470560
IMR90|chr13:110046831-110046895,chr13,110046831,110046895,IMR90|chr13:98828455-98828496,chr13,98828455,98828496,0,11218376
IMR90|chr13:110388090-110388156,chr13,110388090,110388156,IMR90|chr13:41344713-41344741,chr13,41344713,41344741,0,69043377
IMR90|chr13:110678301-110678347,chr13,110678301,110678347,IMR90|chr13:114567666-114567765,chr13,114567666,114567765,0,3889365
IMR90|chr13:111416771-111416807,chr13,111416771,111416807,IMR90|chr13:52983212-52983250,chr13,52983212,52983250,0,58433559
IMR90|chr13:112074147-112074192,chr13,112074147,112074192,IMR90|chr13:33857458-33857476,chr13,33857458,33857476,0,78216689
IMR90|chr13:112192855-112192883,chr13,112192855,112192883,IMR90|chr13:114896869-114896956,chr13,114896869,114896956,0,2704014
IMR90|chr13:112441558-112441590,chr13,112441558,112441590,IMR90|chr13:41362562-41362625,chr13,41362562,41362625,0,71078996
IMR90|chr13:112958188-112958324,chr13,112958188,112958324,IMR90|chr13:53188169-53188202,chr13,53188169,53188202,0,59770019
IMR90|chr13:113189277-113189371,chr13,113189277,113189371,IMR90|chr13:76212870-76212901,chr13,76212870,76212901,0,36976407
IMR90|chr13:114445398-114445474,chr13,114445398,114445474,IMR90|chr13:67808508-67808582,chr13,67808508,67808582,0,46636890
IMR90|chr13:114595138-114595183,chr13,114595138,114595183,IMR90|chr13:23942907-23943006,chr13,23942907,23943006,0,90652231
IMR90|chr13:114845429-114845459,chr13,114845429,114845459,IMR90|chr13:33858681-33858795,chr13,33858681,33858795,0,80986748
IMR90|chr14:1453054-1453080,chr14,1453054,1453080,IMR90|chr14:105261279-105261366,chr14,105261279,105261366,0,103808225
IMR90|chr14:1777421-1777474,chr14,1777421,1777474,IMR90|chr14:35102115-35102173,chr14,35102115,35102173,0,33324694
IMR90|chr14:1907383-1907489,chr14,1907383,1907489,IMR90|chr14:50051897-50051974,chr14,50051897,50051974,0,48144514
IMR90|chr14:3788826-3788884,chr14,3788826,3788884,IMR90|chr14:105189815-105189874,chr14,105189815,105189874,0,101400989
IMR90|chr14:4018734-4018792,chr14,4018734,4018792,IMR90|chr14:95981500-95981648,chr14,95981500,95981648,0,91962766
IMR90|chr14:4508557-4508656,chr14,4508557,4508656,IMR90|chr14:95979824-95979849,chr14,95979824,95979849,0,91471267
IMR90|chr14:5190051-5190116,chr14,5190051,5190116,IMR90|chr14:105189815-105189874,chr14,105189815,105189874,0,99999764
IMR90|chr14:5602888-5603038,chr14,5602888,5603038,IMR90|chr14:55519278-55519343,chr14,55519278,55519343,0,49916390
IMR90|chr14:6408654-6408703,chr14,6408654,6408703,IMR90|chr14:59935383-59935439,chr14,59935383,59935439,0,53526729
IMR90|chr14:6964557-6964628,chr14,6964557,6964628,IMR90|chr14:95982235-95982296,chr14,95982235,95982296,0,89017678
IMR90|chr14:7373162-7373226,chr14,7373162,7373226,IMR90|chr14:52459501-52459547,chr14,52459501,52459547,0,45086339
IMR90|chr14:7417626-7417776,chr14,7417626,7417776,IMR90|chr14:53174664-53174705,chr14,53174664,53174705,0,45757038
IMR90|chr14:7645248-7645308,chr14,7645248,7645308,IMR90|chr14:35098943-35099061,chr14,35098943,35099061,0,27453695
IMR90|chr14:7861709-7861774,chr14,7861709,7861774,IMR90|chr14:20800826-20800911,chr14,20800826,20800911,0,12939117
IMR90|chr14:8150724-8150807,chr14,8150724,8150807,IMR90|chr14:95980598-95980642,chr14,95980598,95980642,0,87829874
IMR90|chr14:8308257-8308317,chr14,8308257,8308317,IMR90|chr14:35098943-35099061,chr14,35098943,35099061,0,26790686
IMR90|chr14:8769738-8769823,chr14,8769738,8769823,IMR90|chr14:55519278-55519343,chr14,55519278,55519343,0,46749540
IMR90|chr14:9398189-9398272,chr14,9398189,9398272,IMR90|chr14:95979672-95979739,chr14,95979672,95979739,0,86581483
IMR90|chr14:10150263-10150359,chr14,10150263,10150359,IMR90|chr14:53258968-53259010,chr14,53258968,53259010,0,43108705
IMR90|chr14:11724812-11724901,chr14,11724812,11724901,IMR90|chr14:59932343-59932374,chr14,59932343,59932374,0,48207531
IMR90|chr14:11798684-11798720,chr14,11798684,11798720,IMR90|chr14:59933573-59933665,chr14,59933573,59933665,0,48134889
IMR90|chr14:11842162-11842227,chr14,11842162,11842227,IMR90|chr14:20800826-20800911,chr14,20800826,20800911,0,8958664
IMR90|chr14:13372933-13372991,chr14,13372933,13372991,IMR90|chr14:95981500-95981648,chr14,95981500,95981648,0,82608567
IMR90|chr14:13373671-13373751,chr14,13373671,13373751,IMR90|chr14:95977506-95977536,chr14,95977506,95977536,0,82603835
IMR90|chr14:13556169-13556270,chr14,13556169,13556270,IMR90|chr14:74357472-74357521,chr14,74357472,74357521,0,60801303
IMR90|chr14:13975754-13975904,chr14,13975754,13975904,IMR90|chr14:53174664-53174705,chr14,53174664,53174705,0,39198910
IMR90|chr14:13993198-13993254,chr14,13993198,13993254,IMR90|chr14:59934411-59934445,chr14,59934411,59934445,0,45941213
IMR90|chr14:14063565-14063636,chr14,14063565,14063636,IMR90|chr14:95982235-95982296,chr14,95982235,95982296,0,81918670
IMR90|chr14:14826726-14826776,chr14,14826726,14826776,IMR90|chr14:95980240-95980318,chr14,95980240,95980318,0,81153514
IMR90|chr14:14955758-14955830,chr14,14955758,14955830,IMR90|chr14:59936099-59936150,chr14,59936099,59936150,0,44980341
IMR90|chr14:15094662-15094744,chr14,15094662,15094744,IMR90|chr14:103245425-103245490,chr14,103245425,103245490,0,88150763
IMR90|chr14:15473721-15473791,chr14,15473721,15473791,IMR90|chr14:53258964-53259044,chr14,53258964,53259044,0,37785243
IMR90|chr14:15648081-15648187,chr14,15648081,15648187,IMR90|chr14:53174664-53174705,chr14,53174664,53174705,0,37526583
IMR90|chr14:16049053-16049112,chr14,16049053,16049112,IMR90|chr14:50106334-50106383,chr14,50106334,50106383,0,34057281
IMR90|chr14:16411890-16411933,chr14,16411890,16411933,IMR90|chr14:92589451-92589521,chr14,92589451,92589521,0,76177561
IMR90|chr14:16499623-16499653,chr14,16499623,16499653,IMR90|chr14:50102409-50102559,chr14,50102409,50102559,0,33602786
IMR90|chr14:17984603-17984706,chr14,17984603,17984706,IMR90|chr14:73923480-73923524,chr14,73923480,73923524,0,55938877
IMR90|chr14:18074271-18074326,chr14,18074271,18074326,IMR90|chr14:61114814-61114964,chr14,61114814,61114964,0,43040543
IMR90|chr14:19461065-19461119,chr14,19461065,19461119,IMR90|chr14:55033145-55033255,chr14,55033145,55033255,0,35572080
IMR90|chr14:19492481-19492554,chr14,19492481,19492554,IMR90|chr14:50051897-50051974,chr14,50051897,50051974,0,30559416
IMR90|chr14:20185440-20185525,chr14,20185440,20185525,IMR90|chr14:95981013-95981153,chr14,95981013,95981153,0,75795573
IMR90|chr14:20682652-20682751,chr14,20682652,20682751,IMR90|chr14:59935037-59935090,chr14,59935037,59935090,0,39252385
IMR90|chr14:21637446-21637558,chr14,21637446,21637558,IMR90|chr14:50051897-50051974,chr14,50051897,50051974,0,28414451
IMR90|chr14:21792635-21792666,chr14,21792635,21792666,IMR90|chr14:105153760-105153836,chr14,105153760,105153836,0,83361125
IMR90|chr14:22195587-22195649,chr14,22195587,22195649,IMR90|chr14:105441746-105441832,chr14,105441746,105441832,0,83246159
IMR90|chr14:22518409-22518434,chr14,22518409,22518434,IMR90|chr14:35102115-35102173,chr14,35102115,35102173,0,12583706
IMR90|chr14:22552371-22552416,chr14,22552371,22552416,IMR90|chr14:69323563-69323687,chr14,69323563,69323687,0,46771192
IMR90|chr14:22560108-22560133,chr14,22560108,22560133,IMR90|chr14:77968461-77968564,chr14,77968461,77968564,0,55408353
IMR90|chr14:23085385-23085451,chr14,23085385,23085451,IMR90|chr14:93798446-93798502,chr14,93798446,93798502,0,70713061
IMR90|chr14:23305958-23306020,chr14,23305958,23306020,IMR90|chr14:95981450-95981491,chr14,95981450,95981491,0,72675492
IMR90|chr14:24043846-24043893,chr14,24043846,24043893,IMR90|chr14:61106027-61106102,chr14,61106027,61106102,0,37062181
IMR90|chr14:24072666-24072696,chr14,24072666,24072696,IMR90|chr14:78173772-78173850,chr14,78173772,78173850,0,54101106
IMR90|chr14:25181628-25181646,chr14,25181628,25181646,IMR90|chr14:69323563-69323687,chr14,69323563,69323687,0,44141935
IMR90|chr14:26237482-26237529,chr14,26237482,26237529,IMR90|chr14:104181161-104181263,chr14,104181161,104181263,0,77943679
IMR90|chr14:27682797-27682867,chr14,27682797,27682867,IMR90|chr14:53258964-53259044,chr14,53258964,53259044,0,25576167
IMR90|chr14:27891265-27891323,chr14,27891265,27891323,IMR90|chr14:95981725-95981814,chr14,95981725,95981814,0,68090460
IMR90|chr14:27946166-27946248,chr14,27946166,27946248,IMR90|chr14:103245425-103245490,chr14,103245425,103245490,0,75299259
IMR90|chr14:28099738-28099764,chr14,28099738,28099764,IMR90|chr14:105261279-105261366,chr14,105261279,105261366,0,77161541
IMR90|chr14:28927063-28927118,chr14,28927063,28927118,IMR90|chr14:58865172-58865232,chr14,58865172,58865232,0,29938109
IMR90|chr14:30365426-30365464,chr14,30365426,30365464,IMR90|chr14:69442371-69442483,chr14,69442371,69442483,0,39076945
IMR90|chr14:30544376-30544464,chr14,30544376,30544464,IMR90|chr14:95979103-95979194,chr14,95979103,95979194,0,65434727
IMR90|chr14:31239754-31239846,chr14,31239754,31239846,IMR90|chr14:95980746-95980819,chr14,95980746,95980819,0,64740992
IMR90|chr14:31415854-31415945,chr14,31415854,31415945,IMR90|chr14:55032841-55032884,chr14,55032841,55032884,0,23616987
IMR90|chr14:31590193-31590311,chr14,31590193,31590311,IMR90|chr14:95979672-95979739,chr14,95979672,95979739,0,64389479
IMR90|chr14:32588933-32588964,chr14,32588933,32588964,IMR90|chr14:78173772-78173850,chr14,78173772,78173850,0,45584839
IMR90|chr14:32944582-32944641,chr14,32944582,32944641,IMR90|chr14:95981725-95981814,chr14,95981725,95981814,0,63037143
IMR90|chr14:33043603-33043649,chr14,33043603,33043649,IMR90|chr14:105441746-105441800,chr14,105441746,105441800,0,72398143
IMR90|chr14:33436819-33436904,chr14,33436819,33436904,IMR90|chr14:53174739-53174767,chr14,53174739,53174767,0,19737920
IMR90|chr14:33745973-33746053,chr14,33745973,33746053,IMR90|chr14:77968461-77968564,chr14,77968461,77968564,0,44222488
IMR90|chr14:33802437-33802497,chr14,33802437,33802497,IMR90|chr14:20800826-20800911,chr14,20800826,20800911,0,13001611
IMR90|chr14:34381136-34381185,chr14,34381136,34381185,IMR90|chr14:105441746-105441832,chr14,105441746,105441832,0,71060610
IMR90|chr14:35295450-35295506,chr14,35295450,35295506,IMR90|chr14:59934411-59934445,chr14,59934411,59934445,0,24638961
IMR90|chr14:36114819-36114859,chr14,36114819,36114859,IMR90|chr14:95980658-95980801,chr14,95980658,95980801,0,59865839
IMR90|chr14:36288519-36288584,chr14,36288519,36288584,IMR90|chr14:105189815-105189874,chr14,105189815,105189874,0,68901296
IMR90|chr14:36295924-36295976,chr14,36295924,36295976,IMR90|chr14:69442371-69442483,chr14,69442371,69442483,0,33146447
IMR90|chr14:36722714-36722767,chr14,36722714,36722767,IMR90|chr14:69323563-69323693,chr14,69323563,69323693,0,32600849
IMR90|chr14:36805619-36805689,chr14,36805619,36805689,IMR90|chr14:105153929-105153986,chr14,105153929,105153986,0,68348310
IMR90|chr14:37245245-37245268,chr14,37245245,37245268,IMR90|chr14:100705132-100705151,chr14,100705132,100705151,0,63459887
IMR90|chr14:38433051-38433136,chr14,38433051,38433136,IMR90|chr14:55519278-55519343,chr14,55519278,55519343,0,17086227
IMR90|chr14:38771238-38771335,chr14,38771238,38771335,IMR90|chr14:59935037-59935090,chr14,59935037,59935090,0,21163799
IMR90|chr14:38930526-38930549,chr14,38930526,38930549,IMR90|chr14:100705132-100705151,chr14,100705132,100705151,0,61774606
IMR90|chr14:38956585-38956603,chr14,38956585,38956603,IMR90|chr14:100705106-100705151,chr14,100705106,100705151,0,61748521
IMR90|chr14:39297776-39297820,chr14,39297776,39297820,IMR90|chr14:92589451-92589521,chr14,92589451,92589521,0,53291675
IMR90|chr14:39497275-39497360,chr14,39497275,39497360,IMR90|chr14:95981013-95981153,chr14,95981013,95981153,0,56483738
IMR90|chr14:40092899-40092943,chr14,40092899,40092943,IMR90|chr14:92589451-92589521,chr14,92589451,92589521,0,52496552
IMR90|chr14:40303444-40303540,chr14,40303444,40303540,IMR90|chr14:53258968-53259010,chr14,53258968,53259010,0,12955524
IMR90|chr14:40541469-40541523,chr14,40541469,40541523,IMR90|chr14:55033145-55033255,chr14,55033145,55033255,0,14491676
IMR90|chr14:40655350-40655456,chr14,40655350,40655456,IMR90|chr14:53174664-53174705,chr14,53174664,53174705,0,12519314
IMR90|chr14:40689974-40690059,chr14,40689974,40690059,IMR90|chr14:59934393-59934443,chr14,59934393,59934443,0,19244419
IMR90|chr14:41783639-41783692,chr14,41783639,41783692,IMR90|chr14:69323563-69323693,chr14,69323563,69323693,0,27539924
IMR90|chr14:41996822-41996931,chr14,41996822,41996931,IMR90|chr14:55032841-55032884,chr14,55032841,55032884,0,13036019
IMR90|chr14:42254665-42254729,chr14,42254665,42254729,IMR90|chr14:35103791-35103825,chr14,35103791,35103825,0,7150874
IMR90|chr14:42348249-42348313,chr14,42348249,42348313,IMR90|chr14:52459501-52459547,chr14,52459501,52459547,0,10111252
IMR90|chr14:42553873-42553922,chr14,42553873,42553922,IMR90|chr14:105441746-105441832,chr14,105441746,105441832,0,62887873
IMR90|chr14:43497962-43498071,chr14,43497962,43498071,IMR90|chr14:55032841-55032884,chr14,55032841,55032884,0,11534879
IMR90|chr14:43662164-43662219,chr14,43662164,43662219,IMR90|chr14:58865172-58865232,chr14,58865172,58865232,0,15203008
IMR90|chr14:43861129-43861170,chr14,43861129,43861170,IMR90|chr14:59933573-59933665,chr14,59933573,59933665,0,16072444
IMR90|chr14:44479201-44479281,chr14,44479201,44479281,IMR90|chr14:95977506-95977536,chr14,95977506,95977536,0,51498305
IMR90|chr14:44999374-44999465,chr14,44999374,44999465,IMR90|chr14:55032841-55032884,chr14,55032841,55032884,0,10033467
IMR90|chr14:45202939-45202984,chr14,45202939,45202984,IMR90|chr14:69323563-69323687,chr14,69323563,69323687,0,24120624
IMR90|chr14:45219218-45219269,chr14,45219218,45219269,IMR90|chr14:95980240-95980318,chr14,95980240,95980318,0,50761022
IMR90|chr14:45487946-45487977,chr14,45487946,45487977,IMR90|chr14:78173772-78173850,chr14,78173772,78173850,0,32685826
IMR90|chr14:46154911-46154996,chr14,46154911,46154996,IMR90|chr14:59934393-59934443,chr14,59934393,59934443,0,13779482
IMR90|chr14:47959095-47959180,chr14,47959095,47959180,IMR90|chr14:53174739-53174767,chr14,53174739,53174767,0,5215644
IMR90|chr14:49021744-49021856,chr14,49021744,49021856,IMR90|chr14:50051897-50051974,chr14,50051897,50051974,0,1030153
IMR90|chr14:49051180-49051227,chr14,49051180,49051227,IMR90|chr14:104181161-104181263,chr14,104181161,104181263,0,55129981
IMR90|chr14:49252448-49252503,chr14,49252448,49252503,IMR90|chr14:59934393-59934443,chr14,59934393,59934443,0,10681945
IMR90|chr14:49400457-49400487,chr14,49400457,49400487,IMR90|chr14:78173772-78173850,chr14,78173772,78173850,0,28773315
IMR90|chr14:49508610-49508632,chr14,49508610,49508632,IMR90|chr14:61106027-61106102,chr14,61106027,61106102,0,11597417
IMR90|chr14:49767613-49767695,chr14,49767613,49767695,IMR90|chr14:95980598-95980642,chr14,95980598,95980642,0,46212985
IMR90|chr14:51441054-51441070,chr14,51441054,51441070,IMR90|chr14:69323563-69323693,chr14,69323563,69323693,0,17882509
IMR90|chr14:52929883-52929972,chr14,52929883,52929972,IMR90|chr14:59932343-59932374,chr14,59932343,59932374,0,7002460
IMR90|chr14:53742059-53742099,chr14,53742059,53742099,IMR90|chr14:52458585-52458624,chr14,52458585,52458624,0,1283474
IMR90|chr14:54085760-54085847,chr14,54085760,54085847,IMR90|chr14:53174739-53174767,chr14,53174739,53174767,0,911021
IMR90|chr14:55504327-55504379,chr14,55504327,55504379,IMR90|chr14:69442371-69442483,chr14,69442371,69442483,0,13938044
IMR90|chr14:56101220-56101279,chr14,56101220,56101279,IMR90|chr14:50106334-50106383,chr14,50106334,50106383,0,5994886
IMR90|chr14:56508776-56508853,chr14,56508776,56508853,IMR90|chr14:95980746-95980819,chr14,95980746,95980819,0,39471970
IMR90|chr14:56881772-56881815,chr14,56881772,56881815,IMR90|chr14:92589451-92589521,chr14,92589451,92589521,0,35707679
IMR90|chr14:56984388-56984419,chr14,56984388,56984419,IMR90|chr14:105153760-105153836,chr14,105153760,105153836,0,48169372
IMR90|chr14:57998663-57998781,chr14,57998663,57998781,IMR90|chr14:95979672-95979739,chr14,95979672,95979739,0,37981009
IMR90|chr14:58297409-58297445,chr14,58297409,58297445,IMR90|chr14:59933573-59933665,chr14,59933573,59933665,0,1636164
IMR90|chr14:58368031-58368071,chr14,58368031,58368071,IMR90|chr14:95980658-95980801,chr14,95980658,95980801,0,37612627
IMR90|chr14:58654701-58654814,chr14,58654701,58654814,IMR90|chr14:73923480-73923524,chr14,73923480,73923524,0,15268779
IMR90|chr14:59426892-59426917,chr14,59426892,59426917,IMR90|chr14:35102115-35102173,chr14,35102115,35102173,0,24324777
IMR90|chr14:61307845-61307916,chr14,61307845,61307916,IMR90|chr14:95980053-95980114,chr14,95980053,95980114,0,34672208
IMR90|chr14:62007629-62007736,chr14,62007629,62007736,IMR90|chr14:55032841-55032884,chr14,55032841,55032884,0,6974788
IMR90|chr14:62067772-62067831,chr14,62067772,62067831,IMR90|chr14:95981725-95981814,chr14,95981725,95981814,0,33913953
IMR90|chr14:62111881-62111913,chr14,62111881,62111913,IMR90|chr14:35098943-35099061,chr14,35098943,35099061,0,27012938
IMR90|chr14:62166449-62166502,chr14,62166449,62166502,IMR90|chr14:35102115-35102173,chr14,35102115,35102173,0,27064334
IMR90|chr14:62847302-62847342,chr14,62847302,62847342,IMR90|chr14:52458585-52458624,chr14,52458585,52458624,0,10388717
IMR90|chr14:62971174-62971262,chr14,62971174,62971262,IMR90|chr14:95979103-95979194,chr14,95979103,95979194,0,33007929
IMR90|chr14:64150467-64150538,chr14,64150467,64150538,IMR90|chr14:95980053-95980114,chr14,95980053,95980114,0,31829586
IMR90|chr14:64186055-64186138,chr14,64186055,64186138,IMR90|chr14:95980598-95980642,chr14,95980598,95980642,0,31794543
IMR90|chr14:65010712-65010742,chr14,65010712,65010742,IMR90|chr14:89017383-89017494,chr14,89017383,89017494,0,24006671
IMR90|chr14:65631912-65631981,chr14,65631912,65631981,IMR90|chr14:95982235-95982296,chr14,95982235,95982296,0,30350323
IMR90|chr14:66154834-66154907,chr14,66154834,66154907,IMR90|chr14:59936099-59936150,chr14,59936099,59936150,0,6218735
IMR90|chr14:66638879-66639015,chr14,66638879,66639015,IMR90|chr14:20800826-20800911,chr14,20800826,20800911,0,45838053
IMR90|chr14:68403796-68403860,chr14,68403796,68403860,IMR90|chr14:35103791-35103825,chr14,35103791,35103825,0,33300005
IMR90|chr14:69734730-69734757,chr14,69734730,69734757,IMR90|chr14:105261279-105261366,chr14,105261279,105261366,0,35526549
IMR90|chr14:69985717-69985823,chr14,69985717,69985823,IMR90|chr14:50051897-50051974,chr14,50051897,50051974,0,19933820
IMR90|chr14:70484530-70484594,chr14,70484530,70484594,IMR90|chr14:95981450-95981491,chr14,95981450,95981491,0,25496920
IMR90|chr14:70867323-70867348,chr14,70867323,70867348,IMR90|chr14:77968461-77968564,chr14,77968461,77968564,0,7101138
IMR90|chr14:71076087-71076152,chr14,71076087,71076152,IMR90|chr14:59933761-59933808,chr14,59933761,59933808,0,11142326
IMR90|chr14:71146056-71146122,chr14,71146056,71146122,IMR90|chr14:93798446-93798502,chr14,93798446,93798502,0,22652390
IMR90|chr14:72086091-72086141,chr14,72086091,72086141,IMR90|chr14:95980240-95980318,chr14,95980240,95980318,0,23894149
IMR90|chr14:73269055-73269093,chr14,73269055,73269093,IMR90|chr14:69442371-69442483,chr14,69442371,69442483,0,3826684
IMR90|chr14:74406764-74406830,chr14,74406764,74406830,IMR90|chr14:95979146-95979202,chr14,95979146,95979202,0,21572382
IMR90|chr14:75549469-75549524,chr14,75549469,75549524,IMR90|chr14:59934393-59934443,chr14,59934393,59934443,0,15615076
IMR90|chr14:76615203-76615287,chr14,76615203,76615287,IMR90|chr14:53259005-53259044,chr14,53259005,53259044,0,23356198
IMR90|chr14:76735524-76735584,chr14,76735524,76735584,IMR90|chr14:20800826-20800911,chr14,20800826,20800911,0,55934698
IMR90|chr14:76898870-76898936,chr14,76898870,76898936,IMR90|chr14:95979146-95979202,chr14,95979146,95979202,0,19080276
IMR90|chr14:76998296-76998354,chr14,76998296,76998354,IMR90|chr14:105189815-105189874,chr14,105189815,105189874,0,28191519
IMR90|chr14:77026158-77026174,chr14,77026158,77026174,IMR90|chr14:69323563-69323693,chr14,69323563,69323693,0,7702595
IMR90|chr14:77127206-77127305,chr14,77127206,77127305,IMR90|chr14:95979824-95979849,chr14,95979824,95979849,0,18852618
IMR90|chr14:77407747-77407834,chr14,77407747,77407834,IMR90|chr14:53174739-53174767,chr14,53174739,53174767,0,24233008
IMR90|chr14:78423692-78423805,chr14,78423692,78423805,IMR90|chr14:73923480-73923524,chr14,73923480,73923524,0,4500212
IMR90|chr14:79384344-79384392,chr14,79384344,79384392,IMR90|chr14:61126998-61127028,chr14,61126998,61127028,0,18257346
IMR90|chr14:79548173-79548246,chr14,79548173,79548246,IMR90|chr14:50051897-50051974,chr14,50051897,50051974,0,29496276
IMR90|chr14:79760585-79760606,chr14,79760585,79760606,IMR90|chr14:100705106-100705151,chr14,100705106,100705151,0,20944521
IMR90|chr14:80051397-80051474,chr14,80051397,80051474,IMR90|chr14:104181161-104181263,chr14,104181161,104181263,0,24129764
IMR90|chr14:80128608-80128678,chr14,80128608,80128678,IMR90|chr14:61126998-61127028,chr14,61126998,61127028,0,19001610
IMR90|chr14:80435291-80435370,chr14,80435291,80435370,IMR90|chr14:95977506-95977536,chr14,95977506,95977536,0,15542215
IMR90|chr14:80583843-80583935,chr14,80583843,80583935,IMR90|chr14:95980746-95980819,chr14,95980746,95980819,0,15396903
IMR90|chr14:80849780-80849857,chr14,80849780,80849857,IMR90|chr14:95980746-95980819,chr14,95980746,95980819,0,15130966
IMR90|chr14:81465196-81465298,chr14,81465196,81465298,IMR90|chr14:31680823-31680871,chr14,31680823,31680871,0,49784373
IMR90|chr14:81717799-81717873,chr14,81717799,81717873,IMR90|chr14:62163216-62163284,chr14,62163216,62163284,0,19554583
IMR90|chr14:81906029-81906051,chr14,81906029,81906051,IMR90|chr14:61106027-61106102,chr14,61106027,61106102,0,20800002
IMR90|chr14:82065347-82065430,chr14,82065347,82065430,IMR90|chr14:95979672-95979739,chr14,95979672,95979739,0,13914325
IMR90|chr14:82680808-82680890,chr14,82680808,82680890,IMR90|chr14:95980598-95980642,chr14,95980598,95980642,0,13299790
IMR90|chr14:83928254-83928316,chr14,83928254,83928316,IMR90|chr14:105441746-105441832,chr14,105441746,105441832,0,21513492
IMR90|chr14:84421702-84421799,chr14,84421702,84421799,IMR90|chr14:59935037-59935090,chr14,59935037,59935090,0,24486665
IMR90|chr14:84690488-84690624,chr14,84690488,84690624,IMR90|chr14:20800826-20800911,chr14,20800826,20800911,0,63889662
IMR90|chr14:84883683-84883755,chr14,84883683,84883755,IMR90|chr14:59936099-59936150,chr14,59936099,59936150,0,24947584
IMR90|chr14:85493985-85494015,chr14,85493985,85494015,IMR90|chr14:50102409-50102559,chr14,50102409,50102559,0,35391576
IMR90|chr14:86196829-86196909,chr14,86196829,86196909,IMR90|chr14:77968461-77968564,chr14,77968461,77968564,0,8228368
IMR90|chr14:86422832-86422935,chr14,86422832,86422935,IMR90|chr14:73923480-73923524,chr14,73923480,73923524,0,12499352
IMR90|chr14:86736504-86736592,chr14,86736504,86736592,IMR90|chr14:53174739-53174767,chr14,53174739,53174767,0,33561765
IMR90|chr14:87470086-87470155,chr14,87470086,87470155,IMR90|chr14:95982235-95982296,chr14,95982235,95982296,0,8512149
IMR90|chr14:87731221-87731253,chr14,87731221,87731253,IMR90|chr14:35098943-35099061,chr14,35098943,35099061,0,52632278
IMR90|chr14:87774558-87774622,chr14,87774558,87774622,IMR90|chr14:95981450-95981491,chr14,95981450,95981491,0,8206892
IMR90|chr14:88714942-88714972,chr14,88714942,88714972,IMR90|chr14:89017383-89017494,chr14,89017383,89017494,0,302441
IMR90|chr14:89597584-89597611,chr14,89597584,89597611,IMR90|chr14:105261279-105261366,chr14,105261279,105261366,0,15663695
IMR90|chr14:90526508-90526596,chr14,90526508,90526596,IMR90|chr14:53174739-53174767,chr14,53174739,53174767,0,37351769
IMR90|chr14:90546096-90546143,chr14,90546096,90546143,IMR90|chr14:61106027-61106102,chr14,61106027,61106102,0,29440069
IMR90|chr14:90604134-90604284,chr14,90604134,90604284,IMR90|chr14:55519278-55519343,chr14,55519278,55519343,0,35084856
IMR90|chr14:91584812-91584861,chr14,91584812,91584861,IMR90|chr14:59935383-59935439,chr14,59935383,59935439,0,31649429
IMR90|chr14:92390171-92390189,chr14,92390171,92390189,IMR90|chr14:100705106-100705151,chr14,100705106,100705151,0,8314935
IMR90|chr14:92707643-92707727,chr14,92707643,92707727,IMR90|chr14:53259005-53259044,chr14,53259005,53259044,0,39448638
IMR90|chr14:94034792-94034894,chr14,94034792,94034894,IMR90|chr14:31680823-31680871,chr14,31680823,31680871,0,62353969
IMR90|chr14:94124588-94124643,chr14,94124588,94124643,IMR90|chr14:61114814-61114964,chr14,61114814,61114964,0,33009774
IMR90|chr14:94182785-94182892,chr14,94182785,94182892,IMR90|chr14:55032841-55032884,chr14,55032841,55032884,0,39149944
IMR90|chr14:95110283-95110329,chr14,95110283,95110329,IMR90|chr14:105441746-105441800,chr14,105441746,105441800,0,10331463
IMR90|chr14:95184548-95184618,chr14,95184548,95184618,IMR90|chr14:61126998-61127028,chr14,61126998,61127028,0,34057550
IMR90|chr14:95246723-95246744,chr14,95246723,95246744,IMR90|chr14:100705106-100705151,chr14,100705106,100705151,0,5458383
IMR90|chr14:95314824-95314842,chr14,95314824,95314842,IMR90|chr14:69323563-69323687,chr14,69323563,69323687,0,25991261
IMR90|chr14:95391120-95391194,chr14,95391120,95391194,IMR90|chr14:62163216-62163284,chr14,62163216,62163284,0,33227904
IMR90|chr14:96082582-96082683,chr14,96082582,96082683,IMR90|chr14:74357472-74357521,chr14,74357472,74357521,0,21725110
IMR90|chr14:96420954-96421019,chr14,96420954,96421019,IMR90|chr14:59933761-59933808,chr14,59933761,59933808,0,36487193
IMR90|chr14:97298503-97298544,chr14,97298503,97298544,IMR90|chr14:59933573-59933665,chr14,59933573,59933665,0,37364930
IMR90|chr14:97956635-97956734,chr14,97956635,97956734,IMR90|chr14:59935037-59935090,chr14,59935037,59935090,0,38021598
IMR90|chr14:99786258-99786309,chr14,99786258,99786309,IMR90|chr14:95980240-95980318,chr14,95980240,95980318,0,3806018
IMR90|chr14:100236837-100236907,chr14,100236837,100236907,IMR90|chr14:105153929-105153986,chr14,105153929,105153986,0,4917092
IMR90|chr14:101492928-101493001,chr14,101492928,101493001,IMR90|chr14:59936099-59936150,chr14,59936099,59936150,0,41556829
IMR90|chr14:103428502-103428560,chr14,103428502,103428560,IMR90|chr14:95981725-95981814,chr14,95981725,95981814,0,7446777
IMR90|chr14:104066202-104066250,chr14,104066202,104066250,IMR90|chr14:61126998-61127028,chr14,61126998,61127028,0,42939204
IMR90|chr14:104348557-104348619,chr14,104348557,104348619,IMR90|chr14:95981450-95981491,chr14,95981450,95981491,0,8367107
IMR90|chr14:104657884-104657961,chr14,104657884,104657961,IMR90|chr14:104181161-104181263,chr14,104181161,104181263,0,476723
IMR90|chr14:106982143-106982222,chr14,106982143,106982222,IMR90|chr14:95977506-95977536,chr14,95977506,95977536,0,11004637
IMR90|chr15:122101-122129,chr15,122101,122129,IMR90|chr15:96878061-96878183,chr15,96878061,96878183,0,96755960
IMR90|chr15:297585-297650,chr15,297585,297650,IMR90|chr15:74831574-74831644,chr15,74831574,74831644,0,74533989
IMR90|chr15:308239-308367,chr15,308239,308367,IMR90|chr15:60687671-60687688,chr15,60687671,60687688,0,60379432
IMR90|chr15:891616-891643,chr15,891616,891643,IMR90|chr15:89877264-89877375,chr15,89877264,89877375,0,88985648
IMR90|chr15:995484-995634,chr15,995484,995634,IMR90|chr15:28566669-28566816,chr15,28566669,28566816,0,27571185
IMR90|chr15:1100327-1100407,chr15,1100327,1100407,IMR90|chr15:96875871-96875924,chr15,96875871,96875924,0,95775544
IMR90|chr15:1315481-1315615,chr15,1315481,1315615,IMR90|chr15:85295766-85295798,chr15,85295766,85295798,0,83980285
IMR90|chr15:1563023-1563075,chr15,1563023,1563075,IMR90|chr15:57512713-57512759,chr15,57512713,57512759,0,55949690
IMR90|chr15:1721206-1721306,chr15,1721206,1721306,IMR90|chr15:63345449-63345488,chr15,63345449,63345488,0,61624243
IMR90|chr15:2098233-2098260,chr15,2098233,2098260,IMR90|chr15:89877264-89877375,chr15,89877264,89877375,0,87779031
IMR90|chr15:2281548-2281611,chr15,2281548,2281611,IMR90|chr15:52314222-52314272,chr15,52314222,52314272,0,50032674
IMR90|chr15:2359421-2359476,chr15,2359421,2359476,IMR90|chr15:72519443-72519499,chr15,72519443,72519499,0,70160022
IMR90|chr15:2439182-2439273,chr15,2439182,2439273,IMR90|chr15:102189644-102189693,chr15,102189644,102189693,0,99750462
IMR90|chr15:2785582-2785669,chr15,2785582,2785669,IMR90|chr15:23032971-23033034,chr15,23032971,23033034,0,20247389
IMR90|chr15:2907282-2907303,chr15,2907282,2907303,IMR90|chr15:60689961-60690086,chr15,60689961,60690086,0,57782679
IMR90|chr15:3422206-3422263,chr15,3422206,3422263,IMR90|chr15:89165051-89165125,chr15,89165051,89165125,0,85742845
IMR90|chr15:3506516-3506572,chr15,3506516,3506572,IMR90|chr15:67000356-67000448,chr15,67000356,67000448,0,63493840
IMR90|chr15:4239273-4239336,chr15,4239273,4239336,IMR90|chr15:33013332-33013385,chr15,33013332,33013385,0,28774059
IMR90|chr15:4287298-4287373,chr15,4287298,4287373,IMR90|chr15:33011813-33011864,chr15,33011813,33011864,0,28724515
IMR90|chr15:4776134-4776281,chr15,4776134,4776281,IMR90|chr15:72410926-72410962,chr15,72410926,72410962,0,67634792
IMR90|chr15:5004090-5004155,chr15,5004090,5004155,IMR90|chr15:89441348-89441380,chr15,89441348,89441380,0,84437258
IMR90|chr15:5006476-5006539,chr15,5006476,5006539,IMR90|chr15:33013332-33013385,chr15,33013332,33013385,0,28006856
IMR90|chr15:5302083-5302168,chr15,5302083,5302168,IMR90|chr15:96871259-96871313,chr15,96871259,96871313,0,91569176
IMR90|chr15:5508741-5508809,chr15,5508741,5508809,IMR90|chr15:60686407-60686441,chr15,60686407,60686441,0,55177666
IMR90|chr15:5516107-5516229,chr15,5516107,5516229,IMR90|chr15:69222811-69222830,chr15,69222811,69222830,0,63706704
IMR90|chr15:5821176-5821240,chr15,5821176,5821240,IMR90|chr15:71051885-71052008,chr15,71051885,71052008,0,65230709
IMR90|chr15:5897612-5897670,chr15,5897612,5897670,IMR90|chr15:33011638-33011729,chr15,33011638,33011729,0,27114026
IMR90|chr15:6102042-6102076,chr15,6102042,6102076,IMR90|chr15:72522586-72522736,chr15,72522586,72522736,0,66420544
IMR90|chr15:6143266-6143319,chr15,6143266,6143319,IMR90|chr15:93452081-93452144,chr15,93452081,93452144,0,87308815
IMR90|chr15:6244650-6244691,chr15,6244650,6244691,IMR90|chr15:50645841-50645918,chr15,50645841,50645918,0,44401191
IMR90|chr15:6267043-6267082,chr15,6267043,6267082,IMR90|chr15:78591638-78591749,chr15,78591638,78591749,0,72324595
IMR90|chr15:6298738-6298888,chr15,6298738,6298888,IMR90|chr15:28566669-28566816,chr15,28566669,28566816,0,22267931
IMR90|chr15:6445922-6446039,chr15,6445922,6446039,IMR90|chr15:60683919-60683952,chr15,60683919,60683952,0,54237997
IMR90|chr15:6460365-6460458,chr15,6460365,6460458,IMR90|chr15:34518769-34518879,chr15,34518769,34518879,0,28058404
IMR90|chr15:6629523-6629596,chr15,6629523,6629596,IMR90|chr15:60686617-60686677,chr15,60686617,60686677,0,54057094
IMR90|chr15:7102323-7102354,chr15,7102323,7102354,IMR90|chr15:66997607-66997715,chr15,66997607,66997715,0,59895284
IMR90|chr15:7530600-7530667,chr15,7530600,7530667,IMR90|chr15:74831574-74831644,chr15,74831574,74831644,0,67300974
IMR90|chr15:7602508-7602563,chr15,7602508,7602563,IMR90|chr15:72519443-72519499,chr15,72519443,72519499,0,64916935
IMR90|chr15:8295690-8295759,chr15,8295690,8295759,IMR90|chr15:67419385-67419423,chr15,67419385,67419423,0,59123695
IMR90|chr15:8296667-8296694,chr15,8296667,8296694,IMR90|chr15:71051885-71052008,chr15,71051885,71052008,0,62755218
IMR90|chr15:8396195-8396227,chr15,8396195,8396227,IMR90|chr15:72519212-72519359,chr15,72519212,72519359,0,64123017
IMR90|chr15:8738679-8738738,chr15,8738679,8738738,IMR90|chr15:71051702-71051793,chr15,71051702,71051793,0,62313023
IMR90|chr15:9077302-9077350,chr15,9077302,9077350,IMR90|chr15:60688705-60688768,chr15,60688705,60688768,0,51611403
IMR90|chr15:9430112-9430155,chr15,9430112,9430155,IMR90|chr15:96902776-96902839,chr15,96902776,96902839,0,87472664
IMR90|chr15:9599183-9599264,chr15,9599183,9599264,IMR90|chr15:90357158-90357187,chr15,90357158,90357187,0,80757975
IMR90|chr15:9695838-9695892,chr15,9695838,9695892,IMR90|chr15:85295766-85295798,chr15,85295766,85295798,0,75599928
IMR90|chr15:9973925-9974013,chr15,9973925,9974013,IMR90|chr15:40630342-40630404,chr15,40630342,40630404,0,30656417
IMR90|chr15:10624807-10624890,chr15,10624807,10624890,IMR90|chr15:66998205-66998259,chr15,66998205,66998259,0,56373398
IMR90|chr15:10815913-10816011,chr15,10815913,10816011,IMR90|chr15:102189644-102189693,chr15,102189644,102189693,0,91373731
IMR90|chr15:11185150-11185226,chr15,11185150,11185226,IMR90|chr15:71055101-71055175,chr15,71055101,71055175,0,59869951
IMR90|chr15:11558368-11558491,chr15,11558368,11558491,IMR90|chr15:72518941-72519030,chr15,72518941,72519030,0,60960573
IMR90|chr15:11713397-11713455,chr15,11713397,11713455,IMR90|chr15:60685952-60685974,chr15,60685952,60685974,0,48972555
IMR90|chr15:11911881-11911934,chr15,11911881,11911934,IMR90|chr15:71051892-71051996,chr15,71051892,71051996,0,59140011
IMR90|chr15:11938132-11938186,chr15,11938132,11938186,IMR90|chr15:33013970-33014045,chr15,33013970,33014045,0,21075838
IMR90|chr15:12180206-12180267,chr15,12180206,12180267,IMR90|chr15:60684815-60684866,chr15,60684815,60684866,0,48504609
IMR90|chr15:12346013-12346094,chr15,12346013,12346094,IMR90|chr15:90357158-90357187,chr15,90357158,90357187,0,78011145
IMR90|chr15:13268211-13268322,chr15,13268211,13268322,IMR90|chr15:60683919-60683952,chr15,60683919,60683952,0,47415708
IMR90|chr15:13291439-13291490,chr15,13291439,13291490,IMR90|chr15:71054996-71055110,chr15,71054996,71055110,0,57763557
IMR90|chr15:13825910-13825985,chr15,13825910,13825985,IMR90|chr15:33011813-33011864,chr15,33011813,33011864,0,19185903
IMR90|chr15:13938515-13938581,chr15,13938515,13938581,IMR90|chr15:63336584-63336623,chr15,63336584,63336623,0,49398069
IMR90|chr15:14210181-14210324,chr15,14210181,14210324,IMR90|chr15:60687551-60687613,chr15,60687551,60687613,0,46477370
IMR90|chr15:14239044-14239194,chr15,14239044,14239194,IMR90|chr15:28566878-28567028,chr15,28566878,28567028,0,14327834
IMR90|chr15:14248979-14249051,chr15,14248979,14249051,IMR90|chr15:71052060-71052086,chr15,71052060,71052086,0,56803081
IMR90|chr15:14697439-14697516,chr15,14697439,14697516,IMR90|chr15:63342723-63342792,chr15,63342723,63342792,0,48645284
IMR90|chr15:14870225-14870269,chr15,14870225,14870269,IMR90|chr15:96902776-96902839,chr15,96902776,96902839,0,82032551
IMR90|chr15:15122202-15122273,chr15,15122202,15122273,IMR90|chr15:71051771-71051816,chr15,71051771,71051816,0,55929569
IMR90|chr15:15150779-15150820,chr15,15150779,15150820,IMR90|chr15:63335188-63335254,chr15,63335188,63335254,0,48184409
IMR90|chr15:15175946-15176037,chr15,15175946,15176037,IMR90|chr15:33012502-33012548,chr15,33012502,33012548,0,17836556
IMR90|chr15:15408002-15408098,chr15,15408002,15408098,IMR90|chr15:23032971-23033034,chr15,23032971,23033034,0,7624969
IMR90|chr15:15472175-15472253,chr15,15472175,15472253,IMR90|chr15:89441348-89441382,chr15,89441348,89441382,0,73969173
IMR90|chr15:15678724-15678750,chr15,15678724,15678750,IMR90|chr15:65119779-65119909,chr15,65119779,65119909,0,49441055
IMR90|chr15:15770430-15770472,chr15,15770430,15770472,IMR90|chr15:33012447-33012562,chr15,33012447,33012562,0,17242017
IMR90|chr15:15868970-15869036,chr15,15868970,15869036,IMR90|chr15:63336584-63336623,chr15,63336584,63336623,0,47467614
IMR90|chr15:16000931-16001012,chr15,16000931,16001012,IMR90|chr15:60686520-60686586,chr15,60686520,60686586,0,44685589
IMR90|chr15:16149256-16149294,chr15,16149256,16149294,IMR90|chr15:96879283-96879379,chr15,96879283,96879379,0,80730027
IMR90|chr15:16336808-16336878,chr15,16336808,16336878,IMR90|chr15:71051771-71051816,chr15,71051771,71051816,0,54714963
IMR90|chr15:16350382-16350405,chr15,16350382,16350405,IMR90|chr15:60686407-60686441,chr15,60686407,60686441,0,44336025
IMR90|chr15:16385996-16386065,chr15,16385996,16386065,IMR90|chr15:71054022-71054046,chr15,71054022,71054046,0,54668026
IMR90|chr15:16392387-16392523,chr15,16392387,16392523,IMR90|chr15:72515729-72515782,chr15,72515729,72515782,0,56123342
IMR90|chr15:16397237-16397281,chr15,16397237,16397281,IMR90|chr15:96902776-96902839,chr15,96902776,96902839,0,80505539
IMR90|chr15:16426262-16426331,chr15,16426262,16426331,IMR90|chr15:67419385-67419423,chr15,67419385,67419423,0,50993123
IMR90|chr15:16942354-16942389,chr15,16942354,16942389,IMR90|chr15:63344587-63344615,chr15,63344587,63344615,0,46402233
IMR90|chr15:16959338-16959438,chr15,16959338,16959438,IMR90|chr15:63345449-63345488,chr15,63345449,63345488,0,46386111
IMR90|chr15:17366332-17366480,chr15,17366332,17366480,IMR90|chr15:72410926-72410962,chr15,72410926,72410962,0,55044594
IMR90|chr15:17398448-17398471,chr15,17398448,17398471,IMR90|chr15:33013231-33013378,chr15,33013231,33013378,0,15614783
IMR90|chr15:17473345-17473418,chr15,17473345,17473418,IMR90|chr15:39877252-39877332,chr15,39877252,39877332,0,22403907
IMR90|chr15:17606922-17606981,chr15,17606922,17606981,IMR90|chr15:33011746-33011811,chr15,33011746,33011811,0,15404824
IMR90|chr15:18148162-18148190,chr15,18148162,18148190,IMR90|chr15:71051868-71051951,chr15,71051868,71051951,0,52903706
IMR90|chr15:18176068-18176125,chr15,18176068,18176125,IMR90|chr15:72521763-72521852,chr15,72521763,72521852,0,54345695
IMR90|chr15:18225421-18225477,chr15,18225421,18225477,IMR90|chr15:72521763-72521852,chr15,72521763,72521852,0,54296342
IMR90|chr15:18551303-18551349,chr15,18551303,18551349,IMR90|chr15:67430513-67430606,chr15,67430513,67430606,0,48879210
IMR90|chr15:18611112-18611163,chr15,18611112,18611163,IMR90|chr15:60686616-60686693,chr15,60686616,60686693,0,42075504
IMR90|chr15:18887060-18887087,chr15,18887060,18887087,IMR90|chr15:96876146-96876216,chr15,96876146,96876216,0,77989086
IMR90|chr15:18897144-18897218,chr15,18897144,18897218,IMR90|chr15:90548022-90548061,chr15,90548022,90548061,0,71650878
IMR90|chr15:20030164-20030219,chr15,20030164,20030219,IMR90|chr15:60687813-60687894,chr15,60687813,60687894,0,40657649
IMR90|chr15:20099209-20099260,chr15,20099209,20099260,IMR90|chr15:60686616-60686693,chr15,60686616,60686693,0,40587407
IMR90|chr15:20415096-20415206,chr15,20415096,20415206,IMR90|chr15:60685063-60685102,chr15,60685063,60685102,0,40269967
IMR90|chr15:20639856-20639896,chr15,20639856,20639896,IMR90|chr15:91473332-91473381,chr15,91473332,91473381,0,70833476
IMR90|chr15:20915343-20915442,chr15,20915343,20915442,IMR90|chr15:90549168-90549215,chr15,90549168,90549215,0,69633825
IMR90|chr15:21214225-21214344,chr15,21214225,21214344,IMR90|chr15:71051700-71051793,chr15,71051700,71051793,0,49837475
IMR90|chr15:21254206-21254270,chr15,21254206,21254270,IMR90|chr15:89877499-89877567,chr15,89877499,89877567,0,68623293
IMR90|chr15:21297562-21297620,chr15,21297562,21297620,IMR90|chr15:67000356-67000448,chr15,67000356,67000448,0,45702794
IMR90|chr15:21644292-21644360,chr15,21644292,21644360,IMR90|chr15:71142592-71142637,chr15,71142592,71142637,0,49498300
IMR90|chr15:21691107-21691153,chr15,21691107,21691153,IMR90|chr15:67430513-67430606,chr15,67430513,67430606,0,45739406
IMR90|chr15:22011843-22011935,chr15,22011843,22011935,IMR90|chr15:63342304-63342420,chr15,63342304,63342420,0,41330461
IMR90|chr15:22022796-22022853,chr15,22022796,22022853,IMR90|chr15:89165051-89165125,chr15,89165051,89165125,0,67142255
IMR90|chr15:22631334-22631396,chr15,22631334,22631396,IMR90|chr15:52314222-52314272,chr15,52314222,52314272,0,29682888
IMR90|chr15:22694216-22694347,chr15,22694216,22694347,IMR90|chr15:96878061-96878183,chr15,96878061,96878183,0,74183845
IMR90|chr15:22711836-22711909,chr15,22711836,22711909,IMR90|chr15:33011813-33011864,chr15,33011813,33011864,0,10299977
IMR90|chr15:22971345-22971386,chr15,22971345,22971386,IMR90|chr15:63342856-63342902,chr15,63342856,63342902,0,40371511
IMR90|chr15:23028249-23028399,chr15,23028249,23028399,IMR90|chr15:71055502-71055525,chr15,71055502,71055525,0,48027253
IMR90|chr15:23063149-23063224,chr15,23063149,23063224,IMR90|chr15:85293141-85293216,chr15,85293141,85293216,0,62229992
IMR90|chr15:23161907-23161945,chr15,23161907,23161945,IMR90|chr15:96879283-96879379,chr15,96879283,96879379,0,73717376
IMR90|chr15:23208512-23208571,chr15,23208512,23208571,IMR90|chr15:89176864-89176923,chr15,89176864,89176923,0,65968352
IMR90|chr15:23296899-23296970,chr15,23296899,23296970,IMR90|chr15:96879928-96879995,chr15,96879928,96879995,0,73583029
IMR90|chr15:23389497-23389541,chr15,23389497,23389541,IMR90|chr15:63336954-63337043,chr15,63336954,63337043,0,39947457
IMR90|chr15:23779161-23779184,chr15,23779161,23779184,IMR90|chr15:33013231-33013378,chr15,33013231,33013378,0,9234070
IMR90|chr15:24085227-24085257,chr15,24085227,24085257,IMR90|chr15:71051829-71051906,chr15,71051829,71051906,0,46966602
IMR90|chr15:24135820-24135913,chr15,24135820,24135913,IMR90|chr15:34518769-34518879,chr15,34518769,34518879,0,10382949
IMR90|chr15:24594084-24594168,chr15,24594084,24594168,IMR90|chr15:70995075-70995141,chr15,70995075,70995141,0,46400991
IMR90|chr15:24885000-24885024,chr15,24885000,24885024,IMR90|chr15:33012566-33012641,chr15,33012566,33012641,0,8127566
IMR90|chr15:25000957-25001074,chr15,25000957,25001074,IMR90|chr15:71052609-71052646,chr15,71052609,71052646,0,46051652
IMR90|chr15:25318840-25318871,chr15,25318840,25318871,IMR90|chr15:71051236-71051320,chr15,71051236,71051320,0,45732396
IMR90|chr15:25947029-25947108,chr15,25947029,25947108,IMR90|chr15:72410926-72410962,chr15,72410926,72410962,0,46463897
IMR90|chr15:26138582-26138699,chr15,26138582,26138699,IMR90|chr15:71052609-71052646,chr15,71052609,71052646,0,44914027
IMR90|chr15:26328903-26329053,chr15,26328903,26329053,IMR90|chr15:69747137-69747272,chr15,69747137,69747272,0,43418234
IMR90|chr15:26529390-26529449,chr15,26529390,26529449,IMR90|chr15:70994688-70994746,chr15,70994688,70994746,0,44465298
IMR90|chr15:26808796-26808895,chr15,26808796,26808895,IMR90|chr15:90549168-90549215,chr15,90549168,90549215,0,63740372
IMR90|chr15:26846632-26846742,chr15,26846632,26846742,IMR90|chr15:64752809-64752958,chr15,64752809,64752958,0,37906177
IMR90|chr15:26896013-26896035,chr15,26896013,26896035,IMR90|chr15:60689961-60690086,chr15,60689961,60690086,0,33793948
IMR90|chr15:27067861-27067942,chr15,27067861,27067942,IMR90|chr15:96869628-96869663,chr15,96869628,96869663,0,69801767
IMR90|chr15:27150237-27150302,chr15,27150237,27150302,IMR90|chr15:71053838-71053917,chr15,71053838,71053917,0,43903601
IMR90|chr15:27176700-27176730,chr15,27176700,27176730,IMR90|chr15:71054477-71054535,chr15,71054477,71054535,0,43877777
IMR90|chr15:28264805-28264876,chr15,28264805,28264876,IMR90|chr15:71051771-71051816,chr15,71051771,71051816,0,42786966
IMR90|chr15:28668713-28668740,chr15,28668713,28668740,IMR90|chr15:96871597-96871720,chr15,96871597,96871720,0,68202884
IMR90|chr15:30025934-30025968,chr15,30025934,30025968,IMR90|chr15:72522586-72522736,chr15,72522586,72522736,0,42496652
IMR90|chr15:30288878-30288939,chr15,30288878,30288939,IMR90|chr15:67360760-67360889,chr15,67360760,67360889,0,37071882
IMR90|chr15:30959554-30959650,chr15,30959554,30959650,IMR90|chr15:39873646-39873698,chr15,39873646,39873698,0,8914092
IMR90|chr15:31168635-31168674,chr15,31168635,31168674,IMR90|chr15:63342856-63342902,chr15,63342856,63342902,0,32174221
IMR90|chr15:31335379-31335472,chr15,31335379,31335472,IMR90|chr15:39873646-39873698,chr15,39873646,39873698,0,8538267
IMR90|chr15:31959316-31959447,chr15,31959316,31959447,IMR90|chr15:96870695-96870714,chr15,96870695,96870714,0,64911379
IMR90|chr15:32539458-32539515,chr15,32539458,32539515,IMR90|chr15:72521763-72521852,chr15,72521763,72521852,0,39982305
IMR90|chr15:32569372-32569407,chr15,32569372,32569407,IMR90|chr15:90644820-90644902,chr15,90644820,90644902,0,58075448
IMR90|chr15:32750966-32750994,chr15,32750966,32750994,IMR90|chr15:66997607-66997716,chr15,66997607,66997716,0,34246641
IMR90|chr15:32763412-32763535,chr15,32763412,32763535,IMR90|chr15:72518941-72519030,chr15,72518941,72519030,0,39755529
IMR90|chr15:32850305-32850344,chr15,32850305,32850344,IMR90|chr15:63335480-63335545,chr15,63335480,63335545,0,30485175
IMR90|chr15:32903141-32903165,chr15,32903141,32903165,IMR90|chr15:33011782-33011839,chr15,33011782,33011839,0,108641
IMR90|chr15:33237428-33237462,chr15,33237428,33237462,IMR90|chr15:33012447-33012562,chr15,33012447,33012562,0,224981
IMR90|chr15:33613625-33613710,chr15,33613625,33613710,IMR90|chr15:96871259-96871313,chr15,96871259,96871313,0,63257634
IMR90|chr15:33676759-33676847,chr15,33676759,33676847,IMR90|chr15:71055099-71055161,chr15,71055099,71055161,0,37378340
IMR90|chr15:33758719-33758830,chr15,33758719,33758830,IMR90|chr15:72410926-72410962,chr15,72410926,72410962,0,38652207
IMR90|chr15:33776185-33776226,chr15,33776185,33776226,IMR90|chr15:71053613-71053647,chr15,71053613,71053647,0,37277428
IMR90|chr15:33823025-33823111,chr15,33823025,33823111,IMR90|chr15:60685103-60685160,chr15,60685103,60685160,0,26862078
IMR90|chr15:34263762-34263808,chr15,34263762,34263808,IMR90|chr15:33012196-33012319,chr15,33012196,33012319,0,1251566
IMR90|chr15:34272210-34272297,chr15,34272210,34272297,IMR90|chr15:23032971-23033034,chr15,23032971,23033034,0,11239239
IMR90|chr15:34277074-34277142,chr15,34277074,34277142,IMR90|chr15:68872409-68872458,chr15,68872409,68872458,0,34595335
IMR90|chr15:34386371-34386443,chr15,34386371,34386443,IMR90|chr15:71143119-71143194,chr15,71143119,71143194,0,36756748
IMR90|chr15:34532299-34532372,chr15,34532299,34532372,IMR90|chr15:63342096-63342131,chr15,63342096,63342131,0,28809797
IMR90|chr15:34649843-34649906,chr15,34649843,34649906,IMR90|chr15:60684815-60684866,chr15,60684815,60684866,0,26034972
IMR90|chr15:34800703-34800803,chr15,34800703,34800803,IMR90|chr15:72519240-72519290,chr15,72519240,72519290,0,37718537
IMR90|chr15:35091077-35091098,chr15,35091077,35091098,IMR90|chr15:67360760-67360889,chr15,67360760,67360889,0,32269683
IMR90|chr15:35099221-35099313,chr15,35099221,35099313,IMR90|chr15:59965821-59965879,chr15,59965821,59965879,0,24866600
IMR90|chr15:35360316-35360429,chr15,35360316,35360429,IMR90|chr15:71051543-71051580,chr15,71051543,71051580,0,35691227
IMR90|chr15:35442903-35442932,chr15,35442903,35442932,IMR90|chr15:71051829-71051907,chr15,71051829,71051907,0,35608926
IMR90|chr15:35482417-35482488,chr15,35482417,35482488,IMR90|chr15:96879928-96879995,chr15,96879928,96879995,0,61397511
IMR90|chr15:35607162-35607189,chr15,35607162,35607189,IMR90|chr15:71054477-71054535,chr15,71054477,71054535,0,35447315
IMR90|chr15:35706698-35706815,chr15,35706698,35706815,IMR90|chr15:71053085-71053104,chr15,71053085,71053104,0,35346387
IMR90|chr15:36164094-36164155,chr15,36164094,36164155,IMR90|chr15:72521788-72521877,chr15,72521788,72521877,0,36357694
IMR90|chr15:36546740-36546770,chr15,36546740,36546770,IMR90|chr15:90549227-90549287,chr15,90549227,90549287,0,54002487
IMR90|chr15:36719706-36719834,chr15,36719706,36719834,IMR90|chr15:60687671-60687688,chr15,60687671,60687688,0,23967965
IMR90|chr15:36778683-36778781,chr15,36778683,36778781,IMR90|chr15:69747137-69747272,chr15,69747137,69747272,0,32968454
IMR90|chr15:37515473-37515565,chr15,37515473,37515565,IMR90|chr15:59965821-59965879,chr15,59965821,59965879,0,22450348
IMR90|chr15:37685882-37685945,chr15,37685882,37685945,IMR90|chr15:60684815-60684866,chr15,60684815,60684866,0,22998933
IMR90|chr15:37812728-37812878,chr15,37812728,37812878,IMR90|chr15:28566878-28567028,chr15,28566878,28567028,0,9245850
IMR90|chr15:37867263-37867311,chr15,37867263,37867311,IMR90|chr15:60688705-60688768,chr15,60688705,60688768,0,22821442
IMR90|chr15:38419342-38419388,chr15,38419342,38419388,IMR90|chr15:33012196-33012319,chr15,33012196,33012319,0,5407146
IMR90|chr15:38564847-38564915,chr15,38564847,38564915,IMR90|chr15:68872409-68872458,chr15,68872409,68872458,0,30307562
IMR90|chr15:38777238-38777323,chr15,38777238,38777323,IMR90|chr15:72515435-72515469,chr15,72515435,72515469,0,33738197
IMR90|chr15:38960818-38960847,chr15,38960818,38960847,IMR90|chr15:74835447-74835522,chr15,74835447,74835522,0,35874629
IMR90|chr15:38970763-38970787,chr15,38970763,38970787,IMR90|chr15:70995075-70995183,chr15,70995075,70995183,0,32024312
IMR90|chr15:39183050-39183127,chr15,39183050,39183127,IMR90|chr15:63342723-63342792,chr15,63342723,63342792,0,24159673
IMR90|chr15:39320686-39320775,chr15,39320686,39320775,IMR90|chr15:33011657-33011714,chr15,33011657,33011714,0,6309029
IMR90|chr15:39378631-39378680,chr15,39378631,39378680,IMR90|chr15:39877437-39877473,chr15,39877437,39877473,0,498806
IMR90|chr15:39556023-39556117,chr15,39556023,39556117,IMR90|chr15:75203700-75203847,chr15,75203700,75203847,0,35647677
IMR90|chr15:39639617-39639668,chr15,39639617,39639668,IMR90|chr15:71054996-71055110,chr15,71054996,71055110,0,31415379
IMR90|chr15:39734736-39734786,chr15,39734736,39734786,IMR90|chr15:23032846-23032913,chr15,23032846,23032913,0,16701890
IMR90|chr15:39928025-39928061,chr15,39928025,39928061,IMR90|chr15:63344411-63344489,chr15,63344411,63344489,0,23416386
IMR90|chr15:39938484-39938519,chr15,39938484,39938519,IMR90|chr15:71051797-71051908,chr15,71051797,71051908,0,31113313
IMR90|chr15:40180299-40180351,chr15,40180299,40180351,IMR90|chr15:90549168-90549215,chr15,90549168,90549215,0,50368869
IMR90|chr15:40182068-40182102,chr15,40182068,40182102,IMR90|chr15:63342304-63342420,chr15,63342304,63342420,0,23160236
IMR90|chr15:40324323-40324364,chr15,40324323,40324364,IMR90|chr15:39877474-39877579,chr15,39877474,39877579,0,446849
IMR90|chr15:40436585-40436650,chr15,40436585,40436650,IMR90|chr15:74831574-74831644,chr15,74831574,74831644,0,34394989
IMR90|chr15:40543938-40543973,chr15,40543938,40543973,IMR90|chr15:63335480-63335545,chr15,63335480,63335545,0,22791542
IMR90|chr15:40623504-40623549,chr15,40623504,40623549,IMR90|chr15:71408348-71408497,chr15,71408348,71408497,0,30784844
IMR90|chr15:40704048-40704142,chr15,40704048,40704142,IMR90|chr15:75203700-75203847,chr15,75203700,75203847,0,34499652
IMR90|chr15:40778385-40778466,chr15,40778385,40778466,IMR90|chr15:60686520-60686586,chr15,60686520,60686586,0,19908135
IMR90|chr15:40922436-40922524,chr15,40922436,40922524,IMR90|chr15:40630342-40630404,chr15,40630342,40630404,0,292094
IMR90|chr15:41215439-41215480,chr15,41215439,41215480,IMR90|chr15:39877474-39877579,chr15,39877474,39877579,0,1337965
IMR90|chr15:41274888-41275032,chr15,41274888,41275032,IMR90|chr15:71051543-71051580,chr15,71051543,71051580,0,29776655
IMR90|chr15:41311150-41311203,chr15,41311150,41311203,IMR90|chr15:60687813-60687896,chr15,60687813,60687896,0,19376663
IMR90|chr15:41821407-41821437,chr15,41821407,41821437,IMR90|chr15:71054477-71054535,chr15,71054477,71054535,0,29233070
IMR90|chr15:41840774-41840822,chr15,41840774,41840822,IMR90|chr15:59967700-59967789,chr15,59967700,59967789,0,18126926
IMR90|chr15:41987280-41987316,chr15,41987280,41987316,IMR90|chr15:63344411-63344489,chr15,63344411,63344489,0,21357131
IMR90|chr15:42041214-42041298,chr15,42041214,42041298,IMR90|chr15:72515435-72515469,chr15,72515435,72515469,0,30474221
IMR90|chr15:42123925-42123953,chr15,42123925,42123953,IMR90|chr15:71054851-71054948,chr15,71054851,71054948,0,28930926
IMR90|chr15:42186852-42186943,chr15,42186852,42186943,IMR90|chr15:33012502-33012548,chr15,33012502,33012548,0,9174350
IMR90|chr15:42242860-42242973,chr15,42242860,42242973,IMR90|chr15:71053456-71053493,chr15,71053456,71053493,0,28810596
IMR90|chr15:42297811-42297875,chr15,42297811,42297875,IMR90|chr15:63336465-63336510,chr15,63336465,63336510,0,21038654
IMR90|chr15:43010889-43010916,chr15,43010889,43010916,IMR90|chr15:85291664-85291697,chr15,85291664,85291697,0,42280775
IMR90|chr15:43112814-43112962,chr15,43112814,43112962,IMR90|chr15:72410926-72410962,chr15,72410926,72410962,0,29298112
IMR90|chr15:43164265-43164363,chr15,43164265,43164363,IMR90|chr15:102189644-102189693,chr15,102189644,102189693,0,59025379
IMR90|chr15:43291895-43291923,chr15,43291895,43291923,IMR90|chr15:96878061-96878183,chr15,96878061,96878183,0,53586166
IMR90|chr15:43618159-43618237,chr15,43618159,43618237,IMR90|chr15:71053188-71053225,chr15,71053188,71053225,0,27435029
IMR90|chr15:43702189-43702218,chr15,43702189,43702218,IMR90|chr15:74835447-74835522,chr15,74835447,74835522,0,31133258
IMR90|chr15:43864128-43864264,chr15,43864128,43864264,IMR90|chr15:72515729-72515782,chr15,72515729,72515782,0,28651601
IMR90|chr15:44155965-44156057,chr15,44155965,44156057,IMR90|chr15:63342304-63342420,chr15,63342304,63342420,0,19186339
IMR90|chr15:45473185-45473209,chr15,45473185,45473209,IMR90|chr15:70995075-70995183,chr15,70995075,70995183,0,25521890
IMR90|chr15:45551567-45551607,chr15,45551567,45551607,IMR90|chr15:71149610-71149684,chr15,71149610,71149684,0,25598043
IMR90|chr15:45666248-45666359,chr15,45666248,45666359,IMR90|chr15:72520498-72520515,chr15,72520498,72520515,0,26854250
IMR90|chr15:46331196-46331278,chr15,46331196,46331278,IMR90|chr15:90357158-90357187,chr15,90357158,90357187,0,44025962
IMR90|chr15:46601212-46601234,chr15,46601212,46601234,IMR90|chr15:60689961-60690086,chr15,60689961,60690086,0,14088749
IMR90|chr15:46712202-46712277,chr15,46712202,46712277,IMR90|chr15:85293141-85293216,chr15,85293141,85293216,0,38580939
IMR90|chr15:47130447-47130558,chr15,47130447,47130558,IMR90|chr15:60683919-60683952,chr15,60683919,60683952,0,13553472
IMR90|chr15:47630814-47630879,chr15,47630814,47630879,IMR90|chr15:75203700-75203799,chr15,75203700,75203799,0,27572886
IMR90|chr15:48253446-48253493,chr15,48253446,48253493,IMR90|chr15:59967700-59967789,chr15,59967700,59967789,0,11714254
IMR90|chr15:48279932-48279977,chr15,48279932,48279977,IMR90|chr15:85046504-85046596,chr15,85046504,85046596,0,36766572
IMR90|chr15:48297870-48297898,chr15,48297870,48297898,IMR90|chr15:71051868-71051951,chr15,71051868,71051951,0,22753998
IMR90|chr15:48595455-48595504,chr15,48595455,48595504,IMR90|chr15:50642292-50642361,chr15,50642292,50642361,0,2046837
IMR90|chr15:48837998-48838115,chr15,48837998,48838115,IMR90|chr15:60683919-60683952,chr15,60683919,60683952,0,11845921
IMR90|chr15:48875516-48875567,chr15,48875516,48875567,IMR90|chr15:57512713-57512758,chr15,57512713,57512758,0,8637197
IMR90|chr15:49061413-49061472,chr15,49061413,49061472,IMR90|chr15:33011746-33011811,chr15,33011746,33011811,0,16049667
IMR90|chr15:49513484-49513579,chr15,49513484,49513579,IMR90|chr15:59966034-59966140,chr15,59966034,59966140,0,10452550
IMR90|chr15:49675298-49675368,chr15,49675298,49675368,IMR90|chr15:67000005-67000056,chr15,67000005,67000056,0,17324707
IMR90|chr15:49844540-49844609,chr15,49844540,49844609,IMR90|chr15:71054022-71054046,chr15,71054022,71054046,0,21209482
IMR90|chr15:49891357-49891403,chr15,49891357,49891403,IMR90|chr15:71051892-71051996,chr15,71051892,71051996,0,21160535
IMR90|chr15:49937906-49937971,chr15,49937906,49937971,IMR90|chr15:75203700-75203799,chr15,75203700,75203799,0,25265794
IMR90|chr15:50263551-50263579,chr15,50263551,50263579,IMR90|chr15:50650641-50650733,chr15,50650641,50650733,0,387090
IMR90|chr15:50596088-50596155,chr15,50596088,50596155,IMR90|chr15:74831574-74831644,chr15,74831574,74831644,0,24235486
IMR90|chr15:50713096-50713181,chr15,50713096,50713181,IMR90|chr15:71051677-71051715,chr15,71051677,71051715,0,20338581
IMR90|chr15:50717423-50717508,chr15,50717423,50717508,IMR90|chr15:72515435-72515469,chr15,72515435,72515469,0,21798012
IMR90|chr15:51112864-51112957,chr15,51112864,51112957,IMR90|chr15:71052230-71052282,chr15,71052230,71052282,0,19939366
IMR90|chr15:51156258-51156353,chr15,51156258,51156353,IMR90|chr15:90549168-90549215,chr15,90549168,90549215,0,39392910
IMR90|chr15:51244179-51244240,chr15,51244179,51244240,IMR90|chr15:33011657-33011714,chr15,33011657,33011714,0,18232522
IMR90|chr15:51275870-51275955,chr15,51275870,51275955,IMR90|chr15:71051677-71051715,chr15,71051677,71051715,0,19775807
IMR90|chr15:51589401-51589468,chr15,51589401,51589468,IMR90|chr15:67419385-67419423,chr15,67419385,67419423,0,15829984
IMR90|chr15:51785917-51786030,chr15,51785917,51786030,IMR90|chr15:65423438-65423475,chr15,65423438,65423475,0,13637521
IMR90|chr15:51794436-51794463,chr15,51794436,51794463,IMR90|chr15:71054477-71054535,chr15,71054477,71054535,0,19260041
IMR90|chr15:51922166-51922258,chr15,51922166,51922258,IMR90|chr15:72515724-72515782,chr15,72515724,72515782,0,20593558
IMR90|chr15:52404099-52404158,chr15,52404099,52404158,IMR90|chr15:71051702-71051793,chr15,71051702,71051793,0,18647603
IMR90|chr15:52638716-52638859,chr15,52638716,52638859,IMR90|chr15:60687551-60687613,chr15,60687551,60687613,0,8048835
IMR90|chr15:52988286-52988354,chr15,52988286,52988354,IMR90|chr15:71054022-71054046,chr15,71054022,71054046,0,18065736
IMR90|chr15:53001263-53001318,chr15,53001263,53001318,IMR90|chr15:60687813-60687894,chr15,60687813,60687894,0,7686550
IMR90|chr15:53127321-53127375,chr15,53127321,53127375,IMR90|chr15:85295766-85295798,chr15,85295766,85295798,0,32168445
IMR90|chr15:53437124-53437165,chr15,53437124,53437165,IMR90|chr15:63344411-63344489,chr15,63344411,63344489,0,9907287
IMR90|chr15:53650797-53650903,chr15,53650797,53650903,IMR90|chr15:64752809-64752959,chr15,64752809,64752959,0,11102012
IMR90|chr15:53700927-53700995,chr15,53700927,53700995,IMR90|chr15:71142592-71142637,chr15,71142592,71142637,0,17441665
IMR90|chr15:53996747-53996897,chr15,53996747,53996897,IMR90|chr15:69747137-69747272,chr15,69747137,69747272,0,15750390
IMR90|chr15:54183152-54183178,chr15,54183152,54183178,IMR90|chr15:65119779-65119909,chr15,65119779,65119909,0,10936627
IMR90|chr15:54472799-54472828,chr15,54472799,54472828,IMR90|chr15:71051829-71051907,chr15,71051829,71051907,0,16579030
IMR90|chr15:54668915-54668956,chr15,54668915,54668956,IMR90|chr15:50645841-50645918,chr15,50645841,50645918,0,4023074
IMR90|chr15:54686261-54686305,chr15,54686261,54686305,IMR90|chr15:63673497-63673609,chr15,63673497,63673609,0,8987236
IMR90|chr15:54724876-54724915,chr15,54724876,54724915,IMR90|chr15:63335480-63335545,chr15,63335480,63335545,0,8610604
IMR90|chr15:54872484-54872514,chr15,54872484,54872514,IMR90|chr15:72520133-72520213,chr15,72520133,72520213,0,17647649
IMR90|chr15:55101953-55102004,chr15,55101953,55102004,IMR90|chr15:71051868-71051951,chr15,71051868,71051951,0,15949915
IMR90|chr15:55189681-55189708,chr15,55189681,55189708,IMR90|chr15:85291664-85291697,chr15,85291664,85291697,0,30101983
IMR90|chr15:55751527-55751578,chr15,55751527,55751578,IMR90|chr15:23032846-23032913,chr15,23032846,23032913,0,32718681
IMR90|chr15:56104664-56104689,chr15,56104664,56104689,IMR90|chr15:96879181-96879242,chr15,96879181,96879242,0,40774517
IMR90|chr15:56354884-56354954,chr15,56354884,56354954,IMR90|chr15:39877252-39877332,chr15,39877252,39877332,0,16477632
IMR90|chr15:56530848-56530998,chr15,56530848,56530998,IMR90|chr15:96870695-96870714,chr15,96870695,96870714,0,40339847
IMR90|chr15:56597333-56597397,chr15,56597333,56597397,IMR90|chr15:63336465-63336510,chr15,63336465,63336510,0,6739132
IMR90|chr15:56840739-56840860,chr15,56840739,56840860,IMR90|chr15:71055502-71055525,chr15,71055502,71055525,0,14214763
IMR90|chr15:56870707-56870799,chr15,56870707,56870799,IMR90|chr15:71051240-71051284,chr15,71051240,71051284,0,14180533
IMR90|chr15:56939778-56939857,chr15,56939778,56939857,IMR90|chr15:72410926-72410962,chr15,72410926,72410962,0,15471148
IMR90|chr15:57063590-57063620,chr15,57063590,57063620,IMR90|chr15:71051829-71051906,chr15,71051829,71051906,0,13988239
IMR90|chr15:57175623-57175653,chr15,57175623,57175653,IMR90|chr15:90549227-90549287,chr15,90549227,90549287,0,33373604
IMR90|chr15:57365062-57365093,chr15,57365062,57365093,IMR90|chr15:71051236-71051320,chr15,71051236,71051320,0,13686174
IMR90|chr15:57793024-57793095,chr15,57793024,57793095,IMR90|chr15:90548022-90548061,chr15,90548022,90548061,0,32754998
IMR90|chr15:57941442-57941477,chr15,57941442,57941477,IMR90|chr15:63335480-63335545,chr15,63335480,63335545,0,5394038
IMR90|chr15:58236020-58236113,chr15,58236020,58236113,IMR90|chr15:39873646-39873698,chr15,39873646,39873698,0,18362374
IMR90|chr15:58332406-58332439,chr15,58332406,58332439,IMR90|chr15:72522586-72522736,chr15,72522586,72522736,0,14190180
IMR90|chr15:58446727-58446826,chr15,58446727,58446826,IMR90|chr15:74835447-74835522,chr15,74835447,74835522,0,16388720
IMR90|chr15:58479328-58479359,chr15,58479328,58479359,IMR90|chr15:96871597-96871720,chr15,96871597,96871720,0,38392269
IMR90|chr15:58479617-58479685,chr15,58479617,58479685,IMR90|chr15:71054022-71054046,chr15,71054022,71054046,0,12574405
IMR90|chr15:58524333-58524434,chr15,58524333,58524434,IMR90|chr15:96879181-96879242,chr15,96879181,96879242,0,38354848
IMR90|chr15:58584747-58584796,chr15,58584747,58584796,IMR90|chr15:50642292-50642361,chr15,50642292,50642361,0,7942455
IMR90|chr15:59234632-59234667,chr15,59234632,59234667,IMR90|chr15:63344587-63344615,chr15,63344587,63344615,0,4109955
IMR90|chr15:59344569-59344622,chr15,59344569,59344622,IMR90|chr15:93452081-93452144,chr15,93452081,93452144,0,34107512
IMR90|chr15:59525382-59525495,chr15,59525382,59525495,IMR90|chr15:71052609-71052646,chr15,71052609,71052646,0,11527227
IMR90|chr15:59533256-59533315,chr15,59533256,59533315,IMR90|chr15:89176864-89176923,chr15,89176864,89176923,0,29643608
IMR90|chr15:59916716-59916755,chr15,59916716,59916755,IMR90|chr15:78591638-78591749,chr15,78591638,78591749,0,18674922
IMR90|chr15:60672198-60672268,chr15,60672198,60672268,IMR90|chr15:71051771-71051816,chr15,71051771,71051816,0,10379573
IMR90|chr15:60782887-60782915,chr15,60782887,60782915,IMR90|chr15:71054851-71054948,chr15,71054851,71054948,0,10271964
IMR90|chr15:60787762-60787798,chr15,60787762,60787798,IMR90|chr15:70994678-70994769,chr15,70994678,70994769,0,10206916
IMR90|chr15:60848724-60848800,chr15,60848724,60848800,IMR90|chr15:71055101-71055175,chr15,71055101,71055175,0,10206377
IMR90|chr15:61182785-61182862,chr15,61182785,61182862,IMR90|chr15:63346301-63346329,chr15,63346301,63346329,0,2163516
IMR90|chr15:61185863-61185973,chr15,61185863,61185973,IMR90|chr15:60685063-60685102,chr15,60685063,60685102,0,500800
IMR90|chr15:61284897-61284924,chr15,61284897,61284924,IMR90|chr15:96871597-96871720,chr15,96871597,96871720,0,35586700
IMR90|chr15:61663683-61663774,chr15,61663683,61663774,IMR90|chr15:40630342-40630404,chr15,40630342,40630404,0,21033341
IMR90|chr15:61699125-61699226,chr15,61699125,61699226,IMR90|chr15:71054834-71054926,chr15,71054834,71054926,0,9355709
IMR90|chr15:62257109-62257231,chr15,62257109,62257231,IMR90|chr15:65423438-65423475,chr15,65423438,65423475,0,3166329
IMR90|chr15:62373885-62373934,chr15,62373885,62373934,IMR90|chr15:60688705-60688768,chr15,60688705,60688768,0,1685180
IMR90|chr15:62937667-62937715,chr15,62937667,62937715,IMR90|chr15:59967700-59967789,chr15,59967700,59967789,0,2969967
IMR90|chr15:63055084-63055168,chr15,63055084,63055168,IMR90|chr15:72515435-72515469,chr15,72515435,72515469,0,9460351
IMR90|chr15:63107811-63107903,chr15,63107811,63107903,IMR90|chr15:72521788-72521877,chr15,72521788,72521877,0,9413977
IMR90|chr15:63160524-63160604,chr15,63160524,63160604,IMR90|chr15:96875871-96875924,chr15,96875871,96875924,0,33715347
IMR90|chr15:63532028-63532068,chr15,63532028,63532068,IMR90|chr15:71149610-71149684,chr15,71149610,71149684,0,7617582
IMR90|chr15:63678388-63678419,chr15,63678388,63678419,IMR90|chr15:96871597-96871720,chr15,96871597,96871720,0,33193209
IMR90|chr15:63693234-63693269,chr15,63693234,63693269,IMR90|chr15:89180291-89180335,chr15,89180291,89180335,0,25487057
IMR90|chr15:64062220-64062281,chr15,64062220,64062281,IMR90|chr15:60684815-60684866,chr15,60684815,60684866,0,3377405
IMR90|chr15:64323220-64323315,chr15,64323220,64323315,IMR90|chr15:60686723-60686778,chr15,60686723,60686778,0,3636497
IMR90|chr15:64706991-64707082,chr15,64706991,64707082,IMR90|chr15:102189644-102189693,chr15,102189644,102189693,0,37482653
IMR90|chr15:64867016-64867044,chr15,64867016,64867044,IMR90|chr15:50650641-50650733,chr15,50650641,50650733,0,14216375
IMR90|chr15:65373598-65373647,chr15,65373598,65373647,IMR90|chr15:39877437-39877473,chr15,39877437,39877473,0,25496161
IMR90|chr15:65930155-65930268,chr15,65930155,65930268,IMR90|chr15:71052609-71052646,chr15,71052609,71052646,0,5122454
IMR90|chr15:66084315-66084421,chr15,66084315,66084421,IMR90|chr15:72523119-72523160,chr15,72523119,72523160,0,6438804
IMR90|chr15:66227323-66227376,chr15,66227323,66227376,IMR90|chr15:71051892-71051996,chr15,71051892,71051996,0,4824569
IMR90|chr15:66396433-66396515,chr15,66396433,66396515,IMR90|chr15:90357158-90357187,chr15,90357158,90357187,0,23960725
IMR90|chr15:66409713-66409814,chr15,66409713,66409814,IMR90|chr15:96879181-96879242,chr15,96879181,96879242,0,30469468
IMR90|chr15:66451817-66451864,chr15,66451817,66451864,IMR90|chr15:60686616-60686693,chr15,60686616,60686693,0,5765201
IMR90|chr15:66627369-66627478,chr15,66627369,66627478,IMR90|chr15:60686520-60686586,chr15,60686520,60686586,0,5940849
IMR90|chr15:67003474-67003515,chr15,67003474,67003515,IMR90|chr15:59966034-59966140,chr15,59966034,59966140,0,7037440
IMR90|chr15:67040085-67040230,chr15,67040085,67040230,IMR90|chr15:60687671-60687688,chr15,60687671,60687688,0,6352414
IMR90|chr15:67283265-67283352,chr15,67283265,67283352,IMR90|chr15:71054853-71054892,chr15,71054853,71054892,0,3771588
IMR90|chr15:67497020-67497041,chr15,67497020,67497041,IMR90|chr15:60689961-60690086,chr15,60689961,60690086,0,6807059
IMR90|chr15:67561295-67561346,chr15,67561295,67561346,IMR90|chr15:23032846-23032913,chr15,23032846,23032913,0,44528449
IMR90|chr15:67875099-67875220,chr15,67875099,67875220,IMR90|chr15:71055502-71055525,chr15,71055502,71055525,0,3180403
IMR90|chr15:68183339-68183451,chr15,68183339,68183451,IMR90|chr15:71053074-71053108,chr15,71053074,71053108,0,2869735
IMR90|chr15:68917957-68918038,chr15,68917957,68918038,IMR90|chr15:96869628-96869663,chr15,96869628,96869663,0,27951671
IMR90|chr15:69333965-69334112,chr15,69333965,69334112,IMR90|chr15:72519240-72519290,chr15,72519240,72519290,0,3185275
IMR90|chr15:69428725-69428820,chr15,69428725,69428820,IMR90|chr15:39875387-39875406,chr15,39875387,39875406,0,29553338
IMR90|chr15:69513656-69513773,chr15,69513656,69513773,IMR90|chr15:71053085-71053104,chr15,71053085,71053104,0,1539429
IMR90|chr15:70030184-70030257,chr15,70030184,70030257,IMR90|chr15:33011813-33011864,chr15,33011813,33011864,0,37018371
IMR90|chr15:70350894-70350917,chr15,70350894,70350917,IMR90|chr15:60686407-60686441,chr15,60686407,60686441,0,9664487
IMR90|chr15:70520978-70521019,chr15,70520978,70521019,IMR90|chr15:60684957-60685001,chr15,60684957,60685001,0,9836021
IMR90|chr15:70860840-70860950,chr15,70860840,70860950,IMR90|chr15:64752809-64752958,chr15,64752809,64752958,0,6108031
IMR90|chr15:70864137-70864169,chr15,70864137,70864169,IMR90|chr15:72519212-72519359,chr15,72519212,72519359,0,1655075
IMR90|chr15:71110590-71110686,chr15,71110590,71110686,IMR90|chr15:23032971-23033034,chr15,23032971,23033034,0,48077619
IMR90|chr15:71411964-71412050,chr15,71411964,71412050,IMR90|chr15:60685103-60685160,chr15,60685103,60685160,0,10726861
IMR90|chr15:71708711-71708754,chr15,71708711,71708754,IMR90|chr15:96902776-96902839,chr15,96902776,96902839,0,25194065
IMR90|chr15:71786639-71786783,chr15,71786639,71786783,IMR90|chr15:71051543-71051580,chr15,71051543,71051580,0,735096
IMR90|chr15:71789114-71789172,chr15,71789114,71789172,IMR90|chr15:33011638-33011729,chr15,33011638,33011729,0,38777476
IMR90|chr15:71986927-71986983,chr15,71986927,71986983,IMR90|chr15:67000356-67000448,chr15,67000356,67000448,0,4986571
IMR90|chr15:72215719-72215763,chr15,72215719,72215763,IMR90|chr15:63673497-63673609,chr15,63673497,63673609,0,8542222
IMR90|chr15:72266988-72267029,chr15,72266988,72267029,IMR90|chr15:71053613-71053647,chr15,71053613,71053647,0,1213375
IMR90|chr15:72334268-72334330,chr15,72334268,72334330,IMR90|chr15:59965500-59965557,chr15,59965500,59965557,0,12368768
IMR90|chr15:72551260-72551294,chr15,72551260,72551294,IMR90|chr15:33012447-33012562,chr15,33012447,33012562,0,39538813
IMR90|chr15:73342059-73342127,chr15,73342059,73342127,IMR90|chr15:60686407-60686441,chr15,60686407,60686441,0,12655652
IMR90|chr15:73597161-73597196,chr15,73597161,73597196,IMR90|chr15:71051797-71051908,chr15,71051797,71051908,0,2545364
IMR90|chr15:73611604-73611653,chr15,73611604,73611653,IMR90|chr15:71051758-71051827,chr15,71051758,71051827,0,2559846
IMR90|chr15:73769396-73769438,chr15,73769396,73769438,IMR90|chr15:71051797-71051908,chr15,71051797,71051908,0,2717599
IMR90|chr15:73886237-73886278,chr15,73886237,73886278,IMR90|chr15:59966034-59966140,chr15,59966034,59966140,0,13920203
IMR90|chr15:73958829-73958979,chr15,73958829,73958979,IMR90|chr15:67362109-67362153,chr15,67362109,67362153,0,6596720
IMR90|chr15:75088728-75088806,chr15,75088728,75088806,IMR90|chr15:89441348-89441382,chr15,89441348,89441382,0,14352620
IMR90|chr15:75292078-75292143,chr15,75292078,75292143,IMR90|chr15:89441348-89441380,chr15,89441348,89441380,0,14149270
IMR90|chr15:75559820-75559956,chr15,75559820,75559956,IMR90|chr15:52314366-52314387,chr15,52314366,52314387,0,23245454
IMR90|chr15:75575508-75575611,chr15,75575508,75575611,IMR90|chr15:67362109-67362153,chr15,67362109,67362153,0,8213399
IMR90|chr15:75960993-75961091,chr15,75960993,75961091,IMR90|chr15:69747137-69747272,chr15,69747137,69747272,0,6213856
IMR90|chr15:76404210-76404237,chr15,76404210,76404237,IMR90|chr15:71051885-71052008,chr15,71051885,71052008,0,5352325
IMR90|chr15:76544072-76544121,chr15,76544072,76544121,IMR90|chr15:60688705-60688768,chr15,60688705,60688768,0,15855367
IMR90|chr15:76952401-76952451,chr15,76952401,76952451,IMR90|chr15:39877067-39877120,chr15,39877067,39877120,0,37075334
IMR90|chr15:77145677-77145721,chr15,77145677,77145721,IMR90|chr15:63336954-63337043,chr15,63336954,63337043,0,13808723
IMR90|chr15:77550930-77550955,chr15,77550930,77550955,IMR90|chr15:96879181-96879242,chr15,96879181,96879242,0,19328251
IMR90|chr15:77612125-77612197,chr15,77612125,77612197,IMR90|chr15:71143119-71143194,chr15,71143119,71143194,0,6469006
IMR90|chr15:77630242-77630305,chr15,77630242,77630305,IMR90|chr15:78591638-78591749,chr15,78591638,78591749,0,961396
IMR90|chr15:78255586-78255687,chr15,78255586,78255687,IMR90|chr15:71054834-71054926,chr15,71054834,71054926,0,7200752
IMR90|chr15:78315781-78315894,chr15,78315781,78315894,IMR90|chr15:65423438-65423475,chr15,65423438,65423475,0,12892343
IMR90|chr15:78563826-78563878,chr15,78563826,78563878,IMR90|chr15:57512713-57512759,chr15,57512713,57512759,0,21051113
IMR90|chr15:78592977-78593106,chr15,78592977,78593106,IMR90|chr15:52314366-52314387,chr15,52314366,52314387,0,26278611
IMR90|chr15:78736575-78736668,chr15,78736575,78736668,IMR90|chr15:33012502-33012548,chr15,33012502,33012548,0,45724073
IMR90|chr15:78778770-78778847,chr15,78778770,78778847,IMR90|chr15:102190950-102191023,chr15,102190950,102191023,0,23412180
IMR90|chr15:78978903-78978980,chr15,78978903,78978980,IMR90|chr15:102190950-102191023,chr15,102190950,102191023,0,23212047
IMR90|chr15:78996231-78996288,chr15,78996231,78996288,IMR90|chr15:71051700-71051793,chr15,71051700,71051793,0,7944531
IMR90|chr15:79447471-79447585,chr15,79447471,79447585,IMR90|chr15:72520498-72520515,chr15,72520498,72520515,0,6926973
IMR90|chr15:79451518-79451641,chr15,79451518,79451641,IMR90|chr15:71053456-71053493,chr15,71053456,71053493,0,8398062
IMR90|chr15:79837589-79837623,chr15,79837589,79837623,IMR90|chr15:63342304-63342420,chr15,63342304,63342420,0,16495285
IMR90|chr15:79912893-79912929,chr15,79912893,79912929,IMR90|chr15:70994678-70994769,chr15,70994678,70994769,0,8918215
IMR90|chr15:80143563-80143694,chr15,80143563,80143694,IMR90|chr15:96878061-96878183,chr15,96878061,96878183,0,16734498
IMR90|chr15:80614447-80614489,chr15,80614447,80614489,IMR90|chr15:71051797-71051908,chr15,71051797,71051908,0,9562650
IMR90|chr15:80702705-80702807,chr15,80702705,80702807,IMR90|chr15:69109839-69109865,chr15,69109839,69109865,0,11592866
IMR90|chr15:80818221-80818312,chr15,80818221,80818312,IMR90|chr15:40630342-40630404,chr15,40630342,40630404,0,40187879
IMR90|chr15:81069569-81069610,chr15,81069569,81069610,IMR90|chr15:60684957-60685001,chr15,60684957,60685001,0,20384612
IMR90|chr15:81146512-81146570,chr15,81146512,81146570,IMR90|chr15:67000356-67000448,chr15,67000356,67000448,0,14146156
IMR90|chr15:81327447-81327489,chr15,81327447,81327489,IMR90|chr15:89166516-89166602,chr15,89166516,89166602,0,7839069
IMR90|chr15:81715662-81715754,chr15,81715662,81715754,IMR90|chr15:72515724-72515782,chr15,72515724,72515782,0,9199938
IMR90|chr15:81846155-81846286,chr15,81846155,81846286,IMR90|chr15:85293141-85293215,chr15,85293141,85293215,0,3446986
IMR90|chr15:81859278-81859309,chr15,81859278,81859309,IMR90|chr15:66997607-66997715,chr15,66997607,66997715,0,14861671
IMR90|chr15:82097571-82097680,chr15,82097571,82097680,IMR90|chr15:60686520-60686586,chr15,60686520,60686586,0,21411051
IMR90|chr15:82167766-82167807,chr15,82167766,82167807,IMR90|chr15:63335188-63335254,chr15,63335188,63335254,0,18832578
IMR90|chr15:82342550-82342669,chr15,82342550,82342669,IMR90|chr15:71051700-71051793,chr15,71051700,71051793,0,11290850
IMR90|chr15:82490659-82490726,chr15,82490659,82490726,IMR90|chr15:67419385-67419423,chr15,67419385,67419423,0,15071274
IMR90|chr15:82511743-82511804,chr15,82511743,82511804,IMR90|chr15:67360760-67360889,chr15,67360760,67360889,0,15150983
IMR90|chr15:82536395-82536508,chr15,82536395,82536508,IMR90|chr15:71051543-71051580,chr15,71051543,71051580,0,11484852
IMR90|chr15:82570864-82570963,chr15,82570864,82570963,IMR90|chr15:63345318-63345345,chr15,63345318,63345345,0,19225546
IMR90|chr15:83039804-83039910,chr15,83039804,83039910,IMR90|chr15:72523119-72523160,chr15,72523119,72523160,0,10516685
IMR90|chr15:83283105-83283167,chr15,83283105,83283167,IMR90|chr15:59965500-59965557,chr15,59965500,59965557,0,23317605
IMR90|chr15:84365916-84365937,chr15,84365916,84365937,IMR90|chr15:67360760-67360889,chr15,67360760,67360889,0,17005156
IMR90|chr15:84537408-84537500,chr15,84537408,84537500,IMR90|chr15:72521788-72521877,chr15,72521788,72521877,0,12015620
IMR90|chr15:84604984-84605027,chr15,84604984,84605027,IMR90|chr15:38545495-38545561,chr15,38545495,38545561,0,46059489
IMR90|chr15:84863050-84863152,chr15,84863050,84863152,IMR90|chr15:69109839-69109865,chr15,69109839,69109865,0,15753211
IMR90|chr15:85088059-85088146,chr15,85088059,85088146,IMR90|chr15:71054853-71054892,chr15,71054853,71054892,0,14033206
IMR90|chr15:85245946-85246007,chr15,85245946,85246007,IMR90|chr15:72521788-72521877,chr15,72521788,72521877,0,12724158
IMR90|chr15:85281484-85281584,chr15,85281484,85281584,IMR90|chr15:72519240-72519290,chr15,72519240,72519290,0,12762244
IMR90|chr15:85477947-85478050,chr15,85477947,85478050,IMR90|chr15:67362109-67362153,chr15,67362109,67362153,0,18115838
IMR90|chr15:85905343-85905457,chr15,85905343,85905457,IMR90|chr15:72520498-72520515,chr15,72520498,72520515,0,13384845
IMR90|chr15:86446991-86447036,chr15,86446991,86447036,IMR90|chr15:71408348-71408497,chr15,71408348,71408497,0,15038643
IMR90|chr15:86499201-86499296,chr15,86499201,86499296,IMR90|chr15:39875387-39875406,chr15,39875387,39875406,0,46623814
IMR90|chr15:86623440-86623513,chr15,86623440,86623513,IMR90|chr15:40630590-40630623,chr15,40630590,40630623,0,45992850
IMR90|chr15:86711629-86711751,chr15,86711629,86711751,IMR90|chr15:69222811-69222830,chr15,69222811,69222830,0,17488818
IMR90|chr15:86724171-86724321,chr15,86724171,86724321,IMR90|chr15:67362109-67362153,chr15,67362109,67362153,0,19362062
IMR90|chr15:86976943-86977054,chr15,86976943,86977054,IMR90|chr15:72410926-72410962,chr15,72410926,72410962,0,14566017
IMR90|chr15:87231727-87231789,chr15,87231727,87231789,IMR90|chr15:52314222-52314272,chr15,52314222,52314272,0,34917505
IMR90|chr15:87245209-87245315,chr15,87245209,87245315,IMR90|chr15:64752809-64752959,chr15,64752809,64752959,0,22492400
IMR90|chr15:87288580-87288658,chr15,87288580,87288658,IMR90|chr15:71053188-71053225,chr15,71053188,71053225,0,16235392
IMR90|chr15:87296474-87296597,chr15,87296474,87296597,IMR90|chr15:71053456-71053493,chr15,71053456,71053493,0,16243018
IMR90|chr15:87605510-87605552,chr15,87605510,87605552,IMR90|chr15:33012447-33012562,chr15,33012447,33012562,0,54593063
IMR90|chr15:87727277-87727408,chr15,87727277,87727408,IMR90|chr15:96870695-96870714,chr15,96870695,96870714,0,9143418
IMR90|chr15:87774833-87774873,chr15,87774833,87774873,IMR90|chr15:91473332-91473381,chr15,91473332,91473381,0,3698499
IMR90|chr15:87923357-87923384,chr15,87923357,87923384,IMR90|chr15:33012196-33012319,chr15,33012196,33012319,0,54911161
IMR90|chr15:88018129-88018157,chr15,88018129,88018157,IMR90|chr15:66997607-66997716,chr15,66997607,66997716,0,21020522
IMR90|chr15:88470082-88470143,chr15,88470082,88470143,IMR90|chr15:72518941-72519030,chr15,72518941,72519030,0,15951141
IMR90|chr15:88502955-88503016,chr15,88502955,88503016,IMR90|chr15:72518941-72519030,chr15,72518941,72519030,0,15984014
IMR90|chr15:88594095-88594122,chr15,88594095,88594122,IMR90|chr15:33012196-33012319,chr15,33012196,33012319,0,55581899
IMR90|chr15:88655009-88655038,chr15,88655009,88655038,IMR90|chr15:71051868-71051951,chr15,71051868,71051951,0,17603141
IMR90|chr15:88672271-88672363,chr15,88672271,88672363,IMR90|chr15:71051240-71051284,chr15,71051240,71051284,0,17621031
IMR90|chr15:88696124-88696183,chr15,88696124,88696183,IMR90|chr15:70994688-70994746,chr15,70994688,70994746,0,17701436
IMR90|chr15:88827508-88827578,chr15,88827508,88827578,IMR90|chr15:39877252-39877332,chr15,39877252,39877332,0,48950256
IMR90|chr15:88854416-88854467,chr15,88854416,88854467,IMR90|chr15:57512713-57512758,chr15,57512713,57512758,0,31341703
IMR90|chr15:88977581-88977611,chr15,88977581,88977611,IMR90|chr15:72520133-72520213,chr15,72520133,72520213,0,16457448
IMR90|chr15:89093903-89093966,chr15,89093903,89093966,IMR90|chr15:78591638-78591749,chr15,78591638,78591749,0,10502265
IMR90|chr15:89224369-89224427,chr15,89224369,89224427,IMR90|chr15:60685952-60685974,chr15,60685952,60685974,0,28538417
IMR90|chr15:89495653-89495736,chr15,89495653,89495736,IMR90|chr15:66998205-66998259,chr15,66998205,66998259,0,22497448
IMR90|chr15:89633447-89633476,chr15,89633447,89633476,IMR90|chr15:71051868-71051951,chr15,71051868,71051951,0,18581579
IMR90|chr15:89762389-89762477,chr15,89762389,89762477,IMR90|chr15:71055099-71055161,chr15,71055099,71055161,0,18707290
IMR90|chr15:89785563-89785605,chr15,89785563,89785605,IMR90|chr15:89166516-89166602,chr15,89166516,89166602,0,619047
IMR90|chr15:90039340-90039397,chr15,90039340,90039397,IMR90|chr15:71051700-71051793,chr15,71051700,71051793,0,18987640
IMR90|chr15:90235295-90235319,chr15,90235295,90235319,IMR90|chr15:33011782-33011839,chr15,33011782,33011839,0,57223513
IMR90|chr15:90599889-90599943,chr15,90599889,90599943,IMR90|chr15:33013970-33014045,chr15,33013970,33014045,0,57585919
IMR90|chr15:90843801-90843864,chr15,90843801,90843864,IMR90|chr15:52314222-52314272,chr15,52314222,52314272,0,38529579
IMR90|chr15:91412639-91412684,chr15,91412639,91412684,IMR90|chr15:85046504-85046596,chr15,85046504,85046596,0,6366135
IMR90|chr15:91566317-91566381,chr15,91566317,91566381,IMR90|chr15:89877499-89877567,chr15,89877499,89877567,0,1688818
IMR90|chr15:91684218-91684365,chr15,91684218,91684365,IMR90|chr15:72410926-72410962,chr15,72410926,72410962,0,19273292
IMR90|chr15:91878512-91878662,chr15,91878512,91878662,IMR90|chr15:71055502-71055525,chr15,71055502,71055525,0,20823010
IMR90|chr15:92065532-92065608,chr15,92065532,92065608,IMR90|chr15:90357158-90357187,chr15,90357158,90357187,0,1708374
IMR90|chr15:92094755-92094790,chr15,92094755,92094790,IMR90|chr15:89180291-89180335,chr15,89180291,89180335,0,2914464
IMR90|chr15:92283052-92283202,chr15,92283052,92283202,IMR90|chr15:96870695-96870714,chr15,96870695,96870714,0,4587643
IMR90|chr15:92571842-92571987,chr15,92571842,92571987,IMR90|chr15:60687671-60687688,chr15,60687671,60687688,0,31884171
IMR90|chr15:92708354-92708416,chr15,92708354,92708416,IMR90|chr15:63344587-63344615,chr15,63344587,63344615,0,29363767
IMR90|chr15:92857978-92858052,chr15,92857978,92858052,IMR90|chr15:90548022-90548061,chr15,90548022,90548061,0,2309956
IMR90|chr15:92956519-92956560,chr15,92956519,92956560,IMR90|chr15:63344411-63344489,chr15,63344411,63344489,0,29612108
IMR90|chr15:93062777-93062846,chr15,93062777,93062846,IMR90|chr15:96876120-96876152,chr15,96876120,96876152,0,3813343
IMR90|chr15:93133567-93133689,chr15,93133567,93133689,IMR90|chr15:65423438-65423475,chr15,65423438,65423475,0,27710129
IMR90|chr15:93838572-93838611,chr15,93838572,93838611,IMR90|chr15:63342856-63342902,chr15,63342856,63342902,0,30495716
IMR90|chr15:93916402-93916475,chr15,93916402,93916475,IMR90|chr15:39877252-39877332,chr15,39877252,39877332,0,54039150
IMR90|chr15:93925738-93925811,chr15,93925738,93925811,IMR90|chr15:63342096-63342131,chr15,63342096,63342131,0,30583642
IMR90|chr15:93965290-93965352,chr15,93965290,93965352,IMR90|chr15:63344587-63344615,chr15,63344587,63344615,0,30620703
IMR90|chr15:94480855-94480882,chr15,94480855,94480882,IMR90|chr15:96876146-96876216,chr15,96876146,96876216,0,2395291
IMR90|chr15:94618887-94618922,chr15,94618887,94618922,IMR90|chr15:90644820-90644902,chr15,90644820,90644902,0,3974067
IMR90|chr15:94708002-94708052,chr15,94708002,94708052,IMR90|chr15:39877067-39877120,chr15,39877067,39877120,0,54830935
IMR90|chr15:95299698-95299845,chr15,95299698,95299845,IMR90|chr15:72519240-72519290,chr15,72519240,72519290,0,22780458
IMR90|chr15:95355884-95356018,chr15,95355884,95356018,IMR90|chr15:85295766-85295798,chr15,85295766,85295798,0,10060118
IMR90|chr15:95399532-95399627,chr15,95399532,95399627,IMR90|chr15:90549168-90549215,chr15,90549168,90549215,0,4850364
IMR90|chr15:95595156-95595251,chr15,95595156,95595251,IMR90|chr15:59966034-59966140,chr15,59966034,59966140,0,35629122
IMR90|chr15:95948608-95948661,chr15,95948608,95948661,IMR90|chr15:60687813-60687896,chr15,60687813,60687896,0,35260795
IMR90|chr15:95987510-95987641,chr15,95987510,95987641,IMR90|chr15:85293141-85293215,chr15,85293141,85293215,0,10694369
IMR90|chr15:96034868-96035004,chr15,96034868,96035004,IMR90|chr15:52314366-52314387,chr15,52314366,52314387,0,43720502
IMR90|chr15:96281439-96281565,chr15,96281439,96281565,IMR90|chr15:59965821-59965879,chr15,59965821,59965879,0,36315618
IMR90|chr15:96295465-96295506,chr15,96295465,96295506,IMR90|chr15:63342856-63342902,chr15,63342856,63342902,0,32952609
IMR90|chr15:96717405-96717461,chr15,96717405,96717461,IMR90|chr15:72521763-72521852,chr15,72521763,72521852,0,24195642
IMR90|chr15:96933302-96933345,chr15,96933302,96933345,IMR90|chr15:38545495-38545561,chr15,38545495,38545561,0,58387807
IMR90|chr15:97135868-97135952,chr15,97135868,97135952,IMR90|chr15:70995075-70995141,chr15,70995075,70995141,0,26140793
IMR90|chr15:97721049-97721138,chr15,97721049,97721138,IMR90|chr15:33011657-33011714,chr15,33011657,33011714,0,64709392
IMR90|chr15:97986026-97986076,chr15,97986026,97986076,IMR90|chr15:23032846-23032913,chr15,23032846,23032913,0,74953180
IMR90|chr15:98075371-98075470,chr15,98075371,98075470,IMR90|chr15:63345318-63345345,chr15,63345318,63345345,0,34730053
IMR90|chr15:98169259-98169308,chr15,98169259,98169308,IMR90|chr15:71051758-71051827,chr15,71051758,71051827,0,27117501
IMR90|chr15:98199957-98200004,chr15,98199957,98200004,IMR90|chr15:59967700-59967789,chr15,59967700,59967789,0,38232257
IMR90|chr15:98575532-98575579,chr15,98575532,98575579,IMR90|chr15:60686616-60686693,chr15,60686616,60686693,0,37888916
IMR90|chr15:98656729-98656781,chr15,98656729,98656781,IMR90|chr15:90549168-90549215,chr15,90549168,90549215,0,8107561
IMR90|chr15:98679407-98679503,chr15,98679407,98679503,IMR90|chr15:39873646-39873698,chr15,39873646,39873698,0,58805761
IMR90|chr15:98777756-98777855,chr15,98777756,98777855,IMR90|chr15:74835447-74835522,chr15,74835447,74835522,0,23942309
IMR90|chr15:98827761-98827812,chr15,98827761,98827812,IMR90|chr15:71051868-71051951,chr15,71051868,71051951,0,27775893
IMR90|chr15:98983204-98983268,chr15,98983204,98983268,IMR90|chr15:71051885-71052008,chr15,71051885,71052008,0,27931319
IMR90|chr15:99187290-99187367,chr15,99187290,99187367,IMR90|chr15:63346301-63346329,chr15,63346301,63346329,0,35840989
IMR90|chr15:99214851-99214980,chr15,99214851,99214980,IMR90|chr15:52314366-52314387,chr15,52314366,52314387,0,46900485
IMR90|chr15:99236029-99236141,chr15,99236029,99236141,IMR90|chr15:71053074-71053108,chr15,71053074,71053108,0,28182955
IMR90|chr15:99245059-99245152,chr15,99245059,99245152,IMR90|chr15:33012502-33012548,chr15,33012502,33012548,0,66232557
IMR90|chr15:99329378-99329489,chr15,99329378,99329489,IMR90|chr15:72520498-72520515,chr15,72520498,72520515,0,26808880
IMR90|chr15:99386397-99386469,chr15,99386397,99386469,IMR90|chr15:71052060-71052086,chr15,71052060,71052086,0,28334337
IMR90|chr15:99585427-99585540,chr15,99585427,99585540,IMR90|chr15:71053456-71053493,chr15,71053456,71053493,0,28531971
IMR90|chr15:99864797-99864868,chr15,99864797,99864868,IMR90|chr15:90548022-90548061,chr15,90548022,90548061,0,9316775
IMR90|chr15:100104091-100104156,chr15,100104091,100104156,IMR90|chr15:71053838-71053917,chr15,71053838,71053917,0,29050253
IMR90|chr15:100683668-100683744,chr15,100683668,100683744,IMR90|chr15:90357158-90357187,chr15,90357158,90357187,0,10326510
IMR90|chr15:100788162-100788259,chr15,100788162,100788259,IMR90|chr15:71145184-71145227,chr15,71145184,71145227,0,29642978
IMR90|chr15:100799052-100799098,chr15,100799052,100799098,IMR90|chr15:71051892-71051996,chr15,71051892,71051996,0,29747160
IMR90|chr15:100807300-100807395,chr15,100807300,100807395,IMR90|chr15:60686723-60686778,chr15,60686723,60686778,0,40120577
IMR90|chr15:100936057-100936092,chr15,100936057,100936092,IMR90|chr15:63673497-63673609,chr15,63673497,63673609,0,37262560
IMR90|chr15:101001974-101002071,chr15,101001974,101002071,IMR90|chr15:71145184-71145227,chr15,71145184,71145227,0,29856790
IMR90|chr15:101227899-101227934,chr15,101227899,101227934,IMR90|chr15:63673497-63673609,chr15,63673497,63673609,0,37554402
IMR90|chr15:101365563-101365636,chr15,101365563,101365636,IMR90|chr15:40630590-40630623,chr15,40630590,40630623,0,60734973
IMR90|chr15:101463910-101464003,chr15,101463910,101464003,IMR90|chr15:71052230-71052282,chr15,71052230,71052282,0,30411680
IMR90|chr15:101496251-101496284,chr15,101496251,101496284,IMR90|chr15:72522586-72522736,chr15,72522586,72522736,0,28973665
IMR90|chr15:101713036-101713060,chr15,101713036,101713060,IMR90|chr15:33012566-33012641,chr15,33012566,33012641,0,68700470
IMR90|chr15:101903338-101903407,chr15,101903338,101903407,IMR90|chr15:96876120-96876152,chr15,96876120,96876152,0,5027218
IMR90|chr15:102034257-102034318,chr15,102034257,102034318,IMR90|chr15:33011657-33011714,chr15,33011657,33011714,0,69022600
IMR90|chr15:102069456-102069526,chr15,102069456,102069526,IMR90|chr15:67000005-67000056,chr15,67000005,67000056,0,35069451
IMR90|chr15:102095719-102095792,chr15,102095719,102095792,IMR90|chr15:60686617-60686677,chr15,60686617,60686677,0,41409102
IMR90|chr15:102288090-102288216,chr15,102288090,102288216,IMR90|chr15:59965821-59965879,chr15,59965821,59965879,0,42322269
IMR90|chr16:59424-59453,chr16,59424,59453,IMR90|chr16:28885742-28885830,chr16,28885742,28885830,0,28826318
IMR90|chr16:102642-102732,chr16,102642,102732,IMR90|chr16:4476331-4476388,chr16,4476331,4476388,0,4373689
IMR90|chr16:174266-174286,chr16,174266,174286,IMR90|chr16:88730237-88730269,chr16,88730237,88730269,0,88555971
IMR90|chr16:648337-648427,chr16,648337,648427,IMR90|chr16:85205625-85205689,chr16,85205625,85205689,0,84557288
IMR90|chr16:716855-716974,chr16,716855,716974,IMR90|chr16:85207364-85207419,chr16,85207364,85207419,0,84490509
IMR90|chr16:1032632-1032770,chr16,1032632,1032770,IMR90|chr16:88214239-88214355,chr16,88214239,88214355,0,87181607
IMR90|chr16:1136200-1136227,chr16,1136200,1136227,IMR90|chr16:85205546-85205622,chr16,85205546,85205622,0,84069346
IMR90|chr16:1191493-1191643,chr16,1191493,1191643,IMR90|chr16:87899090-87899234,chr16,87899090,87899234,0,86707597
IMR90|chr16:1223930-1224033,chr16,1223930,1224033,IMR90|chr16:85207373-85207419,chr16,85207373,85207419,0,83983443
IMR90|chr16:1314338-1314431,chr16,1314338,1314431,IMR90|chr16:85640567-85640614,chr16,85640567,85640614,0,84326229
IMR90|chr16:1462941-1462970,chr16,1462941,1462970,IMR90|chr16:85205478-85205574,chr16,85205478,85205574,0,83742537
IMR90|chr16:1488549-1488587,chr16,1488549,1488587,IMR90|chr16:89160926-89161074,chr16,89160926,89161074,0,87672377
IMR90|chr16:1512777-1512826,chr16,1512777,1512826,IMR90|chr16:85644174-85644275,chr16,85644174,85644275,0,84131397
IMR90|chr16:1532951-1533026,chr16,1532951,1533026,IMR90|chr16:48281126-48281198,chr16,48281126,48281198,0,46748175
IMR90|chr16:1597795-1597857,chr16,1597795,1597857,IMR90|chr16:3106362-3106412,chr16,3106362,3106412,0,1508567
IMR90|chr16:1700438-1700588,chr16,1700438,1700588,IMR90|chr16:87899048-87899198,chr16,87899048,87899198,0,86198610
IMR90|chr16:1829518-1829581,chr16,1829518,1829581,IMR90|chr16:85205509-85205659,chr16,85205509,85205659,0,83375991
IMR90|chr16:1931568-1931641,chr16,1931568,1931641,IMR90|chr16:85206181-85206228,chr16,85206181,85206228,0,83274613
IMR90|chr16:2194236-2194327,chr16,2194236,2194327,IMR90|chr16:88214286-88214368,chr16,88214286,88214368,0,86020050
IMR90|chr16:2217281-2217343,chr16,2217281,2217343,IMR90|chr16:88217709-88217829,chr16,88217709,88217829,0,86000428
IMR90|chr16:2256422-2256561,chr16,2256422,2256561,IMR90|chr16:88214182-88214332,chr16,88214182,88214332,0,85957760
IMR90|chr16:2470530-2470617,chr16,2470530,2470617,IMR90|chr16:85202387-85202447,chr16,85202387,85202447,0,82731857
IMR90|chr16:2543136-2543199,chr16,2543136,2543199,IMR90|chr16:85203648-85203676,chr16,85203648,85203676,0,82660512
IMR90|chr16:2826059-2826089,chr16,2826059,2826089,IMR90|chr16:85204584-85204628,chr16,85204584,85204628,0,82378525
IMR90|chr16:2970457-2970523,chr16,2970457,2970523,IMR90|chr16:19723916-19723944,chr16,19723916,19723944,0,16753459
IMR90|chr16:3086055-3086124,chr16,3086055,3086124,IMR90|chr16:31458967-31459094,chr16,31458967,31459094,0,28372912
IMR90|chr16:3238035-3238055,chr16,3238035,3238055,IMR90|chr16:70718296-70718396,chr16,70718296,70718396,0,67480261
IMR90|chr16:3305551-3305636,chr16,3305551,3305636,IMR90|chr16:9188656-9188728,chr16,9188656,9188728,0,5883105
IMR90|chr16:3385363-3385464,chr16,3385363,3385464,IMR90|chr16:85644473-85644494,chr16,85644473,85644494,0,82259110
IMR90|chr16:3452278-3452298,chr16,3452278,3452298,IMR90|chr16:86609144-86609294,chr16,86609144,86609294,0,83156866
IMR90|chr16:3604839-3604932,chr16,3604839,3604932,IMR90|chr16:71846697-71846742,chr16,71846697,71846742,0,68241858
IMR90|chr16:3644211-3644275,chr16,3644211,3644275,IMR90|chr16:19723916-19723944,chr16,19723916,19723944,0,16079705
IMR90|chr16:3721828-3721918,chr16,3721828,3721918,IMR90|chr16:85205625-85205689,chr16,85205625,85205689,0,81483797
IMR90|chr16:3929967-3930016,chr16,3929967,3930016,IMR90|chr16:85208443-85208519,chr16,85208443,85208519,0,81278476
IMR90|chr16:4029848-4029985,chr16,4029848,4029985,IMR90|chr16:87899046-87899196,chr16,87899046,87899196,0,83869198
IMR90|chr16:4104026-4104132,chr16,4104026,4104132,IMR90|chr16:85203034-85203078,chr16,85203034,85203078,0,81099008
IMR90|chr16:4222292-4222313,chr16,4222292,4222313,IMR90|chr16:11835574-11835675,chr16,11835574,11835675,0,7613282
IMR90|chr16:4310759-4310814,chr16,4310759,4310814,IMR90|chr16:85204827-85204919,chr16,85204827,85204919,0,80894068
IMR90|chr16:4371113-4371263,chr16,4371113,4371263,IMR90|chr16:29605760-29605907,chr16,29605760,29605907,0,25234647
IMR90|chr16:4480019-4480123,chr16,4480019,4480123,IMR90|chr16:81347618-81347681,chr16,81347618,81347681,0,76867599
IMR90|chr16:4506370-4506457,chr16,4506370,4506457,IMR90|chr16:85207044-85207076,chr16,85207044,85207076,0,80700674
IMR90|chr16:4607994-4608104,chr16,4607994,4608104,IMR90|chr16:89770566-89770620,chr16,89770566,89770620,0,85162572
IMR90|chr16:4663022-4663118,chr16,4663022,4663118,IMR90|chr16:85205931-85205983,chr16,85205931,85205983,0,80542909
IMR90|chr16:4768472-4768552,chr16,4768472,4768552,IMR90|chr16:2732235-2732273,chr16,2732235,2732273,0,2036237
IMR90|chr16:4798693-4798784,chr16,4798693,4798784,IMR90|chr16:88214286-88214368,chr16,88214286,88214368,0,83415593
IMR90|chr16:4836067-4836124,chr16,4836067,4836124,IMR90|chr16:71495505-71495558,chr16,71495505,71495558,0,66659438
IMR90|chr16:4881998-4882119,chr16,4881998,4882119,IMR90|chr16:88214254-88214383,chr16,88214254,88214383,0,83332256
IMR90|chr16:4946182-4946218,chr16,4946182,4946218,IMR90|chr16:85208446-85208495,chr16,85208446,85208495,0,80262264
IMR90|chr16:4978301-4978450,chr16,4978301,4978450,IMR90|chr16:2733243-2733322,chr16,2733243,2733322,0,2245058
IMR90|chr16:4981310-4981384,chr16,4981310,4981384,IMR90|chr16:31466084-31466128,chr16,31466084,31466128,0,26484774
IMR90|chr16:5175428-5175502,chr16,5175428,5175502,IMR90|chr16:85206181-85206228,chr16,85206181,85206228,0,80030753
IMR90|chr16:5421982-5422093,chr16,5421982,5422093,IMR90|chr16:67279684-67279706,chr16,67279684,67279706,0,61857702
IMR90|chr16:5746726-5746813,chr16,5746726,5746813,IMR90|chr16:85201575-85201638,chr16,85201575,85201638,0,79454849
IMR90|chr16:5801450-5801600,chr16,5801450,5801600,IMR90|chr16:88210621-88210771,chr16,88210621,88210771,0,82409171
IMR90|chr16:5886660-5886736,chr16,5886660,5886736,IMR90|chr16:2045317-2045391,chr16,2045317,2045391,0,3841343
IMR90|chr16:5895285-5895323,chr16,5895285,5895323,IMR90|chr16:89160926-89161074,chr16,89160926,89161074,0,83265641
IMR90|chr16:6238773-6238856,chr16,6238773,6238856,IMR90|chr16:85207094-85207235,chr16,85207094,85207235,0,78968321
IMR90|chr16:6752059-6752137,chr16,6752059,6752137,IMR90|chr16:2045882-2045932,chr16,2045882,2045932,0,4706177
IMR90|chr16:6796783-6796896,chr16,6796783,6796896,IMR90|chr16:85203313-85203350,chr16,85203313,85203350,0,78406530
IMR90|chr16:7247104-7247130,chr16,7247104,7247130,IMR90|chr16:31466930-31466996,chr16,31466930,31466996,0,24219826
IMR90|chr16:7467446-7467494,chr16,7467446,7467494,IMR90|chr16:4327280-4327342,chr16,4327280,4327342,0,3140166
IMR90|chr16:7499676-7499787,chr16,7499676,7499787,IMR90|chr16:67279905-67279943,chr16,67279905,67279943,0,59780229
IMR90|chr16:7591806-7591879,chr16,7591806,7591879,IMR90|chr16:19724858-19724880,chr16,19724858,19724880,0,12133052
IMR90|chr16:7655136-7655200,chr16,7655136,7655200,IMR90|chr16:3031215-3031268,chr16,3031215,3031268,0,4623921
IMR90|chr16:7705258-7705336,chr16,7705258,7705336,IMR90|chr16:452022-452076,chr16,452022,452076,0,7253236
IMR90|chr16:7772241-7772321,chr16,7772241,7772321,IMR90|chr16:85207089-85207124,chr16,85207089,85207124,0,77434848
IMR90|chr16:7808814-7808841,chr16,7808814,7808841,IMR90|chr16:3106362-3106412,chr16,3106362,3106412,0,4702452
IMR90|chr16:7831396-7831502,chr16,7831396,7831502,IMR90|chr16:71847109-71847150,chr16,71847109,71847150,0,64015713
IMR90|chr16:7925058-7925172,chr16,7925058,7925172,IMR90|chr16:70716881-70716959,chr16,70716881,70716959,0,62791823
IMR90|chr16:8022593-8022743,chr16,8022593,8022743,IMR90|chr16:87899048-87899198,chr16,87899048,87899198,0,79876455
IMR90|chr16:8265093-8265137,chr16,8265093,8265137,IMR90|chr16:31467511-31467578,chr16,31467511,31467578,0,23202418
IMR90|chr16:8370926-8370993,chr16,8370926,8370993,IMR90|chr16:67279684-67279706,chr16,67279684,67279706,0,58908758
IMR90|chr16:8418297-8418324,chr16,8418297,8418324,IMR90|chr16:85205546-85205622,chr16,85205546,85205622,0,76787249
IMR90|chr16:8427492-8427537,chr16,8427492,8427537,IMR90|chr16:85204822-85204913,chr16,85204822,85204913,0,76777330
IMR90|chr16:8433981-8434073,chr16,8433981,8434073,IMR90|chr16:85207364-85207419,chr16,85207364,85207419,0,76773383
IMR90|chr16:8508826-8508906,chr16,8508826,8508906,IMR90|chr16:2732235-2732273,chr16,2732235,2732273,0,5776591
IMR90|chr16:8782757-8782863,chr16,8782757,8782863,IMR90|chr16:85203034-85203078,chr16,85203034,85203078,0,76420277
IMR90|chr16:8860571-8860638,chr16,8860571,8860638,IMR90|chr16:51189860-51189940,chr16,51189860,51189940,0,42329289
IMR90|chr16:8920700-8920759,chr16,8920700,8920759,IMR90|chr16:85203566-85203585,chr16,85203566,85203585,0,76282866
IMR90|chr16:9218150-9218214,chr16,9218150,9218214,IMR90|chr16:85205836-85205896,chr16,85205836,85205896,0,75987686
IMR90|chr16:9303927-9304012,chr16,9303927,9304012,IMR90|chr16:89572011-89572057,chr16,89572011,89572057,0,80268084
IMR90|chr16:9322536-9322686,chr16,9322536,9322686,IMR90|chr16:85207364-85207419,chr16,85207364,85207419,0,75884828
IMR90|chr16:9337785-9337823,chr16,9337785,9337823,IMR90|chr16:85204848-85204897,chr16,85204848,85204897,0,75867063
IMR90|chr16:9617762-9617862,chr16,9617762,9617862,IMR90|chr16:29605840-29605990,chr16,29605840,29605990,0,19988078
IMR90|chr16:9679483-9679590,chr16,9679483,9679590,IMR90|chr16:31467504-31467630,chr16,31467504,31467630,0,21788021
IMR90|chr16:9724755-9724775,chr16,9724755,9724775,IMR90|chr16:85641479-85641571,chr16,85641479,85641571,0,75916724
IMR90|chr16:9870105-9870251,chr16,9870105,9870251,IMR90|chr16:18937861-18937988,chr16,18937861,18937988,0,9067756
IMR90|chr16:9994455-9994474,chr16,9994455,9994474,IMR90|chr16:51188768-51188860,chr16,51188768,51188860,0,41194313
IMR90|chr16:10379968-10379991,chr16,10379968,10379991,IMR90|chr16:31458967-31459094,chr16,31458967,31459094,0,21078999
IMR90|chr16:10618366-10618415,chr16,10618366,10618415,IMR90|chr16:23461339-23461406,chr16,23461339,23461406,0,12842973
IMR90|chr16:10701247-10701397,chr16,10701247,10701397,IMR90|chr16:88210621-88210771,chr16,88210621,88210771,0,77509374
IMR90|chr16:10730047-10730150,chr16,10730047,10730150,IMR90|chr16:85207373-85207419,chr16,85207373,85207419,0,74477326
IMR90|chr16:11001155-11001218,chr16,11001155,11001218,IMR90|chr16:85203648-85203676,chr16,85203648,85203676,0,74202493
IMR90|chr16:11017692-11017841,chr16,11017692,11017841,IMR90|chr16:87899056-87899206,chr16,87899056,87899206,0,76881364
IMR90|chr16:11180270-11180420,chr16,11180270,11180420,IMR90|chr16:18937912-18938061,chr16,18937912,18938061,0,7757642
IMR90|chr16:11188501-11188572,chr16,11188501,11188572,IMR90|chr16:89996381-89996492,chr16,89996381,89996492,0,78807880
IMR90|chr16:11216325-11216436,chr16,11216325,11216436,IMR90|chr16:85203974-85204032,chr16,85203974,85204032,0,73987649
IMR90|chr16:11426160-11426310,chr16,11426160,11426310,IMR90|chr16:29606045-29606189,chr16,29606045,29606189,0,18179885
IMR90|chr16:11471577-11471600,chr16,11471577,11471600,IMR90|chr16:75289174-75289272,chr16,75289174,75289272,0,63817597
IMR90|chr16:11846964-11847110,chr16,11846964,11847110,IMR90|chr16:29605760-29605905,chr16,29605760,29605905,0,17758796
IMR90|chr16:12063618-12063687,chr16,12063618,12063687,IMR90|chr16:85207133-85207214,chr16,85207133,85207214,0,73143515
IMR90|chr16:12147411-12147541,chr16,12147411,12147541,IMR90|chr16:48281148-48281198,chr16,48281148,48281198,0,36133737
IMR90|chr16:12188067-12188104,chr16,12188067,12188104,IMR90|chr16:31466895-31466971,chr16,31466895,31466971,0,19278828
IMR90|chr16:12202547-12202633,chr16,12202547,12202633,IMR90|chr16:85204848-85204897,chr16,85204848,85204897,0,73002301
IMR90|chr16:12353920-12353994,chr16,12353920,12353994,IMR90|chr16:4476331-4476388,chr16,4476331,4476388,0,7877589
IMR90|chr16:12455443-12455521,chr16,12455443,12455521,IMR90|chr16:2045882-2045932,chr16,2045882,2045932,0,10409561
IMR90|chr16:12516422-12516475,chr16,12516422,12516475,IMR90|chr16:85207358-85207478,chr16,85207358,85207478,0,72690936
IMR90|chr16:12527321-12527469,chr16,12527321,12527469,IMR90|chr16:88214252-88214383,chr16,88214252,88214383,0,75686931
IMR90|chr16:12735463-12735492,chr16,12735463,12735492,IMR90|chr16:28885742-28885830,chr16,28885742,28885830,0,16150279
IMR90|chr16:12768273-12768307,chr16,12768273,12768307,IMR90|chr16:85642876-85642959,chr16,85642876,85642959,0,72874603
IMR90|chr16:12879596-12879746,chr16,12879596,12879746,IMR90|chr16:29606047-29606197,chr16,29606047,29606197,0,16726451
IMR90|chr16:12903652-12903749,chr16,12903652,12903749,IMR90|chr16:2182607-2182757,chr16,2182607,2182757,0,10721045
IMR90|chr16:13186994-13187072,chr16,13186994,13187072,IMR90|chr16:9188656-9188728,chr16,9188656,9188728,0,3998338
IMR90|chr16:13286045-13286107,chr16,13286045,13286107,IMR90|chr16:85642342-85642403,chr16,85642342,85642403,0,72356297
IMR90|chr16:13293365-13293484,chr16,13293365,13293484,IMR90|chr16:89573507-89573529,chr16,89573507,89573529,0,76280142
IMR90|chr16:13570804-13570905,chr16,13570804,13570905,IMR90|chr16:85644473-85644494,chr16,85644473,85644494,0,72073669
IMR90|chr16:13701224-13701246,chr16,13701224,13701246,IMR90|chr16:75289174-75289272,chr16,75289174,75289272,0,61587950
IMR90|chr16:13972244-13972279,chr16,13972244,13972279,IMR90|chr16:2181627-2181741,chr16,2181627,2181741,0,11790617
IMR90|chr16:14064569-14064668,chr16,14064569,14064668,IMR90|chr16:22304402-22304453,chr16,22304402,22304453,0,8239833
IMR90|chr16:14101341-14101403,chr16,14101341,14101403,IMR90|chr16:88217709-88217829,chr16,88217709,88217829,0,74116368
IMR90|chr16:14252667-14252705,chr16,14252667,14252705,IMR90|chr16:85204848-85204897,chr16,85204848,85204897,0,70952181
IMR90|chr16:14359647-14359797,chr16,14359647,14359797,IMR90|chr16:87899090-87899234,chr16,87899090,87899234,0,73539443
IMR90|chr16:14701190-14701210,chr16,14701190,14701210,IMR90|chr16:86609144-86609294,chr16,86609144,86609294,0,71907954
IMR90|chr16:14711533-14711653,chr16,14711533,14711653,IMR90|chr16:89770566-89770620,chr16,89770566,89770620,0,75059033
IMR90|chr16:14901909-14902000,chr16,14901909,14902000,IMR90|chr16:87899046-87899196,chr16,87899046,87899196,0,72997137
IMR90|chr16:15128082-15128101,chr16,15128082,15128101,IMR90|chr16:85208359-85208502,chr16,85208359,85208502,0,70080277
IMR90|chr16:15219471-15219550,chr16,15219471,15219550,IMR90|chr16:18937922-18937993,chr16,18937922,18937993,0,3718451
IMR90|chr16:15258355-15258416,chr16,15258355,15258416,IMR90|chr16:87900081-87900204,chr16,87900081,87900204,0,72641726
IMR90|chr16:15385086-15385113,chr16,15385086,15385113,IMR90|chr16:3661779-3661892,chr16,3661779,3661892,0,11723307
IMR90|chr16:15415875-15415927,chr16,15415875,15415927,IMR90|chr16:2183073-2183119,chr16,2183073,2183119,0,13232802
IMR90|chr16:15465752-15465790,chr16,15465752,15465790,IMR90|chr16:70283369-70283457,chr16,70283369,70283457,0,54817617
IMR90|chr16:15761177-15761251,chr16,15761177,15761251,IMR90|chr16:89993277-89993300,chr16,89993277,89993300,0,74232100
IMR90|chr16:15813412-15813468,chr16,15813412,15813468,IMR90|chr16:71495505-71495558,chr16,71495505,71495558,0,55682093
IMR90|chr16:15877445-15877545,chr16,15877445,15877545,IMR90|chr16:18937861-18937988,chr16,18937861,18937988,0,3060416
IMR90|chr16:16189215-16189284,chr16,16189215,16189284,IMR90|chr16:81072355-81072505,chr16,81072355,81072505,0,64883140
IMR90|chr16:16281851-16281941,chr16,16281851,16281941,IMR90|chr16:4476331-4476388,chr16,4476331,4476388,0,11805520
IMR90|chr16:16361903-16361990,chr16,16361903,16361990,IMR90|chr16:18937922-18937973,chr16,18937922,18937973,0,2576019
IMR90|chr16:16489948-16490079,chr16,16489948,16490079,IMR90|chr16:85207089-85207107,chr16,85207089,85207107,0,68717141
IMR90|chr16:16677736-16677824,chr16,16677736,16677824,IMR90|chr16:31103058-31103091,chr16,31103058,31103091,0,14425322
IMR90|chr16:17268555-17268675,chr16,17268555,17268675,IMR90|chr16:89770566-89770620,chr16,89770566,89770620,0,72502011
IMR90|chr16:17301452-17301516,chr16,17301452,17301516,IMR90|chr16:3031215-3031268,chr16,3031215,3031268,0,14270237
IMR90|chr16:17316143-17316293,chr16,17316143,17316293,IMR90|chr16:18937941-18938028,chr16,18937941,18938028,0,1621798
IMR90|chr16:17355207-17355242,chr16,17355207,17355242,IMR90|chr16:85206629-85206727,chr16,85206629,85206727,0,67851422
IMR90|chr16:17478159-17478186,chr16,17478159,17478186,IMR90|chr16:67972357-67972484,chr16,67972357,67972484,0,50494198
IMR90|chr16:17554431-17554563,chr16,17554431,17554563,IMR90|chr16:85207089-85207107,chr16,85207089,85207107,0,67652658
IMR90|chr16:17631889-17631980,chr16,17631889,17631980,IMR90|chr16:85640766-85640811,chr16,85640766,85640811,0,68008877
IMR90|chr16:18181306-18181333,chr16,18181306,18181333,IMR90|chr16:67966888-67967009,chr16,67966888,67967009,0,49785582
IMR90|chr16:18330665-18330720,chr16,18330665,18330720,IMR90|chr16:85200183-85200278,chr16,85200183,85200278,0,66869518
IMR90|chr16:18498160-18498238,chr16,18498160,18498238,IMR90|chr16:84855994-84856066,chr16,84855994,84856066,0,66357834
IMR90|chr16:18546120-18546139,chr16,18546120,18546139,IMR90|chr16:51188768-51188860,chr16,51188768,51188860,0,32642648
IMR90|chr16:18568370-18568458,chr16,18568370,18568458,IMR90|chr16:18937922-18937976,chr16,18937922,18937976,0,369552
IMR90|chr16:18606522-18606558,chr16,18606522,18606558,IMR90|chr16:89161166-89161280,chr16,89161166,89161280,0,70554644
IMR90|chr16:18768004-18768042,chr16,18768004,18768042,IMR90|chr16:19724858-19724880,chr16,19724858,19724880,0,956854
IMR90|chr16:18902991-18903039,chr16,18902991,18903039,IMR90|chr16:85642301-85642403,chr16,85642301,85642403,0,66739310
IMR90|chr16:19073876-19073972,chr16,19073876,19073972,IMR90|chr16:18937922-18937976,chr16,18937922,18937976,0,135954
IMR90|chr16:19126700-19126736,chr16,19126700,19126736,IMR90|chr16:85205923-85206073,chr16,85205923,85206073,0,66079223
IMR90|chr16:19339801-19339833,chr16,19339801,19339833,IMR90|chr16:88215509-88215591,chr16,88215509,88215591,0,68875708
IMR90|chr16:19431853-19431945,chr16,19431853,19431945,IMR90|chr16:18937922-18937975,chr16,18937922,18937975,0,493931
IMR90|chr16:19466728-19466815,chr16,19466728,19466815,IMR90|chr16:18937922-18937973,chr16,18937922,18937973,0,528806
IMR90|chr16:19483202-19483294,chr16,19483202,19483294,IMR90|chr16:85203974-85204032,chr16,85203974,85204032,0,65720772
IMR90|chr16:19616364-19616402,chr16,19616364,19616402,IMR90|chr16:69366412-69366479,chr16,69366412,69366479,0,49750048
IMR90|chr16:19638236-19638360,chr16,19638236,19638360,IMR90|chr16:22304402-22304453,chr16,22304402,22304453,0,2666166
IMR90|chr16:19674837-19674943,chr16,19674837,19674943,IMR90|chr16:71847109-71847150,chr16,71847109,71847150,0,52172272
IMR90|chr16:19719837-19719865,chr16,19719837,19719865,IMR90|chr16:85204125-85204223,chr16,85204125,85204223,0,65484288
IMR90|chr16:19723908-19723926,chr16,19723908,19723926,IMR90|chr16:31467516-31467648,chr16,31467516,31467648,0,11743608
IMR90|chr16:19759048-19759086,chr16,19759048,19759086,IMR90|chr16:31467478-31467590,chr16,31467478,31467590,0,11708430
IMR90|chr16:19931079-19931105,chr16,19931079,19931105,IMR90|chr16:71844126-71844195,chr16,71844126,71844195,0,51913047
IMR90|chr16:20014535-20014588,chr16,20014535,20014588,IMR90|chr16:2183011-2183106,chr16,2183011,2183106,0,17831524
IMR90|chr16:20170004-20170154,chr16,20170004,20170154,IMR90|chr16:87899046-87899196,chr16,87899046,87899196,0,67729042
IMR90|chr16:20378140-20378222,chr16,20378140,20378222,IMR90|chr16:85205546-85205580,chr16,85205546,85205580,0,64827406
IMR90|chr16:20445694-20445841,chr16,20445694,20445841,IMR90|chr16:88214370-88214448,chr16,88214370,88214448,0,67768676
IMR90|chr16:20589642-20589686,chr16,20589642,20589686,IMR90|chr16:85204145-85204224,chr16,85204145,85204224,0,64614503
IMR90|chr16:20625934-20626006,chr16,20625934,20626006,IMR90|chr16:87900167-87900223,chr16,87900167,87900223,0,67274233
IMR90|chr16:20836945-20837013,chr16,20836945,20837013,IMR90|chr16:2733243-2733322,chr16,2733243,2733322,0,18103702
IMR90|chr16:20991844-20991865,chr16,20991844,20991865,IMR90|chr16:11835574-11835675,chr16,11835574,11835675,0,9156270
IMR90|chr16:21068210-21068286,chr16,21068210,21068286,IMR90|chr16:85205559-85205633,chr16,85205559,85205633,0,64137349
IMR90|chr16:21291251-21291361,chr16,21291251,21291361,IMR90|chr16:89770566-89770620,chr16,89770566,89770620,0,68479315
IMR90|chr16:21303130-21303167,chr16,21303130,21303167,IMR90|chr16:70283369-70283458,chr16,70283369,70283458,0,48980239
IMR90|chr16:21737179-21737237,chr16,21737179,21737237,IMR90|chr16:85207497-85207611,chr16,85207497,85207611,0,63470318
IMR90|chr16:21841419-21841457,chr16,21841419,21841457,IMR90|chr16:70283369-70283457,chr16,70283369,70283457,0,48441950
IMR90|chr16:21898535-21898616,chr16,21898535,21898616,IMR90|chr16:452022-452076,chr16,452022,452076,0,21446513
IMR90|chr16:22007244-22007331,chr16,22007244,22007331,IMR90|chr16:71848067-71848093,chr16,71848067,71848093,0,49840823
IMR90|chr16:22132183-22132204,chr16,22132183,22132204,IMR90|chr16:70718296-70718396,chr16,70718296,70718396,0,48586113
IMR90|chr16:22261806-22261891,chr16,22261806,22261891,IMR90|chr16:89989661-89989676,chr16,89989661,89989676,0,67727855
IMR90|chr16:22488242-22488315,chr16,22488242,22488315,IMR90|chr16:85206181-85206228,chr16,85206181,85206228,0,62717939
IMR90|chr16:22508233-22508379,chr16,22508233,22508379,IMR90|chr16:18937861-18937988,chr16,18937861,18937988,0,3570372
IMR90|chr16:22653638-22653707,chr16,22653638,22653707,IMR90|chr16:81072355-81072505,chr16,81072355,81072505,0,58418717
IMR90|chr16:22766255-22766318,chr16,22766255,22766318,IMR90|chr16:85205509-85205659,chr16,85205509,85205659,0,62439254
IMR90|chr16:22897947-22898051,chr16,22897947,22898051,IMR90|chr16:85206142-85206166,chr16,85206142,85206166,0,62308195
IMR90|chr16:23141702-23141833,chr16,23141702,23141833,IMR90|chr16:85207089-85207107,chr16,85207089,85207107,0,62065387
IMR90|chr16:23454901-23454921,chr16,23454901,23454921,IMR90|chr16:2587161-2587285,chr16,2587161,2587285,0,20867740
IMR90|chr16:23664669-23664779,chr16,23664669,23664779,IMR90|chr16:18937861-18937986,chr16,18937861,18937986,0,4726808
IMR90|chr16:23850573-23850599,chr16,23850573,23850599,IMR90|chr16:3353454-3353578,chr16,3353454,3353578,0,20497119
IMR90|chr16:23977270-23977327,chr16,23977270,23977327,IMR90|chr16:71495505-71495558,chr16,71495505,71495558,0,47518235
IMR90|chr16:24034382-24034444,chr16,24034382,24034444,IMR90|chr16:67279684-67279706,chr16,67279684,67279706,0,43245302
IMR90|chr16:24063765-24063837,chr16,24063765,24063837,IMR90|chr16:19724427-19724525,chr16,19724427,19724525,0,4339338
IMR90|chr16:24151990-24152026,chr16,24151990,24152026,IMR90|chr16:85207497-85207611,chr16,85207497,85207611,0,61055507
IMR90|chr16:24317532-24317611,chr16,24317532,24317611,IMR90|chr16:89990325-89990370,chr16,89990325,89990370,0,65672793
IMR90|chr16:24607278-24607349,chr16,24607278,24607349,IMR90|chr16:4327295-4327329,chr16,4327295,4327329,0,20279983
IMR90|chr16:24842433-24842511,chr16,24842433,24842511,IMR90|chr16:452022-452076,chr16,452022,452076,0,24390411
IMR90|chr16:24903402-24903471,chr16,24903402,24903471,IMR90|chr16:90039654-90039679,chr16,90039654,90039679,0,65136252
IMR90|chr16:24935723-24935833,chr16,24935723,24935833,IMR90|chr16:85207396-85207436,chr16,85207396,85207436,0,60271673
IMR90|chr16:24940491-24940521,chr16,24940491,24940521,IMR90|chr16:85204584-85204628,chr16,85204584,85204628,0,60264093
IMR90|chr16:25009582-25009609,chr16,25009582,25009609,IMR90|chr16:90035870-90035894,chr16,90035870,90035894,0,65026288
IMR90|chr16:25032168-25032202,chr16,25032168,25032202,IMR90|chr16:85641856-85641932,chr16,85641856,85641932,0,60609688
IMR90|chr16:25287440-25287506,chr16,25287440,25287506,IMR90|chr16:19723916-19723944,chr16,19723916,19723944,0,5563524
IMR90|chr16:25505098-25505246,chr16,25505098,25505246,IMR90|chr16:88214252-88214383,chr16,88214252,88214383,0,62709154
IMR90|chr16:25758940-25759023,chr16,25758940,25759023,IMR90|chr16:31467649-31467739,chr16,31467649,31467739,0,5708709
IMR90|chr16:25771422-25771503,chr16,25771422,25771503,IMR90|chr16:2732235-2732273,chr16,2732235,2732273,0,23039187
IMR90|chr16:25808099-25808181,chr16,25808099,25808181,IMR90|chr16:85205546-85205580,chr16,85205546,85205580,0,59397447
IMR90|chr16:26001313-26001358,chr16,26001313,26001358,IMR90|chr16:85208344-85208447,chr16,85208344,85208447,0,59207031
IMR90|chr16:26108749-26108802,chr16,26108749,26108802,IMR90|chr16:2183011-2183106,chr16,2183011,2183106,0,23925738
IMR90|chr16:26168368-26168395,chr16,26168368,26168395,IMR90|chr16:86609899-86610001,chr16,86609899,86610001,0,60441531
IMR90|chr16:26256808-26256877,chr16,26256808,26256877,IMR90|chr16:85207133-85207214,chr16,85207133,85207214,0,58950325
IMR90|chr16:26347526-26347558,chr16,26347526,26347558,IMR90|chr16:3106362-3106412,chr16,3106362,3106412,0,23241164
IMR90|chr16:26410127-26410271,chr16,26410127,26410271,IMR90|chr16:87899105-87899255,chr16,87899105,87899255,0,61488978
IMR90|chr16:26425358-26425462,chr16,26425358,26425462,IMR90|chr16:81347618-81347681,chr16,81347618,81347681,0,54922260
IMR90|chr16:26493794-26493843,chr16,26493794,26493843,IMR90|chr16:23461339-23461406,chr16,23461339,23461406,0,3032455
IMR90|chr16:26757129-26757168,chr16,26757129,26757168,IMR90|chr16:85208476-85208613,chr16,85208476,85208613,0,58451347
IMR90|chr16:26809513-26809607,chr16,26809513,26809607,IMR90|chr16:88217190-88217237,chr16,88217190,88217237,0,61407677
IMR90|chr16:26888810-26888858,chr16,26888810,26888858,IMR90|chr16:89993862-89993929,chr16,89993862,89993929,0,63105052
IMR90|chr16:27049959-27049986,chr16,27049959,27049986,IMR90|chr16:86609899-86610001,chr16,86609899,86610001,0,59559940
IMR90|chr16:27148850-27149000,chr16,27148850,27149000,IMR90|chr16:85203034-85203078,chr16,85203034,85203078,0,58054184
IMR90|chr16:27497734-27497845,chr16,27497734,27497845,IMR90|chr16:85203974-85204032,chr16,85203974,85204032,0,57706240
IMR90|chr16:27517298-27517392,chr16,27517298,27517392,IMR90|chr16:85202386-85202447,chr16,85202386,85202447,0,57685088
IMR90|chr16:27732092-27732199,chr16,27732092,27732199,IMR90|chr16:85208097-85208133,chr16,85208097,85208133,0,57476005
IMR90|chr16:28162114-28162141,chr16,28162114,28162141,IMR90|chr16:67972357-67972484,chr16,67972357,67972484,0,39810243
IMR90|chr16:28195464-28195499,chr16,28195464,28195499,IMR90|chr16:85206629-85206727,chr16,85206629,85206727,0,57011165
IMR90|chr16:28448947-28449030,chr16,28448947,28449030,IMR90|chr16:85205625-85205689,chr16,85205625,85205689,0,56756678
IMR90|chr16:28705637-28705738,chr16,28705637,28705738,IMR90|chr16:85207373-85207419,chr16,85207373,85207419,0,56501736
IMR90|chr16:28792999-28793032,chr16,28792999,28793032,IMR90|chr16:74732909-74732974,chr16,74732909,74732974,0,45939910
IMR90|chr16:28911916-28911943,chr16,28911916,28911943,IMR90|chr16:30087128-30087194,chr16,30087128,30087194,0,1175212
IMR90|chr16:29019284-29019382,chr16,29019284,29019382,IMR90|chr16:31467533-31467613,chr16,31467533,31467613,0,2448249
IMR90|chr16:29126925-29126951,chr16,29126925,29126951,IMR90|chr16:89573770-89573898,chr16,89573770,89573898,0,60446845
IMR90|chr16:29144707-29144746,chr16,29144707,29144746,IMR90|chr16:85204327-85204472,chr16,85204327,85204472,0,56059620
IMR90|chr16:29160898-29160939,chr16,29160898,29160939,IMR90|chr16:85204241-85204318,chr16,85204241,85204318,0,56043343
IMR90|chr16:29167983-29168035,chr16,29167983,29168035,IMR90|chr16:85644030-85644061,chr16,85644030,85644061,0,56476047
IMR90|chr16:29192065-29192110,chr16,29192065,29192110,IMR90|chr16:71845976-71846050,chr16,71845976,71846050,0,42653911
IMR90|chr16:29269617-29269755,chr16,29269617,29269755,IMR90|chr16:88214235-88214368,chr16,88214235,88214368,0,58944618
IMR90|chr16:29269975-29270047,chr16,29269975,29270047,IMR90|chr16:70716881-70716959,chr16,70716881,70716959,0,41446906
IMR90|chr16:29348717-29348750,chr16,29348717,29348750,IMR90|chr16:85199993-85200110,chr16,85199993,85200110,0,55851276
IMR90|chr16:29390686-29390774,chr16,29390686,29390774,IMR90|chr16:85205433-85205454,chr16,85205433,85205454,0,55814747
IMR90|chr16:30028835-30028866,chr16,30028835,30028866,IMR90|chr16:11835510-11835571,chr16,11835510,11835571,0,18193325
IMR90|chr16:30373242-30373392,chr16,30373242,30373392,IMR90|chr16:29606047-29606197,chr16,29606047,29606197,0,767195
IMR90|chr16:30396694-30396735,chr16,30396694,30396735,IMR90|chr16:4425220-4425278,chr16,4425220,4425278,0,25971474
IMR90|chr16:30441263-30441385,chr16,30441263,30441385,IMR90|chr16:89982191-89982253,chr16,89982191,89982253,0,59540928
IMR90|chr16:30535570-30535625,chr16,30535570,30535625,IMR90|chr16:85200183-85200278,chr16,85200183,85200278,0,54664613
IMR90|chr16:30762413-30762468,chr16,30762413,30762468,IMR90|chr16:22305868-22305961,chr16,22305868,22305961,0,8456545
IMR90|chr16:30922223-30922252,chr16,30922223,30922252,IMR90|chr16:85204125-85204223,chr16,85204125,85204223,0,54281902
IMR90|chr16:30999166-30999202,chr16,30999166,30999202,IMR90|chr16:85208446-85208495,chr16,85208446,85208495,0,54209280
IMR90|chr16:31167565-31167614,chr16,31167565,31167614,IMR90|chr16:85206934-85206989,chr16,85206934,85206989,0,54039369
IMR90|chr16:31179891-31180015,chr16,31179891,31180015,IMR90|chr16:4588477-4588500,chr16,4588477,4588500,0,26591414
IMR90|chr16:31182149-31182229,chr16,31182149,31182229,IMR90|chr16:4326249-4326399,chr16,4326249,4326399,0,26855900
IMR90|chr16:31187089-31187237,chr16,31187089,31187237,IMR90|chr16:18937922-18937988,chr16,18937922,18937988,0,12249167
IMR90|chr16:31489108-31489201,chr16,31489108,31489201,IMR90|chr16:4588477-4588500,chr16,4588477,4588500,0,26900631
IMR90|chr16:31636527-31636630,chr16,31636527,31636630,IMR90|chr16:85206142-85206166,chr16,85206142,85206166,0,53569615
IMR90|chr16:31660860-31660960,chr16,31660860,31660960,IMR90|chr16:85207133-85207214,chr16,85207133,85207214,0,53546273
IMR90|chr16:31939033-31939104,chr16,31939033,31939104,IMR90|chr16:56641686-56641765,chr16,56641686,56641765,0,24702653
IMR90|chr16:31954998-31955026,chr16,31954998,31955026,IMR90|chr16:67966888-67967010,chr16,67966888,67967010,0,36011890
IMR90|chr16:32431932-32431971,chr16,32431932,32431971,IMR90|chr16:31467519-31467601,chr16,31467519,31467601,0,964413
IMR90|chr16:32627977-32628057,chr16,32627977,32628057,IMR90|chr16:4326249-4326399,chr16,4326249,4326399,0,28301728
IMR90|chr16:32696141-32696179,chr16,32696141,32696179,IMR90|chr16:31467478-31467590,chr16,31467478,31467590,0,1228663
IMR90|chr16:32717327-32717372,chr16,32717327,32717372,IMR90|chr16:89161166-89161280,chr16,89161166,89161280,0,56443839
IMR90|chr16:32806944-32807031,chr16,32806944,32807031,IMR90|chr16:85205659-85205722,chr16,85205659,85205722,0,52398715
IMR90|chr16:33046120-33046210,chr16,33046120,33046210,IMR90|chr16:18937922-18937982,chr16,18937922,18937982,0,14108198
IMR90|chr16:33347552-33347665,chr16,33347552,33347665,IMR90|chr16:85642987-85643033,chr16,85642987,85643033,0,52295435
IMR90|chr16:33453610-33453748,chr16,33453610,33453748,IMR90|chr16:88214239-88214355,chr16,88214239,88214355,0,54760629
IMR90|chr16:33501111-33501147,chr16,33501111,33501147,IMR90|chr16:85207497-85207611,chr16,85207497,85207611,0,51706386
IMR90|chr16:33821567-33821674,chr16,33821567,33821674,IMR90|chr16:85206532-85206571,chr16,85206532,85206571,0,51384965
IMR90|chr16:34036355-34036382,chr16,34036355,34036382,IMR90|chr16:90035870-90035894,chr16,90035870,90035894,0,55999515
IMR90|chr16:34148439-34148472,chr16,34148439,34148472,IMR90|chr16:89996197-89996272,chr16,89996197,89996272,0,55847758
IMR90|chr16:34218941-34219090,chr16,34218941,34219090,IMR90|chr16:87899056-87899206,chr16,87899056,87899206,0,53680115
IMR90|chr16:34314081-34314170,chr16,34314081,34314170,IMR90|chr16:85202387-85202447,chr16,85202387,85202447,0,50888306
IMR90|chr16:34341604-34341644,chr16,34341604,34341644,IMR90|chr16:85208393-85208503,chr16,85208393,85208503,0,50866789
IMR90|chr16:34371014-34371074,chr16,34371014,34371074,IMR90|chr16:81072355-81072504,chr16,81072355,81072504,0,46701341
IMR90|chr16:34480571-34480661,chr16,34480571,34480661,IMR90|chr16:31103060-31103091,chr16,31103060,31103091,0,3377511
IMR90|chr16:34660051-34660087,chr16,34660051,34660087,IMR90|chr16:2181627-2181741,chr16,2181627,2181741,0,32478424
IMR90|chr16:34701710-34701792,chr16,34701710,34701792,IMR90|chr16:88214681-88214809,chr16,88214681,88214809,0,53512971
IMR90|chr16:35129727-35129852,chr16,35129727,35129852,IMR90|chr16:87899717-87899843,chr16,87899717,87899843,0,52769990
IMR90|chr16:35231086-35231193,chr16,35231086,35231193,IMR90|chr16:85208097-85208133,chr16,85208097,85208133,0,49977011
IMR90|chr16:35290739-35290766,chr16,35290739,35290766,IMR90|chr16:3661779-3661892,chr16,3661779,3661892,0,31628960
IMR90|chr16:35309932-35309954,chr16,35309932,35309954,IMR90|chr16:11835574-11835675,chr16,11835574,11835675,0,23474358
IMR90|chr16:35380091-35380117,chr16,35380091,35380117,IMR90|chr16:28885742-28885830,chr16,28885742,28885830,0,6494349
IMR90|chr16:35567147-35567225,chr16,35567147,35567225,IMR90|chr16:85204061-85204095,chr16,85204061,85204095,0,49636914
IMR90|chr16:35751892-35752013,chr16,35751892,35752013,IMR90|chr16:87899041-87899191,chr16,87899041,87899191,0,52147149
IMR90|chr16:36060172-36060300,chr16,36060172,36060300,IMR90|chr16:75284481-75284500,chr16,75284481,75284500,0,39224309
IMR90|chr16:36109103-36109189,chr16,36109103,36109189,IMR90|chr16:85207402-85207441,chr16,85207402,85207441,0,49098299
IMR90|chr16:36191990-36192140,chr16,36191990,36192140,IMR90|chr16:88214252-88214368,chr16,88214252,88214368,0,52022262
IMR90|chr16:36273297-36273406,chr16,36273297,36273406,IMR90|chr16:67279905-67279943,chr16,67279905,67279943,0,31006608
IMR90|chr16:36301962-36302110,chr16,36301962,36302110,IMR90|chr16:18937922-18937988,chr16,18937922,18937988,0,17364040
IMR90|chr16:36410598-36410717,chr16,36410598,36410717,IMR90|chr16:18937922-18937976,chr16,18937922,18937976,0,17472676
IMR90|chr16:36506223-36506310,chr16,36506223,36506310,IMR90|chr16:81347618-81347681,chr16,81347618,81347681,0,44841395
IMR90|chr16:36773210-36773287,chr16,36773210,36773287,IMR90|chr16:89990325-89990370,chr16,89990325,89990370,0,53217115
IMR90|chr16:37048426-37048465,chr16,37048426,37048465,IMR90|chr16:31467519-31467601,chr16,31467519,31467601,0,5580907
IMR90|chr16:37106760-37106801,chr16,37106760,37106801,IMR90|chr16:2182994-2183103,chr16,2182994,2183103,0,34923766
IMR90|chr16:37180113-37180165,chr16,37180113,37180165,IMR90|chr16:85204666-85204782,chr16,85204666,85204782,0,48024553
IMR90|chr16:37252061-37252211,chr16,37252061,37252211,IMR90|chr16:29605760-29605907,chr16,29605760,29605907,0,7646301
IMR90|chr16:37312370-37312520,chr16,37312370,37312520,IMR90|chr16:18937941-18938028,chr16,18937941,18938028,0,18374429
IMR90|chr16:37425212-37425362,chr16,37425212,37425362,IMR90|chr16:11835510-11835571,chr16,11835510,11835571,0,25589702
IMR90|chr16:37510456-37510527,chr16,37510456,37510527,IMR90|chr16:89996381-89996492,chr16,89996381,89996492,0,52485925
IMR90|chr16:37692713-37692819,chr16,37692713,37692819,IMR90|chr16:85208097-85208133,chr16,85208097,85208133,0,47515384
IMR90|chr16:37752182-37752280,chr16,37752182,37752280,IMR90|chr16:85208101-85208134,chr16,85208101,85208134,0,47455919
IMR90|chr16:38107260-38107310,chr16,38107260,38107310,IMR90|chr16:85204286-85204307,chr16,85204286,85204307,0,47097026
IMR90|chr16:38365176-38365216,chr16,38365176,38365216,IMR90|chr16:85208393-85208503,chr16,85208393,85208503,0,46843217
IMR90|chr16:38379395-38379457,chr16,38379395,38379457,IMR90|chr16:85642342-85642403,chr16,85642342,85642403,0,47262947
IMR90|chr16:38722349-38722416,chr16,38722349,38722416,IMR90|chr16:51189860-51189940,chr16,51189860,51189940,0,12467511
IMR90|chr16:38800631-38800683,chr16,38800631,38800683,IMR90|chr16:19724427-19724525,chr16,19724427,19724525,0,19076204
IMR90|chr16:39491897-39491988,chr16,39491897,39491988,IMR90|chr16:85640766-85640811,chr16,85640766,85640811,0,46148869
IMR90|chr16:39895172-39895234,chr16,39895172,39895234,IMR90|chr16:3662643-3662681,chr16,3662643,3662681,0,36232529
IMR90|chr16:39921963-39922013,chr16,39921963,39922013,IMR90|chr16:85204286-85204307,chr16,85204286,85204307,0,45282323
IMR90|chr16:40054092-40054184,chr16,40054092,40054184,IMR90|chr16:87899413-87899513,chr16,87899413,87899513,0,47845321
IMR90|chr16:40181562-40181589,chr16,40181562,40181589,IMR90|chr16:67966888-67967009,chr16,67966888,67967009,0,27785326
IMR90|chr16:40261671-40261775,chr16,40261671,40261775,IMR90|chr16:85206142-85206166,chr16,85206142,85206166,0,44944471
IMR90|chr16:40261678-40261753,chr16,40261678,40261753,IMR90|chr16:85208107-85208145,chr16,85208107,85208145,0,44946429
IMR90|chr16:40292140-40292195,chr16,40292140,40292195,IMR90|chr16:85204827-85204919,chr16,85204827,85204919,0,44912687
IMR90|chr16:41087344-41087425,chr16,41087344,41087425,IMR90|chr16:18937922-18937988,chr16,18937922,18937988,0,22149422
IMR90|chr16:41146768-41146868,chr16,41146768,41146868,IMR90|chr16:18937861-18937988,chr16,18937861,18937988,0,22208907
IMR90|chr16:41177342-41177379,chr16,41177342,41177379,IMR90|chr16:87899018-87899168,chr16,87899018,87899168,0,46721676
IMR90|chr16:41293413-41293560,chr16,41293413,41293560,IMR90|chr16:18937922-18937975,chr16,18937922,18937975,0,22355491
IMR90|chr16:41548611-41548682,chr16,41548611,41548682,IMR90|chr16:56641686-56641765,chr16,56641686,56641765,0,15093075
IMR90|chr16:41649438-41649458,chr16,41649438,41649458,IMR90|chr16:31467516-31467648,chr16,31467516,31467648,0,10181922
IMR90|chr16:41864983-41865017,chr16,41864983,41865017,IMR90|chr16:85642876-85642959,chr16,85642876,85642959,0,43777893
IMR90|chr16:42043732-42043763,chr16,42043732,42043763,IMR90|chr16:3353454-3353565,chr16,3353454,3353565,0,38690278
IMR90|chr16:42053742-42053804,chr16,42053742,42053804,IMR90|chr16:3662643-3662681,chr16,3662643,3662681,0,38391099
IMR90|chr16:42148437-42148584,chr16,42148437,42148584,IMR90|chr16:18937922-18937975,chr16,18937922,18937975,0,23210515
IMR90|chr16:42686461-42686558,chr16,42686461,42686558,IMR90|chr16:2182607-2182757,chr16,2182607,2182757,0,40503854
IMR90|chr16:42730497-42730517,chr16,42730497,42730517,IMR90|chr16:11835574-11835674,chr16,11835574,11835674,0,30894923
IMR90|chr16:42861540-42861562,chr16,42861540,42861562,IMR90|chr16:85204398-85204548,chr16,85204398,85204548,0,42342858
IMR90|chr16:43217096-43217192,chr16,43217096,43217192,IMR90|chr16:89770566-89770620,chr16,89770566,89770620,0,46553470
IMR90|chr16:43317449-43317534,chr16,43317449,43317534,IMR90|chr16:435301-435341,chr16,435301,435341,0,42882148
IMR90|chr16:43371578-43371610,chr16,43371578,43371610,IMR90|chr16:88215509-88215591,chr16,88215509,88215591,0,44843931
IMR90|chr16:43424147-43424297,chr16,43424147,43424297,IMR90|chr16:88217370-88217520,chr16,88217370,88217520,0,44793223
IMR90|chr16:43435197-43435236,chr16,43435197,43435236,IMR90|chr16:89570856-89570961,chr16,89570856,89570961,0,46135659
IMR90|chr16:43498428-43498575,chr16,43498428,43498575,IMR90|chr16:88214370-88214448,chr16,88214370,88214448,0,44715942
IMR90|chr16:43573677-43573711,chr16,43573677,43573711,IMR90|chr16:85207914-85208064,chr16,85207914,85208064,0,41634237
IMR90|chr16:43690496-43690617,chr16,43690496,43690617,IMR90|chr16:84855994-84856066,chr16,84855994,84856066,0,41165498
IMR90|chr16:43964932-43965005,chr16,43964932,43965005,IMR90|chr16:51189860-51189940,chr16,51189860,51189940,0,7224928
IMR90|chr16:43984320-43984346,chr16,43984320,43984346,IMR90|chr16:3353454-3353578,chr16,3353454,3353578,0,40630866
IMR90|chr16:44190733-44190766,chr16,44190733,44190766,IMR90|chr16:30084801-30084863,chr16,30084801,30084863,0,14105932
IMR90|chr16:44196575-44196634,chr16,44196575,44196634,IMR90|chr16:2587161-2587285,chr16,2587161,2587285,0,41609414
IMR90|chr16:44238299-44238338,chr16,44238299,44238338,IMR90|chr16:89570856-89570961,chr16,89570856,89570961,0,45332557
IMR90|chr16:44454320-44454401,chr16,44454320,44454401,IMR90|chr16:2732235-2732273,chr16,2732235,2732273,0,41722085
IMR90|chr16:44563936-44563961,chr16,44563936,44563961,IMR90|chr16:85203153-85203270,chr16,85203153,85203270,0,40639217
IMR90|chr16:44688692-44688813,chr16,44688692,44688813,IMR90|chr16:84855994-84856066,chr16,84855994,84856066,0,40167302
IMR90|chr16:44732995-44733091,chr16,44732995,44733091,IMR90|chr16:31467502-31467648,chr16,31467502,31467648,0,13265493
IMR90|chr16:45108678-45108762,chr16,45108678,45108762,IMR90|chr16:85208052-85208114,chr16,85208052,85208114,0,40099374
IMR90|chr16:45254277-45254336,chr16,45254277,45254336,IMR90|chr16:2587161-2587285,chr16,2587161,2587285,0,42667116
IMR90|chr16:45419609-45419659,chr16,45419609,45419659,IMR90|chr16:71841030-71841054,chr16,71841030,71841054,0,26421421
IMR90|chr16:45421403-45421503,chr16,45421403,45421503,IMR90|chr16:48281148-48281198,chr16,48281148,48281198,0,2859745
IMR90|chr16:45477982-45478132,chr16,45477982,45478132,IMR90|chr16:88214328-88214365,chr16,88214328,88214365,0,42736346
IMR90|chr16:45540602-45540690,chr16,45540602,45540690,IMR90|chr16:18937922-18937976,chr16,18937922,18937976,0,26602680
IMR90|chr16:45630407-45630479,chr16,45630407,45630479,IMR90|chr16:70716881-70716959,chr16,70716881,70716959,0,25086474
IMR90|chr16:45784927-45784950,chr16,45784927,45784950,IMR90|chr16:67972357-67972484,chr16,67972357,67972484,0,22187430
IMR90|chr16:45806395-45806453,chr16,45806395,45806453,IMR90|chr16:85203821-85203913,chr16,85203821,85203913,0,39397426
IMR90|chr16:45809753-45809822,chr16,45809753,45809822,IMR90|chr16:31458967-31459094,chr16,31458967,31459094,0,14350786
IMR90|chr16:45847231-45847381,chr16,45847231,45847381,IMR90|chr16:29606045-29606189,chr16,29606045,29606189,0,16241186
IMR90|chr16:45889181-45889302,chr16,45889181,45889302,IMR90|chr16:85207079-85207100,chr16,85207079,85207100,0,39317898
IMR90|chr16:45926348-45926373,chr16,45926348,45926373,IMR90|chr16:71844126-71844195,chr16,71844126,71844195,0,25917778
IMR90|chr16:45983346-45983395,chr16,45983346,45983395,IMR90|chr16:85206934-85206989,chr16,85206934,85206989,0,39223588
IMR90|chr16:46059180-46059263,chr16,46059180,46059263,IMR90|chr16:9188656-9188728,chr16,9188656,9188728,0,36870524
IMR90|chr16:46112632-46112671,chr16,46112632,46112671,IMR90|chr16:4425220-4425278,chr16,4425220,4425278,0,41687412
IMR90|chr16:46337907-46337981,chr16,46337907,46337981,IMR90|chr16:31466084-31466128,chr16,31466084,31466128,0,14871823
IMR90|chr16:46370730-46370870,chr16,46370730,46370870,IMR90|chr16:18937922-18937975,chr16,18937922,18937975,0,27432808
IMR90|chr16:46585909-46586002,chr16,46585909,46586002,IMR90|chr16:4588477-4588500,chr16,4588477,4588500,0,41997432
IMR90|chr16:46612896-46613033,chr16,46612896,46613033,IMR90|chr16:87899046-87899196,chr16,87899046,87899196,0,41286150
IMR90|chr16:46696652-46696738,chr16,46696652,46696738,IMR90|chr16:85643359-85643423,chr16,85643359,85643423,0,38946707
IMR90|chr16:47000501-47000602,chr16,47000501,47000602,IMR90|chr16:18937922-18937976,chr16,18937922,18937976,0,28062579
IMR90|chr16:47333927-47334002,chr16,47333927,47334002,IMR90|chr16:48281126-48281198,chr16,48281126,48281198,0,947199
IMR90|chr16:47488355-47488431,chr16,47488355,47488431,IMR90|chr16:88214679-88214726,chr16,88214679,88214726,0,40726324
IMR90|chr16:47961412-47961447,chr16,47961412,47961447,IMR90|chr16:85204059-85204110,chr16,85204059,85204110,0,37242647
IMR90|chr16:47963660-47963758,chr16,47963660,47963758,IMR90|chr16:31467533-31467613,chr16,31467533,31467613,0,16496127
IMR90|chr16:47987697-47987780,chr16,47987697,47987780,IMR90|chr16:9188656-9188728,chr16,9188656,9188728,0,38799041
IMR90|chr16:48276698-48276720,chr16,48276698,48276720,IMR90|chr16:85207358-85207478,chr16,85207358,85207478,0,36930660
IMR90|chr16:48447533-48447597,chr16,48447533,48447597,IMR90|chr16:19723916-19723944,chr16,19723916,19723944,0,28723617
IMR90|chr16:48477667-48477725,chr16,48477667,48477725,IMR90|chr16:85205852-85205886,chr16,85205852,85205886,0,36728185
IMR90|chr16:48516249-48516336,chr16,48516249,48516336,IMR90|chr16:85207044-85207076,chr16,85207044,85207076,0,36690795
IMR90|chr16:48576823-48576897,chr16,48576823,48576897,IMR90|chr16:85206181-85206228,chr16,85206181,85206228,0,36629358
IMR90|chr16:48618860-48618916,chr16,48618860,48618916,IMR90|chr16:71495505-71495558,chr16,71495505,71495558,0,22876645
IMR90|chr16:48721298-48721342,chr16,48721298,48721342,IMR90|chr16:88218613-88218710,chr16,88218613,88218710,0,39497315
IMR90|chr16:48774327-48774415,chr16,48774327,48774415,IMR90|chr16:31103058-31103091,chr16,31103058,31103091,0,17671269
IMR90|chr16:48821822-48821926,chr16,48821822,48821926,IMR90|chr16:22304505-22304533,chr16,22304505,22304533,0,26517317
IMR90|chr16:49186046-49186138,chr16,49186046,49186138,IMR90|chr16:85207364-85207419,chr16,85207364,85207419,0,36021318
IMR90|chr16:49237653-49237715,chr16,49237653,49237715,IMR90|chr16:85643719-85643765,chr16,85643719,85643765,0,36406066
IMR90|chr16:49273130-49273168,chr16,49273130,49273168,IMR90|chr16:19724858-19724880,chr16,19724858,19724880,0,29548272
IMR90|chr16:49285300-49285322,chr16,49285300,49285322,IMR90|chr16:85207358-85207478,chr16,85207358,85207478,0,35922058
IMR90|chr16:49296384-49296418,chr16,49296384,49296418,IMR90|chr16:85207102-85207210,chr16,85207102,85207210,0,35910718
IMR90|chr16:49331055-49331204,chr16,49331055,49331204,IMR90|chr16:88214696-88214765,chr16,88214696,88214765,0,38883641
IMR90|chr16:49411235-49411272,chr16,49411235,49411272,IMR90|chr16:85207741-85207779,chr16,85207741,85207779,0,35796506
IMR90|chr16:49689172-49689291,chr16,49689172,49689291,IMR90|chr16:85207364-85207419,chr16,85207364,85207419,0,35518192
IMR90|chr16:49758943-49758971,chr16,49758943,49758971,IMR90|chr16:67966888-67967010,chr16,67966888,67967010,0,18207945
IMR90|chr16:49881101-49881188,chr16,49881101,49881188,IMR90|chr16:85202387-85202447,chr16,85202387,85202447,0,35321286
IMR90|chr16:50135914-50136064,chr16,50135914,50136064,IMR90|chr16:2587161-2587285,chr16,2587161,2587285,0,47548753
IMR90|chr16:50466649-50466782,chr16,50466649,50466782,IMR90|chr16:85201575-85201638,chr16,85201575,85201638,0,34734926
IMR90|chr16:50863085-50863170,chr16,50863085,50863170,IMR90|chr16:89989661-89989676,chr16,89989661,89989676,0,39126576
IMR90|chr16:50942549-50942590,chr16,50942549,50942590,IMR90|chr16:85204241-85204318,chr16,85204241,85204318,0,34261692
IMR90|chr16:50949513-50949575,chr16,50949513,50949575,IMR90|chr16:85643719-85643765,chr16,85643719,85643765,0,34694206
IMR90|chr16:51045111-51045181,chr16,51045111,51045181,IMR90|chr16:31467533-31467613,chr16,31467533,31467613,0,19577578
IMR90|chr16:51342052-51342190,chr16,51342052,51342190,IMR90|chr16:88214235-88214368,chr16,88214235,88214368,0,36872183
IMR90|chr16:51826473-51826555,chr16,51826473,51826555,IMR90|chr16:18937922-18937976,chr16,18937922,18937976,0,32888551
IMR90|chr16:51901675-51901766,chr16,51901675,51901766,IMR90|chr16:87899046-87899196,chr16,87899046,87899196,0,35997371
IMR90|chr16:51955678-51955726,chr16,51955678,51955726,IMR90|chr16:89993862-89993929,chr16,89993862,89993929,0,38038184
IMR90|chr16:52201809-52201901,chr16,52201809,52201901,IMR90|chr16:87899413-87899513,chr16,87899413,87899513,0,35697604
IMR90|chr16:52266989-52267049,chr16,52266989,52267049,IMR90|chr16:31467649-31467739,chr16,31467649,31467739,0,20799340
IMR90|chr16:52350113-52350178,chr16,52350113,52350178,IMR90|chr16:85205585-85205670,chr16,85205585,85205670,0,32855472
IMR90|chr16:52446216-52446312,chr16,52446216,52446312,IMR90|chr16:85205931-85205983,chr16,85205931,85205983,0,32759715
IMR90|chr16:52469666-52469749,chr16,52469666,52469749,IMR90|chr16:31467649-31467739,chr16,31467649,31467739,0,21002017
IMR90|chr16:52509095-52509165,chr16,52509095,52509165,IMR90|chr16:4327295-4327329,chr16,4327295,4327329,0,48181800
IMR90|chr16:52789764-52789853,chr16,52789764,52789853,IMR90|chr16:85643979-85644040,chr16,85643979,85644040,0,32854215
IMR90|chr16:52834856-52834916,chr16,52834856,52834916,IMR90|chr16:71491562-71491636,chr16,71491562,71491636,0,18656706
IMR90|chr16:52885189-52885286,chr16,52885189,52885286,IMR90|chr16:85205931-85205983,chr16,85205931,85205983,0,32320742
IMR90|chr16:52897460-52897581,chr16,52897460,52897581,IMR90|chr16:87899041-87899191,chr16,87899041,87899191,0,35001581
IMR90|chr16:53293984-53294065,chr16,53293984,53294065,IMR90|chr16:452022-452076,chr16,452022,452076,0,52841962
IMR90|chr16:53465116-53465212,chr16,53465116,53465212,IMR90|chr16:87899041-87899115,chr16,87899041,87899115,0,34433925
IMR90|chr16:53678930-53679074,chr16,53678930,53679074,IMR90|chr16:88214262-88214365,chr16,88214262,88214365,0,34535332
IMR90|chr16:53696889-53696927,chr16,53696889,53696927,IMR90|chr16:85646148-85646240,chr16,85646148,85646240,0,31949259
IMR90|chr16:53886851-53886895,chr16,53886851,53886895,IMR90|chr16:88218613-88218710,chr16,88218613,88218710,0,34331762
IMR90|chr16:54096130-54096227,chr16,54096130,54096227,IMR90|chr16:18937922-18937976,chr16,18937922,18937976,0,35158208
IMR90|chr16:54257338-54257477,chr16,54257338,54257477,IMR90|chr16:88214182-88214332,chr16,88214182,88214332,0,33956844
IMR90|chr16:54283147-54283172,chr16,54283147,54283172,IMR90|chr16:71844126-71844195,chr16,71844126,71844195,0,17560979
IMR90|chr16:54484078-54484227,chr16,54484078,54484227,IMR90|chr16:2733243-2733322,chr16,2733243,2733322,0,51750835
IMR90|chr16:54576471-54576549,chr16,54576471,54576549,IMR90|chr16:84855994-84856066,chr16,84855994,84856066,0,30279523
IMR90|chr16:54695112-54695261,chr16,54695112,54695261,IMR90|chr16:87899056-87899206,chr16,87899056,87899206,0,33203944
IMR90|chr16:54703385-54703418,chr16,54703385,54703418,IMR90|chr16:74732909-74732974,chr16,74732909,74732974,0,20029524
IMR90|chr16:55042163-55042208,chr16,55042163,55042208,IMR90|chr16:85208344-85208447,chr16,85208344,85208447,0,30166181
IMR90|chr16:55072460-55072496,chr16,55072460,55072496,IMR90|chr16:85205923-85206073,chr16,85205923,85206073,0,30133463
IMR90|chr16:55144180-55144283,chr16,55144180,55144283,IMR90|chr16:85206142-85206166,chr16,85206142,85206166,0,30061962
IMR90|chr16:55428326-55428385,chr16,55428326,55428385,IMR90|chr16:85203566-85203585,chr16,85203566,85203585,0,29775240
IMR90|chr16:55439691-55439798,chr16,55439691,55439798,IMR90|chr16:90035870-90035894,chr16,90035870,90035894,0,34596179
IMR90|chr16:55449690-55449763,chr16,55449690,55449763,IMR90|chr16:19724858-19724880,chr16,19724858,19724880,0,35724832
IMR90|chr16:55721538-55721620,chr16,55721538,55721620,IMR90|chr16:88214681-88214809,chr16,88214681,88214809,0,32493143
IMR90|chr16:55751440-55751491,chr16,55751440,55751491,IMR90|chr16:71841030-71841054,chr16,71841030,71841054,0,16089590
IMR90|chr16:55756091-55756152,chr16,55756091,55756152,IMR90|chr16:87899042-87899192,chr16,87899042,87899192,0,32142951
IMR90|chr16:55776224-55776330,chr16,55776224,55776330,IMR90|chr16:85208097-85208133,chr16,85208097,85208133,0,29431873
IMR90|chr16:55998850-55998960,chr16,55998850,55998960,IMR90|chr16:18937861-18937986,chr16,18937861,18937986,0,37060989
IMR90|chr16:56009085-56009153,chr16,56009085,56009153,IMR90|chr16:19723916-19723944,chr16,19723916,19723944,0,36285169
IMR90|chr16:56695589-56695739,chr16,56695589,56695739,IMR90|chr16:88214328-88214365,chr16,88214328,88214365,0,31518739
IMR90|chr16:56721242-56721361,chr16,56721242,56721361,IMR90|chr16:89573507-89573529,chr16,89573507,89573529,0,32852265
IMR90|chr16:56730603-56730694,chr16,56730603,56730694,IMR90|chr16:85643359-85643423,chr16,85643359,85643423,0,28912756
IMR90|chr16:56839607-56839718,chr16,56839607,56839718,IMR90|chr16:67279905-67279943,chr16,67279905,67279943,0,10440298
IMR90|chr16:56969827-56969898,chr16,56969827,56969898,IMR90|chr16:85643969-85644040,chr16,85643969,85644040,0,28674142
IMR90|chr16:57280217-57280270,chr16,57280217,57280270,IMR90|chr16:85207358-85207478,chr16,85207358,85207478,0,27927141
IMR90|chr16:57494849-57494941,chr16,57494849,57494941,IMR90|chr16:85203974-85204032,chr16,85203974,85204032,0,27709125
IMR90|chr16:57519486-57519557,chr16,57519486,57519557,IMR90|chr16:4327295-4327329,chr16,4327295,4327329,0,53192191
IMR90|chr16:57578911-57578987,chr16,57578911,57578987,IMR90|chr16:15982334-15982405,chr16,15982334,15982405,0,41596577
IMR90|chr16:57816166-57816187,chr16,57816166,57816187,IMR90|chr16:70718296-70718396,chr16,70718296,70718396,0,12902130
IMR90|chr16:57967478-57967628,chr16,57967478,57967628,IMR90|chr16:85207364-85207419,chr16,85207364,85207419,0,27239886
IMR90|chr16:58015970-58016008,chr16,58015970,58016008,IMR90|chr16:85646148-85646240,chr16,85646148,85646240,0,27630178
IMR90|chr16:58042869-58042893,chr16,58042869,58042893,IMR90|chr16:85205825-85205890,chr16,85205825,85205890,0,27162956
IMR90|chr16:58043632-58043712,chr16,58043632,58043712,IMR90|chr16:88217513-88217560,chr16,88217513,88217560,0,30173881
IMR90|chr16:58373166-58373242,chr16,58373166,58373242,IMR90|chr16:15982334-15982405,chr16,15982334,15982405,0,42390832
IMR90|chr16:58691125-58691153,chr16,58691125,58691153,IMR90|chr16:67966888-67967010,chr16,67966888,67967010,0,9275763
IMR90|chr16:58758094-58758235,chr16,58758094,58758235,IMR90|chr16:88214258-88214383,chr16,88214258,88214383,0,29456164
IMR90|chr16:58939445-58939558,chr16,58939445,58939558,IMR90|chr16:67279684-67279706,chr16,67279684,67279706,0,8340239
IMR90|chr16:58973973-58974117,chr16,58973973,58974117,IMR90|chr16:88214262-88214365,chr16,88214262,88214365,0,29240289
IMR90|chr16:59044760-59044873,chr16,59044760,59044873,IMR90|chr16:67279684-67279706,chr16,67279684,67279706,0,8234924
IMR90|chr16:59070619-59070667,chr16,59070619,59070667,IMR90|chr16:4327280-4327342,chr16,4327280,4327342,0,54743339
IMR90|chr16:59106268-59106286,chr16,59106268,59106286,IMR90|chr16:31467516-31467648,chr16,31467516,31467648,0,27638752
IMR90|chr16:59175470-59175591,chr16,59175470,59175591,IMR90|chr16:85207079-85207100,chr16,85207079,85207100,0,26031609
IMR90|chr16:59318096-59318182,chr16,59318096,59318182,IMR90|chr16:85204848-85204897,chr16,85204848,85204897,0,25886752
IMR90|chr16:59435081-59435172,chr16,59435081,59435172,IMR90|chr16:85205940-85205977,chr16,85205940,85205977,0,25770859
IMR90|chr16:59526840-59526926,chr16,59526840,59526926,IMR90|chr16:15982353-15982410,chr16,15982353,15982410,0,43544487
IMR90|chr16:59530060-59530080,chr16,59530060,59530080,IMR90|chr16:11835574-11835674,chr16,11835574,11835674,0,47694486
IMR90|chr16:59698292-59698352,chr16,59698292,59698352,IMR90|chr16:3448299-3448337,chr16,3448299,3448337,0,56249993
IMR90|chr16:59935662-59935753,chr16,59935662,59935753,IMR90|chr16:85643359-85643423,chr16,85643359,85643423,0,25707697
IMR90|chr16:59947265-59947360,chr16,59947265,59947360,IMR90|chr16:4588477-4588500,chr16,4588477,4588500,0,55358788
IMR90|chr16:59979882-59979927,chr16,59979882,59979927,IMR90|chr16:71845976-71846050,chr16,71845976,71846050,0,11866094
IMR90|chr16:60552655-60552719,chr16,60552655,60552719,IMR90|chr16:85205836-85205896,chr16,85205836,85205896,0,24653181
IMR90|chr16:60572270-60572339,chr16,60572270,60572339,IMR90|chr16:85205836-85205896,chr16,85205836,85205896,0,24633566
IMR90|chr16:60650129-60650215,chr16,60650129,60650215,IMR90|chr16:85207402-85207441,chr16,85207402,85207441,0,24557273
IMR90|chr16:60861691-60861779,chr16,60861691,60861779,IMR90|chr16:85205433-85205454,chr16,85205433,85205454,0,24343742
IMR90|chr16:61028823-61028881,chr16,61028823,61028881,IMR90|chr16:85207497-85207611,chr16,85207497,85207611,0,24178674
IMR90|chr16:61343069-61343156,chr16,61343069,61343156,IMR90|chr16:85201575-85201638,chr16,85201575,85201638,0,23858506
IMR90|chr16:61359700-61359764,chr16,61359700,61359764,IMR90|chr16:89571965-89572076,chr16,89571965,89572076,0,28212265
IMR90|chr16:61509666-61509745,chr16,61509666,61509745,IMR90|chr16:89990325-89990370,chr16,89990325,89990370,0,28480659
IMR90|chr16:61623521-61623640,chr16,61623521,61623640,IMR90|chr16:87901411-87901530,chr16,87901411,87901530,0,26277890
IMR90|chr16:61810013-61810057,chr16,61810013,61810057,IMR90|chr16:75284461-75284500,chr16,75284461,75284500,0,13474448
IMR90|chr16:62065001-62065061,chr16,62065001,62065061,IMR90|chr16:31467649-31467739,chr16,31467649,31467739,0,30597352
IMR90|chr16:62117572-62117713,chr16,62117572,62117713,IMR90|chr16:88214258-88214383,chr16,88214258,88214383,0,26096686
IMR90|chr16:62167643-62167754,chr16,62167643,62167754,IMR90|chr16:31465456-31465563,chr16,31465456,31465563,0,30702187
IMR90|chr16:62211174-62211284,chr16,62211174,62211284,IMR90|chr16:85206532-85206571,chr16,85206532,85206571,0,22995358
IMR90|chr16:62300005-62300112,chr16,62300005,62300112,IMR90|chr16:85206532-85206571,chr16,85206532,85206571,0,22906527
IMR90|chr16:62310719-62310771,chr16,62310719,62310771,IMR90|chr16:85644030-85644061,chr16,85644030,85644061,0,23333311
IMR90|chr16:62384922-62385069,chr16,62384922,62385069,IMR90|chr16:88214203-88214353,chr16,88214203,88214353,0,25829281
IMR90|chr16:62516532-62516646,chr16,62516532,62516646,IMR90|chr16:70716881-70716959,chr16,70716881,70716959,0,8200349
IMR90|chr16:62566468-62566538,chr16,62566468,62566538,IMR90|chr16:4327295-4327329,chr16,4327295,4327329,0,58239173
IMR90|chr16:62739712-62739862,chr16,62739712,62739862,IMR90|chr16:2587161-2587285,chr16,2587161,2587285,0,60152551
IMR90|chr16:62765679-62765772,chr16,62765679,62765772,IMR90|chr16:18937922-18937975,chr16,18937922,18937975,0,43827757
IMR90|chr16:62850716-62850866,chr16,62850716,62850866,IMR90|chr16:11835510-11835571,chr16,11835510,11835571,0,51015206
IMR90|chr16:62940363-62940442,chr16,62940363,62940442,IMR90|chr16:85205559-85205633,chr16,85205559,85205633,0,22265196
IMR90|chr16:63209825-63209974,chr16,63209825,63209974,IMR90|chr16:88214696-88214765,chr16,88214696,88214765,0,25004871
IMR90|chr16:63441692-63441752,chr16,63441692,63441752,IMR90|chr16:3448299-3448337,chr16,3448299,3448337,0,59993393
IMR90|chr16:63499353-63499443,chr16,63499353,63499443,IMR90|chr16:85206400-85206531,chr16,85206400,85206531,0,21707047
IMR90|chr16:63869320-63869411,chr16,63869320,63869411,IMR90|chr16:85205940-85205977,chr16,85205940,85205977,0,21336620
IMR90|chr16:63909849-63909882,chr16,63909849,63909882,IMR90|chr16:85199993-85200110,chr16,85199993,85200110,0,21290144
IMR90|chr16:64003114-64003239,chr16,64003114,64003239,IMR90|chr16:87899717-87899843,chr16,87899717,87899843,0,23896603
IMR90|chr16:64019821-64019856,chr16,64019821,64019856,IMR90|chr16:2181627-2181741,chr16,2181627,2181741,0,61838194
IMR90|chr16:64123886-64123925,chr16,64123886,64123925,IMR90|chr16:4425220-4425278,chr16,4425220,4425278,0,59698666
IMR90|chr16:64250947-64250972,chr16,64250947,64250972,IMR90|chr16:89573507-89573529,chr16,89573507,89573529,0,25322560
IMR90|chr16:64262985-64263035,chr16,64262985,64263035,IMR90|chr16:71841030-71841054,chr16,71841030,71841054,0,7578045
IMR90|chr16:64324975-64325019,chr16,64324975,64325019,IMR90|chr16:75284461-75284500,chr16,75284461,75284500,0,10959486
IMR90|chr16:64663472-64663549,chr16,64663472,64663549,IMR90|chr16:9188656-9188728,chr16,9188656,9188728,0,55474816
IMR90|chr16:64664075-64664123,chr16,64664075,64664123,IMR90|chr16:71844371-71844461,chr16,71844371,71844461,0,7180296
IMR90|chr16:64743053-64743123,chr16,64743053,64743123,IMR90|chr16:31467533-31467613,chr16,31467533,31467613,0,33275520
IMR90|chr16:64761768-64761813,chr16,64761768,64761813,IMR90|chr16:85208393-85208503,chr16,85208393,85208503,0,20446625
IMR90|chr16:64895528-64895580,chr16,64895528,64895580,IMR90|chr16:19724427-19724525,chr16,19724427,19724525,0,45171101
IMR90|chr16:64972043-64972086,chr16,64972043,64972086,IMR90|chr16:88218613-88218710,chr16,88218613,88218710,0,23246570
IMR90|chr16:65056108-65056153,chr16,65056108,65056153,IMR90|chr16:85204822-85204913,chr16,85204822,85204913,0,20148714
IMR90|chr16:65066833-65066853,chr16,65066833,65066853,IMR90|chr16:88730237-88730269,chr16,88730237,88730269,0,23663404
IMR90|chr16:65171761-65171859,chr16,65171761,65171859,IMR90|chr16:85208101-85208134,chr16,85208101,85208134,0,20036340
IMR90|chr16:65198720-65198794,chr16,65198720,65198794,IMR90|chr16:4476331-4476388,chr16,4476331,4476388,0,60722389
IMR90|chr16:65484871-65484891,chr16,65484871,65484891,IMR90|chr16:31467516-31467648,chr16,31467516,31467648,0,34017355
IMR90|chr16:65522811-65522842,chr16,65522811,65522842,IMR90|chr16:3353454-3353565,chr16,3353454,3353565,0,62169357
IMR90|chr16:65555763-65555871,chr16,65555763,65555871,IMR90|chr16:85204118-85204160,chr16,85204118,85204160,0,19648355
IMR90|chr16:65685368-65685427,chr16,65685368,65685427,IMR90|chr16:85643007-85643046,chr16,85643007,85643046,0,19957639
IMR90|chr16:65872842-65872914,chr16,65872842,65872914,IMR90|chr16:19724427-19724525,chr16,19724427,19724525,0,46148415
IMR90|chr16:66149029-66149089,chr16,66149029,66149089,IMR90|chr16:71491562-71491636,chr16,71491562,71491636,0,5342533
IMR90|chr16:66243961-66244107,chr16,66243961,66244107,IMR90|chr16:29605760-29605905,chr16,29605760,29605905,0,36638201
IMR90|chr16:66322536-66322554,chr16,66322536,66322554,IMR90|chr16:85206143-85206166,chr16,85206143,85206166,0,18883607
IMR90|chr16:66455137-66455161,chr16,66455137,66455161,IMR90|chr16:11830584-11830631,chr16,11830584,11830631,0,54624553
IMR90|chr16:66636567-66636629,chr16,66636567,66636629,IMR90|chr16:67279684-67279706,chr16,67279684,67279706,0,643117
IMR90|chr16:66676365-66676433,chr16,66676365,66676433,IMR90|chr16:19723916-19723944,chr16,19723916,19723944,0,46952449
IMR90|chr16:66869418-66869469,chr16,66869418,66869469,IMR90|chr16:71841030-71841054,chr16,71841030,71841054,0,4971612
IMR90|chr16:67452260-67452344,chr16,67452260,67452344,IMR90|chr16:435301-435341,chr16,435301,435341,0,67016959
IMR90|chr16:67484078-67484167,chr16,67484078,67484167,IMR90|chr16:85202387-85202447,chr16,85202387,85202447,0,17718309
IMR90|chr16:67531102-67531226,chr16,67531102,67531226,IMR90|chr16:4588477-4588500,chr16,4588477,4588500,0,62942625
IMR90|chr16:67676068-67676159,chr16,67676068,67676159,IMR90|chr16:4588478-4588498,chr16,4588478,4588498,0,63087590
IMR90|chr16:67840581-67840625,chr16,67840581,67840625,IMR90|chr16:85204145-85204224,chr16,85204145,85204224,0,17363564
IMR90|chr16:67895204-67895224,chr16,67895204,67895224,IMR90|chr16:86540428-86540518,chr16,86540428,86540518,0,18645224
IMR90|chr16:68014164-68014186,chr16,68014164,68014186,IMR90|chr16:11835574-11835675,chr16,11835574,11835675,0,56178590
IMR90|chr16:68024232-68024301,chr16,68024232,68024301,IMR90|chr16:85205836-85205896,chr16,85205836,85205896,0,17181604
IMR90|chr16:68102652-68102684,chr16,68102652,68102684,IMR90|chr16:85642876-85642959,chr16,85642876,85642959,0,17540224
IMR90|chr16:68133893-68134024,chr16,68133893,68134024,IMR90|chr16:85204118-85204160,chr16,85204118,85204160,0,17070225
IMR90|chr16:68201079-68201107,chr16,68201079,68201107,IMR90|chr16:67966888-67967010,chr16,67966888,67967010,0,234191
IMR90|chr16:68348870-68348929,chr16,68348870,68348929,IMR90|chr16:85204651-85204691,chr16,85204651,85204691,0,16855781
IMR90|chr16:68422795-68422854,chr16,68422795,68422854,IMR90|chr16:85643007-85643046,chr16,85643007,85643046,0,17220212
IMR90|chr16:68455056-68455149,chr16,68455056,68455149,IMR90|chr16:85640567-85640614,chr16,85640567,85640614,0,17185511
IMR90|chr16:68459165-68459189,chr16,68459165,68459189,IMR90|chr16:11830584-11830631,chr16,11830584,11830631,0,56628581
IMR90|chr16:68464831-68464925,chr16,68464831,68464925,IMR90|chr16:88217190-88217237,chr16,88217190,88217237,0,19752359
IMR90|chr16:68495215-68495325,chr16,68495215,68495325,IMR90|chr16:85207396-85207436,chr16,85207396,85207436,0,16712181
IMR90|chr16:68501919-68501955,chr16,68501919,68501955,IMR90|chr16:2181627-2181741,chr16,2181627,2181741,0,66320292
IMR90|chr16:68548840-68548951,chr16,68548840,68548951,IMR90|chr16:31465456-31465563,chr16,31465456,31465563,0,37083384
IMR90|chr16:68596349-68596474,chr16,68596349,68596474,IMR90|chr16:85205659-85205722,chr16,85205659,85205722,0,16609310
IMR90|chr16:68710554-68710629,chr16,68710554,68710629,IMR90|chr16:2045315-2045376,chr16,2045315,2045376,0,66665239
IMR90|chr16:68729370-68729404,chr16,68729370,68729404,IMR90|chr16:85207914-85208064,chr16,85207914,85208064,0,16478544
IMR90|chr16:68755033-68755112,chr16,68755033,68755112,IMR90|chr16:85205559-85205633,chr16,85205559,85205633,0,16450526
IMR90|chr16:68921547-68921573,chr16,68921547,68921573,IMR90|chr16:71844126-71844195,chr16,71844126,71844195,0,2922579
IMR90|chr16:69064511-69064576,chr16,69064511,69064576,IMR90|chr16:85205585-85205670,chr16,85205585,85205670,0,16141074
IMR90|chr16:69066457-69066550,chr16,69066457,69066550,IMR90|chr16:71846697-71846742,chr16,71846697,71846742,0,2780240
IMR90|chr16:69289189-69289333,chr16,69289189,69289333,IMR90|chr16:87899105-87899255,chr16,87899105,87899255,0,18609916
IMR90|chr16:69480980-69481029,chr16,69480980,69481029,IMR90|chr16:85208443-85208519,chr16,85208443,85208519,0,15727463
IMR90|chr16:69547331-69547351,chr16,69547331,69547351,IMR90|chr16:2587161-2587285,chr16,2587161,2587285,0,66960170
IMR90|chr16:69610480-69610524,chr16,69610480,69610524,IMR90|chr16:31467511-31467578,chr16,31467511,31467578,0,38142969
IMR90|chr16:69775786-69775862,chr16,69775786,69775862,IMR90|chr16:88214679-88214726,chr16,88214679,88214726,0,18438893
IMR90|chr16:69810142-69810220,chr16,69810142,69810220,IMR90|chr16:9188656-9188728,chr16,9188656,9188728,0,60621486
IMR90|chr16:69848309-69848350,chr16,69848309,69848350,IMR90|chr16:85206400-85206458,chr16,85206400,85206458,0,15358091
IMR90|chr16:69886232-69886263,chr16,69886232,69886263,IMR90|chr16:11835510-11835571,chr16,11835510,11835571,0,58050722
IMR90|chr16:69896397-69896491,chr16,69896397,69896491,IMR90|chr16:71846697-71846742,chr16,71846697,71846742,0,1950300
IMR90|chr16:70061575-70061624,chr16,70061575,70061624,IMR90|chr16:85644174-85644275,chr16,85644174,85644275,0,15582599
IMR90|chr16:70141289-70141323,chr16,70141289,70141323,IMR90|chr16:3661779-3661892,chr16,3661779,3661892,0,66479510
IMR90|chr16:70324102-70324142,chr16,70324102,70324142,IMR90|chr16:85206400-85206458,chr16,85206400,85206458,0,14882298
IMR90|chr16:70431827-70431914,chr16,70431827,70431914,IMR90|chr16:89982191-89982253,chr16,89982191,89982253,0,19550364
IMR90|chr16:70799125-70799221,chr16,70799125,70799221,IMR90|chr16:87899041-87899115,chr16,87899041,87899115,0,17099916
IMR90|chr16:70818233-70818360,chr16,70818233,70818360,IMR90|chr16:85207396-85207436,chr16,85207396,85207436,0,14389163
IMR90|chr16:71010550-71010586,chr16,71010550,71010586,IMR90|chr16:85204584-85204628,chr16,85204584,85204628,0,14194034
IMR90|chr16:71119064-71119185,chr16,71119064,71119185,IMR90|chr16:88214254-88214383,chr16,88214254,88214383,0,17095190
IMR90|chr16:71303883-71303962,chr16,71303883,71303962,IMR90|chr16:18937922-18937993,chr16,18937922,18937993,0,52365961
IMR90|chr16:71330055-71330087,chr16,71330055,71330087,IMR90|chr16:3106362-3106412,chr16,3106362,3106412,0,68223693
IMR90|chr16:71361086-71361118,chr16,71361086,71361118,IMR90|chr16:85642876-85642959,chr16,85642876,85642959,0,14281790
IMR90|chr16:71538047-71538067,chr16,71538047,71538067,IMR90|chr16:70718296-70718396,chr16,70718296,70718396,0,819751
IMR90|chr16:71618280-71618370,chr16,71618280,71618370,IMR90|chr16:85206400-85206531,chr16,85206400,85206531,0,13588120
IMR90|chr16:71646422-71646494,chr16,71646422,71646494,IMR90|chr16:87900167-87900223,chr16,87900167,87900223,0,16253745
IMR90|chr16:71722175-71722254,chr16,71722175,71722254,IMR90|chr16:31466292-31466316,chr16,31466292,31466316,0,40255883
IMR90|chr16:71828767-71828801,chr16,71828767,71828801,IMR90|chr16:3661779-3661892,chr16,3661779,3661892,0,68166988
IMR90|chr16:71941827-71941921,chr16,71941827,71941921,IMR90|chr16:71846697-71846742,chr16,71846697,71846742,0,95130
IMR90|chr16:72147239-72147308,chr16,72147239,72147308,IMR90|chr16:90039654-90039679,chr16,90039654,90039679,0,17892415
IMR90|chr16:72148038-72148067,chr16,72148038,72148067,IMR90|chr16:85204125-85204223,chr16,85204125,85204223,0,13056087
IMR90|chr16:72264924-72264950,chr16,72264924,72264950,IMR90|chr16:28885742-28885830,chr16,28885742,28885830,0,43379182
IMR90|chr16:72448864-72448895,chr16,72448864,72448895,IMR90|chr16:85203153-85203270,chr16,85203153,85203270,0,12754289
IMR90|chr16:72466311-72466392,chr16,72466311,72466392,IMR90|chr16:18937922-18937988,chr16,18937922,18937988,0,53528389
IMR90|chr16:72714720-72714810,chr16,72714720,72714810,IMR90|chr16:18937922-18937982,chr16,18937922,18937982,0,53776798
IMR90|chr16:72723276-72723386,chr16,72723276,72723386,IMR90|chr16:85206532-85206571,chr16,85206532,85206571,0,12483256
IMR90|chr16:72820121-72820146,chr16,72820121,72820146,IMR90|chr16:89573507-89573529,chr16,89573507,89573529,0,16753386
IMR90|chr16:72880763-72880891,chr16,72880763,72880891,IMR90|chr16:75284481-75284500,chr16,75284481,75284500,0,2403718
IMR90|chr16:73146215-73146250,chr16,73146215,73146250,IMR90|chr16:85204059-85204110,chr16,85204059,85204110,0,12057844
IMR90|chr16:73490762-73490884,chr16,73490762,73490884,IMR90|chr16:89982191-89982253,chr16,89982191,89982253,0,16491429
IMR90|chr16:73522270-73522306,chr16,73522270,73522306,IMR90|chr16:89161166-89161280,chr16,89161166,89161280,0,15638896
IMR90|chr16:73570137-73570165,chr16,73570137,73570165,IMR90|chr16:85204125-85204223,chr16,85204125,85204223,0,11633988
IMR90|chr16:73670536-73670577,chr16,73670536,73670577,IMR90|chr16:2182994-2183103,chr16,2182994,2183103,0,71487542
IMR90|chr16:73705694-73705803,chr16,73705694,73705803,IMR90|chr16:67279905-67279943,chr16,67279905,67279943,0,6425789
IMR90|chr16:73829248-73829300,chr16,73829248,73829300,IMR90|chr16:2183073-2183119,chr16,2183073,2183119,0,71646175
IMR90|chr16:73856258-73856294,chr16,73856258,73856294,IMR90|chr16:85204584-85204628,chr16,85204584,85204628,0,11348326
IMR90|chr16:73916411-73916518,chr16,73916411,73916518,IMR90|chr16:31467504-31467630,chr16,31467504,31467630,0,42448907
IMR90|chr16:74205119-74205198,chr16,74205119,74205198,IMR90|chr16:31466292-31466316,chr16,31466292,31466316,0,42738827
IMR90|chr16:74248106-74248125,chr16,74248106,74248125,IMR90|chr16:85208359-85208502,chr16,85208359,85208502,0,10960253
IMR90|chr16:74250611-74250678,chr16,74250611,74250678,IMR90|chr16:67279684-67279706,chr16,67279684,67279706,0,6970927
IMR90|chr16:74303796-74303842,chr16,74303796,74303842,IMR90|chr16:85208344-85208447,chr16,85208344,85208447,0,10904548
IMR90|chr16:74360035-74360061,chr16,74360035,74360061,IMR90|chr16:89573770-89573898,chr16,89573770,89573898,0,15213735
IMR90|chr16:74605425-74605509,chr16,74605425,74605509,IMR90|chr16:435301-435341,chr16,435301,435341,0,74170124
IMR90|chr16:74621480-74621599,chr16,74621480,74621599,IMR90|chr16:87901411-87901530,chr16,87901411,87901530,0,13279931
IMR90|chr16:74629976-74630089,chr16,74629976,74630089,IMR90|chr16:85203313-85203350,chr16,85203313,85203350,0,10573337
IMR90|chr16:74887861-74888010,chr16,74887861,74888010,IMR90|chr16:87899056-87899206,chr16,87899056,87899206,0,13011195
IMR90|chr16:74923001-74923028,chr16,74923001,74923028,IMR90|chr16:3106362-3106412,chr16,3106362,3106412,0,71816639
IMR90|chr16:75224637-75224708,chr16,75224637,75224708,IMR90|chr16:85643969-85644040,chr16,85643969,85644040,0,10419332
IMR90|chr16:75291547-75291623,chr16,75291547,75291623,IMR90|chr16:85205559-85205633,chr16,85205559,85205633,0,9914012
IMR90|chr16:75312228-75312292,chr16,75312228,75312292,IMR90|chr16:89571965-89572076,chr16,89571965,89572076,0,14259737
IMR90|chr16:75669331-75669450,chr16,75669331,75669450,IMR90|chr16:18937922-18937976,chr16,18937922,18937976,0,56731409
IMR90|chr16:75799633-75799666,chr16,75799633,75799666,IMR90|chr16:30084801-30084863,chr16,30084801,30084863,0,45714832
IMR90|chr16:75895024-75895064,chr16,75895024,75895064,IMR90|chr16:85206400-85206458,chr16,85206400,85206458,0,9311376
IMR90|chr16:76089421-76089444,chr16,76089421,76089444,IMR90|chr16:31458967-31459094,chr16,31458967,31459094,0,44630454
IMR90|chr16:76163702-76163815,chr16,76163702,76163815,IMR90|chr16:85642987-85643033,chr16,85642987,85643033,0,9479285
IMR90|chr16:76164507-76164527,chr16,76164507,76164527,IMR90|chr16:86540428-86540518,chr16,86540428,86540518,0,10375921
IMR90|chr16:76168199-76168349,chr16,76168199,76168349,IMR90|chr16:85203034-85203078,chr16,85203034,85203078,0,9034835
IMR90|chr16:76216517-76216605,chr16,76216517,76216605,IMR90|chr16:89982191-89982253,chr16,89982191,89982253,0,13765674
IMR90|chr16:76356054-76356153,chr16,76356054,76356153,IMR90|chr16:22304402-22304453,chr16,22304402,22304453,0,54051652
IMR90|chr16:76358068-76358148,chr16,76358068,76358148,IMR90|chr16:88217513-88217560,chr16,88217513,88217560,0,11859445
IMR90|chr16:76384251-76384290,chr16,76384251,76384290,IMR90|chr16:85204327-85204472,chr16,85204327,85204472,0,8820076
IMR90|chr16:76724350-76724480,chr16,76724350,76724480,IMR90|chr16:48281148-48281198,chr16,48281148,48281198,0,28443202
IMR90|chr16:76779342-76779435,chr16,76779342,76779435,IMR90|chr16:85205940-85205977,chr16,85205940,85205977,0,8426598
IMR90|chr16:76970081-76970161,chr16,76970081,76970161,IMR90|chr16:85207089-85207124,chr16,85207089,85207124,0,8237008
IMR90|chr16:77304400-77304478,chr16,77304400,77304478,IMR90|chr16:85204061-85204095,chr16,85204061,85204095,0,7899661
IMR90|chr16:77553054-77553204,chr16,77553054,77553204,IMR90|chr16:18937912-18938061,chr16,18937912,18938061,0,58615142
IMR90|chr16:77681868-77681911,chr16,77681868,77681911,IMR90|chr16:88218613-88218710,chr16,88218613,88218710,0,10536745
IMR90|chr16:77906935-77906996,chr16,77906935,77906996,IMR90|chr16:85203646-85203709,chr16,85203646,85203709,0,7296711
IMR90|chr16:77934566-77934603,chr16,77934566,77934603,IMR90|chr16:31466895-31466971,chr16,31466895,31466971,0,46467671
IMR90|chr16:78019228-78019324,chr16,78019228,78019324,IMR90|chr16:18937922-18937976,chr16,18937922,18937976,0,59081306
IMR90|chr16:78159799-78159840,chr16,78159799,78159840,IMR90|chr16:4425220-4425278,chr16,4425220,4425278,0,73734579
IMR90|chr16:78287139-78287170,chr16,78287139,78287170,IMR90|chr16:85203153-85203270,chr16,85203153,85203270,0,6916014
IMR90|chr16:78313888-78313983,chr16,78313888,78313983,IMR90|chr16:74640159-74640205,chr16,74640159,74640205,0,3673729
IMR90|chr16:78344577-78344664,chr16,78344577,78344664,IMR90|chr16:89982191-89982253,chr16,89982191,89982253,0,11637614
IMR90|chr16:78345844-78345874,chr16,78345844,78345874,IMR90|chr16:31467574-31467649,chr16,31467574,31467649,0,46878270
IMR90|chr16:78358280-78358367,chr16,78358280,78358367,IMR90|chr16:71848067-71848093,chr16,71848067,71848093,0,6510213
IMR90|chr16:78413443-78413538,chr16,78413443,78413538,IMR90|chr16:74640159-74640205,chr16,74640159,74640205,0,3773284
IMR90|chr16:78424788-78424938,chr16,78424788,78424938,IMR90|chr16:87899046-87899196,chr16,87899046,87899196,0,9474258
IMR90|chr16:78457282-78457378,chr16,78457282,78457378,IMR90|chr16:89770566-89770620,chr16,89770566,89770620,0,11313284
IMR90|chr16:78467523-78467670,chr16,78467523,78467670,IMR90|chr16:88214203-88214353,chr16,88214203,88214353,0,9746680
IMR90|chr16:78528100-78528190,chr16,78528100,78528190,IMR90|chr16:31103060-31103091,chr16,31103060,31103091,0,47425040
IMR90|chr16:78569216-78569254,chr16,78569216,78569254,IMR90|chr16:69366412-69366479,chr16,69366412,69366479,0,9202804
IMR90|chr16:78968728-78968852,chr16,78968728,78968852,IMR90|chr16:22304402-22304453,chr16,22304402,22304453,0,56664326
IMR90|chr16:79000053-79000130,chr16,79000053,79000130,IMR90|chr16:89990325-89990370,chr16,89990325,89990370,0,10990272
IMR90|chr16:79496495-79496595,chr16,79496495,79496595,IMR90|chr16:85207133-85207214,chr16,85207133,85207214,0,5710638
IMR90|chr16:79563629-79563674,chr16,79563629,79563674,IMR90|chr16:30084801-30084863,chr16,30084801,30084863,0,49478828
IMR90|chr16:79597504-79597593,chr16,79597504,79597593,IMR90|chr16:85202386-85202447,chr16,85202386,85202447,0,5604882
IMR90|chr16:79838265-79838299,chr16,79838265,79838299,IMR90|chr16:2045882-2045932,chr16,2045882,2045932,0,77792383
IMR90|chr16:79855478-79855501,chr16,79855478,79855501,IMR90|chr16:75289174-75289272,chr16,75289174,75289272,0,4566304
IMR90|chr16:79894372-79894460,chr16,79894372,79894460,IMR90|chr16:89982191-89982253,chr16,89982191,89982253,0,10087819
IMR90|chr16:79933855-79933956,chr16,79933855,79933956,IMR90|chr16:85207373-85207419,chr16,85207373,85207419,0,5273518
IMR90|chr16:79986698-79986802,chr16,79986698,79986802,IMR90|chr16:85642987-85643033,chr16,85642987,85643033,0,5656289
IMR90|chr16:80024954-80025054,chr16,80024954,80025054,IMR90|chr16:48281148-48281198,chr16,48281148,48281198,0,31743806
IMR90|chr16:80174251-80174333,chr16,80174251,80174333,IMR90|chr16:18937922-18937976,chr16,18937922,18937976,0,61236329
IMR90|chr16:80222703-80222811,chr16,80222703,80222811,IMR90|chr16:85204118-85204160,chr16,85204118,85204160,0,4981415
IMR90|chr16:80235529-80235605,chr16,80235529,80235605,IMR90|chr16:2045317-2045391,chr16,2045317,2045391,0,78190212
IMR90|chr16:80483647-80483742,chr16,80483647,80483742,IMR90|chr16:4588477-4588500,chr16,4588477,4588500,0,75895170
IMR90|chr16:80517977-80518062,chr16,80517977,80518062,IMR90|chr16:435301-435341,chr16,435301,435341,0,80082676
IMR90|chr16:80624887-80624973,chr16,80624887,80624973,IMR90|chr16:15982353-15982410,chr16,15982353,15982410,0,64642534
IMR90|chr16:80634784-80634832,chr16,80634784,80634832,IMR90|chr16:85642301-85642403,chr16,85642301,85642403,0,5007517
IMR90|chr16:80860958-80861083,chr16,80860958,80861083,IMR90|chr16:85205659-85205722,chr16,85205659,85205722,0,4344701
IMR90|chr16:81069357-81069430,chr16,81069357,81069430,IMR90|chr16:51189860-51189940,chr16,51189860,51189940,0,29879497
IMR90|chr16:81205160-81205184,chr16,81205160,81205184,IMR90|chr16:85205825-85205890,chr16,85205825,85205890,0,4000665
IMR90|chr16:81261189-81261289,chr16,81261189,81261289,IMR90|chr16:29605840-29605990,chr16,29605840,29605990,0,51655349
IMR90|chr16:81343035-81343139,chr16,81343035,81343139,IMR90|chr16:85642987-85643033,chr16,85642987,85643033,0,4299952
IMR90|chr16:81484385-81484430,chr16,81484385,81484430,IMR90|chr16:89161166-89161280,chr16,89161166,89161280,0,7676781
IMR90|chr16:81503948-81504098,chr16,81503948,81504098,IMR90|chr16:88214252-88214368,chr16,88214252,88214368,0,6710304
IMR90|chr16:81803450-81803518,chr16,81803450,81803518,IMR90|chr16:2733243-2733322,chr16,2733243,2733322,0,79070207
IMR90|chr16:81958100-81958187,chr16,81958100,81958187,IMR90|chr16:81347618-81347681,chr16,81347618,81347681,0,610482
IMR90|chr16:81962073-81962128,chr16,81962073,81962128,IMR90|chr16:22305868-22305961,chr16,22305868,22305961,0,59656205
IMR90|chr16:82029896-82029942,chr16,82029896,82029942,IMR90|chr16:85208344-85208447,chr16,85208344,85208447,0,3178448
IMR90|chr16:82092449-82092478,chr16,82092449,82092478,IMR90|chr16:85205478-85205574,chr16,85205478,85205574,0,3113029
IMR90|chr16:82095495-82095557,chr16,82095495,82095557,IMR90|chr16:3106362-3106412,chr16,3106362,3106412,0,78989133
IMR90|chr16:82175296-82175382,chr16,82175296,82175382,IMR90|chr16:85643359-85643423,chr16,85643359,85643423,0,3468063
IMR90|chr16:82549588-82549649,chr16,82549588,82549649,IMR90|chr16:87900081-87900204,chr16,87900081,87900204,0,5350493
IMR90|chr16:82604441-82604552,chr16,82604441,82604552,IMR90|chr16:67279684-67279706,chr16,67279684,67279706,0,15324757
IMR90|chr16:82618082-82618232,chr16,82618082,82618232,IMR90|chr16:88217370-88217520,chr16,88217370,88217520,0,5599288
IMR90|chr16:82629299-82629333,chr16,82629299,82629333,IMR90|chr16:85207102-85207210,chr16,85207102,85207210,0,2577803
IMR90|chr16:82647713-82647797,chr16,82647713,82647797,IMR90|chr16:85208052-85208114,chr16,85208052,85208114,0,2560339
IMR90|chr16:83208855-83208949,chr16,83208855,83208949,IMR90|chr16:85202386-85202447,chr16,85202386,85202447,0,1993531
IMR90|chr16:83224496-83224627,chr16,83224496,83224627,IMR90|chr16:85204118-85204160,chr16,85204118,85204160,0,1979622
IMR90|chr16:83315681-83315821,chr16,83315681,83315821,IMR90|chr16:18937922-18937975,chr16,18937922,18937975,0,64377759
IMR90|chr16:83350313-83350371,chr16,83350313,83350371,IMR90|chr16:85203821-85203913,chr16,85203821,85203913,0,1853508
IMR90|chr16:83404094-83404183,chr16,83404094,83404183,IMR90|chr16:85202386-85202447,chr16,85202386,85202447,0,1798292
IMR90|chr16:83584687-83584739,chr16,83584687,83584739,IMR90|chr16:85204666-85204782,chr16,85204666,85204782,0,1619979
IMR90|chr16:83647531-83647564,chr16,83647531,83647564,IMR90|chr16:89996197-89996272,chr16,89996197,89996272,0,6348666
IMR90|chr16:83865437-83865474,chr16,83865437,83865474,IMR90|chr16:87899018-87899168,chr16,87899018,87899168,0,4033581
IMR90|chr16:84070712-84070751,chr16,84070712,84070751,IMR90|chr16:85208476-85208613,chr16,85208476,85208613,0,1137764
IMR90|chr16:84078890-84078983,chr16,84078890,84078983,IMR90|chr16:18937922-18937975,chr16,18937922,18937975,0,65140968
IMR90|chr16:84105006-84105064,chr16,84105006,84105064,IMR90|chr16:85203821-85203913,chr16,85203821,85203913,0,1098815
IMR90|chr16:84123203-84123228,chr16,84123203,84123228,IMR90|chr16:85203153-85203270,chr16,85203153,85203270,0,1079950
IMR90|chr16:84242677-84242764,chr16,84242677,84242764,IMR90|chr16:85205659-85205722,chr16,85205659,85205722,0,962982
IMR90|chr16:84247901-84247990,chr16,84247901,84247990,IMR90|chr16:85643979-85644040,chr16,85643979,85644040,0,1396078
IMR90|chr16:84330529-84330574,chr16,84330529,84330574,IMR90|chr16:85208393-85208503,chr16,85208393,85208503,0,877864
IMR90|chr16:84472294-84472371,chr16,84472294,84472371,IMR90|chr16:9188656-9188728,chr16,9188656,9188728,0,75283638
IMR90|chr16:84898505-84898531,chr16,84898505,84898531,IMR90|chr16:31466930-31466996,chr16,31466930,31466996,0,53431575
IMR90|chr16:84920258-84920341,chr16,84920258,84920341,IMR90|chr16:85205625-85205689,chr16,85205625,85205689,0,285367
IMR90|chr16:84920823-84920924,chr16,84920823,84920924,IMR90|chr16:18937922-18937976,chr16,18937922,18937976,0,65982901
IMR90|chr16:85240629-85240761,chr16,85240629,85240761,IMR90|chr16:85207089-85207107,chr16,85207089,85207107,0,33540
IMR90|chr16:85588394-85588468,chr16,85588394,85588468,IMR90|chr16:89993277-89993300,chr16,89993277,89993300,0,4404883
IMR90|chr16:85622305-85622432,chr16,85622305,85622432,IMR90|chr16:85207396-85207436,chr16,85207396,85207436,0,414909
IMR90|chr16:85667730-85667760,chr16,85667730,85667760,IMR90|chr16:31467574-31467649,chr16,31467574,31467649,0,54200156
IMR90|chr16:85801750-85801854,chr16,85801750,85801854,IMR90|chr16:22304505-22304533,chr16,22304505,22304533,0,63497245
IMR90|chr16:85811674-85811694,chr16,85811674,85811694,IMR90|chr16:85641479-85641571,chr16,85641479,85641571,0,170195
IMR90|chr16:86178131-86178191,chr16,86178131,86178191,IMR90|chr16:81072355-81072504,chr16,81072355,81072504,0,5105776
IMR90|chr16:86227825-86227890,chr16,86227825,86227890,IMR90|chr16:85203021-85203106,chr16,85203021,85203106,0,1024804
IMR90|chr16:86398486-86398547,chr16,86398486,86398547,IMR90|chr16:85203646-85203709,chr16,85203646,85203709,0,1194840
IMR90|chr16:86450317-86450354,chr16,86450317,86450354,IMR90|chr16:85207741-85207779,chr16,85207741,85207779,0,1242576
IMR90|chr16:86708189-86708247,chr16,86708189,86708247,IMR90|chr16:85203821-85203913,chr16,85203821,85203913,0,1504368
IMR90|chr16:87030136-87030229,chr16,87030136,87030229,IMR90|chr16:85205940-85205977,chr16,85205940,85205977,0,1824196
IMR90|chr16:87252213-87252346,chr16,87252213,87252346,IMR90|chr16:85201575-85201638,chr16,85201575,85201638,0,2050638
IMR90|chr16:87369327-87369402,chr16,87369327,87369402,IMR90|chr16:2045315-2045376,chr16,2045315,2045376,0,85324012
IMR90|chr16:87445194-87445255,chr16,87445194,87445255,IMR90|chr16:87899042-87899192,chr16,87899042,87899192,0,453848
IMR90|chr16:87733244-87733266,chr16,87733244,87733266,IMR90|chr16:75289174-75289272,chr16,75289174,75289272,0,12444070
IMR90|chr16:87776622-87776640,chr16,87776622,87776640,IMR90|chr16:85206143-85206166,chr16,85206143,85206166,0,2570479
IMR90|chr16:87777561-87777598,chr16,87777561,87777598,IMR90|chr16:70283369-70283458,chr16,70283369,70283458,0,17494192
IMR90|chr16:87955991-87956025,chr16,87955991,87956025,IMR90|chr16:85641856-85641932,chr16,85641856,85641932,0,2314135
IMR90|chr16:87974112-87974177,chr16,87974112,87974177,IMR90|chr16:85203021-85203106,chr16,85203021,85203106,0,2771091
IMR90|chr16:88014647-88014706,chr16,88014647,88014706,IMR90|chr16:85204651-85204691,chr16,85204651,85204691,0,2809996
IMR90|chr16:88255525-88255632,chr16,88255525,88255632,IMR90|chr16:90035870-90035894,chr16,90035870,90035894,0,1780345
IMR90|chr16:88274298-88274395,chr16,88274298,88274395,IMR90|chr16:85205931-85205983,chr16,85205931,85205983,0,3068367
IMR90|chr16:88395829-88395870,chr16,88395829,88395870,IMR90|chr16:85206400-85206458,chr16,85206400,85206458,0,3189429
IMR90|chr16:88518204-88518262,chr16,88518204,88518262,IMR90|chr16:85205852-85205886,chr16,85205852,85205886,0,3312352
IMR90|chr16:88803226-88803301,chr16,88803226,88803301,IMR90|chr16:85208107-85208145,chr16,85208107,85208145,0,3595119
IMR90|chr16:88908588-88908680,chr16,88908588,88908680,IMR90|chr16:18937922-18937975,chr16,18937922,18937975,0,69970666
IMR90|chr16:88919464-88919491,chr16,88919464,88919491,IMR90|chr16:30087128-30087194,chr16,30087128,30087194,0,58832336
IMR90|chr16:89069385-89069468,chr16,89069385,89069468,IMR90|chr16:85207094-85207235,chr16,85207094,85207235,0,3862291
IMR90|chr16:89214823-89214908,chr16,89214823,89214908,IMR90|chr16:9188656-9188728,chr16,9188656,9188728,0,80026167
IMR90|chr16:89368108-89368131,chr16,89368108,89368131,IMR90|chr16:67972357-67972484,chr16,67972357,67972484,0,21395751
IMR90|chr16:89372522-89372613,chr16,89372522,89372613,IMR90|chr16:4588478-4588498,chr16,4588478,4588498,0,84784044
IMR90|chr16:89525392-89525426,chr16,89525392,89525426,IMR90|chr16:2045882-2045932,chr16,2045882,2045932,0,87479510
IMR90|chr16:89728534-89728579,chr16,89728534,89728579,IMR90|chr16:30084801-30084863,chr16,30084801,30084863,0,59643733
IMR90|chr16:89730998-89731095,chr16,89730998,89731095,IMR90|chr16:18937922-18937976,chr16,18937922,18937976,0,70793076
IMR90|chr16:89810729-89810777,chr16,89810729,89810777,IMR90|chr16:71844371-71844461,chr16,71844371,71844461,0,17966358
IMR90|chr16:90023761-90023846,chr16,90023761,90023846,IMR90|chr16:89572011-89572057,chr16,89572011,89572057,0,451750
IMR90|chr16:90060086-90060108,chr16,90060086,90060108,IMR90|chr16:85204398-85204548,chr16,85204398,85204548,0,4855688
IMR90|chr16:90213511-90213607,chr16,90213511,90213607,IMR90|chr16:31467502-31467648,chr16,31467502,31467648,0,58746009
IMR90|chr17:214532-214569,chr17,214532,214569,IMR90|chr17:39974978-39975050,chr17,39974978,39975050,0,39760446
IMR90|chr17:419007-419047,chr17,419007,419047,IMR90|chr17:61048205-61048231,chr17,61048205,61048231,0,60629198
IMR90|chr17:438777-438880,chr17,438777,438880,IMR90|chr17:56429261-56429307,chr17,56429261,56429307,0,55990484
IMR90|chr17:486372-486498,chr17,486372,486498,IMR90|chr17:62661726-62661750,chr17,62661726,62661750,0,62175354
IMR90|chr17:607576-607636,chr17,607576,607636,IMR90|chr17:46649871-46649919,chr17,46649871,46649919,0,46042295
IMR90|chr17:632666-632708,chr17,632666,632708,IMR90|chr17:75374601-75374751,chr17,75374601,75374751,0,74741935
IMR90|chr17:635372-635458,chr17,635372,635458,IMR90|chr17:2308123-2308188,chr17,2308123,2308188,0,1672751
IMR90|chr17:834472-834594,chr17,834472,834594,IMR90|chr17:74499903-74500053,chr17,74499903,74500053,0,73665431
IMR90|chr17:999938-999985,chr17,999938,999985,IMR90|chr17:57699790-57699849,chr17,57699790,57699849,0,56699852
IMR90|chr17:1029362-1029404,chr17,1029362,1029404,IMR90|chr17:62654052-62654127,chr17,62654052,62654127,0,61624690
IMR90|chr17:1088617-1088742,chr17,1088617,1088742,IMR90|chr17:6542870-6542921,chr17,6542870,6542921,0,5454253
IMR90|chr17:1184058-1184136,chr17,1184058,1184136,IMR90|chr17:62655203-62655239,chr17,62655203,62655239,0,61471145
IMR90|chr17:1238135-1238185,chr17,1238135,1238185,IMR90|chr17:79820558-79820700,chr17,79820558,79820700,0,78582423
IMR90|chr17:1573584-1573620,chr17,1573584,1573620,IMR90|chr17:8096316-8096427,chr17,8096316,8096427,0,6522732
IMR90|chr17:1607534-1607605,chr17,1607534,1607605,IMR90|chr17:47075292-47075322,chr17,47075292,47075322,0,45467758
IMR90|chr17:1638651-1638684,chr17,1638651,1638684,IMR90|chr17:62657889-62657976,chr17,62657889,62657976,0,61019238
IMR90|chr17:1642495-1642617,chr17,1642495,1642617,IMR90|chr17:74499903-74500053,chr17,74499903,74500053,0,72857408
IMR90|chr17:1814843-1814943,chr17,1814843,1814943,IMR90|chr17:38603218-38603266,chr17,38603218,38603266,0,36788375
IMR90|chr17:2017444-2017483,chr17,2017444,2017483,IMR90|chr17:38522877-38522915,chr17,38522877,38522915,0,36505433
IMR90|chr17:2018008-2018081,chr17,2018008,2018081,IMR90|chr17:2308195-2308267,chr17,2308195,2308267,0,290187
IMR90|chr17:2159078-2159187,chr17,2159078,2159187,IMR90|chr17:40545402-40545443,chr17,40545402,40545443,0,38386324
IMR90|chr17:2170543-2170640,chr17,2170543,2170640,IMR90|chr17:38601616-38601665,chr17,38601616,38601665,0,36431073
IMR90|chr17:2324890-2325013,chr17,2324890,2325013,IMR90|chr17:26548915-26548938,chr17,26548915,26548938,0,24224025
IMR90|chr17:2606055-2606135,chr17,2606055,2606135,IMR90|chr17:38604436-38604474,chr17,38604436,38604474,0,35998381
IMR90|chr17:2880088-2880157,chr17,2880088,2880157,IMR90|chr17:53498279-53498340,chr17,53498279,53498340,0,50618191
IMR90|chr17:2894707-2894759,chr17,2894707,2894759,IMR90|chr17:62656493-62656585,chr17,62656493,62656585,0,59761786
IMR90|chr17:3059141-3059198,chr17,3059141,3059198,IMR90|chr17:40426519-40426572,chr17,40426519,40426572,0,37367378
IMR90|chr17:3137284-3137340,chr17,3137284,3137340,IMR90|chr17:48473180-48473242,chr17,48473180,48473242,0,45335896
IMR90|chr17:3197030-3197151,chr17,3197030,3197151,IMR90|chr17:62661729-62661790,chr17,62661729,62661790,0,59464699
IMR90|chr17:3339416-3339474,chr17,3339416,3339474,IMR90|chr17:38600901-38600986,chr17,38600901,38600986,0,35261485
IMR90|chr17:3420763-3420799,chr17,3420763,3420799,IMR90|chr17:28615855-28615943,chr17,28615855,28615943,0,25195092
IMR90|chr17:3484247-3484316,chr17,3484247,3484316,IMR90|chr17:27072998-27073021,chr17,27072998,27073021,0,23588751
IMR90|chr17:3526277-3526319,chr17,3526277,3526319,IMR90|chr17:40074833-40074873,chr17,40074833,40074873,0,36548556
IMR90|chr17:3650599-3650655,chr17,3650599,3650655,IMR90|chr17:48473180-48473242,chr17,48473180,48473242,0,44822581
IMR90|chr17:3704824-3704860,chr17,3704824,3704860,IMR90|chr17:26548915-26549017,chr17,26548915,26549017,0,22844091
IMR90|chr17:3738493-3738528,chr17,3738493,3738528,IMR90|chr17:62656069-62656172,chr17,62656069,62656172,0,58917576
IMR90|chr17:3785685-3785747,chr17,3785685,3785747,IMR90|chr17:75374155-75374224,chr17,75374155,75374224,0,71588470
IMR90|chr17:3809602-3809654,chr17,3809602,3809654,IMR90|chr17:75373356-75373454,chr17,75373356,75373454,0,71563754
IMR90|chr17:3840214-3840255,chr17,3840214,3840255,IMR90|chr17:78390116-78390197,chr17,78390116,78390197,0,74549902
IMR90|chr17:3955477-3955598,chr17,3955477,3955598,IMR90|chr17:62661729-62661790,chr17,62661729,62661790,0,58706252
IMR90|chr17:4028340-4028363,chr17,4028340,4028363,IMR90|chr17:46648931-46649026,chr17,46648931,46649026,0,42620591
IMR90|chr17:4093967-4094021,chr17,4093967,4094021,IMR90|chr17:62655228-62655301,chr17,62655228,62655301,0,58561261
IMR90|chr17:4170054-4170084,chr17,4170054,4170084,IMR90|chr17:38604517-38604634,chr17,38604517,38604634,0,34434463
IMR90|chr17:4355412-4355529,chr17,4355412,4355529,IMR90|chr17:80008741-80008774,chr17,80008741,80008774,0,75653329
IMR90|chr17:4815837-4815924,chr17,4815837,4815924,IMR90|chr17:74499910-74500060,chr17,74499910,74500060,0,69684073
IMR90|chr17:4997885-4997931,chr17,4997885,4997931,IMR90|chr17:59484237-59484275,chr17,59484237,59484275,0,54486352
IMR90|chr17:5008664-5008753,chr17,5008664,5008753,IMR90|chr17:8113194-8113231,chr17,8113194,8113231,0,3104530
IMR90|chr17:5092484-5092542,chr17,5092484,5092542,IMR90|chr17:28931130-28931179,chr17,28931130,28931179,0,23838646
IMR90|chr17:5165190-5165261,chr17,5165190,5165261,IMR90|chr17:40574180-40574233,chr17,40574180,40574233,0,35408990
IMR90|chr17:5192591-5192612,chr17,5192591,5192612,IMR90|chr17:62656496-62656531,chr17,62656496,62656531,0,57463905
IMR90|chr17:5210075-5210119,chr17,5210075,5210119,IMR90|chr17:59484237-59484275,chr17,59484237,59484275,0,54274162
IMR90|chr17:5430328-5430404,chr17,5430328,5430404,IMR90|chr17:62659142-62659292,chr17,62659142,62659292,0,57228814
IMR90|chr17:5447322-5447376,chr17,5447322,5447376,IMR90|chr17:61675552-61675646,chr17,61675552,61675646,0,56228230
IMR90|chr17:5618246-5618350,chr17,5618246,5618350,IMR90|chr17:56429261-56429307,chr17,56429261,56429307,0,50811015
IMR90|chr17:5757870-5757963,chr17,5757870,5757963,IMR90|chr17:62501071-62501105,chr17,62501071,62501105,0,56743201
IMR90|chr17:5818719-5818817,chr17,5818719,5818817,IMR90|chr17:26667128-26667163,chr17,26667128,26667163,0,20848409
IMR90|chr17:5866327-5866352,chr17,5866327,5866352,IMR90|chr17:75447924-75448004,chr17,75447924,75448004,0,69581597
IMR90|chr17:6063710-6063822,chr17,6063710,6063822,IMR90|chr17:38525820-38525888,chr17,38525820,38525888,0,32462110
IMR90|chr17:6189680-6189752,chr17,6189680,6189752,IMR90|chr17:62656036-62656104,chr17,62656036,62656104,0,56466356
IMR90|chr17:6203088-6203128,chr17,6203088,6203128,IMR90|chr17:38604494-38604634,chr17,38604494,38604634,0,32401406
IMR90|chr17:6252870-6252902,chr17,6252870,6252902,IMR90|chr17:27052202-27052281,chr17,27052202,27052281,0,20799332
IMR90|chr17:6273017-6273080,chr17,6273017,6273080,IMR90|chr17:39966720-39966810,chr17,39966720,39966810,0,33693703
IMR90|chr17:6306513-6306564,chr17,6306513,6306564,IMR90|chr17:38604077-38604120,chr17,38604077,38604120,0,32297564
IMR90|chr17:6356845-6356891,chr17,6356845,6356891,IMR90|chr17:39973064-39973110,chr17,39973064,39973110,0,33616219
IMR90|chr17:6361114-6361211,chr17,6361114,6361211,IMR90|chr17:62655274-62655359,chr17,62655274,62655359,0,56294160
IMR90|chr17:6528073-6528216,chr17,6528073,6528216,IMR90|chr17:42277279-42277379,chr17,42277279,42277379,0,35749206
IMR90|chr17:6610878-6610938,chr17,6610878,6610938,IMR90|chr17:30772202-30772308,chr17,30772202,30772308,0,24161324
IMR90|chr17:6632061-6632113,chr17,6632061,6632113,IMR90|chr17:41151602-41151654,chr17,41151602,41151654,0,34519541
IMR90|chr17:6685823-6685883,chr17,6685823,6685883,IMR90|chr17:26548915-26549022,chr17,26548915,26549022,0,19863092
IMR90|chr17:6914847-6914934,chr17,6914847,6914934,IMR90|chr17:61048763-61048826,chr17,61048763,61048826,0,54133916
IMR90|chr17:7260977-7261093,chr17,7260977,7261093,IMR90|chr17:78390151-78390185,chr17,78390151,78390185,0,71129174
IMR90|chr17:7395353-7395397,chr17,7395353,7395397,IMR90|chr17:36586525-36586582,chr17,36586525,36586582,0,29191172
IMR90|chr17:7481232-7481331,chr17,7481232,7481331,IMR90|chr17:4844953-4844999,chr17,4844953,4844999,0,2636279
IMR90|chr17:7525739-7525792,chr17,7525739,7525792,IMR90|chr17:19289328-19289471,chr17,19289328,19289471,0,11763589
IMR90|chr17:7546861-7546884,chr17,7546861,7546884,IMR90|chr17:80232253-80232341,chr17,80232253,80232341,0,72685392
IMR90|chr17:7704988-7705022,chr17,7704988,7705022,IMR90|chr17:47841646-47841694,chr17,47841646,47841694,0,40136658
IMR90|chr17:7788798-7788825,chr17,7788798,7788825,IMR90|chr17:1362781-1362816,chr17,1362781,1362816,0,6426017
IMR90|chr17:7802454-7802477,chr17,7802454,7802477,IMR90|chr17:38601988-38602008,chr17,38601988,38602008,0,30799534
IMR90|chr17:7834957-7834992,chr17,7834957,7834992,IMR90|chr17:79824888-79824972,chr17,79824888,79824972,0,71989931
IMR90|chr17:8094658-8094678,chr17,8094658,8094678,IMR90|chr17:40428923-40428939,chr17,40428923,40428939,0,32334265
IMR90|chr17:8134946-8134986,chr17,8134946,8134986,IMR90|chr17:57782183-57782248,chr17,57782183,57782248,0,49647237
IMR90|chr17:8225312-8225390,chr17,8225312,8225390,IMR90|chr17:8097210-8097274,chr17,8097210,8097274,0,128102
IMR90|chr17:8251323-8251383,chr17,8251323,8251383,IMR90|chr17:46649871-46649919,chr17,46649871,46649919,0,38398548
IMR90|chr17:8278754-8278784,chr17,8278754,8278784,IMR90|chr17:38604517-38604634,chr17,38604517,38604634,0,30325763
IMR90|chr17:8384765-8384847,chr17,8384765,8384847,IMR90|chr17:38601799-38601903,chr17,38601799,38601903,0,30217034
IMR90|chr17:8430996-8431036,chr17,8430996,8431036,IMR90|chr17:7310956-7311001,chr17,7310956,7311001,0,1120040
IMR90|chr17:8586330-8586365,chr17,8586330,8586365,IMR90|chr17:79824888-79824972,chr17,79824888,79824972,0,71238558
IMR90|chr17:8590035-8590160,chr17,8590035,8590160,IMR90|chr17:38603923-38603948,chr17,38603923,38603948,0,30013888
IMR90|chr17:8613014-8613143,chr17,8613014,8613143,IMR90|chr17:43024258-43024279,chr17,43024258,43024279,0,34411244
IMR90|chr17:8624182-8624203,chr17,8624182,8624203,IMR90|chr17:62656496-62656531,chr17,62656496,62656531,0,54032314
IMR90|chr17:8806156-8806202,chr17,8806156,8806202,IMR90|chr17:75449773-75449847,chr17,75449773,75449847,0,66643617
IMR90|chr17:8961285-8961338,chr17,8961285,8961338,IMR90|chr17:41855216-41855323,chr17,41855216,41855323,0,32893931
IMR90|chr17:8998861-8998925,chr17,8998861,8998925,IMR90|chr17:27042253-27042339,chr17,27042253,27042339,0,18043392
IMR90|chr17:9020355-9020426,chr17,9020355,9020426,IMR90|chr17:47075292-47075322,chr17,47075292,47075322,0,38054937
IMR90|chr17:9123584-9123658,chr17,9123584,9123658,IMR90|chr17:38600440-38600481,chr17,38600440,38600481,0,29476856
IMR90|chr17:9235157-9235231,chr17,9235157,9235231,IMR90|chr17:80188978-80189084,chr17,80188978,80189084,0,70953821
IMR90|chr17:9279621-9279708,chr17,9279621,9279708,IMR90|chr17:62662214-62662277,chr17,62662214,62662277,0,53382593
IMR90|chr17:9387535-9387572,chr17,9387535,9387572,IMR90|chr17:26548915-26549028,chr17,26548915,26549028,0,17161380
IMR90|chr17:9420568-9420614,chr17,9420568,9420614,IMR90|chr17:38601799-38601903,chr17,38601799,38601903,0,29181231
IMR90|chr17:9535545-9535601,chr17,9535545,9535601,IMR90|chr17:38601381-38601429,chr17,38601381,38601429,0,29065836
IMR90|chr17:9927013-9927083,chr17,9927013,9927083,IMR90|chr17:40545402-40545482,chr17,40545402,40545482,0,30618389
IMR90|chr17:9937560-9937662,chr17,9937560,9937662,IMR90|chr17:80234709-80234793,chr17,80234709,80234793,0,70297149
IMR90|chr17:10038401-10038551,chr17,10038401,10038551,IMR90|chr17:74499900-74500050,chr17,74499900,74500050,0,64461499
IMR90|chr17:10233200-10233233,chr17,10233200,10233233,IMR90|chr17:79824888-79824972,chr17,79824888,79824972,0,69591688
IMR90|chr17:10580646-10580695,chr17,10580646,10580695,IMR90|chr17:15553524-15553591,chr17,15553524,15553591,0,4972878
IMR90|chr17:10679251-10679331,chr17,10679251,10679331,IMR90|chr17:79819730-79819767,chr17,79819730,79819767,0,69140479
IMR90|chr17:10785053-10785080,chr17,10785053,10785080,IMR90|chr17:26548915-26549014,chr17,26548915,26549014,0,15763862
IMR90|chr17:10799274-10799303,chr17,10799274,10799303,IMR90|chr17:48543444-48543529,chr17,48543444,48543529,0,37744170
IMR90|chr17:10904391-10904456,chr17,10904391,10904456,IMR90|chr17:62654086-62654106,chr17,62654086,62654106,0,51749695
IMR90|chr17:11237492-11237545,chr17,11237492,11237545,IMR90|chr17:41855216-41855323,chr17,41855216,41855323,0,30617724
IMR90|chr17:11241956-11241983,chr17,11241956,11241983,IMR90|chr17:62657316-62657389,chr17,62657316,62657389,0,51415360
IMR90|chr17:11359714-11359780,chr17,11359714,11359780,IMR90|chr17:40165032-40165099,chr17,40165032,40165099,0,28805318
IMR90|chr17:11440059-11440131,chr17,11440059,11440131,IMR90|chr17:34959293-34959339,chr17,34959293,34959339,0,23519234
IMR90|chr17:11542269-11542329,chr17,11542269,11542329,IMR90|chr17:48942185-48942257,chr17,48942185,48942257,0,37399916
IMR90|chr17:11759717-11759750,chr17,11759717,11759750,IMR90|chr17:79824888-79824972,chr17,79824888,79824972,0,68065171
IMR90|chr17:11798531-11798585,chr17,11798531,11798585,IMR90|chr17:62656377-62656443,chr17,62656377,62656443,0,50857846
IMR90|chr17:11981147-11981213,chr17,11981147,11981213,IMR90|chr17:62653542-62653626,chr17,62653542,62653626,0,50672395
IMR90|chr17:12176701-12176817,chr17,12176701,12176817,IMR90|chr17:62653744-62653772,chr17,62653744,62653772,0,50477043
IMR90|chr17:12198494-12198592,chr17,12198494,12198592,IMR90|chr17:38603218-38603266,chr17,38603218,38603266,0,26404724
IMR90|chr17:12218081-12218103,chr17,12218081,12218103,IMR90|chr17:62658307-62658420,chr17,62658307,62658420,0,50440226
IMR90|chr17:12297301-12297364,chr17,12297301,12297364,IMR90|chr17:46683281-46683322,chr17,46683281,46683322,0,34385980
IMR90|chr17:12349620-12349715,chr17,12349620,12349715,IMR90|chr17:79534358-79534442,chr17,79534358,79534442,0,67184738
IMR90|chr17:12462186-12462207,chr17,12462186,12462207,IMR90|chr17:62501103-62501174,chr17,62501103,62501174,0,50038917
IMR90|chr17:12620516-12620619,chr17,12620516,12620619,IMR90|chr17:56429261-56429307,chr17,56429261,56429307,0,43808745
IMR90|chr17:12645750-12645796,chr17,12645750,12645796,IMR90|chr17:62658226-62658367,chr17,62658226,62658367,0,50012476
IMR90|chr17:12754214-12754339,chr17,12754214,12754339,IMR90|chr17:62658145-62658266,chr17,62658145,62658266,0,49903931
IMR90|chr17:12954497-12954553,chr17,12954497,12954553,IMR90|chr17:62656558-62656619,chr17,62656558,62656619,0,49702061
IMR90|chr17:12999150-12999221,chr17,12999150,12999221,IMR90|chr17:40574180-40574233,chr17,40574180,40574233,0,27575030
IMR90|chr17:13105932-13105984,chr17,13105932,13105984,IMR90|chr17:62656493-62656585,chr17,62656493,62656585,0,49550561
IMR90|chr17:13245712-13245809,chr17,13245712,13245809,IMR90|chr17:26667128-26667163,chr17,26667128,26667163,0,13421416
IMR90|chr17:13663417-13663459,chr17,13663417,13663459,IMR90|chr17:75374601-75374751,chr17,75374601,75374751,0,61711184
IMR90|chr17:13713434-13713577,chr17,13713434,13713577,IMR90|chr17:42277279-42277379,chr17,42277279,42277379,0,28563845
IMR90|chr17:13713988-13714048,chr17,13713988,13714048,IMR90|chr17:62660094-62660189,chr17,62660094,62660189,0,48946106
IMR90|chr17:13724989-13725065,chr17,13724989,13725065,IMR90|chr17:62659142-62659292,chr17,62659142,62659292,0,48934153
IMR90|chr17:13778204-13778237,chr17,13778204,13778237,IMR90|chr17:76163075-76163182,chr17,76163075,76163182,0,62384871
IMR90|chr17:13847172-13847232,chr17,13847172,13847232,IMR90|chr17:62660094-62660189,chr17,62660094,62660189,0,48812922
IMR90|chr17:13933606-13933661,chr17,13933606,13933661,IMR90|chr17:40166289-40166384,chr17,40166289,40166384,0,26232683
IMR90|chr17:13999503-13999611,chr17,13999503,13999611,IMR90|chr17:78230190-78230251,chr17,78230190,78230251,0,64230687
IMR90|chr17:14168201-14168242,chr17,14168201,14168242,IMR90|chr17:76779085-76779136,chr17,76779085,76779136,0,62610884
IMR90|chr17:14204577-14204676,chr17,14204577,14204676,IMR90|chr17:28444845-28444866,chr17,28444845,28444866,0,14240268
IMR90|chr17:14265894-14265955,chr17,14265894,14265955,IMR90|chr17:73177947-73178025,chr17,73177947,73178025,0,58912053
IMR90|chr17:14285551-14285640,chr17,14285551,14285640,IMR90|chr17:61047821-61047861,chr17,61047821,61047861,0,46762270
IMR90|chr17:14358103-14358128,chr17,14358103,14358128,IMR90|chr17:75447924-75448004,chr17,75447924,75448004,0,61089821
IMR90|chr17:14673251-14673302,chr17,14673251,14673302,IMR90|chr17:78189274-78189424,chr17,78189274,78189424,0,63516023
IMR90|chr17:14889386-14889432,chr17,14889386,14889432,IMR90|chr17:40572787-40572891,chr17,40572787,40572891,0,25683401
IMR90|chr17:14978959-14979075,chr17,14978959,14979075,IMR90|chr17:78390151-78390185,chr17,78390151,78390185,0,63411192
IMR90|chr17:15007433-15007477,chr17,15007433,15007477,IMR90|chr17:62495108-62495181,chr17,62495108,62495181,0,47487675
IMR90|chr17:15041874-15042020,chr17,15041874,15042020,IMR90|chr17:66287573-66287670,chr17,66287573,66287670,0,51245699
IMR90|chr17:15098892-15098938,chr17,15098892,15098938,IMR90|chr17:62657033-62657141,chr17,62657033,62657141,0,47558141
IMR90|chr17:15252847-15252893,chr17,15252847,15252893,IMR90|chr17:39973064-39973110,chr17,39973064,39973110,0,24720217
IMR90|chr17:15316099-15316167,chr17,15316099,15316167,IMR90|chr17:57784364-57784396,chr17,57784364,57784396,0,42468265
IMR90|chr17:15366410-15366495,chr17,15366410,15366495,IMR90|chr17:62655288-62655307,chr17,62655288,62655307,0,47288878
IMR90|chr17:15469607-15469673,chr17,15469607,15469673,IMR90|chr17:40579313-40579463,chr17,40579313,40579463,0,25109706
IMR90|chr17:15529768-15529794,chr17,15529768,15529794,IMR90|chr17:38603528-38603568,chr17,38603528,38603568,0,23073760
IMR90|chr17:15684822-15684874,chr17,15684822,15684874,IMR90|chr17:41151602-41151654,chr17,41151602,41151654,0,25466780
IMR90|chr17:15691065-15691107,chr17,15691065,15691107,IMR90|chr17:38440587-38440658,chr17,38440587,38440658,0,22749522
IMR90|chr17:15735614-15735708,chr17,15735614,15735708,IMR90|chr17:21187460-21187514,chr17,21187460,21187514,0,5451846
IMR90|chr17:15763127-15763197,chr17,15763127,15763197,IMR90|chr17:62504434-62504514,chr17,62504434,62504514,0,46741307
IMR90|chr17:15763837-15763877,chr17,15763837,15763877,IMR90|chr17:62915051-62915161,chr17,62915051,62915161,0,47151214
IMR90|chr17:15863578-15863611,chr17,15863578,15863611,IMR90|chr17:40608104-40608162,chr17,40608104,40608162,0,24744526
IMR90|chr17:15940828-15940877,chr17,15940828,15940877,IMR90|chr17:15553524-15553591,chr17,15553524,15553591,0,387304
IMR90|chr17:16242772-16242791,chr17,16242772,16242791,IMR90|chr17:38604406-38604435,chr17,38604406,38604435,0,22361634
IMR90|chr17:16392489-16392515,chr17,16392489,16392515,IMR90|chr17:38523742-38523860,chr17,38523742,38523860,0,22131253
IMR90|chr17:16393592-16393645,chr17,16393592,16393645,IMR90|chr17:40166287-40166384,chr17,40166287,40166384,0,23772695
IMR90|chr17:16474360-16474442,chr17,16474360,16474442,IMR90|chr17:62655650-62655728,chr17,62655650,62655728,0,46181290
IMR90|chr17:16531322-16531384,chr17,16531322,16531384,IMR90|chr17:2308195-2308267,chr17,2308195,2308267,0,14223127
IMR90|chr17:16588404-16588470,chr17,16588404,16588470,IMR90|chr17:80408177-80408261,chr17,80408177,80408261,0,63819773
IMR90|chr17:16752265-16752305,chr17,16752265,16752305,IMR90|chr17:38603886-38603971,chr17,38603886,38603971,0,21851621
IMR90|chr17:16813152-16813230,chr17,16813152,16813230,IMR90|chr17:62655203-62655239,chr17,62655203,62655239,0,45842051
IMR90|chr17:16858512-16858565,chr17,16858512,16858565,IMR90|chr17:62657442-62657482,chr17,62657442,62657482,0,45798930
IMR90|chr17:16947741-16947812,chr17,16947741,16947812,IMR90|chr17:62491987-62492028,chr17,62491987,62492028,0,45544246
IMR90|chr17:17071147-17071223,chr17,17071147,17071223,IMR90|chr17:62497619-62497663,chr17,62497619,62497663,0,45426472
IMR90|chr17:17299592-17299742,chr17,17299592,17299742,IMR90|chr17:38603923-38603948,chr17,38603923,38603948,0,21304331
IMR90|chr17:17348732-17348774,chr17,17348732,17348774,IMR90|chr17:38440587-38440658,chr17,38440587,38440658,0,21091855
IMR90|chr17:17420545-17420604,chr17,17420545,17420604,IMR90|chr17:26548915-26549028,chr17,26548915,26549028,0,9128370
IMR90|chr17:17458633-17458668,chr17,17458633,17458668,IMR90|chr17:62656256-62656368,chr17,62656256,62656368,0,45197623
IMR90|chr17:17486208-17486258,chr17,17486208,17486258,IMR90|chr17:62659189-62659275,chr17,62659189,62659275,0,45172981
IMR90|chr17:17489892-17489943,chr17,17489892,17489943,IMR90|chr17:71092707-71092853,chr17,71092707,71092853,0,53602815
IMR90|chr17:17570051-17570201,chr17,17570051,17570201,IMR90|chr17:74499922-74500072,chr17,74499922,74500072,0,56929871
IMR90|chr17:17823201-17823230,chr17,17823201,17823230,IMR90|chr17:38602896-38602970,chr17,38602896,38602970,0,20779695
IMR90|chr17:17837807-17837866,chr17,17837807,17837866,IMR90|chr17:26548915-26549028,chr17,26548915,26549028,0,8711108
IMR90|chr17:17912078-17912131,chr17,17912078,17912131,IMR90|chr17:76783272-76783369,chr17,76783272,76783369,0,58871194
IMR90|chr17:17952465-17952501,chr17,17952465,17952501,IMR90|chr17:36585938-36585984,chr17,36585938,36585984,0,18633473
IMR90|chr17:17985014-17985164,chr17,17985014,17985164,IMR90|chr17:1618338-1618372,chr17,1618338,1618372,0,16366676
IMR90|chr17:18219652-18219726,chr17,18219652,18219726,IMR90|chr17:80188978-80189084,chr17,80188978,80189084,0,61969326
IMR90|chr17:18230315-18230459,chr17,18230315,18230459,IMR90|chr17:74499923-74500072,chr17,74499923,74500072,0,56269608
IMR90|chr17:18263967-18264008,chr17,18263967,18264008,IMR90|chr17:62656383-62656454,chr17,62656383,62656454,0,44392416
IMR90|chr17:18308976-18309077,chr17,18308976,18309077,IMR90|chr17:65373436-65373469,chr17,65373436,65373469,0,47064460
IMR90|chr17:18679152-18679195,chr17,18679152,18679195,IMR90|chr17:41855216-41855323,chr17,41855216,41855323,0,23176064
IMR90|chr17:18720392-18720430,chr17,18720392,18720430,IMR90|chr17:26548915-26549022,chr17,26548915,26549022,0,7828523
IMR90|chr17:18731887-18731976,chr17,18731887,18731976,IMR90|chr17:62661729-62661790,chr17,62661729,62661790,0,43929842
IMR90|chr17:18738958-18739001,chr17,18738958,18739001,IMR90|chr17:8054163-8054196,chr17,8054163,8054196,0,10684795
IMR90|chr17:18790535-18790629,chr17,18790535,18790629,IMR90|chr17:62654087-62654110,chr17,62654087,62654110,0,43863552
IMR90|chr17:18835795-18835911,chr17,18835795,18835911,IMR90|chr17:1618338-1618372,chr17,1618338,1618372,0,17217457
IMR90|chr17:18980491-18980566,chr17,18980491,18980566,IMR90|chr17:48135251-48135326,chr17,48135251,48135326,0,29154760
IMR90|chr17:19207866-19207973,chr17,19207866,19207973,IMR90|chr17:62658383-62658416,chr17,62658383,62658416,0,43450517
IMR90|chr17:19213213-19213269,chr17,19213213,19213269,IMR90|chr17:39971186-39971280,chr17,39971186,39971280,0,20757973
IMR90|chr17:19244157-19244195,chr17,19244157,19244195,IMR90|chr17:26666141-26666249,chr17,26666141,26666249,0,7421984
IMR90|chr17:19436575-19436645,chr17,19436575,19436645,IMR90|chr17:40545402-40545482,chr17,40545402,40545482,0,21108827
IMR90|chr17:19487517-19487593,chr17,19487517,19487593,IMR90|chr17:62653673-62653739,chr17,62653673,62653739,0,43166156
IMR90|chr17:19631242-19631279,chr17,19631242,19631279,IMR90|chr17:38442813-38442863,chr17,38442813,38442863,0,18811571
IMR90|chr17:19663296-19663344,chr17,19663296,19663344,IMR90|chr17:57699790-57699849,chr17,57699790,57699849,0,38036494
IMR90|chr17:19743964-19744071,chr17,19743964,19744071,IMR90|chr17:62658383-62658416,chr17,62658383,62658416,0,42914419
IMR90|chr17:19853901-19853935,chr17,19853901,19853935,IMR90|chr17:62657844-62657965,chr17,62657844,62657965,0,42803943
IMR90|chr17:19967762-19967859,chr17,19967762,19967859,IMR90|chr17:38601616-38601665,chr17,38601616,38601665,0,18633854
IMR90|chr17:19980331-19980404,chr17,19980331,19980404,IMR90|chr17:46652375-46652407,chr17,46652375,46652407,0,26672044
IMR90|chr17:20009597-20009672,chr17,20009597,20009672,IMR90|chr17:34137377-34137425,chr17,34137377,34137425,0,14127780
IMR90|chr17:20039263-20039319,chr17,20039263,20039319,IMR90|chr17:61675552-61675646,chr17,61675552,61675646,0,41636289
IMR90|chr17:20120397-20120457,chr17,20120397,20120457,IMR90|chr17:16259310-16259386,chr17,16259310,16259386,0,3861087
IMR90|chr17:20126570-20126663,chr17,20126570,20126663,IMR90|chr17:62501071-62501105,chr17,62501071,62501105,0,42374501
IMR90|chr17:20277803-20277935,chr17,20277803,20277935,IMR90|chr17:38600425-38600460,chr17,38600425,38600460,0,18322622
IMR90|chr17:20443265-20443311,chr17,20443265,20443311,IMR90|chr17:62658226-62658367,chr17,62658226,62658367,0,42214961
IMR90|chr17:20476787-20476850,chr17,20476787,20476850,IMR90|chr17:62497563-62497645,chr17,62497563,62497645,0,42020776
IMR90|chr17:20618625-20618715,chr17,20618625,20618715,IMR90|chr17:65368719-65368756,chr17,65368719,65368756,0,44750094
IMR90|chr17:20785450-20785513,chr17,20785450,20785513,IMR90|chr17:62497563-62497645,chr17,62497563,62497645,0,41712113
IMR90|chr17:20855574-20855630,chr17,20855574,20855630,IMR90|chr17:55929708-55929802,chr17,55929708,55929802,0,35074134
IMR90|chr17:20940796-20940829,chr17,20940796,20940829,IMR90|chr17:78195044-78195103,chr17,78195044,78195103,0,57254248
IMR90|chr17:20991070-20991111,chr17,20991070,20991111,IMR90|chr17:38598353-38598440,chr17,38598353,38598440,0,17607283
IMR90|chr17:21097191-21097316,chr17,21097191,21097316,IMR90|chr17:6542870-6542921,chr17,6542870,6542921,0,14554321
IMR90|chr17:21149693-21149746,chr17,21149693,21149746,IMR90|chr17:41151602-41151654,chr17,41151602,41151654,0,20001909
IMR90|chr17:21166485-21166535,chr17,21166485,21166535,IMR90|chr17:61047275-61047324,chr17,61047275,61047324,0,39880790
IMR90|chr17:21178194-21178259,chr17,21178194,21178259,IMR90|chr17:38601882-38601958,chr17,38601882,38601958,0,17423688
IMR90|chr17:21213221-21213274,chr17,21213221,21213274,IMR90|chr17:40539738-40539795,chr17,40539738,40539795,0,19326517
IMR90|chr17:21593478-21593578,chr17,21593478,21593578,IMR90|chr17:38601736-38601793,chr17,38601736,38601793,0,17008258
IMR90|chr17:21722404-21722472,chr17,21722404,21722472,IMR90|chr17:21190956-21191012,chr17,21190956,21191012,0,531448
IMR90|chr17:21812418-21812484,chr17,21812418,21812484,IMR90|chr17:6541491-6541545,chr17,6541491,6541545,0,15270927
IMR90|chr17:21934148-21934210,chr17,21934148,21934210,IMR90|chr17:2308195-2308267,chr17,2308195,2308267,0,19625953
IMR90|chr17:21997460-21997492,chr17,21997460,21997492,IMR90|chr17:27052202-27052281,chr17,27052202,27052281,0,5054742
IMR90|chr17:22251239-22251275,chr17,22251239,22251275,IMR90|chr17:36585938-36585984,chr17,36585938,36585984,0,14334699
IMR90|chr17:22660309-22660363,chr17,22660309,22660363,IMR90|chr17:62655180-62655238,chr17,62655180,62655238,0,39994871
IMR90|chr17:22675563-22675606,chr17,22675563,22675606,IMR90|chr17:61048763-61048828,chr17,61048763,61048828,0,38373200
IMR90|chr17:22708469-22708529,chr17,22708469,22708529,IMR90|chr17:61047275-61047324,chr17,61047275,61047324,0,38338806
IMR90|chr17:22738022-22738064,chr17,22738022,22738064,IMR90|chr17:62915051-62915161,chr17,62915051,62915161,0,40177029
IMR90|chr17:22853716-22853814,chr17,22853716,22853814,IMR90|chr17:38603218-38603266,chr17,38603218,38603266,0,15749502
IMR90|chr17:22909367-22909426,chr17,22909367,22909426,IMR90|chr17:37557018-37557072,chr17,37557018,37557072,0,14647651
IMR90|chr17:22969484-22969512,chr17,22969484,22969512,IMR90|chr17:75373441-75373458,chr17,75373441,75373458,0,52403957
IMR90|chr17:23102077-23102149,chr17,23102077,23102149,IMR90|chr17:34959293-34959339,chr17,34959293,34959339,0,11857216
IMR90|chr17:23190197-23190218,chr17,23190197,23190218,IMR90|chr17:62491211-62491311,chr17,62491211,62491311,0,39301014
IMR90|chr17:23284205-23284239,chr17,23284205,23284239,IMR90|chr17:27052202-27052281,chr17,27052202,27052281,0,3767997
IMR90|chr17:23360614-23360658,chr17,23360614,23360658,IMR90|chr17:40543005-40543155,chr17,40543005,40543155,0,17182391
IMR90|chr17:23640680-23640789,chr17,23640680,23640789,IMR90|chr17:48543477-48543566,chr17,48543477,48543566,0,24902797
IMR90|chr17:23935918-23935994,chr17,23935918,23935994,IMR90|chr17:62497619-62497663,chr17,62497619,62497663,0,38561701
IMR90|chr17:23950448-23950523,chr17,23950448,23950523,IMR90|chr17:48135251-48135326,chr17,48135251,48135326,0,24184803
IMR90|chr17:24142145-24142290,chr17,24142145,24142290,IMR90|chr17:42419761-42419893,chr17,42419761,42419893,0,18277616
IMR90|chr17:24373634-24373710,chr17,24373634,24373710,IMR90|chr17:75448526-75448579,chr17,75448526,75448579,0,51074892
IMR90|chr17:24751959-24751980,chr17,24751959,24751980,IMR90|chr17:62501103-62501174,chr17,62501103,62501174,0,37749144
IMR90|chr17:24854927-24854979,chr17,24854927,24854979,IMR90|chr17:26548915-26549013,chr17,26548915,26549013,0,1693988
IMR90|chr17:24902478-24902514,chr17,24902478,24902514,IMR90|chr17:79980462-79980539,chr17,79980462,79980539,0,55077984
IMR90|chr17:24982876-24982995,chr17,24982876,24982995,IMR90|chr17:62661275-62661306,chr17,62661275,62661306,0,37678399
IMR90|chr17:25098733-25098797,chr17,25098733,25098797,IMR90|chr17:61048213-61048261,chr17,61048213,61048261,0,35949480
IMR90|chr17:25153398-25153469,chr17,25153398,25153469,IMR90|chr17:75452264-75452311,chr17,75452264,75452311,0,50298866
IMR90|chr17:25407418-25407486,chr17,25407418,25407486,IMR90|chr17:57784364-57784396,chr17,57784364,57784396,0,32376946
IMR90|chr17:25410659-25410718,chr17,25410659,25410718,IMR90|chr17:71225404-71225470,chr17,71225404,71225470,0,45814745
IMR90|chr17:25437154-25437207,chr17,25437154,25437207,IMR90|chr17:76783272-76783369,chr17,76783272,76783369,0,51346118
IMR90|chr17:25444708-25444784,chr17,25444708,25444784,IMR90|chr17:57696198-57696226,chr17,57696198,57696226,0,32251490
IMR90|chr17:25484994-25485023,chr17,25484994,25485023,IMR90|chr17:62657844-62657965,chr17,62657844,62657965,0,37172850
IMR90|chr17:25548275-25548295,chr17,25548275,25548295,IMR90|chr17:38603053-38603094,chr17,38603053,38603094,0,13054778
IMR90|chr17:25785064-25785102,chr17,25785064,25785102,IMR90|chr17:47841646-47841694,chr17,47841646,47841694,0,22056582
IMR90|chr17:25815044-25815159,chr17,25815044,25815159,IMR90|chr17:38600425-38600460,chr17,38600425,38600460,0,12785381
IMR90|chr17:25935713-25935853,chr17,25935713,25935853,IMR90|chr17:62655203-62655239,chr17,62655203,62655239,0,36719490
IMR90|chr17:26052121-26052271,chr17,26052121,26052271,IMR90|chr17:62915464-62915583,chr17,62915464,62915583,0,36863343
IMR90|chr17:26074557-26074620,chr17,26074557,26074620,IMR90|chr17:46683281-46683322,chr17,46683281,46683322,0,20608724
IMR90|chr17:26093355-26093398,chr17,26093355,26093398,IMR90|chr17:8054163-8054196,chr17,8054163,8054196,0,18039192
IMR90|chr17:26156260-26156401,chr17,26156260,26156401,IMR90|chr17:40579632-40579719,chr17,40579632,40579719,0,14423372
IMR90|chr17:26185292-26185333,chr17,26185292,26185333,IMR90|chr17:38598353-38598440,chr17,38598353,38598440,0,12413061
IMR90|chr17:26193674-26193771,chr17,26193674,26193771,IMR90|chr17:6542870-6542921,chr17,6542870,6542921,0,19650804
IMR90|chr17:26245116-26245146,chr17,26245116,26245146,IMR90|chr17:38602896-38602970,chr17,38602896,38602970,0,12357780
IMR90|chr17:26364250-26364321,chr17,26364250,26364321,IMR90|chr17:80187411-80187441,chr17,80187411,80187441,0,53823161
IMR90|chr17:26474669-26474724,chr17,26474669,26474724,IMR90|chr17:40166289-40166384,chr17,40166289,40166384,0,13691620
IMR90|chr17:26807458-26807520,chr17,26807458,26807520,IMR90|chr17:55929708-55929802,chr17,55929708,55929802,0,29122250
IMR90|chr17:26859556-26859627,chr17,26859556,26859627,IMR90|chr17:35852353-35852418,chr17,35852353,35852418,0,8992797
IMR90|chr17:26891691-26891841,chr17,26891691,26891841,IMR90|chr17:74499922-74500072,chr17,74499922,74500072,0,47608231
IMR90|chr17:26979237-26979348,chr17,26979237,26979348,IMR90|chr17:40575653-40575690,chr17,40575653,40575690,0,13596416
IMR90|chr17:27027591-27027640,chr17,27027591,27027640,IMR90|chr17:37031266-37031309,chr17,37031266,37031309,0,10003675
IMR90|chr17:27270376-27270435,chr17,27270376,27270435,IMR90|chr17:40610429-40610502,chr17,40610429,40610502,0,13340053
IMR90|chr17:27280744-27280802,chr17,27280744,27280802,IMR90|chr17:40541286-40541315,chr17,40541286,40541315,0,13260542
IMR90|chr17:27385845-27385887,chr17,27385845,27385887,IMR90|chr17:62654052-62654127,chr17,62654052,62654127,0,35268207
IMR90|chr17:27473240-27473278,chr17,27473240,27473278,IMR90|chr17:26548915-26549022,chr17,26548915,26549022,0,924325
IMR90|chr17:27569382-27569430,chr17,27569382,27569430,IMR90|chr17:62654324-62654426,chr17,62654324,62654426,0,35084942
IMR90|chr17:27865811-27865885,chr17,27865811,27865885,IMR90|chr17:40166666-40166721,chr17,40166666,40166721,0,12300855
IMR90|chr17:27944213-27944336,chr17,27944213,27944336,IMR90|chr17:73083107-73083252,chr17,73083107,73083252,0,45138894
IMR90|chr17:27967369-27967447,chr17,27967369,27967447,IMR90|chr17:62658288-62658318,chr17,62658288,62658318,0,34690919
IMR90|chr17:27983548-27983635,chr17,27983548,27983635,IMR90|chr17:74499910-74500060,chr17,74499910,74500060,0,46516362
IMR90|chr17:27985269-27985413,chr17,27985269,27985413,IMR90|chr17:57781427-57781463,chr17,57781427,57781463,0,29796158
IMR90|chr17:28324781-28324817,chr17,28324781,28324817,IMR90|chr17:4844280-4844339,chr17,4844280,4844339,0,23480501
IMR90|chr17:28416345-28416427,chr17,28416345,28416427,IMR90|chr17:62655650-62655728,chr17,62655650,62655728,0,34239305
IMR90|chr17:28462393-28462486,chr17,28462393,28462486,IMR90|chr17:80232476-80232503,chr17,80232476,80232503,0,51770083
IMR90|chr17:28517842-28517931,chr17,28517842,28517931,IMR90|chr17:8113194-8113231,chr17,8113194,8113231,0,20404648
IMR90|chr17:28566189-28566226,chr17,28566189,28566226,IMR90|chr17:72771528-72771601,chr17,72771528,72771601,0,44205339
IMR90|chr17:28568656-28568700,chr17,28568656,28568700,IMR90|chr17:62915371-62915486,chr17,62915371,62915486,0,34346715
IMR90|chr17:28783188-28783328,chr17,28783188,28783328,IMR90|chr17:62655203-62655239,chr17,62655203,62655239,0,33872015
IMR90|chr17:28787294-28787345,chr17,28787294,28787345,IMR90|chr17:21190949-21191012,chr17,21190949,21191012,0,7596345
IMR90|chr17:28800696-28800716,chr17,28800696,28800716,IMR90|chr17:38603923-38603948,chr17,38603923,38603948,0,9803227
IMR90|chr17:28937977-28938075,chr17,28937977,28938075,IMR90|chr17:17589719-17589856,chr17,17589719,17589856,0,11348258
IMR90|chr17:28938774-28938845,chr17,28938774,28938845,IMR90|chr17:75452264-75452311,chr17,75452264,75452311,0,46513490
IMR90|chr17:28991219-28991335,chr17,28991219,28991335,IMR90|chr17:62653744-62653772,chr17,62653744,62653772,0,33662525
IMR90|chr17:29035609-29035652,chr17,29035609,29035652,IMR90|chr17:40543005-40543138,chr17,40543005,40543138,0,11507396
IMR90|chr17:29114662-29114725,chr17,29114662,29114725,IMR90|chr17:59472895-59472977,chr17,59472895,59472977,0,30358233
IMR90|chr17:29170083-29170148,chr17,29170083,29170148,IMR90|chr17:80170000-80170065,chr17,80170000,80170065,0,50999917
IMR90|chr17:29258465-29258489,chr17,29258465,29258489,IMR90|chr17:75449773-75449847,chr17,75449773,75449847,0,46191308
IMR90|chr17:29474832-29474897,chr17,29474832,29474897,IMR90|chr17:62654086-62654106,chr17,62654086,62654106,0,33179254
IMR90|chr17:29498848-29498950,chr17,29498848,29498950,IMR90|chr17:74499897-74500047,chr17,74499897,74500047,0,45001049
IMR90|chr17:29698412-29698473,chr17,29698412,29698473,IMR90|chr17:47437914-47438001,chr17,47437914,47438001,0,17739502
IMR90|chr17:29784914-29784958,chr17,29784914,29784958,IMR90|chr17:59484237-59484275,chr17,59484237,59484275,0,29699323
IMR90|chr17:29790192-29790257,chr17,29790192,29790257,IMR90|chr17:1464325-1464390,chr17,1464325,1464390,0,28325867
IMR90|chr17:29949461-29949597,chr17,29949461,29949597,IMR90|chr17:43024258-43024279,chr17,43024258,43024279,0,13074797
IMR90|chr17:30038696-30038790,chr17,30038696,30038790,IMR90|chr17:62654087-62654110,chr17,62654087,62654110,0,32615391
IMR90|chr17:30040670-30040764,chr17,30040670,30040764,IMR90|chr17:28616663-28616698,chr17,28616663,28616698,0,1424007
IMR90|chr17:30076322-30076361,chr17,30076322,30076361,IMR90|chr17:7310956-7311001,chr17,7310956,7311001,0,22765366
IMR90|chr17:30078763-30078854,chr17,30078763,30078854,IMR90|chr17:65368719-65368756,chr17,65368719,65368756,0,35289956
IMR90|chr17:30090039-30090115,chr17,30090039,30090115,IMR90|chr17:38603403-38603473,chr17,38603403,38603473,0,8513364
IMR90|chr17:30264264-30264361,chr17,30264264,30264361,IMR90|chr17:26667128-26667163,chr17,26667128,26667163,0,3597136
IMR90|chr17:30295726-30295775,chr17,30295726,30295775,IMR90|chr17:39975275-39975335,chr17,39975275,39975335,0,9679549
IMR90|chr17:30416295-30416343,chr17,30416295,30416343,IMR90|chr17:37031266-37031309,chr17,37031266,37031309,0,6614971
IMR90|chr17:30500539-30500624,chr17,30500539,30500624,IMR90|chr17:2308123-2308188,chr17,2308123,2308188,0,28192416
IMR90|chr17:30585550-30585592,chr17,30585550,30585592,IMR90|chr17:62915051-62915161,chr17,62915051,62915161,0,32329501
IMR90|chr17:30692057-30692123,chr17,30692057,30692123,IMR90|chr17:6541491-6541545,chr17,6541491,6541545,0,24150566
IMR90|chr17:30743343-30743379,chr17,30743343,30743379,IMR90|chr17:48543452-48543529,chr17,48543452,48543529,0,17800109
IMR90|chr17:30780140-30780206,chr17,30780140,30780206,IMR90|chr17:80170001-80170066,chr17,80170001,80170066,0,49389861
IMR90|chr17:30781803-30781831,chr17,30781803,30781831,IMR90|chr17:38523742-38523860,chr17,38523742,38523860,0,7741939
IMR90|chr17:30803538-30803621,chr17,30803538,30803621,IMR90|chr17:78230190-78230251,chr17,78230190,78230251,0,47426652
IMR90|chr17:30860792-30860872,chr17,30860792,30860872,IMR90|chr17:80408177-80408261,chr17,80408177,80408261,0,49547385
IMR90|chr17:30978098-30978127,chr17,30978098,30978127,IMR90|chr17:1360611-1360696,chr17,1360611,1360696,0,29617487
IMR90|chr17:31143722-31143816,chr17,31143722,31143816,IMR90|chr17:62501071-62501105,chr17,62501071,62501105,0,31357349
IMR90|chr17:31158447-31158597,chr17,31158447,31158597,IMR90|chr17:74499900-74500050,chr17,74499900,74500050,0,43341453
IMR90|chr17:31197647-31197705,chr17,31197647,31197705,IMR90|chr17:40579012-40579061,chr17,40579012,40579061,0,9381365
IMR90|chr17:31290915-31290956,chr17,31290915,31290956,IMR90|chr17:62656383-62656454,chr17,62656383,62656454,0,31365468
IMR90|chr17:31540872-31540934,chr17,31540872,31540934,IMR90|chr17:55929708-55929802,chr17,55929708,55929802,0,24388836
IMR90|chr17:31542496-31542522,chr17,31542496,31542522,IMR90|chr17:62653528-62653635,chr17,62653528,62653635,0,31111032
IMR90|chr17:31646430-31646483,chr17,31646430,31646483,IMR90|chr17:19289328-19289471,chr17,19289328,19289471,0,12357102
IMR90|chr17:31757226-31757280,chr17,31757226,31757280,IMR90|chr17:62655172-62655239,chr17,62655172,62655239,0,30897946
IMR90|chr17:31982259-31982374,chr17,31982259,31982374,IMR90|chr17:38600425-38600460,chr17,38600425,38600460,0,6618166
IMR90|chr17:32233145-32233240,chr17,32233145,32233240,IMR90|chr17:62654087-62654111,chr17,62654087,62654111,0,30420942
IMR90|chr17:32300558-32300641,chr17,32300558,32300641,IMR90|chr17:39973084-39973151,chr17,39973084,39973151,0,7672526
IMR90|chr17:32392310-32392329,chr17,32392310,32392329,IMR90|chr17:74099047-74099160,chr17,74099047,74099160,0,41706737
IMR90|chr17:32523591-32523741,chr17,32523591,32523741,IMR90|chr17:26548914-26549053,chr17,26548914,26549053,0,5974677
IMR90|chr17:32548235-32548313,chr17,32548235,32548313,IMR90|chr17:62658288-62658318,chr17,62658288,62658318,0,30110053
IMR90|chr17:32746040-32746116,chr17,32746040,32746116,IMR90|chr17:62497619-62497663,chr17,62497619,62497663,0,29751579
IMR90|chr17:32766376-32766465,chr17,32766376,32766465,IMR90|chr17:59484214-59484235,chr17,59484214,59484235,0,26717838
IMR90|chr17:32850926-32850946,chr17,32850926,32850946,IMR90|chr17:38603053-38603094,chr17,38603053,38603094,0,5752127
IMR90|chr17:32875988-32876088,chr17,32875988,32876088,IMR90|chr17:38603218-38603266,chr17,38603218,38603266,0,5727230
IMR90|chr17:32969355-32969422,chr17,32969355,32969422,IMR90|chr17:40165032-40165098,chr17,40165032,40165098,0,7195677
IMR90|chr17:33010733-33010752,chr17,33010733,33010752,IMR90|chr17:80186961-80187049,chr17,80186961,80187049,0,47176228
IMR90|chr17:33040087-33040167,chr17,33040087,33040167,IMR90|chr17:80408177-80408261,chr17,80408177,80408261,0,47368090
IMR90|chr17:33092264-33092333,chr17,33092264,33092333,IMR90|chr17:62489697-62489768,chr17,62489697,62489768,0,29397433
IMR90|chr17:33158236-33158272,chr17,33158236,33158272,IMR90|chr17:28615855-28615943,chr17,28615855,28615943,0,4542381
IMR90|chr17:33325424-33325523,chr17,33325424,33325523,IMR90|chr17:45726166-45726201,chr17,45726166,45726201,0,12400742
IMR90|chr17:33475585-33475638,chr17,33475585,33475638,IMR90|chr17:41151602-41151654,chr17,41151602,41151654,0,7676017
IMR90|chr17:33584395-33584490,chr17,33584395,33584490,IMR90|chr17:62654087-62654111,chr17,62654087,62654111,0,29069692
IMR90|chr17:33793762-33793783,chr17,33793762,33793783,IMR90|chr17:62658307-62658420,chr17,62658307,62658420,0,28864545
IMR90|chr17:33849683-33849718,chr17,33849683,33849718,IMR90|chr17:62505377-62505464,chr17,62505377,62505464,0,28655694
IMR90|chr17:34150432-34150544,chr17,34150432,34150544,IMR90|chr17:75316780-75316877,chr17,75316780,75316877,0,41166348
IMR90|chr17:34284975-34285032,chr17,34284975,34285032,IMR90|chr17:48942185-48942257,chr17,48942185,48942257,0,14657210
IMR90|chr17:34463505-34463539,chr17,34463505,34463539,IMR90|chr17:62656069-62656172,chr17,62656069,62656172,0,28192564
IMR90|chr17:34499196-34499259,chr17,34499196,34499259,IMR90|chr17:59472895-59472977,chr17,59472895,59472977,0,24973699
IMR90|chr17:34533104-34533134,chr17,34533104,34533134,IMR90|chr17:62915433-62915506,chr17,62915433,62915506,0,28382329
IMR90|chr17:34639111-34639164,chr17,34639111,34639164,IMR90|chr17:40166287-40166384,chr17,40166287,40166384,0,5527176
IMR90|chr17:34689923-34689947,chr17,34689923,34689947,IMR90|chr17:75449773-75449847,chr17,75449773,75449847,0,40759850
IMR90|chr17:34717837-34717938,chr17,34717837,34717938,IMR90|chr17:65373436-65373469,chr17,65373436,65373469,0,30655599
IMR90|chr17:34903380-34903474,chr17,34903380,34903474,IMR90|chr17:28616663-28616698,chr17,28616663,28616698,0,6286717
IMR90|chr17:34981395-34981477,chr17,34981395,34981477,IMR90|chr17:38601799-38601903,chr17,38601799,38601903,0,3620404
IMR90|chr17:34986819-34986863,chr17,34986819,34986863,IMR90|chr17:62915371-62915486,chr17,62915371,62915486,0,27928552
IMR90|chr17:35111563-35111608,chr17,35111563,35111608,IMR90|chr17:75449773-75449847,chr17,75449773,75449847,0,40338210
IMR90|chr17:35254533-35254593,chr17,35254533,35254593,IMR90|chr17:48942185-48942257,chr17,48942185,48942257,0,13687652
IMR90|chr17:35316331-35316456,chr17,35316331,35316456,IMR90|chr17:62658145-62658266,chr17,62658145,62658266,0,27341814
IMR90|chr17:35496973-35497000,chr17,35496973,35497000,IMR90|chr17:62657316-62657389,chr17,62657316,62657389,0,27160343
IMR90|chr17:35572066-35572127,chr17,35572066,35572127,IMR90|chr17:16259309-16259386,chr17,16259309,16259386,0,19312757
IMR90|chr17:35681953-35681990,chr17,35681953,35681990,IMR90|chr17:62656789-62656896,chr17,62656789,62656896,0,26974836
IMR90|chr17:35759540-35759669,chr17,35759540,35759669,IMR90|chr17:43024258-43024279,chr17,43024258,43024279,0,7264718
IMR90|chr17:35832452-35832568,chr17,35832452,35832568,IMR90|chr17:55930204-55930292,chr17,55930204,55930292,0,20097752
IMR90|chr17:35969970-35970043,chr17,35969970,35970043,IMR90|chr17:27072998-27073021,chr17,27072998,27073021,0,8896972
IMR90|chr17:36125258-36125328,chr17,36125258,36125328,IMR90|chr17:62504434-62504514,chr17,62504434,62504514,0,26379176
IMR90|chr17:36235268-36235341,chr17,36235268,36235341,IMR90|chr17:38600440-38600481,chr17,38600440,38600481,0,2365172
IMR90|chr17:36343299-36343327,chr17,36343299,36343327,IMR90|chr17:75373441-75373458,chr17,75373441,75373458,0,39030142
IMR90|chr17:36354946-36355000,chr17,36354946,36355000,IMR90|chr17:62657442-62657482,chr17,62657442,62657482,0,26302496
IMR90|chr17:36561287-36561367,chr17,36561287,36561367,IMR90|chr17:38604436-38604474,chr17,38604436,38604474,0,2043149
IMR90|chr17:36564250-36564358,chr17,36564250,36564358,IMR90|chr17:39973084-39973151,chr17,39973084,39973151,0,3408834
IMR90|chr17:36567101-36567194,chr17,36567101,36567194,IMR90|chr17:38601736-38601793,chr17,38601736,38601793,0,2034635
IMR90|chr17:36579627-36579771,chr17,36579627,36579771,IMR90|chr17:74499923-74500072,chr17,74499923,74500072,0,37920296
IMR90|chr17:36602084-36602107,chr17,36602084,36602107,IMR90|chr17:80232253-80232341,chr17,80232253,80232341,0,43630169
IMR90|chr17:36836381-36836513,chr17,36836381,36836513,IMR90|chr17:38600425-38600460,chr17,38600425,38600460,0,1764044
IMR90|chr17:36853952-36853969,chr17,36853952,36853969,IMR90|chr17:80186961-80187049,chr17,80186961,80187049,0,43333009
IMR90|chr17:37062630-37062691,chr17,37062630,37062691,IMR90|chr17:7310796-7310878,chr17,7310796,7310878,0,29751834
IMR90|chr17:37072790-37072848,chr17,37072790,37072848,IMR90|chr17:40579012-40579061,chr17,40579012,40579061,0,3506222
IMR90|chr17:37163524-37163640,chr17,37163524,37163640,IMR90|chr17:1618338-1618372,chr17,1618338,1618372,0,35545186
IMR90|chr17:37286379-37286454,chr17,37286379,37286454,IMR90|chr17:34137377-34137425,chr17,34137377,34137425,0,3149002
IMR90|chr17:37290773-37290834,chr17,37290773,37290834,IMR90|chr17:16294232-16294270,chr17,16294232,16294270,0,20996541
IMR90|chr17:37394572-37394638,chr17,37394572,37394638,IMR90|chr17:40165032-40165099,chr17,40165032,40165099,0,2770460
IMR90|chr17:37420265-37420286,chr17,37420265,37420286,IMR90|chr17:62658307-62658420,chr17,62658307,62658420,0,25238042
IMR90|chr17:37425855-37425891,chr17,37425855,37425891,IMR90|chr17:80189774-80189862,chr17,80189774,80189862,0,42763919
IMR90|chr17:37623742-37623835,chr17,37623742,37623835,IMR90|chr17:38601736-38601793,chr17,38601736,38601793,0,977994
IMR90|chr17:37679112-37679175,chr17,37679112,37679175,IMR90|chr17:40166289-40166384,chr17,40166289,40166384,0,2487177
IMR90|chr17:37795211-37795266,chr17,37795211,37795266,IMR90|chr17:73177947-73178025,chr17,73177947,73178025,0,35382736
IMR90|chr17:37955291-37955334,chr17,37955291,37955334,IMR90|chr17:16942814-16942918,chr17,16942814,16942918,0,21012477
IMR90|chr17:38015505-38015560,chr17,38015505,38015560,IMR90|chr17:18087497-18087571,chr17,18087497,18087571,0,19928008
IMR90|chr17:38046984-38047029,chr17,38046984,38047029,IMR90|chr17:38601749-38601820,chr17,38601749,38601820,0,554765
IMR90|chr17:38123899-38123965,chr17,38123899,38123965,IMR90|chr17:61048364-61048396,chr17,61048364,61048396,0,22924465
IMR90|chr17:38333554-38333617,chr17,38333554,38333617,IMR90|chr17:16283642-16283695,chr17,16283642,16283695,0,22049912
IMR90|chr17:38673328-38673386,chr17,38673328,38673386,IMR90|chr17:73177947-73178025,chr17,73177947,73178025,0,34504619
IMR90|chr17:38812878-38812939,chr17,38812878,38812939,IMR90|chr17:47437914-47438001,chr17,47437914,47438001,0,8625036
IMR90|chr17:39031985-39032070,chr17,39031985,39032070,IMR90|chr17:48135176-48135219,chr17,48135176,48135219,0,9103191
IMR90|chr17:39063399-39063453,chr17,39063399,39063453,IMR90|chr17:62655172-62655239,chr17,62655172,62655239,0,23591773
IMR90|chr17:39184442-39184583,chr17,39184442,39184583,IMR90|chr17:40579632-40579719,chr17,40579632,40579719,0,1395190
IMR90|chr17:39282604-39282656,chr17,39282604,39282656,IMR90|chr17:75373356-75373454,chr17,75373356,75373454,0,36090752
IMR90|chr17:39305273-39305333,chr17,39305273,39305333,IMR90|chr17:26548915-26549022,chr17,26548915,26549022,0,12756358
IMR90|chr17:39572887-39573037,chr17,39572887,39573037,IMR90|chr17:26548914-26549053,chr17,26548914,26549053,0,13023973
IMR90|chr17:39617733-39617786,chr17,39617733,39617786,IMR90|chr17:39971186-39971280,chr17,39971186,39971280,0,353453
IMR90|chr17:39702559-39702599,chr17,39702559,39702599,IMR90|chr17:7310956-7311001,chr17,7310956,7311001,0,32391603
IMR90|chr17:39708548-39708671,chr17,39708548,39708671,IMR90|chr17:73083107-73083252,chr17,73083107,73083252,0,33374559
IMR90|chr17:39958741-39958787,chr17,39958741,39958787,IMR90|chr17:38601799-38601903,chr17,38601799,38601903,0,1356942
IMR90|chr17:39964603-39964673,chr17,39964603,39964673,IMR90|chr17:76783093-76783163,chr17,76783093,76783163,0,36818490
IMR90|chr17:40079056-40079156,chr17,40079056,40079156,IMR90|chr17:34959293-34959339,chr17,34959293,34959339,0,5119763
IMR90|chr17:40079279-40079339,chr17,40079279,40079339,IMR90|chr17:38604537-38604687,chr17,38604537,38604687,0,1474742
IMR90|chr17:40095622-40095665,chr17,40095622,40095665,IMR90|chr17:38604220-38604367,chr17,38604220,38604367,0,1491402
IMR90|chr17:40098583-40098656,chr17,40098583,40098656,IMR90|chr17:75448526-75448579,chr17,75448526,75448579,0,35349943
IMR90|chr17:40115437-40115531,chr17,40115437,40115531,IMR90|chr17:21187460-21187514,chr17,21187460,21187514,0,18927977
IMR90|chr17:40172636-40172720,chr17,40172636,40172720,IMR90|chr17:48135176-48135219,chr17,48135176,48135219,0,7962540
IMR90|chr17:40493513-40493660,chr17,40493513,40493660,IMR90|chr17:42419777-42419896,chr17,42419777,42419896,0,1926264
IMR90|chr17:40496450-40496582,chr17,40496450,40496582,IMR90|chr17:8097210-8097274,chr17,8097210,8097274,0,32399240
IMR90|chr17:40587757-40587800,chr17,40587757,40587800,IMR90|chr17:40074833-40074873,chr17,40074833,40074873,0,512924
IMR90|chr17:40657671-40657770,chr17,40657671,40657770,IMR90|chr17:45726166-45726201,chr17,45726166,45726201,0,5068495
IMR90|chr17:40736522-40736556,chr17,40736522,40736556,IMR90|chr17:76163075-76163182,chr17,76163075,76163182,0,35426553
IMR90|chr17:40945584-40945641,chr17,40945584,40945641,IMR90|chr17:40426519-40426572,chr17,40426519,40426572,0,519065
IMR90|chr17:41078951-41079053,chr17,41078951,41079053,IMR90|chr17:74499897-74500047,chr17,74499897,74500047,0,33420946
IMR90|chr17:41105517-41105571,chr17,41105517,41105571,IMR90|chr17:62656377-62656443,chr17,62656377,62656443,0,21550860
IMR90|chr17:41133115-41133231,chr17,41133115,41133231,IMR90|chr17:55930204-55930292,chr17,55930204,55930292,0,14797089
IMR90|chr17:41135350-41135374,chr17,41135350,41135374,IMR90|chr17:75319463-75319578,chr17,75319463,75319578,0,34184113
IMR90|chr17:41195858-41195918,chr17,41195858,41195918,IMR90|chr17:38604537-38604687,chr17,38604537,38604687,0,2591321
IMR90|chr17:41226119-41226184,chr17,41226119,41226184,IMR90|chr17:80170000-80170065,chr17,80170000,80170065,0,38943881
IMR90|chr17:41363057-41363207,chr17,41363057,41363207,IMR90|chr17:62655288-62655307,chr17,62655288,62655307,0,21292231
IMR90|chr17:41409559-41409582,chr17,41409559,41409582,IMR90|chr17:46648931-46649026,chr17,46648931,46649026,0,5239372
IMR90|chr17:41420985-41421058,chr17,41420985,41421058,IMR90|chr17:2308195-2308267,chr17,2308195,2308267,0,39112790
IMR90|chr17:41422126-41422213,chr17,41422126,41422213,IMR90|chr17:62662214-62662277,chr17,62662214,62662277,0,21240088
IMR90|chr17:41444459-41444511,chr17,41444459,41444511,IMR90|chr17:16942814-16942918,chr17,16942814,16942918,0,24501645
IMR90|chr17:41536098-41536175,chr17,41536098,41536175,IMR90|chr17:41323364-41323411,chr17,41323364,41323411,0,212734
IMR90|chr17:41601925-41601962,chr17,41601925,41601962,IMR90|chr17:26548915-26549028,chr17,26548915,26549028,0,15053010
IMR90|chr17:41768504-41768547,chr17,41768504,41768547,IMR90|chr17:38604220-38604367,chr17,38604220,38604367,0,3164284
IMR90|chr17:42111190-42111249,chr17,42111190,42111249,IMR90|chr17:48942185-48942257,chr17,48942185,48942257,0,6830995
IMR90|chr17:42375501-42375538,chr17,42375501,42375538,IMR90|chr17:62656789-62656896,chr17,62656789,62656896,0,20281288
IMR90|chr17:42426502-42426557,chr17,42426502,42426557,IMR90|chr17:60143258-60143318,chr17,60143258,60143318,0,17716756
IMR90|chr17:42430577-42430713,chr17,42430577,42430713,IMR90|chr17:43024258-43024279,chr17,43024258,43024279,0,593681
IMR90|chr17:42647270-42647332,chr17,42647270,42647332,IMR90|chr17:75374155-75374224,chr17,75374155,75374224,0,32726885
IMR90|chr17:42656564-42656668,chr17,42656564,42656668,IMR90|chr17:56429261-56429307,chr17,56429261,56429307,0,13772697
IMR90|chr17:42676181-42676279,chr17,42676181,42676279,IMR90|chr17:17589719-17589856,chr17,17589719,17589856,0,25086462
IMR90|chr17:42756420-42756449,chr17,42756420,42756449,IMR90|chr17:48543444-48543529,chr17,48543444,48543529,0,5787024
IMR90|chr17:42865047-42865091,chr17,42865047,42865091,IMR90|chr17:62495108-62495181,chr17,62495108,62495181,0,19630061
IMR90|chr17:42869952-42870086,chr17,42869952,42870086,IMR90|chr17:40575653-40575690,chr17,40575653,40575690,0,2294299
IMR90|chr17:42872199-42872270,chr17,42872199,42872270,IMR90|chr17:35852353-35852418,chr17,35852353,35852418,0,7019846
IMR90|chr17:42895788-42895851,chr17,42895788,42895851,IMR90|chr17:78230110-78230140,chr17,78230110,78230140,0,35334322
IMR90|chr17:42935568-42935677,chr17,42935568,42935677,IMR90|chr17:45726166-45726201,chr17,45726166,45726201,0,2790598
IMR90|chr17:42947177-42947211,chr17,42947177,42947211,IMR90|chr17:76163075-76163182,chr17,76163075,76163182,0,33215898
IMR90|chr17:42965658-42965808,chr17,42965658,42965808,IMR90|chr17:38603923-38603948,chr17,38603923,38603948,0,4361735
IMR90|chr17:42996429-42996579,chr17,42996429,42996579,IMR90|chr17:59479992-59480023,chr17,59479992,59480023,0,16483563
IMR90|chr17:43083141-43083234,chr17,43083141,43083234,IMR90|chr17:27042253-27042339,chr17,27042253,27042339,0,16040888
IMR90|chr17:43195517-43195649,chr17,43195517,43195649,IMR90|chr17:8097210-8097274,chr17,8097210,8097274,0,35098307
IMR90|chr17:43338767-43338844,chr17,43338767,43338844,IMR90|chr17:41323364-41323411,chr17,41323364,41323411,0,2015403
IMR90|chr17:43661453-43661503,chr17,43661453,43661503,IMR90|chr17:62657442-62657482,chr17,62657442,62657482,0,18995989
IMR90|chr17:43758035-43758147,chr17,43758035,43758147,IMR90|chr17:45726166-45726201,chr17,45726166,45726201,0,1968131
IMR90|chr17:43787787-43787835,chr17,43787787,43787835,IMR90|chr17:27072999-27073021,chr17,27072999,27073021,0,16714788
IMR90|chr17:43789756-43789801,chr17,43789756,43789801,IMR90|chr17:78390116-78390197,chr17,78390116,78390197,0,34600360
IMR90|chr17:43883403-43883457,chr17,43883403,43883457,IMR90|chr17:61675552-61675646,chr17,61675552,61675646,0,17792149
IMR90|chr17:44130761-44130823,chr17,44130761,44130823,IMR90|chr17:62504217-62504301,chr17,62504217,62504301,0,18373456
IMR90|chr17:44142518-44142604,chr17,44142518,44142604,IMR90|chr17:2308123-2308188,chr17,2308123,2308188,0,41834395
IMR90|chr17:44266195-44266235,chr17,44266195,44266235,IMR90|chr17:62656383-62656454,chr17,62656383,62656454,0,18390188
IMR90|chr17:44297954-44297994,chr17,44297954,44297994,IMR90|chr17:1360610-1360718,chr17,1360610,1360718,0,42937344
IMR90|chr17:44389133-44389150,chr17,44389133,44389150,IMR90|chr17:80186961-80187049,chr17,80186961,80187049,0,35797828
IMR90|chr17:44505456-44505483,chr17,44505456,44505483,IMR90|chr17:26548915-26549014,chr17,26548915,26549014,0,17956541
IMR90|chr17:44663494-44663560,chr17,44663494,44663560,IMR90|chr17:80170001-80170066,chr17,80170001,80170066,0,35506507
IMR90|chr17:44674300-44674345,chr17,44674300,44674345,IMR90|chr17:56061325-56061475,chr17,56061325,56061475,0,11387025
IMR90|chr17:44728139-44728229,chr17,44728139,44728229,IMR90|chr17:61047821-61047861,chr17,61047821,61047861,0,16319682
IMR90|chr17:44748500-44748584,chr17,44748500,44748584,IMR90|chr17:48135176-48135219,chr17,48135176,48135219,0,3386676
IMR90|chr17:44779606-44779640,chr17,44779606,44779640,IMR90|chr17:27052202-27052281,chr17,27052202,27052281,0,17727404
IMR90|chr17:44822030-44822085,chr17,44822030,44822085,IMR90|chr17:18087497-18087571,chr17,18087497,18087571,0,26734533
IMR90|chr17:44883341-44883380,chr17,44883341,44883380,IMR90|chr17:7310956-7311001,chr17,7310956,7311001,0,37572385
IMR90|chr17:44910576-44910678,chr17,44910576,44910678,IMR90|chr17:80234709-80234793,chr17,80234709,80234793,0,35324133
IMR90|chr17:45019377-45019416,chr17,45019377,45019416,IMR90|chr17:26548915-26549026,chr17,26548915,26549026,0,18470462
IMR90|chr17:45028546-45028661,chr17,45028546,45028661,IMR90|chr17:1618338-1618372,chr17,1618338,1618372,0,43410208
IMR90|chr17:45038833-45038918,chr17,45038833,45038918,IMR90|chr17:48135176-48135219,chr17,48135176,48135219,0,3096343
IMR90|chr17:45078015-45078141,chr17,45078015,45078141,IMR90|chr17:40572558-40572595,chr17,40572558,40572595,0,4505457
IMR90|chr17:45207189-45207247,chr17,45207189,45207247,IMR90|chr17:38600901-38600986,chr17,38600901,38600986,0,6606288
IMR90|chr17:45242789-45242888,chr17,45242789,45242888,IMR90|chr17:4844953-4844999,chr17,4844953,4844999,0,40397836
IMR90|chr17:45342886-45342919,chr17,45342886,45342919,IMR90|chr17:40608104-40608162,chr17,40608104,40608162,0,4734782
IMR90|chr17:45358590-45358713,chr17,45358590,45358713,IMR90|chr17:26548915-26548938,chr17,26548915,26548938,0,18809675
IMR90|chr17:45443012-45443080,chr17,45443012,45443080,IMR90|chr17:38601144-38601237,chr17,38601144,38601237,0,6841868
IMR90|chr17:45673327-45673353,chr17,45673327,45673353,IMR90|chr17:38603528-38603568,chr17,38603528,38603568,0,7069799
IMR90|chr17:45683555-45683645,chr17,45683555,45683645,IMR90|chr17:61047821-61047861,chr17,61047821,61047861,0,15364266
IMR90|chr17:45683665-45683726,chr17,45683665,45683726,IMR90|chr17:16259309-16259386,chr17,16259309,16259386,0,29424356
IMR90|chr17:45906061-45906112,chr17,45906061,45906112,IMR90|chr17:56062175-56062254,chr17,56062175,56062254,0,10156114
IMR90|chr17:45909296-45909378,chr17,45909296,45909378,IMR90|chr17:40166666-40166722,chr17,40166666,40166722,0,5742630
IMR90|chr17:45914921-45914997,chr17,45914921,45914997,IMR90|chr17:38603403-38603473,chr17,38603403,38603473,0,7311518
IMR90|chr17:46115620-46115673,chr17,46115620,46115673,IMR90|chr17:62657442-62657482,chr17,62657442,62657482,0,16541822
IMR90|chr17:46170058-46170118,chr17,46170058,46170118,IMR90|chr17:8054163-8054196,chr17,8054163,8054196,0,38115895
IMR90|chr17:46325511-46325607,chr17,46325511,46325607,IMR90|chr17:62654087-62654111,chr17,62654087,62654111,0,16328576
IMR90|chr17:46449115-46449142,chr17,46449115,46449142,IMR90|chr17:8103941-8104091,chr17,8103941,8104091,0,38345174
IMR90|chr17:46460883-46460944,chr17,46460883,46460944,IMR90|chr17:16294232-16294270,chr17,16294232,16294270,0,30166651
IMR90|chr17:46641904-46641935,chr17,46641904,46641935,IMR90|chr17:33468031-33468181,chr17,33468031,33468181,0,13173873
IMR90|chr17:46772318-46772344,chr17,46772318,46772344,IMR90|chr17:38523742-38523860,chr17,38523742,38523860,0,8248576
IMR90|chr17:46833222-46833254,chr17,46833222,46833254,IMR90|chr17:62915431-62915572,chr17,62915431,62915572,0,16082209
IMR90|chr17:46897929-46897962,chr17,46897929,46897962,IMR90|chr17:78195044-78195103,chr17,78195044,78195103,0,31297115
IMR90|chr17:46928381-46928441,chr17,46928381,46928441,IMR90|chr17:39966720-39966810,chr17,39966720,39966810,0,6961661
IMR90|chr17:46947825-46947921,chr17,46947825,46947921,IMR90|chr17:62654087-62654111,chr17,62654087,62654111,0,15706262
IMR90|chr17:46988411-46988530,chr17,46988411,46988530,IMR90|chr17:62661275-62661306,chr17,62661275,62661306,0,15672864
IMR90|chr17:47117479-47117522,chr17,47117479,47117522,IMR90|chr17:41855216-41855323,chr17,41855216,41855323,0,5262263
IMR90|chr17:47125961-47125983,chr17,47125961,47125983,IMR90|chr17:62658307-62658420,chr17,62658307,62658420,0,15532346
IMR90|chr17:47138681-47138718,chr17,47138681,47138718,IMR90|chr17:62656349-62656499,chr17,62656349,62656499,0,15517668
IMR90|chr17:47201508-47201597,chr17,47201508,47201597,IMR90|chr17:61047821-61047861,chr17,61047821,61047861,0,13846313
IMR90|chr17:47371166-47371236,chr17,47371166,47371236,IMR90|chr17:47075292-47075322,chr17,47075292,47075322,0,295874
IMR90|chr17:47436338-47436362,chr17,47436338,47436362,IMR90|chr17:39969615-39969703,chr17,39969615,39969703,0,7466723
IMR90|chr17:47553832-47553899,chr17,47553832,47553899,IMR90|chr17:40165032-40165098,chr17,40165032,40165098,0,7388800
IMR90|chr17:47598059-47598156,chr17,47598059,47598156,IMR90|chr17:62655274-62655359,chr17,62655274,62655359,0,15057215
IMR90|chr17:47665636-47665659,chr17,47665636,47665659,IMR90|chr17:38442813-38442863,chr17,38442813,38442863,0,9222823
IMR90|chr17:47677141-47677174,chr17,47677141,47677174,IMR90|chr17:62657889-62657976,chr17,62657889,62657976,0,14980748
IMR90|chr17:47746258-47746287,chr17,47746258,47746287,IMR90|chr17:33468031-33468181,chr17,33468031,33468181,0,14278227
IMR90|chr17:47881510-47881545,chr17,47881510,47881545,IMR90|chr17:38603242-38603386,chr17,38603242,38603386,0,9278268
IMR90|chr17:47886680-47886799,chr17,47886680,47886799,IMR90|chr17:59479992-59480023,chr17,59479992,59480023,0,11593312
IMR90|chr17:48006632-48006692,chr17,48006632,48006692,IMR90|chr17:30772202-30772308,chr17,30772202,30772308,0,17234430
IMR90|chr17:48082880-48082936,chr17,48082880,48082936,IMR90|chr17:55929708-55929802,chr17,55929708,55929802,0,7846828
IMR90|chr17:48088379-48088488,chr17,48088379,48088488,IMR90|chr17:45726166-45726201,chr17,45726166,45726201,0,2362213
IMR90|chr17:48213733-48213859,chr17,48213733,48213859,IMR90|chr17:62661726-62661750,chr17,62661726,62661750,0,14447993
IMR90|chr17:48256635-48256656,chr17,48256635,48256656,IMR90|chr17:62491211-62491311,chr17,62491211,62491311,0,14234576
IMR90|chr17:48350242-48350298,chr17,48350242,48350298,IMR90|chr17:40426519-40426572,chr17,40426519,40426572,0,7923723
IMR90|chr17:48456619-48456648,chr17,48456619,48456648,IMR90|chr17:38602896-38602970,chr17,38602896,38602970,0,9853723
IMR90|chr17:48613640-48613701,chr17,48613640,48613701,IMR90|chr17:7479422-7479480,chr17,7479422,7479480,0,41134218
IMR90|chr17:48758691-48758724,chr17,48758691,48758724,IMR90|chr17:76163075-76163182,chr17,76163075,76163182,0,27404384
IMR90|chr17:48893664-48893773,chr17,48893664,48893773,IMR90|chr17:48543477-48543566,chr17,48543477,48543566,0,350187
IMR90|chr17:48922414-48922433,chr17,48922414,48922433,IMR90|chr17:74099047-74099160,chr17,74099047,74099160,0,25176633
IMR90|chr17:48923542-48923692,chr17,48923542,48923692,IMR90|chr17:59479992-59480023,chr17,59479992,59480023,0,10556450
IMR90|chr17:48968119-48968215,chr17,48968119,48968215,IMR90|chr17:62915314-62915422,chr17,62915314,62915422,0,13947195
IMR90|chr17:49113265-49113415,chr17,49113265,49113415,IMR90|chr17:62915464-62915583,chr17,62915464,62915583,0,13802199
IMR90|chr17:49272171-49272192,chr17,49272171,49272192,IMR90|chr17:40166666-40166722,chr17,40166666,40166722,0,9105505
IMR90|chr17:49408941-49408965,chr17,49408941,49408965,IMR90|chr17:40074833-40074873,chr17,40074833,40074873,0,9334108
IMR90|chr17:49489489-49489553,chr17,49489489,49489553,IMR90|chr17:79534358-79534442,chr17,79534358,79534442,0,30044869
IMR90|chr17:49504533-49504593,chr17,49504533,49504593,IMR90|chr17:61047275-61047324,chr17,61047275,61047324,0,11542742
IMR90|chr17:49506406-49506461,chr17,49506406,49506461,IMR90|chr17:62655228-62655301,chr17,62655228,62655301,0,13148822
IMR90|chr17:49509010-49509065,chr17,49509010,49509065,IMR90|chr17:73177947-73178025,chr17,73177947,73178025,0,23668937
IMR90|chr17:49875446-49875504,chr17,49875446,49875504,IMR90|chr17:62915464-62915600,chr17,62915464,62915600,0,13040018
IMR90|chr17:50075924-50076001,chr17,50075924,50076001,IMR90|chr17:40572095-40572122,chr17,40572095,40572122,0,9503829
IMR90|chr17:50201921-50202071,chr17,50201921,50202071,IMR90|chr17:26548915-26549013,chr17,26548915,26549013,0,23653006
IMR90|chr17:50298404-50298488,chr17,50298404,50298488,IMR90|chr17:8113194-8113233,chr17,8113194,8113233,0,42185210
IMR90|chr17:50352258-50352294,chr17,50352258,50352294,IMR90|chr17:17874839-17874867,chr17,17874839,17874867,0,32477419
IMR90|chr17:50491521-50491620,chr17,50491521,50491620,IMR90|chr17:28444845-28444866,chr17,28444845,28444866,0,22046676
IMR90|chr17:50574254-50574277,chr17,50574254,50574277,IMR90|chr17:75319942-75320012,chr17,75319942,75320012,0,24745688
IMR90|chr17:50587912-50587956,chr17,50587912,50587956,IMR90|chr17:40543005-40543155,chr17,40543005,40543155,0,10044907
IMR90|chr17:50807162-50807199,chr17,50807162,50807199,IMR90|chr17:72771528-72771601,chr17,72771528,72771601,0,21964366
IMR90|chr17:50842754-50842807,chr17,50842754,50842807,IMR90|chr17:39971186-39971280,chr17,39971186,39971280,0,10871568
IMR90|chr17:50881935-50881970,chr17,50881935,50881970,IMR90|chr17:38603242-38603386,chr17,38603242,38603386,0,12278693
IMR90|chr17:51168845-51168917,chr17,51168845,51168917,IMR90|chr17:62656036-62656104,chr17,62656036,62656104,0,11487191
IMR90|chr17:51184998-51185148,chr17,51184998,51185148,IMR90|chr17:62504434-62504514,chr17,62504434,62504514,0,11319436
IMR90|chr17:51255918-51255959,chr17,51255918,51255959,IMR90|chr17:41853202-41853326,chr17,41853202,41853326,0,9402716
IMR90|chr17:51301004-51301150,chr17,51301004,51301150,IMR90|chr17:66287573-66287670,chr17,66287573,66287670,0,14986569
IMR90|chr17:51321802-51321864,chr17,51321802,51321864,IMR90|chr17:55930204-55930292,chr17,55930204,55930292,0,4608402
IMR90|chr17:51411414-51411459,chr17,51411414,51411459,IMR90|chr17:78390116-78390197,chr17,78390116,78390197,0,26978702
IMR90|chr17:51449565-51449626,chr17,51449565,51449626,IMR90|chr17:73177947-73178025,chr17,73177947,73178025,0,21728382
IMR90|chr17:51534945-51534987,chr17,51534945,51534987,IMR90|chr17:40074833-40074873,chr17,40074833,40074873,0,11460112
IMR90|chr17:51535681-51535774,chr17,51535681,51535774,IMR90|chr17:80232476-80232503,chr17,80232476,80232503,0,28696795
IMR90|chr17:51606088-51606125,chr17,51606088,51606125,IMR90|chr17:40811740-40811837,chr17,40811740,40811837,0,10794348
IMR90|chr17:51772418-51772468,chr17,51772418,51772468,IMR90|chr17:62657442-62657482,chr17,62657442,62657482,0,10885024
IMR90|chr17:51813694-51813770,chr17,51813694,51813770,IMR90|chr17:8113194-8113233,chr17,8113194,8113233,0,43700500
IMR90|chr17:51963998-51964095,chr17,51963998,51964095,IMR90|chr17:62657140-62657176,chr17,62657140,62657176,0,10693142
IMR90|chr17:51976557-51976617,chr17,51976557,51976617,IMR90|chr17:7310796-7310878,chr17,7310796,7310878,0,44665761
IMR90|chr17:51999546-51999654,chr17,51999546,51999654,IMR90|chr17:39973084-39973151,chr17,39973084,39973151,0,12026462
IMR90|chr17:52035695-52035793,chr17,52035695,52035793,IMR90|chr17:62657140-62657176,chr17,62657140,62657176,0,10621445
IMR90|chr17:52182313-52182447,chr17,52182313,52182447,IMR90|chr17:40575653-40575690,chr17,40575653,40575690,0,11606660
IMR90|chr17:52319101-52319167,chr17,52319101,52319167,IMR90|chr17:79534358-79534439,chr17,79534358,79534439,0,27215257
IMR90|chr17:52390718-52390798,chr17,52390718,52390798,IMR90|chr17:79819730-79819767,chr17,79819730,79819767,0,27429012
IMR90|chr17:52474413-52474479,chr17,52474413,52474479,IMR90|chr17:61048364-61048396,chr17,61048364,61048396,0,8573951
IMR90|chr17:52476296-52476438,chr17,52476296,52476438,IMR90|chr17:42277279-42277378,chr17,42277279,42277378,0,10199017
IMR90|chr17:52484528-52484590,chr17,52484528,52484590,IMR90|chr17:55930204-55930292,chr17,55930204,55930292,0,3445676
IMR90|chr17:52531004-52531102,chr17,52531004,52531102,IMR90|chr17:62657140-62657176,chr17,62657140,62657176,0,10126136
IMR90|chr17:52681615-52681656,chr17,52681615,52681656,IMR90|chr17:76779085-76779136,chr17,76779085,76779136,0,24097470
IMR90|chr17:52807496-52807531,chr17,52807496,52807531,IMR90|chr17:62656256-62656368,chr17,62656256,62656368,0,9848760
IMR90|chr17:52816785-52816837,chr17,52816785,52816837,IMR90|chr17:62657409-62657453,chr17,62657409,62657453,0,9840624
IMR90|chr17:52950770-52950800,chr17,52950770,52950800,IMR90|chr17:76163075-76163182,chr17,76163075,76163182,0,23212305
IMR90|chr17:52952668-52952741,chr17,52952668,52952741,IMR90|chr17:75448526-75448579,chr17,75448526,75448579,0,22495858
IMR90|chr17:53035287-53035327,chr17,53035287,53035327,IMR90|chr17:57782183-57782248,chr17,57782183,57782248,0,4746896
IMR90|chr17:53076583-53076624,chr17,53076583,53076624,IMR90|chr17:41853202-41853326,chr17,41853202,41853326,0,11223381
IMR90|chr17:53080262-53080298,chr17,53080262,53080298,IMR90|chr17:4844280-4844339,chr17,4844280,4844339,0,48235982
IMR90|chr17:53082120-53082189,chr17,53082120,53082189,IMR90|chr17:53498279-53498340,chr17,53498279,53498340,0,416159
IMR90|chr17:53128730-53128780,chr17,53128730,53128780,IMR90|chr17:38603886-38603971,chr17,38603886,38603971,0,14524844
IMR90|chr17:53236444-53236483,chr17,53236444,53236483,IMR90|chr17:62657025-62657122,chr17,62657025,62657122,0,9420581
IMR90|chr17:53248260-53248316,chr17,53248260,53248316,IMR90|chr17:39971186-39971280,chr17,39971186,39971280,0,13277074
IMR90|chr17:53448010-53448041,chr17,53448010,53448041,IMR90|chr17:33468031-33468181,chr17,33468031,33468181,0,19979979
IMR90|chr17:53490289-53490328,chr17,53490289,53490328,IMR90|chr17:72771528-72771601,chr17,72771528,72771601,0,19281239
IMR90|chr17:53685148-53685242,chr17,53685148,53685242,IMR90|chr17:62501071-62501105,chr17,62501071,62501105,0,8815923
IMR90|chr17:53769895-53769934,chr17,53769895,53769934,IMR90|chr17:38522877-38522915,chr17,38522877,38522915,0,15247018
IMR90|chr17:53804031-53804122,chr17,53804031,53804122,IMR90|chr17:62654259-62654308,chr17,62654259,62654308,0,8850228
IMR90|chr17:53947187-53947239,chr17,53947187,53947239,IMR90|chr17:62657409-62657453,chr17,62657409,62657453,0,8710222
IMR90|chr17:54042643-54042725,chr17,54042643,54042725,IMR90|chr17:74499900-74500050,chr17,74499900,74500050,0,20457257
IMR90|chr17:54058189-54058229,chr17,54058189,54058229,IMR90|chr17:38603886-38603971,chr17,38603886,38603971,0,15454303
IMR90|chr17:54059842-54059902,chr17,54059842,54059902,IMR90|chr17:38602049-38602119,chr17,38602049,38602119,0,15457793
IMR90|chr17:54068359-54068413,chr17,54068359,54068413,IMR90|chr17:62655180-62655238,chr17,62655180,62655238,0,8586821
IMR90|chr17:54102466-54102526,chr17,54102466,54102526,IMR90|chr17:16259310-16259386,chr17,16259310,16259386,0,37843156
IMR90|chr17:54251219-54251276,chr17,54251219,54251276,IMR90|chr17:48473180-48473242,chr17,48473180,48473242,0,5778039
IMR90|chr17:54454327-54454363,chr17,54454327,54454363,IMR90|chr17:79980462-79980539,chr17,79980462,79980539,0,25526135
IMR90|chr17:54505420-54505502,chr17,54505420,54505502,IMR90|chr17:74499900-74500050,chr17,74499900,74500050,0,19994480
IMR90|chr17:54511193-54511222,chr17,54511193,54511222,IMR90|chr17:38600440-38600481,chr17,38600440,38600481,0,15910753
IMR90|chr17:54518822-54518874,chr17,54518822,54518874,IMR90|chr17:16942814-16942918,chr17,16942814,16942918,0,37576008
IMR90|chr17:54532701-54532848,chr17,54532701,54532848,IMR90|chr17:42419777-42419896,chr17,42419777,42419896,0,12112924
IMR90|chr17:54653846-54653941,chr17,54653846,54653941,IMR90|chr17:79534358-79534442,chr17,79534358,79534442,0,24880512
IMR90|chr17:54874500-54874540,chr17,54874500,54874540,IMR90|chr17:79819529-79819601,chr17,79819529,79819601,0,24945029
IMR90|chr17:54998173-54998228,chr17,54998173,54998228,IMR90|chr17:62655228-62655301,chr17,62655228,62655301,0,7657055
IMR90|chr17:55029051-55029165,chr17,55029051,55029165,IMR90|chr17:57781427-57781463,chr17,57781427,57781463,0,2752376
IMR90|chr17:55102404-55102439,chr17,55102404,55102439,IMR90|chr17:59474917-59475044,chr17,59474917,59475044,0,4372513
IMR90|chr17:55136115-55136180,chr17,55136115,55136180,IMR90|chr17:62655274-62655359,chr17,62655274,62655359,0,7519159
IMR90|chr17:55257852-55257908,chr17,55257852,55257908,IMR90|chr17:61675552-61675646,chr17,61675552,61675646,0,6417700
IMR90|chr17:55289293-55289391,chr17,55289293,55289391,IMR90|chr17:26667128-26667163,chr17,26667128,26667163,0,28622165
IMR90|chr17:55436519-55436582,chr17,55436519,55436582,IMR90|chr17:16283642-16283695,chr17,16283642,16283695,0,39152877
IMR90|chr17:55515371-55515442,chr17,55515371,55515442,IMR90|chr17:62657194-62657234,chr17,62657194,62657234,0,7141823
IMR90|chr17:55532583-55532656,chr17,55532583,55532656,IMR90|chr17:38600440-38600481,chr17,38600440,38600481,0,16932143
IMR90|chr17:55550475-55550505,chr17,55550475,55550505,IMR90|chr17:40572095-40572122,chr17,40572095,40572122,0,14978380
IMR90|chr17:55654393-55654471,chr17,55654393,55654471,IMR90|chr17:8097210-8097274,chr17,8097210,8097274,0,47557183
IMR90|chr17:55660833-55660910,chr17,55660833,55660910,IMR90|chr17:38603403-38603473,chr17,38603403,38603473,0,17057430
IMR90|chr17:55669503-55669574,chr17,55669503,55669574,IMR90|chr17:62657194-62657234,chr17,62657194,62657234,0,6987691
IMR90|chr17:55676596-55676640,chr17,55676596,55676640,IMR90|chr17:36586525-36586582,chr17,36586525,36586582,0,19090071
IMR90|chr17:55815794-55815843,chr17,55815794,55815843,IMR90|chr17:62657025-62657122,chr17,62657025,62657122,0,6841231
IMR90|chr17:55896254-55896281,chr17,55896254,55896281,IMR90|chr17:80188978-80189085,chr17,80188978,80189085,0,24292724
IMR90|chr17:55962390-55962464,chr17,55962390,55962464,IMR90|chr17:38600440-38600481,chr17,38600440,38600481,0,17361950
IMR90|chr17:56076339-56076412,chr17,56076339,56076412,IMR90|chr17:46652375-46652407,chr17,46652375,46652407,0,9423964
IMR90|chr17:56137341-56137378,chr17,56137341,56137378,IMR90|chr17:40811740-40811837,chr17,40811740,40811837,0,15325601
IMR90|chr17:56139996-56140035,chr17,56139996,56140035,IMR90|chr17:76781929-76781960,chr17,76781929,76781960,0,20641933
IMR90|chr17:56141324-56141414,chr17,56141324,56141414,IMR90|chr17:65368719-65368756,chr17,65368719,65368756,0,9227395
IMR90|chr17:56385448-56385533,chr17,56385448,56385533,IMR90|chr17:2308123-2308188,chr17,2308123,2308188,0,54077325
IMR90|chr17:56392956-56393013,chr17,56392956,56393013,IMR90|chr17:48473180-48473242,chr17,48473180,48473242,0,7919776
IMR90|chr17:56457084-56457173,chr17,56457084,56457173,IMR90|chr17:59484214-59484235,chr17,59484214,59484235,0,3027130
IMR90|chr17:56510647-56510671,chr17,56510647,56510671,IMR90|chr17:40074833-40074873,chr17,40074833,40074873,0,16435814
IMR90|chr17:56570884-56570953,chr17,56570884,56570953,IMR90|chr17:27072998-27073021,chr17,27072998,27073021,0,29497886
IMR90|chr17:56666980-56667019,chr17,56666980,56667019,IMR90|chr17:72771528-72771601,chr17,72771528,72771601,0,16104548
IMR90|chr17:56669265-56669330,chr17,56669265,56669330,IMR90|chr17:8054163-8054196,chr17,8054163,8054196,0,48615102
IMR90|chr17:56686424-56686482,chr17,56686424,56686482,IMR90|chr17:40541286-40541315,chr17,40541286,40541315,0,16145138
IMR90|chr17:56727182-56727332,chr17,56727182,56727332,IMR90|chr17:1618338-1618372,chr17,1618338,1618372,0,55108844
IMR90|chr17:56847622-56847717,chr17,56847622,56847717,IMR90|chr17:62662214-62662277,chr17,62662214,62662277,0,5814592
IMR90|chr17:56857618-56857676,chr17,56857618,56857676,IMR90|chr17:73177947-73178025,chr17,73177947,73178025,0,16320329
IMR90|chr17:56895816-56895938,chr17,56895816,56895938,IMR90|chr17:62654324-62654426,chr17,62654324,62654426,0,5758508
IMR90|chr17:57022238-57022334,chr17,57022238,57022334,IMR90|chr17:62915314-62915422,chr17,62915314,62915422,0,5893076
IMR90|chr17:57038266-57038290,chr17,57038266,57038290,IMR90|chr17:78193183-78193333,chr17,78193183,78193333,0,21154917
IMR90|chr17:57062777-57062807,chr17,57062777,57062807,IMR90|chr17:62915433-62915506,chr17,62915433,62915506,0,5852656
IMR90|chr17:57154168-57154191,chr17,57154168,57154191,IMR90|chr17:38601988-38602008,chr17,38601988,38602008,0,18552180
IMR90|chr17:57274584-57274655,chr17,57274584,57274655,IMR90|chr17:80187411-80187441,chr17,80187411,80187441,0,22912827
IMR90|chr17:57507665-57507700,chr17,57507665,57507700,IMR90|chr17:62656069-62656172,chr17,62656069,62656172,0,5148404
IMR90|chr17:57543901-57543960,chr17,57543901,57543960,IMR90|chr17:48942185-48942257,chr17,48942185,48942257,0,8601716
IMR90|chr17:57666126-57666169,chr17,57666126,57666169,IMR90|chr17:40543005-40543138,chr17,40543005,40543138,0,17123121
IMR90|chr17:57728791-57728841,chr17,57728791,57728841,IMR90|chr17:62659189-62659275,chr17,62659189,62659275,0,4930398
IMR90|chr17:57903331-57903400,chr17,57903331,57903400,IMR90|chr17:59484416-59484488,chr17,59484416,59484488,0,1581085
IMR90|chr17:57923079-57923132,chr17,57923079,57923132,IMR90|chr17:62655208-62655240,chr17,62655208,62655240,0,4732129
IMR90|chr17:58051560-58051598,chr17,58051560,58051598,IMR90|chr17:76779084-76779136,chr17,76779084,76779136,0,18727524
IMR90|chr17:58333604-58333643,chr17,58333604,58333643,IMR90|chr17:26548915-26549026,chr17,26548915,26549026,0,31784689
IMR90|chr17:58456733-58456782,chr17,58456733,58456782,IMR90|chr17:62660094-62660189,chr17,62660094,62660189,0,4203361
IMR90|chr17:58502222-58502243,chr17,58502222,58502243,IMR90|chr17:40166666-40166722,chr17,40166666,40166722,0,18335556
IMR90|chr17:58680609-58680645,chr17,58680609,58680645,IMR90|chr17:28930848-28930879,chr17,28930848,28930879,0,29749761
IMR90|chr17:58706076-58706096,chr17,58706076,58706096,IMR90|chr17:40428923-40428939,chr17,40428923,40428939,0,18277153
IMR90|chr17:58741428-58741475,chr17,58741428,58741475,IMR90|chr17:39973064-39973110,chr17,39973064,39973110,0,18768364
IMR90|chr17:58753003-58753122,chr17,58753003,58753122,IMR90|chr17:59479992-59480023,chr17,59479992,59480023,0,726989
IMR90|chr17:58763050-58763105,chr17,58763050,58763105,IMR90|chr17:60143258-60143318,chr17,60143258,60143318,0,1380208
IMR90|chr17:58972291-58972317,chr17,58972291,58972317,IMR90|chr17:75447924-75448004,chr17,75447924,75448004,0,16475633
IMR90|chr17:59042868-59042936,chr17,59042868,59042936,IMR90|chr17:21190956-21191012,chr17,21190956,21191012,0,37851912
IMR90|chr17:59088506-59088575,chr17,59088506,59088575,IMR90|chr17:62489697-62489768,chr17,62489697,62489768,0,3401191
IMR90|chr17:59091566-59091593,chr17,59091566,59091593,IMR90|chr17:80188978-80189085,chr17,80188978,80189085,0,21097412
IMR90|chr17:59121509-59121557,chr17,59121509,59121557,IMR90|chr17:27072999-27073021,chr17,27072999,27073021,0,32048510
IMR90|chr17:59337228-59337266,chr17,59337228,59337266,IMR90|chr17:76779084-76779136,chr17,76779084,76779136,0,17441856
IMR90|chr17:59369373-59369496,chr17,59369373,59369496,IMR90|chr17:56429261-56429307,chr17,56429261,56429307,0,2940112
IMR90|chr17:59554270-59554371,chr17,59554270,59554371,IMR90|chr17:38603528-38603568,chr17,38603528,38603568,0,20950742
IMR90|chr17:59639018-59639119,chr17,59639018,59639119,IMR90|chr17:38603528-38603568,chr17,38603528,38603568,0,21035490
IMR90|chr17:59697739-59697778,chr17,59697739,59697778,IMR90|chr17:76781929-76781960,chr17,76781929,76781960,0,17084190
IMR90|chr17:59769825-59769916,chr17,59769825,59769916,IMR90|chr17:65368719-65368756,chr17,65368719,65368756,0,5598894
IMR90|chr17:59849658-59849769,chr17,59849658,59849769,IMR90|chr17:40575653-40575690,chr17,40575653,40575690,0,19274005
IMR90|chr17:59891193-59891235,chr17,59891193,59891235,IMR90|chr17:62657033-62657141,chr17,62657033,62657141,0,2765840
IMR90|chr17:59916076-59916139,chr17,59916076,59916139,IMR90|chr17:40166289-40166384,chr17,40166289,40166384,0,19749787
IMR90|chr17:60050652-60050718,chr17,60050652,60050718,IMR90|chr17:79534358-79534439,chr17,79534358,79534439,0,19483706
IMR90|chr17:60109528-60109595,chr17,60109528,60109595,IMR90|chr17:57784364-57784396,chr17,57784364,57784396,0,2325164
IMR90|chr17:60202133-60202184,chr17,60202133,60202184,IMR90|chr17:78189274-78189424,chr17,78189274,78189424,0,17987141
IMR90|chr17:60281353-60281375,chr17,60281353,60281375,IMR90|chr17:46648931-46649026,chr17,46648931,46649026,0,13632422
IMR90|chr17:60313384-60313410,chr17,60313384,60313410,IMR90|chr17:62653528-62653635,chr17,62653528,62653635,0,2340144
IMR90|chr17:60418810-60418850,chr17,60418810,60418850,IMR90|chr17:61048205-61048231,chr17,61048205,61048231,0,629395
IMR90|chr17:60584407-60584557,chr17,60584407,60584557,IMR90|chr17:26548915-26549013,chr17,26548915,26549013,0,34035492
IMR90|chr17:60690988-60691138,chr17,60690988,60691138,IMR90|chr17:62504434-62504514,chr17,62504434,62504514,0,1813446
IMR90|chr17:60691547-60691598,chr17,60691547,60691598,IMR90|chr17:21190949-21191012,chr17,21190949,21191012,0,39500598
IMR90|chr17:60797858-60797893,chr17,60797858,60797893,IMR90|chr17:45726166-45726201,chr17,45726166,45726201,0,15071692
IMR90|chr17:60895378-60895438,chr17,60895378,60895438,IMR90|chr17:8054163-8054196,chr17,8054163,8054196,0,52841215
IMR90|chr17:60971778-60971895,chr17,60971778,60971895,IMR90|chr17:61050475-61050625,chr17,61050475,61050625,0,78697
IMR90|chr17:61037187-61037234,chr17,61037187,61037234,IMR90|chr17:57699790-57699849,chr17,57699790,57699849,0,3337397
IMR90|chr17:61117582-61117616,chr17,61117582,61117616,IMR90|chr17:62657844-62657965,chr17,62657844,62657965,0,1540262
IMR90|chr17:61223992-61224022,chr17,61223992,61224022,IMR90|chr17:40572095-40572122,chr17,40572095,40572122,0,20651897
IMR90|chr17:61238317-61238429,chr17,61238317,61238429,IMR90|chr17:62658362-62658407,chr17,62658362,62658407,0,1420045
IMR90|chr17:61246066-61246140,chr17,61246066,61246140,IMR90|chr17:40166666-40166721,chr17,40166666,40166721,0,21079400
IMR90|chr17:61256606-61256664,chr17,61256606,61256664,IMR90|chr17:28931130-28931179,chr17,28931130,28931179,0,32325476
IMR90|chr17:61384611-61384647,chr17,61384611,61384647,IMR90|chr17:80189774-80189862,chr17,80189774,80189862,0,18805163
IMR90|chr17:61441756-61441819,chr17,61441756,61441819,IMR90|chr17:39966720-39966810,chr17,39966720,39966810,0,21475036
IMR90|chr17:61554258-61554302,chr17,61554258,61554302,IMR90|chr17:62654052-62654127,chr17,62654052,62654127,0,1099794
IMR90|chr17:61794277-61794344,chr17,61794277,61794344,IMR90|chr17:57784364-57784396,chr17,57784364,57784396,0,4009913
IMR90|chr17:61877150-61877201,chr17,61877150,61877201,IMR90|chr17:56062175-56062254,chr17,56062175,56062254,0,5814975
IMR90|chr17:61891158-61891204,chr17,61891158,61891204,IMR90|chr17:75449773-75449847,chr17,75449773,75449847,0,13558615
IMR90|chr17:61933308-61933338,chr17,61933308,61933338,IMR90|chr17:76163075-76163182,chr17,76163075,76163182,0,14229767
IMR90|chr17:62061991-62062084,chr17,62061991,62062084,IMR90|chr17:27042253-27042339,chr17,27042253,27042339,0,35019738
IMR90|chr17:62101478-62101513,chr17,62101478,62101513,IMR90|chr17:38525820-38525888,chr17,38525820,38525888,0,23575658
IMR90|chr17:62173313-62173373,chr17,62173313,62173373,IMR90|chr17:38602049-38602119,chr17,38602049,38602119,0,23571264
IMR90|chr17:62225203-62225235,chr17,62225203,62225235,IMR90|chr17:62915431-62915572,chr17,62915431,62915572,0,690228
IMR90|chr17:62249499-62249611,chr17,62249499,62249611,IMR90|chr17:38525820-38525888,chr17,38525820,38525888,0,23723679
IMR90|chr17:62296342-62296413,chr17,62296342,62296413,IMR90|chr17:56062175-56062254,chr17,56062175,56062254,0,6234167
IMR90|chr17:62384656-62384706,chr17,62384656,62384706,IMR90|chr17:38603886-38603971,chr17,38603886,38603971,0,23780770
IMR90|chr17:62443796-62443862,chr17,62443796,62443862,IMR90|chr17:80408177-80408261,chr17,80408177,80408261,0,17964381
IMR90|chr17:62466940-62467004,chr17,62466940,62467004,IMR90|chr17:41853202-41853326,chr17,41853202,41853326,0,20613738
IMR90|chr17:62623405-62623487,chr17,62623405,62623487,IMR90|chr17:40166666-40166722,chr17,40166666,40166722,0,22456739
IMR90|chr17:62700630-62700664,chr17,62700630,62700664,IMR90|chr17:62656069-62656172,chr17,62656069,62656172,0,44561
IMR90|chr17:62736506-62736570,chr17,62736506,62736570,IMR90|chr17:79534358-79534442,chr17,79534358,79534442,0,16797852
IMR90|chr17:62882175-62882252,chr17,62882175,62882252,IMR90|chr17:40572095-40572122,chr17,40572095,40572122,0,22310080
IMR90|chr17:62922992-62923048,chr17,62922992,62923048,IMR90|chr17:40426519-40426572,chr17,40426519,40426572,0,22496473
IMR90|chr17:63015933-63015974,chr17,63015933,63015974,IMR90|chr17:78390116-78390197,chr17,78390116,78390197,0,15374183
IMR90|chr17:63066356-63066393,chr17,63066356,63066393,IMR90|chr17:62656349-62656499,chr17,62656349,62656499,0,410007
IMR90|chr17:63088478-63088518,chr17,63088478,63088518,IMR90|chr17:79819529-79819601,chr17,79819529,79819601,0,16731051
IMR90|chr17:63209405-63209460,chr17,63209405,63209460,IMR90|chr17:38601604-38601682,chr17,38601604,38601682,0,24607801
IMR90|chr17:63405156-63405221,chr17,63405156,63405221,IMR90|chr17:8054163-8054196,chr17,8054163,8054196,0,55350993
IMR90|chr17:63471156-63471199,chr17,63471156,63471199,IMR90|chr17:38600438-38600514,chr17,38600438,38600514,0,24870718
IMR90|chr17:63916920-63916960,chr17,63916920,63916960,IMR90|chr17:38604494-38604634,chr17,38604494,38604634,0,25312426
IMR90|chr17:64212097-64212133,chr17,64212097,64212133,IMR90|chr17:48543452-48543529,chr17,48543452,48543529,0,15668645
IMR90|chr17:64343823-64343892,chr17,64343823,64343892,IMR90|chr17:59484416-59484488,chr17,59484416,59484488,0,4859407
IMR90|chr17:64507022-64507060,chr17,64507022,64507060,IMR90|chr17:47841646-47841694,chr17,47841646,47841694,0,16665376
IMR90|chr17:64651333-64651398,chr17,64651333,64651398,IMR90|chr17:38601882-38601958,chr17,38601882,38601958,0,26049451
IMR90|chr17:64894118-64894158,chr17,64894118,64894158,IMR90|chr17:39974978-39975050,chr17,39974978,39975050,0,24919140
IMR90|chr17:64919627-64919679,chr17,64919627,64919679,IMR90|chr17:62655761-62655824,chr17,62655761,62655824,0,2263866
IMR90|chr17:64951571-64951688,chr17,64951571,64951688,IMR90|chr17:80008741-80008774,chr17,80008741,80008774,0,15057170
IMR90|chr17:65177534-65177657,chr17,65177534,65177657,IMR90|chr17:56429261-56429307,chr17,56429261,56429307,0,8748273
IMR90|chr17:65220049-65220085,chr17,65220049,65220085,IMR90|chr17:8096316-8096427,chr17,8096316,8096427,0,57123733
IMR90|chr17:65373185-65373239,chr17,65373185,65373239,IMR90|chr17:62655228-62655301,chr17,62655228,62655301,0,2717957
IMR90|chr17:65507779-65507874,chr17,65507779,65507874,IMR90|chr17:62662214-62662277,chr17,62662214,62662277,0,2845565
IMR90|chr17:65546163-65546218,chr17,65546163,65546218,IMR90|chr17:38601604-38601682,chr17,38601604,38601682,0,26944559
IMR90|chr17:65604763-65604812,chr17,65604763,65604812,IMR90|chr17:62657025-62657122,chr17,62657025,62657122,0,2947738
IMR90|chr17:65806302-65806351,chr17,65806302,65806351,IMR90|chr17:37031266-37031309,chr17,37031266,37031309,0,28775036
IMR90|chr17:65871695-65871752,chr17,65871695,65871752,IMR90|chr17:48942185-48942257,chr17,48942185,48942257,0,16929510
IMR90|chr17:66037080-66037164,chr17,66037080,66037164,IMR90|chr17:8113194-8113233,chr17,8113194,8113233,0,57923886
IMR90|chr17:66038592-66038628,chr17,66038592,66038628,IMR90|chr17:26548915-26549017,chr17,26548915,26549017,0,39489677
IMR90|chr17:66609314-66609403,chr17,66609314,66609403,IMR90|chr17:62661729-62661790,chr17,62661729,62661790,0,3947585
IMR90|chr17:66664328-66664390,chr17,66664328,66664390,IMR90|chr17:62504217-62504301,chr17,62504217,62504301,0,4160111
IMR90|chr17:66907668-66907722,chr17,66907668,66907722,IMR90|chr17:62657442-62657482,chr17,62657442,62657482,0,4250226
IMR90|chr17:66917768-66917868,chr17,66917768,66917868,IMR90|chr17:80234674-80234793,chr17,80234674,80234793,0,13316906
IMR90|chr17:67083002-67083089,chr17,67083002,67083089,IMR90|chr17:61048763-61048826,chr17,61048763,61048826,0,6034239
IMR90|chr17:67381952-67382060,chr17,67381952,67382060,IMR90|chr17:78230190-78230251,chr17,78230190,78230251,0,10848238
IMR90|chr17:67855029-67855141,chr17,67855029,67855141,IMR90|chr17:45726166-45726201,chr17,45726166,45726201,0,22128863
IMR90|chr17:67913815-67913880,chr17,67913815,67913880,IMR90|chr17:62655274-62655359,chr17,62655274,62655359,0,5258541
IMR90|chr17:68220143-68220257,chr17,68220143,68220257,IMR90|chr17:57781427-57781463,chr17,57781427,57781463,0,10438716
IMR90|chr17:68239031-68239078,chr17,68239031,68239078,IMR90|chr17:39973064-39973110,chr17,39973064,39973110,0,28265967
IMR90|chr17:68386648-68386707,chr17,68386648,68386707,IMR90|chr17:37557018-37557072,chr17,37557018,37557072,0,30829630
IMR90|chr17:68392035-68392095,chr17,68392035,68392095,IMR90|chr17:39966720-39966810,chr17,39966720,39966810,0,28425315
IMR90|chr17:68429235-68429318,chr17,68429235,68429318,IMR90|chr17:39973084-39973151,chr17,39973084,39973151,0,28456151
IMR90|chr17:68471719-68471764,chr17,68471719,68471764,IMR90|chr17:75449773-75449847,chr17,75449773,75449847,0,6978054
IMR90|chr17:68613224-68613284,chr17,68613224,68613284,IMR90|chr17:7310796-7310878,chr17,7310796,7310878,0,61302428
IMR90|chr17:68976387-68976414,chr17,68976387,68976414,IMR90|chr17:1362781-1362816,chr17,1362781,1362816,0,67613606
IMR90|chr17:69049731-69049777,chr17,69049731,69049777,IMR90|chr17:62657033-62657141,chr17,62657033,62657141,0,6392698
IMR90|chr17:69147357-69147410,chr17,69147357,69147410,IMR90|chr17:62655208-62655240,chr17,62655208,62655240,0,6492149
IMR90|chr17:69350365-69350400,chr17,69350365,69350400,IMR90|chr17:62505377-62505464,chr17,62505377,62505464,0,6844988
IMR90|chr17:69527554-69527591,chr17,69527554,69527591,IMR90|chr17:38442813-38442863,chr17,38442813,38442863,0,31084741
IMR90|chr17:69736348-69736393,chr17,69736348,69736393,IMR90|chr17:38601749-38601820,chr17,38601749,38601820,0,31134599
IMR90|chr17:69763333-69763420,chr17,69763333,69763420,IMR90|chr17:8113194-8113231,chr17,8113194,8113231,0,61650139
IMR90|chr17:69801328-69801387,chr17,69801328,69801387,IMR90|chr17:71225404-71225470,chr17,71225404,71225470,0,1424076
IMR90|chr17:69830800-69830864,chr17,69830800,69830864,IMR90|chr17:41853202-41853326,chr17,41853202,41853326,0,27977598
IMR90|chr17:69871867-69871910,chr17,69871867,69871910,IMR90|chr17:16942814-16942918,chr17,16942814,16942918,0,52929053
IMR90|chr17:69938827-69938903,chr17,69938827,69938903,IMR90|chr17:8113194-8113233,chr17,8113194,8113233,0,61825633
IMR90|chr17:70139524-70139572,chr17,70139524,70139572,IMR90|chr17:80405650-80405728,chr17,80405650,80405728,0,10266126
IMR90|chr17:70203323-70203396,chr17,70203323,70203396,IMR90|chr17:27072998-27073021,chr17,27072998,27073021,0,43130325
IMR90|chr17:70362847-70362912,chr17,70362847,70362912,IMR90|chr17:1464325-1464390,chr17,1464325,1464390,0,68898522
IMR90|chr17:70440827-70440893,chr17,70440827,70440893,IMR90|chr17:62653542-62653626,chr17,62653542,62653626,0,7787285
IMR90|chr17:70482606-70482693,chr17,70482606,70482693,IMR90|chr17:8113194-8113231,chr17,8113194,8113231,0,62369412
IMR90|chr17:70565982-70566032,chr17,70565982,70566032,IMR90|chr17:79820558-79820700,chr17,79820558,79820700,0,9254576
IMR90|chr17:70569200-70569228,chr17,70569200,70569228,IMR90|chr17:38523742-38523860,chr17,38523742,38523860,0,32045458
IMR90|chr17:70719574-70719637,chr17,70719574,70719637,IMR90|chr17:78230110-78230140,chr17,78230110,78230140,0,7510536
IMR90|chr17:70744735-70744759,chr17,70744735,70744759,IMR90|chr17:78193183-78193333,chr17,78193183,78193333,0,7448448
IMR90|chr17:70763255-70763303,chr17,70763255,70763303,IMR90|chr17:62659189-62659275,chr17,62659189,62659275,0,8104066
IMR90|chr17:70776542-70776590,chr17,70776542,70776590,IMR90|chr17:57699790-57699849,chr17,57699790,57699849,0,13076752
IMR90|chr17:70813360-70813485,chr17,70813360,70813485,IMR90|chr17:38603923-38603948,chr17,38603923,38603948,0,32209437
IMR90|chr17:70973280-70973351,chr17,70973280,70973351,IMR90|chr17:56062175-56062254,chr17,56062175,56062254,0,14911105
IMR90|chr17:71008170-71008253,chr17,71008170,71008253,IMR90|chr17:34137377-34137425,chr17,34137377,34137425,0,36870793
IMR90|chr17:71268792-71268868,chr17,71268792,71268868,IMR90|chr17:62653673-62653739,chr17,62653673,62653739,0,8615119
IMR90|chr17:71274706-71274777,chr17,71274706,71274777,IMR90|chr17:62491987-62492028,chr17,62491987,62492028,0,8782719
IMR90|chr17:71297533-71297634,chr17,71297533,71297634,IMR90|chr17:34959291-34959339,chr17,34959291,34959339,0,36338242
IMR90|chr17:71317679-71317708,chr17,71317679,71317708,IMR90|chr17:33468031-33468181,chr17,33468031,33468181,0,37849648
IMR90|chr17:71345320-71345411,chr17,71345320,71345411,IMR90|chr17:62654259-62654308,chr17,62654259,62654308,0,8691061
IMR90|chr17:71442749-71442791,chr17,71442749,71442791,IMR90|chr17:62657033-62657141,chr17,62657033,62657141,0,8785716
IMR90|chr17:71514638-71514738,chr17,71514638,71514738,IMR90|chr17:38601736-38601793,chr17,38601736,38601793,0,32912902
IMR90|chr17:71637034-71637057,chr17,71637034,71637057,IMR90|chr17:38442813-38442863,chr17,38442813,38442863,0,33194221
IMR90|chr17:71790954-71790992,chr17,71790954,71790992,IMR90|chr17:26666141-26666249,chr17,26666141,26666249,0,45124813
IMR90|chr17:71818541-71818581,chr17,71818541,71818581,IMR90|chr17:62915051-62915161,chr17,62915051,62915161,0,8903490
IMR90|chr17:71828074-71828100,chr17,71828074,71828100,IMR90|chr17:75447924-75448004,chr17,75447924,75448004,0,3619850
IMR90|chr17:71881390-71881410,chr17,71881390,71881410,IMR90|chr17:38603923-38603948,chr17,38603923,38603948,0,33277467
IMR90|chr17:71929559-71929629,chr17,71929559,71929629,IMR90|chr17:76783093-76783163,chr17,76783093,76783163,0,4853534
IMR90|chr17:71945647-71945696,chr17,71945647,71945696,IMR90|chr17:62660094-62660189,chr17,62660094,62660189,0,9285553
IMR90|chr17:71976171-71976283,chr17,71976171,71976283,IMR90|chr17:62658362-62658407,chr17,62658362,62658407,0,9317809
IMR90|chr17:72138994-72139070,chr17,72138994,72139070,IMR90|chr17:57696198-57696226,chr17,57696198,57696226,0,14442796
IMR90|chr17:72144103-72144140,chr17,72144103,72144140,IMR90|chr17:39974978-39975050,chr17,39974978,39975050,0,32169125
IMR90|chr17:72304913-72304961,chr17,72304913,72304961,IMR90|chr17:62654324-62654426,chr17,62654324,62654426,0,9650589
IMR90|chr17:72355031-72355107,chr17,72355031,72355107,IMR90|chr17:75448526-75448579,chr17,75448526,75448579,0,3093495
IMR90|chr17:72518334-72518364,chr17,72518334,72518364,IMR90|chr17:38602896-38602970,chr17,38602896,38602970,0,33915438
IMR90|chr17:72833534-72833586,chr17,72833534,72833586,IMR90|chr17:62655761-62655824,chr17,62655761,62655824,0,10177773
IMR90|chr17:72876042-72876139,chr17,72876042,72876139,IMR90|chr17:62657140-62657176,chr17,62657140,62657176,0,10218902
IMR90|chr17:73107608-73107758,chr17,73107608,73107758,IMR90|chr17:62655288-62655307,chr17,62655288,62655307,0,10452320
IMR90|chr17:73231192-73231260,chr17,73231192,73231260,IMR90|chr17:38601144-38601237,chr17,38601144,38601237,0,34630048
IMR90|chr17:73304413-73304469,chr17,73304413,73304469,IMR90|chr17:62656558-62656619,chr17,62656558,62656619,0,10647855
IMR90|chr17:73348027-73348075,chr17,73348027,73348075,IMR90|chr17:62653467-62653538,chr17,62653467,62653538,0,10694560
IMR90|chr17:73415209-73415270,chr17,73415209,73415270,IMR90|chr17:7479422-7479480,chr17,7479422,7479480,0,65935787
IMR90|chr17:73420084-73420229,chr17,73420084,73420229,IMR90|chr17:42419761-42419893,chr17,42419761,42419893,0,31000323
IMR90|chr17:74167257-74167305,chr17,74167257,74167305,IMR90|chr17:62653467-62653538,chr17,62653467,62653538,0,11513790
IMR90|chr17:74380697-74380716,chr17,74380697,74380716,IMR90|chr17:80186961-80187049,chr17,80186961,80187049,0,5806264
IMR90|chr17:74479278-74479367,chr17,74479278,74479367,IMR90|chr17:21187460-21187514,chr17,21187460,21187514,0,53291818
IMR90|chr17:74481988-74482038,chr17,74481988,74482038,IMR90|chr17:61047275-61047324,chr17,61047275,61047324,0,13434713
IMR90|chr17:74507094-74507130,chr17,74507094,74507130,IMR90|chr17:28930848-28930879,chr17,28930848,28930879,0,45576246
IMR90|chr17:74817057-74817079,chr17,74817057,74817079,IMR90|chr17:46648931-46649026,chr17,46648931,46649026,0,28168126
IMR90|chr17:74922977-74923077,chr17,74922977,74923077,IMR90|chr17:34959293-34959339,chr17,34959293,34959339,0,39963684
IMR90|chr17:74929112-74929224,chr17,74929112,74929224,IMR90|chr17:75316780-75316877,chr17,75316780,75316877,0,387668
IMR90|chr17:74979375-74979402,chr17,74979375,74979402,IMR90|chr17:8103941-8104091,chr17,8103941,8104091,0,66875434
IMR90|chr17:75006689-75006778,chr17,75006689,75006778,IMR90|chr17:21187460-21187514,chr17,21187460,21187514,0,53819229
IMR90|chr17:75030306-75030335,chr17,75030306,75030335,IMR90|chr17:38600440-38600481,chr17,38600440,38600481,0,36429866
IMR90|chr17:75037992-75038038,chr17,75037992,75038038,IMR90|chr17:40572787-40572891,chr17,40572787,40572891,0,34465205
IMR90|chr17:75118100-75118242,chr17,75118100,75118242,IMR90|chr17:42277279-42277378,chr17,42277279,42277378,0,32840821
IMR90|chr17:75343393-75343433,chr17,75343393,75343433,IMR90|chr17:1360610-1360718,chr17,1360610,1360718,0,73982783
IMR90|chr17:75420325-75420422,chr17,75420325,75420422,IMR90|chr17:6542870-6542921,chr17,6542870,6542921,0,68877455
IMR90|chr17:75745825-75745908,chr17,75745825,75745908,IMR90|chr17:78230190-78230251,chr17,78230190,78230251,0,2484365
IMR90|chr17:75791852-75791899,chr17,75791852,75791899,IMR90|chr17:62495108-62495181,chr17,62495108,62495181,0,13296744
IMR90|chr17:75899206-75899258,chr17,75899206,75899258,IMR90|chr17:26548915-26549013,chr17,26548915,26549013,0,49350291
IMR90|chr17:76119520-76119620,chr17,76119520,76119620,IMR90|chr17:80234674-80234793,chr17,80234674,80234793,0,4115154
IMR90|chr17:76175063-76175111,chr17,76175063,76175111,IMR90|chr17:62659189-62659275,chr17,62659189,62659275,0,13515874
IMR90|chr17:76184663-76184711,chr17,76184663,76184711,IMR90|chr17:80405650-80405728,chr17,80405650,80405728,0,4220987
IMR90|chr17:76195536-76195600,chr17,76195536,76195600,IMR90|chr17:61048213-61048261,chr17,61048213,61048261,0,15147323
IMR90|chr17:76198140-76198169,chr17,76198140,76198169,IMR90|chr17:1360611-1360696,chr17,1360611,1360696,0,74837529
IMR90|chr17:76288845-76288879,chr17,76288845,76288879,IMR90|chr17:47841646-47841694,chr17,47841646,47841694,0,28447199
IMR90|chr17:76319050-76319135,chr17,76319050,76319135,IMR90|chr17:62655288-62655307,chr17,62655288,62655307,0,13663762
IMR90|chr17:76330440-76330459,chr17,76330440,76330459,IMR90|chr17:38604406-38604435,chr17,38604406,38604435,0,37726034
IMR90|chr17:76563464-76563540,chr17,76563464,76563540,IMR90|chr17:62497619-62497663,chr17,62497619,62497663,0,14065845
IMR90|chr17:76610708-76610830,chr17,76610708,76610830,IMR90|chr17:62654324-62654426,chr17,62654324,62654426,0,13956384
IMR90|chr17:76634743-76634820,chr17,76634743,76634820,IMR90|chr17:38603403-38603473,chr17,38603403,38603473,0,38031340
IMR90|chr17:76715653-76715714,chr17,76715653,76715714,IMR90|chr17:7310796-7310878,chr17,7310796,7310878,0,69404857
IMR90|chr17:76896359-76896408,chr17,76896359,76896408,IMR90|chr17:39975275-39975335,chr17,39975275,39975335,0,36921084
IMR90|chr17:77400146-77400192,chr17,77400146,77400192,IMR90|chr17:59484237-59484275,chr17,59484237,59484275,0,17915909
IMR90|chr17:77469934-77470000,chr17,77469934,77470000,IMR90|chr17:40579313-40579463,chr17,40579313,40579463,0,36890621
IMR90|chr17:77610818-77610869,chr17,77610818,77610869,IMR90|chr17:38604077-38604120,chr17,38604077,38604120,0,39006741
IMR90|chr17:77624823-77624871,chr17,77624823,77624871,IMR90|chr17:37031266-37031309,chr17,37031266,37031309,0,40593557
IMR90|chr17:77690707-77690750,chr17,77690707,77690750,IMR90|chr17:61048763-61048828,chr17,61048763,61048828,0,16641944
IMR90|chr17:77736331-77736448,chr17,77736331,77736448,IMR90|chr17:61050475-61050625,chr17,61050475,61050625,0,16685856
IMR90|chr17:77757233-77757273,chr17,77757233,77757273,IMR90|chr17:62656383-62656454,chr17,62656383,62656454,0,15100850
IMR90|chr17:77925377-77925401,chr17,77925377,77925401,IMR90|chr17:75319463-75319578,chr17,75319463,75319578,0,2605914
IMR90|chr17:77994073-77994132,chr17,77994073,77994132,IMR90|chr17:40610429-40610502,chr17,40610429,40610502,0,37383644
IMR90|chr17:78088745-78088780,chr17,78088745,78088780,IMR90|chr17:45726166-45726201,chr17,45726166,45726201,0,32362579
IMR90|chr17:78098024-78098080,chr17,78098024,78098080,IMR90|chr17:38601381-38601429,chr17,38601381,38601429,0,39496643
IMR90|chr17:78152986-78153026,chr17,78152986,78153026,IMR90|chr17:39974978-39975050,chr17,39974978,39975050,0,38178008
IMR90|chr17:78270304-78270348,chr17,78270304,78270348,IMR90|chr17:62654052-62654127,chr17,62654052,62654127,0,15616252
IMR90|chr17:78399475-78399539,chr17,78399475,78399539,IMR90|chr17:27042253-27042339,chr17,27042253,27042339,0,51357222
IMR90|chr17:78526295-78526353,chr17,78526295,78526353,IMR90|chr17:62915464-62915600,chr17,62915464,62915600,0,15610831
IMR90|chr17:78592397-78592432,chr17,78592397,78592432,IMR90|chr17:38525820-38525888,chr17,38525820,38525888,0,40066577
IMR90|chr17:78832094-78832220,chr17,78832094,78832220,IMR90|chr17:40572558-40572595,chr17,40572558,40572595,0,38259536
IMR90|chr17:78892184-78892328,chr17,78892184,78892328,IMR90|chr17:57781427-57781463,chr17,57781427,57781463,0,21110757
IMR90|chr17:79067637-79067676,chr17,79067637,79067676,IMR90|chr17:62657025-62657122,chr17,62657025,62657122,0,16410612
IMR90|chr17:79142455-79142484,chr17,79142455,79142484,IMR90|chr17:62657844-62657965,chr17,62657844,62657965,0,16484611
IMR90|chr17:79246668-79246715,chr17,79246668,79246715,IMR90|chr17:62495108-62495181,chr17,62495108,62495181,0,16751560
IMR90|chr17:79305506-79305530,chr17,79305506,79305530,IMR90|chr17:39969615-39969703,chr17,39969615,39969703,0,39335891
IMR90|chr17:79417353-79417396,chr17,79417353,79417396,IMR90|chr17:38600438-38600514,chr17,38600438,38600514,0,40816915
IMR90|chr17:79485761-79485812,chr17,79485761,79485812,IMR90|chr17:71092707-71092853,chr17,71092707,71092853,0,8393054
IMR90|chr17:79675257-79675310,chr17,79675257,79675310,IMR90|chr17:40539738-40539795,chr17,40539738,40539795,0,39135519
IMR90|chr17:79817699-79817808,chr17,79817699,79817808,IMR90|chr17:40545402-40545443,chr17,40545402,40545443,0,39272297
IMR90|chr17:79930007-79930050,chr17,79930007,79930050,IMR90|chr17:40074833-40074873,chr17,40074833,40074873,0,39855174
IMR90|chr17:79982662-79982732,chr17,79982662,79982732,IMR90|chr17:47075292-47075322,chr17,47075292,47075322,0,32907370
IMR90|chr17:80071859-80071960,chr17,80071859,80071960,IMR90|chr17:34959291-34959339,chr17,34959291,34959339,0,45112568
IMR90|chr17:80074530-80074566,chr17,80074530,80074566,IMR90|chr17:17874839-17874867,chr17,17874839,17874867,0,62199691
IMR90|chr17:80248067-80248112,chr17,80248067,80248112,IMR90|chr17:56061325-56061475,chr17,56061325,56061475,0,24186742
IMR90|chr17:80293366-80293389,chr17,80293366,80293389,IMR90|chr17:75319942-75320012,chr17,75319942,75320012,0,4973424
IMR90|chr17:80309971-80310086,chr17,80309971,80310086,IMR90|chr17:1618338-1618372,chr17,1618338,1618372,0,78691633
IMR90|chr17:80890691-80890774,chr17,80890691,80890774,IMR90|chr17:34137377-34137425,chr17,34137377,34137425,0,46753314
IMR90|chr17:81157584-81157619,chr17,81157584,81157619,IMR90|chr17:59474917-59475044,chr17,59474917,59475044,0,21682667
IMR90|chr18:336444-336494,chr18,336444,336494,IMR90|chr18:9915190-9915296,chr18,9915190,9915296,0,9578746
IMR90|chr18:972930-972993,chr18,972930,972993,IMR90|chr18:57026037-57026153,chr18,57026037,57026153,0,56053107
IMR90|chr18:2307506-2307569,chr18,2307506,2307569,IMR90|chr18:57026037-57026153,chr18,57026037,57026153,0,54718531
IMR90|chr18:2321911-2321946,chr18,2321911,2321946,IMR90|chr18:57363321-57363436,chr18,57363321,57363436,0,55041410
IMR90|chr18:2788393-2788443,chr18,2788393,2788443,IMR90|chr18:12991659-12991713,chr18,12991659,12991713,0,10203266
IMR90|chr18:2950429-2950497,chr18,2950429,2950497,IMR90|chr18:59245881-59245937,chr18,59245881,59245937,0,56295452
IMR90|chr18:3847461-3847520,chr18,3847461,3847520,IMR90|chr18:61089217-61089295,chr18,61089217,61089295,0,57241756
IMR90|chr18:4938783-4938933,chr18,4938783,4938933,IMR90|chr18:43677071-43677105,chr18,43677071,43677105,0,38738288
IMR90|chr18:5562060-5562086,chr18,5562060,5562086,IMR90|chr18:47016001-47016044,chr18,47016001,47016044,0,41453941
IMR90|chr18:5645729-5645795,chr18,5645729,5645795,IMR90|chr18:43651847-43651930,chr18,43651847,43651930,0,38006118
IMR90|chr18:6445971-6446081,chr18,6445971,6446081,IMR90|chr18:59245237-59245266,chr18,59245237,59245266,0,52799266
IMR90|chr18:7505133-7505186,chr18,7505133,7505186,IMR90|chr18:74816186-74816230,chr18,74816186,74816230,0,67311053
IMR90|chr18:8018563-8018589,chr18,8018563,8018589,IMR90|chr18:47016001-47016044,chr18,47016001,47016044,0,38997438
IMR90|chr18:9817074-9817139,chr18,9817074,9817139,IMR90|chr18:59249697-59249732,chr18,59249697,59249732,0,49432623
IMR90|chr18:10455633-10455749,chr18,10455633,10455749,IMR90|chr18:43677071-43677105,chr18,43677071,43677105,0,33221438
IMR90|chr18:10714667-10714813,chr18,10714667,10714813,IMR90|chr18:59247751-59247847,chr18,59247751,59247847,0,48533084
IMR90|chr18:11613646-11613714,chr18,11613646,11613714,IMR90|chr18:59245881-59245937,chr18,59245881,59245937,0,47632235
IMR90|chr18:13030942-13031007,chr18,13030942,13031007,IMR90|chr18:59249697-59249732,chr18,59249697,59249732,0,46218755
IMR90|chr18:14828194-14828237,chr18,14828194,14828237,IMR90|chr18:61638353-61638412,chr18,61638353,61638412,0,46810159
IMR90|chr18:15111132-15111239,chr18,15111132,15111239,IMR90|chr18:57363343-57363377,chr18,57363343,57363377,0,42252211
IMR90|chr18:15192957-15192994,chr18,15192957,15192994,IMR90|chr18:43546221-43546333,chr18,43546221,43546333,0,28353264
IMR90|chr18:18079168-18079221,chr18,18079168,18079221,IMR90|chr18:74816186-74816230,chr18,74816186,74816230,0,56737018
IMR90|chr18:18499501-18499651,chr18,18499501,18499651,IMR90|chr18:43677071-43677105,chr18,43677071,43677105,0,25177570
IMR90|chr18:18556064-18556142,chr18,18556064,18556142,IMR90|chr18:5236460-5236530,chr18,5236460,5236530,0,13319604
IMR90|chr18:20207008-20207043,chr18,20207008,20207043,IMR90|chr18:57363321-57363436,chr18,57363321,57363436,0,37156313
IMR90|chr18:20640303-20640359,chr18,20640303,20640359,IMR90|chr18:9476328-9476403,chr18,9476328,9476403,0,11163975
IMR90|chr18:20675412-20675555,chr18,20675412,20675555,IMR90|chr18:5236460-5236530,chr18,5236460,5236530,0,15438952
IMR90|chr18:22553380-22553483,chr18,22553380,22553483,IMR90|chr18:47016001-47016044,chr18,47016001,47016044,0,24462621
IMR90|chr18:23744691-23744839,chr18,23744691,23744839,IMR90|chr18:59245664-59245704,chr18,59245664,59245704,0,35500973
IMR90|chr18:24195884-24196022,chr18,24195884,24196022,IMR90|chr18:61088447-61088470,chr18,61088447,61088470,0,36892563
IMR90|chr18:25232949-25232992,chr18,25232949,25232992,IMR90|chr18:61638353-61638412,chr18,61638353,61638412,0,36405404
IMR90|chr18:26165251-26165340,chr18,26165251,26165340,IMR90|chr18:51884903-51884932,chr18,51884903,51884932,0,25719652
IMR90|chr18:26739678-26739821,chr18,26739678,26739821,IMR90|chr18:5236460-5236530,chr18,5236460,5236530,0,21503218
IMR90|chr18:27098746-27098816,chr18,27098746,27098816,IMR90|chr18:59245881-59245937,chr18,59245881,59245937,0,32147135
IMR90|chr18:28529347-28529421,chr18,28529347,28529421,IMR90|chr18:43546256-43546333,chr18,43546256,43546333,0,15016909
IMR90|chr18:29359863-29359920,chr18,29359863,29359920,IMR90|chr18:9476328-9476403,chr18,9476328,9476403,0,19883535
IMR90|chr18:29737828-29737865,chr18,29737828,29737865,IMR90|chr18:43546221-43546333,chr18,43546221,43546333,0,13808393
IMR90|chr18:32037529-32037563,chr18,32037529,32037563,IMR90|chr18:57026037-57026153,chr18,57026037,57026153,0,24988508
IMR90|chr18:35878189-35878316,chr18,35878189,35878316,IMR90|chr18:61088447-61088470,chr18,61088447,61088470,0,25210258
IMR90|chr18:36083583-36083653,chr18,36083583,36083653,IMR90|chr18:61087437-61087506,chr18,61087437,61087506,0,25003854
IMR90|chr18:39147224-39147257,chr18,39147224,39147257,IMR90|chr18:61088240-61088311,chr18,61088240,61088311,0,21941016
IMR90|chr18:41060353-41060420,chr18,41060353,41060420,IMR90|chr18:43651847-43651930,chr18,43651847,43651930,0,2591494
IMR90|chr18:41333455-41333489,chr18,41333455,41333489,IMR90|chr18:57026037-57026153,chr18,57026037,57026153,0,15692582
IMR90|chr18:42121411-42121440,chr18,42121411,42121440,IMR90|chr18:59247827-59247938,chr18,59247827,59247938,0,17126416
IMR90|chr18:42764783-42764827,chr18,42764783,42764827,IMR90|chr18:9915190-9915296,chr18,9915190,9915296,0,32849593
IMR90|chr18:43316442-43316512,chr18,43316442,43316512,IMR90|chr18:61087437-61087506,chr18,61087437,61087506,0,17770995
IMR90|chr18:43736017-43736127,chr18,43736017,43736127,IMR90|chr18:59245664-59245704,chr18,59245664,59245704,0,15509647
IMR90|chr18:43775195-43775233,chr18,43775195,43775233,IMR90|chr18:43546221-43546333,chr18,43546221,43546333,0,228974
IMR90|chr18:45243573-45243623,chr18,45243573,45243623,IMR90|chr18:9915190-9915296,chr18,9915190,9915296,0,35328383
IMR90|chr18:49292767-49292905,chr18,49292767,49292905,IMR90|chr18:61088447-61088470,chr18,61088447,61088470,0,11795680
IMR90|chr18:49564161-49564181,chr18,49564161,49564181,IMR90|chr18:43654559-43654590,chr18,43654559,43654590,0,5909602
IMR90|chr18:50927691-50927727,chr18,50927691,50927727,IMR90|chr18:57363321-57363436,chr18,57363321,57363436,0,6435630
IMR90|chr18:52708332-52708390,chr18,52708332,52708390,IMR90|chr18:74816186-74816230,chr18,74816186,74816230,0,22107854
IMR90|chr18:54320824-54320854,chr18,54320824,54320854,IMR90|chr18:33711385-33711454,chr18,33711385,33711454,0,20609439
IMR90|chr18:54759277-54759384,chr18,54759277,54759384,IMR90|chr18:57363343-57363377,chr18,57363343,57363377,0,2604066
IMR90|chr18:55159576-55159703,chr18,55159576,55159703,IMR90|chr18:61088447-61088470,chr18,61088447,61088470,0,5928871
IMR90|chr18:59650303-59650370,chr18,59650303,59650370,IMR90|chr18:43651847-43651930,chr18,43651847,43651930,0,15998456
IMR90|chr18:60554664-60554700,chr18,60554664,60554700,IMR90|chr18:57363321-57363436,chr18,57363321,57363436,0,3191343
IMR90|chr18:61177807-61177881,chr18,61177807,61177881,IMR90|chr18:43546256-43546333,chr18,43546256,43546333,0,17631551
IMR90|chr18:61439976-61440033,chr18,61439976,61440033,IMR90|chr18:9476328-9476403,chr18,9476328,9476403,0,51963648
IMR90|chr18:62231906-62231976,chr18,62231906,62231976,IMR90|chr18:59245881-59245937,chr18,59245881,59245937,0,2986025
IMR90|chr18:63440195-63440343,chr18,63440195,63440343,IMR90|chr18:59245664-59245704,chr18,59245664,59245704,0,4194531
IMR90|chr18:63440633-63440683,chr18,63440633,63440683,IMR90|chr18:12991659-12991713,chr18,12991659,12991713,0,50448974
IMR90|chr18:63832133-63832234,chr18,63832133,63832234,IMR90|chr18:47016001-47016044,chr18,47016001,47016044,0,16816132
IMR90|chr18:63902933-63902963,chr18,63902933,63902963,IMR90|chr18:33711385-33711454,chr18,33711385,33711454,0,30191548
IMR90|chr18:64413563-64413601,chr18,64413563,64413601,IMR90|chr18:43546221-43546333,chr18,43546221,43546333,0,20867342
IMR90|chr18:64441427-64441493,chr18,64441427,64441493,IMR90|chr18:43651847-43651930,chr18,43651847,43651930,0,20789580
IMR90|chr18:64577905-64577964,chr18,64577905,64577964,IMR90|chr18:61089217-61089295,chr18,61089217,61089295,0,3488688
IMR90|chr18:64955861-64955971,chr18,64955861,64955971,IMR90|chr18:59245237-59245266,chr18,59245237,59245266,0,5710624
IMR90|chr18:64976870-64976890,chr18,64976870,64976890,IMR90|chr18:43654559-43654590,chr18,43654559,43654590,0,21322311
IMR90|chr18:65132100-65132158,chr18,65132100,65132158,IMR90|chr18:74816186-74816230,chr18,74816186,74816230,0,9684086
IMR90|chr18:66481621-66481724,chr18,66481621,66481724,IMR90|chr18:47016001-47016044,chr18,47016001,47016044,0,19465620
IMR90|chr18:67100603-67100692,chr18,67100603,67100692,IMR90|chr18:51884903-51884932,chr18,51884903,51884932,0,15215700
IMR90|chr18:68422534-68422612,chr18,68422534,68422612,IMR90|chr18:5236460-5236530,chr18,5236460,5236530,0,63186074
IMR90|chr18:69050590-69050736,chr18,69050590,69050736,IMR90|chr18:59247751-59247847,chr18,59247751,59247847,0,9802839
IMR90|chr18:69929121-69929150,chr18,69929121,69929150,IMR90|chr18:59247827-59247938,chr18,59247827,59247938,0,10681294
IMR90|chr18:70313010-70313066,chr18,70313010,70313066,IMR90|chr18:9476328-9476403,chr18,9476328,9476403,0,60836682
IMR90|chr18:72040369-72040470,chr18,72040369,72040470,IMR90|chr18:47016001-47016044,chr18,47016001,47016044,0,25024368
IMR90|chr18:72269995-72270105,chr18,72269995,72270105,IMR90|chr18:59245664-59245704,chr18,59245664,59245704,0,13024331
IMR90|chr18:74993364-74993429,chr18,74993364,74993429,IMR90|chr18:43651847-43651930,chr18,43651847,43651930,0,31341517
IMR90|chr18:75082261-75082305,chr18,75082261,75082305,IMR90|chr18:9915190-9915296,chr18,9915190,9915296,0,65167071
IMR90|chr18:76326718-76326834,chr18,76326718,76326834,IMR90|chr18:43677071-43677105,chr18,43677071,43677105,0,32649647
IMR90|chr18:76485338-76485371,chr18,76485338,76485371,IMR90|chr18:61088240-61088311,chr18,61088240,61088311,0,15397098
IMR90|chr18:76737488-76737553,chr18,76737488,76737553,IMR90|chr18:43651847-43651930,chr18,43651847,43651930,0,33085641
IMR90|chr19:31770-31794,chr19,31770,31794,IMR90|chr19:15315934-15316059,chr19,15315934,15316059,0,15284164
IMR90|chr19:134495-134560,chr19,134495,134560,IMR90|chr19:53899407-53899492,chr19,53899407,53899492,0,53764912
IMR90|chr19:189859-189934,chr19,189859,189934,IMR90|chr19:12303003-12303043,chr19,12303003,12303043,0,12113144
IMR90|chr19:238139-238165,chr19,238139,238165,IMR90|chr19:37065051-37065171,chr19,37065051,37065171,0,36826912
IMR90|chr19:447203-447245,chr19,447203,447245,IMR90|chr19:2092429-2092527,chr19,2092429,2092527,0,1645226
IMR90|chr19:743354-743445,chr19,743354,743445,IMR90|chr19:18433227-18433286,chr19,18433227,18433286,0,17689873
IMR90|chr19:1127564-1127646,chr19,1127564,1127646,IMR90|chr19:678646-678677,chr19,678646,678677,0,448918
IMR90|chr19:1193352-1193401,chr19,1193352,1193401,IMR90|chr19:44168300-44168359,chr19,44168300,44168359,0,42974948
IMR90|chr19:1474307-1474401,chr19,1474307,1474401,IMR90|chr19:4063924-4063970,chr19,4063924,4063970,0,2589617
IMR90|chr19:1489416-1489439,chr19,1489416,1489439,IMR90|chr19:42365289-42365338,chr19,42365289,42365338,0,40875873
IMR90|chr19:1773211-1773267,chr19,1773211,1773267,IMR90|chr19:19031323-19031371,chr19,19031323,19031371,0,17258112
IMR90|chr19:1835162-1835184,chr19,1835162,1835184,IMR90|chr19:39882552-39882616,chr19,39882552,39882616,0,38047390
IMR90|chr19:1936707-1936771,chr19,1936707,1936771,IMR90|chr19:44168624-44168644,chr19,44168624,44168644,0,42231917
IMR90|chr19:2030812-2030919,chr19,2030812,2030919,IMR90|chr19:48825955-48825973,chr19,48825955,48825973,0,46795143
IMR90|chr19:2242962-2243021,chr19,2242962,2243021,IMR90|chr19:53395885-53395964,chr19,53395885,53395964,0,51152923
IMR90|chr19:2359017-2359162,chr19,2359017,2359162,IMR90|chr19:13078184-13078268,chr19,13078184,13078268,0,10719167
IMR90|chr19:2588504-2588556,chr19,2588504,2588556,IMR90|chr19:47352016-47352137,chr19,47352016,47352137,0,44763512
IMR90|chr19:2627607-2627649,chr19,2627607,2627649,IMR90|chr19:39336728-39336836,chr19,39336728,39336836,0,36709121
IMR90|chr19:2820008-2820049,chr19,2820008,2820049,IMR90|chr19:41773077-41773139,chr19,41773077,41773139,0,38953069
IMR90|chr19:2954974-2955024,chr19,2954974,2955024,IMR90|chr19:2949718-2949865,chr19,2949718,2949865,0,5256
IMR90|chr19:2973215-2973268,chr19,2973215,2973268,IMR90|chr19:18632262-18632352,chr19,18632262,18632352,0,15659047
IMR90|chr19:3045348-3045431,chr19,3045348,3045431,IMR90|chr19:41773077-41773139,chr19,41773077,41773139,0,38727729
IMR90|chr19:3059088-3059144,chr19,3059088,3059144,IMR90|chr19:3626143-3626205,chr19,3626143,3626205,0,567055
IMR90|chr19:3415146-3415198,chr19,3415146,3415198,IMR90|chr19:39141606-39141661,chr19,39141606,39141661,0,35726460
IMR90|chr19:3466163-3466275,chr19,3466163,3466275,IMR90|chr19:45879048-45879195,chr19,45879048,45879195,0,42412885
IMR90|chr19:3536906-3536945,chr19,3536906,3536945,IMR90|chr19:15315951-15316059,chr19,15315951,15316059,0,11779045
IMR90|chr19:3543230-3543279,chr19,3543230,3543279,IMR90|chr19:41311233-41311331,chr19,41311233,41311331,0,37768003
IMR90|chr19:3602957-3603071,chr19,3602957,3603071,IMR90|chr19:15543554-15543576,chr19,15543554,15543576,0,11940597
IMR90|chr19:3709918-3709989,chr19,3709918,3709989,IMR90|chr19:33866133-33866212,chr19,33866133,33866212,0,30156215
IMR90|chr19:3812358-3812449,chr19,3812358,3812449,IMR90|chr19:18433227-18433286,chr19,18433227,18433286,0,14620869
IMR90|chr19:3927587-3927635,chr19,3927587,3927635,IMR90|chr19:38886970-38887039,chr19,38886970,38887039,0,34959383
IMR90|chr19:4127856-4127891,chr19,4127856,4127891,IMR90|chr19:39972124-39972148,chr19,39972124,39972148,0,35844268
IMR90|chr19:4608009-4608132,chr19,4608009,4608132,IMR90|chr19:14227315-14227348,chr19,14227315,14227348,0,9619306
IMR90|chr19:4856826-4856870,chr19,4856826,4856870,IMR90|chr19:1400060-1400132,chr19,1400060,1400132,0,3456766
IMR90|chr19:4865288-4865331,chr19,4865288,4865331,IMR90|chr19:2092429-2092527,chr19,2092429,2092527,0,2772859
IMR90|chr19:4870231-4870257,chr19,4870231,4870257,IMR90|chr19:37065051-37065171,chr19,37065051,37065171,0,32194820
IMR90|chr19:4936690-4936798,chr19,4936690,4936798,IMR90|chr19:2093943-2093985,chr19,2093943,2093985,0,2842747
IMR90|chr19:5120519-5120561,chr19,5120519,5120561,IMR90|chr19:39969527-39969576,chr19,39969527,39969576,0,34849008
IMR90|chr19:5251722-5251776,chr19,5251722,5251776,IMR90|chr19:33866133-33866212,chr19,33866133,33866212,0,28614411
IMR90|chr19:5310884-5310990,chr19,5310884,5310990,IMR90|chr19:38732171-38732215,chr19,38732171,38732215,0,33421287
IMR90|chr19:5327126-5327173,chr19,5327126,5327173,IMR90|chr19:47732723-47732821,chr19,47732723,47732821,0,42405597
IMR90|chr19:5472474-5472505,chr19,5472474,5472505,IMR90|chr19:30205285-30205404,chr19,30205285,30205404,0,24732811
IMR90|chr19:5895144-5895251,chr19,5895144,5895251,IMR90|chr19:15315934-15316059,chr19,15315934,15316059,0,9420790
IMR90|chr19:6036284-6036318,chr19,6036284,6036318,IMR90|chr19:58325105-58325200,chr19,58325105,58325200,0,52288821
IMR90|chr19:6068200-6068296,chr19,6068200,6068296,IMR90|chr19:10358731-10358766,chr19,10358731,10358766,0,4290531
IMR90|chr19:6111227-6111279,chr19,6111227,6111279,IMR90|chr19:19031324-19031371,chr19,19031324,19031371,0,12920097
IMR90|chr19:6183731-6183779,chr19,6183731,6183779,IMR90|chr19:17333579-17333698,chr19,17333579,17333698,0,11149848
IMR90|chr19:6322118-6322223,chr19,6322118,6322223,IMR90|chr19:19976821-19976967,chr19,19976821,19976967,0,13654703
IMR90|chr19:6470233-6470346,chr19,6470233,6470346,IMR90|chr19:36247478-36247562,chr19,36247478,36247562,0,29777245
IMR90|chr19:6568700-6568791,chr19,6568700,6568791,IMR90|chr19:48248136-48248184,chr19,48248136,48248184,0,41679436
IMR90|chr19:6656060-6656136,chr19,6656060,6656136,IMR90|chr19:2093943-2093985,chr19,2093943,2093985,0,4562117
IMR90|chr19:6759112-6759225,chr19,6759112,6759225,IMR90|chr19:36247478-36247562,chr19,36247478,36247562,0,29488366
IMR90|chr19:6903892-6903997,chr19,6903892,6903997,IMR90|chr19:14226813-14226836,chr19,14226813,14226836,0,7322921
IMR90|chr19:7001655-7001793,chr19,7001655,7001793,IMR90|chr19:2949793-2949839,chr19,2949793,2949839,0,4051862
IMR90|chr19:7328606-7328662,chr19,7328606,7328662,IMR90|chr19:39134904-39135015,chr19,39134904,39135015,0,31806298
IMR90|chr19:7506799-7506840,chr19,7506799,7506840,IMR90|chr19:41773077-41773139,chr19,41773077,41773139,0,34266278
IMR90|chr19:7615937-7615970,chr19,7615937,7615970,IMR90|chr19:38888608-38888628,chr19,38888608,38888628,0,31272671
IMR90|chr19:7668355-7668417,chr19,7668355,7668417,IMR90|chr19:56153343-56153416,chr19,56153343,56153416,0,48484988
IMR90|chr19:7824494-7824578,chr19,7824494,7824578,IMR90|chr19:56150554-56150661,chr19,56150554,56150661,0,48326060
IMR90|chr19:7899351-7899426,chr19,7899351,7899426,IMR90|chr19:39336728-39336803,chr19,39336728,39336803,0,31437377
IMR90|chr19:7990815-7990933,chr19,7990815,7990933,IMR90|chr19:2093943-2093985,chr19,2093943,2093985,0,5896872
IMR90|chr19:7992410-7992488,chr19,7992410,7992488,IMR90|chr19:45876133-45876205,chr19,45876133,45876205,0,37883723
IMR90|chr19:8193472-8193528,chr19,8193472,8193528,IMR90|chr19:2091743-2091821,chr19,2091743,2091821,0,6101729
IMR90|chr19:8238114-8238220,chr19,8238114,8238220,IMR90|chr19:48825955-48825973,chr19,48825955,48825973,0,40587841
IMR90|chr19:8320683-8320737,chr19,8320683,8320737,IMR90|chr19:54705488-54705528,chr19,54705488,54705528,0,46384805
IMR90|chr19:8327045-8327136,chr19,8327045,8327136,IMR90|chr19:39972124-39972149,chr19,39972124,39972149,0,31645079
IMR90|chr19:8682830-8682880,chr19,8682830,8682880,IMR90|chr19:38886970-38887039,chr19,38886970,38887039,0,30204140
IMR90|chr19:8794952-8795010,chr19,8794952,8795010,IMR90|chr19:41767831-41767917,chr19,41767831,41767917,0,32972879
IMR90|chr19:9149307-9149345,chr19,9149307,9149345,IMR90|chr19:47350084-47350196,chr19,47350084,47350196,0,38200777
IMR90|chr19:9159856-9159901,chr19,9159856,9159901,IMR90|chr19:53395885-53395964,chr19,53395885,53395964,0,44236029
IMR90|chr19:9210102-9210158,chr19,9210102,9210158,IMR90|chr19:2091743-2091821,chr19,2091743,2091821,0,7118359
IMR90|chr19:9300350-9300433,chr19,9300350,9300433,IMR90|chr19:41773077-41773139,chr19,41773077,41773139,0,32472727
IMR90|chr19:9442610-9442760,chr19,9442610,9442760,IMR90|chr19:37065051-37065171,chr19,37065051,37065171,0,27622441
IMR90|chr19:9683567-9683694,chr19,9683567,9683694,IMR90|chr19:2839557-2839591,chr19,2839557,2839591,0,6844010
IMR90|chr19:9766492-9766550,chr19,9766492,9766550,IMR90|chr19:17377287-17377330,chr19,17377287,17377330,0,7610795
IMR90|chr19:9822443-9822503,chr19,9822443,9822503,IMR90|chr19:56148620-56148709,chr19,56148620,56148709,0,46326177
IMR90|chr19:9956351-9956401,chr19,9956351,9956401,IMR90|chr19:16736611-16736652,chr19,16736611,16736652,0,6780260
IMR90|chr19:10202610-10202689,chr19,10202610,10202689,IMR90|chr19:54984148-54984179,chr19,54984148,54984179,0,44781538
IMR90|chr19:10412014-10412070,chr19,10412014,10412070,IMR90|chr19:16189854-16189894,chr19,16189854,16189894,0,5777840
IMR90|chr19:10444909-10445005,chr19,10444909,10445005,IMR90|chr19:10358731-10358766,chr19,10358731,10358766,0,86178
IMR90|chr19:10569045-10569152,chr19,10569045,10569152,IMR90|chr19:678647-678677,chr19,678647,678677,0,9890398
IMR90|chr19:10792005-10792102,chr19,10792005,10792102,IMR90|chr19:10358732-10358765,chr19,10358732,10358765,0,433273
IMR90|chr19:10841333-10841396,chr19,10841333,10841396,IMR90|chr19:50141077-50141135,chr19,50141077,50141135,0,39299744
IMR90|chr19:10855174-10855206,chr19,10855174,10855206,IMR90|chr19:45248299-45248394,chr19,45248299,45248394,0,34393125
IMR90|chr19:11109756-11109791,chr19,11109756,11109791,IMR90|chr19:13057600-13057707,chr19,13057600,13057707,0,1947844
IMR90|chr19:11378273-11378420,chr19,11378273,11378420,IMR90|chr19:39337700-39337745,chr19,39337700,39337745,0,27959427
IMR90|chr19:11451249-11451288,chr19,11451249,11451288,IMR90|chr19:39134904-39135015,chr19,39134904,39135015,0,27683655
IMR90|chr19:11933376-11933526,chr19,11933376,11933526,IMR90|chr19:16191463-16191597,chr19,16191463,16191597,0,4258087
IMR90|chr19:12488914-12489003,chr19,12488914,12489003,IMR90|chr19:38145869-38145968,chr19,38145869,38145968,0,25656955
IMR90|chr19:12505583-12505675,chr19,12505583,12505675,IMR90|chr19:37067138-37067187,chr19,37067138,37067187,0,24561555
IMR90|chr19:12570867-12570922,chr19,12570867,12570922,IMR90|chr19:10358683-10358729,chr19,10358683,10358729,0,2212184
IMR90|chr19:12597146-12597199,chr19,12597146,12597199,IMR90|chr19:13903990-13904055,chr19,13903990,13904055,0,1306844
IMR90|chr19:12759440-12759464,chr19,12759440,12759464,IMR90|chr19:17190026-17190112,chr19,17190026,17190112,0,4430586
IMR90|chr19:13019585-13019651,chr19,13019585,13019651,IMR90|chr19:39972124-39972148,chr19,39972124,39972148,0,26952539
IMR90|chr19:13093503-13093597,chr19,13093503,13093597,IMR90|chr19:4063924-4063970,chr19,4063924,4063970,0,9029579
IMR90|chr19:13230368-13230482,chr19,13230368,13230482,IMR90|chr19:15543554-15543576,chr19,15543554,15543576,0,2313186
IMR90|chr19:13352986-13353110,chr19,13352986,13353110,IMR90|chr19:33866133-33866212,chr19,33866133,33866212,0,20513147
IMR90|chr19:13371498-13371546,chr19,13371498,13371546,IMR90|chr19:44168300-44168359,chr19,44168300,44168359,0,30796802
IMR90|chr19:13399883-13400000,chr19,13399883,13400000,IMR90|chr19:14227315-14227348,chr19,14227315,14227348,0,827432
IMR90|chr19:13514427-13514475,chr19,13514427,13514475,IMR90|chr19:38886970-38887039,chr19,38886970,38887039,0,25372543
IMR90|chr19:13831700-13831728,chr19,13831700,13831728,IMR90|chr19:49864412-49864435,chr19,49864412,49864435,0,36032712
IMR90|chr19:13849881-13849935,chr19,13849881,13849935,IMR90|chr19:39141606-39141659,chr19,39141606,39141659,0,25291725
IMR90|chr19:13967356-13967433,chr19,13967356,13967433,IMR90|chr19:47352076-47352144,chr19,47352076,47352144,0,33384720
IMR90|chr19:13987456-13987511,chr19,13987456,13987511,IMR90|chr19:54705488-54705528,chr19,54705488,54705528,0,40718032
IMR90|chr19:14369266-14369367,chr19,14369266,14369367,IMR90|chr19:2949793-2949839,chr19,2949793,2949839,0,11419473
IMR90|chr19:14406989-14407044,chr19,14406989,14407044,IMR90|chr19:2091743-2091821,chr19,2091743,2091821,0,12315246
IMR90|chr19:14467480-14467572,chr19,14467480,14467572,IMR90|chr19:37067138-37067187,chr19,37067138,37067187,0,22599658
IMR90|chr19:14561111-14561139,chr19,14561111,14561139,IMR90|chr19:48250409-48250478,chr19,48250409,48250478,0,33689298
IMR90|chr19:14977034-14977128,chr19,14977034,14977128,IMR90|chr19:45256992-45257054,chr19,45256992,45257054,0,30279958
IMR90|chr19:15303749-15303803,chr19,15303749,15303803,IMR90|chr19:33866133-33866212,chr19,33866133,33866212,0,18562384
IMR90|chr19:15364717-15364750,chr19,15364717,15364750,IMR90|chr19:41773077-41773139,chr19,41773077,41773139,0,26408360
IMR90|chr19:15424237-15424286,chr19,15424237,15424286,IMR90|chr19:15315951-15316059,chr19,15315951,15316059,0,108286
IMR90|chr19:15514929-15514955,chr19,15514929,15514955,IMR90|chr19:58906808-58906892,chr19,58906808,58906892,0,43391879
IMR90|chr19:15721189-15721206,chr19,15721189,15721206,IMR90|chr19:15315941-15316059,chr19,15315941,15316059,0,405248
IMR90|chr19:15817903-15818003,chr19,15817903,15818003,IMR90|chr19:922572-922600,chr19,922572,922600,0,14895331
IMR90|chr19:15819884-15819908,chr19,15819884,15819908,IMR90|chr19:53192669-53192711,chr19,53192669,53192711,0,37372785
IMR90|chr19:15960649-15960745,chr19,15960649,15960745,IMR90|chr19:12205087-12205126,chr19,12205087,12205126,0,3755562
IMR90|chr19:16050376-16050411,chr19,16050376,16050411,IMR90|chr19:13057600-13057707,chr19,13057600,13057707,0,2992776
IMR90|chr19:16226396-16226450,chr19,16226396,16226450,IMR90|chr19:13903990-13904055,chr19,13903990,13904055,0,2322406
IMR90|chr19:16263492-16263554,chr19,16263492,16263554,IMR90|chr19:50141077-50141135,chr19,50141077,50141135,0,33877585
IMR90|chr19:16284154-16284182,chr19,16284154,16284182,IMR90|chr19:48250409-48250478,chr19,48250409,48250478,0,31966255
IMR90|chr19:16986337-16986409,chr19,16986337,16986409,IMR90|chr19:678642-678674,chr19,678642,678674,0,16307695
IMR90|chr19:17071123-17071200,chr19,17071123,17071200,IMR90|chr19:47352076-47352144,chr19,47352076,47352144,0,30280953
IMR90|chr19:17310832-17310864,chr19,17310832,17310864,IMR90|chr19:45248299-45248394,chr19,45248299,45248394,0,27937467
IMR90|chr19:17351793-17351898,chr19,17351793,17351898,IMR90|chr19:48825955-48825973,chr19,48825955,48825973,0,31474162
IMR90|chr19:17510361-17510453,chr19,17510361,17510453,IMR90|chr19:4063924-4063972,chr19,4063924,4063972,0,13446437
IMR90|chr19:17540279-17540346,chr19,17540279,17540346,IMR90|chr19:6527689-6527773,chr19,6527689,6527773,0,11012590
IMR90|chr19:17655130-17655280,chr19,17655130,17655280,IMR90|chr19:49458581-49458642,chr19,49458581,49458642,0,31803451
IMR90|chr19:18111060-18111108,chr19,18111060,18111108,IMR90|chr19:51303692-51303819,chr19,51303692,51303819,0,33192632
IMR90|chr19:18283844-18283949,chr19,18283844,18283949,IMR90|chr19:14226813-14226836,chr19,14226813,14226836,0,4057031
IMR90|chr19:18438396-18438507,chr19,18438396,18438507,IMR90|chr19:48248136-48248184,chr19,48248136,48248184,0,29809740
IMR90|chr19:18502206-18502318,chr19,18502206,18502318,IMR90|chr19:1018759-1018779,chr19,1018759,1018779,0,17483447
IMR90|chr19:18603955-18603997,chr19,18603955,18603997,IMR90|chr19:2092429-2092527,chr19,2092429,2092527,0,16511526
IMR90|chr19:18639919-18640064,chr19,18639919,18640064,IMR90|chr19:13078184-13078268,chr19,13078184,13078268,0,5561735
IMR90|chr19:18773327-18773367,chr19,18773327,18773367,IMR90|chr19:56150554-56150661,chr19,56150554,56150661,0,37377227
IMR90|chr19:19005997-19006089,chr19,19005997,19006089,IMR90|chr19:16190243-16190289,chr19,16190243,16190289,0,2815754
IMR90|chr19:19026561-19026621,chr19,19026561,19026621,IMR90|chr19:6527689-6527773,chr19,6527689,6527773,0,12498872
IMR90|chr19:19499887-19499963,chr19,19499887,19499963,IMR90|chr19:48248168-48248208,chr19,48248168,48248208,0,28748281
IMR90|chr19:19870116-19870176,chr19,19870116,19870176,IMR90|chr19:14224948-14225098,chr19,14224948,14225098,0,5645168
IMR90|chr19:20177715-20177770,chr19,20177715,20177770,IMR90|chr19:2091743-2091821,chr19,2091743,2091821,0,18085972
IMR90|chr19:20265828-20265880,chr19,20265828,20265880,IMR90|chr19:45248301-45248370,chr19,45248301,45248370,0,24982473
IMR90|chr19:20370315-20370375,chr19,20370315,20370375,IMR90|chr19:14224948-14225098,chr19,14224948,14225098,0,6145367
IMR90|chr19:20508140-20508184,chr19,20508140,20508184,IMR90|chr19:1400060-1400132,chr19,1400060,1400132,0,19108080
IMR90|chr19:20614353-20614442,chr19,20614353,20614442,IMR90|chr19:54983206-54983268,chr19,54983206,54983268,0,34368853
IMR90|chr19:20636163-20636222,chr19,20636163,20636222,IMR90|chr19:45248301-45248392,chr19,45248301,45248392,0,24612138
IMR90|chr19:20756956-20757019,chr19,20756956,20757019,IMR90|chr19:50141077-50141135,chr19,50141077,50141135,0,29384121
IMR90|chr19:20953801-20953886,chr19,20953801,20953886,IMR90|chr19:42911015-42911149,chr19,42911015,42911149,0,21957214
IMR90|chr19:20955069-20955135,chr19,20955069,20955135,IMR90|chr19:39336119-39336161,chr19,39336119,39336161,0,18381050
IMR90|chr19:21048588-21048694,chr19,21048588,21048694,IMR90|chr19:15542816-15542836,chr19,15542816,15542836,0,5505772
IMR90|chr19:21177480-21177546,chr19,21177480,21177546,IMR90|chr19:39336119-39336161,chr19,39336119,39336161,0,18158639
IMR90|chr19:21200972-21201048,chr19,21200972,21201048,IMR90|chr19:16181079-16181153,chr19,16181079,16181153,0,5019893
IMR90|chr19:21310882-21310970,chr19,21310882,21310970,IMR90|chr19:45256992-45257054,chr19,45256992,45257054,0,23946110
IMR90|chr19:22025417-22025511,chr19,22025417,22025511,IMR90|chr19:56148620-56148710,chr19,56148620,56148710,0,34123203
IMR90|chr19:22491481-22491505,chr19,22491481,22491505,IMR90|chr19:15315934-15316059,chr19,15315934,15316059,0,7175547
IMR90|chr19:22657203-22657261,chr19,22657203,22657261,IMR90|chr19:17377287-17377330,chr19,17377287,17377330,0,5279916
IMR90|chr19:22857873-22857953,chr19,22857873,22857953,IMR90|chr19:53899391-53899505,chr19,53899391,53899505,0,31041518
IMR90|chr19:23196701-23196750,chr19,23196701,23196750,IMR90|chr19:44168300-44168359,chr19,44168300,44168359,0,20971599
IMR90|chr19:23255763-23255820,chr19,23255763,23255820,IMR90|chr19:3626143-3626205,chr19,3626143,3626205,0,19629620
IMR90|chr19:23265268-23265311,chr19,23265268,23265311,IMR90|chr19:53396065-53396147,chr19,53396065,53396147,0,30130797
IMR90|chr19:23400839-23400869,chr19,23400839,23400869,IMR90|chr19:48250409-48250478,chr19,48250409,48250478,0,24849570
IMR90|chr19:23418390-23418452,chr19,23418390,23418452,IMR90|chr19:56153343-56153416,chr19,56153343,56153416,0,32734953
IMR90|chr19:23865130-23865190,chr19,23865130,23865190,IMR90|chr19:16189854-16189894,chr19,16189854,16189894,0,7675276
IMR90|chr19:24182673-24182729,chr19,24182673,24182729,IMR90|chr19:19031323-19031371,chr19,19031323,19031371,0,5151350
IMR90|chr19:24607191-24607301,chr19,24607191,24607301,IMR90|chr19:14226813-14226836,chr19,14226813,14226836,0,10380378
IMR90|chr19:24986820-24986837,chr19,24986820,24986837,IMR90|chr19:17379305-17379390,chr19,17379305,17379390,0,7607515
IMR90|chr19:25109645-25109712,chr19,25109645,25109712,IMR90|chr19:6527689-6527773,chr19,6527689,6527773,0,18581956
IMR90|chr19:25188637-25188716,chr19,25188637,25188716,IMR90|chr19:54984148-54984179,chr19,54984148,54984179,0,29795511
IMR90|chr19:25254762-25254847,chr19,25254762,25254847,IMR90|chr19:45876133-45876205,chr19,45876133,45876205,0,20621371
IMR90|chr19:26010411-26010437,chr19,26010411,26010437,IMR90|chr19:38888526-38888635,chr19,38888526,38888635,0,12878115
IMR90|chr19:26029613-26029651,chr19,26029613,26029651,IMR90|chr19:47350084-47350196,chr19,47350084,47350196,0,21320471
IMR90|chr19:26268933-26268983,chr19,26268933,26268983,IMR90|chr19:47732723-47732821,chr19,47732723,47732821,0,21463790
IMR90|chr19:26884051-26884104,chr19,26884051,26884104,IMR90|chr19:8375589-8375625,chr19,8375589,8375625,0,18508462
IMR90|chr19:27007399-27007452,chr19,27007399,27007452,IMR90|chr19:8375589-8375625,chr19,8375589,8375625,0,18631810
IMR90|chr19:27009059-27009123,chr19,27009059,27009123,IMR90|chr19:44168624-44168644,chr19,44168624,44168644,0,17159565
IMR90|chr19:27069611-27069636,chr19,27069611,27069636,IMR90|chr19:17190026-17190112,chr19,17190026,17190112,0,9879585
IMR90|chr19:27145833-27145883,chr19,27145833,27145883,IMR90|chr19:38886970-38887039,chr19,38886970,38887039,0,11741137
IMR90|chr19:27860010-27860069,chr19,27860010,27860069,IMR90|chr19:41767831-41767917,chr19,41767831,41767917,0,13907821
IMR90|chr19:28004457-28004561,chr19,28004457,28004561,IMR90|chr19:45248301-45248392,chr19,45248301,45248392,0,17243844
IMR90|chr19:28032782-28032871,chr19,28032782,28032871,IMR90|chr19:49458581-49458642,chr19,49458581,49458642,0,21425799
IMR90|chr19:28873082-28873112,chr19,28873082,28873112,IMR90|chr19:16189659-16189705,chr19,16189659,16189705,0,12683423
IMR90|chr19:28914407-28914496,chr19,28914407,28914496,IMR90|chr19:38145869-38145968,chr19,38145869,38145968,0,9231462
IMR90|chr19:29048642-29048739,chr19,29048642,29048739,IMR90|chr19:45248176-45248216,chr19,45248176,45248216,0,16199534
IMR90|chr19:29051933-29052039,chr19,29051933,29052039,IMR90|chr19:19976821-19976967,chr19,19976821,19976967,0,9075112
IMR90|chr19:29384328-29384434,chr19,29384328,29384434,IMR90|chr19:39141903-39141941,chr19,39141903,39141941,0,9757575
IMR90|chr19:29416696-29416731,chr19,29416696,29416731,IMR90|chr19:45248299-45248394,chr19,45248299,45248394,0,15831603
IMR90|chr19:29491623-29491668,chr19,29491623,29491668,IMR90|chr19:16736611-16736657,chr19,16736611,16736657,0,12755012
IMR90|chr19:29585694-29585719,chr19,29585694,29585719,IMR90|chr19:36641766-36641824,chr19,36641766,36641824,0,7056072
IMR90|chr19:29663478-29663576,chr19,29663478,29663576,IMR90|chr19:45248371-45248395,chr19,45248371,45248395,0,15584893
IMR90|chr19:29737234-29737340,chr19,29737234,29737340,IMR90|chr19:39141903-39141941,chr19,39141903,39141941,0,9404669
IMR90|chr19:29767366-29767392,chr19,29767366,29767392,IMR90|chr19:53192872-53193013,chr19,53192872,53193013,0,23425506
IMR90|chr19:30219112-30219225,chr19,30219112,30219225,IMR90|chr19:2839557-2839591,chr19,2839557,2839591,0,27379555
IMR90|chr19:30764704-30764802,chr19,30764704,30764802,IMR90|chr19:678641-678674,chr19,678641,678674,0,30086063
IMR90|chr19:30777417-30777482,chr19,30777417,30777482,IMR90|chr19:53899407-53899492,chr19,53899407,53899492,0,23121990
IMR90|chr19:30919947-30920002,chr19,30919947,30920002,IMR90|chr19:18632262-18632352,chr19,18632262,18632352,0,12287685
IMR90|chr19:30981522-30981600,chr19,30981522,30981600,IMR90|chr19:6527689-6527773,chr19,6527689,6527773,0,24453833
IMR90|chr19:31125617-31125660,chr19,31125617,31125660,IMR90|chr19:53396065-53396147,chr19,53396065,53396147,0,22270448
IMR90|chr19:31210302-31210329,chr19,31210302,31210329,IMR90|chr19:58906808-58906892,chr19,58906808,58906892,0,27696506
IMR90|chr19:31460563-31460589,chr19,31460563,31460589,IMR90|chr19:38888526-38888635,chr19,38888526,38888635,0,7427963
IMR90|chr19:31463671-31463749,chr19,31463671,31463749,IMR90|chr19:47354798-47354845,chr19,47354798,47354845,0,15891127
IMR90|chr19:31502360-31502409,chr19,31502360,31502409,IMR90|chr19:15315951-15316059,chr19,15315951,15316059,0,16186409
IMR90|chr19:31542014-31542065,chr19,31542014,31542065,IMR90|chr19:47732723-47732821,chr19,47732723,47732821,0,16190709
IMR90|chr19:31552563-31552603,chr19,31552563,31552603,IMR90|chr19:1400060-1400132,chr19,1400060,1400132,0,30152503
IMR90|chr19:31589438-31589490,chr19,31589438,31589490,IMR90|chr19:45248301-45248370,chr19,45248301,45248370,0,13658863
IMR90|chr19:31738665-31738759,chr19,31738665,31738759,IMR90|chr19:45256992-45257054,chr19,45256992,45257054,0,13518327
IMR90|chr19:31993991-31994051,chr19,31993991,31994051,IMR90|chr19:56148620-56148709,chr19,56148620,56148709,0,24154629
IMR90|chr19:32272727-32272778,chr19,32272727,32272778,IMR90|chr19:47732723-47732821,chr19,47732723,47732821,0,15459996
IMR90|chr19:32351472-32351543,chr19,32351472,32351543,IMR90|chr19:33866133-33866212,chr19,33866133,33866212,0,1514661
IMR90|chr19:32451462-32451579,chr19,32451462,32451579,IMR90|chr19:14227315-14227348,chr19,14227315,14227348,0,18224147
IMR90|chr19:32516095-32516196,chr19,32516095,32516196,IMR90|chr19:2949793-2949839,chr19,2949793,2949839,0,29566302
IMR90|chr19:32722719-32722797,chr19,32722719,32722797,IMR90|chr19:6527689-6527773,chr19,6527689,6527773,0,26195030
IMR90|chr19:32731351-32731403,chr19,32731351,32731403,IMR90|chr19:39141606-39141661,chr19,39141606,39141661,0,6410255
IMR90|chr19:32778407-32778483,chr19,32778407,32778483,IMR90|chr19:2093943-2093985,chr19,2093943,2093985,0,30684464
IMR90|chr19:32841486-32841508,chr19,32841486,32841508,IMR90|chr19:39882552-39882616,chr19,39882552,39882616,0,7041066
IMR90|chr19:32874688-32874747,chr19,32874688,32874747,IMR90|chr19:45248301-45248392,chr19,45248301,45248392,0,12373613
IMR90|chr19:32995545-32995599,chr19,32995545,32995599,IMR90|chr19:39141606-39141659,chr19,39141606,39141659,0,6146061
IMR90|chr19:33102056-33102112,chr19,33102056,33102112,IMR90|chr19:39972124-39972149,chr19,39972124,39972149,0,6870068
IMR90|chr19:33138001-33138018,chr19,33138001,33138018,IMR90|chr19:15315941-15316059,chr19,15315941,15316059,0,17822060
IMR90|chr19:33441920-33441954,chr19,33441920,33441954,IMR90|chr19:58325105-58325200,chr19,58325105,58325200,0,24883185
IMR90|chr19:33470763-33470821,chr19,33470763,33470821,IMR90|chr19:19776396-19776543,chr19,19776396,19776543,0,13694367
IMR90|chr19:33500477-33500578,chr19,33500477,33500578,IMR90|chr19:3629601-3629650,chr19,3629601,3629650,0,29870876
IMR90|chr19:33501544-33501642,chr19,33501544,33501642,IMR90|chr19:18649875-18649927,chr19,18649875,18649927,0,14851669
IMR90|chr19:33713241-33713301,chr19,33713241,33713301,IMR90|chr19:16189854-16189894,chr19,16189854,16189894,0,17523387
IMR90|chr19:34004637-34004738,chr19,34004637,34004738,IMR90|chr19:16181079-16181125,chr19,16181079,16181125,0,17823558
IMR90|chr19:34077077-34077144,chr19,34077077,34077144,IMR90|chr19:39336119-39336161,chr19,39336119,39336161,0,5259042
IMR90|chr19:34108669-34108725,chr19,34108669,34108725,IMR90|chr19:39972124-39972149,chr19,39972124,39972149,0,5863455
IMR90|chr19:34117050-34117079,chr19,34117050,34117079,IMR90|chr19:16189659-16189706,chr19,16189659,16189706,0,17927391
IMR90|chr19:34142092-34142135,chr19,34142092,34142135,IMR90|chr19:13042404-13042538,chr19,13042404,13042538,0,21099688
IMR90|chr19:34494516-34494540,chr19,34494516,34494540,IMR90|chr19:17190026-17190112,chr19,17190026,17190112,0,17304490
IMR90|chr19:34733309-34733394,chr19,34733309,34733394,IMR90|chr19:45876133-45876205,chr19,45876133,45876205,0,11142824
IMR90|chr19:34943196-34943303,chr19,34943196,34943303,IMR90|chr19:48247468-48247583,chr19,48247468,48247583,0,13304272
IMR90|chr19:35090505-35090535,chr19,35090505,35090535,IMR90|chr19:16189659-16189705,chr19,16189659,16189705,0,18900846
IMR90|chr19:35177290-35177384,chr19,35177290,35177384,IMR90|chr19:56148620-56148710,chr19,56148620,56148710,0,20971330
IMR90|chr19:35211056-35211203,chr19,35211056,35211203,IMR90|chr19:53192541-53192691,chr19,53192541,53192691,0,17981485
IMR90|chr19:35408649-35408727,chr19,35408649,35408727,IMR90|chr19:45876133-45876205,chr19,45876133,45876205,0,10467484
IMR90|chr19:35687874-35687906,chr19,35687874,35687906,IMR90|chr19:39134061-39134123,chr19,39134061,39134123,0,3446187
IMR90|chr19:35742153-35742205,chr19,35742153,35742205,IMR90|chr19:47352016-47352137,chr19,47352016,47352137,0,11609863
IMR90|chr19:35865643-35865697,chr19,35865643,35865697,IMR90|chr19:8375589-8375625,chr19,8375589,8375625,0,27490054
IMR90|chr19:36395516-36395590,chr19,36395516,36395590,IMR90|chr19:18649851-18649927,chr19,18649851,18649927,0,17745665
IMR90|chr19:36445796-36445871,chr19,36445796,36445871,IMR90|chr19:12303003-12303043,chr19,12303003,12303043,0,24142793
IMR90|chr19:36554024-36554080,chr19,36554024,36554080,IMR90|chr19:3626143-3626205,chr19,3626143,3626205,0,32927881
IMR90|chr19:36692626-36692701,chr19,36692626,36692701,IMR90|chr19:41308244-41308294,chr19,41308244,41308294,0,4615618
IMR90|chr19:36736276-36736329,chr19,36736276,36736329,IMR90|chr19:13903990-13904055,chr19,13903990,13904055,0,22832286
IMR90|chr19:36929602-36929749,chr19,36929602,36929749,IMR90|chr19:39337700-39337745,chr19,39337700,39337745,0,2408098
IMR90|chr19:36956997-36957051,chr19,36956997,36957051,IMR90|chr19:17378488-17378548,chr19,17378488,17378548,0,19578509
IMR90|chr19:37095498-37095555,chr19,37095498,37095555,IMR90|chr19:19776396-19776543,chr19,19776396,19776543,0,17319102
IMR90|chr19:37109469-37109495,chr19,37109469,37109495,IMR90|chr19:58906808-58906892,chr19,58906808,58906892,0,21797339
IMR90|chr19:37208102-37208157,chr19,37208102,37208157,IMR90|chr19:10358683-10358729,chr19,10358683,10358729,0,26849419
IMR90|chr19:37316198-37316255,chr19,37316198,37316255,IMR90|chr19:19776396-19776543,chr19,19776396,19776543,0,17539802
IMR90|chr19:37926997-37927096,chr19,37926997,37927096,IMR90|chr19:922572-922600,chr19,922572,922600,0,37004425
IMR90|chr19:38062620-38062682,chr19,38062620,38062682,IMR90|chr19:50141077-50141135,chr19,50141077,50141135,0,12078457
IMR90|chr19:38117155-38117203,chr19,38117155,38117203,IMR90|chr19:18632387-18632489,chr19,18632387,18632489,0,19484768
IMR90|chr19:38240768-38240831,chr19,38240768,38240831,IMR90|chr19:47352899-47352961,chr19,47352899,47352961,0,9112131
IMR90|chr19:38313960-38314023,chr19,38313960,38314023,IMR90|chr19:47352899-47352961,chr19,47352899,47352961,0,9038939
IMR90|chr19:38461559-38461647,chr19,38461559,38461647,IMR90|chr19:45256992-45257054,chr19,45256992,45257054,0,6795433
IMR90|chr19:38624073-38624115,chr19,38624073,38624115,IMR90|chr19:39336728-39336836,chr19,39336728,39336836,0,712655
IMR90|chr19:38750422-38750462,chr19,38750422,38750462,IMR90|chr19:56150554-56150661,chr19,56150554,56150661,0,17400132
IMR90|chr19:38775413-38775519,chr19,38775413,38775519,IMR90|chr19:48825955-48825973,chr19,48825955,48825973,0,10050542
IMR90|chr19:38834257-38834311,chr19,38834257,38834311,IMR90|chr19:13903990-13904055,chr19,13903990,13904055,0,24930267
IMR90|chr19:39198925-39199033,chr19,39198925,39199033,IMR90|chr19:2093943-2093985,chr19,2093943,2093985,0,37104982
IMR90|chr19:39225521-39225572,chr19,39225521,39225572,IMR90|chr19:38145869-38145968,chr19,38145869,38145968,0,1079652
IMR90|chr19:39238283-39238387,chr19,39238283,39238387,IMR90|chr19:45248301-45248392,chr19,45248301,45248392,0,6010018
IMR90|chr19:39765715-39765787,chr19,39765715,39765787,IMR90|chr19:678642-678674,chr19,678642,678674,0,39087073
IMR90|chr19:39860292-39860339,chr19,39860292,39860339,IMR90|chr19:47732723-47732821,chr19,47732723,47732821,0,7872431
IMR90|chr19:39889975-39890032,chr19,39889975,39890032,IMR90|chr19:574505-574567,chr19,574505,574567,0,39315470
IMR90|chr19:40262740-40262790,chr19,40262740,40262790,IMR90|chr19:16736611-16736652,chr19,16736611,16736652,0,23526129
IMR90|chr19:40388597-40388703,chr19,40388597,40388703,IMR90|chr19:38732171-38732215,chr19,38732171,38732215,0,1656426
IMR90|chr19:40424894-40424918,chr19,40424894,40424918,IMR90|chr19:53192669-53192711,chr19,53192669,53192711,0,12767775
IMR90|chr19:40457953-40458066,chr19,40457953,40458066,IMR90|chr19:2839557-2839591,chr19,2839557,2839591,0,37618396
IMR90|chr19:40502138-40502197,chr19,40502138,40502197,IMR90|chr19:53395885-53395964,chr19,53395885,53395964,0,12893747
IMR90|chr19:40684897-40684947,chr19,40684897,40684947,IMR90|chr19:47732723-47732821,chr19,47732723,47732821,0,7047826
IMR90|chr19:41053645-41053772,chr19,41053645,41053772,IMR90|chr19:2839557-2839591,chr19,2839557,2839591,0,38214088
IMR90|chr19:41054519-41054608,chr19,41054519,41054608,IMR90|chr19:49458581-49458642,chr19,49458581,49458642,0,8404062
IMR90|chr19:41212140-41212245,chr19,41212140,41212245,IMR90|chr19:48825955-48825973,chr19,48825955,48825973,0,7613815
IMR90|chr19:41355007-41355108,chr19,41355007,41355108,IMR90|chr19:3629601-3629650,chr19,3629601,3629650,0,37725406
IMR90|chr19:41420053-41420098,chr19,41420053,41420098,IMR90|chr19:53395885-53395964,chr19,53395885,53395964,0,11975832
IMR90|chr19:41520248-41520344,chr19,41520248,41520344,IMR90|chr19:12205087-12205126,chr19,12205087,12205126,0,29315161
IMR90|chr19:41645171-41645233,chr19,41645171,41645233,IMR90|chr19:41767831-41767917,chr19,41767831,41767917,0,122660
IMR90|chr19:41726956-41727031,chr19,41726956,41727031,IMR90|chr19:39336728-39336803,chr19,39336728,39336803,0,2390228
IMR90|chr19:42166445-42166497,chr19,42166445,42166497,IMR90|chr19:19031324-19031371,chr19,19031324,19031371,0,23135121
IMR90|chr19:42195593-42195731,chr19,42195593,42195731,IMR90|chr19:2949793-2949839,chr19,2949793,2949839,0,39245800
IMR90|chr19:42236807-42236837,chr19,42236807,42236837,IMR90|chr19:47352584-47352680,chr19,47352584,47352680,0,5115777
IMR90|chr19:42385453-42385563,chr19,42385453,42385563,IMR90|chr19:14226813-14226836,chr19,14226813,14226836,0,28158640
IMR90|chr19:42403044-42403128,chr19,42403044,42403128,IMR90|chr19:56150554-56150661,chr19,56150554,56150661,0,13747510
IMR90|chr19:42590722-42590755,chr19,42590722,42590755,IMR90|chr19:41773077-41773139,chr19,41773077,41773139,0,817645
IMR90|chr19:42687993-42688035,chr19,42687993,42688035,IMR90|chr19:39969527-39969576,chr19,39969527,39969576,0,2718466
IMR90|chr19:42700015-42700038,chr19,42700015,42700038,IMR90|chr19:42365289-42365338,chr19,42365289,42365338,0,334726
IMR90|chr19:42825303-42825453,chr19,42825303,42825453,IMR90|chr19:16191463-16191597,chr19,16191463,16191597,0,26633840
IMR90|chr19:42850146-42850234,chr19,42850146,42850234,IMR90|chr19:16189360-16189412,chr19,16189360,16189412,0,26660786
IMR90|chr19:42934428-42934476,chr19,42934428,42934476,IMR90|chr19:18632387-18632489,chr19,18632387,18632489,0,24302041
IMR90|chr19:42990352-42990427,chr19,42990352,42990427,IMR90|chr19:41308244-41308294,chr19,41308244,41308294,0,1682108
IMR90|chr19:43226389-43226444,chr19,43226389,43226444,IMR90|chr19:18632262-18632352,chr19,18632262,18632352,0,24594127
IMR90|chr19:43318411-43318430,chr19,43318411,43318430,IMR90|chr19:56150897-56151028,chr19,56150897,56151028,0,12832486
IMR90|chr19:44002144-44002211,chr19,44002144,44002211,IMR90|chr19:39336119-39336161,chr19,39336119,39336161,0,4666025
IMR90|chr19:44145203-44145283,chr19,44145203,44145283,IMR90|chr19:53899391-53899505,chr19,53899391,53899505,0,9754188
IMR90|chr19:44174914-44174970,chr19,44174914,44174970,IMR90|chr19:16189854-16189894,chr19,16189854,16189894,0,27985060
IMR90|chr19:44178308-44178408,chr19,44178308,44178408,IMR90|chr19:922572-922600,chr19,922572,922600,0,43255736
IMR90|chr19:44267949-44268027,chr19,44267949,44268027,IMR90|chr19:48248168-48248208,chr19,48248168,48248208,0,3980219
IMR90|chr19:44479769-44479824,chr19,44479769,44479824,IMR90|chr19:54705488-54705528,chr19,54705488,54705528,0,10225719
IMR90|chr19:44525882-44525958,chr19,44525882,44525958,IMR90|chr19:48248168-48248208,chr19,48248168,48248208,0,3722286
IMR90|chr19:44821077-44821184,chr19,44821077,44821184,IMR90|chr19:48247468-48247583,chr19,48247468,48247583,0,3426391
IMR90|chr19:44949739-44949840,chr19,44949739,44949840,IMR90|chr19:16181079-16181125,chr19,16181079,16181125,0,28768660
IMR90|chr19:45181501-45181591,chr19,45181501,45181591,IMR90|chr19:47352076-47352144,chr19,47352076,47352144,0,2170575
IMR90|chr19:45222941-45223053,chr19,45222941,45223053,IMR90|chr19:45879048-45879195,chr19,45879048,45879195,0,656107
IMR90|chr19:45223522-45223572,chr19,45223522,45223572,IMR90|chr19:2949718-2949865,chr19,2949718,2949865,0,42273804
IMR90|chr19:45257184-45257272,chr19,45257184,45257272,IMR90|chr19:16189360-16189412,chr19,16189360,16189412,0,29067824
IMR90|chr19:45369150-45369194,chr19,45369150,45369194,IMR90|chr19:912913-912934,chr19,912913,912934,0,44456237
IMR90|chr19:45433105-45433137,chr19,45433105,45433137,IMR90|chr19:39134061-39134123,chr19,39134061,39134123,0,6299044
IMR90|chr19:45896055-45896173,chr19,45896055,45896173,IMR90|chr19:2093943-2093985,chr19,2093943,2093985,0,43802112
IMR90|chr19:46029671-46029769,chr19,46029671,46029769,IMR90|chr19:18649875-18649927,chr19,18649875,18649927,0,27379796
IMR90|chr19:46172395-46172428,chr19,46172395,46172428,IMR90|chr19:38888608-38888628,chr19,38888608,38888628,0,7283787
IMR90|chr19:46186168-46186187,chr19,46186168,46186187,IMR90|chr19:56150897-56151028,chr19,56150897,56151028,0,9964729
IMR90|chr19:46533931-46534037,chr19,46533931,46534037,IMR90|chr19:19976821-19976967,chr19,19976821,19976967,0,26557110
IMR90|chr19:46752368-46752407,chr19,46752368,46752407,IMR90|chr19:39134904-39135015,chr19,39134904,39135015,0,7617464
IMR90|chr19:46920303-46920338,chr19,46920303,46920338,IMR90|chr19:45248299-45248394,chr19,45248299,45248394,0,1672004
IMR90|chr19:46976923-46977022,chr19,46976923,46977022,IMR90|chr19:922572-922600,chr19,922572,922600,0,46054351
IMR90|chr19:47624994-47625084,chr19,47624994,47625084,IMR90|chr19:47352076-47352144,chr19,47352076,47352144,0,272918
IMR90|chr19:47663167-47663207,chr19,47663167,47663207,IMR90|chr19:1400060-1400132,chr19,1400060,1400132,0,46263107
IMR90|chr19:47988849-47988874,chr19,47988849,47988874,IMR90|chr19:17190026-17190112,chr19,17190026,17190112,0,30798823
IMR90|chr19:48349617-48349671,chr19,48349617,48349671,IMR90|chr19:8375589-8375625,chr19,8375589,8375625,0,39974028
IMR90|chr19:48499596-48499681,chr19,48499596,48499681,IMR90|chr19:42911015-42911149,chr19,42911015,42911149,0,5588581
IMR90|chr19:48672708-48672800,chr19,48672708,48672800,IMR90|chr19:4063924-4063972,chr19,4063924,4063972,0,44608784
IMR90|chr19:48862590-48862638,chr19,48862590,48862638,IMR90|chr19:51303692-51303819,chr19,51303692,51303819,0,2441102
IMR90|chr19:48965392-48965499,chr19,48965392,48965499,IMR90|chr19:678647-678677,chr19,678647,678677,0,48286745
IMR90|chr19:49287790-49287844,chr19,49287790,49287844,IMR90|chr19:17378488-17378548,chr19,17378488,17378548,0,31909302
IMR90|chr19:49330138-49330186,chr19,49330138,49330186,IMR90|chr19:17333579-17333698,chr19,17333579,17333698,0,31996559
IMR90|chr19:49674433-49674540,chr19,49674433,49674540,IMR90|chr19:48825955-48825973,chr19,48825955,48825973,0,848478
IMR90|chr19:49941597-49941709,chr19,49941597,49941709,IMR90|chr19:1018759-1018779,chr19,1018759,1018779,0,48922838
IMR90|chr19:50003711-50003731,chr19,50003711,50003731,IMR90|chr19:45248301-45248405,chr19,45248301,45248405,0,4755410
IMR90|chr19:50077699-50077757,chr19,50077699,50077757,IMR90|chr19:19776396-19776543,chr19,19776396,19776543,0,30301303
IMR90|chr19:50203838-50203897,chr19,50203838,50203897,IMR90|chr19:41767831-41767917,chr19,41767831,41767917,0,8436007
IMR90|chr19:50243436-50243541,chr19,50243436,50243541,IMR90|chr19:19976821-19976967,chr19,19976821,19976967,0,30266615
IMR90|chr19:50317292-50317403,chr19,50317292,50317403,IMR90|chr19:48248136-48248184,chr19,48248136,48248184,0,2069156
IMR90|chr19:50496616-50496678,chr19,50496616,50496678,IMR90|chr19:41767831-41767917,chr19,41767831,41767917,0,8728785
IMR90|chr19:50820598-50820690,chr19,50820598,50820690,IMR90|chr19:16190243-16190289,chr19,16190243,16190289,0,34630355
IMR90|chr19:51079498-51079527,chr19,51079498,51079527,IMR90|chr19:16189659-16189706,chr19,16189659,16189706,0,34889839
IMR90|chr19:51197911-51198058,chr19,51197911,51198058,IMR90|chr19:53192541-53192691,chr19,53192541,53192691,0,1994630
IMR90|chr19:51292914-51292992,chr19,51292914,51292992,IMR90|chr19:47354798-47354845,chr19,47354798,47354845,0,3938116
IMR90|chr19:51454561-51454591,chr19,51454561,51454591,IMR90|chr19:47352584-47352680,chr19,47352584,47352680,0,4101977
IMR90|chr19:51581871-51581999,chr19,51581871,51581999,IMR90|chr19:2839557-2839591,chr19,2839557,2839591,0,48742314
IMR90|chr19:51663609-51663732,chr19,51663609,51663732,IMR90|chr19:14227315-14227348,chr19,14227315,14227348,0,37436294
IMR90|chr19:51816444-51816550,chr19,51816444,51816550,IMR90|chr19:15542816-15542836,chr19,15542816,15542836,0,36273628
IMR90|chr19:51909220-51909271,chr19,51909220,51909271,IMR90|chr19:38145869-38145968,chr19,38145869,38145968,0,13763351
IMR90|chr19:51928883-51928909,chr19,51928883,51928909,IMR90|chr19:53192872-53193013,chr19,53192872,53193013,0,1263989
IMR90|chr19:52797096-52797194,chr19,52797096,52797194,IMR90|chr19:45248371-45248395,chr19,45248371,45248395,0,7548725
IMR90|chr19:53121776-53121815,chr19,53121776,53121815,IMR90|chr19:15315951-15316059,chr19,15315951,15316059,0,37805825
IMR90|chr19:53145875-53145900,chr19,53145875,53145900,IMR90|chr19:36641766-36641824,chr19,36641766,36641824,0,16504109
IMR90|chr19:53265609-53265666,chr19,53265609,53265666,IMR90|chr19:3626143-3626205,chr19,3626143,3626205,0,49639466
IMR90|chr19:53290751-53290794,chr19,53290751,53290794,IMR90|chr19:13042404-13042538,chr19,13042404,13042538,0,40248347
IMR90|chr19:53339384-53339458,chr19,53339384,53339458,IMR90|chr19:18649851-18649927,chr19,18649851,18649927,0,34689533
IMR90|chr19:53378991-53379080,chr19,53378991,53379080,IMR90|chr19:54983206-54983268,chr19,54983206,54983268,0,1604215
IMR90|chr19:53895799-53895844,chr19,53895799,53895844,IMR90|chr19:16736611-16736657,chr19,16736611,16736657,0,37159188
IMR90|chr19:54153831-54153879,chr19,54153831,54153879,IMR90|chr19:44168300-44168359,chr19,44168300,44168359,0,9985531
IMR90|chr19:54715384-54715442,chr19,54715384,54715442,IMR90|chr19:41767831-41767917,chr19,41767831,41767917,0,12947553
IMR90|chr19:54867804-54867857,chr19,54867804,54867857,IMR90|chr19:18632262-18632352,chr19,18632262,18632352,0,36235542
IMR90|chr19:54871640-54871716,chr19,54871640,54871716,IMR90|chr19:16181079-16181153,chr19,16181079,16181153,0,38690561
IMR90|chr19:54998157-54998254,chr19,54998157,54998254,IMR90|chr19:45248176-45248216,chr19,45248176,45248216,0,9749981
IMR90|chr19:55121247-55121345,chr19,55121247,55121345,IMR90|chr19:678641-678674,chr19,678641,678674,0,54442606
IMR90|chr19:55245865-55245896,chr19,55245865,55245896,IMR90|chr19:30205285-30205404,chr19,30205285,30205404,0,25040580
IMR90|chr19:55653261-55653389,chr19,55653261,55653389,IMR90|chr19:2839557-2839591,chr19,2839557,2839591,0,52813704
IMR90|chr19:55658764-55658794,chr19,55658764,55658794,IMR90|chr19:48250409-48250478,chr19,48250409,48250478,0,7408355
IMR90|chr19:56045575-56045602,chr19,56045575,56045602,IMR90|chr19:58906808-58906892,chr19,58906808,58906892,0,2861233
IMR90|chr19:56236284-56236375,chr19,56236284,56236375,IMR90|chr19:39972124-39972149,chr19,39972124,39972149,0,16264160
IMR90|chr19:56521268-56521392,chr19,56521268,56521392,IMR90|chr19:33866133-33866212,chr19,33866133,33866212,0,22655135
IMR90|chr19:56544957-56545013,chr19,56544957,56545013,IMR90|chr19:39134904-39135015,chr19,39134904,39135015,0,17410053
IMR90|chr19:56761585-56761735,chr19,56761585,56761735,IMR90|chr19:37065051-37065171,chr19,37065051,37065171,0,19696534
IMR90|chr19:56781687-56781722,chr19,56781687,56781722,IMR90|chr19:39972124-39972148,chr19,39972124,39972148,0,16809563
IMR90|chr19:56799366-56799463,chr19,56799366,56799463,IMR90|chr19:10358732-10358765,chr19,10358732,10358765,0,46440634
IMR90|chr19:56834645-56834688,chr19,56834645,56834688,IMR90|chr19:2092429-2092527,chr19,2092429,2092527,0,54742216
IMR90|chr19:56914853-56914910,chr19,56914853,56914910,IMR90|chr19:574505-574567,chr19,574505,574567,0,56340348
IMR90|chr19:57335377-57335397,chr19,57335377,57335397,IMR90|chr19:45248301-45248405,chr19,45248301,45248405,0,12087076
IMR90|chr19:57706398-57706426,chr19,57706398,57706426,IMR90|chr19:49864412-49864435,chr19,49864412,49864435,0,7841986
IMR90|chr19:57933002-57933046,chr19,57933002,57933046,IMR90|chr19:912913-912934,chr19,912913,912934,0,57020089
IMR90|chr19:58062090-58062150,chr19,58062090,58062150,IMR90|chr19:6527689-6527773,chr19,6527689,6527773,0,51534401
IMR90|chr19:58103470-58103487,chr19,58103470,58103487,IMR90|chr19:17379305-17379390,chr19,17379305,17379390,0,40724165
IMR90|chr19:58251894-58251943,chr19,58251894,58251943,IMR90|chr19:41311233-41311331,chr19,41311233,41311331,0,16940661
IMR90|chr19:58302378-58302460,chr19,58302378,58302460,IMR90|chr19:678646-678677,chr19,678646,678677,0,57623732
IMR90|chr19:58364700-58364807,chr19,58364700,58364807,IMR90|chr19:15315934-15316059,chr19,15315934,15316059,0,43048766
IMR90|chr19:58460644-58460722,chr19,58460644,58460722,IMR90|chr19:48248168-48248208,chr19,48248168,48248208,0,10212476
IMR90|chr19:58597886-58597940,chr19,58597886,58597940,IMR90|chr19:54705488-54705528,chr19,54705488,54705528,0,3892398
IMR90|chr19:58650268-58650418,chr19,58650268,58650418,IMR90|chr19:49458581-49458642,chr19,49458581,49458642,0,9191687
IMR90|chr19:58721587-58721653,chr19,58721587,58721653,IMR90|chr19:39972124-39972148,chr19,39972124,39972148,0,18749463
IMR90|chr19:58844747-58844838,chr19,58844747,58844838,IMR90|chr19:48248136-48248184,chr19,48248136,48248184,0,10596611
IMR90|chr20:1158964-1158996,chr20,1158964,1158996,IMR90|chr20:19867770-19867825,chr20,19867770,19867825,0,18708806
IMR90|chr20:1244723-1244771,chr20,1244723,1244771,IMR90|chr20:34821596-34821652,chr20,34821596,34821652,0,33576873
IMR90|chr20:1694796-1694907,chr20,1694796,1694907,IMR90|chr20:30540346-30540382,chr20,30540346,30540382,0,28845550
IMR90|chr20:1735939-1736045,chr20,1735939,1736045,IMR90|chr20:19864190-19864296,chr20,19864190,19864296,0,18128251
IMR90|chr20:1884528-1884585,chr20,1884528,1884585,IMR90|chr20:30944741-30944788,chr20,30944741,30944788,0,29060213
IMR90|chr20:2094894-2094918,chr20,2094894,2094918,IMR90|chr20:34330646-34330709,chr20,34330646,34330709,0,32235752
IMR90|chr20:2521516-2521573,chr20,2521516,2521573,IMR90|chr20:30944741-30944788,chr20,30944741,30944788,0,28423225
IMR90|chr20:2547811-2547881,chr20,2547811,2547881,IMR90|chr20:30941129-30941188,chr20,30941129,30941188,0,28393318
IMR90|chr20:2710769-2710835,chr20,2710769,2710835,IMR90|chr20:30942071-30942155,chr20,30942071,30942155,0,28231302
IMR90|chr20:2923152-2923251,chr20,2923152,2923251,IMR90|chr20:3797343-3797394,chr20,3797343,3797394,0,874191
IMR90|chr20:3152867-3152984,chr20,3152867,3152984,IMR90|chr20:17946191-17946235,chr20,17946191,17946235,0,14793324
IMR90|chr20:3325323-3325405,chr20,3325323,3325405,IMR90|chr20:3797690-3797726,chr20,3797690,3797726,0,472367
IMR90|chr20:3477311-3477345,chr20,3477311,3477345,IMR90|chr20:19866024-19866140,chr20,19866024,19866140,0,16388713
IMR90|chr20:3651421-3651558,chr20,3651421,3651558,IMR90|chr20:521801-521839,chr20,521801,521839,0,3129620
IMR90|chr20:3732324-3732474,chr20,3732324,3732474,IMR90|chr20:30191300-30191358,chr20,30191300,30191358,0,26458976
IMR90|chr20:3911952-3912102,chr20,3911952,3912102,IMR90|chr20:30191300-30191358,chr20,30191300,30191358,0,26279348
IMR90|chr20:4428742-4428780,chr20,4428742,4428780,IMR90|chr20:44561903-44561996,chr20,44561903,44561996,0,40133161
IMR90|chr20:4501852-4501964,chr20,4501852,4501964,IMR90|chr20:35170104-35170231,chr20,35170104,35170231,0,30668252
IMR90|chr20:4867450-4867563,chr20,4867450,4867563,IMR90|chr20:30947849-30947877,chr20,30947849,30947877,0,26080399
IMR90|chr20:5018227-5018372,chr20,5018227,5018372,IMR90|chr20:30942071-30942155,chr20,30942071,30942155,0,25923844
IMR90|chr20:5387844-5387862,chr20,5387844,5387862,IMR90|chr20:19868894-19869010,chr20,19868894,19869010,0,14481050
IMR90|chr20:5673465-5673545,chr20,5673465,5673545,IMR90|chr20:47896088-47896157,chr20,47896088,47896157,0,42222623
IMR90|chr20:5891243-5891311,chr20,5891243,5891311,IMR90|chr20:19870064-19870143,chr20,19870064,19870143,0,13978821
IMR90|chr20:6076804-6076927,chr20,6076804,6076927,IMR90|chr20:57557386-57557428,chr20,57557386,57557428,0,51480582
IMR90|chr20:6327636-6327675,chr20,6327636,6327675,IMR90|chr20:45337964-45338036,chr20,45337964,45338036,0,39010328
IMR90|chr20:6598672-6598784,chr20,6598672,6598784,IMR90|chr20:521801-521839,chr20,521801,521839,0,6076871
IMR90|chr20:6631576-6631643,chr20,6631576,6631643,IMR90|chr20:43975369-43975434,chr20,43975369,43975434,0,37343793
IMR90|chr20:6663975-6664086,chr20,6663975,6664086,IMR90|chr20:30540346-30540382,chr20,30540346,30540382,0,23876371
IMR90|chr20:6679252-6679286,chr20,6679252,6679286,IMR90|chr20:19866024-19866140,chr20,19866024,19866140,0,13186772
IMR90|chr20:6876984-6877023,chr20,6876984,6877023,IMR90|chr20:45337964-45338036,chr20,45337964,45338036,0,38460980
IMR90|chr20:7099308-7099328,chr20,7099308,7099328,IMR90|chr20:43975368-43975434,chr20,43975368,43975434,0,36876060
IMR90|chr20:7360832-7360974,chr20,7360832,7360974,IMR90|chr20:19868003-19868069,chr20,19868003,19868069,0,12507171
IMR90|chr20:7451676-7451760,chr20,7451676,7451760,IMR90|chr20:19868104-19868131,chr20,19868104,19868131,0,12416428
IMR90|chr20:7553643-7553741,chr20,7553643,7553741,IMR90|chr20:19867892-19867982,chr20,19867892,19867982,0,12314249
IMR90|chr20:7654368-7654437,chr20,7654368,7654437,IMR90|chr20:5590869-5590921,chr20,5590869,5590921,0,2063499
IMR90|chr20:8089273-8089340,chr20,8089273,8089340,IMR90|chr20:19862232-19862287,chr20,19862232,19862287,0,11772959
IMR90|chr20:8107963-8108100,chr20,8107963,8108100,IMR90|chr20:521801-521839,chr20,521801,521839,0,7586162
IMR90|chr20:8191634-8191744,chr20,8191634,8191744,IMR90|chr20:30194331-30194385,chr20,30194331,30194385,0,22002697
IMR90|chr20:8341989-8342048,chr20,8341989,8342048,IMR90|chr20:19870064-19870144,chr20,19870064,19870144,0,11528075
IMR90|chr20:9004507-9004574,chr20,9004507,9004574,IMR90|chr20:19862232-19862287,chr20,19862232,19862287,0,10857725
IMR90|chr20:9053248-9053316,chr20,9053248,9053316,IMR90|chr20:19870064-19870143,chr20,19870064,19870143,0,10816816
IMR90|chr20:9080566-9080627,chr20,9080566,9080627,IMR90|chr20:19869334-19869415,chr20,19869334,19869415,0,10788768
IMR90|chr20:9149756-9149782,chr20,9149756,9149782,IMR90|chr20:3827195-3827277,chr20,3827195,3827277,0,5322561
IMR90|chr20:9150677-9150735,chr20,9150677,9150735,IMR90|chr20:19869391-19869440,chr20,19869391,19869440,0,10718714
IMR90|chr20:9211143-9211185,chr20,9211143,9211185,IMR90|chr20:49127515-49127602,chr20,49127515,49127602,0,39916372
IMR90|chr20:9274698-9274821,chr20,9274698,9274821,IMR90|chr20:19866216-19866318,chr20,19866216,19866318,0,10591518
IMR90|chr20:9360488-9360557,chr20,9360488,9360557,IMR90|chr20:17945097-17945155,chr20,17945097,17945155,0,8584609
IMR90|chr20:9364548-9364631,chr20,9364548,9364631,IMR90|chr20:45985071-45985135,chr20,45985071,45985135,0,36620523
IMR90|chr20:9463760-9463817,chr20,9463760,9463817,IMR90|chr20:47896159-47896208,chr20,47896159,47896208,0,38432399
IMR90|chr20:10024719-10024822,chr20,10024719,10024822,IMR90|chr20:30944741-30944788,chr20,30944741,30944788,0,20920022
IMR90|chr20:10175884-10175954,chr20,10175884,10175954,IMR90|chr20:34126851-34126913,chr20,34126851,34126913,0,23950967
IMR90|chr20:10468143-10468210,chr20,10468143,10468210,IMR90|chr20:34126851-34126913,chr20,34126851,34126913,0,23658708
IMR90|chr20:10519452-10519476,chr20,10519452,10519476,IMR90|chr20:19866801-19866927,chr20,19866801,19866927,0,9347349
IMR90|chr20:10635878-10635919,chr20,10635878,10635919,IMR90|chr20:19864048-19864137,chr20,19864048,19864137,0,9228170
IMR90|chr20:11203957-11204038,chr20,11203957,11204038,IMR90|chr20:47896088-47896157,chr20,47896088,47896157,0,36692131
IMR90|chr20:11413812-11413878,chr20,11413812,11413878,IMR90|chr20:19869055-19869104,chr20,19869055,19869104,0,8455243
IMR90|chr20:11921298-11921405,chr20,11921298,11921405,IMR90|chr20:47896088-47896157,chr20,47896088,47896157,0,35974790
IMR90|chr20:11971229-11971270,chr20,11971229,11971270,IMR90|chr20:49127515-49127602,chr20,49127515,49127602,0,37156286
IMR90|chr20:12036749-12036837,chr20,12036749,12036837,IMR90|chr20:45985071-45985135,chr20,45985071,45985135,0,33948322
IMR90|chr20:12265264-12265390,chr20,12265264,12265390,IMR90|chr20:49546486-49546517,chr20,49546486,49546517,0,37281222
IMR90|chr20:12427565-12427631,chr20,12427565,12427631,IMR90|chr20:19869055-19869104,chr20,19869055,19869104,0,7441490
IMR90|chr20:12665821-12665907,chr20,12665821,12665907,IMR90|chr20:45985071-45985135,chr20,45985071,45985135,0,33319250
IMR90|chr20:13223676-13223737,chr20,13223676,13223737,IMR90|chr20:39659031-39659085,chr20,39659031,39659085,0,26435355
IMR90|chr20:13515907-13515974,chr20,13515907,13515974,IMR90|chr20:17945097-17945155,chr20,17945097,17945155,0,4429190
IMR90|chr20:13809724-13809794,chr20,13809724,13809794,IMR90|chr20:5590869-5590921,chr20,5590869,5590921,0,8218855
IMR90|chr20:14887645-14887693,chr20,14887645,14887693,IMR90|chr20:4156270-4156357,chr20,4156270,4156357,0,10731375
IMR90|chr20:15154793-15154906,chr20,15154793,15154906,IMR90|chr20:17946540-17946578,chr20,17946540,17946578,0,2791747
IMR90|chr20:15367316-15367346,chr20,15367316,15367346,IMR90|chr20:57557386-57557428,chr20,57557386,57557428,0,42190070
IMR90|chr20:15478767-15478830,chr20,15478767,15478830,IMR90|chr20:19866918-19866984,chr20,19866918,19866984,0,4388151
IMR90|chr20:15586871-15586934,chr20,15586871,15586934,IMR90|chr20:19866918-19866984,chr20,19866918,19866984,0,4280047
IMR90|chr20:15600975-15601022,chr20,15600975,15601022,IMR90|chr20:1099764-1099849,chr20,1099764,1099849,0,14501211
IMR90|chr20:15771488-15771611,chr20,15771488,15771611,IMR90|chr20:47896161-47896208,chr20,47896161,47896208,0,32124673
IMR90|chr20:16103754-16103789,chr20,16103754,16103789,IMR90|chr20:33103570-33103656,chr20,33103570,33103656,0,16999816
IMR90|chr20:16276738-16276855,chr20,16276738,16276855,IMR90|chr20:17946191-17946235,chr20,17946191,17946235,0,1669453
IMR90|chr20:16546604-16546694,chr20,16546604,16546694,IMR90|chr20:19866823-19866863,chr20,19866823,19866863,0,3320219
IMR90|chr20:16802175-16802214,chr20,16802175,16802214,IMR90|chr20:19868728-19868769,chr20,19868728,19868769,0,3066553
IMR90|chr20:17234296-17234340,chr20,17234296,17234340,IMR90|chr20:1099764-1099849,chr20,1099764,1099849,0,16134532
IMR90|chr20:17310787-17310896,chr20,17310787,17310896,IMR90|chr20:17946540-17946578,chr20,17946540,17946578,0,635753
IMR90|chr20:17730608-17730718,chr20,17730608,17730718,IMR90|chr20:30944741-30944788,chr20,30944741,30944788,0,13214133
IMR90|chr20:18057755-18057838,chr20,18057755,18057838,IMR90|chr20:45985071-45985135,chr20,45985071,45985135,0,27927316
IMR90|chr20:18174392-18174441,chr20,18174392,18174441,IMR90|chr20:19869758-19869800,chr20,19869758,19869800,0,1695366
IMR90|chr20:18282190-18282237,chr20,18282190,18282237,IMR90|chr20:30308080-30308148,chr20,30308080,30308148,0,12025890
IMR90|chr20:18323279-18323391,chr20,18323279,18323391,IMR90|chr20:35170104-35170231,chr20,35170104,35170231,0,16846825
IMR90|chr20:18509571-18509590,chr20,18509571,18509590,IMR90|chr20:19866966-19867012,chr20,19866966,19867012,0,1357395
IMR90|chr20:18514372-18514487,chr20,18514372,18514487,IMR90|chr20:30542104-30542129,chr20,30542104,30542129,0,12027732
IMR90|chr20:18634922-18634970,chr20,18634922,18634970,IMR90|chr20:34821596-34821652,chr20,34821596,34821652,0,16186674
IMR90|chr20:18712711-18712777,chr20,18712711,18712777,IMR90|chr20:30942071-30942155,chr20,30942071,30942155,0,12229360
IMR90|chr20:18744632-18744701,chr20,18744632,18744701,IMR90|chr20:19862232-19862287,chr20,19862232,19862287,0,1117600
IMR90|chr20:18787527-18787650,chr20,18787527,18787650,IMR90|chr20:47896161-47896208,chr20,47896161,47896208,0,29108634
IMR90|chr20:19105036-19105132,chr20,19105036,19105132,IMR90|chr20:19869834-19869857,chr20,19869834,19869857,0,764798
IMR90|chr20:19346000-19346135,chr20,19346000,19346135,IMR90|chr20:30308520-30308546,chr20,30308520,30308546,0,10962520
IMR90|chr20:19398016-19398071,chr20,19398016,19398071,IMR90|chr20:19865697-19865747,chr20,19865697,19865747,0,467681
IMR90|chr20:19526913-19527053,chr20,19526913,19527053,IMR90|chr20:49546486-49546517,chr20,49546486,49546517,0,30019573
IMR90|chr20:19793369-19793416,chr20,19793369,19793416,IMR90|chr20:30308080-30308148,chr20,30308080,30308148,0,10514711
IMR90|chr20:19883289-19883373,chr20,19883289,19883373,IMR90|chr20:19868003-19868069,chr20,19868003,19868069,0,15286
IMR90|chr20:20144825-20144867,chr20,20144825,20144867,IMR90|chr20:49127515-49127602,chr20,49127515,49127602,0,28982690
IMR90|chr20:20414665-20414718,chr20,20414665,20414718,IMR90|chr20:19869758-19869800,chr20,19869758,19869800,0,544907
IMR90|chr20:20541095-20541138,chr20,20541095,20541138,IMR90|chr20:33103734-33103837,chr20,33103734,33103837,0,12562639
IMR90|chr20:20595747-20595837,chr20,20595747,20595837,IMR90|chr20:19864002-19864133,chr20,19864002,19864133,0,731745
IMR90|chr20:20646607-20646633,chr20,20646607,20646633,IMR90|chr20:17947594-17947618,chr20,17947594,17947618,0,2699013
IMR90|chr20:20803135-20803187,chr20,20803135,20803187,IMR90|chr20:57225673-57225771,chr20,57225673,57225771,0,36422538
IMR90|chr20:20890563-20890604,chr20,20890563,20890604,IMR90|chr20:49127515-49127602,chr20,49127515,49127602,0,28236952
IMR90|chr20:21204598-21204748,chr20,21204598,21204748,IMR90|chr20:39658317-39658428,chr20,39658317,39658428,0,18453719
IMR90|chr20:21438531-21438642,chr20,21438531,21438642,IMR90|chr20:30308520-30308546,chr20,30308520,30308546,0,8869989
IMR90|chr20:21507115-21507205,chr20,21507115,21507205,IMR90|chr20:19864002-19864133,chr20,19864002,19864133,0,1643113
IMR90|chr20:21596258-21596380,chr20,21596258,21596380,IMR90|chr20:17947525-17947545,chr20,17947525,17947545,0,3648733
IMR90|chr20:21971085-21971201,chr20,21971085,21971201,IMR90|chr20:30947849-30947877,chr20,30947849,30947877,0,8976764
IMR90|chr20:22077440-22077484,chr20,22077440,22077484,IMR90|chr20:19864796-19864869,chr20,19864796,19864869,0,2212644
IMR90|chr20:22180678-22180762,chr20,22180678,22180762,IMR90|chr20:42939094-42939160,chr20,42939094,42939160,0,20758416
IMR90|chr20:22186017-22186037,chr20,22186017,22186037,IMR90|chr20:43975368-43975434,chr20,43975368,43975434,0,21789351
IMR90|chr20:23075086-23075110,chr20,23075086,23075110,IMR90|chr20:19866801-19866927,chr20,19866801,19866927,0,3208285
IMR90|chr20:23250373-23250470,chr20,23250373,23250470,IMR90|chr20:30308021-30308064,chr20,30308021,30308064,0,7057648
IMR90|chr20:23258152-23258200,chr20,23258152,23258200,IMR90|chr20:4156270-4156357,chr20,4156270,4156357,0,19101882
IMR90|chr20:23661167-23661238,chr20,23661167,23661238,IMR90|chr20:45333851-45333905,chr20,45333851,45333905,0,21672684
IMR90|chr20:24044022-24044106,chr20,24044022,24044106,IMR90|chr20:42939094-42939160,chr20,42939094,42939160,0,18895072
IMR90|chr20:24144857-24144936,chr20,24144857,24144936,IMR90|chr20:30322631-30322664,chr20,30322631,30322664,0,6177774
IMR90|chr20:24396339-24396489,chr20,24396339,24396489,IMR90|chr20:39658317-39658428,chr20,39658317,39658428,0,15261978
IMR90|chr20:24798598-24798655,chr20,24798598,24798655,IMR90|chr20:47896159-47896208,chr20,47896159,47896208,0,23097561
IMR90|chr20:25194905-25194959,chr20,25194905,25194959,IMR90|chr20:30308131-30308281,chr20,30308131,30308281,0,5113226
IMR90|chr20:25200378-25200449,chr20,25200378,25200449,IMR90|chr20:45333851-45333905,chr20,45333851,45333905,0,20133473
IMR90|chr20:25211470-25211604,chr20,25211470,25211604,IMR90|chr20:19866268-19866319,chr20,19866268,19866319,0,5345202
IMR90|chr20:25696854-25696880,chr20,25696854,25696880,IMR90|chr20:34330646-34330701,chr20,34330646,34330701,0,8633792
IMR90|chr20:25706594-25706667,chr20,25706594,25706667,IMR90|chr20:42939094-42939160,chr20,42939094,42939160,0,17232500
IMR90|chr20:26068015-26068157,chr20,26068015,26068157,IMR90|chr20:30540346-30540382,chr20,30540346,30540382,0,4472331
IMR90|chr20:26197401-26197508,chr20,26197401,26197508,IMR90|chr20:47896088-47896157,chr20,47896088,47896157,0,21698687
IMR90|chr20:26515728-26515861,chr20,26515728,26515861,IMR90|chr20:44559640-44559784,chr20,44559640,44559784,0,18043912
IMR90|chr20:26552102-26552212,chr20,26552102,26552212,IMR90|chr20:30944741-30944788,chr20,30944741,30944788,0,4392639
IMR90|chr20:26934597-26934640,chr20,26934597,26934640,IMR90|chr20:33103734-33103837,chr20,33103734,33103837,0,6169137
IMR90|chr20:27289715-27289795,chr20,27289715,27289795,IMR90|chr20:62583289-62583323,chr20,62583289,62583323,0,35293574
IMR90|chr20:27541197-27541220,chr20,27541197,27541220,IMR90|chr20:35170104-35170231,chr20,35170104,35170231,0,7628907
IMR90|chr20:27916882-27916985,chr20,27916882,27916985,IMR90|chr20:30944741-30944788,chr20,30944741,30944788,0,3027859
IMR90|chr20:28013363-28013471,chr20,28013363,28013471,IMR90|chr20:57557386-57557428,chr20,57557386,57557428,0,29544023
IMR90|chr20:28032854-28032952,chr20,28032854,28032952,IMR90|chr20:56964899-56964948,chr20,56964899,56964948,0,28932045
IMR90|chr20:28616365-28616486,chr20,28616365,28616486,IMR90|chr20:57225674-57225771,chr20,57225674,57225771,0,28609309
IMR90|chr20:28828573-28828631,chr20,28828573,28828631,IMR90|chr20:19865867-19865949,chr20,19865867,19865949,0,8962706
IMR90|chr20:29060758-29060848,chr20,29060758,29060848,IMR90|chr20:19866268-19866319,chr20,19866268,19866319,0,9194490
IMR90|chr20:29658331-29658473,chr20,29658331,29658473,IMR90|chr20:30540346-30540382,chr20,30540346,30540382,0,882015
IMR90|chr20:30313721-30313833,chr20,30313721,30313833,IMR90|chr20:521801-521839,chr20,521801,521839,0,29791920
IMR90|chr20:30363528-30363614,chr20,30363528,30363614,IMR90|chr20:45985071-45985135,chr20,45985071,45985135,0,15621543
IMR90|chr20:30396420-30396519,chr20,30396420,30396519,IMR90|chr20:19870064-19870144,chr20,19870064,19870144,0,10526356
IMR90|chr20:30521564-30521641,chr20,30521564,30521641,IMR90|chr20:49546395-49546440,chr20,49546395,49546440,0,19024831
IMR90|chr20:30648314-30648352,chr20,30648314,30648352,IMR90|chr20:19866024-19866140,chr20,19866024,19866140,0,10782290
IMR90|chr20:30812773-30812844,chr20,30812773,30812844,IMR90|chr20:34200061-34200112,chr20,34200061,34200112,0,3387288
IMR90|chr20:30871378-30871462,chr20,30871378,30871462,IMR90|chr20:19868003-19868069,chr20,19868003,19868069,0,11003375
IMR90|chr20:30900582-30900643,chr20,30900582,30900643,IMR90|chr20:39659031-39659085,chr20,39659031,39659085,0,8758449
IMR90|chr20:30930839-30930927,chr20,30930839,30930927,IMR90|chr20:45985071-45985135,chr20,45985071,45985135,0,15054232
IMR90|chr20:31258547-31258669,chr20,31258547,31258669,IMR90|chr20:17947525-17947545,chr20,17947525,17947545,0,13311022
IMR90|chr20:31380141-31380244,chr20,31380141,31380244,IMR90|chr20:34198210-34198234,chr20,34198210,34198234,0,2818069
IMR90|chr20:31540332-31540382,chr20,31540332,31540382,IMR90|chr20:34204737-34204789,chr20,34204737,34204789,0,2664405
IMR90|chr20:32343110-32343223,chr20,32343110,32343223,IMR90|chr20:30322631-30322664,chr20,30322631,30322664,0,2020479
IMR90|chr20:32506892-32507042,chr20,32506892,32507042,IMR90|chr20:3797343-3797394,chr20,3797343,3797394,0,28709549
IMR90|chr20:32625664-32625733,chr20,32625664,32625733,IMR90|chr20:5590869-5590921,chr20,5590869,5590921,0,27034795
IMR90|chr20:32975393-32975410,chr20,32975393,32975410,IMR90|chr20:19868894-19869010,chr20,19868894,19869010,0,13106499
IMR90|chr20:33119977-33120073,chr20,33119977,33120073,IMR90|chr20:19869834-19869857,chr20,19869834,19869857,0,13250143
IMR90|chr20:33393178-33393195,chr20,33393178,33393195,IMR90|chr20:19868894-19869010,chr20,19868894,19869010,0,13524284
IMR90|chr20:33554082-33554148,chr20,33554082,33554148,IMR90|chr20:43975368-43975434,chr20,43975368,43975434,0,10421286
IMR90|chr20:33638226-33638296,chr20,33638226,33638296,IMR90|chr20:5590869-5590921,chr20,5590869,5590921,0,28047357
IMR90|chr20:33682609-33682633,chr20,33682609,33682633,IMR90|chr20:34330646-34330709,chr20,34330646,34330709,0,648037
IMR90|chr20:33905500-33905608,chr20,33905500,33905608,IMR90|chr20:57557386-57557428,chr20,57557386,57557428,0,23651886
IMR90|chr20:34296947-34296984,chr20,34296947,34296984,IMR90|chr20:31991790-31991811,chr20,31991790,31991811,0,2305157
IMR90|chr20:34409682-34409769,chr20,34409682,34409769,IMR90|chr20:2630837-2630878,chr20,2630837,2630878,0,31778845
IMR90|chr20:34510192-34510262,chr20,34510192,34510262,IMR90|chr20:34126851-34126913,chr20,34126851,34126913,0,383341
IMR90|chr20:35482473-35482540,chr20,35482473,35482540,IMR90|chr20:43975369-43975434,chr20,43975369,43975434,0,8492896
IMR90|chr20:35715673-35715782,chr20,35715673,35715782,IMR90|chr20:17946540-17946578,chr20,17946540,17946578,0,17769133
IMR90|chr20:35728479-35728590,chr20,35728479,35728590,IMR90|chr20:30308520-30308546,chr20,30308520,30308546,0,5419959
IMR90|chr20:35824960-35824989,chr20,35824960,35824989,IMR90|chr20:19868294-19868370,chr20,19868294,19868370,0,15956666
IMR90|chr20:36223999-36224022,chr20,36223999,36224022,IMR90|chr20:35170104-35170231,chr20,35170104,35170231,0,1053895
IMR90|chr20:36741308-36741334,chr20,36741308,36741334,IMR90|chr20:34330646-34330701,chr20,34330646,34330701,0,2410662
IMR90|chr20:37506069-37506166,chr20,37506069,37506166,IMR90|chr20:30308021-30308064,chr20,30308021,30308064,0,7198048
IMR90|chr20:37550630-37550699,chr20,37550630,37550699,IMR90|chr20:19862232-19862287,chr20,19862232,19862287,0,17688398
IMR90|chr20:37562416-37562514,chr20,37562416,37562514,IMR90|chr20:33101279-33101301,chr20,33101279,33101301,0,4461137
IMR90|chr20:37564154-37564214,chr20,37564154,37564214,IMR90|chr20:19867892-19867982,chr20,19867892,19867982,0,17696262
IMR90|chr20:37666260-37666313,chr20,37666260,37666313,IMR90|chr20:19869758-19869800,chr20,19869758,19869800,0,17796502
IMR90|chr20:37682998-37683067,chr20,37682998,37683067,IMR90|chr20:17945097-17945155,chr20,17945097,17945155,0,19737901
IMR90|chr20:37757278-37757360,chr20,37757278,37757360,IMR90|chr20:3797690-3797726,chr20,3797690,3797726,0,33959588
IMR90|chr20:38139400-38139432,chr20,38139400,38139432,IMR90|chr20:19869334-19869415,chr20,19869334,19869415,0,18270066
IMR90|chr20:38234639-38234765,chr20,38234639,38234765,IMR90|chr20:49546486-49546517,chr20,49546486,49546517,0,11311847
IMR90|chr20:38333280-38333393,chr20,38333280,38333393,IMR90|chr20:30947849-30947877,chr20,30947849,30947877,0,7385431
IMR90|chr20:38428292-38428432,chr20,38428292,38428432,IMR90|chr20:49546486-49546517,chr20,49546486,49546517,0,11118194
IMR90|chr20:38636848-38636880,chr20,38636848,38636880,IMR90|chr20:19869334-19869415,chr20,19869334,19869415,0,18767514
IMR90|chr20:38855408-38855446,chr20,38855408,38855446,IMR90|chr20:44561903-44561996,chr20,44561903,44561996,0,5706495
IMR90|chr20:39272828-39272857,chr20,39272828,39272857,IMR90|chr20:19863695-19863845,chr20,19863695,19863845,0,19409133
IMR90|chr20:39515092-39515198,chr20,39515092,39515198,IMR90|chr20:17946191-17946235,chr20,17946191,17946235,0,21568901
IMR90|chr20:39629417-39629538,chr20,39629417,39629538,IMR90|chr20:17947525-17947545,chr20,17947525,17947545,0,21681892
IMR90|chr20:39780086-39780205,chr20,39780086,39780205,IMR90|chr20:49546486-49546517,chr20,49546486,49546517,0,9766400
IMR90|chr20:39800472-39800513,chr20,39800472,39800513,IMR90|chr20:19864048-19864137,chr20,19864048,19864137,0,19936424
IMR90|chr20:39856864-39856937,chr20,39856864,39856937,IMR90|chr20:42939094-42939160,chr20,42939094,42939160,0,3082230
IMR90|chr20:39915287-39915374,chr20,39915287,39915374,IMR90|chr20:2630837-2630878,chr20,2630837,2630878,0,37284450
IMR90|chr20:40433098-40433162,chr20,40433098,40433162,IMR90|chr20:19866918-19866984,chr20,19866918,19866984,0,20566180
IMR90|chr20:40690088-40690177,chr20,40690088,40690177,IMR90|chr20:42939094-42939160,chr20,42939094,42939160,0,2249006
IMR90|chr20:40837492-40837559,chr20,40837492,40837559,IMR90|chr20:34126851-34126913,chr20,34126851,34126913,0,6710641
IMR90|chr20:41284624-41284668,chr20,41284624,41284668,IMR90|chr20:19864796-19864869,chr20,19864796,19864869,0,21419828
IMR90|chr20:41532267-41532365,chr20,41532267,41532365,IMR90|chr20:19867892-19867982,chr20,19867892,19867982,0,21664375
IMR90|chr20:41720192-41720218,chr20,41720192,41720218,IMR90|chr20:17947594-17947618,chr20,17947594,17947618,0,23772598
IMR90|chr20:41723743-41723802,chr20,41723743,41723802,IMR90|chr20:19870064-19870144,chr20,19870064,19870144,0,21853679
IMR90|chr20:41874981-41875097,chr20,41874981,41875097,IMR90|chr20:30947849-30947877,chr20,30947849,30947877,0,10927132
IMR90|chr20:42127607-42127646,chr20,42127607,42127646,IMR90|chr20:19868728-19868769,chr20,19868728,19868769,0,22258879
IMR90|chr20:43017842-43017955,chr20,43017842,43017955,IMR90|chr20:17946540-17946578,chr20,17946540,17946578,0,25071302
IMR90|chr20:43470859-43470948,chr20,43470859,43470948,IMR90|chr20:42939094-42939160,chr20,42939094,42939160,0,531765
IMR90|chr20:43639430-43639490,chr20,43639430,43639490,IMR90|chr20:19867892-19867982,chr20,19867892,19867982,0,23771538
IMR90|chr20:43769818-43769848,chr20,43769818,43769848,IMR90|chr20:57557386-57557428,chr20,57557386,57557428,0,13787568
IMR90|chr20:43806141-43806276,chr20,43806141,43806276,IMR90|chr20:30308520-30308546,chr20,30308520,30308546,0,13497621
IMR90|chr20:43898889-43898907,chr20,43898889,43898907,IMR90|chr20:19868894-19869010,chr20,19868894,19869010,0,24029995
IMR90|chr20:43925093-43925217,chr20,43925093,43925217,IMR90|chr20:19866153-19866206,chr20,19866153,19866206,0,24058940
IMR90|chr20:43936316-43936392,chr20,43936316,43936392,IMR90|chr20:19868471-19868519,chr20,19868471,19868519,0,24067845
IMR90|chr20:43968573-43968642,chr20,43968573,43968642,IMR90|chr20:19866823-19866863,chr20,19866823,19866863,0,24101750
IMR90|chr20:44053547-44053624,chr20,44053547,44053624,IMR90|chr20:49546395-49546440,chr20,49546395,49546440,0,5492848
IMR90|chr20:44228875-44228922,chr20,44228875,44228922,IMR90|chr20:36154341-36154441,chr20,36154341,36154441,0,8074534
IMR90|chr20:44523044-44523105,chr20,44523044,44523105,IMR90|chr20:19869334-19869415,chr20,19869334,19869415,0,24653710
IMR90|chr20:45025560-45025659,chr20,45025560,45025659,IMR90|chr20:19870064-19870144,chr20,19870064,19870144,0,25155496
IMR90|chr20:45134721-45134845,chr20,45134721,45134845,IMR90|chr20:19866153-19866206,chr20,19866153,19866206,0,25268568
IMR90|chr20:45319312-45319341,chr20,45319312,45319341,IMR90|chr20:19868294-19868370,chr20,19868294,19868370,0,25451018
IMR90|chr20:45576781-45576852,chr20,45576781,45576852,IMR90|chr20:34200061-34200112,chr20,34200061,34200112,0,11376720
IMR90|chr20:45997395-45997453,chr20,45997395,45997453,IMR90|chr20:19865867-19865949,chr20,19865867,19865949,0,26131528
IMR90|chr20:46099267-46099331,chr20,46099267,46099331,IMR90|chr20:19866918-19866984,chr20,19866918,19866984,0,26232349
IMR90|chr20:46196623-46196654,chr20,46196623,46196654,IMR90|chr20:34821581-34821698,chr20,34821581,34821698,0,11375042
IMR90|chr20:46219903-46219938,chr20,46219903,46219938,IMR90|chr20:33103570-33103656,chr20,33103570,33103656,0,13116333
IMR90|chr20:46637993-46638045,chr20,46637993,46638045,IMR90|chr20:57225673-57225771,chr20,57225673,57225771,0,10587680
IMR90|chr20:46657070-46657123,chr20,46657070,46657123,IMR90|chr20:30307639-30307718,chr20,30307639,30307718,0,16349431
IMR90|chr20:46714831-46714869,chr20,46714831,46714869,IMR90|chr20:19866024-19866140,chr20,19866024,19866140,0,26848807
IMR90|chr20:46828533-46828580,chr20,46828533,46828580,IMR90|chr20:1099764-1099849,chr20,1099764,1099849,0,45728769
IMR90|chr20:47175178-47175232,chr20,47175178,47175232,IMR90|chr20:30308131-30308281,chr20,30308131,30308281,0,16867047
IMR90|chr20:47519222-47519320,chr20,47519222,47519320,IMR90|chr20:33101279-33101301,chr20,33101279,33101301,0,14417943
IMR90|chr20:48321070-48321131,chr20,48321070,48321131,IMR90|chr20:35489749-35489770,chr20,35489749,35489770,0,12831321
IMR90|chr20:48417608-48417640,chr20,48417608,48417640,IMR90|chr20:19867770-19867825,chr20,19867770,19867825,0,28549838
IMR90|chr20:48555399-48555446,chr20,48555399,48555446,IMR90|chr20:36154341-36154441,chr20,36154341,36154441,0,12401058
IMR90|chr20:48650974-48651012,chr20,48650974,48651012,IMR90|chr20:45337964-45338036,chr20,45337964,45338036,0,3313010
IMR90|chr20:48762838-48762951,chr20,48762838,48762951,IMR90|chr20:30322631-30322664,chr20,30322631,30322664,0,18440207
IMR90|chr20:49109270-49109360,chr20,49109270,49109360,IMR90|chr20:19866823-19866863,chr20,19866823,19866863,0,29242447
IMR90|chr20:49494002-49494069,chr20,49494002,49494069,IMR90|chr20:17945097-17945155,chr20,17945097,17945155,0,31548905
IMR90|chr20:49910888-49910956,chr20,49910888,49910956,IMR90|chr20:19862232-19862287,chr20,19862232,19862287,0,30048656
IMR90|chr20:50108575-50108639,chr20,50108575,50108639,IMR90|chr20:35490539-35490585,chr20,35490539,35490585,0,14618036
IMR90|chr20:50512806-50512885,chr20,50512806,50512885,IMR90|chr20:30322631-30322664,chr20,30322631,30322664,0,20190175
IMR90|chr20:51181146-51181244,chr20,51181146,51181244,IMR90|chr20:19869834-19869857,chr20,19869834,19869857,0,31311312
IMR90|chr20:51203035-51203158,chr20,51203035,51203158,IMR90|chr20:57557386-57557428,chr20,57557386,57557428,0,6354351
IMR90|chr20:51284682-51284827,chr20,51284682,51284827,IMR90|chr20:30942071-30942155,chr20,30942071,30942155,0,20342611
IMR90|chr20:51313995-51314114,chr20,51313995,51314114,IMR90|chr20:49546486-49546517,chr20,49546486,49546517,0,1767509
IMR90|chr20:51652253-51652373,chr20,51652253,51652373,IMR90|chr20:30947849-30947877,chr20,30947849,30947877,0,20704404
IMR90|chr20:51855600-51855655,chr20,51855600,51855655,IMR90|chr20:19865697-19865747,chr20,19865697,19865747,0,31989903
IMR90|chr20:51871154-51871203,chr20,51871154,51871203,IMR90|chr20:19869758-19869800,chr20,19869758,19869800,0,32001396
IMR90|chr20:51937536-51937625,chr20,51937536,51937625,IMR90|chr20:36154341-36154441,chr20,36154341,36154441,0,15783195
IMR90|chr20:52051121-52051152,chr20,52051121,52051152,IMR90|chr20:30325890-30325963,chr20,30325890,30325963,0,21725231
IMR90|chr20:52874363-52874443,chr20,52874363,52874443,IMR90|chr20:47896088-47896157,chr20,47896088,47896157,0,4978275
IMR90|chr20:52979455-52979523,chr20,52979455,52979523,IMR90|chr20:19862232-19862287,chr20,19862232,19862287,0,33117223
IMR90|chr20:53052485-53052561,chr20,53052485,53052561,IMR90|chr20:19868471-19868519,chr20,19868471,19868519,0,33184014
IMR90|chr20:53381714-53381780,chr20,53381714,53381780,IMR90|chr20:43975368-43975434,chr20,43975368,43975434,0,9406346
IMR90|chr20:53760492-53760521,chr20,53760492,53760521,IMR90|chr20:19863695-19863845,chr20,19863695,19863845,0,33896797
IMR90|chr20:53856192-53856217,chr20,53856192,53856217,IMR90|chr20:34198083-34198192,chr20,34198083,34198192,0,19658109
IMR90|chr20:53902049-53902191,chr20,53902049,53902191,IMR90|chr20:19868003-19868069,chr20,19868003,19868069,0,34034046
IMR90|chr20:53982025-53982050,chr20,53982025,53982050,IMR90|chr20:34198083-34198192,chr20,34198083,34198192,0,19783942
IMR90|chr20:54028331-54028400,chr20,54028331,54028400,IMR90|chr20:19866823-19866863,chr20,19866823,19866863,0,34161508
IMR90|chr20:54047248-54047321,chr20,54047248,54047321,IMR90|chr20:19867903-19867980,chr20,19867903,19867980,0,34179345
IMR90|chr20:54221922-54221959,chr20,54221922,54221959,IMR90|chr20:31991790-31991811,chr20,31991790,31991811,0,22230132
IMR90|chr20:54399785-54399935,chr20,54399785,54399935,IMR90|chr20:3797343-3797394,chr20,3797343,3797394,0,50602442
IMR90|chr20:54572195-54572329,chr20,54572195,54572329,IMR90|chr20:19866268-19866319,chr20,19866268,19866319,0,34705927
IMR90|chr20:54576133-54576206,chr20,54576133,54576206,IMR90|chr20:19867903-19867980,chr20,19867903,19867980,0,34708230
IMR90|chr20:54650372-54650430,chr20,54650372,54650430,IMR90|chr20:19869391-19869440,chr20,19869391,19869440,0,34780981
IMR90|chr20:54900082-54900163,chr20,54900082,54900163,IMR90|chr20:47896088-47896157,chr20,47896088,47896157,0,7003994
IMR90|chr20:55418129-55418173,chr20,55418129,55418173,IMR90|chr20:1099764-1099849,chr20,1099764,1099849,0,54318365
IMR90|chr20:55528432-55528502,chr20,55528432,55528502,IMR90|chr20:30941129-30941188,chr20,30941129,30941188,0,24587303
IMR90|chr20:55537986-55538012,chr20,55537986,55538012,IMR90|chr20:3827195-3827277,chr20,3827195,3827277,0,51710791
IMR90|chr20:55557059-55557165,chr20,55557059,55557165,IMR90|chr20:17946191-17946235,chr20,17946191,17946235,0,37610868
IMR90|chr20:55574361-55574411,chr20,55574361,55574411,IMR90|chr20:34204737-34204789,chr20,34204737,34204789,0,21369624
IMR90|chr20:55767552-55767667,chr20,55767552,55767667,IMR90|chr20:30542104-30542129,chr20,30542104,30542129,0,25225448
IMR90|chr20:56256769-56256890,chr20,56256769,56256890,IMR90|chr20:17947525-17947545,chr20,17947525,17947545,0,38309244
IMR90|chr20:56696564-56696602,chr20,56696564,56696602,IMR90|chr20:45337964-45338036,chr20,45337964,45338036,0,11358600
IMR90|chr20:57318155-57318253,chr20,57318155,57318253,IMR90|chr20:19869834-19869857,chr20,19869834,19869857,0,37448321
IMR90|chr20:57364565-57364675,chr20,57364565,57364675,IMR90|chr20:30194331-30194385,chr20,30194331,30194385,0,27170234
IMR90|chr20:57428597-57428686,chr20,57428597,57428686,IMR90|chr20:36154341-36154441,chr20,36154341,36154441,0,21274256
IMR90|chr20:57431858-57431919,chr20,57431858,57431919,IMR90|chr20:35489749-35489770,chr20,35489749,35489770,0,21942109
IMR90|chr20:57512046-57512136,chr20,57512046,57512136,IMR90|chr20:19866268-19866319,chr20,19866268,19866319,0,37645778
IMR90|chr20:57641632-57641685,chr20,57641632,57641685,IMR90|chr20:30307639-30307718,chr20,30307639,30307718,0,27333993
IMR90|chr20:57947958-57948064,chr20,57947958,57948064,IMR90|chr20:19864190-19864296,chr20,19864190,19864296,0,38083768
IMR90|chr20:58316228-58316293,chr20,58316228,58316293,IMR90|chr20:39659031-39659085,chr20,39659031,39659085,0,18657197
IMR90|chr20:58365551-58365684,chr20,58365551,58365684,IMR90|chr20:44559640-44559784,chr20,44559640,44559784,0,13805911
IMR90|chr20:58406614-58406713,chr20,58406614,58406713,IMR90|chr20:3797343-3797394,chr20,3797343,3797394,0,54609271
IMR90|chr20:58410069-58410172,chr20,58410069,58410172,IMR90|chr20:34198210-34198234,chr20,34198210,34198234,0,24211859
IMR90|chr20:58894079-58894110,chr20,58894079,58894110,IMR90|chr20:30325890-30325963,chr20,30325890,30325963,0,28568189
IMR90|chr20:59100504-59100544,chr20,59100504,59100544,IMR90|chr20:30308335-30308413,chr20,30308335,30308413,0,28792169
IMR90|chr20:59181301-59181351,chr20,59181301,59181351,IMR90|chr20:1100316-1100338,chr20,1100316,1100338,0,58080985
IMR90|chr20:59509178-59509298,chr20,59509178,59509298,IMR90|chr20:30947849-30947877,chr20,30947849,30947877,0,28561329
IMR90|chr20:59855410-59855429,chr20,59855410,59855429,IMR90|chr20:19866966-19867012,chr20,19866966,19867012,0,39988444
IMR90|chr20:60265546-60265644,chr20,60265546,60265644,IMR90|chr20:56964899-56964948,chr20,56964899,56964948,0,3300647
IMR90|chr20:60916239-60916319,chr20,60916239,60916319,IMR90|chr20:62583289-62583323,chr20,62583289,62583323,0,1667050
IMR90|chr20:61203974-61204039,chr20,61203974,61204039,IMR90|chr20:39659031-39659085,chr20,39659031,39659085,0,21544943
IMR90|chr20:61392380-61392444,chr20,61392380,61392444,IMR90|chr20:35490539-35490585,chr20,35490539,35490585,0,25901841
IMR90|chr20:61523625-61523665,chr20,61523625,61523665,IMR90|chr20:30308335-30308413,chr20,30308335,30308413,0,31215290
IMR90|chr20:62276024-62276055,chr20,62276024,62276055,IMR90|chr20:34821581-34821698,chr20,34821581,34821698,0,27454443
IMR90|chr20:62621656-62621706,chr20,62621656,62621706,IMR90|chr20:1100316-1100338,chr20,1100316,1100338,0,61521340
IMR90|chr20:62766258-62766379,chr20,62766258,62766379,IMR90|chr20:57225674-57225771,chr20,57225674,57225771,0,5540584
IMR90|chr20:62778562-62778685,chr20,62778562,62778685,IMR90|chr20:19866216-19866318,chr20,19866216,19866318,0,42912346
IMR90|chr20:62865329-62865413,chr20,62865329,62865413,IMR90|chr20:19868104-19868131,chr20,19868104,19868131,0,42997225
IMR90|chr21:799116-799159,chr21,799116,799159,IMR90|chr21:30676431-30676507,chr21,30676431,30676507,0,29877315
IMR90|chr21:3499377-3499398,chr21,3499377,3499398,IMR90|chr21:47397043-47397167,chr21,47397043,47397167,0,43897666
IMR90|chr21:3817434-3817584,chr21,3817434,3817584,IMR90|chr21:47647361-47647415,chr21,47647361,47647415,0,43829927
IMR90|chr21:3871344-3871396,chr21,3871344,3871396,IMR90|chr21:30676434-30676507,chr21,30676434,30676507,0,26805090
IMR90|chr21:4252904-4252930,chr21,4252904,4252930,IMR90|chr21:47397043-47397167,chr21,47397043,47397167,0,43144139
IMR90|chr21:6475817-6475869,chr21,6475817,6475869,IMR90|chr21:30676434-30676507,chr21,30676434,30676507,0,24200617
IMR90|chr21:7500246-7500395,chr21,7500246,7500395,IMR90|chr21:47647361-47647415,chr21,47647361,47647415,0,40147115
IMR90|chr21:7838511-7838560,chr21,7838511,7838560,IMR90|chr21:30676434-30676507,chr21,30676434,30676507,0,22837923
IMR90|chr21:7948120-7948270,chr21,7948120,7948270,IMR90|chr21:47647361-47647415,chr21,47647361,47647415,0,39699241
IMR90|chr21:9825434-9825472,chr21,9825434,9825472,IMR90|chr21:34866529-34866630,chr21,34866529,34866630,0,25041095
IMR90|chr21:11448638-11448667,chr21,11448638,11448667,IMR90|chr21:47397043-47397141,chr21,47397043,47397141,0,35948405
IMR90|chr21:14568760-14568856,chr21,14568760,14568856,IMR90|chr21:47647361-47647415,chr21,47647361,47647415,0,33078601
IMR90|chr21:15763786-15763913,chr21,15763786,15763913,IMR90|chr21:47397051-47397201,chr21,47397051,47397201,0,31633265
IMR90|chr21:17286344-17286370,chr21,17286344,17286370,IMR90|chr21:47397043-47397167,chr21,47397043,47397167,0,30110699
IMR90|chr21:18906952-18907048,chr21,18906952,18907048,IMR90|chr21:47647361-47647415,chr21,47647361,47647415,0,28740409
IMR90|chr21:19128691-19128710,chr21,19128691,19128710,IMR90|chr21:45208696-45208794,chr21,45208696,45208794,0,26080005
IMR90|chr21:20121717-20121771,chr21,20121717,20121771,IMR90|chr21:47397043-47397167,chr21,47397043,47397167,0,27275326
IMR90|chr21:20727053-20727073,chr21,20727053,20727073,IMR90|chr21:47397043-47397173,chr21,47397043,47397173,0,26669990
IMR90|chr21:24410537-24410566,chr21,24410537,24410566,IMR90|chr21:47397043-47397141,chr21,47397043,47397141,0,22986506
IMR90|chr21:24421123-24421139,chr21,24421123,24421139,IMR90|chr21:47397043-47397141,chr21,47397043,47397141,0,22975920
IMR90|chr21:29110354-29110373,chr21,29110354,29110373,IMR90|chr21:45208696-45208794,chr21,45208696,45208794,0,16098342
IMR90|chr21:30446555-30446571,chr21,30446555,30446571,IMR90|chr21:47397043-47397141,chr21,47397043,47397141,0,16950488
IMR90|chr21:34593324-34593367,chr21,34593324,34593367,IMR90|chr21:30676431-30676507,chr21,30676431,30676507,0,3916893
IMR90|chr21:39543184-39543222,chr21,39543184,39543222,IMR90|chr21:34866529-34866630,chr21,34866529,34866630,0,4676655
IMR90|chr21:41211762-41211816,chr21,41211762,41211816,IMR90|chr21:47397043-47397167,chr21,47397043,47397167,0,6185281
IMR90|chr21:41360694-41360843,chr21,41360694,41360843,IMR90|chr21:47647361-47647415,chr21,47647361,47647415,0,6286667
IMR90|chr21:44430332-44430459,chr21,44430332,44430459,IMR90|chr21:47397051-47397201,chr21,47397051,47397201,0,2966719
IMR90|chr21:44562312-44562333,chr21,44562312,44562333,IMR90|chr21:47397043-47397167,chr21,47397043,47397167,0,2834731
IMR90|chr21:46311344-46311364,chr21,46311344,46311364,IMR90|chr21:47397043-47397173,chr21,47397043,47397173,0,1085699
IMR90|chr21:47154650-47154699,chr21,47154650,47154699,IMR90|chr21:30676434-30676507,chr21,30676434,30676507,0,16478216
IMR90|chr22:303132-303231,chr22,303132,303231,IMR90|chr22:30987244-30987295,chr22,30987244,30987295,0,30684112
IMR90|chr22:755398-755447,chr22,755398,755447,IMR90|chr22:46481245-46481268,chr22,46481245,46481268,0,45725847
IMR90|chr22:1183817-1183889,chr22,1183817,1183889,IMR90|chr22:38145666-38145720,chr22,38145666,38145720,0,36961849
IMR90|chr22:1856954-1857020,chr22,1856954,1857020,IMR90|chr22:38145462-38145502,chr22,38145462,38145502,0,36288508
IMR90|chr22:1972951-1973023,chr22,1972951,1973023,IMR90|chr22:38793166-38793274,chr22,38793166,38793274,0,36820215
IMR90|chr22:2736367-2736439,chr22,2736367,2736439,IMR90|chr22:43046610-43046688,chr22,43046610,43046688,0,40310243
IMR90|chr22:3959314-3959352,chr22,3959314,3959352,IMR90|chr22:20069956-20070054,chr22,20069956,20070054,0,16110642
IMR90|chr22:4376098-4376152,chr22,4376098,4376152,IMR90|chr22:38146176-38146231,chr22,38146176,38146231,0,33770078
IMR90|chr22:6363518-6363549,chr22,6363518,6363549,IMR90|chr22:38032734-38032848,chr22,38032734,38032848,0,31669216
IMR90|chr22:6423997-6424024,chr22,6423997,6424024,IMR90|chr22:38034321-38034393,chr22,38034321,38034393,0,31610324
IMR90|chr22:6653307-6653457,chr22,6653307,6653457,IMR90|chr22:30987244-30987295,chr22,30987244,30987295,0,24333937
IMR90|chr22:6657738-6657845,chr22,6657738,6657845,IMR90|chr22:39716783-39716839,chr22,39716783,39716839,0,33059045
IMR90|chr22:8268338-8268458,chr22,8268338,8268458,IMR90|chr22:20848571-20848635,chr22,20848571,20848635,0,12580233
IMR90|chr22:8622275-8622366,chr22,8622275,8622366,IMR90|chr22:38007898-38007999,chr22,38007898,38007999,0,29385623
IMR90|chr22:9099756-9099829,chr22,9099756,9099829,IMR90|chr22:43010170-43010229,chr22,43010170,43010229,0,33910414
IMR90|chr22:9341070-9341117,chr22,9341070,9341117,IMR90|chr22:41214861-41214918,chr22,41214861,41214918,0,31873791
IMR90|chr22:10103991-10104040,chr22,10103991,10104040,IMR90|chr22:46480607-46480660,chr22,46480607,46480660,0,36376616
IMR90|chr22:11017136-11017229,chr22,11017136,11017229,IMR90|chr22:41213118-41213145,chr22,41213118,41213145,0,30195982
IMR90|chr22:11474640-11474703,chr22,11474640,11474703,IMR90|chr22:37418111-37418176,chr22,37418111,37418176,0,25943471
IMR90|chr22:11901445-11901553,chr22,11901445,11901553,IMR90|chr22:39716783-39716839,chr22,39716783,39716839,0,27815338
IMR90|chr22:12032037-12032109,chr22,12032037,12032109,IMR90|chr22:43046610-43046688,chr22,43046610,43046688,0,31014573
IMR90|chr22:12110525-12110566,chr22,12110525,12110566,IMR90|chr22:41212679-41212757,chr22,41212679,41212757,0,29102154
IMR90|chr22:12451256-12451339,chr22,12451256,12451339,IMR90|chr22:20848571-20848635,chr22,20848571,20848635,0,8397315
IMR90|chr22:12465938-12465975,chr22,12465938,12465975,IMR90|chr22:20069956-20070054,chr22,20069956,20070054,0,7604018
IMR90|chr22:12649662-12649750,chr22,12649662,12649750,IMR90|chr22:46475291-46475331,chr22,46475291,46475331,0,33825629
IMR90|chr22:12747824-12747864,chr22,12747824,12747864,IMR90|chr22:46473495-46473517,chr22,46473495,46473517,0,33725671
IMR90|chr22:13730326-13730348,chr22,13730326,13730348,IMR90|chr22:46475291-46475331,chr22,46475291,46475331,0,32744965
IMR90|chr22:14090182-14090263,chr22,14090182,14090263,IMR90|chr22:20849300-20849350,chr22,20849300,20849350,0,6759118
IMR90|chr22:14352751-14352854,chr22,14352751,14352854,IMR90|chr22:42089003-42089050,chr22,42089003,42089050,0,27736252
IMR90|chr22:14956101-14956129,chr22,14956101,14956129,IMR90|chr22:30640124-30640209,chr22,30640124,30640209,0,15684023
IMR90|chr22:15053261-15053398,chr22,15053261,15053398,IMR90|chr22:46478170-46478232,chr22,46478170,46478232,0,31424909
IMR90|chr22:15067913-15067974,chr22,15067913,15067974,IMR90|chr22:24200121-24200167,chr22,24200121,24200167,0,9132208
IMR90|chr22:15218292-15218374,chr22,15218292,15218374,IMR90|chr22:20849300-20849350,chr22,20849300,20849350,0,5631008
IMR90|chr22:16004033-16004131,chr22,16004033,16004131,IMR90|chr22:41217180-41217232,chr22,41217180,41217232,0,25213147
IMR90|chr22:16064758-16064814,chr22,16064758,16064814,IMR90|chr22:41213975-41214073,chr22,41213975,41214073,0,25149217
IMR90|chr22:16097704-16097784,chr22,16097704,16097784,IMR90|chr22:46478170-46478237,chr22,46478170,46478237,0,30380466
IMR90|chr22:16441644-16441752,chr22,16441644,16441752,IMR90|chr22:39716783-39716839,chr22,39716783,39716839,0,23275139
IMR90|chr22:16650961-16651045,chr22,16650961,16651045,IMR90|chr22:42089003-42089050,chr22,42089003,42089050,0,25438042
IMR90|chr22:16781340-16781385,chr22,16781340,16781385,IMR90|chr22:23491189-23491244,chr22,23491189,23491244,0,6709849
IMR90|chr22:16829039-16829122,chr22,16829039,16829122,IMR90|chr22:20849300-20849350,chr22,20849300,20849350,0,4020261
IMR90|chr22:16877484-16877522,chr22,16877484,16877522,IMR90|chr22:20069956-20070054,chr22,20069956,20070054,0,3192472
IMR90|chr22:17057523-17057638,chr22,17057523,17057638,IMR90|chr22:42089003-42089050,chr22,42089003,42089050,0,25031480
IMR90|chr22:17157191-17157220,chr22,17157191,17157220,IMR90|chr22:38032734-38032848,chr22,38032734,38032848,0,20875543
IMR90|chr22:17425067-17425123,chr22,17425067,17425123,IMR90|chr22:41031853-41031942,chr22,41031853,41031942,0,23606786
IMR90|chr22:17714749-17714801,chr22,17714749,17714801,IMR90|chr22:41213975-41214073,chr22,41213975,41214073,0,23499226
IMR90|chr22:18106424-18106455,chr22,18106424,18106455,IMR90|chr22:38032734-38032848,chr22,38032734,38032848,0,19926310
IMR90|chr22:18689417-18689472,chr22,18689417,18689472,IMR90|chr22:46475291-46475331,chr22,46475291,46475331,0,27785874
IMR90|chr22:18835564-18835685,chr22,18835564,18835685,IMR90|chr22:20848571-20848635,chr22,20848571,20848635,0,2013007
IMR90|chr22:18890511-18890582,chr22,18890511,18890582,IMR90|chr22:38793168-38793273,chr22,38793168,38793273,0,19902657
IMR90|chr22:19023934-19023994,chr22,19023934,19023994,IMR90|chr22:24200121-24200167,chr22,24200121,24200167,0,5176187
IMR90|chr22:19071386-19071510,chr22,19071386,19071510,IMR90|chr22:38144780-38144806,chr22,38144780,38144806,0,19073394
IMR90|chr22:19164969-19165014,chr22,19164969,19165014,IMR90|chr22:43046605-43046680,chr22,43046605,43046680,0,23881636
IMR90|chr22:19628841-19628863,chr22,19628841,19628863,IMR90|chr22:46475291-46475331,chr22,46475291,46475331,0,26846450
IMR90|chr22:20195224-20195285,chr22,20195224,20195285,IMR90|chr22:37417579-37417667,chr22,37417579,37417667,0,17222355
IMR90|chr22:20393387-20393436,chr22,20393387,20393436,IMR90|chr22:46473495-46473514,chr22,46473495,46473514,0,26080108
IMR90|chr22:20503319-20503426,chr22,20503319,20503426,IMR90|chr22:39716783-39716839,chr22,39716783,39716839,0,19213464
IMR90|chr22:20884914-20884951,chr22,20884914,20884951,IMR90|chr22:20069956-20070054,chr22,20069956,20070054,0,814958
IMR90|chr22:21190947-21191019,chr22,21190947,21191019,IMR90|chr22:38145666-38145720,chr22,38145666,38145720,0,16954719
IMR90|chr22:21955570-21955631,chr22,21955570,21955631,IMR90|chr22:37417579-37417667,chr22,37417579,37417667,0,15462009
IMR90|chr22:22831877-22831927,chr22,22831877,22831927,IMR90|chr22:46480607-46480660,chr22,46480607,46480660,0,23648730
IMR90|chr22:23260271-23260421,chr22,23260271,23260421,IMR90|chr22:41217180-41217232,chr22,41217180,41217232,0,17956909
IMR90|chr22:23672295-23672348,chr22,23672295,23672348,IMR90|chr22:46475292-46475331,chr22,46475292,46475331,0,22802997
IMR90|chr22:24118934-24119019,chr22,24118934,24119019,IMR90|chr22:36905601-36905635,chr22,36905601,36905635,0,12786667
IMR90|chr22:24372805-24372852,chr22,24372805,24372852,IMR90|chr22:38032235-38032323,chr22,38032235,38032323,0,13659430
IMR90|chr22:24396456-24396481,chr22,24396456,24396481,IMR90|chr22:30279846-30279953,chr22,30279846,30279953,0,5883390
IMR90|chr22:25040963-25041018,chr22,25040963,25041018,IMR90|chr22:46475291-46475331,chr22,46475291,46475331,0,21434328
IMR90|chr22:25183349-25183442,chr22,25183349,25183442,IMR90|chr22:41213118-41213145,chr22,41213118,41213145,0,16029769
IMR90|chr22:25505118-25505179,chr22,25505118,25505179,IMR90|chr22:24200121-24200167,chr22,24200121,24200167,0,1304997
IMR90|chr22:25562548-25562698,chr22,25562548,25562698,IMR90|chr22:30987244-30987295,chr22,30987244,30987295,0,5424696
IMR90|chr22:26228607-26228663,chr22,26228607,26228663,IMR90|chr22:41031853-41031942,chr22,41031853,41031942,0,14803246
IMR90|chr22:26975000-26975052,chr22,26975000,26975052,IMR90|chr22:41217493-41217549,chr22,41217493,41217549,0,14242493
IMR90|chr22:27716722-27716859,chr22,27716722,27716859,IMR90|chr22:46478170-46478232,chr22,46478170,46478232,0,18761448
IMR90|chr22:27822303-27822442,chr22,27822303,27822442,IMR90|chr22:38144780-38144806,chr22,38144780,38144806,0,10322477
IMR90|chr22:28132364-28132408,chr22,28132364,28132408,IMR90|chr22:21922597-21922747,chr22,21922597,21922747,0,6209767
IMR90|chr22:28371653-28371723,chr22,28371653,28371723,IMR90|chr22:41212679-41212757,chr22,41212679,41212757,0,12841026
IMR90|chr22:28427033-28427113,chr22,28427033,28427113,IMR90|chr22:38005876-38005933,chr22,38005876,38005933,0,9578843
IMR90|chr22:28492297-28492380,chr22,28492297,28492380,IMR90|chr22:20849300-20849350,chr22,20849300,20849350,0,7642997
IMR90|chr22:29336336-29336379,chr22,29336336,29336379,IMR90|chr22:37823219-37823369,chr22,37823219,37823369,0,8486883
IMR90|chr22:29515967-29515995,chr22,29515967,29515995,IMR90|chr22:30640124-30640209,chr22,30640124,30640209,0,1124157
IMR90|chr22:29906990-29907050,chr22,29906990,29907050,IMR90|chr22:37417579-37417667,chr22,37417579,37417667,0,7510589
IMR90|chr22:31183722-31183772,chr22,31183722,31183772,IMR90|chr22:46480607-46480660,chr22,46480607,46480660,0,15296885
IMR90|chr22:31248857-31248939,chr22,31248857,31248939,IMR90|chr22:20849300-20849350,chr22,20849300,20849350,0,10399557
IMR90|chr22:31960704-31960813,chr22,31960704,31960813,IMR90|chr22:22222642-22222699,chr22,22222642,22222699,0,9738062
IMR90|chr22:32581360-32581438,chr22,32581360,32581438,IMR90|chr22:26875903-26875938,chr22,26875903,26875938,0,5705457
IMR90|chr22:32687600-32687647,chr22,32687600,32687647,IMR90|chr22:38032235-38032323,chr22,38032235,38032323,0,5344635
IMR90|chr22:32989756-32989841,chr22,32989756,32989841,IMR90|chr22:46478170-46478232,chr22,46478170,46478232,0,13488414
IMR90|chr22:33316039-33316178,chr22,33316039,33316178,IMR90|chr22:38144780-38144806,chr22,38144780,38144806,0,4828741
IMR90|chr22:33425827-33425936,chr22,33425827,33425936,IMR90|chr22:22222642-22222699,chr22,22222642,22222699,0,11203185
IMR90|chr22:33952068-33952088,chr22,33952068,33952088,IMR90|chr22:30279845-30279953,chr22,30279845,30279953,0,3672223
IMR90|chr22:34050757-34050813,chr22,34050757,34050813,IMR90|chr22:41213975-41214073,chr22,41213975,41214073,0,7163218
IMR90|chr22:34736191-34736290,chr22,34736191,34736290,IMR90|chr22:36906478-36906522,chr22,36906478,36906522,0,2170287
IMR90|chr22:34820910-34820967,chr22,34820910,34820967,IMR90|chr22:38032235-38032323,chr22,38032235,38032323,0,3211325
IMR90|chr22:35870616-35870676,chr22,35870616,35870676,IMR90|chr22:37417579-37417667,chr22,37417579,37417667,0,1546963
IMR90|chr22:35989643-35989793,chr22,35989643,35989793,IMR90|chr22:41217180-41217232,chr22,41217180,41217232,0,5227537
IMR90|chr22:36483502-36483596,chr22,36483502,36483596,IMR90|chr22:39716783-39716839,chr22,39716783,39716839,0,3233281
IMR90|chr22:37632591-37632640,chr22,37632591,37632640,IMR90|chr22:46473495-46473514,chr22,46473495,46473514,0,8840904
IMR90|chr22:37943228-37943257,chr22,37943228,37943257,IMR90|chr22:38032734-38032848,chr22,38032734,38032848,0,89506
IMR90|chr22:38014206-38014291,chr22,38014206,38014291,IMR90|chr22:36905601-36905635,chr22,36905601,36905635,0,1108605
IMR90|chr22:38039243-38039297,chr22,38039243,38039297,IMR90|chr22:38146176-38146231,chr22,38146176,38146231,0,106933
IMR90|chr22:38068431-38068514,chr22,38068431,38068514,IMR90|chr22:20848571-20848635,chr22,20848571,20848635,0,17219860
IMR90|chr22:38269599-38269651,chr22,38269599,38269651,IMR90|chr22:41213975-41214073,chr22,41213975,41214073,0,2944376
IMR90|chr22:38275742-38275856,chr22,38275742,38275856,IMR90|chr22:42089003-42089050,chr22,42089003,42089050,0,3813261
IMR90|chr22:38491856-38491905,chr22,38491856,38491905,IMR90|chr22:46481245-46481268,chr22,46481245,46481268,0,7989389
IMR90|chr22:38604765-38604806,chr22,38604765,38604806,IMR90|chr22:41212679-41212757,chr22,41212679,41212757,0,2607914
IMR90|chr22:38609626-38609678,chr22,38609626,38609678,IMR90|chr22:41217493-41217549,chr22,41217493,41217549,0,2607867
IMR90|chr22:38938580-38938652,chr22,38938580,38938652,IMR90|chr22:38793166-38793274,chr22,38793166,38793274,0,145414
IMR90|chr22:39426066-39426139,chr22,39426066,39426139,IMR90|chr22:43010170-43010229,chr22,43010170,43010229,0,3584104
IMR90|chr22:39722824-39722844,chr22,39722824,39722844,IMR90|chr22:30279845-30279953,chr22,30279845,30279953,0,9442979
IMR90|chr22:39978767-39978857,chr22,39978767,39978857,IMR90|chr22:22222642-22222699,chr22,22222642,22222699,0,17756125
IMR90|chr22:40122967-40123037,chr22,40122967,40123037,IMR90|chr22:41212679-41212757,chr22,41212679,41212757,0,1089712
IMR90|chr22:40152767-40152792,chr22,40152767,40152792,IMR90|chr22:30279846-30279953,chr22,30279846,30279953,0,9872921
IMR90|chr22:40501517-40501542,chr22,40501517,40501542,IMR90|chr22:30640124-30640209,chr22,30640124,30640209,0,9861393
IMR90|chr22:40678889-40678968,chr22,40678889,40678968,IMR90|chr22:26875903-26875938,chr22,26875903,26875938,0,13802986
IMR90|chr22:41116224-41116318,chr22,41116224,41116318,IMR90|chr22:39716783-39716839,chr22,39716783,39716839,0,1399441
IMR90|chr22:41372074-41372194,chr22,41372074,41372194,IMR90|chr22:20848571-20848635,chr22,20848571,20848635,0,20523503
IMR90|chr22:41558382-41558463,chr22,41558382,41558463,IMR90|chr22:20849300-20849350,chr22,20849300,20849350,0,20709082
IMR90|chr22:41662013-41662111,chr22,41662013,41662111,IMR90|chr22:41217180-41217232,chr22,41217180,41217232,0,444833
IMR90|chr22:41671883-41671961,chr22,41671883,41671961,IMR90|chr22:26875903-26875938,chr22,26875903,26875938,0,14795980
IMR90|chr22:42163940-42163966,chr22,42163940,42163966,IMR90|chr22:38034321-38034393,chr22,38034321,38034393,0,4129619
IMR90|chr22:42243588-42243614,chr22,42243588,42243614,IMR90|chr22:38034321-38034393,chr22,38034321,38034393,0,4209267
IMR90|chr22:42476836-42476907,chr22,42476836,42476907,IMR90|chr22:38793168-38793273,chr22,38793168,38793273,0,3683668
IMR90|chr22:42952872-42952956,chr22,42952872,42952956,IMR90|chr22:42089003-42089050,chr22,42089003,42089050,0,863869
IMR90|chr22:43062222-43062249,chr22,43062222,43062249,IMR90|chr22:38034321-38034393,chr22,38034321,38034393,0,5027901
IMR90|chr22:43219867-43219914,chr22,43219867,43219914,IMR90|chr22:41214861-41214918,chr22,41214861,41214918,0,2005006
IMR90|chr22:43286131-43286234,chr22,43286131,43286234,IMR90|chr22:42089003-42089050,chr22,42089003,42089050,0,1197128
IMR90|chr22:43935717-43935816,chr22,43935717,43935816,IMR90|chr22:30987244-30987295,chr22,30987244,30987295,0,12948473
IMR90|chr22:44696951-44697031,chr22,44696951,44697031,IMR90|chr22:38005876-38005933,chr22,38005876,38005933,0,6691075
IMR90|chr22:44828897-44828946,chr22,44828897,44828946,IMR90|chr22:46480607-46480660,chr22,46480607,46480660,0,1651710
IMR90|chr22:45054987-45055072,chr22,45054987,45055072,IMR90|chr22:46478170-46478232,chr22,46478170,46478232,0,1423183
IMR90|chr22:45084747-45084772,chr22,45084747,45084772,IMR90|chr22:30640124-30640209,chr22,30640124,30640209,0,14444623
IMR90|chr22:45919520-45919580,chr22,45919520,45919580,IMR90|chr22:24200121-24200167,chr22,24200121,24200167,0,21719399
IMR90|chr22:46179412-46179492,chr22,46179412,46179492,IMR90|chr22:46478170-46478237,chr22,46478170,46478237,0,298758
IMR90|chr22:46255079-46255158,chr22,46255079,46255158,IMR90|chr22:26875903-26875938,chr22,26875903,26875938,0,19379176
IMR90|chr22:46399588-46399641,chr22,46399588,46399641,IMR90|chr22:41031853-41031942,chr22,41031853,41031942,0,5367735
IMR90|chr22:46647008-46647048,chr22,46647008,46647048,IMR90|chr22:46473495-46473517,chr22,46473495,46473517,0,173513
IMR90|chr22:46661399-46661444,chr22,46661399,46661444,IMR90|chr22:43046605-43046680,chr22,43046605,43046680,0,3614794
IMR90|chr22:47118760-47118848,chr22,47118760,47118848,IMR90|chr22:46475291-46475331,chr22,46475291,46475331,0,643469
IMR90|chr22:47154417-47154531,chr22,47154417,47154531,IMR90|chr22:42089003-42089050,chr22,42089003,42089050,0,5065414
IMR90|chr22:47591893-47592017,chr22,47591893,47592017,IMR90|chr22:38144780-38144806,chr22,38144780,38144806,0,9447113
IMR90|chr22:47609944-47610034,chr22,47609944,47610034,IMR90|chr22:22222642-22222699,chr22,22222642,22222699,0,25387302
IMR90|chr22:48232250-48232365,chr22,48232250,48232365,IMR90|chr22:42089003-42089050,chr22,42089003,42089050,0,6143247
IMR90|chr22:48257008-48257061,chr22,48257008,48257061,IMR90|chr22:46475292-46475331,chr22,46475292,46475331,0,1781716
IMR90|chr22:48344549-48344611,chr22,48344549,48344611,IMR90|chr22:39053448-39053514,chr22,39053448,39053514,0,9291101
IMR90|chr22:48406048-48406114,chr22,48406048,48406114,IMR90|chr22:38145462-38145502,chr22,38145462,38145502,0,10260586
IMR90|chr22:48503971-48504028,chr22,48503971,48504028,IMR90|chr22:38032235-38032323,chr22,38032235,38032323,0,10471736
IMR90|chr22:48536877-48536939,chr22,48536877,48536939,IMR90|chr22:39053448-39053514,chr22,39053448,39053514,0,9483429
IMR90|chr22:49002289-49002332,chr22,49002289,49002332,IMR90|chr22:37823219-37823369,chr22,37823219,37823369,0,11179070
IMR90|chr22:49424395-49424439,chr22,49424395,49424439,IMR90|chr22:21922597-21922747,chr22,21922597,21922747,0,27501798
IMR90|chr22:49457341-49457404,chr22,49457341,49457404,IMR90|chr22:37418111-37418176,chr22,37418111,37418176,0,12039230
IMR90|chr22:50023576-50023667,chr22,50023576,50023667,IMR90|chr22:38007898-38007999,chr22,38007898,38007999,0,12015678
IMR90|chr22:50086528-50086649,chr22,50086528,50086649,IMR90|chr22:20848571-20848635,chr22,20848571,20848635,0,29237957
IMR90|chr22:50405228-50405281,chr22,50405228,50405281,IMR90|chr22:41031853-41031942,chr22,41031853,41031942,0,9373375
IMR90|chr22:50631429-50631474,chr22,50631429,50631474,IMR90|chr22:23491189-23491244,chr22,23491189,23491244,0,27140240
IMR90|chr22:50964539-50964638,chr22,50964539,50964638,IMR90|chr22:36906478-36906522,chr22,36906478,36906522,0,14058061
